index,open,high,low,close,Plot.2,Plot.3,MA,MA.1,MA.2,MA.3,EMA,EMA.1,Basis,Upper,Lower,MA.4,MA.5,MA.6,MA.7,VWAP,Volume,Volume MA,RSI,Min,Max,ATR,Plot.4,Histogram,MACD,Signal,HV,ROC,OnBalanceVolume,date,year,day_of_week,day_of_year,month,hi_lo_delta,average_price,tomorrow_high,tomorrow_low,ticks
2000-01-03 14:30:00,148.25,148.25,143.875,145.4375,119.50390625,148.25,134.93009715000017,136.10285100000002,140.25367119999999,143.59765549999997,140.78411537894618,144.03380182037859,144.66706615384606,148.69473436286927,140.63939794482286,134.93009715000017,136.10285100000002,140.25367119999999,143.59765549999997,145.85416666666666,8164301,5298449.95,60.130576939839756,1.5,2.75,1.9785421684096136,1.5408848016012682,0.10667624280980603,1.8146703463761185,1.7079941035663124,15.069278334489946,2.669313920141187,-2608745.0,2000-01-03,2000,0,3,1,3.04,146.06,144.0625,139.64061999999998,0
2000-01-04 14:30:00,143.53125,144.0625,139.64061999999998,139.75,119.4296875,148.3953125,134.97915965000016,136.19894480000002,140.4467962,143.44609299999996,140.74356183467378,143.62582069462826,144.533653076923,149.0584041035402,140.0089020503058,134.97915965000016,136.19894480000002,140.4467962,143.44609299999996,141.15104,8089801,5546000.0,39.903017125157945,1.5,2.75,2.2512805849517834,1.4586730977280924,-0.3636349676895452,1.2534503939543808,1.6170853616439262,28.201262901630198,-2.824858757062147,-10698546.0,2000-01-04,2000,1,4,1,3.17,141.85,141.53125,137.25,1
2000-01-05 14:30:00,139.9375,141.53125,137.25,140.0,137.25,148.540625,135.04822215000016,136.2673823,140.65804619999997,143.36484299999995,140.7144025470395,143.280504437997,144.37019153846148,149.36075196111494,139.37963111580794,135.04822215000016,136.2673823,140.65804619999997,143.36484299999995,139.59375,12177898,5619194.9,40.84499969449905,1.5,2.75,2.39627840031237,2.1671962294812017,-0.6381428197169807,0.8194068369977003,1.4575496567146808,26.334901910177088,-2.904204594711747,1479352.0,2000-01-05,2000,2,5,1,3.12,139.39,141.5,137.75,2
2000-01-06 14:30:00,139.625,141.5,137.75,137.75,137.50113636363636,148.6859375,135.1024409000002,136.3073823,140.85679620000005,143.21640549999995,140.59815146676343,142.75378972961633,143.99038384615375,150.06843231942395,137.91233537288358,135.1024409000002,136.3073823,140.85679620000005,143.21640549999995,139.0,6227199,5699994.9,35.458165018090384,1.5,2.75,2.4929728002900577,1.0924920301244478,-0.9336244677646548,0.2905190720088626,1.2241435397735174,27.14905313681434,-5.9626634568589205,-4747847.0,2000-01-06,2000,3,6,1,2.72,139.62,145.75,140.0625,3
2000-01-07 14:30:00,140.3125,145.75,140.0625,145.75,137.75227272727273,148.83125,135.18369090000016,136.4186323,141.16929620000005,143.43359299999997,140.80018474257662,143.03914308870046,144.30528769230762,150.29046473147278,138.32011065314242,135.18369090000016,136.4186323,141.16929620000005,143.43359299999997,143.85416666666666,8066602,5779590.05,57.11491150818232,1.5,2.75,2.8863318859836253,1.395704873566249,-0.5705034754310043,0.511014195484762,1.0815176709157663,43.40890951579029,-0.3631702627643666,3318755.0,2000-01-07,2000,4,7,1,4.06,142.91,146.90625,145.03125,4
2000-01-10 14:30:00,146.25,146.90625,145.03125,146.25,138.0034090909091,148.9765625,135.27212840000016,136.5445698,141.40304619999998,143.65234299999997,141.01390298796582,143.34493898501472,144.49278769230762,150.55666950610262,138.42890587851258,135.27212840000016,136.5445698,141.40304619999998,143.65234299999997,146.0625,5741602,5810305.1,58.06207200058638,1.5,2.75,2.814093894127652,0.9881756467487396,-0.2909506956178867,0.7178293013934081,1.0087799970112947,43.460692497573156,0.04275331338178709,9060357.0,2000-01-10,2000,0,10,1,1.29,145.97,146.09375,143.5,5
2000-01-11 14:30:00,145.8125,146.09375,143.5,144.3125,138.25454545454545,149.121875,135.33790965000014,136.6620698,141.5492962,143.76171799999997,141.14325973353576,143.43708765310856,144.502403076923,150.5647142577254,138.44009189612058,135.33790965000014,136.6620698,141.5492962,143.76171799999997,144.63541666666666,7433699,5971450.0,53.16228404479933,1.5,2.75,2.80951575883282,1.244873355717623,-0.23332389115117225,0.7171251330723294,0.9504490242235016,44.130712336947575,-1.7028522775649213,1626658.0,2000-01-11,2000,1,11,1,1.81,144.8,144.59375,142.875,6
2000-01-12 14:30:00,144.59375,144.59375,142.875,143.0625,138.5056818181818,149.2671875,135.40087840000015,136.75363230000002,141.69929620000005,143.87734299999997,141.21852405771082,143.4014126385268,144.23918230769218,150.23115579805742,138.24720881732702,135.40087840000015,136.75363230000002,141.69929620000005,143.87734299999997,143.51041666666666,6911699,6030084.95,50.217888261819404,1.5,2.75,2.7316039189161896,1.146202592054694,-0.2734104447057457,0.6086859683413195,0.8820964130470652,44.16045594799436,-2.440060605308415,-5285041.0,2000-01-12,2000,2,12,1,1.2,143.73,145.75,143.28125,7
2000-01-13 14:30:00,144.46875,145.75,143.28125,145.0,138.75681818181818,149.4125,135.4840034000002,136.8389448,141.90742120000004,144.05312449999997,141.36681723191825,143.5536590539052,144.14062461538455,150.0363780170412,138.24487121372786,135.4840034000002,136.8389448,141.90742120000004,144.05312449999997,144.67708333333334,5158301,5944050.0,54.43078206968647,1.5,2.75,2.7284536389936043,0.8678091536915067,-0.16859847354098711,0.6713483211208313,0.8399467946618184,45.11664583524479,-1.2765957446808511,-126740.0,2000-01-13,2000,3,13,1,1.72,144.52,147.46875,145.96875,8
2000-01-14 14:30:00,146.53125,147.46875,145.96875,146.96875,139.00795454545454,149.5578125,135.57212840000014,136.9389448,142.13679620000005,144.29531199999997,141.58650086988226,143.87890581067612,144.20072076923068,150.19382824092034,138.20761329754106,135.57212840000014,136.9389448,142.13679620000005,144.29531199999997,146.80208333333334,7437301,6023175.0,58.29310513386315,1.5,2.75,2.7099033790654903,1.234780825727295,0.023917241064368988,0.8698433459922796,0.8459261049279106,45.88651235689069,1.0528577567683712,7310561.0,2000-01-14,2000,4,14,1,1.03,146.72,146.625,145.1875,9
2000-01-18 14:30:00,145.34375,146.625,145.1875,145.8125,139.2590909090909,149.703125,135.63915965000015,137.0133198,142.32242119999998,144.45156199999997,141.7522263259653,144.06305763823073,144.1237976923076,150.00547365060854,138.24212173400664,135.63915965000015,137.0133198,142.32242119999998,144.45156199999997,145.875,6488500,6108830.1,55.32717202080399,1.5,2.75,2.6435709948465265,1.0621510000744658,0.06182725941714695,0.9232101791993444,0.8613829197821974,45.74720547560407,4.338103756708408,822061.0,2000-01-18,2000,1,18,1,0.99,145.91,146.46875,145.0,10
2000-01-19 14:30:00,145.3125,146.46875,145.0,146.25,139.51022727272726,149.8484375,135.70994090000016,137.1086323,142.48992119999997,144.68124949999995,141.9286096073,144.27133786316116,144.09374999999991,149.92748396060662,138.26001603939315,135.70994090000016,137.1086323,142.48992119999997,144.68124949999995,145.90625,6152898,6186040.05,56.23454656304287,1.5,2.75,2.5596552095003458,0.9946424449676816,0.10241460164233196,0.9894011718351124,0.8869865701927804,37.94805177445796,4.464285714285714,6974959.0,2000-01-19,2000,2,19,1,1.01,145.73,146.96875,143.8125,11
2000-01-20 14:30:00,146.96875,146.96875,143.8125,144.75,139.76136363636363,149.99375,135.76790965000018,137.20550730000002,142.62492120000005,144.72812449999995,142.039252367798,144.31692473333632,143.93028846153837,149.55860766633526,138.30196925674147,135.76790965000018,137.20550730000002,142.62492120000005,144.72812449999995,145.17708333333334,5800102,6076980.1,52.31137613960521,1.5,2.75,2.602269123107464,0.9544382085437471,0.01867223581526356,0.91032686496186,0.8916546291465963,38.890703845525174,5.081669691470053,1174857.0,2000-01-20,2000,3,20,1,2.19,145.39,145.5,144.0625,12
2000-01-21 14:30:00,145.5,145.5,144.0625,144.4375,140.0125,150.1390625,135.81587840000014,137.3242573,142.77960880000003,144.74062449999997,142.13330129455102,144.32840809206618,143.8533653846153,149.4242258160775,138.28250495315305,135.81587840000014,137.3242573,142.77960880000003,144.74062449999997,144.66666666666666,6244801,6120345.15,51.50520263098309,1.5,2.75,2.519071328599788,1.0203347763810346,-0.06286675117683793,0.8130711901755491,0.8759379413523869,37.10772273852493,-0.9005145797598628,-5069944.0,2000-01-21,2000,4,21,1,1.0,144.78,145.84375,139.40625,13
2000-01-24 14:30:00,145.65625,145.84375,139.40625,140.34375,140.26363636363635,150.284375,135.84322215000014,137.40706980000002,142.8321088,144.43359349999997,142.0631228124118,143.94891684520275,143.89903846153837,149.34287064134068,138.45520628173605,135.84322215000014,137.40706980000002,142.8321088,144.43359349999997,141.86458333333334,7896898,6229105.1,42.30704149664915,1.5,2.75,2.7989590908426605,1.2677419746858984,-0.3799175498347696,0.40104100405892495,0.7809585538936945,23.353729983329483,-4.038461538461538,-12966842.0,2000-01-24,2000,0,24,1,4.62,142.62,141.9375,139.0,14
2000-01-25 14:30:00,140.51561999999998,141.9375,139.0,141.9375,140.5147727272727,150.4296875,135.87134715000016,137.4895698,142.9008588,144.21640599999995,142.05819642761136,143.7573533361358,144.04807692307682,149.1522569234693,138.9438969226843,135.87134715000016,137.4895698,142.9008588,144.21640599999995,140.95833333333334,9942500,6591680.1,46.325861536711336,1.5,2.75,2.8088548700681852,1.5083407946329193,-0.4641333907471541,0.2007918154597519,0.664925206206906,24.63952358088206,-1.645734084019056,-3024342.0,2000-01-25,2000,1,25,1,2.11,140.47,141.54686999999998,140.09375,15
2000-01-26 14:30:00,141.0,141.54686999999998,140.09375,140.8125,140.7659090909091,150.575,135.89822215000015,137.5766011,142.92210880000005,143.94765599999997,142.00934558731285,143.47689111364667,144.28365384615375,148.38816748050962,140.17914021179786,135.89822215000015,137.5766011,142.92210880000005,143.94765599999997,140.81770666666668,5158102,6645360.2,43.99612309635712,1.5,2.75,2.739918807920457,0.776195999127331,-0.5704444769888625,-0.048130390029172083,0.5223140869596904,23.999933010778786,-1.5727391874180865,-8182444.0,2000-01-26,2000,2,26,1,1.04,140.82,142.21875,138.125,16
2000-01-27 14:30:00,141.84375,142.21875,138.125,140.25,141.01704545454547,150.7203125,135.93369090000016,137.6194136,142.9255464,143.61953099999997,141.9403516427124,143.16956815044225,143.86057692307682,148.38558856941373,139.3355652767399,135.93369090000016,137.6194136,142.9255464,143.61953099999997,140.19791666666666,10919898,7041305.1,42.83614775696528,1.5,2.75,2.8366210359261386,1.5508343758602363,-0.6478338378858848,-0.28747821039766563,0.3603556274882192,23.70303426559382,-3.2758620689655173,-19102342.0,2000-01-27,2000,3,27,1,2.96,140.17,140.0625,135.53125,17
2000-01-28 14:30:00,139.4375,140.0625,135.53125,135.875,141.26818181818183,150.865625,135.94978465000014,137.6234761,142.8180464,143.08124999999995,141.70249471554718,142.47484737420965,143.06249999999991,149.04519740746522,137.07980259253455,135.94978465000014,137.6234761,142.8180464,143.08124999999995,137.15625,11916199,7455050.05,35.08748438293962,1.5,2.75,2.9710588190742717,1.5984063044620338,-0.9448670424106704,-0.8207281755251188,0.12413886688555155,26.88026833502843,-7.548373378694451,-31018541.0,2000-01-28,2000,4,28,1,3.34,137.8,139.67186999999998,135.0,18
2000-01-31 14:30:00,135.8125,139.67186999999998,135.0,139.625,135.0,151.0109375,135.99025340000014,137.6716011,142.77929640000002,142.71874999999994,141.6210243345453,142.20343333857062,142.70192307692298,148.9009273095725,136.5029188442735,135.99025340000014,137.6716011,142.77929640000002,142.71874999999994,138.09895666666668,10768602,7834845.15,44.375453510693426,1.5,2.75,3.0925453319975387,1.3744498830331062,-0.8433257198725921,-0.9300182829551886,-0.08669256308259654,31.384687498854266,-4.2434633519074145,-20249939.0,2000-01-31,2000,0,31,1,3.46,137.34,141.6875,138.53125,19
2000-02-01 14:30:00,139.75,141.6875,138.53125,140.9375,134.86764705882354,151.15625,136.04744090000014,137.73347610000002,142.74554640000002,142.49374999999995,141.5942194586808,142.08286825870675,142.53846153846143,148.8025396179913,136.27438345893157,136.04744090000014,137.73347610000002,142.74554640000002,142.49374999999995,140.38541666666666,8419801,7847620.15,47.221873748148404,1.5,2.75,3.0970956654262864,1.0729113844787708,-0.6509220150124835,-0.9003450818482008,-0.2494230668357174,32.370966934967704,-3.632478632478633,-11830138.0,2000-02-01,2000,1,32,2,2.28,140.11,142.25,140.375,20
2000-02-02 14:30:00,141.28125,142.25,140.375,141.0625,134.73529411764707,151.3015625,136.09712840000014,137.78535109999999,142.7168746,142.55937499999996,141.57336771520312,141.98569032930612,142.23557692307682,148.37378948671508,136.09736435943856,136.09712840000014,137.78535109999999,142.7168746,142.55937499999996,141.22916666666666,6205898,7753425.0,47.49742887237773,1.5,2.75,3.0098031178958378,0.8004073038689353,-0.4859535421938859,-0.8568649945780749,-0.3709114523841889,32.24114628208702,-2.547495682210708,-5624240.0,2000-02-02,2000,2,33,2,1.34,141.31,143.25,140.0,21
2000-02-03 14:30:00,140.875,143.25,140.0,143.1875,134.60294117647058,151.446875,136.13869090000014,137.8676949,142.7312496,142.71874999999994,141.63666702048928,142.10014839318174,141.94471153846143,147.48771181548392,136.40171126143898,136.13869090000014,137.8676949,142.7312496,142.71874999999994,142.14583333333334,7997500,7544405.1,52.0780330415237,1.5,2.75,3.0269600380461346,1.0600570746128148,-0.21808594719647326,-0.6435188863797805,-0.4254329391833073,33.550010798342,-0.8654262224145391,2373260.0,2000-02-03,2000,3,34,2,2.32,141.62,144.0,142.125,22
2000-02-04 14:30:00,143.1875,144.0,142.125,142.59375,134.47058823529414,151.5921875,136.17087840000016,137.95300740000002,142.75874960000004,142.96093749999994,141.67419968635244,142.14715807002156,141.6971153846153,146.79674681781609,136.59748395141443,136.17087840000016,137.95300740000002,142.75874960000004,142.96093749999994,142.90625,4925398,7479315.05,50.74582550724546,1.5,2.75,2.9446771781856964,0.6585359711515295,-0.07277244938100197,-0.5163985009095597,-0.4436260515285578,33.59279067057061,1.6032064128256514,-2552138.0,2000-02-04,2000,4,35,2,1.32,143.06,142.78125,141.4375,23
2000-02-07 14:30:00,142.5625,142.78125,141.4375,142.375,134.33823529411765,151.7375,136.20369090000014,138.0573824,142.7649996,142.79218749999995,141.7016820515935,142.1688573014481,141.39903846153837,145.80518813621978,136.99288878685695,136.20369090000014,138.0573824,142.7649996,142.79218749999995,142.19791666666666,5845801,7368275.0,50.2359535980005,1.5,2.75,2.8303252368867184,0.7933744329575104,0.012206427977710876,-0.4283680165564192,-0.4405744445341301,28.741672135444784,0.30823425803610743,-8397939.0,2000-02-07,2000,0,38,2,0.95,142.11,144.5625,143.625,24
2000-02-08 14:30:00,143.96875,144.5625,143.625,144.3125,134.20588235294122,151.8828125,136.24228465000016,138.17597619999998,142.8237496,142.69531249999994,141.80406706917807,142.3730137489292,141.3653846153845,145.67425185728794,137.05651737348106,136.24228465000016,138.17597619999998,142.8237496,142.69531249999994,144.16666666666666,4936500,7328019.9,54.5881482247135,1.5,2.75,2.7844091485376667,0.6736471881032965,0.1924930176262321,-0.19995817250134,-0.3924511901275721,29.04675184035481,2.485574789169996,-3461439.0,2000-02-08,2000,1,39,2,0.65,144.09,144.46875,141.26561999999998,25
2000-02-09 14:30:00,144.46875,144.46875,141.26561999999998,141.28125,134.0735294117647,152.028125,136.26244090000014,138.25128869999998,142.83062460000005,142.54374999999996,141.78356443901424,142.2690362490312,141.12259615384605,145.05054255671962,137.19464975097245,136.26244090000014,138.25128869999998,142.83062460000005,142.54374999999996,142.33854,8511500,7381909.95,47.57748885426098,1.5,2.75,2.814317780784976,1.1530213803271876,0.10553296636343128,-0.26053498217328297,-0.3660679485367143,31.53942938646588,0.7352941176470589,-11972939.0,2000-02-09,2000,2,40,2,2.27,142.87,142.5625,140.875,26
2000-02-10 14:30:00,141.625,142.5625,140.875,141.5625,133.94117647058823,152.1734375,136.29337840000017,138.33128870000002,142.8740622,142.46874999999994,141.77489524532743,142.20174708245682,141.21634615384605,145.12358345511885,137.30910885257325,136.29337840000017,138.33128870000002,142.8740622,142.46874999999994,141.66666666666666,6690602,7370855.1,48.241684609019096,1.5,2.75,2.7338307964431916,0.9077104229060208,0.06678196800565178,-0.2825904885296495,-0.3493724565353013,31.425588339972983,4.185832566697332,-5282337.0,2000-02-10,2000,3,41,2,1.2,141.72,141.9375,138.03125,27
2000-02-11 14:30:00,141.84375,141.9375,138.03125,138.6875,133.80882352941177,152.31875,136.31509715000016,138.4106637,142.8396872,142.15312499999996,141.65382092198126,141.8670568841276,140.96634615384605,145.06807696365792,136.8646153440342,136.31509715000016,138.4106637,142.8396872,142.15312499999996,139.55208333333334,9849199,7605400.0,42.33662232798757,1.5,2.75,2.8175750252686784,1.2950270860178297,-0.14129784962712333,-0.5259947685692055,-0.3846969189420821,27.613308657401838,-0.6714413607878246,-15131536.0,2000-02-11,2000,4,42,2,2.83,139.98,139.78125,138.3125,28
2000-02-14 14:30:00,139.78125,139.78125,138.3125,139.5,133.6764705882353,152.4640625,136.34634715000016,138.4996481,142.80468720000005,141.77968749999997,141.56935735641338,141.64162289516304,140.8653846153845,145.04123556328722,136.68953366748178,136.34634715000016,138.4996481,142.80468720000005,141.77968749999997,139.19791666666666,8528801,7659975.0,44.4076562186321,1.5,2.75,2.72123038060663,1.1134241299743146,-0.2089521211526412,-0.6458870703828836,-0.4369349492302425,22.79702892790699,-1.0199556541019956,-6602735.0,2000-02-14,2000,0,45,2,1.06,139.05,141.21875,137.79686999999998,29
2000-02-15 14:30:00,139.25,141.21875,137.79686999999998,141.09375,133.54411764705878,152.609375,136.37337840000018,138.63183560000002,142.7496872,141.54374999999996,141.55070608753442,141.58944452419513,140.93028846153837,145.09206752291112,136.76850940016558,136.37337840000018,138.63183560000002,142.7496872,141.54374999999996,140.03645666666668,11078301,7889465.05,48.32799797164576,1.5,2.75,2.7712767819918698,1.4041891217960336,-0.13471003815796462,-0.6053224969276982,-0.4706124587697336,23.12660252693648,0.022153300841825437,4475566.0,2000-02-15,2000,1,46,2,2.48,139.51,140.9375,138.79686999999998,30
2000-02-16 14:30:00,140.375,140.9375,138.79686999999998,139.1875,133.41176470588235,152.7546875,136.40056590000015,138.74621059999998,142.6778122,141.19062499999995,141.4580313390036,141.36068790284318,141.18509615384605,144.36815882112856,138.0020334865635,136.40056590000015,138.74621059999998,142.6778122,141.19062499999995,139.64062333333334,8845398,8024090.05,44.3036732096381,1.5,2.75,2.7373912975638777,1.1023552757860688,-0.19847675374484386,-0.7187084009507885,-0.5202316472059446,24.404889135051498,-2.7935399388913136,-4369832.0,2000-02-16,2000,2,47,2,1.54,139.87,140.4375,138.21875,31
2000-02-17 14:30:00,140.4375,140.4375,138.21875,138.28125,133.27941176470586,152.9,136.41790965000015,138.84308560000002,142.6109372,140.86718749999994,141.33345167865056,141.06740810257241,141.08173076923066,144.53641147618964,137.62705006227168,136.41790965000015,138.84308560000002,142.6109372,140.86718749999994,138.97916666666666,7584199,8113294.9,42.4921025283235,1.5,2.75,2.700345490595029,0.934786556322512,-0.2811319215202063,-0.8716465491062024,-0.5905146275859962,22.17522733981696,-3.0243261012491782,-11954031.0,2000-02-17,2000,3,48,2,1.61,139.33,138.875,134.625,32
2000-02-18 14:30:00,138.875,138.875,134.625,135.3125,133.14705882352942,153.0453125,136.42455030000016,138.91277309999998,142.5028122,140.41093749999996,141.0973359265466,140.51932161661313,140.64903846153834,145.27729575047582,136.02078117260092,136.42455030000016,138.91277309999998,142.5028122,140.41093749999996,136.27083333333334,9650898,8283599.75,37.13522304501729,1.5,2.75,2.8110350984096706,1.1650608782733618,-0.5022762598288467,-1.2183599523720543,-0.7160836925432078,24.524613071048144,-4.960491659350306,-21604929.0,2000-02-18,2000,4,49,2,3.16,136.75,136.34375,133.53125,33
2000-02-22 14:30:00,135.1875,136.34375,133.53125,134.96875,133.01470588235293,153.190625,136.42439405000016,138.9943356,142.3740622,140.14218749999995,140.85699922354482,139.99069574836426,140.18028846153834,145.6954638679405,134.66511305513623,136.42439405000016,138.9943356,142.3740622,140.14218749999995,134.94791666666666,16415398,8709524.75,36.560485755183,1.5,2.75,2.8111397342375506,1.884763918949768,-0.6299640188912691,-1.5035387161572942,-0.8735746972660251,24.475755057305488,-6.474664356864444,-38020327.0,2000-02-22,2000,1,53,2,2.11,134.94,137.46875,134.5,34
2000-02-23 14:30:00,135.625,137.46875,134.5,136.5625,132.88235294117646,153.3359375,136.43556595000018,139.0724606,142.2678122,139.87343749999997,140.68858748928812,139.6642009151867,139.67067307692298,145.20447520352698,134.136870950319,136.43556595000018,139.0724606,142.2678122,139.87343749999997,136.17708333333334,12119000,8818349.75,41.11118689234742,1.5,2.75,2.82239761036344,1.374293415840078,-0.5672988622385082,-1.5826982750641605,-1.0153994128256525,23.99227310208066,-3.3399690333996905,-25901327.0,2000-02-23,2000,2,54,2,2.21,135.98,137.03125,133.09375,35
2000-02-24 14:30:00,136.6875,137.03125,133.09375,133.8125,132.75,153.48125,136.4261909500002,139.1258981,142.10156220000005,139.52343749999994,140.4189369995121,139.10689606612132,138.9951923076922,145.0555778506297,132.93480676475474,136.4261909500002,139.1258981,142.10156220000005,139.52343749999994,134.64583333333334,17375008,9429195.05,36.27578609841401,1.5,2.75,2.902047781051765,1.8426820007292135,-0.6645241851734618,-1.8460546442924797,-1.1815304591190177,23.785088895021968,-5.474613686534217,-43276335.0,2000-02-24,2000,3,55,2,2.96,135.06,136.71875,133.125,36
2000-02-25 14:30:00,135.1875,136.71875,133.125,133.32811999999998,132.61764705882354,153.6265625,136.40908155000017,139.1516793,141.95312460000005,139.17734349999995,140.14086574462928,138.55653644077645,138.29927846153836,144.7147320750124,131.88382484806434,136.40908155000017,139.1516793,141.95312460000005,139.17734349999995,134.39062333333334,10559898,9411195.05,35.48411528108984,1.5,2.75,2.9514550824052113,1.1220570760564568,-0.7107678904991412,-2.069990322242944,-1.3592224317438029,23.35964233025792,-3.86435691753041,-53836233.0,2000-02-25,2000,4,56,2,2.7,134.92,136.6875,132.71875,37
2000-02-28 14:30:00,133.375,136.6875,132.71875,136.125,132.71875,153.771875,136.4029878000002,139.20667930000002,141.8459372,139.18984349999997,139.9833808134673,138.32496154165486,137.66947076923068,143.13758110359282,132.20136043486852,136.4029878000002,139.20667930000002,141.8459372,139.18984349999997,135.17708333333334,13397801,9485275.15,43.19316287839034,1.5,2.75,3.024119005090553,1.412484170266795,-0.5116108027637889,-1.9987359351985392,-1.4871251324347499,25.840166212159428,-2.419354838709677,-40438432.0,2000-02-28,2000,0,59,2,2.99,134.7,137.4375,135.75,38
2000-02-29 14:30:00,136.0625,137.4375,135.75,137.4375,132.5986842105263,153.9171875,136.42126905000018,139.25480430000002,141.7521872,139.08046849999997,139.88354235019412,138.24044139483058,137.3737976923076,142.4288216176868,132.31877376692842,136.42126905000018,139.25480430000002,141.7521872,139.08046849999997,136.875,8242500,9358970.05,46.42820844558278,1.5,2.75,2.9286462190126565,0.8807058849386957,-0.2626449950816592,-1.815431376286824,-1.552786381205165,26.333715455126125,-2.5913621262458477,-32195932.0,2000-02-29,2000,1,60,2,1.24,136.59,139.0,137.21875,39
2000-03-01 14:30:00,137.625,139.0,137.21875,138.4375,132.47861842105266,154.0625,136.44251905000021,139.3204293,141.6671872,138.95546849999997,139.82683480704924,138.25920888103718,137.13341307692298,141.6358278489791,132.63099830486686,136.44251905000021,139.3204293,141.6671872,138.95546849999997,138.21875,6866000,9281280.0,48.819695475350954,1.5,2.75,2.8466893462260385,0.7397686525996414,-0.014855644598959385,-1.5713559369538643,-1.556500292354905,25.69940625343896,-0.5388414907947912,-25329932.0,2000-03-01,2000,2,61,3,1.3,138.11,139.125,137.34375,40
2000-03-02 14:30:00,138.6875,139.125,137.34375,138.53125,132.35855263157896,154.2078125,136.4654878000002,139.36699180000002,141.6046872,138.82890599999996,139.77602755971398,138.28511755903364,137.12139384615378,141.6079561734076,132.63483151889992,136.4654878000002,139.36699180000002,141.6046872,138.82890599999996,138.33333333333334,7600199,9350995.05,49.04933028186675,1.5,2.75,2.7705865357813217,0.8127690111438995,0.16140589928238036,-1.3547429182519295,-1.51614881753431,24.606084633730273,0.1807909604519774,-17729733.0,2000-03-02,2000,3,62,3,1.3,138.23,141.71875,139.71875,41
2000-03-03 14:30:00,140.4375,141.71875,139.71875,141.125,132.23848684210526,154.353125,136.49658155000014,139.4416793,141.55093720000005,138.72578099999996,139.82892843972522,138.5555825534114,137.24639384615378,142.06903292348363,132.42375476882387,136.49658155000014,139.4416793,141.55093720000005,138.72578099999996,140.85416666666666,12770301,9589635.1,55.057395135942926,1.5,2.75,2.8003660689397987,1.3316774691458282,0.44277156117186256,-0.9626843660694816,-1.4054559272413445,26.479680762158367,4.2956120092378764,-4959432.0,2000-03-03,2000,4,63,3,1.43,140.72,141.34375,138.75,42
2000-03-06 14:30:00,140.8125,141.34375,138.75,139.8125,132.1184210526316,154.4984375,136.52517530000014,139.5238668,141.46343720000004,138.58671849999996,139.82828418718694,138.675288976896,137.14783615384607,141.69652926465542,132.59914304303672,136.52517530000014,139.5238668,141.46343720000004,138.58671849999996,139.96875,11966898,9941710.1,51.733031487446524,1.5,2.75,2.7856077783012414,1.2037061913523308,0.5249678798536217,-0.749246077424317,-1.2742139572779387,23.17717309061386,3.5887937022458902,-16926330.0,2000-03-06,2000,0,66,3,1.87,140.05,140.15625,135.21875,43
2000-03-07 14:30:00,140.0,140.15625,135.21875,137.04686999999998,131.9983552631579,154.64375,136.54369090000014,139.61246050000003,141.27468720000005,138.32031199999997,139.71920912102274,138.5202014552869,136.98317230769223,141.3769427401581,132.58940187522632,136.54369090000014,139.61246050000003,141.27468720000005,138.32031199999997,137.47395666666668,20061808,10652510.45,45.49893468812472,1.5,2.75,2.9393143655654383,1.8832939046776531,0.3840879761042306,-0.7941039871476505,-1.1781919632518811,26.665728107659287,0.35468741418765226,-36988138.0,2000-03-07,2000,1,67,3,3.65,137.69,137.84375,135.03125,44
2000-03-08 14:30:00,136.46875,137.84375,135.03125,136.875,131.87828947368422,154.7890625,136.57244090000015,139.69964800000002,141.0865622,137.94843699999996,139.60767150843358,138.3635156024024,136.8749992307691,141.20438140934115,132.54561705219714,136.57244090000015,139.69964800000002,141.0865622,137.94843699999996,136.58333333333334,11808398,10996105.35,45.13492826046804,1.5,2.75,2.930256196596478,1.0738709410418663,0.2754256647003026,-0.8339098823765028,-1.1093355470768054,25.877930571522647,2.2886501634750114,-48796536.0,2000-03-08,2000,2,68,3,2.08,136.44,140.875,136.125,45
2000-03-09 14:30:00,137.25,140.875,136.125,140.875,131.75822368421052,154.934375,136.63181590000016,139.85964800000002,140.9803122,137.92812449999997,139.65737066496564,138.60270459264981,137.30288384615378,142.01277627644643,132.59299141586106,136.63181590000016,139.85964800000002,140.9803122,137.92812449999997,139.29166666666666,5500898,10845575.25,54.298817993302706,1.5,2.75,3.060237896839587,0.5072020499788612,0.4582642202880454,-0.5365052717167487,-0.994769492004794,26.92770019919749,5.660381320909638,-43295638.0,2000-03-09,2000,3,69,3,3.49,138.5,142.0,139.53125,46
2000-03-10 14:30:00,140.1875,142.0,139.53125,140.1875,131.63815789473685,155.0796875,136.6805659000002,140.0037105,140.84781220000005,137.85937449999997,139.67816005065328,138.7536374885879,137.70432615384607,142.4395569350309,132.96909537266123,136.6805659000002,140.0037105,140.84781220000005,137.85937449999997,140.57291666666666,7924500,10907270.15,52.6704653869184,1.5,2.75,3.0179887613510448,0.7265337606037016,0.514035396784972,-0.3522252460235791,-0.8662606428085511,27.087461527680286,2.9843893480257115,-51220138.0,2000-03-10,2000,4,70,3,1.77,140.77,140.46875,136.5,47
2000-03-13 14:30:00,136.6875,140.46875,136.5,138.59375,131.51809210526315,155.225,136.73072215000016,140.119648,140.68687480000003,137.85468699999996,139.6356341663139,138.7384101087224,137.86057615384607,142.56876082086833,133.15239148682383,136.73072215000016,140.119648,140.68687480000003,137.85468699999996,138.52083333333334,10540398,10941830.1,49.001845678678855,1.5,2.75,3.0859002783973994,0.9633121610981696,0.42823323605980135,-0.3309690977337993,-0.7592023337936007,26.53688898204591,0.8412914961346066,-61760536.0,2000-03-13,2000,0,73,3,2.91,138.48,140.09375,136.15625,48
2000-03-14 14:30:00,139.28125,140.09375,136.15625,136.625,131.39802631578948,155.3703125,136.76283155000021,140.20339800000002,140.4818748,137.71093699999997,139.51757008136045,138.53713295551074,138.07692230769223,142.24913860188502,133.9047060134994,136.76283155000021,140.20339800000002,140.4818748,137.71093699999997,137.625,8263699,10928575.0,44.846394985901185,1.5,2.75,3.1467288299404426,0.7561552169427396,0.2332858872424295,-0.4675949747405639,-0.7008808619829934,27.492154750628305,-1.309255079006772,-70024235.0,2000-03-14,2000,1,74,3,2.89,138.12,140.4375,136.0625,49
2000-03-15 14:30:00,136.875,140.4375,136.0625,139.8125,131.27796052631578,155.515625,136.8131440500002,140.31152300000002,140.3693748,137.64687449999997,139.52913596052278,138.65859648355735,138.57572076923068,141.80065828411512,135.35078325434623,136.8131440500002,140.31152300000002,140.3693748,137.64687449999997,138.77083333333334,10300801,10889700.0,51.95092042509214,1.5,2.75,3.234462484944697,0.9459214670743914,0.30867603451667824,-0.3150358188371456,-0.6237118533538238,30.471054080963988,0.9248815700428604,-59723434.0,2000-03-15,2000,2,75,3,3.22,138.25,146.84375,140.875,50
2000-03-16 14:30:00,141.625,146.84375,140.875,146.34375,131.1578947368421,155.6609375,136.89548780000018,140.47402300000002,140.5012498,138.00468699999996,139.7963757267768,139.3905158660757,139.36177846153836,144.32640534244612,134.39715158063058,136.89548780000018,140.47402300000002,140.5012498,138.00468699999996,144.6875,25601392,11727499.7,62.58572094150031,1.5,2.75,3.505661593162933,2.183022183321821,0.7622431892060366,0.329092133153722,-0.4331510560523146,39.785128340431385,3.697962798937112,-34122042.0,2000-03-16,2000,3,76,3,4.24,143.86,148.0,145.4375,51
2000-03-17 14:30:00,145.8125,148.0,145.4375,146.9375,131.0378289473684,155.80625,136.9772065500002,140.64902300000003,140.63999980000003,138.43749949999997,140.0764198159228,140.10927625978277,140.0925476923076,146.34002944356698,133.8450659410482,136.9772065500002,140.64902300000003,140.63999980000003,138.43749949999997,146.79166666666666,10272898,11861934.65,63.37925120354432,1.5,2.75,3.438292907937009,0.8660389981157078,1.0484129405725109,0.8773651196633239,-0.1710478209091869,38.905560871881136,5.096110862762629,-23849144.0,2000-03-17,2000,4,77,3,1.76,146.72,147.34375,144.78125,52
2000-03-20 14:30:00,146.875,147.34375,144.78125,146.78125,130.91776315789474,155.9515625,137.04501905000018,140.83871050000005,140.82062480000005,139.01093699999996,140.33935433294545,140.7447023302797,140.73437461538452,147.8270610775119,133.64168815325715,137.04501905000018,140.83871050000005,140.82062480000005,139.01093699999996,146.30208333333334,12502102,12004494.85,63.000571794771176,1.5,2.75,3.3757362716557937,1.0414517358887452,1.1644069582961658,1.2844608769610204,0.1200539186648546,38.14827968770645,7.102956820538832,-36351246.0,2000-03-20,2000,0,80,3,1.77,146.06,149.75,144.5,53
2000-03-21 14:30:00,145.53125,149.75,144.5,149.1875,130.79769736842104,156.096875,137.12314405000018,141.0293355,140.8893748,139.72187449999996,140.68634043753582,141.54877829882446,141.5540861538461,149.8070422429471,133.30113006474505,137.12314405000018,141.0293355,140.8893748,139.72187449999996,147.8125,13612801,11864365.0,66.33630825617169,1.5,2.75,3.5096122522518085,1.1473686960911942,1.3285363694836947,1.7807243805194732,0.4521880110357783,35.06401380316619,8.995433789954339,-22738445.0,2000-03-21,2000,1,81,3,3.63,147.12,150.84375,148.6875,54
2000-03-22 14:30:00,149.5625,150.84375,148.6875,150.09375,130.67763157894734,156.2421875,137.21236280000016,141.184648,140.9662498,140.39843699999997,141.05525845959326,142.36258512750788,142.2439899999999,151.6561889948529,132.83179100514693,137.21236280000016,141.184648,140.9662498,140.39843699999997,149.875,8259801,11671405.05,67.52386142154356,1.5,2.75,3.4129435199481084,0.7076955143459783,1.415477678963596,2.221535109740273,0.8060574307766772,34.56942134759765,6.5439219165927245,-14478644.0,2000-03-22,2000,2,82,3,1.45,149.77,153.46875,149.15625,55
2000-03-23 14:30:00,149.15625,153.46875,149.15625,152.5,130.5575657894737,156.3875,137.31423780000014,141.339648,141.1299998,141.33281199999996,141.50407185333466,143.32805321060238,143.21995153846143,153.95890905435587,132.48099402256702,137.31423780000014,141.339648,141.1299998,141.33281199999996,151.70833333333334,11653898,11385349.55,70.49961157806572,1.5,2.75,3.4771975542375286,1.0235871941235215,1.5419817103429851,2.7335345687054087,1.1915528583624235,32.6384761203402,8.782880071333036,-2824746.0,2000-03-23,2000,3,83,3,2.89,151.31,155.75,151.71875,56
2000-03-24 14:30:00,152.875,155.75,151.71875,153.5625,130.4375,155.75,137.42751905000014,141.51964800000005,141.33999980000004,142.34453099999996,141.976951388498,144.30276242864022,144.4903846153845,155.89465234660247,133.0861168841665,137.42751905000014,141.51964800000005,141.33999980000004,142.34453099999996,153.67708333333334,11462898,11430499.55,71.73132699307341,1.5,2.75,3.516772728934848,1.0028343861839353,1.5973818650050853,3.18828018961878,1.5908983246136947,31.63086168699075,10.800450958286357,8638152.0,2000-03-24,2000,4,84,3,2.66,153.73,153.78125,151.8125,57
2000-03-27 14:30:00,153.375,153.78125,151.8125,151.9375,130.3174342105263,155.8815789473684,137.53814405000014,141.69308550000005,141.4787498,143.13515599999997,142.36756113796866,145.02988029257926,145.64903846153837,156.78041503313938,134.51766188993736,137.53814405000014,141.69308550000005,141.4787498,143.13515599999997,152.51041666666666,8798602,11200539.6,67.11584744736481,1.5,2.75,3.4061996768680727,0.7855516175309982,1.4301605917025273,3.3785990642418535,1.948438472539327,31.445011633251053,11.20768526989936,-160450.0,2000-03-27,2000,0,87,3,1.3,152.8,152.98436999999998,150.59375,58
2000-03-28 14:30:00,151.25,152.98436999999998,150.59375,151.0625,130.19736842105266,156.01315789473685,137.64376905000015,141.8487105,141.56062480000003,143.81640599999997,142.70853913255812,145.60441550280981,146.43269230769218,157.54374250065806,135.32164211472636,137.64376905000015,141.8487105,141.56062480000003,143.81640599999997,151.54687333333334,6334301,11105129.65,64.70170409117978,1.5,2.75,3.333658271377497,0.5703941511389738,1.1767741582950717,3.419406170408166,2.2426320121130945,29.43376174456518,8.046490835940991,-6494751.0,2000-03-28,2000,1,88,3,1.59,151.79,152.48436999999998,149.65625,59
2000-03-29 14:30:00,151.5625,152.48436999999998,149.65625,151.21875,130.07730263157896,156.14473684210526,137.74580030000018,141.9955855,141.6687498,144.45546849999997,143.04227289206563,146.13911402635168,147.28124999999991,158.03404480665046,136.52845519334932,137.74580030000018,141.9955855,141.6687498,144.45546849999997,151.11979,6747500,11099204.65,64.94419451040713,1.5,2.75,3.2975483948505335,0.6079264427293896,0.945793866839128,3.4248743456620048,2.4790804788228766,28.573237399702894,3.3311979500320317,252749.0,2000-03-29,2000,2,89,3,1.89,151.07,151.92186999999998,147.125,60
2000-03-30 14:30:00,150.15625,151.92186999999998,147.125,148.6875,129.95723684210526,156.2763157894737,137.82267530000018,142.1037105,141.7174998,144.96328099999997,143.26365434727876,146.38181745241346,148.05769230769218,157.57595177640204,138.53943283898238,137.82267530000018,142.1037105,141.7174998,144.96328099999997,149.24479,9491898,11193789.6,57.99361917204124,1.5,2.75,3.4046427952183533,0.8479610872800397,0.5673000525873501,3.1882055445570643,2.6209054919697143,19.361947205120337,1.1909825606125053,-9239149.0,2000-03-30,2000,3,90,3,3.26,149.52,152.3125,148.4375,61
2000-03-31 14:30:00,149.625,152.3125,148.4375,150.375,129.8371710526316,156.4078947368421,137.90173780000018,142.2274605,141.82999980000002,145.42578099999997,143.54253064738546,146.7621205521836,149.1153846153845,156.01156634771186,142.21920288305716,137.90173780000018,142.2274605,141.82999980000002,145.42578099999997,150.375,9249102,11017729.65,60.9909790856915,1.5,2.75,3.438239738417043,0.8394744011530543,0.3841266688913327,3.1010638280838805,2.716937159192548,20.126670741432616,2.4483713008303174,9953.0,2000-03-31,2000,4,91,3,2.61,150.38,151.25,148.6875,62
2000-04-03 13:30:00,150.125,151.25,148.6875,151.25,129.7171052631579,156.53947368421052,137.98642530000018,142.3729293,141.9662498,145.99765599999995,143.844784347488,147.18953764245182,149.99519230769218,154.38088296532533,145.60950165005912,137.98642530000018,142.3729293,141.9662498,145.99765599999995,150.39583333333334,8508199,10844794.7,62.485730848749114,1.5,2.75,3.3756868999586827,0.7845421914718219,0.2802512443040137,3.0672512145725648,2.7869999702685506,20.090930008570336,1.3824884792626728,8518152.0,2000-04-03,2000,0,94,4,1.72,149.97,153.0,141.39061999999998,63
2000-04-04 13:30:00,151.75,153.0,141.39061999999998,145.75,129.59703947368422,156.67105263157896,138.04205030000014,142.4532418,142.07437480000004,146.43281249999995,143.9194986868022,147.05243881936119,149.9495192307691,154.49579164072404,145.4032468208142,138.04205030000014,142.4532418,142.07437480000004,146.43281249999995,146.71354,21056400,10894524.3,49.61610285992382,1.5,2.75,3.963807835675919,1.9327507489243931,-0.17595279048019652,2.567058982168305,2.7430117726485017,28.651937356196623,-2.894024567978347,-12538248.0,2000-04-04,2000,1,95,4,8.21,147.2,150.8125,147.625,64
2000-04-05 13:30:00,147.875,150.8125,147.625,149.1875,129.47697368421052,156.80263157894737,138.11955030000018,142.5601168,142.21937480000003,147.04843749999995,144.12608697359428,147.25577797942205,150.12259615384605,154.35768463961946,145.88750766807263,138.11955030000018,142.5601168,142.21937480000003,147.04843749999995,149.20833333333334,8227898,10715499.3,55.75033028905504,1.5,2.75,4.042285847413353,0.7678501738131791,-0.2583032006800869,2.420132771798393,2.67843597247848,32.00601769674763,-2.172131147540984,-4310350.0,2000-04-05,2000,2,96,4,2.16,149.22,151.6875,149.0,65
2000-04-06 13:30:00,150.25,151.6875,149.0,150.48436999999998,129.35690789473685,156.93421052631578,138.20681590000015,142.6674605,142.41281220000005,147.52890599999995,144.37543140600238,147.56326293376281,150.40745153846143,154.17791772435328,146.6369853525696,138.20681590000015,142.6674605,142.41281220000005,147.52890599999995,150.39062333333334,6378500,10759379.4,57.83601284947576,1.5,2.75,3.945515429740971,0.5928315902681153,-0.2380337376128505,2.3808938004624167,2.6189275380752672,30.891393006381897,-2.004480260480252,2068150.0,2000-04-06,2000,3,97,4,1.8,150.34,152.125,150.5,66
2000-04-07 13:30:00,151.5625,152.125,150.5,151.4375,129.23684210526315,157.06578947368422,138.30384715000017,142.78105430000005,142.6365622,148.09140599999995,144.65237527243363,147.93223789245204,150.58052846153836,154.31752209450187,146.84353482857486,138.30384715000017,142.78105430000005,142.6365622,148.09140599999995,151.35416666666666,6023602,10664334.5,59.35241133534869,1.5,2.75,3.780880756188044,0.5648361836362128,-0.17590084153014107,2.3990514861625907,2.5749523276927317,30.831924462542553,-0.3290826820238585,8091752.0,2000-04-07,2000,4,98,4,1.08,151.31,153.10936999999998,150.3125,67
2000-04-10 13:30:00,151.75,153.10936999999998,150.3125,150.84375,129.11677631578948,157.19736842105263,138.39955030000021,142.8769918,142.93593719999998,148.70390599999996,144.8951742813578,148.20952475983756,150.63822076923068,154.3665203473457,146.90992119111567,138.39955030000021,142.8769918,142.93593719999998,148.70390599999996,151.42187333333334,9624199,10618524.55,57.95413733589169,1.5,2.75,3.7105942736031836,0.9063593491432856,-0.18910321995254356,2.338573302752053,2.5276765227045965,30.33337576713157,-0.1448076127430699,-1532447.0,2000-04-10,2000,0,101,4,1.86,151.71,151.625,148.375,68
2000-04-11 13:30:00,150.0,151.625,148.375,150.40625,128.99671052631578,157.32894736842104,138.4850190500002,142.9654293,143.1515622,149.39296849999997,145.1112948977751,148.4187366874721,150.47716307692298,154.04738529189356,146.9069408619524,138.4850190500002,142.9654293,143.1515622,149.39296849999997,150.13541666666666,9006398,10655659.5,56.89059806280804,1.5,2.75,3.6776946826315284,0.8452220155871161,-0.23842968399375275,2.2296394177124057,2.4680691017061585,30.203159765767204,-0.5373010952676173,-10538845.0,2000-04-11,2000,1,102,4,2.19,150.0,151.15625,146.15625,69
2000-04-12 13:30:00,150.375,151.15625,146.15625,146.28125,128.8766447368421,157.46052631578948,138.5436128000002,143.0019918,143.2584372,149.71640599999995,145.15717549001926,148.21516652676047,149.91706692307682,153.6560204648259,146.17811338132773,138.5436128000002,143.0019918,143.2584372,149.71640599999995,147.86458333333334,10779699,10679604.4,47.95482769355786,1.5,2.75,3.772145062443562,1.0093725007267125,-0.5425964561562484,1.7898235315108482,2.3324199876670964,33.979045569045745,-1.6183270281630937,-21318544.0,2000-04-12,2000,2,103,4,3.42,148.66,148.15625,141.125,70
2000-04-13 13:30:00,147.46875,148.15625,141.125,144.25,128.7565789473684,157.5921052631579,138.57986280000014,143.0195309,143.3221872,149.61171849999997,145.12159998060673,147.83753161944998,149.32572076923068,153.93079450265842,144.72064703580298,138.57986280000014,143.0195309,143.3221872,149.61171849999997,144.51041666666666,12226801,10010874.85,44.26758723033181,1.5,2.75,4.004938272269022,1.2213518981310612,-0.8556923508656853,1.26280454908499,2.1184968999506752,33.59538567829572,-4.073150457190358,-33545345.0,2000-04-13,2000,3,104,4,4.98,144.64,142.8125,133.5,71
2000-04-14 13:30:00,142.625,142.8125,133.5,138.375,133.5,157.7236842105263,138.58158155000018,142.97859340000005,143.2259372,149.18359349999997,144.85702743234762,146.93633813188328,148.3497592307691,155.65499780515987,141.0445206563784,138.58158155000018,142.97859340000005,143.2259372,149.18359349999997,138.22916666666666,29603808,10977420.35,35.71418260777523,1.5,2.75,4.4867283956783774,2.696790963279456,-1.4013206917773382,0.3668460352290026,1.7681667270063408,38.65599900757129,-8.512396694214878,-63149153.0,2000-04-14,2000,4,105,4,6.98,138.16,140.75,134.6875,72
2000-04-17 13:30:00,135.1875,140.75,134.6875,140.75,133.52297794117646,157.85526315789474,138.58830030000018,142.9739059,143.1890622,148.88203099999996,144.69596753303992,146.3471630717039,147.54447076923068,155.66919141850803,139.4197501199533,138.58830030000018,142.9739059,143.1890622,148.88203099999996,138.72916666666666,23918192,11548224.85,40.702244638713935,1.5,2.75,4.5992835102727785,2.0711574558578154,-1.5344035060174366,-0.14983765551545505,1.3845658505019816,40.635049436241815,-3.4305317324185247,-39230961.0,2000-04-17,2000,0,108,4,4.5,137.72,144.46875,139.78125,73
2000-04-18 13:30:00,140.5625,144.46875,139.78125,144.46875,133.54595588235293,157.98684210526315,138.61376905000014,142.99796840000005,143.2309372,148.64609349999995,144.68705704154812,146.16826658868447,147.21995153846143,155.4721401566243,138.96776292029855,138.61376905000014,142.99796840000005,143.2309372,148.64609349999995,142.90625,10955699,11415369.75,47.56300881856463,1.5,2.75,4.605584688110438,0.9597322942605516,-1.3126821537203082,-0.25628684164840365,1.0563953120719043,39.80866987105743,-3.162966066191873,-28275262.0,2000-04-18,2000,1,109,4,3.35,142.12,145.125,142.53125,74
2000-04-19 13:30:00,144.5,145.125,142.53125,143.125,133.56893382352942,158.1184210526316,138.63158155000016,143.0154684,143.20718720000005,148.29765599999996,144.62579990266389,145.87843167547643,146.6622592307691,154.96594762890913,138.35857083262914,138.63158155000016,143.0154684,143.20718720000005,148.29765599999996,143.59375,6553699,11330064.65,45.513812208852755,1.5,2.75,4.461882210388263,0.5784343869564769,-1.2002844781214592,-0.4439602855799194,0.7563241925415397,36.85496202253945,-4.890454736262651,-34828961.0,2000-04-19,2000,2,110,4,1.82,143.83,143.9375,142.375,75
2000-04-20 13:30:00,143.5625,143.9375,142.375,143.8125,133.59191176470586,158.25,138.65228470000022,143.0442184,143.25781220000005,147.86328099999997,144.59390578883395,145.68167627781202,146.09014384615375,154.0691583877387,138.11112930456883,138.65228470000022,143.0442184,143.25781220000005,147.86328099999997,143.375,8537602,11174249.85,46.77724052210613,1.5,2.75,4.254783481074817,0.7640425187020496,-1.0299355162609334,-0.531095202784627,0.4988403134763064,36.42912749385134,-5.035080478745356,-26291359.0,2000-04-20,2000,3,111,4,1.1,143.16,143.3125,140.5,76
2000-04-24 13:30:00,141.5,143.3125,140.5,142.25,133.61488970588235,158.3815789473684,138.66103470000022,143.07281220000004,143.2715622,147.29765599999996,144.50198791476203,145.35484996563943,145.82091307692298,154.05963752373287,137.58218863011308,138.66103470000022,143.07281220000004,143.2715622,147.29765599999996,142.02083333333334,12893102,11245760.05,44.265024954367846,1.5,2.75,4.187477518140901,1.1464856037009254,-0.9734360971572404,-0.7179548079702442,0.2554812891869962,35.89119925861001,-5.697120364615703,-39184461.0,2000-04-24,2000,0,115,4,2.0,141.91,148.15625,144.4375,77
2000-04-25 13:30:00,144.625,148.15625,144.4375,148.15625,133.63786764705878,158.51315789473685,138.70244095000018,143.1503122,143.46093720000005,147.10859349999996,144.64529231026157,145.62164996891187,145.7415861538461,153.86821800044854,137.6149543072436,138.70244095000018,143.1503122,143.46093720000005,147.10859349999996,146.91666666666666,14102000,11510929.95,54.26402800042731,1.5,2.75,4.310246981130836,1.2250965005655343,-0.5124003243221924,-0.3850191162157444,0.12738120810644807,44.91982046877994,-1.495948472885934,-25082461.0,2000-04-25,2000,1,116,4,2.57,146.3,148.75,146.0,78
2000-04-26 13:30:00,147.96875,148.75,146.0,146.48436999999998,133.6608455882353,158.64473684210526,138.73798780000018,143.20265590000002,143.6006246,146.87968699999996,144.71741300397682,145.70381378139646,145.43389384615375,153.10930777742502,137.75847991488249,138.73798780000018,143.20265590000002,143.6006246,146.87968699999996,147.07812333333334,7711102,11579770.0,51.450222299209976,1.5,2.75,4.1988007681929185,0.6659114991057681,-0.30442794789683403,-0.2531537267645945,0.05127422113223956,45.25523755087934,0.13885580004273454,-32793563.0,2000-04-26,2000,2,117,4,1.88,147.38,147.34375,143.0,79
2000-04-27 13:30:00,143.0,147.34375,143.0,146.0,133.68382352941177,158.7763157894737,138.76720655000014,143.2242184,143.6987496,146.61874949999995,144.7677105332326,145.73202199269204,145.01562461538455,151.88734553269984,138.1439036980692,138.76720655000014,143.2242184,143.6987496,146.61874949999995,145.44791666666666,15595301,12022160.05,50.63108606341811,1.5,2.75,4.209154284750568,1.2972128914553922,-0.18949509448586396,-0.18559464697509045,0.003900447510773564,42.368851906832575,1.2131715771230502,-48388864.0,2000-04-27,2000,3,118,4,3.04,145.17,147.85936999999998,145.0625,80
2000-04-28 13:30:00,147.0,147.85936999999998,145.0625,145.09375,133.70680147058823,158.9078947368421,138.78744095000022,143.2473434,143.8168746,146.43906199999995,144.7804963946745,145.6712341838642,144.57331692307682,150.57235712923057,138.5742767169231,138.78744095000022,143.2473434,143.8168746,146.43906199999995,146.00520666666668,8743398,11984735.05,49.05736216162739,1.5,2.75,4.108276835839814,0.7295445384084648,-0.16539408007865894,-0.20284215258755006,-0.03744807250889118,41.67487843699357,4.855465221318879,-57132262.0,2000-04-28,2000,4,119,4,1.93,146.46,148.48436999999998,145.84375,81
2000-05-01 13:30:00,146.5625,148.48436999999998,145.84375,147.0625,133.7297794117647,159.03947368421052,138.81369095000022,143.3017184,143.9924996,146.27343699999997,144.86998673213822,145.80373569016285,144.3161053846153,149.52779178118863,139.10441898804194,138.81369095000022,143.3017184,143.9924996,146.27343699999997,147.13020666666668,7328301,11888695.0,52.51066466708468,1.5,2.75,4.0570156332798275,0.6164092021874562,-0.01563536761410915,-0.056992282026527626,-0.04135691441241847,32.217175195895926,4.484902309058613,-49803961.0,2000-05-01,2000,0,122,5,1.81,147.16,147.125,144.125,82
2000-05-02 13:30:00,145.5,147.125,144.125,144.125,133.75275735294122,159.17105263157896,138.82994095000018,143.3357809,144.1687496,145.91718699999996,144.840771566172,145.64385610062354,144.1502399999999,149.23695042969962,139.06352957030018,138.82994095000018,143.3357809,144.1687496,145.91718699999996,145.125,9411898,11933879.95,47.3527903251177,1.5,2.75,3.981514516616984,0.7886704105817656,-0.10803722051319914,-0.1764034400539174,-0.06836621954071825,34.57838237728622,-0.23794073112697384,-59215859.0,2000-05-02,2000,1,123,5,2.08,145.62,144.0,139.78125,83
2000-05-03 13:30:00,144.0,144.0,139.78125,141.625,133.77573529411765,159.30263157894737,138.84814410000018,143.33796840000005,144.30187460000005,145.71093699999997,144.71466287730254,145.26110790056416,143.94831692307682,149.2085995027607,138.6880343433929,138.84814410000018,143.33796840000005,144.30187460000005,145.71093699999997,141.80208333333334,12180699,11490094.9,43.44187328841298,1.5,2.75,4.007388479715772,1.0601042990515248,-0.31921029993719896,-0.4673790944622169,-0.148168794525018,32.638473691715866,-1.0480349344978166,-71396558.0,2000-05-03,2000,2,124,5,3.02,141.89,142.35936999999998,140.75,84
2000-05-04 13:30:00,142.0,142.35936999999998,140.75,141.8125,133.79871323529414,159.43421052631578,138.8680660000002,143.3373434,144.4068746,145.34218699999997,144.6008525683887,144.93266905289136,144.2127399999999,148.5987407974977,139.82673920250215,138.8680660000002,143.3373434,144.4068746,145.34218699999997,141.64062333333334,5963602,11376880.1,43.8166620094616,1.5,2.75,3.83610144545036,0.524186063980757,-0.42151932504248346,-0.6750679508281223,-0.2535486257856389,32.332074557374895,-1.3906996957844415,-65432956.0,2000-05-04,2000,3,125,5,1.14,141.55,144.0,140.9375,85
2000-05-05 13:30:00,141.0625,144.0,140.9375,143.53125,133.82169117647058,159.56578947368422,138.9056441500002,143.3514059,144.60124960000005,144.99453099999997,144.55890736962834,144.79920057166362,144.42668230769218,148.36462761359994,140.48873700178447,138.9056441500002,143.3514059,144.60124960000005,144.99453099999997,142.82291666666666,7862398,11451075.0,47.2663174512249,1.5,2.75,3.7808441993467614,0.6866078512279414,-0.3515497362671808,-0.6929857961196149,-0.3414360598524341,33.05922159510092,0.9007029876977153,-57570558.0,2000-05-05,2000,4,126,5,2.17,142.47,143.375,141.84375,86
2000-05-08 13:30:00,142.75,143.375,141.84375,142.45311999999998,133.84466911764707,159.69736842105263,138.93915975000021,143.36843710000005,144.78374960000005,144.54531199999997,144.47632747278018,144.57576432674333,144.27163384615375,148.34706685443084,140.19620083787666,138.93915975000021,143.36843710000005,144.78374960000005,144.54531199999997,142.55729,5064102,11403100.0,45.383911830963974,1.5,2.75,3.631319613679136,0.4440987099999123,-0.35495626598395225,-0.7851313923323744,-0.4301751263484221,32.71342761839135,-3.84940223581522,-62634660.0,2000-05-08,2000,0,129,5,1.08,142.61,143.40625,140.26561999999998,87
2000-05-09 13:30:00,143.0625,143.40625,140.26561999999998,141.3125,133.86764705882354,159.82894736842104,138.97197225000022,143.36671840000002,144.8874996,144.06874949999997,144.35225580718097,144.26497724800583,144.13221076923068,148.47054617426662,139.79387536419472,138.97197225000022,143.36671840000002,144.8874996,144.06874949999997,141.66145666666668,5619801,11202880.1,43.414004375184405,1.5,2.75,3.5962703555591973,0.5016389490770324,-0.4073538980046759,-0.9393674988542672,-0.5320136008495912,20.202150638084948,-3.5306633738466515,-68254461.0,2000-05-09,2000,1,130,5,2.24,141.84,140.96875,137.75,88
2000-05-10 13:30:00,140.5,140.96875,137.75,138.125,133.890625,159.96052631578948,138.9832222500002,143.3267184,144.9012496,143.45468699999995,144.10804969709542,143.6802175101005,143.69471076923068,149.0917138060034,138.29770773245795,138.9832222500002,143.3267184,144.9012496,143.45468699999995,138.94791666666666,10293898,11267255.1,38.398117585668494,1.5,2.75,3.5938581873049693,0.9136118698510696,-0.6174100911629611,-1.3037762148032923,-0.6863661236403314,22.510422063613568,-5.3938356164383565,-78548359.0,2000-05-10,2000,2,131,5,2.34,139.36,141.5,139.125,89
2000-05-11 13:30:00,140.125,141.5,139.125,141.28125,133.91360294117646,160.0921052631579,139.0080660000002,143.3126559,144.95812460000005,143.20468699999995,143.99719480701327,143.45174441390046,143.62019153846148,149.12068799030772,138.1196950866152,139.0080660000002,143.3126559,144.95812460000005,143.20468699999995,140.63541666666666,7091102,11082825.25,45.15520009168312,1.5,2.75,3.5782254596403287,0.6398280077546111,-0.5090216160113029,-1.32264314365446,-0.8136215276431572,27.850695077913226,-2.6276114581089813,-71457257.0,2000-05-11,2000,3,132,5,1.71,140.31,143.46875,141.625,90
2000-05-12 13:30:00,141.8125,143.46875,141.625,142.8125,133.93658088235293,160.2236842105263,139.05009725000022,143.3242184,145.0437496,143.13281199999997,143.95073618713042,143.390863993529,143.20913384615375,148.05158073767862,138.36668695462885,139.05009725000022,143.3242184,145.0437496,143.13281199999997,142.63541666666666,5960801,10769525.25,48.12794783390761,1.5,2.75,3.4788879268088766,0.5534878150733711,-0.3092636355086653,-1.2002010720289888,-0.8909374365203235,28.88177996584935,-2.889927751806205,-65496456.0,2000-05-12,2000,4,133,5,1.3,142.55,145.60936999999998,142.0,91
2000-05-15 13:30:00,142.75,145.60936999999998,142.0,145.28125,133.95955882352942,160.35526315789474,139.11275350000022,143.3389059,145.1268746,143.47812449999995,144.0029131993998,143.57090075605004,143.1165861538461,147.74643400574362,138.48673830194852,139.11275350000022,143.3389059,145.1268746,143.47812449999995,144.29687333333334,4441301,9511399.9,52.58975217492308,1.5,2.75,3.488208074893958,0.4669450392891166,-0.002174728383870339,-0.8936558470001614,-0.8914811186162911,29.64488800313333,0.8022549869904597,-61055155.0,2000-05-15,2000,0,136,5,2.54,143.8,147.71875,145.3125,92
2000-05-16 13:30:00,146.5625,147.71875,145.3125,146.5625,133.98253676470586,160.48684210526315,139.18025350000022,143.36265590000005,145.2618746,143.76874949999996,144.1032891523645,143.85581496975956,143.1598553846153,147.905744425517,138.41396634371358,139.18025350000022,143.36265590000005,145.2618746,143.76874949999996,146.53125,8192000,8725090.3,54.76444758973387,1.5,2.75,3.4131574981158184,0.9389014575585538,0.280310497112686,-0.5410929972254337,-0.8214034943381197,27.45036539995048,3.4863195057369816,-52863155.0,2000-05-16,2000,1,137,5,1.66,146.52,146.1875,144.46875,93
2000-05-17 13:30:00,145.6875,146.1875,144.46875,145.15625,134.00551470588235,160.6184210526316,139.24384725000021,143.3493747,145.4240622,143.80312449999997,144.14458173462472,143.97966592502056,143.16466307692298,147.91849866706585,138.41082748678008,139.24384725000021,143.3493747,145.4240622,143.80312449999997,145.27083333333334,5906898,8472650.25,51.94795871283645,1.5,2.75,3.3189141053932603,0.6971724107223711,0.3604174134780853,-0.37088172749051296,-0.7312991409685983,25.764682530959398,2.3578669017188187,-58770053.0,2000-05-17,2000,2,138,5,1.19,145.33,146.3125,143.8125,94
2000-05-18 13:30:00,145.625,146.3125,143.8125,143.8125,134.02849264705878,160.75,139.3097847500002,143.3246872,145.5628122,143.83749949999995,144.13155892150218,143.96374536073287,142.91466307692298,147.13405627642302,138.69526987742293,139.3097847500002,143.3246872,145.5628122,143.83749949999995,144.64583333333334,4325301,8361230.35,49.33687045292985,1.5,2.75,3.260420240722313,0.5173043701636566,0.3126453292714897,-0.3404924793792361,-0.6531378086507258,26.640784230439607,0.1959503592423253,-63095354.0,2000-05-18,2000,3,139,5,1.74,145.06,143.23436999999998,140.40625,95
2000-05-19 13:30:00,142.5625,143.23436999999998,140.40625,141.125,134.0514705882353,160.8815789473684,139.3563472500002,143.2740622,145.56781220000005,143.70312449999997,144.01365465007072,143.6933886597107,142.68389384615375,146.94124323562338,138.42654445668416,139.3563472500002,143.2740622,145.56781220000005,143.70312449999997,141.58854,6518398,8260270.15,44.51741788179356,1.5,2.75,3.270836652099291,0.7891264912201449,0.10075788882601257,-0.5271904476182101,-0.6279483364442227,27.988827764963798,-0.9323207522587168,-69613752.0,2000-05-19,2000,4,140,5,2.01,141.82,141.46875,137.0,96
2000-05-22 13:30:00,141.25,141.46875,137.0,140.0625,134.07444852941177,161.01315789473685,139.4047847500002,143.2065622,145.5653122,143.59374949999997,143.85870740889146,143.34758973973825,142.56370153846143,147.01753226532645,138.1098708115964,139.4047847500002,143.2065622,145.5653122,143.59374949999997,139.51041666666666,10839398,8157584.95,42.73985761883454,1.5,2.75,3.356401891235056,1.3287508578136231,-0.09941233161781393,-0.7522137509664901,-0.6528014193486762,27.990160766376864,-0.8845643520566121,-80453150.0,2000-05-22,2000,0,143,5,3.26,139.23,140.8125,137.5625,97
2000-05-23 13:30:00,140.4375,140.8125,137.5625,138.0,134.09742647058823,161.14473684210526,139.4443160000002,143.120156,145.55343720000005,143.08593699999997,143.6289541771702,142.8382954788108,142.27043230769218,147.34264789110563,137.19821672427878,139.4443160000002,143.120156,145.55343720000005,143.08593699999997,138.79166666666666,7979199,7851444.9,39.44710429320039,1.5,2.75,3.348801756146837,1.0162714126669856,-0.3453362548484511,-1.08447173790924,-0.7391354830607891,28.81157202508353,-0.09049773755656107,-88432349.0,2000-05-23,2000,1,144,5,2.36,139.19,140.6875,136.5,98
2000-05-24 13:30:00,138.0,140.6875,136.5,140.25,136.5,161.2763157894737,139.5022847500002,143.053906,145.6259372,142.77421849999996,143.49644617022238,142.59179114749546,142.01802846153836,147.14047501767504,136.8955819054017,139.5022847500002,143.053906,145.6259372,142.77421849999996,139.14583333333334,11084500,8020114.8,44.47289502872922,1.5,2.75,3.4087087735649217,1.382087448424055,-0.3310452077707764,-1.1529419927742597,-0.8218967850034831,27.34262295739525,-0.7299270072992701,-77347849.0,2000-05-24,2000,2,145,5,3.07,138.59,141.8125,137.71875,99
2000-05-25 13:30:00,140.6875,141.8125,137.71875,137.84375,136.61111111111111,161.4078947368421,139.5404097500002,142.9779685,145.5865622,142.36640599999996,143.27477181060578,142.1395967524959,141.66346153846143,147.23479494414238,136.09212813278052,139.5404097500002,142.9779685,145.5865622,142.36640599999996,139.125,8278898,7654294.65,40.59264469819573,1.5,2.75,3.4576402897388547,1.0816016861854147,-0.4508020969671337,-1.3853994062124002,-0.9345973092452664,25.631516249565806,-3.479212253829321,-85626747.0,2000-05-25,2000,3,146,5,2.97,139.77,139.6875,137.32811999999998,100
2000-05-26 13:30:00,138.8125,139.6875,137.32811999999998,138.0,136.72222222222223,161.53947368421052,139.57970665000022,142.96046850000005,145.4196872,142.01171849999997,143.06791801411146,141.7453494427344,141.40865384615375,147.31387793993045,135.50342975237706,139.57970665000022,142.96046850000005,145.4196872,142.01171849999997,138.33854,4814000,7457824.75,40.95291360230717,1.5,2.75,3.379193126186079,0.6454965303388229,-0.4837395489597691,-1.5392717454449778,-1.0555321964852091,24.37792938966887,-5.0118305011830495,-80812747.0,2000-05-26,2000,4,147,5,1.72,138.51,142.9375,139.46875,101
2000-05-30 13:30:00,140.0,142.9375,139.46875,142.71875,136.83333333333334,161.67105263157896,139.6275191500002,142.98765600000004,145.3353122,141.79453099999995,143.05422515081298,141.8380542577121,141.7620192307691,147.38186400847582,136.1421744530624,139.6275191500002,142.98765600000004,145.3353122,141.79453099999995,141.70833333333334,5362602,7359539.8,50.68034573447425,1.5,2.75,3.4905007600299305,0.7286599632221569,-0.16826299257450694,-1.2658609372033425,-1.0975979446288355,30.512505672560142,-2.6226012793176974,-75450145.0,2000-05-30,2000,1,151,5,2.49,141.2,144.0,142.09375,102
2000-05-31 13:30:00,142.5625,144.0,142.09375,142.8125,136.94444444444446,161.80263157894737,139.6728316500002,143.038281,145.2559372,141.72890599999997,143.04474573313402,141.93085861412047,141.8798076923076,147.5185647026235,136.24105068199168,139.6728316500002,143.038281,145.2559372,141.72890599999997,142.96875,6056500,7191769.9,50.853574759679304,1.5,2.75,3.377339991456364,0.8421431836966864,0.054281722214504224,-1.0297457918607051,-1.0840275140752094,29.834008285160166,-1.6146393972012918,-69393645.0,2000-05-31,2000,2,152,5,1.34,143.05,145.4375,143.0,103
2000-06-01 13:30:00,143.6875,145.4375,143.0,145.3125,137.05555555555554,161.93421052631578,139.7262691500002,143.033906,145.17843720000005,141.91328099999996,143.13367727301113,142.2529196984899,142.0721153846153,147.98867179802014,136.1555589712104,139.7262691500002,143.033906,145.17843720000005,141.91328099999996,144.58333333333334,8961602,7030815.05,55.3566653187951,1.5,2.75,3.3236014206380515,1.2746177984016234,0.3603499319292436,-0.6335900991636549,-0.9939400310928984,31.472897307803564,1.0430247718383312,-60432043.0,2000-06-01,2000,3,153,6,1.7,144.22,149.09375,147.48436999999998,104
2000-06-02 13:30:00,148.9375,149.09375,147.48436999999998,147.84375,137.16666666666666,162.06578947368422,139.79720665000022,143.0498435,145.1334372,142.21484349999997,143.31838600740286,142.78537972720517,142.26923076923066,148.7446622620228,135.79379927643853,139.79720665000022,143.0498435,145.1334372,142.21484349999997,148.14062333333334,8962199,7180744.9,59.41174033018326,1.5,2.75,3.3562906048781915,1.2480876461716388,0.7038974404456164,-0.114068230535878,-0.8179656709814944,32.24860200974705,4.760850310008856,-51469844.0,2000-06-02,2000,4,154,6,1.09,148.29,148.21875,146.875,105
2000-06-05 13:30:00,147.46875,148.21875,146.875,147.125,137.27777777777777,162.19736842105263,139.87001915000022,143.0779685,145.02593720000004,142.39453099999997,143.46766498750472,143.19867689604274,142.31249999999991,148.9084996618056,135.71650033819418,139.87001915000022,143.0779685,145.02593720000004,142.39453099999997,147.40625,6998102,7137530.1,57.80611738430423,1.5,2.75,3.2125377045297485,0.9804654974414748,0.8439151872163855,0.23692831303898745,-0.6069868741773979,29.72155226514617,5.0423917893797405,-58467946.0,2000-06-05,2000,0,157,6,0.91,147.55,147.78125,145.90625,106
2000-06-06 13:30:00,146.625,147.78125,145.90625,146.46875,137.38888888888889,162.32894736842104,139.9328316500002,143.112031,144.88406220000005,142.59531249999995,143.58535459583788,143.51011242975295,142.41346153846143,149.21738406054203,135.60953901638084,139.9328316500002,143.112031,144.88406220000005,142.59531249999995,146.71875,4858898,7127269.9,56.309774166762,1.5,2.75,3.1169992970633382,0.6817334081876147,0.8510896112681081,0.4568751399077371,-0.394214471360371,29.327277626215626,6.136775362318841,-63326844.0,2000-06-06,2000,1,158,6,1.29,146.84,148.0,146.0,107
2000-06-07 13:30:00,146.625,148.0,146.0,147.48436999999998,137.5,162.46052631578948,139.9879097500002,143.13687470000005,144.7949996,142.90390599999995,143.73825716070698,143.8886131507289,142.69591307692298,149.9955043017043,135.39632185214165,139.9879097500002,143.13687470000005,144.7949996,142.90390599999995,147.16145666666668,4919500,7092254.85,58.116718332022856,1.5,2.75,3.0372136329873847,0.6936439967325766,0.8793793513034303,0.7050097177689167,-0.17436963353451346,26.62585310950034,5.158196078431382,-58407344.0,2000-06-07,2000,2,159,6,1.37,147.0,147.75,146.0625,108
2000-06-08 13:30:00,147.5,147.75,146.0625,146.90625,137.61111111111111,162.5921052631579,140.0375972500002,143.1362497,144.71187460000004,143.34296849999996,143.86249217401257,144.17600713637376,143.14062461538455,150.70290519707666,135.5783440336924,140.0375972500002,143.1362497,144.71187460000004,143.34296849999996,146.90625,5723102,6863715.05,56.6797093238717,1.5,2.75,2.9408055163454287,0.8338198713537794,0.8157077204518737,0.8452650170303286,0.02955729657845499,26.49303593353891,6.574472908637498,-64130446.0,2000-06-08,2000,3,160,6,1.16,146.91,147.96875,145.625,109
2000-06-09 13:30:00,147.5,147.96875,145.625,146.59375,137.72222222222223,162.7236842105263,140.07869100000022,143.1440622,144.6193746,143.60859349999996,143.9696003240513,144.406268361481,143.64302846153836,151.18836188112954,136.09769504194722,140.07869100000022,143.1440622,144.6193746,143.60859349999996,146.72916666666666,3085300,6663424.95,55.875449912491504,1.5,2.75,2.8981586937493264,0.4630201470191391,0.7128263409854453,0.9205902228102616,0.20776388182481634,23.118094366920204,6.2273550724637685,-67215746.0,2000-06-09,2000,4,161,6,1.61,146.8,146.96875,144.875,110
2000-06-12 13:30:00,146.96875,146.96875,144.875,144.875,137.83333333333334,162.85526315789474,140.1194722500002,143.13031220000005,144.5431246,143.71171849999996,144.00510619369638,144.45090946991135,144.17187461538455,150.98966468566314,137.35408454510588,140.1194722500002,143.13031220000005,144.5431246,143.71171849999996,145.57291666666666,3436800,6537224.9,51.5434412107676,1.5,2.75,2.840700929910089,0.5257276677141702,0.4993939974567306,0.8320063786457297,0.33261238118899905,25.233406356387416,1.5108386249178891,-70652546.0,2000-06-12,2000,0,164,6,1.45,145.92,147.75,144.625,111
2000-06-13 13:30:00,144.8125,147.75,144.625,147.59375,137.94444444444446,162.98684210526315,140.1821285000002,143.15874970000004,144.4874996,143.82734349999996,144.14583732335532,144.75022761563412,144.73677846153836,151.3757535380566,138.0978033850201,140.1821285000002,143.15874970000004,144.4874996,143.82734349999996,146.65625,6551500,6642734.85,57.196561101721095,1.5,2.75,2.8610080063450822,0.9862654686570848,0.5099115907634958,0.9700018696433688,0.460090278879873,19.884083051591503,3.347921225382932,-64101046.0,2000-06-13,2000,1,165,6,2.16,146.19,148.875,147.1875,112
2000-06-14 13:30:00,148.25,148.875,147.1875,147.84375,138.05555555555554,163.1184210526316,140.25853475000022,143.19281220000005,144.4193746,143.89140599999996,144.29085350675317,145.04484879509752,145.5060092307691,150.98868378286244,140.02333467867584,140.25853475000022,143.19281220000005,144.4193746,143.89140599999996,147.96875,6407102,6553489.95,57.68541727904972,1.5,2.75,2.777186005891862,0.9776625964002584,0.5015332670171134,1.0870068626512648,0.5854735956341514,19.841525608828444,1.7419354838709675,-57693944.0,2000-06-14,2000,2,166,6,1.15,148.03,148.75,146.84375,113
2000-06-15 13:30:00,148.125,148.75,146.84375,148.15625,138.16666666666666,163.25,140.33900350000022,143.27093720000005,144.4674996,144.04140599999997,144.4424376829589,145.34117271937396,146.2872592307691,149.81486997344967,142.7596484880886,140.33900350000022,143.27093720000005,144.4674996,144.04140599999997,147.91666666666666,5776199,6546955.0,58.32612655267771,1.5,2.75,2.714976291185301,0.8822725984828061,0.4845960623352232,1.1912186735531805,0.7066226112179572,17.760483371159644,0.2113718030014796,-51917745.0,2000-06-15,2000,3,167,6,1.3,147.8,148.3125,145.875,114
2000-06-16 13:30:00,148.3125,148.3125,145.875,146.59375,138.27777777777777,163.3815789473684,140.4035347500002,143.31749969999998,144.4156246,144.18046849999996,144.52680287186251,145.46046579371932,146.5853361538461,149.44877961224267,143.72189269544944,140.4035347500002,143.31749969999998,144.4156246,144.18046849999996,146.92708333333334,5526199,6606999.9,53.92919623684615,1.5,2.75,2.6951565561006356,0.8364157838113483,0.3424195810449492,1.1346470875241437,0.7922275064791945,16.083786011494595,-0.3610875106202209,-57443944.0,2000-06-16,2000,4,168,6,1.67,147.09,149.15625,146.25,115
2000-06-19 13:30:00,146.46875,149.15625,146.25,148.46875,138.38888888888889,149.15625,140.4853316500002,143.3940622,144.3753122,144.54765599999996,144.68138903375024,145.7469690514603,147.02043230769218,149.0585079370041,144.98235667838034,140.4853316500002,143.3940622,144.3753122,144.54765599999996,147.95833333333334,5090500,6535605.0,58.0190230456178,1.5,2.75,2.7102346592363054,0.7788873409577232,0.34779144943294016,1.2269668182703697,0.8791753688374295,17.566761454081625,1.3654789844250053,-52353444.0,2000-06-19,2000,0,171,6,1.99,147.7,148.875,147.0,116
2000-06-20 13:30:00,148.1875,148.875,147.0,147.9375,138.5,149.04449152542372,140.5451754000002,143.4709372,144.3053122,144.94140599999997,144.80907965987768,145.9555910465593,147.2223553846153,149.05317085552758,145.391539913703,140.5451754000002,143.4709372,144.3053122,144.94140599999997,147.9375,5662301,6276750.15,56.488906022716215,1.5,2.75,2.6505750407194264,0.9021071198763584,0.29100822206971233,1.24293564642457,0.9519274243548576,17.474838790807038,0.3072393366157969,-58015745.0,2000-06-20,2000,1,172,6,1.28,147.94,148.4375,146.89061999999998,117
2000-06-21 13:30:00,146.9375,148.4375,146.89061999999998,147.84375,138.61111111111111,148.93273305084745,140.60705040000022,143.5906247,144.2453122,145.43359349999997,144.92808633988247,146.13541570879178,147.2223553846153,149.05317085552758,145.391539913703,140.60705040000022,143.5906247,144.2453122,145.43359349999997,147.72395666666668,3112700,6033425.2,56.2071954362419,1.5,2.75,2.571739680668038,0.5159092715693235,0.22550101675938586,1.2338036953040898,1.0083026785447042,17.07353705120826,0.6381620931716656,-61128445.0,2000-06-21,2000,2,173,6,1.05,147.66,147.6875,145.0,118
2000-06-22 13:30:00,147.5625,147.6875,145.0,145.625,138.72222222222223,148.8209745762712,140.6611129000002,143.6506247,144.14968720000005,145.70234349999996,144.9554162873381,146.08680468890685,147.10697076923068,149.12707102710604,145.0868705113553,140.6611129000002,143.6506247,144.14968720000005,145.70234349999996,146.10416666666666,7486500,5853525.2,49.86865278802986,1.5,2.75,2.591168989191749,1.2789728828706504,0.021833288987344712,1.035594289778885,1.0137610007915403,19.15065444492978,-0.6608399062033682,-68614945.0,2000-06-22,2000,3,174,6,1.85,146.34,146.125,143.875,119
2000-06-23 13:30:00,145.8125,146.125,143.875,144.375,138.83333333333334,148.70921610169492,140.7092379000002,143.68499970000005,144.1115622,146.02890599999995,144.9326548643052,145.92377567091572,146.94591307692298,149.42547509835654,144.46635105548944,140.7092379000002,143.68499970000005,144.1115622,146.02890599999995,144.79166666666666,4469898,5663075.2,46.675134517726896,1.5,2.75,2.5667997756780534,0.7893057821305286,-0.1959805794734908,0.7687852764496768,0.9647658559231675,19.660347622843144,-0.3451251078515962,-73084843.0,2000-06-23,2000,4,175,6,1.56,145.0,146.25,144.875,120
2000-06-26 13:30:00,145.375,146.25,144.875,146.23436999999998,138.94444444444446,148.59745762711862,140.7610347500002,143.7367184,144.1512496,146.44062449999996,144.98370251668538,145.95335608320948,146.8497592307691,149.33528073886748,144.3642377226708,140.7610347500002,143.7367184,144.1512496,146.44062449999996,145.78645666666668,5194801,5682115.25,51.63648716304088,1.5,2.75,2.517385505986763,0.9142371760234888,-0.21236340322855565,0.699311601887473,0.9116750051160286,20.020860464360343,-0.921028160067745,-67890042.0,2000-06-26,2000,0,178,6,0.95,145.56,146.71875,145.01561999999998,121
2000-06-27 13:30:00,145.98436999999998,146.71875,145.01561999999998,145.15625,139.05555555555554,148.4856991525424,140.8120504000002,143.7564059,144.2868746,146.56249949999997,144.9904690846585,145.87744121814188,146.71514384615375,149.35840006518194,144.07188762712556,140.8120504000002,143.7564059,144.2868746,146.56249949999997,145.63020666666668,4076600,5617815.15,48.80126327507427,1.5,2.75,2.4592243984162794,0.7256557738465281,-0.2886140659723689,0.5509074226505675,0.8395214886229364,16.96209526543943,-1.8177975058127245,-71966642.0,2000-06-27,2000,1,179,6,1.17,145.87,146.98436999999998,145.3125,122
2000-06-28 13:30:00,145.625,146.98436999999998,145.3125,145.5625,139.16666666666666,148.3739406779661,140.86955040000018,143.7860934,144.3831246,146.69999949999996,145.0129016695739,145.84744681641408,146.63581692307682,149.34983504324418,143.92179880290942,140.86955040000018,143.7860934,144.3831246,146.69999949999996,145.95312333333334,5320102,5580995.25,49.917176512552174,1.5,2.75,2.4141455128151166,0.9532532750319039,-0.3030047091442733,0.4607656021925948,0.7637703113368681,17.053268959777416,-1.7506855093862057,-66646540.0,2000-06-28,2000,2,180,6,1.15,146.15,145.75,143.51561999999998,123
2000-06-29 13:30:00,144.75,145.75,143.51561999999998,144.1875,143.51561999999998,148.26218220338984,140.93080040000018,143.80421840000002,144.37749960000005,146.64374949999996,144.98053297664939,145.68935664342223,146.58293230769218,149.45436068475976,143.71150393062462,140.93080040000018,143.80421840000002,144.37749960000005,146.64374949999996,144.48437333333334,6339199,5449875.1,46.24338263398009,1.5,2.75,2.401305119042608,1.1631824369699777,-0.3908529138332921,0.2752041690452529,0.666057082878545,17.435054532592062,-1.6414410573438498,-72985739.0,2000-06-29,2000,3,181,6,1.56,144.63,145.59375,143.89061999999998,124
2000-06-30 13:30:00,143.9375,145.59375,143.89061999999998,145.28125,143.7962448,148.15042372881356,140.99494105000022,143.8139059,144.4206246,146.51562449999997,144.9923258010945,145.65048934404868,146.4050476923076,149.29044030684202,143.51965507777314,140.99494105000022,143.8139059,144.4206246,146.51562449999997,144.92187333333334,7396602,5371595.25,49.43157317021923,1.5,2.75,2.3514354676824207,1.3769842394584737,-0.3616970565177949,0.2139357622313014,0.5756328187490963,17.54294031964077,-2.146916438644496,-65589137.0,2000-06-30,2000,4,182,6,1.18,144.74,147.4375,145.1875,125
2000-07-03 13:30:00,145.4375,147.4375,145.1875,147.28125,144.0768696,148.03866525423732,141.06259730000022,143.8739059,144.4899996,146.52343699999997,145.0820875343849,145.80579988271074,146.36177846153836,149.17555618315075,143.54800073992598,141.06259730000022,143.8739059,144.4899996,146.52343699999997,146.63541666666666,1431900,5093285.15,54.719878608140796,1.5,2.75,2.3441900771336766,0.2811348585107197,-0.2020745795111314,0.32303959436018204,0.5251141738713134,17.822118173847418,-0.4435994930291508,-64157237.0,2000-07-03,2000,0,185,7,1.55,146.31,146.65625,144.375,126
2000-07-05 13:30:00,146.375,146.65625,144.375,144.625,144.3574944,147.926906779661,141.11790980000018,143.90453090000003,144.53749960000005,146.43124949999995,145.06416253303647,145.693342751024,146.09014384615375,148.8396015858741,143.34068610643342,141.11790980000018,143.90453090000003,144.53749960000005,146.43124949999995,145.21875,2714800,4986080.25,47.600070070986774,1.5,2.75,2.384337214481272,0.5444757933849942,-0.2657362551576151,0.19294385492429456,0.4586801100819097,20.43217862612339,-2.17712957091524,-66872037.0,2000-07-05,2000,2,187,7,1.58,145.52,146.46875,144.21875,127
2000-07-06 13:30:00,144.9375,146.46875,144.21875,145.75,144.63811919999998,147.81514830508473,141.19290980000022,143.9751559,144.48937460000005,146.34453099999996,145.09105811997622,145.69873867949792,146.0252399999999,148.76389486975685,143.286585130243,141.19290980000022,143.9751559,144.48937460000005,146.34453099999996,145.47916666666666,5382898,5009250.15,50.53558520342799,1.5,2.75,2.3747416991611803,1.0745915733515523,-0.22409465373194354,0.17856179291698027,0.4026564466489238,21.225812518878453,0.08583690987124462,-61489139.0,2000-07-06,2000,3,188,7,1.56,145.34,148.78125,146.25,128
2000-07-07 13:30:00,146.6875,148.78125,146.25,148.09375,144.918744,147.70338983050846,141.28037075000026,144.0610934,144.5215622,146.40390599999995,145.20881074272225,145.9268349957362,145.99639384615375,148.6376595277886,143.3551281645189,141.28037075000026,144.0610934,144.5215622,146.40390599999995,147.70833333333334,3021300,4874160.05,56.05854064691287,1.5,2.75,2.4216351492210957,0.6198606465538611,-0.04034538503382612,0.3522247153566411,0.3925701003904673,21.37936036969441,2.575757575757576,-58467839.0,2000-07-07,2000,4,189,7,1.73,147.52,148.90625,147.53125,129
2000-07-10 13:30:00,147.875,148.90625,147.53125,147.84375,145.1993688,147.59163135593218,141.38021450000022,144.1285934,144.5584372,146.46640599999995,145.31214169398802,146.10939832947562,145.98918230769218,148.6096391017015,143.3687255136829,141.38021450000022,144.1285934,144.5584372,146.46640599999995,148.09375,2814500,4860620.05,55.34863765454436,1.5,2.75,2.346875495705304,0.5790413509074835,0.057406665897694165,0.464328432762585,0.4069217668648908,20.51179756945955,1.1005483868122024,-61282339.0,2000-07-10,2000,0,192,7,0.93,148.22,149.125,147.15625,130
2000-07-11 13:30:00,147.46875,149.125,147.15625,148.15625,145.47999360000003,147.4798728813559,141.48224575000026,144.21828090000002,144.61968720000004,146.63046849999995,145.42367535304734,146.30433658381128,146.01322076923068,148.70602193693242,143.32041960152898,141.48224575000026,144.21828090000002,144.61968720000004,146.63046849999995,148.14583333333334,5420699,4959815.0,56.097057922563884,1.5,2.75,2.3198665317263543,1.09292362719174,0.1318995972322849,0.5717962634052469,0.439896666172962,19.415036634061217,2.0667384284176533,-55861640.0,2000-07-11,2000,1,193,7,1.34,148.14,150.125,148.6875,131
2000-07-12 13:30:00,149.28125,150.125,148.6875,149.125,145.76061840000003,147.36811440677963,141.58490200000026,144.3267184,144.6609372,146.70703099999997,145.56882533920236,146.57297119487689,146.28245153846143,149.42797220426002,143.13693087266287,141.58490200000026,144.3267184,144.6609372,146.70703099999997,149.3125,5800699,4922274.95,58.423565370157824,1.5,2.75,2.294786779460186,1.1784589562596457,0.2294888364709956,0.7267577117617066,0.497268875290711,18.765022104738385,2.4474023185916702,-50060941.0,2000-07-12,2000,2,194,7,0.97,149.41,150.375,149.1875,132
2000-07-13 13:30:00,149.98436999999998,150.375,149.1875,149.78125,146.04124320000003,147.25635593220338,141.69208950000018,144.4714059,144.7740622,146.80390599999996,145.73401846315522,146.87852155726955,146.69831692307682,150.14065168125182,143.2559821649018,141.69208950000018,144.4714059,144.7740622,146.80390599999996,149.78125,5354102,4869624.95,59.97105329623226,1.5,2.75,2.2201591523558872,1.099489602376873,0.3159725334525235,0.8922345421063653,0.5762620086538418,18.79033049802339,3.8794971824880804,-44706839.0,2000-07-13,2000,3,195,7,0.8,149.78,151.25,149.67186999999998,133
2000-07-14 13:30:00,150.4375,151.25,149.67186999999998,151.25,146.32186800000005,147.14459745762713,141.81427700000026,144.6342184,144.9665622,146.95859349999995,145.95033146460008,147.2948528375296,147.0841346153845,151.27492584606267,142.8933433847063,141.81427700000026,144.6342184,144.9665622,146.95859349999995,150.72395666666668,5335199,4847574.95,63.26643934903567,1.5,2.75,2.174299927187609,1.1005913379431091,0.4420935599274913,1.128878958563206,0.6867853986357146,17.35749161288583,4.108410410841041,-39371640.0,2000-07-14,2000,4,196,7,1.05,150.46,151.98436999999998,150.6875,134
2000-07-17 13:30:00,150.98436999999998,151.98436999999998,150.6875,151.0,146.60249280000005,151.98436999999998,141.92552700000022,144.7785934,145.1503122,147.17890599999996,146.14835768167458,147.6477239958601,147.53365384615375,152.0424234486586,143.02488424364887,141.92552700000022,144.7785934,145.1503122,147.17890599999996,151.22395666666668,3933000,4767915.0,62.32589885210732,1.5,2.75,2.1116263609599235,0.8248888665171255,0.4757527936773205,1.2814763907323652,0.8057235970550447,17.620865413017775,2.5249310417992787,-43304640.0,2000-07-17,2000,0,199,7,0.86,151.34,150.625,149.34375,135
2000-07-18 13:30:00,150.625,150.625,149.34375,149.76561999999998,146.88311760000005,152.13321842105262,142.0320113500002,144.9381246,145.2749996,147.24374949999995,146.29021110592268,147.84942837720675,147.85697076923068,152.35676722338007,143.35717431508132,142.0320113500002,144.9381246,145.2749996,147.24374949999995,149.91145666666668,4245602,4725670.1,57.760014067681475,1.5,2.75,2.0790994780342147,0.8984126928369376,0.3857891256167287,1.2879600040759556,0.9021708784592268,17.636580441246632,3.5544477095937856,-47550242.0,2000-07-18,2000,1,200,7,0.86,149.98,149.90625,148.25,136
2000-07-19 13:30:00,149.46875,149.90625,148.25,148.6875,147.16374240000005,152.28206684210528,142.1216988500002,145.09171840000005,145.39968720000005,147.28124949999997,146.38422243510215,147.9292447222347,148.20312461538455,152.18282762663705,144.22342160413203,142.1216988500002,145.09171840000005,145.39968720000005,147.28124949999997,148.94791666666666,8294199,4857265.0,54.03655197669693,1.5,2.75,2.0488959438889136,1.7075862651100981,0.23214991850634606,1.1923582765921594,0.9602083580858134,13.834816039062707,2.0154373927958837,-55844441.0,2000-07-19,2000,2,201,7,1.12,149.08,150.625,148.8125,137
2000-07-20 13:30:00,149.0,150.625,148.8125,150.625,147.44436720000004,152.4309152631579,142.22169885000022,145.2367184,145.58593720000005,147.42031199999997,146.5505274376472,148.1859833201171,148.61418230769218,152.4010079218867,144.8273566934977,142.22169885000022,145.2367184,145.58593720000005,147.42031199999997,150.02083333333334,4283000,4915780.0,59.13492114842617,1.5,2.75,2.0409390907539917,0.8712757690539447,0.2385748449716472,1.2584269143003723,1.0198520693287252,14.804314658944142,1.7092213547161847,-51561441.0,2000-07-20,2000,3,202,7,1.22,149.72,149.75,147.6875,138
2000-07-21 13:30:00,149.75,149.75,147.6875,147.6875,147.724992,152.57976368421058,142.29701135000022,145.33921840000005,145.7771872,147.52343699999997,146.59511459695514,148.13850871820117,148.64543230769218,152.39425747771554,144.89660713766887,142.29701135000022,145.33921840000005,145.7771872,147.52343699999997,148.375,5370398,4809974.9,50.06729414338772,1.5,2.75,2.1049791557001347,1.1165126869996764,0.03333319270108959,1.0615185602050872,1.0281853675039976,17.52399764698566,-0.1056859015007398,-56931839.0,2000-07-21,2000,4,203,7,1.4,148.72,148.85936999999998,146.5625,139
2000-07-24 13:30:00,148.125,148.85936999999998,146.5625,146.84375,148.0056168,152.72861210526318,142.3718551000002,145.4232809,145.8884372,147.64687449999997,146.60486500491768,148.01519836408673,148.8161053846153,151.9724418838224,145.6597688854082,142.3718551000002,145.4232809,145.8884372,147.64687449999997,147.42187333333334,5625301,4867745.05,47.80004859818916,1.5,2.75,2.1186856445786977,1.1556276966477528,-0.16027560337079486,0.8278408632905041,0.9881164666612988,17.793945351413353,-0.8858890529424173,-62557140.0,2000-07-24,2000,0,206,7,1.57,147.71,147.84375,146.78125,140
2000-07-25 13:30:00,147.75,147.84375,146.78125,147.3125,148.2862416,152.87746052631582,142.43904260000022,145.51109340000005,145.9784372,147.70078099999995,146.6326153968817,147.94827471036422,148.9362976923076,151.71257199459887,146.1600233900163,142.43904260000022,145.51109340000005,145.9784372,147.70078099999995,147.3125,4488801,4832445.05,49.176994750165406,1.5,2.75,2.0432438128230763,0.9288881619047071,-0.2523178732486053,0.6727191251005422,0.9250369983491477,17.866038784183015,-1.2154233025984913,-58068339.0,2000-07-25,2000,1,207,7,0.72,147.31,147.15625,145.64061999999998,141
2000-07-26 13:30:00,146.96875,147.15625,145.64061999999998,145.875,148.5668664,153.02630894736842,142.50013635000022,145.5585934,145.9903122,147.73671849999997,146.6029049891609,147.75081997604383,148.76562461538455,151.96817157355918,145.56307765720987,142.50013635000022,145.5585934,145.9903122,147.73671849999997,146.22395666666668,11773301,5217280.1,45.23619654768036,1.5,2.75,2.016717826192856,2.2565974558276065,-0.3969525424795547,0.42884632024970415,0.8257988627292588,17.951550632287933,-2.6079699561861047,-69841640.0,2000-07-26,2000,2,208,7,1.04,146.4,146.625,144.6875,142
2000-07-27 13:30:00,145.9375,146.625,144.6875,145.375,148.84749120000004,153.1751573684211,142.56904260000022,145.6142184,145.9665622,147.72734349999996,146.55475185233104,147.52455140689682,148.57572076923068,152.2346678716093,144.91677366685204,142.56904260000022,145.6142184,145.9665622,147.72734349999996,145.5625,7640000,5333275.0,43.91790737818201,1.5,2.75,2.011059410036223,1.4325156681401203,-0.5062353254137985,0.1930047059620108,0.6992400313758093,17.455740086028786,-3.884297520661157,-77481640.0,2000-07-27,2000,3,209,7,1.34,145.66,145.90625,141.51561999999998,143
2000-07-28 13:30:00,145.71875,145.90625,141.51561999999998,142.09375,141.51561999999998,153.32400578947372,142.6385738500002,145.6646872,145.9053122,147.62265599999995,146.37981060322002,147.00733222528757,148.10937461538455,153.14840446516686,143.0703447656022,142.6385738500002,145.6646872,145.9053122,147.62265599999995,143.17187333333334,6217102,5327170.15,36.41744446272771,1.5,2.75,2.1810287378907782,1.1670552704234536,-0.7639705116198464,-0.2557231081489988,0.5082474034708476,18.718613831095027,-5.898178807947019,-83698742.0,2000-07-28,2000,4,210,7,3.1,143.71,144.125,142.0625,144
2000-07-31 13:30:00,142.9375,144.125,142.0625,142.90625,141.41562000000005,153.47285421052632,142.71232385000022,145.72499969999998,145.8871872,147.50390599999997,146.24359254034866,146.61675296573637,147.6310092307691,153.33093087782927,141.931087583709,142.71232385000022,145.72499969999998,145.8871872,147.50390599999997,143.03125,5235000,5219090.05,39.18700922170824,1.5,2.75,2.172562399470008,1.0030484145411518,-0.8382470792626697,-0.5395614456074895,0.2986856336551802,19.81949195974953,-4.580069845135361,-78463742.0,2000-07-31,2000,0,213,7,1.45,143.09,144.71875,143.125,145
2000-08-01 13:30:00,143.625,144.71875,143.125,143.875,141.31562000000002,153.62170263157896,142.80732385000022,145.75499969999998,145.9421872,147.33359349999995,146.1507065583742,146.35563363566627,147.17668230769218,153.0572971010381,141.2960675143463,142.80732385000022,145.75499969999998,145.9421872,147.33359349999995,143.90625,3939600,5344475.05,42.408135235129755,1.5,2.75,2.1468436566507214,0.7371350718533152,-0.7817595939369862,-0.6785138587660526,0.1032457351709336,20.901862283803325,-3.2366540563261874,-74524142.0,2000-08-01,2000,1,214,8,1.11,143.92,145.40625,143.625,146
2000-08-02 13:30:00,143.875,145.40625,143.625,144.59375,141.21562,153.7705510526316,142.90138635000022,145.7990622,146.0328122,147.33203099999997,146.089649438438,146.18783519417426,146.66466307692298,152.18558253515596,141.14374361869,142.90138635000022,145.7990622,146.0328122,147.33203099999997,144.54166666666666,7432898,5580379.95,44.746550175820964,1.5,2.75,2.1207298240328134,1.3319698777858306,-0.6604455285593789,-0.7223111755282899,-0.061865646968911135,21.382707619656,-4.004149377593361,-67091244.0,2000-08-02,2000,2,215,8,1.24,144.52,145.8125,142.625,147
2000-08-03 13:30:00,142.875,145.8125,142.625,145.59375,141.11562,153.91939947368422,142.99435510000018,145.8690622,146.18468719999998,147.32421849999997,146.07020240163646,146.1312556518719,146.2487976923076,151.1842340538152,141.31336133079995,142.99435510000018,145.8690622,146.18468719999998,147.32421849999997,144.67708333333334,4544801,5538475.1,47.915227621673594,1.5,2.75,2.1969276937447546,0.8205870601458514,-0.4854048955711394,-0.6686217664328353,-0.183216870861696,19.992561554269127,-1.4176893779094368,-62546443.0,2000-08-03,2000,3,216,8,2.23,144.22,146.71875,145.40625,148
2000-08-04 13:30:00,146.3125,146.71875,145.40625,146.375,141.01561999999998,154.06824789473688,143.08498010000022,145.9665622,146.30718720000004,147.23828099999997,146.08215524863112,146.1544693993127,145.98798076923066,150.49195460635852,141.48400693210286,143.08498010000022,145.9665622,146.30718720000004,147.23828099999997,146.16666666666666,3679600,5571390.1,50.312621707307855,1.5,2.75,2.1337542870487014,0.6604455861024703,-0.29871918809912146,-0.5566158559855978,-0.2578966678864764,17.5441548574726,-0.3192168546499255,-58866843.0,2000-08-04,2000,4,217,8,0.9,146.06,148.4375,146.375,149
2000-08-07 13:30:00,146.71875,148.4375,146.375,148.125,140.91562000000005,154.21709631578952,143.18060510000018,146.0496872,146.51281219999998,147.25234349999997,146.1622668075083,146.34213898033053,145.94471153846143,150.35392895484378,141.5354941220791,143.18060510000018,146.0496872,146.51281219999998,147.25234349999997,147.64583333333334,4134500,5637390.1,55.278311164672616,1.5,2.75,2.1286646951166515,0.7334067585636836,-0.052016743534711314,-0.3229175973048655,-0.27090085377015416,18.642001607821808,0.5515485787017395,-54732343.0,2000-08-07,2000,0,220,8,1.41,147.41,148.8125,147.5,150
2000-08-08 13:30:00,147.5,148.8125,147.5,148.6875,140.81562000000002,154.36594473684212,143.27357385000022,146.0731247,146.72656220000005,147.27890599999995,146.26129556015508,146.56550669648954,145.79567307692298,149.65922746568074,141.9321186881652,143.27357385000022,146.0731247,146.72656220000005,147.27890599999995,148.33333333333334,3591700,5545940.15,56.773688567746795,1.5,2.75,2.070367216894033,0.6476268951441894,0.14370556021818565,-0.09126890349742213,-0.23497446371560776,18.672562261038394,1.9280205655526992,-51140643.0,2000-08-08,2000,1,221,8,0.89,148.16,149.21875,147.375,151
2000-08-09 13:30:00,149.14061999999998,149.21875,147.375,147.4375,140.71562,154.51479315789476,143.36357385000022,146.07812470000005,146.8209372,147.19453099999996,146.30742122446273,146.64855367777625,145.77644230769218,149.60446447302888,141.94842014235556,143.36357385000022,146.07812470000005,146.8209372,147.19453099999996,148.01041666666666,5350898,5523450.1,52.56720072075344,1.5,2.75,2.054180272830174,0.9687600871057024,0.18121736307149824,-0.00845275987623495,-0.1896701229477332,18.40078572647084,1.4187446259673258,-56491541.0,2000-08-09,2000,2,222,8,1.25,148.3,147.85936999999998,146.28125,152
2000-08-10 13:30:00,147.53125,147.85936999999998,146.28125,146.71875,140.61562,154.66364157894742,143.45810510000018,146.0774997,146.8990622,147.04140599999997,146.32355176467988,146.65523904179756,145.76682692307682,149.58469163734068,141.9489622088129,143.45810510000018,146.0774997,146.8990622,147.04140599999997,146.95312333333334,4188398,5465164.9,50.261207767241615,1.5,2.75,2.0201759676280195,0.7663809009678738,0.15108956119301087,-0.0008081714564696085,-0.15189773264948048,18.548747656870216,3.2548933362656696,-60679939.0,2000-08-10,2000,3,223,8,1.08,147.07,148.0,145.5625,153
2000-08-11 13:30:00,146.625,148.0,145.5625,147.32811999999998,140.51561999999998,154.81249000000003,143.54412070000018,146.0589059,146.9393746,146.84531199999995,146.36294659743754,146.71932294257874,145.76802846153836,149.5878475356509,141.94820938742583,143.54412070000018,146.0589059,146.9393746,146.84531199999995,146.96354,5080898,5452449.85,52.176658296740335,1.5,2.75,2.049984827083161,0.9318559802984708,0.16455906662109204,0.05380110062688459,-0.11075796599420744,10.743224327406374,3.09424535315986,-55599041.0,2000-08-11,2000,4,224,8,1.67,146.78,149.5625,147.0625,154
2000-08-14 13:30:00,147.78125,149.5625,147.0625,149.28125,140.41562000000002,154.96133842105266,143.6177144500002,146.0507809,146.9681246,146.75937449999995,146.47738986812627,146.96331599566648,146.0300476923076,150.28570771993924,141.77438766467594,143.6177144500002,146.0507809,146.9681246,146.75937449999995,148.63541666666666,2917200,5401659.85,57.7877682934131,1.5,2.75,2.0821287680057923,0.5400562199413576,0.2900289864488149,0.2517782670668112,-0.038250719382003716,12.045792034673926,3.7576020851433536,-52681841.0,2000-08-14,2000,0,227,8,1.7,148.31,149.8125,148.5625,155
2000-08-15 13:30:00,149.34375,149.8125,148.5625,149.15625,140.31562000000002,155.11018684210532,143.67849570000018,146.01734340000004,147.00874960000004,146.72890599999997,146.58244320663113,147.17216685322202,146.32091307692298,150.8648458375936,141.77698031625238,143.67849570000018,146.01734340000004,147.00874960000004,146.72890599999997,149.17708333333334,5547602,5466759.85,57.32420350794374,1.5,2.75,2.022690998862521,1.01478794609937,0.34583881925070536,0.394047804681378,0.04820898543067263,12.279483380692742,3.155392262805273,-58229443.0,2000-08-15,2000,1,228,8,0.84,149.19,149.9375,147.84375,156
2000-08-16 13:30:00,149.3125,149.9375,147.84375,148.625,140.21562,155.2590352631579,143.74380820000022,145.96796840000005,147.05187460000005,146.72578099999996,146.66254347303777,147.31053191481996,146.82331692307682,150.79484597501983,142.85178787113378,143.74380820000022,145.96796840000005,147.05187460000005,146.72578099999996,148.80208333333334,5136898,5308894.8,55.29406059082172,1.5,2.75,2.027766641800913,0.967602145742274,0.32834725283708244,0.4586430514770257,0.13029579863994326,12.89198748396426,2.0819918437432925,-63366341.0,2000-08-16,2000,2,229,8,1.42,148.89,150.4375,148.34375,157
2000-08-17 13:30:00,148.6875,150.4375,148.34375,150.1875,140.11562,155.40788368421056,143.82177695000019,145.9504684,147.1059372,146.70390599999996,146.80077706233038,147.5845288753133,147.38341307692298,151.0275233580729,143.73930279577303,143.82177695000019,145.9504684,147.1059372,146.70390599999996,149.65625,5612801,5375384.85,59.80312688388624,1.5,2.75,2.032479738815133,1.044167284134084,0.3986985901053392,0.6286690362716172,0.22997044616627804,13.459717579196965,2.6046114432109313,-57753540.0,2000-08-17,2000,3,230,8,1.41,149.39,150.375,149.21875,158
2000-08-18 13:30:00,150.375,150.375,149.21875,149.6875,140.01561999999998,155.5567321052632,143.8927144500002,145.93671840000005,147.16156220000005,146.80390599999996,146.91398188341546,147.7848118395692,147.83052846153836,151.04393787626418,144.61711904681255,143.8927144500002,145.93671840000005,147.16156220000005,146.80390599999996,149.76041666666666,4620801,5337905.0,57.79430646803804,1.5,2.75,1.9698919003283384,0.8656581561492758,0.3878875778926377,0.7148299185320752,0.3269423406394375,13.84605988192082,1.0548523206751057,-62374341.0,2000-08-18,2000,4,231,8,0.77,149.8,150.71875,149.40625,159
2000-08-21 13:30:00,150.03125,150.71875,149.40625,150.5625,139.91562000000002,155.70558052631583,143.9628707000002,145.93015590000005,147.24093720000005,146.98984349999995,147.05706102524232,148.049353569134,148.28966307692298,151.2146732233304,145.36465293051555,143.9628707000002,145.93015590000005,147.24093720000005,146.98984349999995,150.22916666666666,2359900,5174634.95,60.30707811381728,1.5,2.75,1.9229353360191708,0.4560514940285788,0.413637522023518,0.843989243168835,0.43035172114531706,12.693021477195668,1.261034047919294,-60014441.0,2000-08-21,2000,0,234,8,0.88,150.06,151.3125,150.09375,160
2000-08-22 13:30:00,150.5625,151.3125,150.09375,150.3125,139.81562000000002,155.85442894736846,144.02505820000022,145.9464059,147.3496872,147.13984349999996,147.18472529876217,148.2648913244546,148.65264384615375,151.3080928479152,145.9971948443923,144.02505820000022,145.9464059,147.3496872,147.13984349999996,150.57291666666666,3017900,5101089.9,59.2221945798825,1.5,2.75,1.872636383446373,0.5916186656502563,0.388215675288186,0.9156213152555496,0.5274056399673634,12.739241430531877,1.9499788045782112,-63032341.0,2000-08-22,2000,1,235,8,0.81,150.7,151.28125,149.28125,161
2000-08-23 13:30:00,149.8125,151.28125,149.28125,150.84375,139.71562,156.0032773684211,144.0892769500002,145.95109340000005,147.4146872,147.38828099999995,147.3282164635166,148.51049691260178,148.99639384615375,151.5380003900649,146.45478730224258,144.0892769500002,145.95109340000005,147.4146872,147.38828099999995,150.46875,5477500,4786299.85,60.83455280629387,1.5,2.75,1.8817337846287747,1.1444122122854463,0.3810257244193217,1.0036877954915155,0.6226620710721938,11.228876671660524,2.8115015974440896,-57554841.0,2000-08-23,2000,2,236,8,1.34,150.28,151.54686999999998,150.5,162
2000-08-24 13:30:00,151.15625,151.54686999999998,150.5,151.3125,139.61562,156.15212578947373,144.16232385000018,145.9517184,147.4840622,147.68515599999995,147.48446287671206,148.77735434949685,149.2415861538461,152.0049565835429,146.47821572414924,144.16232385000018,145.9517184,147.4840622,147.68515599999995,151.11979,4522398,4630419.75,62.252792191058596,1.5,2.75,1.822100657155292,0.976671283418744,0.3807830430862663,1.0986408749300267,0.7178578318437604,10.258338644708463,2.704426011816337,-53032443.0,2000-08-24,2000,3,237,8,0.7,151.02,151.625,150.9375,163
2000-08-25 13:30:00,151.15625,151.625,150.9375,151.25,139.51561999999998,156.3009742105263,144.2299801000002,146.0067184,147.5459372,148.14296849999997,147.63213099919398,149.01284441144952,149.43870153846143,152.37595870834068,146.50144436858218,144.2299801000002,146.0067184,147.5459372,148.14296849999997,151.27083333333334,2820400,4460584.65,61.930776969964334,1.5,2.75,1.741057753072771,0.6322937958368304,0.3501364819809838,1.15552843431999,0.8053919523390063,10.417538862155784,1.3188193426836927,-55852843.0,2000-08-25,2000,4,238,8,0.46,151.28,152.90625,151.25,164
2000-08-28 13:30:00,151.25,152.90625,151.25,151.76561999999998,139.41562000000002,156.44982263157897,144.2963082000002,146.03249960000005,147.64937460000004,148.58593699999997,147.7942286070687,149.275013515121,149.77163384615375,152.70725486110118,146.83601283120632,144.2963082000002,146.03249960000005,147.64937460000004,148.58593699999997,151.97395666666668,5497398,4473704.55,63.60345423612063,1.5,2.75,1.7350000564247163,1.2288245543617762,0.3381361373681683,1.2280621240492169,0.8899259866810484,8.043257974566515,1.7494204902577082,-50355445.0,2000-08-28,2000,0,241,8,1.1,152.08,151.875,150.90625,165
2000-08-29 13:30:00,151.4375,151.875,150.90625,151.79686999999998,139.31562000000002,156.5986710526316,144.3565425500002,146.0456246,147.71593700000003,148.98203049999995,147.95119493620325,149.51519032320468,150.1622584615384,152.69244075627904,147.6320761667977,144.3565425500002,146.0456246,147.71593700000003,148.98203049999995,151.52604,3528200,4453134.55,63.70753239223443,1.5,2.75,1.6802679095372366,0.7922958447325604,0.30676991543150606,1.273388380970431,0.9666184655389248,7.947086840083463,2.1341429772918503,-46827245.0,2000-08-29,2000,1,242,8,0.64,151.39,151.5,150.34375,166
2000-08-30 13:30:00,151.3125,151.5,150.34375,150.34375,139.21562,156.74751947368426,144.40787070000022,146.0346871,147.76406200000002,149.26953049999997,148.0450206249796,149.59410076861377,150.3942299999999,152.3243141730435,148.4641458269563,144.40787070000022,146.0346871,147.76406200000002,149.26953049999997,150.72916666666666,3948600,4278919.65,55.72749246000778,1.5,2.75,1.6640430588560062,0.9228030257590838,0.16948158962028706,1.1784704525642835,1.0089888629439967,9.934563237786245,0.10403662089055347,-50775845.0,2000-08-30,2000,2,243,8,0.77,150.92,153.09375,150.90625,167
2000-08-31 13:30:00,151.0625,153.09375,150.90625,152.34375,139.11562,156.89636789473687,144.46333945000018,146.0496871,147.854062,149.60703049999995,148.21359824752943,149.8559721239839,150.62980692307684,152.7014046265941,148.5582092195596,144.46333945000018,146.0496871,147.854062,149.60703049999995,152.11458333333334,4820801,4292719.65,62.66015405576864,1.5,2.75,1.7416114117948631,1.1230178984551202,0.1929839905066253,1.2502188510772785,1.057234860570653,10.951093358687604,1.7745302713987474,-45955044.0,2000-08-31,2000,3,244,8,1.45,152.0,153.59375,152.0,168
2000-09-01 13:30:00,153.25,153.59375,152.0,152.375,139.01561999999998,153.59375,144.5174019500002,146.0693746,147.98906200000005,149.90703049999996,148.3767904731165,150.09587954074732,150.877403076923,152.95473932590912,148.8000668279369,144.5174019500002,146.0693746,147.98906200000005,149.90703049999996,152.65625,3152900,4266384.65,62.75828371203271,1.5,2.75,1.7310498823809444,0.739009784314689,0.18995399397055568,1.2946773530338476,1.104723359063292,10.570804176965336,1.2038190120381902,-42802144.0,2000-09-01,2000,4,245,9,1.05,152.8,152.20311999999998,150.8125,169
2000-09-05 13:30:00,151.875,152.20311999999998,150.8125,151.28125,138.91562000000002,153.64108470588238,144.5606832000002,146.1193746,148.12718700000005,150.06484299999997,148.49069084671981,150.20877196543802,151.0817299999999,152.70576471673925,149.45769528326056,144.5606832000002,146.1193746,148.12718700000005,150.06484299999997,151.43229,3450400,4232179.65,57.101992674507684,1.5,2.75,1.7190106050680198,0.8152773004331231,0.0982250268024878,1.2275046425664016,1.1292796157639138,11.358456722516658,0.6444906444906445,-46252544.0,2000-09-05,2000,1,249,9,0.92,151.51,151.78125,149.53125,170
2000-09-06 13:30:00,151.1875,151.78125,149.53125,149.78125,138.81562000000002,153.68841941176467,144.5971090000002,146.1746871,148.1981246,150.11953049999997,148.54130100959352,150.1680555877773,151.0504799999999,152.75574281293615,149.3452171870637,144.5971090000002,146.1746871,148.1981246,150.11953049999997,150.36458333333334,4164102,4260799.75,50.393934328905665,1.5,2.75,1.7569384189917323,0.9773052582440656,-0.07043995337011832,1.041229674051266,1.1116696274213842,12.830442443319185,-0.7043712450797597,-50416646.0,2000-09-06,2000,2,250,9,1.5,150.66,151.07811999999998,149.82811999999998,171
2000-09-07 13:30:00,150.25,151.07811999999998,149.82811999999998,150.84375,138.71562,153.73575411764705,144.6389840000002,146.29937460000005,148.3118746,150.28984299999996,148.63159312686437,150.23240743656038,151.13942230769223,152.6618623904394,149.61698222494502,144.6389840000002,146.29937460000005,148.3118746,150.28984299999996,150.58333000000005,4078800,4197194.85,54.473657470968476,1.5,2.75,1.7240763890637525,0.9717919100181877,-0.1147919285943595,0.9681797166784348,1.0829716452727944,13.370564364375895,-0.3097893432465923,-46337846.0,2000-09-07,2000,3,251,9,0.83,150.45,150.5,149.32811999999998,172
2000-09-08 13:30:00,150.28125,150.5,149.32811999999998,149.8125,138.61562,153.78308882352943,144.6819527500002,146.3899996,148.39687460000005,150.44453049999996,148.67790320032069,150.1924162521261,151.0817299999999,152.73818976512757,149.42527023487224,144.6819527500002,146.3899996,148.39687460000005,150.44453049999996,149.88020666666668,3476100,4161579.95,50.161577558032896,1.5,2.75,1.7091873612734836,0.835283724394145,-0.2122585164236301,0.8176484997432567,1.0299070161668868,13.740896762686793,-0.950413223140496,-49813946.0,2000-09-08,2000,4,252,9,0.78,149.91,151.1875,148.6875,173
2000-09-11 13:30:00,149.75,151.1875,148.6875,149.59375,138.51561999999998,153.83042352941175,144.7196090000002,146.44124960000005,148.50499960000005,150.55781199999996,148.71381876109243,150.13540041859025,151.02644153846148,152.82389038910063,149.22899268782228,144.7196090000002,146.44124960000005,148.50499960000005,150.55781199999996,149.82291666666666,3933800,4104225.05,49.27061987999553,1.5,2.75,1.7656739783253776,0.9584757054197114,-0.2855713228965092,0.6729428625462504,0.9585141854427596,13.737792348175715,-1.4310685120912183,-53747746.0,2000-09-11,2000,0,255,9,1.68,149.94,150.25,148.4375,174
2000-09-12 13:30:00,149.75,150.25,148.4375,148.46875,138.41562000000002,153.87775823529412,144.7550777500002,146.49468710000005,148.56874960000005,150.51718699999995,148.70420822144175,149.9766718072959,150.8437492307691,153.10204595321952,148.58545250831878,144.7550777500002,146.49468710000005,148.56874960000005,150.51718699999995,149.05208333333334,4742500,4195490.05,44.8578295858234,1.5,2.75,1.7690186941592791,1.1303804665202342,-0.3970857117174721,0.4621570457959194,0.8592427575133915,13.860644309810226,-2.192482624971129,-58490246.0,2000-09-12,2000,1,256,9,1.22,149.34,149.34375,147.65625,175
2000-09-13 13:30:00,148.0,149.34375,147.65625,148.89061999999998,138.31562000000002,153.92509294117647,144.79484335000018,146.5454683,148.60093700000004,150.50390549999997,148.71151848726757,149.87323830183917,150.65745076923068,153.12062459875014,148.19427693971127,144.79484335000018,146.5454683,148.60093700000004,150.50390549999997,148.63020666666668,4555102,4145865.05,46.78264613157396,1.5,2.75,1.7631959302907592,1.0987096649467645,-0.4270756754469679,0.3253981632046816,0.7524738386516495,14.106984559831547,-0.966538349615456,-53935144.0,2000-09-13,2000,2,257,9,1.14,148.5,149.9375,148.15625,176
2000-09-14 13:30:00,149.875,149.9375,148.15625,148.46875,138.21562,153.97242764705882,144.84023400000018,146.60765580000003,148.67781200000005,150.49609299999997,148.70199815443354,149.73947751118783,150.4435084615384,153.1361052461728,147.750911676904,144.84023400000018,146.60765580000003,148.67781200000005,150.49609299999997,148.85416666666666,3391400,4058590.15,45.08772876598387,1.5,2.75,1.7644855066985619,0.8356103658311003,-0.4572677092815722,0.18088920204968414,0.6381569113312564,13.268984936821704,-2.5435897435897434,-57326544.0,2000-09-14,2000,3,258,9,1.2,149.05,148.25,146.03125,177
2000-09-15 13:30:00,148.1875,148.25,146.03125,146.09375,138.11562,154.01976235294114,144.8686715000002,146.5870308,148.68468700000003,150.29140549999997,148.59971391308318,149.39226536726514,150.00721076923068,153.4383149941113,146.5761065443501,144.8686715000002,146.5870308,148.68468700000003,150.29140549999997,146.79166666666666,4075700,3981735.1,36.96772660845581,1.5,2.75,1.812557970505808,1.02359898326737,-0.6096056685667394,-0.12385017437716785,0.4857554941895715,12.203933920008705,-4.122231337161608,-61402244.0,2000-09-15,2000,4,259,9,1.52,147.14,146.96875,144.20311999999998,178
2000-09-18 13:30:00,146.375,146.96875,144.20311999999998,144.65625,138.01561999999998,154.06709705882352,144.88570275000018,146.56874960000005,148.615937,150.03984299999996,148.44506826943288,148.94121628466846,149.45793230769218,153.74631589702338,145.16954871836103,144.88570275000018,146.56874960000005,148.615937,150.03984299999996,145.27604,5104301,4005910.1,33.08403145076041,1.5,2.75,1.8806345440411063,1.2741925985807818,-0.7692980455539635,-0.4758670627528829,0.2934309828010806,12.24847984472636,-4.379260483371204,-66506545.0,2000-09-18,2000,0,262,9,1.92,145.59,146.3125,144.70311999999998,179
2000-09-19 13:30:00,145.125,146.3125,144.70311999999998,145.96875,137.91562000000002,154.11443176470587,144.89632775000018,146.5684371,148.578437,149.81015549999995,148.34795774906297,148.65812425755718,149.12139384615375,153.7519154749583,144.4908722173492,144.89632775000018,146.5684371,148.578437,149.81015549999995,145.66145666666668,6547801,4215305.15,39.34923015822785,1.5,2.75,1.8646070766095983,1.5533397386426462,-0.7479767294398671,-0.6415399289987533,0.1064368004411138,14.589484963149662,-2.5453786772376383,-59958744.0,2000-09-19,2000,1,263,9,1.11,145.51,146.03125,143.15625,180
2000-09-20 13:30:00,145.6875,146.03125,143.15625,144.89061999999998,137.81562000000002,154.16176647058822,144.90687460000018,146.5664058,148.51312439999998,149.53906149999997,148.21237587655068,148.29931432826604,148.5480761538461,153.28511453943003,143.8110377682621,144.90687460000018,146.5664058,148.51312439999998,149.53906149999997,144.69270666666668,6498500,4389335.15,36.339416983913495,1.5,2.75,1.936777999708913,1.480520347141867,-0.7651768673162657,-0.8500342837042183,-0.08485741638795262,14.250971051871733,-3.9465539672674455,-66457244.0,2000-09-20,2000,2,264,9,2.01,144.59,145.5625,143.75,181
2000-09-21 13:30:00,144.46875,145.5625,143.75,145.1875,137.71562,154.2091011764706,144.9246871000002,146.54765580000003,148.43437440000002,149.25624899999997,148.09375329315657,148.00295105890737,147.99519153846148,152.48801483977326,143.5023682371497,144.9246871000002,146.54765580000003,148.43437440000002,149.25624899999997,144.83333333333334,5346602,4382790.25,37.75139334963101,1.5,2.75,1.9279009997297047,1.219908253651883,-0.7161259278340896,-0.9800148261805646,-0.263888898346475,13.164043374656925,-3.0871923237380057,-61110642.0,2000-09-21,2000,3,265,9,1.26,144.66,145.3125,142.42186999999998,182
2000-09-22 13:30:00,142.625,145.3125,142.42186999999998,145.28125,137.61562,154.25643588235297,144.94749960000019,146.55921830000003,148.34437440000005,148.95468649999995,147.9834590463661,147.74374143424953,147.533653076923,151.80883428394475,143.25847186990126,144.94749960000019,146.55921830000003,148.34437440000005,148.95468649999995,144.33854,7587398,4536040.25,38.21740628387343,1.5,2.75,1.996667356891868,1.6726919475637367,-0.639452514065048,-1.063204540927785,-0.42375202686273705,13.234469482959133,-2.882807603927303,-53523244.0,2000-09-22,2000,4,266,9,2.03,143.87,146.0625,143.71875,183
2000-09-25 13:30:00,145.9375,146.0625,143.71875,144.15625,137.51561999999998,154.30377058823532,144.9612496000002,146.5845308,148.20249940000005,148.59999899999997,147.83337241709685,147.40207558336863,147.10096076923068,151.5149971927496,142.68692434571176,144.9612496000002,146.5845308,148.20249940000005,148.59999899999997,144.64583333333334,9715398,4880790.15,34.84616912300058,1.5,2.75,2.0214589742567344,1.990537945992208,-0.6258055517461054,-1.2060089665453688,-0.5802034147992634,13.446997948040572,-2.9046516522837296,-63238642.0,2000-09-25,2000,0,269,9,1.63,144.89,145.0,142.40625,184
2000-09-26 13:30:00,144.375,145.0,142.40625,142.40625,137.41562000000002,154.35110529411762,144.9639058500002,146.59046830000003,148.03062440000005,148.13203049999996,147.62054408701462,146.92628267066686,146.45192230769223,150.95414938029225,141.94969523509218,144.9639058500002,146.59046830000003,148.03062440000005,148.13203049999996,143.27083333333334,5281199,4869980.2,30.359780117593022,1.5,2.75,2.062336904666968,1.084439521951239,-0.6908374469322729,-1.443750223464605,-0.7529127765323317,14.179895130650374,-4.35512324416408,-68519841.0,2000-09-26,2000,1,270,9,1.82,143.7,143.96875,142.125,185
2000-09-27 13:30:00,143.5625,143.96875,142.125,143.15625,137.31562000000002,154.39844,144.9690621000002,146.58671830000003,147.898437,147.69999949999996,147.44547373066112,146.56723194012716,145.939903076923,150.308937595226,141.57086855862,144.9690621000002,146.58671830000003,147.898437,147.69999949999996,143.08333333333334,6049301,4996035.25,34.265857031541145,1.5,2.75,2.046723554333613,1.2108203199727223,-0.6406559285063355,-1.553732687165251,-0.9130767586589156,14.674461933127356,-3.578194064407493,-62470540.0,2000-09-27,2000,2,271,9,1.3,143.05,146.32811999999998,142.89061999999998,186
2000-09-28 13:30:00,143.1875,146.32811999999998,142.89061999999998,146.125,137.21562,154.44577470588234,144.9959371000002,146.62343710000005,147.84718700000005,147.48906199999996,147.39369044710574,146.525114612496,145.6730761538461,149.5079610148664,141.83819129282577,144.9959371000002,146.62343710000005,147.84718700000005,147.48906199999996,145.11458000000005,6842801,5140745.3,46.95004628457747,1.5,2.75,2.146064729024069,1.3310912330163491,-0.3778358465521263,-1.3853715668490736,-1.0075357202969473,20.32828136634538,0.0213903743315508,-55627739.0,2000-09-28,2000,3,272,9,2.41,144.61,145.96875,143.625,187
2000-09-29 13:30:00,145.46875,145.96875,143.625,143.625,137.11562,154.4931094117647,145.0066402500002,146.6465621,147.707187,147.05312449999997,147.2458986648663,146.2489132208297,145.3004799999999,148.9111339882306,141.68982601176918,145.0066402500002,146.6465621,147.707187,147.05312449999997,144.40625,8311699,5315290.2,39.95769551518789,1.5,2.75,2.171345819808064,1.5637338108086742,-0.3436571801377759,-1.4371071954691672,-1.0934500153313913,20.63144258041878,-0.712896953985742,-63939438.0,2000-09-29,2000,4,273,9,1.63,144.8,144.90625,143.14061999999998,188
2000-10-02 13:30:00,144.28125,144.90625,143.14061999999998,143.84375,137.01561999999998,154.54044411764704,145.0152340000002,146.7037496,147.630312,146.62656199999995,147.1124810701657,146.01985005694115,144.9122592307691,147.9323626188874,141.89215584265085,145.0152340000002,146.7037496,147.630312,146.62656199999995,143.96354,5517801,5433535.25,40.78866442505901,1.5,2.75,2.142366118393201,1.0155084574080937,-0.28029068790202194,-1.4438133752089186,-1.163522687306897,20.00640810841403,-1.4557910511667738,-58421637.0,2000-10-02,2000,0,276,10,1.23,144.02,145.75,142.28125,189
2000-10-03 13:30:00,144.53125,145.75,142.28125,142.5,136.91562000000002,154.58777882352942,145.0142965000002,146.71593710000005,147.543437,146.18749949999997,146.93159945957095,145.68462624199438,144.45312461538455,146.9383571730096,141.96789205775949,145.0142965000002,146.71593710000005,147.543437,146.18749949999997,143.51041666666666,9347199,5728375.2,37.367481110294044,1.5,2.75,2.2371078242222584,1.6317365175381668,-0.30102786867511044,-1.5398075231507846,-1.2387796544756742,19.562129862389764,-1.6499480780743518,-67768836.0,2000-10-03,2000,1,277,10,2.44,144.02,144.25,141.75,190
2000-10-04 13:30:00,142.875,144.25,141.75,143.6875,136.81562000000002,154.63511352941177,145.0244527500002,146.7246871,147.47093700000005,145.88281199999997,146.80437987292117,145.4944237427568,144.26802846153836,146.5899891444127,141.94606777866403,145.0244527500002,146.7246871,147.47093700000005,145.88281199999997,143.22916666666666,6149000,5827620.1,41.997506264083746,1.5,2.75,2.255885836777811,1.055147709439742,-0.21116796010569816,-1.5027396046077968,-1.2915716445020986,20.157612630402703,-1.0331467929401636,-61619836.0,2000-10-04,2000,2,278,10,1.76,143.0,144.84375,143.3125,191
2000-10-05 13:30:00,143.40625,144.84375,143.3125,144.1875,136.71562,154.68244823529415,145.02632775000018,146.7137496,147.43718700000005,145.54999949999996,146.7017571328066,145.36995481487526,144.23197076923068,146.54323059342795,141.9207109450334,145.02632775000018,146.7137496,147.43718700000005,145.54999949999996,144.11458333333334,4566898,5852025.0,43.878694720734465,1.5,2.75,2.2041261341508247,0.7803961876444478,-0.1000918928304262,-1.4166865105401314,-1.3165946177097052,20.24842378221736,-0.7528500752850076,-57052938.0,2000-10-05,2000,3,279,10,1.07,144.08,144.64061999999998,139.75,192
2000-10-06 13:30:00,143.875,144.64061999999998,139.75,141.0625,136.61562,154.72978294117647,145.01070275000018,146.65874960000005,147.35093700000004,145.11249949999996,146.48060979426515,144.95972102298234,143.85456692307682,146.48800583644098,141.22112800971266,145.01070275000018,146.65874960000005,147.35093700000004,145.11249949999996,141.81770666666668,10014898,6178964.9,36.01638036206319,1.5,2.75,2.3960185531400526,1.6208051287036764,-0.21265164096344533,-1.5824091689140118,-1.3697575279505665,23.561305736374198,-2.1461088228918275,-67067836.0,2000-10-06,2000,4,280,10,3.5,142.2,141.3125,139.375,193
2000-10-09 13:30:00,141.3125,141.3125,139.375,140.0,136.51561999999998,154.77711764705882,144.9782809000002,146.6071871,147.309062,144.63281199999997,146.2264682337057,144.48736663984116,143.4783653846153,146.73569666968436,140.22103409954622,144.9782809000002,146.6071871,147.309062,144.63281199999997,140.22916666666666,4508000,6207674.9,33.7988852013421,1.5,2.75,2.363267227915763,0.7261978232784065,-0.3273728099266593,-1.7789735403588909,-1.4516007304322314,23.545681963054747,-1.6897081413210446,-71575836.0,2000-10-09,2000,0,283,10,1.39,140.34,141.25,137.6875,194
2000-10-10 13:30:00,140.09375,141.25,137.6875,137.6875,136.41562000000002,154.82445235294114,144.9353121500002,146.5459371,147.204687,144.09374949999997,145.89160673434472,143.8397602931896,142.90144230769218,147.22558671464168,138.5772979007427,144.9353121500002,146.5459371,147.204687,144.09374949999997,138.875,6104699,6275784.85,29.536444777749036,1.5,2.75,2.448926711636066,0.9727387324312116,-0.5164607732653406,-2.0971766970139067,-1.5807159237485666,24.310470174577947,-3.8201266099105,-77680535.0,2000-10-10,2000,1,284,10,2.59,139.47,138.625,135.125,195
2000-10-11 13:30:00,137.625,138.625,135.125,136.53125,136.31562000000002,154.87178705882351,144.88703090000018,146.49999960000005,147.057812,143.47578099999996,145.52453392123317,143.14371169383818,142.2283653846153,147.48473655396054,136.97199421527003,144.88703090000018,146.49999960000005,147.057812,143.47578099999996,136.76041666666666,10366000,6566329.75,27.65827145230217,1.5,2.75,2.5240033750906323,1.5786596766633598,-0.6672818067423723,-2.414818182176532,-1.7475363754341595,23.798805002524293,-6.565440547476474,-88046535.0,2000-10-11,2000,2,285,10,2.59,136.88,137.59375,132.78125,196
2000-10-12 13:30:00,137.28125,137.59375,132.78125,133.125,136.21562,154.91912176470586,144.8185934000002,146.43062460000004,146.828437,142.70859349999995,145.03827768902798,142.18954867537744,141.3798076923076,148.38726620821424,134.37234917640095,144.8185934000002,146.43062460000004,146.828437,142.70859349999995,134.5,12336801,7013599.8,23.01523298430803,1.5,2.75,2.687467419727016,1.7589827409314116,-0.9282804555158626,-2.9078869448289884,-1.979606489313125,20.265036144487947,-7.310704960835509,-100383336.0,2000-10-12,2000,3,286,10,3.62,135.19,137.65625,132.875,197
2000-10-13 13:30:00,132.9375,137.65625,132.875,137.5625,136.11562,154.96645647058818,144.77320280000018,146.4262496,146.66781200000003,142.28203099999996,144.74510993651703,141.74887737296058,141.00721153846143,148.26728220681954,133.74714087010332,144.77320280000018,146.4262496,146.66781200000003,142.28203099999996,136.03125,11776801,7398654.85,37.690282060439685,1.5,2.75,2.8370233183179434,1.5917489379843148,-0.7419687791137806,-2.907067463205351,-2.1650986840915705,30.714757403460627,-4.366717358244623,-88606535.0,2000-10-13,2000,4,287,10,3.6,135.27,138.23436999999998,136.6875,198
2000-10-16 13:30:00,137.40625,138.23436999999998,136.6875,138.1875,136.01561999999998,155.0137911764706,144.7297653000002,146.4056246,146.504062,141.95859349999995,144.48794876253598,141.40969857553574,140.62499999999991,147.91537992310163,133.33462007689812,144.7297653000002,146.4056246,146.504062,141.95859349999995,137.70312333333334,5659000,7426389.8,39.44124923689339,1.5,2.75,2.7448695098666627,0.7620122498821702,-0.5266721690475755,-2.8234388954010403,-2.2967667263534643,30.970961811616306,-3.0263157894736836,-82947535.0,2000-10-16,2000,0,290,10,1.13,137.46,138.5625,134.40625,199
2000-10-17 13:30:00,138.4375,138.5625,134.40625,134.75,135.91562000000002,155.06112588235294,144.67632780000022,146.37468710000005,146.23656200000005,141.39765599999996,144.10606841890709,140.77544156834188,139.74999999999991,146.91935418452283,132.58064581547694,144.67632780000022,146.37468710000005,146.23656200000005,141.39765599999996,135.90625,7831699,7490584.7,33.813222469191444,1.5,2.75,2.8456824020190443,1.0455390752073066,-0.5625534350037724,-2.99995852010818,-2.437405085104408,33.21531437267222,-6.2200956937799035,-90779234.0,2000-10-17,2000,1,291,10,3.09,136.48,136.125,130.15625,200
2000-10-18 13:30:00,132.625,136.125,130.15625,134.25,130.15625,155.10846058823532,144.64882780000022,146.33718710000005,145.947812,140.86562499999997,143.7195559318911,140.15397094278552,139.02884615384605,146.3777840324692,131.67990827522289,144.64882780000022,146.33718710000005,145.947812,140.86562499999997,133.51041666666666,10897301,7710524.75,33.07395165591093,1.5,2.75,3.0687586590176834,1.4133021231791,-0.5652406117387114,-3.1439558497777966,-2.5787152380390848,32.07554114589091,-6.8920676202860855,-101676535.0,2000-10-18,2000,2,292,10,4.59,133.14,139.45311999999998,136.4375,201
2000-10-19 13:30:00,136.84375,139.45311999999998,136.4375,139.28125,129.9569628070175,155.1557952941176,144.64523405000025,146.3028121,145.78468700000005,140.57031249999994,143.5455047188758,140.07085466252022,138.6778846153845,145.48967377270236,131.86609545806664,144.64523405000025,146.3028121,145.78468700000005,140.57031249999994,138.39062333333334,8767301,7881559.7,45.89312515675706,1.5,2.75,3.221213040516421,1.1123814744434404,-0.1927017594992968,-2.819592437413206,-2.6268906779139094,40.53671125510468,-1.2627381479840496,-92909234.0,2000-10-19,2000,3,293,10,2.21,137.95,141.1875,138.375,202
2000-10-20 13:30:00,138.375,141.1875,138.375,139.90625,129.7576756140351,155.20313000000002,144.65601530000018,146.2737496,145.648437,140.30156249999996,143.40278884754733,140.0551780279945,138.4783653846153,144.97533142097274,131.98139934825778,144.65601530000018,146.2737496,145.648437,140.30156249999996,139.82291666666666,7373500,7870864.8,47.2449416881843,1.5,2.75,3.1920192519081048,0.9368093833856732,0.11473502123228928,-2.483471901373548,-2.5982069226058373,38.94320214976335,-0.06696428571428571,-85535734.0,2000-10-20,2000,4,294,10,2.03,139.78,141.03125,138.9375,203
2000-10-23 13:30:00,139.9375,141.03125,138.9375,140.53125,129.55838842105265,155.25046470588234,144.6299215500002,146.2259371,145.5124996,140.12031249999995,143.29017948097686,140.10051821580453,138.23557692307682,144.1450815404325,132.32607230572114,144.6299215500002,146.2259371,145.5124996,140.12031249999995,140.16666666666666,5290000,7649594.9,48.62718144446186,1.5,2.75,3.1135714482003833,0.6915398879488376,0.3649892363964207,-2.141970377110312,-2.506959613506732,38.79315846732872,2.0653654108034503,-80245734.0,2000-10-23,2000,0,297,10,1.51,139.98,141.9375,139.0,204
2000-10-24 13:30:00,140.96875,141.9375,139.0,139.59375,129.35910122807022,155.2977994117647,144.59664030000022,146.1434371,145.31874960000005,139.97968749999995,143.145221462115,140.0522545762041,137.88221153846143,142.79039212666936,132.9740309502535,144.59664030000022,146.1434371,145.31874960000005,139.97968749999995,140.17708333333334,5750699,7673069.9,46.65261737814847,1.5,2.75,3.1009949161860697,0.7494652173050059,0.4657368037743099,-1.9247886087888448,-2.3905254125631545,37.59824949038497,2.243076218814374,-85996433.0,2000-10-24,2000,1,298,10,2.11,140.47,139.5625,136.125,205
2000-10-25 13:30:00,138.75,139.5625,136.125,136.3125,129.15981403508772,155.34513411764704,144.55664030000025,146.0353121,145.0618746,139.63749999999996,142.8772716008556,139.69608747370847,137.51682692307682,142.12142168260613,132.91223216354751,144.55664030000025,146.0353121,145.0618746,139.63749999999996,137.33333333333334,9136102,7827409.95,40.46004339537791,1.5,2.75,3.1272631364584935,1.1671934980229317,0.3168609888281173,-1.994449176528008,-2.311310165356125,40.01238898931342,2.3943661971830985,-95132535.0,2000-10-25,2000,2,299,10,2.53,137.84,137.65625,134.03125,206
2000-10-26 13:30:00,137.125,137.65625,134.03125,136.6875,128.96052684210522,155.39246882352938,144.52476530000018,145.93749960000005,144.8231246,139.16562499999995,142.63453545964555,139.40955533335529,137.2620192307691,141.65029157551638,132.87374688602188,144.52476530000018,145.93749960000005,144.8231246,139.16562499999995,136.125,9345801,7952559.95,41.41711097548018,1.5,2.75,3.162815769568602,1.175194032960418,0.2519415331202417,-1.9963832489558229,-2.248324782076065,36.67965788541379,-0.6360745115856429,-85786734.0,2000-10-26,2000,3,300,10,2.7,135.84,139.28125,136.625,207
2000-10-27 13:30:00,137.875,139.28125,136.625,139.28125,128.76123964912279,155.43980352941176,144.49617155000018,145.8554684,144.6049996,138.94843749999995,142.50303406907122,139.39733577779765,137.3846153846153,141.90077125343132,132.8684595157993,144.49617155000018,145.8554684,144.6049996,138.94843749999995,138.39583333333334,9762898,8025119.9,47.68139932979777,1.5,2.75,3.126632500313701,1.2165423223147107,0.3840686978994512,-1.7682389097017506,-2.1523076076012018,33.192852891673496,0.7914970601537765,-76023836.0,2000-10-27,2000,4,301,10,1.94,137.95,141.09375,138.15625,208
2000-10-30 14:30:00,138.4375,141.09375,138.15625,140.53125,128.56195245614038,155.48713823529408,144.46398405000022,145.7917184,144.42187460000005,138.78281249999995,142.4257092036175,139.50532760848358,137.6923076923076,142.4713714932731,132.9132438913421,144.46398405000022,145.7917184,144.42187460000005,138.78281249999995,139.92708333333334,10154102,8256934.95,50.432248368724956,1.5,2.75,3.11312303600558,1.2297665007037508,0.5461441866584322,-1.4696273742781614,-2.0157715609365936,33.447051650879644,4.290352504638219,-65869734.0,2000-10-30,2000,0,304,10,2.13,139.62,143.6875,140.0625,209
2000-10-31 14:30:00,141.01561999999998,143.6875,140.0625,142.95311999999998,128.36266526315788,155.53447294117646,144.44968715000022,145.7553121,144.269687,138.80546849999996,142.44639197994618,139.833688788628,138.44831692307682,143.20756419012378,133.68906965602986,144.44968715000022,145.7553121,144.269687,138.80546849999996,142.23437333333334,7752398,8177194.9,55.33259558047429,1.5,2.75,3.149685676290896,0.9480510241965736,0.7920356723776831,-1.0257269704644898,-1.817762642842173,29.60602593756044,6.4827709497206785,-58117336.0,2000-10-31,2000,1,305,10,2.59,141.88,143.25,141.21875,210
2000-11-01 14:30:00,142.25,143.25,141.21875,142.46875,128.16337807017544,155.5818076470588,144.4307809000002,145.7312496,144.11281200000005,138.74453099999997,142.44726876504637,140.08464699923485,138.82572076923068,144.0038251199774,133.64761641848398,144.4307809000002,145.7312496,144.11281200000005,138.74453099999997,142.3125,6753602,8207425.0,54.17895805561336,1.5,2.75,3.0697974136986885,0.8228649058626792,0.8902967064049707,-0.7048917598359594,-1.59518846624093,29.5681973718865,2.288534888938748,-64870938.0,2000-11-01,2000,2,306,11,1.44,142.23,143.90625,142.51561999999998,211
2000-11-02 14:30:00,143.15625,143.90625,142.51561999999998,142.70311999999998,127.96409087719296,155.62914235294116,144.4205465000002,145.6823433,143.94999940000002,138.67031199999997,142.45730214680924,140.33402538026007,139.17307615384607,144.7256184486624,133.6205338590297,144.4205465000002,145.6823433,143.94999940000002,138.67031199999997,143.04166333333333,11395102,8548835.2,54.67141690010233,1.5,2.75,2.9532047412916387,1.3329420597556965,0.934713969026418,-0.42679600495790737,-1.3615099739843255,22.103388748313623,1.9991029707393435,-53475836.0,2000-11-02,2000,3,307,11,0.98,143.21,143.75,142.375,212
2000-11-03 14:30:00,143.46875,143.75,142.375,142.78125,127.7648036842105,155.6764770588235,144.4122652500002,145.63171830000005,143.77937440000005,138.75624949999997,142.47000598418927,140.56709439166391,139.79086461538452,145.01487903257387,134.56685019819514,144.4122652500002,145.63171830000005,143.77937440000005,138.75624949999997,142.96875,5187102,8307445.4,54.84563976949955,1.5,2.75,2.84047583119938,0.6243919460487817,0.9309532985517192,-0.1978183507946767,-1.1287716493463955,22.085099736584677,1.6010673782521683,-48288734.0,2000-11-03,2000,4,308,11,0.97,143.06,144.29686999999998,143.03125,213
2000-11-06 14:30:00,143.15625,144.29686999999998,143.03125,143.78125,127.56551649122808,144.29686999999998,144.4294527500002,145.58796830000003,143.6299994,138.94531199999997,142.52142731814263,140.8732044496007,140.52403769230762,145.06199726405129,135.98607812056395,144.4294527500002,145.58796830000003,143.6299994,138.94531199999997,143.70312333333334,4042500,8284170.4,57.11749187454946,1.5,2.75,2.7458432718279964,0.4879788566396461,0.9539025323982102,0.06360651615136703,-0.8902960162468432,22.232909311002683,2.999776136109245,-44246234.0,2000-11-06,2000,0,311,11,0.88,143.66,144.0,142.5625,214
2000-11-07 14:30:00,143.14061999999998,144.0,142.5625,143.75,127.3662292982456,144.0902726666667,144.4385152500002,145.55953080000003,143.46968700000005,139.24843699999997,142.56960663899974,141.14718497821013,140.86778769230762,145.64767115541778,136.08790422919745,144.4385152500002,145.55953080000003,143.46968700000005,139.24843699999997,143.4375,5231301,8240500.5,57.020942501258574,1.5,2.75,2.65239018098314,0.6348280665719273,0.9244038774184388,0.2652088305262055,-0.6591950468922334,21.57839463762529,5.456212746446584,-49477535.0,2000-11-07,2000,1,312,11,1.01,143.28,144.0625,140.5625,215
2000-11-08 14:30:00,144.0625,144.0625,140.5625,140.5625,127.16694210526316,143.88367533333334,144.4372652500002,145.4804683,143.2449996,139.44999949999996,142.4908965747253,141.0915006945711,140.91826846153842,145.6702460929154,136.1662908301614,144.4372652500002,145.4804683,143.2449996,139.44999949999996,141.72916666666666,6123301,8028365.55,48.091341091038075,1.5,2.75,2.712933739484344,0.7627082949654678,0.6600468651962137,0.1658635346030337,-0.49418333059318,20.96788885106593,2.83493369913123,-55600836.0,2000-11-08,2000,2,313,11,2.49,142.31,141.21875,137.25,216
2000-11-09 14:30:00,140.0,141.21875,137.25,140.03125,126.96765491228071,143.67707800000005,144.4361715000002,145.40140580000005,143.03874960000005,139.79531199999997,142.39443984630466,140.99052443794525,140.87980692307684,145.6517436294684,136.10787021668528,144.4361715000002,145.40140580000005,143.03874960000005,139.79531199999997,139.5,10635301,7943290.55,46.776542491444644,1.5,2.75,2.802634900949748,1.338903686457749,0.4303545052230156,0.04375980093558951,-0.3865947042874261,21.33581417547894,0.5384787973973525,-66236137.0,2000-11-09,2000,3,314,11,2.89,139.23,139.46875,136.53125,217
2000-11-10 14:30:00,139.0,139.46875,136.53125,136.625,126.76836771929823,143.47048066666667,144.4399215000002,145.28921830000004,142.7243746,139.74843699999997,142.16818730331232,140.57476020576001,140.65144153846146,145.90730901658182,135.39557406034112,144.4399215000002,145.28921830000004,142.7243746,139.74843699999997,137.54166666666666,8569500,7782925.5,39.34837904864051,1.5,2.75,2.852446693739052,1.1010641178564538,0.049973482327022256,-0.3241278513786483,-0.37410133370567056,23.566303244229328,-2.779630865021125,-74805637.0,2000-11-10,2000,4,315,11,2.15,138.0,136.98436999999998,133.01561999999998,218
2000-11-13 14:30:00,135.625,136.98436999999998,133.01561999999998,135.5625,126.5690805263158,143.26388333333338,144.41960900000018,145.1885933,142.3881246,139.61718699999997,141.90914074239808,140.09740209092573,140.5937492307691,146.0514497230574,135.13604873848087,144.41960900000018,145.1885933,142.3881246,139.61718699999997,135.18749666666668,17285296,8364240.3,37.35565661307879,1.5,2.75,2.9321826441862617,2.0665709472741955,-0.255457323496566,-0.6934229880763779,-0.4379656645798121,22.687390715464673,-5.169960613661326,-92090933.0,2000-11-13,2000,0,318,11,2.98,135.0,139.625,137.0,219
2000-11-14 14:30:00,137.46875,139.625,137.0,139.125,126.36979333333332,143.057286,144.41054650000018,145.13609330000003,142.1449996,139.83593699999997,141.79995875250015,140.0047923679804,140.7812492307691,145.8423381271801,135.72016033435818,144.41054650000018,145.13609330000003,142.1449996,139.83593699999997,138.58333333333334,7668898,8356100.25,47.0401579401424,1.5,2.75,3.012919598172957,0.9177604110242694,-0.2021606636737784,-0.6906664941720351,-0.4885058304982567,25.964559184877142,-2.3470059223513933,-84422035.0,2000-11-14,2000,1,319,11,1.92,138.31,140.10936999999998,137.75,220
2000-11-15 14:30:00,139.0625,140.10936999999998,137.75,139.5625,126.17050614035088,142.85068866666668,144.4030465000002,145.0693746,141.9406246,140.10156199999997,141.71221527200996,139.9626692853156,140.80288384615375,145.84048965465823,135.7652780376493,144.4030465000002,145.0693746,141.9406246,140.10156199999997,139.14062333333334,8837699,8253120.15,48.10126700526194,1.5,2.75,2.9662374840177472,1.0708312540439628,-0.12578391145094525,-0.6457357198119382,-0.519951808360993,26.171364245027092,-2.2008068218830896,-75584336.0,2000-11-15,2000,2,320,11,1.71,138.93,139.875,137.3125,221
2000-11-16 14:30:00,139.5625,139.875,137.3125,137.375,125.97121894736841,142.64409133333334,144.37398400000018,144.9915621,141.6712496,140.00624949999997,141.5421283985978,139.71622459147602,140.5600953846153,145.92055135117812,135.19963941805247,144.37398400000018,144.9915621,141.6712496,140.00624949999997,138.1875,6684102,8148960.2,43.41713434227851,1.5,2.75,2.9373990923021935,0.8202398632404659,-0.206179480549298,-0.7776761590476156,-0.5714966784983175,27.16072829117603,-3.7863865178376015,-82268438.0,2000-11-16,2000,3,321,11,1.87,138.59,139.0,135.75,222
2000-11-17 14:30:00,137.3125,139.0,135.75,136.64061999999998,125.77193175438595,142.43749400000004,144.3442183500002,144.9023433,141.407812,139.84296799999998,141.34991238296655,139.4233098684783,140.07451846153842,145.6203444097236,134.5286925133532,144.3442183500002,144.9023433,141.407812,139.84296799999998,137.13020666666668,6551102,8107840.3,41.940530308159104,1.5,2.75,2.9597277285663237,0.8079959345030513,-0.287417786498977,-0.9307689116220388,-0.6433511251230618,27.025896459752797,-4.9663151488806685,-88819540.0,2000-11-17,2000,4,322,11,2.39,137.38,136.375,134.3125,223
2000-11-20 14:30:00,135.75,136.375,134.3125,134.6875,125.57264456140352,142.23089666666667,144.3057808500002,144.8073433,141.109687,139.55078049999997,141.08864130912468,138.97228035719462,139.47596076923068,145.51653381658795,133.43538772187338,144.3057808500002,144.8073433,141.109687,139.55078049999997,135.125,5458500,8116265.3,38.21780177073917,1.5,2.75,2.9146128908115867,0.6725383902864782,-0.4420477136697965,-1.195910767210307,-0.7538630535405109,26.514117768361622,-6.304347826086956,-94278040.0,2000-11-20,2000,0,325,11,1.54,135.34,136.1875,133.51561999999998,224
2000-11-21 14:30:00,134.875,136.1875,133.51561999999998,135.375,125.37335736842104,142.02429933333337,144.26109335000018,144.7082808,140.847812,139.33984299999997,140.86457694406099,138.62968222793802,138.91225923076914,145.01043421421932,132.81408424731896,144.26109335000018,144.7082808,140.847812,139.33984299999997,135.02604,7684301,8212945.4,40.22896215834852,1.5,2.75,2.8972748271821867,0.9356327877207122,-0.4650464153072014,-1.3351710726745123,-0.8701246573673111,27.142855466922068,-3.690529124055136,-86593739.0,2000-11-21,2000,1,326,11,2.0,134.85,134.875,132.125,225
2000-11-22 14:30:00,134.34375,134.875,132.125,132.14061999999998,125.1740701754386,141.81770200000003,144.21539020000014,144.55687450000005,140.51281200000003,139.13124899999997,140.52246098547036,138.01167630146773,138.0937492307691,144.7278498342704,131.45964862726782,144.21539020000014,144.55687450000005,140.51281200000003,139.13124899999997,133.04687333333334,5736898,8042985.2,34.53352251961368,1.5,2.75,2.9224694823834594,0.7132796912270832,-0.6535608694809996,-1.6870757442185609,-1.0335148747375609,27.54688920360257,-5.634906494086133,-92330637.0,2000-11-22,2000,2,327,11,2.08,133.5,134.96875,133.625,226
2000-11-24 14:30:00,133.625,134.96875,133.625,134.84375,124.97478298245613,141.61110466666668,144.18179645000018,144.45906200000005,140.24031200000002,139.03906149999997,140.29976643702054,137.70996903466127,137.4062492307691,143.35751267533368,131.4549857862046,144.18179645000018,144.45906200000005,140.24031200000002,139.03906149999997,134.47916666666666,3411600,7746275.15,41.93265747562467,1.5,2.75,2.915730947927497,0.4404181279308159,-0.555527537061131,-1.7279242960639751,-1.172396759002844,31.47374126757287,-1.303751143641354,-88919037.0,2000-11-24,2000,4,329,11,1.01,134.3,136.6875,135.3125,227
2000-11-27 14:30:00,136.46875,136.6875,135.3125,136.03125,124.77549578947368,141.40450733333338,144.16851520000014,144.3618745,140.039062,138.87656149999998,140.13237363556874,137.5500910313602,136.8124992307691,141.52488667587272,132.10011178566558,144.16851520000014,144.3618745,140.039062,138.87656149999998,136.01041666666666,5992000,7557730.25,44.8799480963749,1.5,2.75,2.8391608802183903,0.7928306253057921,-0.37848847881865,-1.6455073575261563,-1.2670188787075063,29.131276671227198,0.3457814661134163,-82927037.0,2000-11-27,2000,0,332,11,1.02,136.0,136.59375,133.64061999999998,228
2000-11-28 14:30:00,135.125,136.59375,133.64061999999998,133.6875,124.57620859649124,141.19791,144.1394527000002,144.217812,139.81968700000002,138.534374,139.87963349299739,137.1822252188497,136.283653076923,140.72952349518414,131.8377826586619,144.1394527000002,144.217812,139.81968700000002,138.534374,134.64062333333334,5336102,7316830.25,40.509642813051045,1.5,2.75,2.847301531631361,0.7292914852028992,-0.3857043157546376,-1.7491492734008034,-1.3634449576461658,30.499917187655644,-3.908355795148248,-88263139.0,2000-11-28,2000,1,333,11,2.21,135.12,135.90625,133.26561999999998,229
2000-11-29 14:30:00,134.375,135.90625,133.26561999999998,133.4375,124.37692140350876,140.9913126666667,144.10117145000018,144.07374950000005,139.569062,138.05859299999997,139.6270008069975,136.8255847218164,135.77644153846146,139.88835334646402,131.66452973045892,144.10117145000018,144.07374950000005,139.569062,138.05859299999997,134.20312333333334,6914102,7274915.45,40.061516728718075,1.5,2.75,2.8325392793719777,0.950403073069392,-0.3735319535083708,-1.8303598995316293,-1.4568279460232585,25.08806762334587,-4.38871473354232,-95177241.0,2000-11-29,2000,2,334,11,1.98,134.59,133.5,129.75,230
2000-11-30 14:30:00,132.5,133.5,129.75,132.28125,129.75,140.78471533333334,144.0666402000002,143.91499950000005,139.3168746,137.54921799999997,139.33893214789958,136.39279093878628,135.44230692307684,139.91428208545062,130.97033176070306,144.0666402000002,143.91499950000005,139.3168746,137.54921799999997,131.84375,11201602,7497315.45,37.96946367839897,1.5,2.75,2.898072187988265,1.4940817249459604,-0.4068289419242959,-1.9653641234286283,-1.5585351815043325,24.743783327649275,-3.707916287534122,-106378843.0,2000-11-30,2000,3,335,11,2.89,131.62,134.0625,131.0,231
2000-12-01 14:30:00,133.1875,134.0625,131.0,132.21875,129.73645833333333,140.57811800000002,144.0363277000002,143.74593700000003,139.0574996,137.02499949999998,139.05970931857019,135.99526323033044,135.1850953846153,139.97329073442222,130.39690003480834,144.0363277000002,143.74593700000003,139.0574996,137.02499949999998,132.42708333333334,7587199,7306920.3,37.854390391784,1.5,2.75,2.9098170317033887,1.0383579796265192,-0.3961519400419149,-2.0537251065567257,-1.6575731665148112,23.929321570341145,-3.236131393431918,-113966042.0,2000-12-01,2000,4,336,12,2.34,132.53,133.875,131.5,232
2000-12-04 14:30:00,131.875,133.875,131.5,133.34375,129.72291666666666,140.3715206666667,144.02648395000014,143.58156200000005,138.81874960000002,136.55312449999997,138.83555405117528,135.74273816077516,134.74038384615378,139.03022385271495,130.45054383959254,144.02648395000014,143.58156200000005,138.81874960000002,136.55312449999997,132.90625,6996398,7397385.1,41.30276836104756,1.5,2.75,2.8716158151531475,0.9457933993459392,-0.2817862128517481,-2.0098059325794964,-1.7280197197277485,24.899286145178234,-0.9976798143851509,-106969644.0,2000-12-04,2000,0,339,12,1.81,132.69,138.25,134.40625,233
2000-12-05 14:30:00,134.875,138.25,134.40625,137.71875,129.709375,140.16492333333335,144.0402339500002,143.44624950000005,138.68999960000002,136.24999949999997,138.79175781387428,135.93092976451086,134.59855692307684,138.32642416328136,130.87068968287232,144.0402339500002,143.44624950000005,138.68999960000002,136.24999949999997,136.79166666666666,8883398,7639430.0,52.371162365468045,1.5,2.75,3.0169468283564944,1.162835185347598,0.09962401336316096,-1.6034897030237971,-1.703113716386958,30.469941482590386,1.7313019390581716,-98086246.0,2000-12-05,2000,1,340,12,2.86,136.33,138.34375,135.03125,234
2000-12-06 14:30:00,137.78125,138.34375,135.03125,135.51561999999998,129.69583333333333,139.95832600000003,144.03499955000018,143.29140569999998,138.552187,135.83828049999997,138.66328182117334,135.89137645360506,134.45552769230758,137.87635322732658,131.03470215728868,144.03499955000018,143.29140569999998,138.552187,135.83828049999997,136.29687333333334,12888000,8022264.95,47.512450226312545,1.5,2.75,3.0380577691881734,1.6065288394644706,0.20839045157920788,-1.442625651912948,-1.651016103492156,32.12353297808469,2.554097294230949,-110974246.0,2000-12-06,2000,2,341,12,2.45,136.69,135.875,133.65625,235
2000-12-07 14:30:00,134.875,135.875,133.65625,133.65625,129.68229166666666,139.75172866666668,144.03421830000016,143.130312,138.362187,135.49296799999996,138.46692763210768,135.67850726754745,134.22596076923068,137.42263007704685,131.02929146141452,144.03421830000016,143.130312,138.362187,135.49296799999996,134.39583333333334,6529102,8042555.0,43.81766996393088,1.5,2.75,2.9795357856747318,0.8118193782945843,0.16203032516795202,-1.4484781970322158,-1.610508522200168,29.72273095651236,-0.880648899188876,-117503348.0,2000-12-07,2000,3,342,12,1.66,134.77,139.125,133.875,236
2000-12-08 14:30:00,137.0625,139.125,133.875,133.96875,129.66875,139.54513133333336,144.03742145000018,142.9831245,138.119062,135.18984299999997,138.29052850927997,135.51567324206673,134.17067230769223,137.3583484804646,130.98299613491986,144.03742145000018,142.9831245,138.119062,135.18984299999997,135.65625,10276102,8024595.05,44.59746366014802,1.5,2.75,3.15733680098368,1.280575771857796,0.15910451741146206,-1.4116278754358405,-1.5707323928473025,27.183788535126386,-1.516195727084769,-107227246.0,2000-12-08,2000,4,343,12,3.92,136.5,139.5625,136.71875,237
2000-12-11 14:30:00,137.375,139.5625,136.71875,138.625,129.65520833333332,139.5625,144.04992145000014,142.86312450000003,138.01906200000002,135.28984299999996,138.3036450383278,135.81179959996513,134.42067230769223,138.3665479731275,130.47479664225693,144.04992145000014,142.86312450000003,138.01906200000002,135.28984299999996,138.30208333333334,6405602,7916400.15,54.68894838132102,1.5,2.75,3.3313663151991313,0.8091559141309955,0.4604012206317276,-0.9952308670576429,-1.4556320876893705,33.54834083477654,3.6933146330060778,-100821644.0,2000-12-11,2000,0,346,12,2.08,138.14,138.8125,137.375,238
2000-12-12 14:30:00,138.1875,138.8125,137.375,138.03125,129.64166666666668,139.36523458333335,144.05289020000018,142.76656200000005,137.902812,135.41328049999998,138.292962879962,136.02317582853988,134.8737976923076,139.0162877184805,130.73130766613468,144.05289020000018,142.76656200000005,137.902812,135.41328049999998,138.07291666666666,5022898,7303280.25,53.354359967647255,1.5,2.75,3.1960901498277643,0.6877591750638352,0.6004921463566266,-0.7050169047435872,-1.305509051100214,31.58591996628171,3.442622950819672,-105844542.0,2000-12-12,2000,1,347,12,1.05,138.09,139.40625,136.03125,239
2000-12-13 14:30:00,139.25,139.40625,136.03125,136.14061999999998,129.628125,139.16796916666667,144.04140580000018,142.65953069999998,137.77562440000003,135.26406149999997,138.20855727682624,136.03436098772656,134.97355692307684,139.17045276852014,130.77666107763358,144.04140580000018,142.65953069999998,137.77562440000003,135.26406149999997,137.19270666666668,6070500,7223360.35,49.23430338100422,1.5,2.75,3.208869424840067,0.8403983334432429,0.5480661210860698,-0.6204263997426267,-1.1684925208286965,32.99176779917852,2.9175487833687788,-111915042.0,2000-12-13,2000,2,348,12,2.48,137.72,136.5,134.03125,240
2000-12-14 14:30:00,135.875,136.5,134.03125,134.40625,129.61458333333334,138.97070374999998,144.02078080000018,142.53046819999997,137.58999939999998,135.00624899999997,138.05944718753895,135.87930279841927,134.84855692307684,139.00863404502638,130.6884798011273,144.02078080000018,142.53046819999997,137.58999939999998,135.00624899999997,134.97916666666666,7778398,7170395.3,45.74456656966275,1.5,2.75,3.156003751637205,1.0847934701731161,0.3864454540750815,-0.6854357032348446,-1.0718811573099258,33.55925867090661,1.6544552115339164,-119693440.0,2000-12-14,2000,3,349,12,1.84,135.27,133.125,130.5625,241
2000-12-15 14:30:00,133.125,133.125,130.5625,130.96875,129.60104166666667,138.77343833333333,143.96999955000018,142.38140570000004,137.32562439999998,134.68593649999997,137.78138063116486,135.41163110333173,134.63942230769223,139.25983018988734,130.01901442549712,143.96999955000018,142.38140570000004,137.32562439999998,134.68593649999997,131.55208333333334,9065301,7289455.25,39.73331005379501,1.5,2.75,3.2051284836631186,1.2436184446018788,0.05528555836566063,-1.0027742093528502,-1.0580597677185108,37.10955943749508,-1.7811108507147881,-128758741.0,2000-12-15,2000,4,350,12,1.96,131.84,133.46875,131.76561999999998,242
2000-12-18 14:30:00,132.0625,133.46875,131.76561999999998,132.71875,129.5875,138.57617291666668,143.9345308000002,142.25484319999998,137.1587494,134.48984299999998,137.58284609660942,135.15516623634778,134.58413384615378,139.27737532205296,129.8908923702545,143.9345308000002,142.25484319999998,137.1587494,134.48984299999998,132.65104,7235398,7323670.05,43.7834493799648,1.5,2.75,3.154762163401468,0.9879470198141982,-0.033850168338898534,-1.100372478142134,-1.0665223098032357,37.65253142978524,-3.6305877013841616,-121523343.0,2000-12-18,2000,0,353,12,1.29,132.62,134.96875,130.01561999999998,243
2000-12-19 14:30:00,132.46875,134.96875,130.01561999999998,130.01561999999998,129.57395833333334,138.3789075,143.8993745500002,142.1340619,136.95906180000003,134.25624899999997,137.28609213203646,134.66568564240987,134.40985461538455,139.57659344819652,129.2431157825726,143.8993745500002,142.1340619,136.95906180000003,134.25624899999997,131.66666333333333,9616699,7531580.0,39.38101312769265,1.5,2.75,3.2832170088727906,1.2768501429978836,-0.2507283945103929,-1.3799328029412266,-1.1292044084308337,32.73749857141179,-4.0585727313205675,-131140042.0,2000-12-19,2000,1,354,12,3.81,132.49,128.9375,126.09375,244
2000-12-20 14:30:00,128.625,128.9375,126.09375,126.25,129.56041666666667,138.18164208333332,143.84624955000018,141.9674994,136.7303118,133.799999,136.85330420528993,133.86419177170416,133.95071999999993,140.64862314407608,127.25281685592378,143.84624955000018,141.9674994,136.7303118,133.799999,127.09375,9994199,7647074.9,34.219149190899955,1.5,2.75,3.328835079667592,1.3069309678135883,-0.6035381984755106,-1.8836271565252216,-1.2800889580497112,35.07068793033428,-5.541267243394903,-141134241.0,2000-12-20,2000,2,355,12,2.26,127.52,128.85936999999998,125.53125,245
2000-12-21 14:30:00,126.0,128.85936999999998,125.53125,127.125,125.53125,137.98437666666666,143.7774995500002,141.79999940000005,136.54218680000002,133.54921799999997,136.4718020795923,133.2223639839228,133.47235461538455,141.09919794699624,125.84551128377285,143.7774995500002,141.79999940000005,136.54218680000002,133.54921799999997,127.17187333333334,14331500,8076805.0,36.30824858814754,1.5,2.75,3.328784002548478,1.7744021305454325,-0.7255232963519279,-2.1869930784896208,-1.4614697821376932,35.62525630476116,-5.108467459762071,-126802741.0,2000-12-21,2000,3,356,12,2.65,127.2,131.10936999999998,128.84375,246
2000-12-22 14:30:00,129.0,131.10936999999998,128.84375,130.9375,125.25,137.78711125,143.73124955000014,141.66343690000005,136.4984368,133.35390549999997,136.25477062549064,133.00475789021587,132.95071999999993,140.26571370290716,125.6357262970927,143.73124955000014,141.66343690000005,136.4984368,133.35390549999997,130.29687333333334,10182898,8415369.9,44.56865668098011,1.5,2.75,3.375611573795017,1.210035699084362,-0.50731927805305,-2.0956188797040056,-1.5882996016509556,40.72308183848481,-5.545536519386835,-116619843.0,2000-12-22,2000,4,357,12,1.76,129.98,132.34375,130.28125,247
2000-12-26 14:30:00,130.84375,132.34375,130.28125,132.34375,124.96875,137.58984583333333,143.69999955000014,141.53093690000003,136.39406180000003,133.16953049999998,136.1013972676283,132.94180475781434,132.7067299999999,139.87332940490384,125.540130595096,143.69999955000014,141.53093690000003,136.39406180000003,133.16953049999998,131.65625,4665301,8349034.95,47.28443635182294,1.5,2.75,3.281817889952516,0.5587832639268087,-0.23973489780458146,-1.8879682239066824,-1.648233326102101,34.85101018979682,-4.120443740095086,-111954542.0,2000-12-26,2000,1,361,12,1.58,131.31,133.73436999999998,131.25,248
2000-12-27 14:30:00,132.0,133.73436999999998,131.25,133.3125,124.6875,137.39258041666665,143.68343705000018,141.40031190000005,136.2965618,133.15078049999997,135.99202874732913,132.97710906659395,132.68028769230762,139.83520547107491,125.5253699135403,143.68343705000018,141.40031190000005,136.2965618,133.15078049999997,132.76562333333334,4854102,8324934.95,49.133306872613744,1.5,2.75,3.22485732638448,0.5830798713928691,0.017399097687723408,-1.6264844539924468,-1.6438835516801702,35.51902569370215,-2.0773520790488638,-107100440.0,2000-12-27,2000,2,362,12,1.89,132.49,133.875,132.59375,249
2000-12-28 14:30:00,132.8125,133.875,132.59375,133.71875,124.40625,137.195315,143.65296830000014,141.2562494,136.2759368,133.16484299999996,135.90288056115935,133.04774153644217,132.66105692307684,139.80335171745546,125.51876212869827,143.65296830000014,141.2562494,136.2759368,133.16484299999996,133.39583333333334,8358699,8397164.8,49.92643346397707,1.5,2.75,3.0860282316427314,0.9954191919634588,0.2185665135744057,-1.3706754097121632,-1.5892419232865689,35.04219243250618,-0.5115089514066496,-98741741.0,2000-12-28,2000,3,363,12,0.97,133.23,134.28125,131.1875,250
2000-12-29 14:30:00,134.0625,134.28125,131.1875,131.1875,124.125,136.99804958333334,143.57718705000016,141.08124940000005,136.2146868,133.11015549999996,135.717963676408,132.8705756758286,132.08894153846146,138.36803660627334,125.80984647064956,143.57718705000016,141.08124940000005,136.2146868,133.11015549999996,132.21875,8774602,8275814.8,45.197632424296856,1.5,2.75,3.0865797865253937,1.0602704642448015,0.1861470885026537,-1.3565580626582516,-1.5427051511609051,35.938541404559906,0.16702457647339536,-107516343.0,2000-12-29,2000,4,364,12,2.36,132.73,132.15625,127.5625,251
2001-01-02 14:30:00,132.0,132.15625,127.5625,128.8125,123.84375,136.80078416666666,143.48656205000015,140.89499940000005,136.00531180000002,132.93984299999997,135.44716117929394,132.48409227813065,131.37980692307684,136.84366208212256,125.91595176403112,143.48656205000015,140.89499940000005,136.00531180000002,132.93984299999997,129.51041666666666,8737398,8333324.75,41.24982577491037,1.5,2.75,3.19423480177358,1.048488839943505,0.018566679783228013,-1.5194968014318704,-1.5380634812150984,34.348153460623806,-2.9432540616906047,-116253741.0,2001-01-02,2001,1,2,1,3.6,129.86,136.0,127.65625,252
2001-01-03 14:30:00,128.3125,136.0,127.65625,135.0,123.5625,136.60351874999998,143.42765580000014,140.77781190000005,135.9071868,133.02265549999998,135.42962544677263,132.7237025373563,131.29206692307682,136.4768062655019,126.10732758065174,143.42765580000014,140.77781190000005,135.9071868,133.02265549999998,132.88541666666666,19431600,8955084.85,52.81346550199603,1.5,2.75,3.5620573159326097,2.1698956878113784,0.3214512561752665,-1.1362494109960153,-1.4577006671712818,43.79934564266143,3.833677830402214,-96822141.0,2001-01-03,2001,2,3,1,6.54,131.83,135.46875,133.0,253
2001-01-04 14:30:00,134.9375,135.46875,133.0,133.54686999999998,123.28125,136.40625333333332,143.34945265000016,140.63999940000002,135.76749920000003,132.81406149999998,135.35579189984034,132.80209943856048,131.22596076923068,136.27020004347605,126.18172149498531,143.34945265000016,140.63999940000002,135.76749920000003,132.81406149999998,134.00520666666668,9219000,8971864.95,50.30905512450248,1.5,2.75,3.4839639362231374,1.0275455606361976,0.4149966516954244,-0.9389548525520012,-1.3539515042474255,42.319813386659156,5.779699009901,-106041141.0,2001-01-04,2001,3,4,1,1.86,134.23,133.625,129.1875,254
2001-01-05 14:30:00,133.46875,133.625,129.1875,129.1875,123.0,136.20898791666667,143.24492140000018,140.43906189999998,135.55937419999998,132.49765549999998,135.11389809984664,132.4578518729833,131.08894153846146,136.24912151309726,125.92876156382566,143.24492140000018,140.43906189999998,135.55937419999998,132.49765549999998,130.66666666666666,12911398,8973034.85,43.62553125884574,1.5,2.75,3.552073655064341,1.4389109388112986,0.1860131914014853,-1.1214350149955692,-1.3074482063970545,43.41196855157803,1.6224188790560472,-118952539.0,2001-01-05,2001,4,5,1,3.43,131.41,130.1875,127.6875,255
2001-01-08 14:30:00,129.875,130.1875,127.6875,130.1875,122.71875,136.01172250000002,143.13335890000016,140.24937440000002,135.43687420000003,132.32421799999997,134.9207060174997,132.24162788508013,130.8942299999999,135.98427138108593,125.80418861891388,143.13335890000016,140.24937440000002,135.43687420000003,132.32421799999997,129.35416666666666,6625301,8977844.8,45.416874042741696,1.5,2.75,3.47692553684546,0.7379611864085688,0.10847709531606098,-1.1718518372519782,-1.2803289325680391,43.44554640094205,-0.5727923627684964,-112327238.0,2001-01-08,2001,0,8,1,1.96,128.94,131.5,129.42186999999998,256
2001-01-09 14:30:00,131.04686999999998,131.5,129.42186999999998,129.84375,122.4375,135.8144570833333,143.01476515000016,140.06156190000002,135.29999920000003,132.11796799999996,134.72160970308795,132.01325856269156,130.88100923076914,135.9809933798692,125.7810250816691,143.01476515000016,140.06156190000002,135.29999920000003,132.11796799999996,130.25520666666668,5702398,8749159.6,44.88883989601779,1.5,2.75,3.377011569927926,0.651765227828282,0.043927616374775935,-1.2254194120995692,-1.2693470284743449,39.86827481091943,-1.8890200708382527,-118029636.0,2001-01-09,2001,1,9,1,1.61,130.46,132.125,128.8125,257
2001-01-10 14:30:00,129.0,132.125,128.8125,132.125,122.15625,135.61719166666666,142.91570265000016,139.88093690000002,135.15687420000003,131.79296799999997,134.61978187159428,132.02390060434,131.3329323076922,135.69987783429548,126.96598678108893,142.91570265000016,139.88093690000002,135.15687420000003,131.79296799999997,131.02083333333334,8746102,8866184.6,49.11682842744084,1.5,2.75,3.37240360064736,0.9864561132643236,0.15832293541390266,-1.0714433592069668,-1.2297662946208694,40.75553435123457,-0.8907641819034224,-109283534.0,2001-01-10,2001,2,10,1,2.57,130.47,133.48436999999998,131.09375,258
2001-01-11 14:30:00,131.09375,133.48436999999998,131.09375,132.25,121.875,135.41992625,142.82164015000018,139.70656190000003,134.99124920000003,131.50390549999997,134.52684924917884,132.04543388011712,131.72716307692298,135.36846796386422,128.08585818998176,142.82164015000018,139.70656190000003,134.99124920000003,131.50390549999997,132.27604,7245301,8977304.75,49.34614138510778,1.5,2.75,3.302276200601121,0.8070686249121709,0.2409129078349421,-0.9286251598271916,-1.169538067662134,40.4930562932068,-1.0983874737088104,-102038233.0,2001-01-11,2001,3,11,1,1.82,132.29,133.71875,131.28125,259
2001-01-12 14:30:00,132.6875,133.71875,131.28125,132.0,121.59375,135.22266083333332,142.72554640000016,139.52093689999998,134.7721868,131.29687449999997,134.4277571217601,132.04110684391551,131.80889384615378,135.42322908359972,128.19455860870778,142.72554640000016,139.52093689999998,134.7721868,131.29687449999997,132.33333333333334,7244000,9035979.75,48.87176060341908,1.5,2.75,3.240506471986756,0.8016839568503903,0.2747576891596757,-0.8260909562125391,-1.1008486453722148,40.42083172005932,0.6193425440686041,-109282233.0,2001-01-12,2001,4,12,1,1.86,132.5,133.1875,131.51561999999998,260
2001-01-16 14:30:00,132.0,133.1875,131.51561999999998,132.84375,121.3125,135.02539541666664,142.64632765000016,139.3462494,134.57968680000002,131.21874949999997,134.36563919541658,132.11754904925687,131.8473553846153,135.4941342715315,128.2005764976991,142.64632765000016,139.3462494,134.57968680000002,131.21874949999997,132.51562333333334,8542199,9074169.8,50.59790727312005,1.5,2.75,3.1284617239877006,0.941375264985674,0.3454500711428561,-0.6690360564436446,-1.0144861275865007,38.93218330840764,3.1295487627365355,-100740034.0,2001-01-16,2001,1,16,1,1.27,132.35,135.04686999999998,132.64061999999998,261
2001-01-17 14:30:00,134.84375,135.04686999999998,132.64061999999998,133.45311999999998,121.03125,134.82813000000002,142.56171825000015,139.17234309999998,134.39468680000002,131.34296799999998,134.32985412892964,132.24474628266097,131.85817230769223,135.5230596705537,128.19328494483076,142.56171825000015,139.17234309999998,134.39468680000002,131.34296799999998,133.71353666666667,7851398,9013474.65,51.86193741730903,1.5,2.75,3.0768751722742933,0.8710733989804921,0.41978706924982667,-0.4897522910242174,-0.9095393602740441,36.89923578831026,-1.1458370370370277,-92888636.0,2001-01-17,2001,2,17,1,1.81,133.84,135.70311999999998,132.9375,262
2001-01-18 14:30:00,133.4375,135.70311999999998,132.9375,134.78125,120.75,134.63086458333333,142.47937450000015,139.00703059999998,134.23468680000002,131.44609299999996,134.34755592779516,132.4863180652647,131.939903076923,135.80882631797763,128.07097983586837,142.47937450000015,139.00703059999998,134.23468680000002,131.44609299999996,134.47395666666668,8106898,9057049.65,54.589131778997896,1.5,2.75,3.0546426599689878,0.8950925868006034,0.5374243782589971,-0.2377588874502976,-0.7751832657092947,25.289037863626085,0.9243047029106616,-84781738.0,2001-01-18,2001,3,18,1,2.08,134.32,136.1875,133.875,263
2001-01-19 14:30:00,136.1875,136.1875,133.875,134.01561999999998,120.46875,134.43359916666665,142.42070260000014,138.8346868,134.03937420000003,131.64609299999998,134.3345388325875,132.63196586857282,132.1574507692307,136.14879071280515,128.16611082565626,142.42070260000014,138.8346868,134.03937420000003,131.64609299999998,134.69270666666668,7782500,8965339.7,52.73438589923902,1.5,2.75,3.0016324699712027,0.8680652669524614,0.5411909704878269,-0.0986945525995111,-0.639885523087338,24.663316305075522,3.73729656507016,-92564238.0,2001-01-19,2001,4,19,1,1.73,135.03,135.78125,133.5625,264
2001-01-22 14:30:00,134.25,135.78125,133.5625,134.90625,120.1875,134.23633374999997,142.34929635000015,138.66609309999998,133.86249920000003,132.07890549999996,134.35695887836835,132.84856435728017,132.6262007692307,136.35904206783502,128.89335947062642,142.34929635000015,138.66609309999998,133.86249920000003,132.07890549999996,134.75,7050898,8818174.65,54.66405976888372,1.5,2.75,2.9457122935446884,0.7995870211075939,0.5778533126737284,0.08243111775482248,-0.4954221949189059,12.41937253660742,3.624579932789246,-85513340.0,2001-01-22,2001,0,22,1,1.66,134.67,136.65625,134.15625,265
2001-01-23 14:30:00,134.46875,136.65625,134.15625,135.96875,119.90625,134.03906833333332,142.27671825000016,138.5078119,133.7706242,132.52109299999998,134.42016637333433,133.14572489468205,132.70071999999993,136.65240359793486,128.749036402065,142.27671825000016,138.5078119,133.7706242,132.52109299999998,135.59375,8463102,8524754.75,56.923472640202505,1.5,2.75,2.9138757011486387,0.9927677978067344,0.6428634703701309,0.3081571430437577,-0.3347063273263732,12.432922067243029,4.717208182912153,-77050238.0,2001-01-23,2001,1,23,1,1.86,135.41,137.3125,135.84375,266
2001-01-24 14:30:00,136.25,137.3125,135.84375,136.375,119.625,133.84180291666667,142.20140575000016,138.36812440000003,133.6974992,132.79296799999997,134.4968265155565,133.45327490471232,132.91826846153842,137.31828485852,128.51825206455678,142.20140575000016,138.36812440000003,133.6974992,132.79296799999997,136.51041666666666,6199898,8325604.75,57.78967778217032,1.5,2.75,2.81065243678088,0.7446783970858093,0.6788879919822082,0.5139036626513871,-0.1649843293308211,11.673488159294518,3.2166508987701032,-70850340.0,2001-01-24,2001,2,24,1,1.08,136.58,137.25,135.65625,267
2001-01-25 14:30:00,136.25,137.25,135.65625,136.03125,119.34375,133.64453749999998,142.12734325000017,138.20499940000002,133.6856242,132.97734299999996,134.55699998553467,133.69879634235878,133.44471076923068,137.56182888589888,129.32759265256252,142.12734325000017,138.20499940000002,133.6856242,132.97734299999996,136.3125,10818301,8633254.75,56.749809112238886,1.5,2.75,2.7237308341536735,1.2530964639958064,0.6454458425692339,0.6418229738807213,-0.0036228686885126093,9.20878507224056,2.8591682419659734,-81668641.0,2001-01-25,2001,3,25,1,1.17,136.45,136.125,134.45311999999998,268
2001-01-26 14:30:00,135.15625,136.125,134.45311999999998,135.875,119.0625,133.4472720833333,142.05468700000014,138.03999940000003,133.69187420000003,133.10546799999997,134.60868626061173,133.9060538335627,133.88221076923068,137.72121114619026,130.0432103922711,142.05468700000014,138.03999940000003,133.69187420000003,133.10546799999997,135.48437333333334,7136801,8747389.7,56.25430644358099,1.5,2.75,2.648598631714125,0.8158777926631073,0.5807111326139103,0.7222660470788753,0.141554914464965,9.447382798185467,2.935606060606061,-88805442.0,2001-01-26,2001,4,26,1,1.24,135.29,136.89999,135.37,269
2001-01-29 14:30:00,135.5,136.89999,135.37,136.60001,118.78125,133.25000666666665,142.00628080000016,137.893187,133.64137440000002,133.24953100000002,134.68677738764657,134.1626210875091,134.401923076923,137.70526443680262,131.09858171704337,142.00628080000016,137.893187,133.64137440000002,133.24953100000002,136.29,6705898,8664749.65,58.08315939739161,1.5,2.75,2.568698015163116,0.7739286500908886,0.5546727486920846,0.8348958503300707,0.2802231016379861,9.063306690953404,2.8275775111738395,-82099544.0,2001-01-29,2001,0,29,1,1.13,136.13,137.92,135.78999,270
2001-01-30 14:30:00,136.3,137.92,135.78999,137.8,118.5,133.05274125,141.97403080000015,137.77337450000002,133.60612440000003,133.58015600000002,134.80886454891532,134.50903812679397,134.83846153846144,138.31804598590097,131.35887709102192,141.97403080000015,137.77337450000002,133.60612440000003,133.58015600000002,137.16999666666666,7069102,8579474.65,60.99010295454074,1.5,2.75,2.5373631569371793,0.8239551124496882,0.5833013499343112,1.0093497890558751,0.426048439121564,9.439442908059208,3.2572337012428023,-75030442.0,2001-01-30,2001,1,30,1,1.57,136.85,138.7,136.60001,271
2001-01-31 14:30:00,137.39999,138.7,136.60001,137.02,118.21875,138.7,141.96725580000015,137.635137,133.59902440000005,133.99053099999998,134.8955757430755,134.7481773528136,135.20538461538453,138.51774629242814,131.89302293834092,141.96725580000015,137.635137,133.59902440000005,133.99053099999998,137.44000333333335,9706898,8627949.65,58.166382050827075,1.5,2.75,2.5061222171559514,1.1250526942980017,0.5170056018696597,1.0723054414586386,0.5552998395889789,10.807331630312511,1.6610248087178374,-84737340.0,2001-01-31,2001,2,31,1,1.54,137.65,137.95,136.25,272
2001-02-01 14:30:00,137.10001,137.95,136.25,137.92999,117.9375,138.67463235294116,141.95315575000015,137.5163119,133.62481180000003,134.13703049999998,135.01457238060198,135.0512071287361,135.66153769230758,138.7049242368398,132.61815114777542,141.95315575000015,137.5163119,133.62481180000003,134.13703049999998,137.3766633333333,8239602,8068349.75,60.46602087209022,1.5,2.75,2.4485420587876683,1.0212251892030335,0.5013612966408719,1.1820014603900688,0.6806401637491969,10.14523517570713,2.9208311687846464,-76497738.0,2001-02-01,2001,3,32,2,1.25,137.1,137.99001,134.75,273
2001-02-02 14:30:00,137.39999,137.99001,134.75,134.8,117.65625,138.64926470588233,141.90481200000013,137.36837440000002,133.62706180000004,134.19968699999998,135.0061577774411,135.02728264028505,135.81201846153834,138.44962210031682,133.17441482275993,141.90481200000013,137.36837440000002,133.62706180000004,134.19968699999998,135.84667,8276500,8021224.75,50.236709376499775,1.5,2.75,2.5050754831599784,1.0318249716167098,0.2593196455510387,1.0047897206879952,0.7454700751369565,17.36711681833442,-0.07875839703496956,-84774238.0,2001-02-02,2001,4,33,2,2.4,136.37,135.94,134.75,274
2001-02-05 14:30:00,134.8,135.94,134.75,135.78999,117.375,138.6238970588235,141.86813695000015,137.2415868,133.63536160000004,134.5298115,135.03689629597284,135.09992143644837,135.99177769230758,138.25357455814077,133.72998082647445,141.86813695000015,137.2415868,133.63536160000004,134.5298115,135.49333000000001,4352898,7593299.75,52.94805649843213,1.5,2.75,2.411141520077123,0.5732551253491606,0.15040120407429125,0.9334715802298206,0.7830703761555293,17.45946542286868,-0.13147138588830973,-80421340.0,2001-02-05,2001,0,36,2,0.88,135.34,136.7,135.22,275
2001-02-06 14:30:00,135.3,136.7,135.22,135.39,117.09375,138.5985294117647,141.82602445000015,137.10658059999997,133.70034920000003,134.7899365,135.0507435000523,135.12754796631043,136.03860461538454,138.22206409062787,133.85514514014122,141.82602445000015,137.10658059999997,133.70034920000003,134.7899365,135.76999999999998,7106699,7617369.65,51.7218790203076,1.5,2.75,2.3446314115001847,0.9329597126745712,0.0415834249188769,0.8350496573041255,0.7934662323852486,16.924474421432873,-0.7222731439046847,-87528039.0,2001-02-06,2001,1,37,2,1.09,135.96,135.39999,133.67999,276
2001-02-07 14:30:00,134.72,135.39999,133.67999,134.69,116.8125,138.57316176470587,141.78822445000014,136.9687931,133.69727420000004,135.032249,135.03659669612873,135.08587673142372,136.0904799999999,138.10470965559472,134.07625034440508,141.78822445000014,136.9687931,133.69727420000004,135.032249,134.58999333333333,5748699,7619684.7,49.55887016356974,1.5,2.75,2.3000148821073148,0.7544536586927277,-0.08070756760628739,0.6925817728773893,0.7732893404836767,16.971127609741202,-0.9859866758557332,-93276738.0,2001-02-07,2001,2,38,2,1.29,134.54,135.39999,133.10001,277
2001-02-08 14:30:00,134.8,135.39999,133.10001,133.12,116.53125,138.54779411764704,141.71304320000013,136.83905560000002,133.63904920000002,135.081999,134.9614360413786,134.89865037605006,135.95307615384607,138.45609320779448,133.45005909989766,141.71304320000013,136.83905560000002,133.63904920000002,135.081999,133.8733333333333,5943301,7479544.65,45.01213258690064,1.5,2.75,2.300012390528221,0.7946073294715875,-0.2603700319969716,0.44782680048746215,0.7081968324844338,18.011966740082578,-2.027598896044155,-99220039.0,2001-02-08,2001,3,39,2,1.73,134.25,133.35001,131.25999,278
2001-02-09 14:30:00,133.35001,133.35001,131.25999,131.84,116.25,138.52242647058821,141.63982135000015,136.71089310000002,133.60209920000003,135.061499,134.83902678485393,134.60735034023574,135.63547999999992,138.96217535114542,132.30878464885436,141.63982135000015,136.71089310000002,133.60209920000003,135.061499,132.15,9913000,7612929.6,41.656629660599386,1.5,2.75,2.2850129340619203,1.3021268448351342,-0.44747306174382495,0.14885550530465252,0.5963285670484775,18.491455421002303,-3.4846337126915246,-109133039.0,2001-02-09,2001,4,40,2,1.59,132.3,133.5,131.7,279
2001-02-12 14:30:00,131.7,133.5,131.7,133.35001,115.96875,138.49705882352941,141.57657140000015,136.58470569999997,133.60034940000003,135.12899950000002,134.78063396976162,134.48760364116566,135.40278846153836,138.90838947799955,131.89718744507718,141.57657140000015,136.58470569999997,133.60034940000003,135.12899950000002,132.85000333333332,5804398,7540949.5,46.704127545067855,1.5,2.75,2.2503691530574983,0.7697171291227981,-0.4503596418657169,0.03337901471633131,0.4837386565820482,19.772254881288365,-3.229310595065322,-103328641.0,2001-02-12,2001,0,43,2,1.37,132.6,134.17,132.0,280
2001-02-13 14:30:00,133.7,134.17,132.0,132.25999,115.6875,138.47169117647059,141.51240260000014,136.45839940000002,133.59992420000003,135.09981150000002,134.6817851866337,134.27544996105465,135.11269153846143,138.96888385826858,131.25649921865428,141.51240260000014,136.45839940000002,133.59992420000003,135.09981150000002,132.80999666666665,6587602,7443219.65,43.76098658339286,1.5,2.75,2.2446284992676757,0.8850473732828776,-0.5025329806621472,-0.14442756924563582,0.3581054114165114,18.636396073645805,-3.4739527076339383,-109916243.0,2001-02-13,2001,1,44,2,1.64,133.08,132.64999,130.66,281
2001-02-14 14:30:00,132.64999,132.64999,130.66,132.06,115.40625,138.44632352941179,141.43739010000013,136.3271244,133.59674920000003,135.0301555,134.57897008127551,134.0644547266685,134.8192299999999,138.96824167446118,130.6702183255386,141.43739010000013,136.3271244,133.59674920000003,135.0301555,131.78999666666667,8400102,7470654.85,43.22280694351486,1.5,2.75,2.2264400350342712,1.1244130760504885,-0.5249182826779999,-0.2980424419309884,0.22687584074701145,18.66087110942384,-4.255774976856013,-118316345.0,2001-02-14,2001,2,45,2,1.52,131.65,133.52,132.5,282
2001-02-15 14:30:00,132.84,133.52,132.5,133.34,115.125,138.42095588235293,141.38346510000014,136.20771190000002,133.59667420000002,134.95809300000002,134.53038301926472,133.99545903841434,134.5684599999999,138.65016022529716,130.48675977470265,141.38346510000014,136.20771190000002,133.59667420000002,134.95809300000002,133.12,5928602,7361740.05,47.65954722865256,1.5,2.75,2.171694318246109,0.805326181002547,-0.43181364658856736,-0.3128912174886977,0.1189224290998696,19.33928572502909,-1.0830860534124689,-112387743.0,2001-02-15,2001,3,46,2,0.77,133.01,131.28999,129.3,283
2001-02-16 14:30:00,131.0,131.28999,129.3,130.39999,114.84375,138.3955882352941,141.32734005000015,136.07014930000003,133.45029900000003,134.7773115,134.3684068224308,133.65303341570822,133.99922846153837,138.18222965362818,129.81622726944846,141.32734005000015,136.07014930000003,133.45029900000003,134.7773115,130.32999333333333,6434898,7294359.95,39.93955546480355,1.5,2.75,2.3051447240856726,0.8821744531540426,-0.5395298424182228,-0.5554898739229088,-0.015960031504686098,19.098303733462867,-3.969364752144092,-118822641.0,2001-02-16,2001,4,47,2,1.54,130.29,131.14,128.10001,284
2001-02-20 14:30:00,131.03999,131.14,128.10001,128.39,114.5625,138.37022058823527,141.26022755000014,135.9299868,133.30778660000004,134.45149899999998,134.13395949606098,133.1517921380217,133.3353823076922,138.09017786588862,128.58058674949578,141.26022755000014,135.9299868,133.30778660000004,134.45149899999998,129.21000333333333,5760000,7229815.05,35.6838776707761,1.5,2.75,2.3576336723652664,0.796700878261056,-0.7068885828205485,-0.8995707600303717,-0.1926821772098232,18.943622145358376,-5.170248910554695,-124582641.0,2001-02-20,2001,1,51,2,2.37,129.62,128.84,125.5,285
2001-02-21 14:30:00,127.89998999999999,128.84,125.5,125.62,114.28125,138.34485294117644,141.17067130000015,135.75462430000002,133.14706160000003,133.93406149999998,133.80007873150956,132.43447860106727,132.38845999999987,137.94201361686498,126.83490638313472,141.17067130000015,135.75462430000002,133.14706160000003,133.93406149999998,126.65333333333336,10910801,7352200.0,30.811422835866793,1.5,2.75,2.427802695767748,1.4840185250673268,-0.9497478135827876,-1.3798669441883078,-0.43011913060552015,20.956700454376584,-6.733981735837845,-135493442.0,2001-02-21,2001,2,52,2,2.66,127.17,126.53998999999999,123.02,286
2001-02-22 14:30:00,126.35001000000001,126.53998999999999,123.02,125.81,114.0,138.31948529411764,141.08745570000016,135.5514743,132.98388660000003,133.40581149999997,133.48674231066605,131.80357587715608,131.69692153846142,138.05737732282705,125.3364657540958,141.08745570000016,135.5514743,132.98388660000003,133.40581149999997,125.12333,21281600,8106285.1,31.502314877801428,1.5,2.75,2.5058160746414804,2.6253209377005504,-1.0361332545509514,-1.7252856987942096,-0.6891524442432579,21.56800124675929,-5.491286057692308,-114211842.0,2001-02-22,2001,3,53,2,2.86,124.78,125.53998999999999,121.8,287
2001-02-23 14:30:00,125.08,125.53998999999999,121.8,124.96001000000001,113.71875,138.29411764705878,141.00569325000015,135.3648244,132.71058680000004,132.85224949999997,133.15236065142423,131.15180769837934,130.86384615384605,137.68216132342738,124.04553098426467,141.00569325000015,135.3648244,132.71058680000004,132.85224949999997,124.1,20173008,8574020.45,30.056352590143376,1.5,2.75,2.6132577835956607,2.352806144753248,-1.0839236628349491,-2.0440570227869443,-0.9601333599519952,21.342598087780527,-5.218439016990295,-134384850.0,2001-02-23,2001,4,54,2,3.07,123.67,127.62,124.5,288
2001-02-26 14:30:00,125.8,127.62,124.5,127.62,113.4375,138.26874999999998,140.95316825000015,135.20258690000003,132.50236180000005,132.43949949999995,132.93540533176053,130.81544506043846,130.26615384615374,136.74649146065522,123.78581623165223,140.95316825000015,135.20258690000003,132.50236180000005,132.43949949999995,126.58,11502602,8792310.5,39.42653016221171,1.5,2.75,2.6494536561959707,1.3082570275469685,-0.8785489952408292,-2.058319604003032,-1.1797706087622024,26.282979153354304,-4.296970056470181,-122882248.0,2001-02-26,2001,0,57,2,2.51,126.06,127.84,125.50998999999999,289
2001-02-27 14:30:00,126.8,127.84,125.50998999999999,126.44,113.15625,138.24338235294115,140.87896200000014,135.04198690000004,132.30834940000003,131.93149899999997,132.68068355404444,130.39873600706338,129.63153846153836,135.86584755857905,123.39722936449766,140.87896200000014,135.04198690000004,132.30834940000003,131.93149899999997,126.59666333333332,11415000,9027765.6,37.054977434399646,1.5,2.75,2.626636252181973,1.264432474852914,-0.7683182421605541,-2.140168411462895,-1.3718501693023408,24.70306625200308,-4.40041618028248,-134297248.0,2001-02-27,2001,1,58,2,1.86,126.67,126.84,123.27,290
2001-02-28 14:30:00,126.75,126.84,123.27,123.95,112.875,138.21801470588233,140.78464950000014,134.84461190000005,132.09922440000003,131.23899899999995,132.33830380682699,129.78457067305737,128.92615384615374,135.4884850616991,122.36382263060841,140.78464950000014,134.84461190000005,132.09922440000003,131.23899899999995,124.68666666666668,14831102,9415865.6,32.598931888609464,1.5,2.75,2.6940193770261187,1.5751182769643612,-0.8053503165902445,-2.3785380650401464,-1.573187748449902,26.070840460385927,-6.141147963047099,-149128350.0,2001-02-28,2001,2,59,2,2.9,125.06,124.60001000000001,121.75,291
2001-03-01 14:30:00,124.05,124.60001000000001,121.75,124.60001000000001,112.59375,138.1926470588235,140.68124330000015,134.64873700000004,131.9718496,130.61799949999994,132.0348413045985,129.29080298990903,128.36923153846143,135.07517677497273,121.66328630195014,140.68124330000015,134.64873700000004,131.9718496,130.61799949999994,123.65000666666666,14672000,9664120.7,34.80305421448669,1.5,2.75,2.705161564381396,1.5181929588275942,-0.7305189369726761,-2.486336419665747,-1.755817482693071,26.81648120351204,-6.554664766761666,-134456350.0,2001-03-01,2001,3,60,3,2.34,123.18,125.64998999999999,122.3,292
2001-03-02 14:30:00,122.5,125.64998999999999,122.3,123.61,112.3125,138.1672794117647,140.56648080000014,134.47421200000005,131.7896746,129.90199999999996,131.70445537108483,128.74977413372721,127.61999999999986,134.10539514248168,121.1346048575181,140.56648080000014,134.47421200000005,131.7896746,129.90199999999996,123.85333,12564301,9880355.65,33.03131806894068,1.5,2.75,2.7512207383541534,1.27164460927072,-0.6924937406741525,-2.6214346585357617,-1.9289409178616093,24.944896122810842,-5.2070479453257645,-147020651.0,2001-03-02,2001,4,61,3,2.74,123.97,124.78,123.81,293
2001-03-05 14:30:00,124.14998999999999,124.78,123.81,124.74001000000001,112.03125,138.14191176470587,140.46439960000015,134.32161210000004,131.68416240000002,129.39900049999994,131.4313398663364,128.367891835277,127.04153999999987,133.09542535303706,120.98765464696275,140.46439960000015,134.32161210000004,131.68416240000002,129.39900049999994,124.44333666666668,5293199,9731190.6,36.975171347822645,1.5,2.75,2.638276399900285,0.5439415604499618,-0.542658233690577,-2.6072637099748306,-2.0646054762842536,24.672154936847328,-2.8428927486564284,-141727452.0,2001-03-05,2001,0,64,3,0.78,124.3,127.75,125.49001000000001,294
2001-03-06 14:30:00,126.35001000000001,127.75,125.49001000000001,126.08,111.75,138.11654411764704,140.37573710000015,134.20553710000004,131.68076240000002,128.91350099999994,131.22148340098988,128.1499973747744,126.58153999999986,131.90492192014392,121.25815807985587,140.37573710000015,134.20553710000004,131.68076240000002,128.91350099999994,126.44000333333332,6917000,9859395.7,41.38348933839632,1.5,2.75,2.664827371335979,0.7015642956697641,-0.31595955403130604,-2.4595549188233856,-2.14359536479208,24.94296157752652,0.3661837287056151,-134810452.0,2001-03-06,2001,1,65,3,1.8,126.62,127.03998999999999,125.75998999999999,295
2001-03-07 14:30:00,126.89998999999999,127.03998999999999,125.75998999999999,126.98,111.46875,138.0911764705882,140.30501210000014,134.11002460000003,131.6778624,128.49300099999996,131.05515071859813,128.0385690533673,126.09230923076912,129.74955767430848,122.43506078722977,140.30501210000014,134.11002460000003,131.6778624,128.49300099999996,126.59332666666668,6371699,9822645.7,44.20623992824051,1.5,2.75,2.5659111305262665,0.6486744197645243,-0.08032744438301931,-2.2440046702708543,-2.163677225887835,21.789436416264888,0.929973769970592,-128438753.0,2001-03-07,2001,2,66,3,1.02,126.4,127.24001000000001,126.14,296
2001-03-08 14:30:00,126.60001000000001,127.24001000000001,126.14,127.12,111.1875,138.06580882352938,140.24029960000016,134.04997460000004,131.60151240000002,128.11450099999996,130.90083108257468,127.95108628637995,125.84000230769222,128.62140956637626,123.05859504900816,140.24029960000016,134.04997460000004,131.60151240000002,128.11450099999996,126.83333666666664,6055000,9837960.75,44.652737294341875,1.5,2.75,2.4612039069172478,0.6154730796217092,0.1002333995546314,-2.038385476444546,-2.1386188759991773,21.787719678772607,1.728544996115163,-122383753.0,2001-03-08,2001,3,67,3,0.87,126.69,126.10001000000001,123.11,297
2001-03-09 14:30:00,126.10001000000001,126.10001000000001,123.11,123.36,110.90625,138.04044117647058,140.16709960000014,133.90794960000005,131.42183740000002,127.62650099999996,130.60511221659135,127.5138399733914,125.45307923076912,128.1043161403097,122.80184232122858,140.16709960000014,133.90794960000005,131.42183740000002,127.62650099999996,124.19000333333334,10020301,10041810.75,36.25996965102422,1.5,2.75,2.5718321992803013,0.9978579809423316,-0.012305997830919235,-2.1540013732878265,-2.1416953754569072,28.01472938855416,-3.338034790785147,-132404054.0,2001-03-09,2001,4,68,3,2.43,124.61,122.5,117.75,298
2001-03-12 14:30:00,122.34,122.5,117.75,118.08,110.625,138.01507352941178,140.05624960000014,133.70687460000005,131.1171874,126.93850099999996,130.11393134535248,126.61537902354459,124.87307923076914,129.6061273798249,120.14003108171335,140.05624960000014,133.70687460000005,131.1171874,126.93850099999996,119.44333333333331,13972898,10244805.65,28.234535712552056,1.5,2.75,2.7888441850459937,1.3639007392980655,-0.39963024815361736,-2.6412331856489293,-2.2416029374953115,33.27276366396632,-6.6118316988294845,-146376952.0,2001-03-12,2001,0,71,3,4.03,120.12,120.44,117.53,299
2001-03-13 14:30:00,119.39998999999999,120.44,117.53,120.02,110.34375,137.98970588235292,139.96713085000016,133.55957460000005,130.8432124,126.27200049999996,129.7180909004367,125.98724768796892,124.42769461538452,129.77419458073715,119.08119465003188,139.96713085000016,133.55957460000005,130.8432124,126.27200049999996,119.33,12887199,10598945.7,34.01348362398332,1.5,2.75,2.797498171828423,1.215894426178634,-0.477205772669234,-2.8381101533318542,-2.36090438066262,35.96845835829725,-3.1706333198870564,-133489753.0,2001-03-13,2001,1,72,3,2.48,118.98,119.28998999999999,115.75,300
2001-03-14 14:30:00,117.05,119.28998999999999,115.75,117.64998999999999,110.0625,137.9643382352941,139.86538080000014,133.39357450000006,130.57246220000002,125.54150049999994,129.24483204159606,125.1932231462576,123.8653853846153,130.29715460095815,117.43361616827242,139.86538080000014,133.39357450000006,130.57246220000002,125.54150049999994,117.56332666666664,19883392,11263735.2,30.7552265725878,1.5,2.75,2.9026768738406785,1.765257407684797,-0.6305372802424563,-3.1490759809656907,-2.5185387007232345,35.97662444657169,-5.577864720877627,-153373145.0,2001-03-14,2001,2,73,3,3.06,117.52,118.86,117.36,301
2001-03-15 14:30:00,118.45,118.86,117.36,117.67998999999999,109.78125,137.93897058823526,139.74018700000016,133.17756190000006,130.349812,124.82249999999996,128.7913088242785,124.47767713232832,123.10076923076912,129.9171877017726,116.28435075976564,139.74018700000016,133.17756190000006,130.349812,124.82249999999996,117.96666333333332,10370301,11362245.15,30.8455312485613,1.5,2.75,2.8024856685663444,0.9126982267232634,-0.6687131260183428,-3.354430108246163,-2.6857169822278197,35.55988893436741,-4.79735458296254,-143002844.0,2001-03-15,2001,3,74,3,1.28,118.11,117.39998999999999,114.81,302
2001-03-16 14:30:00,117.13,117.39998999999999,114.81,115.00998999999999,109.5,137.91360294117644,139.60117445000014,132.92859930000006,129.9500118,123.90599949999994,128.25086494881666,123.57599264353513,122.22153769230759,129.9728094224553,114.47026596215986,139.60117445000014,132.92859930000006,129.9500118,123.90599949999994,115.73999333333336,58515392,13991584.65,27.41833475653723,1.5,2.75,2.8073074065258914,4.182184753461788,-0.803493952824121,-3.690084423257972,-2.8865904704338505,36.917309879695146,-7.800239874920642,-201518236.0,2001-03-16,2001,4,75,3,2.26,116.1,117.69,114.82001000000001,303
2001-03-19 14:30:00,115.75998999999999,117.69,114.82001000000001,117.35001000000001,109.21875,137.88823529411764,139.46136200000015,132.69678690000006,129.62607459999998,123.25350049999994,127.82338044101988,122.98304191557942,121.71384615384605,129.80297722239214,113.62471508529995,139.46136200000015,132.69678690000006,129.62607459999998,123.25350049999994,116.62000666666664,10067801,14173229.8,34.30734105791309,1.5,2.75,2.811784734631185,0.7103392199285444,-0.6702003792056597,-3.724340944440925,-3.0541405652352656,39.1716451493289,-6.9241671954314725,-191450435.0,2001-03-19,2001,0,78,3,2.5,116.26,118.46001000000001,114.11,304
2001-03-20 14:30:00,117.89998999999999,118.46001000000001,114.11,114.2,108.9375,137.8628676470588,139.29314325000016,132.44284940000006,129.3263246,122.54400049999997,127.28913022764657,122.14656173314327,120.91384538461529,129.72762063388728,112.10007013534329,139.29314325000016,132.44284940000006,129.3263246,122.54400049999997,115.59000333333334,15086898,14639574.7,30.15774715995262,1.5,2.75,2.921657967871815,1.0305557578800428,-0.7247038009087925,-3.960020316371256,-3.235316515462464,39.26354464090424,-10.064577098755711,-206537333.0,2001-03-20,2001,1,79,3,3.81,116.29,115.25998999999999,111.89998999999999,305
2001-03-21 14:30:00,114.17998999999999,115.25998999999999,111.89998999999999,112.25998999999999,108.65625,137.83749999999998,139.11881820000016,132.20232430000007,128.96777439999997,121.87599999999996,126.69975217950356,121.20498347284392,120.04076769230758,129.81009305661422,110.27144232800094,139.11881820000016,132.20232430000007,128.96777439999997,121.87599999999996,113.13999000000004,19004704,15044269.85,27.91809278877577,1.5,2.75,2.9529681130238283,1.2632520015585869,-0.8151864618446618,-4.254299592768291,-3.4391131309236287,37.86399800771786,-11.689749842668347,-225542037.0,2001-03-21,2001,2,80,3,3.0,113.58,112.60001000000001,108.03998999999999,306
2001-03-22 14:30:00,112.02,112.60001000000001,108.03998999999999,111.12,108.03998999999999,137.81213235294115,138.94207445000015,131.94664930000008,128.59329939999998,121.14149999999997,126.08878150579754,120.2445088563826,118.99307461538451,129.42094719890008,108.56520203186895,138.94207445000015,131.94664930000008,128.59329939999998,121.14149999999997,110.58666666666666,28625600,15411469.85,26.664938763276073,1.5,2.75,3.0677575335221268,1.8574217954947367,-0.8705635800469174,-4.527317605982276,-3.656754025935359,36.9442865324946,-9.922178988326843,-254167637.0,2001-03-22,2001,3,81,3,4.22,110.32,114.66,111.5,307
2001-03-23 14:30:00,113.25,114.66,111.5,114.48,107.75324803278689,137.78676470588232,138.77705260000016,131.6986368000001,128.24039939999997,120.61749949999997,125.63353517223685,119.6955080129176,118.10076692307683,127.91753865242269,108.283995193731,138.77705260000016,131.6986368000001,128.24039939999997,120.61749949999997,113.54666666666664,12861699,15045904.4,35.81041257588605,1.5,2.75,3.1014891382705447,0.8548305677124999,-0.6118712246299292,-4.42159305672277,-3.8097218320928414,42.6208199525031,-3.048780487804873,-241305938.0,2001-03-23,2001,4,82,3,2.83,113.08,116.27,114.77,308
2001-03-26 14:30:00,115.7,116.27,114.77,115.94,107.46650606557377,137.76139705882352,138.62222135000013,131.45272430000009,127.91419939999996,120.03349949999998,125.25339653803148,119.3378405831159,117.25153615384608,125.65761269816319,108.84545960952896,138.62222135000013,131.45272430000009,127.91419939999996,120.03349949999998,115.66,9943801,14967964.35,39.349776492306,1.5,2.75,3.007811342679791,0.6643389019028496,-0.28974627138883857,-4.171904671328888,-3.8821583999400495,36.989108051062644,-3.3994334277620384,-231362137.0,2001-03-26,2001,0,85,3,1.31,115.52,118.64998999999999,115.28,309
2001-03-27 14:30:00,115.62,118.64998999999999,115.28,118.31,107.17976409836065,137.7360294117647,138.48080260000015,131.20629310000007,127.64039939999996,119.62699949999997,124.98110647771652,119.23995100377155,116.57384384615378,122.83520759841585,110.31248009389166,138.48080260000015,131.20629310000007,127.64039939999996,119.62699949999997,117.41333000000004,12881199,15041274.3,44.68198805208243,1.5,2.75,3.0336812467740915,0.8563901397636235,0.11398514737584042,-3.7396769657202498,-3.8536621130960897,37.75468146996488,0.5609945228214637,-218480938.0,2001-03-27,2001,1,86,3,2.92,116.96,116.95,114.89998999999999,310
2001-03-28 14:30:00,116.89998999999999,116.95,114.89998999999999,115.03998999999999,106.89302213114756,137.71066176470586,138.33162755000015,130.93200550000006,127.28432419999996,119.181499,124.59125877270806,118.83995471769806,115.93384307692301,120.84509159751741,111.0225945563286,138.33162755000015,130.93200550000006,127.28432419999996,119.181499,115.62999333333332,10953301,14847384.25,39.519365778466344,1.5,2.75,3.0605618720045134,0.7377259735161767,0.1875095923286021,-3.6192751226853375,-3.80678471501394,39.44763356758958,-2.2433720465136004,-229434239.0,2001-03-28,2001,2,87,3,1.78,115.92,116.5,109.34,311
2001-03-29 14:30:00,114.7,116.5,109.34,115.48,106.60628016393444,137.68529411764703,138.17105880000014,130.65977430000007,126.92486179999996,118.7254985,124.23395450711165,118.51995903029824,115.73384307692301,120.48847355195636,110.97921260188964,138.17105880000014,130.65977430000007,126.92486179999996,118.7254985,113.77333333333333,12061398,14716854.15,40.515323980596854,1.5,2.75,3.3533788811470484,0.8195636021846421,0.2865498671969986,-3.4485973810176915,-3.73514724821469,39.582605272686884,0.40866884694103706,-217372841.0,2001-03-29,2001,3,88,3,6.55,112.92,116.69,114.5,312
2001-03-30 14:30:00,115.55,116.69,114.5,116.69,106.31953819672131,137.6599264705882,138.01529005000015,130.39886180000008,126.56303679999996,118.37949849999998,123.93811315389156,118.34567721788888,115.47768923076916,119.59748247373119,111.35789598780715,138.01529005000015,130.39886180000008,126.56303679999996,118.37949849999998,115.96,9183602,14547819.2,43.2813615815796,1.5,2.75,3.2702803896365444,0.6312700119341599,0.4448769729203854,-3.1790510320642085,-3.623928004984594,37.67646741214851,-0.5624285843691021,-208189239.0,2001-03-30,2001,4,89,3,1.91,115.6,117.38,113.8,313
2001-04-02 13:30:00,116.3,117.38,113.8,114.2,106.03279622950821,137.63455882352935,137.84550880000015,130.10304930000007,126.16672439999996,117.85249799999997,123.55622636354288,117.9508508161852,115.2123053846153,119.17983865076393,111.2447721184667,137.84550880000015,130.10304930000007,126.16672439999996,117.85249799999997,115.12666666666668,10561000,14811209.25,39.23786561223749,1.5,2.75,3.29240321894822,0.7130410368079838,0.3949248264057377,-3.1302719719774217,-3.52519679838316,37.708124615871625,0.0,-218750239.0,2001-04-02,2001,0,92,4,3.15,115.59,114.14998999999999,110.06,314
2001-04-03 13:30:00,113.98,114.14998999999999,110.06,110.39,105.74605426229508,137.60919117647057,137.66449005000015,129.76944930000008,125.67639939999997,117.06799799999996,123.03990376105101,117.23076978607229,114.65153692307686,119.0973285751027,110.20574527105106,137.66449005000015,129.76944930000008,125.67639939999997,117.06799799999996,111.53333,12836000,15107159.25,34.00322864845714,1.5,2.75,3.3529458461662043,0.8496633806253151,0.13190642388647955,-3.3603137685250597,-3.49222019241154,39.457756694557574,-1.6657671179197515,-231586239.0,2001-04-03,2001,1,93,4,3.72,112.1,112.10001000000001,109.3,315
2001-04-04 13:30:00,110.57799999999999,112.10001000000001,109.3,110.85001000000001,105.45931229508196,137.58382352941177,137.47639635000013,129.47232440000008,125.17402459999997,116.26149849999996,122.561868711598,116.62307837787493,114.33153846153841,119.2062262142688,109.45685070880798,137.47639635000013,129.47232440000008,125.17402459999997,116.26149849999996,110.75000666666666,14884500,15532799.3,35.12851235344924,1.5,2.75,3.313450428582904,0.9582625586361628,0.02133150041630838,-3.465555816891154,-3.4868873173074624,38.629890262934964,-0.24297156227502434,-216701739.0,2001-04-04,2001,2,94,4,2.56,110.7,115.49001000000001,112.5,316
2001-04-05 13:30:00,113.3,115.49001000000001,112.5,115.05,105.17257032786884,137.55845588235292,137.31195885000014,129.22251190000006,124.74752459999996,115.6579985,122.26728562486868,116.47326138950591,114.15461461538456,118.73640053422753,109.57282869654158,137.31195885000014,129.22251190000006,124.74752459999996,115.6579985,114.34666999999999,21517600,16305929.3,44.44272122465209,1.5,2.75,3.4082039693984107,1.3196181342451914,0.25072988401826635,-3.173474962284629,-3.4242048463028967,43.82670204403831,0.4979035639412938,-195184139.0,2001-04-05,2001,3,95,4,2.66,114.0,114.39998999999999,112.06,317
2001-04-06 13:30:00,113.991,114.39998999999999,112.06,113.3,104.88582836065572,137.5330882352941,137.13924010000014,128.98926190000006,124.29289959999996,115.1549985,121.91562736506992,116.17104601907677,114.08538384615377,118.6894782041144,109.48128948819316,137.13924010000014,128.98926190000006,124.29289959999996,115.1549985,113.25333,14937801,16551804.3,41.752726479998906,1.5,2.75,3.3783322572985237,0.9024877728889048,0.3009055821227178,-3.0480728686494984,-3.348978450772216,41.50662824524047,-2.277039848197344,-210121940.0,2001-04-06,2001,4,96,4,2.09,113.23,114.99001000000001,112.78,318
2001-04-09 13:30:00,114.0,114.99001000000001,112.78,114.56,104.59908639344265,137.50772058823526,136.98391510000013,128.77923690000006,123.86659959999996,114.9789985,121.62717138996912,116.01761306487896,114.26230769230763,118.74745401424265,109.77716137037257,136.98391510000013,128.77923690000006,123.86659959999996,114.9789985,114.11000333333334,9034301,16304874.45,44.36383633813961,1.5,2.75,3.2948806674914866,0.5540858979137985,0.4275230234742549,-2.8145746714293978,-3.2420976949036526,41.32204761840578,-3.1696390837629957,-201087639.0,2001-04-09,2001,0,99,4,1.96,113.89,117.75,115.17,319
2001-04-10 13:30:00,115.45,117.75,115.17,116.64998999999999,104.31234442622952,137.48235294117643,136.84529005000016,128.55448680000006,123.46759919999997,114.81049799999998,121.43198780604878,116.07783943965241,114.68769153846144,118.94312454449741,110.43225853242552,136.84529005000016,128.55448680000006,123.46759919999997,114.81049799999998,116.52333,17873296,16554179.3,48.48870704652544,1.5,2.75,3.2873891912420947,1.0796848140940456,0.6474087844118829,-2.432836714388799,-3.0802454988006818,40.930452147351374,1.399513334450046,-183214343.0,2001-04-10,2001,1,100,4,2.24,116.46,118.99001000000001,116.14,320
2001-04-11 13:30:00,118.78,118.99001000000001,116.14,116.73,104.0256024590164,137.45698529411763,136.69776820000016,128.32616180000005,123.04619919999996,114.7644985,121.2475961273802,116.13994996920931,114.86076846153837,119.24927697718826,110.47225994588852,136.69776820000016,128.32616180000005,123.04619919999996,114.7644985,117.28667,12722301,16196124.75,48.64567641943469,1.5,2.75,3.2561478204390877,0.7855151276233532,0.7844787427288704,-2.0996470703895938,-2.8841258131184637,37.25930325798321,1.0824385174922064,-170492042.0,2001-04-11,2001,2,101,4,2.45,117.57,118.94,115.96001000000001,321
2001-04-12 13:30:00,116.3,118.94,115.96001000000001,118.85001000000001,103.73886049180328,137.4316176470588,136.56623700000014,128.14091190000005,122.68279939999996,114.82299950000001,121.15357314199277,116.39805092452272,115.08461538461529,119.94227177673555,110.22695899249508,136.56623700000014,128.14091190000005,122.68279939999996,114.82299950000001,117.91667333333334,9233199,16139269.65,52.75392339785593,1.5,2.75,3.2364222618362963,0.5720952186953515,0.9908559751092224,-1.6455558442319358,-2.6364118193411583,38.454407145123064,1.8510669294712483,-161258843.0,2001-04-12,2001,3,102,4,2.57,117.45,118.89,116.91,322
2001-04-16 13:30:00,118.28998999999999,118.89,116.91,117.60001000000001,103.45211852459015,137.40624999999997,136.42642455000015,127.95050580000004,122.27619979999996,114.95250049999999,121.01421772465972,116.51252321742531,115.03000076923072,119.75554547860071,110.30445605986073,136.42642455000015,127.95050580000004,122.27619979999996,114.95250049999999,117.80000333333334,7348699,13580935.0,50.203734546941796,1.5,2.75,3.146677814562276,0.5411040550595375,1.0125305021848896,-1.3707486916100464,-2.383279193794936,38.83151640017316,2.9772416812609417,-168607542.0,2001-04-16,2001,0,106,4,1.69,117.9,119.66,117.02,323
2001-04-17 13:30:00,117.31,119.66,117.02,119.25998999999999,103.16537655737707,137.38088235294114,136.30178700000013,127.79623070000004,121.96539959999994,115.0479995,120.9454244805554,116.77418672052768,115.3546161538461,120.59052306332704,110.11870924436514,136.30178700000013,127.79623070000004,121.96539959999994,115.0479995,118.64666333333332,10924699,13623779.9,53.42376156435857,1.5,2.75,3.110486542093541,0.8018845783026779,1.1007011008646277,-1.0074028177141514,-2.108103918578779,36.65215025045011,8.035139052450402,-157682843.0,2001-04-17,2001,1,107,4,2.26,118.34,126.0,120.69,324
2001-04-18 13:30:00,121.06,126.0,120.69,124.0,102.87863459016394,137.3555147058823,136.19538075000014,127.68248070000006,121.72959979999996,115.53799950000001,121.06521175582778,117.46235941381077,116.01000076923071,122.98778766989166,109.03221386856974,136.19538075000014,127.68248070000006,121.72959979999996,115.53799950000001,123.56333333333332,32491008,14493985.4,61.149209763980636,1.5,2.75,3.369738217658288,2.241689025021372,1.4199796991355371,-0.3331292946593578,-1.7531089937948952,32.44758552267826,11.862867671369633,-125191835.0,2001-04-18,2001,2,108,4,4.4,123.34,125.84,123.58,325
2001-04-19 13:30:00,124.25,125.84,123.58,125.64998999999999,102.59189262295082,137.3301470588235,136.08722445000015,127.61757440000004,121.53479959999993,116.20749950000001,121.2450069810894,118.2421337553526,116.69923076923072,125.37337283913051,108.02508869933092,136.08722445000015,127.61757440000004,121.53479959999993,116.20749950000001,125.02333,13810398,14234270.1,63.423511190468204,1.5,2.75,3.2904712021112674,0.9702217186394404,1.6669409240234119,0.3305671612343701,-1.336373762789042,32.10016041388627,9.213376792698831,-111381437.0,2001-04-19,2001,3,109,4,1.83,124.71,125.39998999999999,123.66,326
2001-04-20 13:30:00,124.89998999999999,125.39998999999999,123.66,124.5,102.3051506557377,137.30477941176468,135.98659945000014,127.51413690000004,121.33099959999994,116.87649950000001,121.37265376614471,118.83812101674759,117.49153846153841,126.95364887878796,108.02942804428885,135.98659945000014,127.51413690000004,121.33099959999994,116.87649950000001,124.51999666666666,7626699,13184325.05,60.7540663394504,1.5,2.75,3.1975796876747484,0.5784671548279219,1.673141426912961,0.7550530208521593,-0.9180884060608016,30.038163048806023,9.885260370697264,-119008136.0,2001-04-20,2001,4,110,4,1.41,124.53,123.89,121.91,327
2001-04-23 13:30:00,123.64998999999999,123.89,121.91,122.24001000000001,102.01840868852459,137.27941176470586,135.86904950000016,127.37622450000003,121.11339979999997,117.2645,121.40666773609983,119.16211044372402,118.40307769230762,127.21376819982606,109.59238718478916,135.86904950000016,127.37622450000003,121.11339979999997,117.2645,122.68000333333332,8451801,12963830.15,55.784890198907156,1.5,2.75,3.1541811385551237,0.6519524632926481,1.4534616983656503,0.8987387168962613,-0.554722981469389,30.918362184375834,6.703919343575414,-127459937.0,2001-04-23,2001,0,113,4,1.62,122.9,123.64998999999999,121.10001000000001,328
2001-04-24 13:30:00,122.52,123.64998999999999,121.10001000000001,121.58,101.7316667213115,137.25404411764703,135.73648075000014,127.25514950000004,120.90819979999996,117.5465,121.4134650797822,119.3923856395598,119.22846153846146,127.00375795787791,111.45316511904501,135.73648075000014,127.25514950000004,120.90819979999996,117.5465,122.11,10045301,12968905.15,54.38587057400097,1.5,2.75,3.111023914372616,0.7745681600578288,1.2025148436943311,0.9484205731485248,-0.25409427054580624,31.676888210342828,4.226326980396651,-137505238.0,2001-04-24,2001,1,114,4,2.11,122.38,123.67,120.95,329
2001-04-25 13:30:00,121.42,123.67,120.95,123.17,101.44492475409835,137.2286764705882,135.61311200000014,127.15247450000004,120.70459959999997,117.7895,121.48234880214369,119.7521584357922,119.85307692307684,127.48869829266502,112.21745555348866,135.61311200000014,127.15247450000004,120.70459959999997,117.7895,122.59666666666668,8249000,12737295.2,57.17239168797967,1.5,2.75,3.0830936347745714,0.6476257219821678,1.085975016099121,1.103374499578095,0.01739948347897402,31.09467621571107,5.517005054399038,-129256238.0,2001-04-25,2001,2,115,4,2.25,122.31,125.22,123.5,330
2001-04-26 13:30:00,123.73,125.22,123.5,123.72,101.15818278688525,137.20330882352937,135.49093075000016,127.06686200000004,120.53379979999997,118.22350049999996,121.5700998295106,120.13004810857392,120.65461538461531,127.51906260148633,113.7901681677443,135.49093075000016,127.06686200000004,120.53379979999997,118.22350049999996,124.14666666666666,10590398,12719150.05,58.12532958378515,1.5,2.75,3.0093012322906736,0.8326340957035883,0.9909425924116428,1.2560777239935277,0.2651351315818848,30.95911910850702,4.097593260614788,-118665840.0,2001-04-26,2001,3,116,4,1.39,124.36,125.84,124.2,331
2001-04-27 13:30:00,124.92,125.84,124.2,125.78,100.87144081967213,137.17794117647057,135.37420575000016,127.00247450000003,120.40819979999996,118.7385005,121.73519395384352,120.6681387649002,121.51769230769224,127.90478442010031,115.13060019528416,135.37420575000016,127.00247450000003,120.40819979999996,118.7385005,125.27333333333335,8048898,12518525.05,61.57402533694329,1.5,2.75,2.945779715698482,0.6429589722313173,1.0084784632587125,1.5257332106552752,0.5172547473965629,30.756822754950537,6.955773218046497,-110616942.0,2001-04-27,2001,4,117,4,1.32,125.02,127.27,124.67,332
2001-04-30 13:30:00,126.45,127.27,124.67,124.91,100.58469885245906,137.15257352941174,135.24984950000015,126.91813700000004,120.23959979999994,119.14950049999996,121.85969615173201,121.0721255491954,122.15307769230762,128.10541425905294,116.2007411255623,135.24984950000015,126.91813700000004,120.23959979999994,119.14950049999996,125.61666666666666,10764898,12597589.85,59.350882450977906,1.5,2.75,2.921081164577162,0.8545204382884398,0.9063664195855614,1.650212771878515,0.7438463522929533,30.12065345676349,4.737556996273431,-121381840.0,2001-04-30,2001,0,120,4,2.09,125.97,127.14998999999999,124.60001000000001,333
2001-05-01 13:30:00,125.07001000000001,127.14998999999999,124.60001000000001,127.05,100.29795688524591,137.1272058823529,135.12884950000014,126.81144950000004,120.17259999999996,119.79200049999999,122.06323747911509,121.64144692546249,122.94692384615378,128.536091765111,117.35775592719652,135.12884950000014,126.81144950000004,120.17259999999996,119.79200049999999,126.26666666666668,10578102,12598444.95,62.89927330286416,1.5,2.75,2.8945739385359373,0.8396355297802052,0.9246396387997906,1.899645900792692,0.9750062619929009,30.4543944699896,2.4596774193548363,-110803738.0,2001-05-01,2001,1,121,5,2.05,125.88,127.69,126.0,334
2001-05-02 13:30:00,127.41,127.69,126.0,126.82001000000001,100.01121491803279,137.10183823529408,135.00794955000015,126.72449340000004,120.14120019999994,120.613501,122.24977757797329,122.13464340875177,123.56000076923071,128.96244932523706,118.15755221322435,135.00794955000015,126.72449340000004,120.14120019999994,120.613501,126.83667,9572898,12435289.85,62.270143786969996,1.5,2.75,2.808532942926227,0.7698170380805398,0.8640554303520402,2.055075549932951,1.191020119580911,22.402541312152838,0.931173969850689,-120376636.0,2001-05-02,2001,2,122,5,1.34,126.84,126.14998999999999,124.22,335
2001-05-03 13:30:00,126.13,126.14998999999999,124.22,125.21001000000001,99.72447295081969,137.07647058823522,134.88517150000015,126.64003100000004,120.13300039999994,121.33150099999996,122.36586512393515,122.42753546506115,124.14538538461531,128.35534527370478,119.93542549552586,134.88517150000015,126.64003100000004,120.13300039999994,121.33150099999996,125.19333333333331,9926199,12187374.8,57.90393857159064,1.5,2.75,2.7936384470029245,0.8144657207063165,0.6671824669342539,2.0249982032487277,1.3578157363144745,22.70872939882204,0.5702891566265036,-130302835.0,2001-05-03,2001,3,123,5,1.55,125.18,127.35001000000001,123.44,336
2001-05-04 13:30:00,123.64998999999999,127.35001000000001,123.44,127.34,99.43773098360657,137.05110294117642,134.77843400000015,126.57374350000003,120.16360039999994,121.94600099999998,122.56092923672199,122.89538923029343,124.76692461538454,128.22741184861928,121.30643738214977,134.77843400000015,126.57374350000003,120.16360039999994,121.94600099999998,126.04333666666665,12145301,11718759.85,61.72733517026386,1.5,2.75,2.8733792722170013,1.036398147539477,0.6323635390148556,2.148270160083044,1.5159066210681882,23.886545724744156,4.1721118969149344,-118157534.0,2001-05-04,2001,4,124,5,3.17,125.4,127.38,126.23,337
2001-05-07 13:30:00,126.86,127.38,126.23,126.24001000000001,99.15098901639344,137.02573529411762,134.65650905000015,126.44989360000004,120.18920039999996,122.59300149999996,122.70520691371328,123.21392454169406,124.939233076923,128.45248242342691,121.4259837304191,134.65650905000015,126.44989360000004,120.18920039999996,122.59300149999996,126.61667,7185199,11331129.75,58.759226412435716,1.5,2.75,2.7502807527729294,0.6341114397706019,0.4933711445773681,2.1326205517898984,1.6392494072125303,21.360580912081872,3.832875472939628,-125342733.0,2001-05-07,2001,0,127,5,0.91,126.8,127.10001000000001,125.56,338
2001-05-08 13:30:00,126.86,127.10001000000001,125.56,126.17998999999999,98.86424704918034,137.0003676470588,134.54897150000016,126.33138100000004,120.16040019999996,123.17400099999998,122.84147291709708,123.4964069662946,124.98000230769225,128.53732142794937,121.42268318743513,134.54897150000016,126.33138100000004,120.16040019999996,123.17400099999998,126.28000000000002,6952602,11227044.8,58.59367041306138,1.5,2.75,2.663832841860577,0.6192726691533287,0.3616150136954512,2.0912681743318444,1.7296531606363932,20.812516885620667,2.4437687748640107,-132295335.0,2001-05-08,2001,1,128,5,1.23,126.33,126.55,125.06,339
2001-05-09 13:30:00,125.25,126.55,125.06,125.64998999999999,98.57750508196722,136.97499999999997,134.44300270000016,126.22647470000004,120.14459999999997,123.62400099999998,122.95161084191679,123.70151011236179,125.06846307692301,128.63082789620336,121.50609825764263,134.44300270000016,126.22647470000004,120.14459999999997,123.62400099999998,125.75333,9507398,10808749.9,57.06469357960728,1.5,2.75,2.5799876388705347,0.8796019972670475,0.21048408731353074,1.9927582697783064,1.782274182464776,20.343130437093198,1.5599660523763366,-141802733.0,2001-05-09,2001,2,129,5,1.19,125.8,127.5,125.77,340
2001-05-10 13:30:00,127.25998999999999,127.5,125.77,126.02,98.29076311475409,136.94963235294114,134.33654020000014,126.14261220000004,120.18599999999996,124.08850099999998,123.0719398285083,123.92231867308924,125.35923153846146,128.54816017090076,122.17030290602214,134.33654020000014,126.14261220000004,120.18599999999996,124.08850099999998,126.43,6872398,10516254.75,57.8908251295929,1.5,2.75,2.5278463789512107,0.6535024268026599,0.11208874715831517,1.92238511641267,1.8102963692543548,20.29468235762233,0.1908093496581292,-134930335.0,2001-05-10,2001,3,130,5,1.38,126.64,126.49001000000001,124.39998999999999,341
2001-05-11 13:30:00,126.0,126.49001000000001,124.39998999999999,125.14998999999999,98.00402114754098,136.9242647058823,134.23291515000014,126.08442460000003,120.19699959999996,124.40349999999997,123.15343199209622,124.03923975184263,125.63384615384605,127.9761614773865,123.29153083030563,134.23291515000014,126.08442460000003,120.19699959999996,124.40349999999997,125.34666333333332,7736602,10441424.9,55.20127752004261,1.5,2.75,2.496573066168981,0.7409527027292989,-0.027485555301719256,1.7759394251272056,1.8034249804289249,18.47491100839025,0.19213033384036984,-142666937.0,2001-05-11,2001,4,131,5,1.68,125.44,125.44,124.46001000000001,342
2001-05-14 13:30:00,124.89998999999999,125.44,124.46001000000001,125.39998999999999,97.71727918032788,136.8988970588235,134.13304010000022,126.01123700000004,120.23279939999996,124.79349899999997,123.24153230613165,124.16883501357194,125.80538384615377,127.68093972157135,123.92982797073614,134.13304010000022,126.01123700000004,120.23279939999996,124.79349899999997,125.1,7914000,10469689.95,55.836222591684134,1.5,2.75,2.3882457042997682,0.7558963099953118,-0.11401425120208986,1.6609071664263126,1.7749214176284025,18.043078324201183,-1.2987091696182564,-134752937.0,2001-05-14,2001,0,134,5,0.79,124.95,126.5,124.85001000000001,343
2001-05-15 13:30:00,125.55,126.5,124.85001000000001,125.98,97.43053721311476,136.87352941176468,134.05247135000022,125.97088080000003,120.25759919999994,125.12949949999997,123.34892319608728,124.34132691704126,125.9792299999999,127.41731951187755,124.54114048812224,134.05247135000022,125.97088080000003,120.25759919999994,125.12949949999997,125.77667000000002,9782199,10412564.95,57.34666334117565,1.5,2.75,2.3355131539926424,0.9394610306848556,-0.14143868257636738,1.5981230644079432,1.7395617469843103,15.031541606908078,-0.6623639282160539,-124970738.0,2001-05-15,2001,1,135,5,1.32,125.68,129.2,124.62,344
2001-05-16 13:30:00,124.84,129.2,124.62,128.95,97.14379524590164,136.84816176470585,133.98269010000018,125.99788080000003,120.31499919999996,125.37699949999994,123.56857326682896,124.78024816303731,126.22307615384605,128.3522955258488,124.09385678184331,133.98269010000018,125.99788080000003,120.31499919999996,125.37699949999994,127.59,14916199,9533824.5,64.11466081974649,1.5,2.75,2.495833642993166,1.5645556513023708,0.02246587373905173,1.7676440891581249,1.7451782154190734,20.381746103563763,2.9869736453179683,-110054539.0,2001-05-16,2001,2,136,5,3.68,126.91,130.08,128.56,345
2001-05-17 13:30:00,129.005,130.08,128.56,129.14999,96.85705327868851,136.82279411764702,133.90906505000018,126.01813070000004,120.35839899999996,125.55199949999994,123.7874523544043,125.19641405227186,126.54922923076914,129.04191941043254,124.05653905110573,133.90906505000018,126.01813070000004,120.35839899999996,125.55199949999994,129.26333,11828898,9434749.5,64.52287873882943,1.5,2.75,2.4261312399222263,1.2537585656089756,0.12087281397623473,1.8962692328893669,1.775396418913132,18.215392652193344,1.4213836971886282,-98225641.0,2001-05-17,2001,3,137,5,1.18,129.32,129.74001,128.10001,346
2001-05-18 13:30:00,129.09,129.74001,128.10001,129.74001,96.57031131147544,136.79742647058822,133.8347963500002,126.00615580000004,120.41079919999996,125.81399999999994,124.02088598756492,125.62913747586502,126.75615307692298,129.7723948758852,123.73991127796076,133.8347963500002,126.00615580000004,120.41079919999996,125.81399999999994,129.19334333333333,6683301,9387579.6,65.76038393594612,1.5,2.75,2.3699790084992114,0.7119301550316548,0.1976837727639809,2.022501134868108,1.8248173621041268,16.057330223200154,2.7724966118111163,-91542340.0,2001-05-18,2001,4,138,5,1.28,128.92,131.84,129.14999,347
2001-05-21 13:30:00,129.84,131.84,129.14999,131.64999,96.28356934426229,136.77205882352936,133.7650775500002,125.99921820000004,120.57659899999996,126.28449899999994,124.32006653707217,126.20255200197313,127.1276899999999,131.11685295951622,123.1385270404836,133.7650775500002,125.99921820000004,120.57659899999996,126.28449899999994,130.87999333333335,11532102,9541594.65,69.47261524498767,1.5,2.75,2.392838365034982,1.2086136985498541,0.34071843360646925,2.250715404112213,1.909996970505744,16.02425441481216,4.335077217869489,-80010238.0,2001-05-21,2001,0,141,5,2.08,130.49,132.09,131.07001,348
2001-05-22 13:30:00,131.83,132.09,131.07001,131.48,95.9968273770492,132.09,133.69060255000022,125.98089320000004,120.84459899999996,126.77949899999994,124.60084824150073,126.7051660970233,127.60999692307684,132.0461999010675,123.17379394508616,133.69060255000022,125.98089320000004,120.84459899999996,126.77949899999994,131.54666999999998,8343199,9456489.55,68.75810366599737,1.5,2.75,2.294777767532484,0.8822723227140878,0.3842473222143559,2.390306123273689,2.006058801059333,16.117702040077347,4.639880990042249,-88353437.0,2001-05-22,2001,1,142,5,0.78,131.58,131.05,129.25,349
2001-05-23 13:30:00,131.05,131.05,129.25,129.25,95.71008540983608,132.00415584415586,133.5962275500002,125.93620570000004,121.02919899999996,127.08349899999992,124.7831679183046,126.94753123064012,127.75691999999992,132.27341126843984,123.24042873155994,133.5962275500002,125.93620570000004,121.02919899999996,127.08349899999992,129.85,12331000,9660589.55,60.03508282825509,1.5,2.75,2.2901507841373063,1.276423135066327,0.2307852612502579,2.294540377622156,2.063755116371897,19.81886782784455,2.5630852245675317,-100684437.0,2001-05-23,2001,2,143,5,1.39,130.15,130.0,128.55,350
2001-05-24 13:30:00,129.47,130.0,128.55,129.63,95.42334344262295,131.91831168831172,133.5009400500002,125.92063070000002,121.26879919999996,127.37899899999996,124.9732397646456,127.20300444676964,128.0176884615384,132.54518271636962,123.49019420670722,133.5009400500002,125.92063070000002,121.26879919999996,127.37899899999996,129.39333333333335,7905398,9526339.55,60.94434753453904,1.5,2.75,2.230140013841784,0.829846339037957,0.12793592053373848,2.2236750170390707,2.0957390965053317,19.818857973542983,3.5797126312195413,-92779039.0,2001-05-24,2001,3,144,5,1.13,129.28,129.7,127.89998999999999,351
2001-05-25 13:30:00,129.64999,129.7,127.89998999999999,128.10001,95.13660147540985,131.83246753246755,133.4042526000002,125.91350580000002,121.47719959999996,127.49499949999996,125.09585820524777,127.28843354707728,128.16538230769225,132.56696348516778,123.76380113021669,133.4042526000002,125.91350580000002,121.47719959999996,127.49499949999996,128.56666666666666,7425000,9495144.65,55.4719856680293,1.5,2.75,2.1994164414245128,0.7819786084038225,-0.05998150682885805,2.0207622129692595,2.0807437197981176,20.88123868392771,2.1531261685108545,-100204039.0,2001-05-25,2001,4,145,5,1.41,128.8,128.35001,126.89998999999999,352
2001-05-29 13:30:00,128.226,128.35001,126.89998999999999,127.08,94.84985950819672,131.74662337662338,133.3060588500002,125.83430580000002,121.71859979999998,127.60349949999996,125.17366768739491,127.26858273306992,128.27538307692302,132.4874092253333,124.06335692851269,133.3060588500002,125.83430580000002,121.71859979999998,127.60349949999996,127.44333333333334,9012301,9407514.8,52.11241997390497,1.5,2.75,2.1458881241799044,0.9579895638325224,-0.2586845786165295,1.7573879965274557,2.016072575143985,21.708257866801528,0.8731544689633229,-109216340.0,2001-05-29,2001,1,149,5,1.14,127.62,127.09,125.0,353
2001-05-30 13:30:00,126.59,127.09,125.0,125.3,94.5631175409836,131.66077922077923,133.1959182500002,125.75183710000002,121.87759959999998,127.51599949999996,125.17862189573236,127.08109866325377,128.21999846153838,132.56599781022766,123.8739991128491,133.1959182500002,125.75183710000002,121.87759959999998,127.51599949999996,125.79666666666668,10041801,9380699.75,46.78720897175882,1.5,2.75,2.1418961153099114,1.070474619977044,-0.5016427318564339,1.3890191603234427,1.8906618921798768,23.27011163412117,-2.8305544784800247,-119258141.0,2001-05-30,2001,2,150,5,1.67,126.04,126.75998999999999,125.25998999999999,354
2001-05-31 13:30:00,125.42998999999999,126.75998999999999,125.25998999999999,125.95,94.27637557377051,131.57493506493506,133.07926200000023,125.71946210000002,122.11259959999998,127.47249899999994,125.20887201746834,126.97337498103913,128.28153769230764,132.4717742438305,124.09130114078476,133.07926200000023,125.71946210000002,122.11259959999998,127.47249899999994,125.98999333333336,9875199,9395814.8,48.84299872085818,1.5,2.75,2.0960463927877746,1.0510210354508052,-0.6033825765903191,1.1364336714419778,1.739816248032297,18.27380944323411,-2.4777315120194743,-109382942.0,2001-05-31,2001,3,151,5,1.2,126.01,127.10001000000001,125.12,355
2001-06-01 13:30:00,126.2,127.10001000000001,125.12,126.73,93.9896336065574,131.48909090909092,132.96713075000022,125.6848871,122.40199979999996,127.54849849999997,125.26852409521469,126.95019641141634,128.3838461538461,132.34642683949014,124.42126546820204,132.96713075000022,125.6848871,122.40199979999996,127.54849849999997,126.31667,8848301,9341919.9,51.275622173471405,1.5,2.75,2.087758079017219,0.9471608721457779,-0.6016046233877423,0.987810468797619,1.5894150921853614,18.81843770331,-2.3200321936155297,-100534641.0,2001-06-01,2001,4,152,6,1.58,126.11,127.42998999999999,126.08,356
2001-06-04 13:30:00,126.8,127.42998999999999,126.08,127.34,93.70289163934427,131.40324675324678,132.86070575000022,125.65984960000002,122.72639979999998,127.54849849999997,125.34975844442194,126.98732056271002,128.48846153846148,132.25881186014794,124.71811121677506,132.86070575000022,125.65984960000002,122.72639979999998,127.54849849999997,126.94999666666668,5634699,9016389.8,53.151835872327105,1.5,2.75,2.035060359087418,0.6249395961119604,-0.5445147473766148,0.9087716579645928,1.4532864053412076,18.849423382119447,-3.273824783427632,-94899942.0,2001-06-04,2001,0,155,6,1.07,126.75,129.23,127.27,357
2001-06-05 13:30:00,127.49001000000001,129.23,127.27,128.8,93.41614967213116,131.3174025974026,132.7537682500002,125.6265996,123.0127998,127.67649799999997,125.48506203483677,127.1599566995948,128.47692307692301,132.2424679950575,124.7113781587885,132.7537682500002,125.6265996,123.0127998,127.67649799999997,128.43333333333334,9115602,9112909.95,57.38181881325503,1.5,2.75,2.0296989048668883,1.0002954105784838,-0.4002631018578465,0.9529575280188992,1.353220629876746,17.889200547892766,-2.0383328262853504,-85784340.0,2001-06-05,2001,1,156,6,1.54,128.25,128.83,127.36,358
2001-06-06 13:30:00,128.83,128.83,127.36,127.73,93.12940770491804,131.23155844155843,132.6439807500002,125.5813996,123.2485998,127.75399849999997,125.57309881778434,127.2142465377286,128.36769307692302,132.13118520387593,124.60420094997005,132.6439807500002,125.5813996,123.2485998,127.75399849999997,127.97333333333334,12064898,9368524.75,53.564661903189595,1.5,2.75,1.989720411662111,1.2878119364524279,-0.36948846632307175,0.8913600469729062,1.260848513295978,18.213651364789182,-1.1760154738878112,-97849238.0,2001-06-06,2001,2,157,6,1.15,128.1,128.35001,127.0,359
2001-06-07 13:30:00,127.05,128.35001,127.0,128.19,92.84266573770492,131.1457142857143,132.53211825000022,125.5432996,123.44619979999996,127.88099899999996,125.67572239355749,127.3071754388973,128.24846153846147,131.9277632377461,124.56915983917685,132.53211825000022,125.5432996,123.44619979999996,127.88099899999996,127.84666999999999,7355301,9260919.9,54.95205467466506,1.5,2.75,1.9440268108291028,0.7942300634735,-0.3129691148830449,0.8696371196921717,1.1826062345752166,16.054053955866564,-1.1108539689886583,-90493937.0,2001-06-07,2001,3,158,6,1.06,127.68,127.87,126.14,360
2001-06-08 13:30:00,127.7,127.87,126.14,127.0,92.55592377049182,131.05987012987015,132.4155557500002,125.48486210000002,123.68539999999996,127.92999899999998,125.72765484871212,127.2779206351928,127.89076999999996,131.0443319174347,124.73720808256516,132.4155557500002,125.48486210000002,123.68539999999996,127.92999899999998,127.00333333333334,8170602,9325830.1,50.72941088203354,1.5,2.75,1.9515963243413093,0.8761259761744963,-0.3478621374471109,0.747778562766328,1.095640700213439,16.53710877414364,-0.8587118767594144,-98664539.0,2001-06-08,2001,4,159,6,1.37,127.0,126.99001000000001,125.41,361
2001-06-11 13:30:00,126.71001000000001,126.99001000000001,125.41,126.10001000000001,92.2691818032787,130.974025974026,132.2918370500002,125.411331,123.89780019999998,127.9775,125.74225701150772,127.16573866993635,127.47692461538456,129.9834614138635,124.9703878169056,132.2918370500002,125.411331,123.89780019999998,127.9775,126.16667333333334,7012199,9289609.95,47.741471913126574,1.5,2.75,1.925768015459788,0.7548432106129495,-0.4189209063238893,0.5719895673085773,0.9909104736324666,15.709245846375618,-0.7711598992760472,-105676738.0,2001-06-11,2001,0,162,6,1.26,126.2,126.74001000000001,124.03998999999999,362
2001-06-12 13:30:00,124.86,126.74001000000001,124.03998999999999,125.88,91.98243983606558,130.88818181818183,132.1646745500002,125.32231850000001,124.08160020000001,128.0015005,125.74765869733095,127.04328736803764,127.2176938461538,129.63249602389513,124.8028916684125,132.1646745500002,125.32231850000001,124.08160020000001,128.0015005,125.55333333333333,9368500,9362334.95,47.01249359518551,1.5,2.75,1.9810717286412312,1.000658494919582,-0.4645731057317438,0.4101940914677869,0.8747671971995307,15.176237911961913,0.4628890662410202,-115045238.0,2001-06-12,2001,1,163,6,2.18,125.39,126.58,124.64998999999999,363
2001-06-13 13:30:00,126.17,126.58,124.64998999999999,124.8,91.69569786885245,130.80233766233766,132.0324245500002,125.2301623,124.29360020000001,127.9425005,125.71049561116112,126.82964095203407,126.84615538461534,129.14552773020722,124.54678303902344,132.0324245500002,125.2301623,124.29360020000001,127.9425005,125.34333,7629398,9254694.9,43.501058471774705,1.5,2.75,1.9774244623097144,0.824381363452619,-0.5457314924989866,0.1926028315757975,0.738334324074784,13.692816580491847,-0.9130607383882536,-122674636.0,2001-06-13,2001,2,164,6,1.55,125.61,124.3,121.75,364
2001-06-14 13:30:00,124.17998999999999,124.3,121.75,122.0,91.40895590163936,130.71649350649352,131.8835964500002,125.1010998,124.5258002,127.5950005,125.56498597935087,126.36967514707844,126.37692384615379,129.71591823116793,123.03792946113964,131.8835964500002,125.1010998,124.5258002,127.5950005,122.68333333333334,12603301,9139050.0,35.99470602839354,1.5,2.75,2.0540370007161632,1.379060296201465,-0.7534125621965694,-0.20343137867092764,0.5499811835256417,18.14344917646745,-3.732344354138723,-135277937.0,2001-06-14,2001,3,165,6,2.09,123.02,122.39998999999999,120.39998999999999,365
2001-06-15 13:30:00,120.91,122.39998999999999,120.39998999999999,121.85001000000001,120.39998999999999,130.63064935064935,131.73386215000022,124.95991240000001,124.7458002,127.23000150000004,125.4193006468273,125.93923084735668,125.97461692307692,130.0556591388698,121.89357470728399,131.73386215000022,124.95991240000001,124.7458002,127.23000150000004,121.54999666666669,16821296,9388669.9,35.63992946666193,1.5,2.75,2.050177214950723,1.7916591145674423,-0.8586739866305693,-0.5233612997625698,0.3353126868679994,17.222122912077204,-4.31128474948956,-152099233.0,2001-06-15,2001,4,166,6,1.66,121.4,122.44,120.91,366
2001-06-18 13:30:00,121.64998999999999,122.44,120.91,121.25998999999999,120.60948152542372,130.5448051948052,131.5884433500002,124.80876229999998,124.86999999999998,126.80600050000002,125.25619042538307,125.49358886189415,125.66384692307687,130.456325909546,120.8713679366078,131.5884433500002,124.80876229999998,124.86999999999998,126.80600050000002,121.53666333333332,11368801,9622944.9,34.2114409056084,1.5,2.75,2.0130216995971,1.1814263843493482,-0.9203473787087934,-0.8151215365179922,0.10522584219080107,16.300405799338414,-5.854045031055907,-163468034.0,2001-06-18,2001,0,169,6,1.27,121.68,122.89,120.89,367
2001-06-19 13:30:00,122.38,122.89,120.89,121.78998999999999,120.81897305084746,130.45896103896104,131.43567455000021,124.6663497,125.03979979999998,126.31300050000004,125.12026099693671,125.14086516076135,125.34384615384613,130.55446270361108,120.13322960408111,131.43567455000021,124.6663497,125.03979979999998,126.31300050000004,121.85666333333334,7732301,9432954.85,36.6670730539728,1.5,2.75,2.0120915781973068,0.8197114396238205,-0.8778928977514593,-0.9921402799985232,-0.11424738224706375,14.080546745663845,-4.650442339309482,-155735733.0,2001-06-19,2001,1,170,6,1.65,121.89,122.86,121.10001000000001,368
2001-06-20 13:30:00,121.19,122.86,121.10001000000001,122.42998999999999,121.0284645762712,130.37311688311692,131.2859495000002,124.5318996,125.19719959999996,125.86050000000004,125.0147601735274,124.8826865740222,125.01307615384613,130.37350169911142,119.65265060858087,131.2859495000002,124.5318996,125.19719959999996,125.86050000000004,122.13,8787199,9455154.85,39.598953048037956,1.5,2.75,1.9940843226117853,0.9293553769772476,-0.7633777787986625,-1.0684696057453922,-0.3050918269467294,15.219875589012018,-4.493338013885634,-146948534.0,2001-06-20,2001,2,171,6,1.45,121.98,124.31,122.14998999999999,369
2001-06-21 13:30:00,122.22,124.31,122.14998999999999,123.82001000000001,121.23795610169493,130.28727272727272,131.1486433000002,124.40409960000001,125.34059999999998,125.58900050000004,124.96790722554594,124.78147928125816,124.74230769230766,129.95890123364134,119.52571415097395,131.1486433000002,124.40409960000001,125.34059999999998,125.58900050000004,123.42666666666668,12259102,9451559.95,45.500120409773295,1.5,2.75,2.0059361567109435,1.297045362337251,-0.5600951031697771,-1.0052107059089508,-0.4451156027391737,17.17827025224365,-2.5039291338582705,-134689432.0,2001-06-21,2001,3,172,6,1.77,123.23,123.59899999999999,122.16,370
2001-06-22 13:30:00,123.49001000000001,123.59899999999999,122.16,122.85001000000001,121.44744762711865,130.20142857142858,131.0139871000002,124.2545997,125.46300019999998,125.25000100000004,124.88485243238728,124.59752982590022,124.28461615384614,129.01859870835742,119.55063359933484,131.0139871000002,124.2545997,125.46300019999998,125.25000100000004,122.86967,12212000,9666890.05,42.38789740638863,1.5,2.75,1.9812271455173047,1.2632811521426168,-0.4611654494220644,-1.0215724145167542,-0.5604069650946898,17.016000230808896,-2.577319383241921,-146901432.0,2001-06-22,2001,4,173,6,1.18,122.88,123.44,121.5,371
2001-06-25 13:30:00,123.28,123.44,121.5,121.72,121.65693915254238,130.11558441558444,130.8683683500002,124.1015997,125.5204,124.93100050000002,124.76074057229366,124.3234793662907,123.82230846153843,128.2862679707381,119.35834895233882,130.8683683500002,124.1015997,125.5204,124.93100050000002,122.21999999999998,8406801,9715980.1,39.03793285771725,1.5,2.75,1.9782823494089257,0.8652550657241466,-0.4419886791025044,-1.1128928139728202,-0.6709041348703159,17.231456764666902,-3.304734667937716,-155308233.0,2001-06-25,2001,0,176,6,1.6,122.47,122.39,120.571,372
2001-06-26 13:30:00,120.89998999999999,122.39,120.571,121.55,121.86643067796612,130.02974025974027,130.7270558500002,123.93779979999998,125.5993998,124.65450050000004,124.63482917730177,124.059338474263,123.3115392307692,127.13284330947269,119.49023515206578,130.7270558500002,123.93779979999998,125.5993998,124.65450050000004,121.50366666666666,8006398,9665684.95,38.54440575333483,1.5,2.75,1.96690503873686,0.8283321918122316,-0.411531771987481,-1.1853188498546672,-0.7737870778671861,17.245820077420326,-2.6041666666666665,-163314631.0,2001-06-26,2001,1,177,6,1.51,121.48,122.24001000000001,120.91,373
2001-06-27 13:30:00,121.60001000000001,122.24001000000001,120.91,121.48,122.07592220338984,129.94389610389612,130.5864871000002,123.80459979999998,125.6438,124.46350050000004,124.511110386035,123.81368719099987,122.8869238461538,126.16217378310287,119.61167390920477,130.5864871000002,123.80459979999998,125.6438,124.46350050000004,121.54333666666668,10105102,9668850.0,38.329527992649375,1.5,2.75,1.9214125359699408,1.0451193264969465,-0.3682815645258052,-1.2341390335244429,-0.8658574689986375,16.988980849342752,-0.4262295081967181,-173419733.0,2001-06-27,2001,2,178,6,1.1,121.58,123.94,121.92998999999999,374
2001-06-28 13:30:00,122.0,123.94,121.92998999999999,122.14998999999999,122.28541372881357,129.85805194805195,130.4548933000002,123.66819979999998,125.6067998,124.27350000000004,124.41851742971993,123.65523983947607,122.58307615384615,125.29388337883059,119.87226892886166,130.4548933000002,123.66819979999998,125.6067998,124.27350000000004,122.67332666666668,10271000,9688640.05,41.680704829564405,1.5,2.75,1.959883069114945,1.0601075018779338,-0.2712161903672864,-1.2048777069577454,-0.933661516590459,11.756216689621198,0.2461879157826947,-163148733.0,2001-06-28,2001,3,179,6,1.65,122.93,124.00998999999999,122.25998999999999,375
2001-06-29 13:30:00,122.8,124.00998999999999,122.25998999999999,122.60001000000001,122.4949052542373,129.77220779220778,130.3234402500002,123.54029990000001,125.5458002,124.06700050000003,124.34720341286815,123.55474175952598,122.33076923076919,124.26710694043292,120.3944315211055,130.3234402500002,123.54029990000001,125.5458002,124.06700050000003,122.95666333333334,9824199,9737434.95,43.88635548708192,1.5,2.75,1.9527485641781632,1.0089103599095162,-0.1589286545532581,-1.1323223347820317,-0.9733936802287736,11.885830765250304,1.1050800845357116,-153324534.0,2001-06-29,2001,4,180,6,1.43,123.13,124.32001000000001,122.62,376
2001-07-02 13:30:00,122.8,124.32001000000001,122.62,124.13,122.70439677966101,129.68636363636364,130.2017465000002,123.43469989999998,125.53840020000001,123.90650050000004,124.33868563197136,123.60952825861874,122.27923076923076,123.97003504841084,120.5884264900507,130.2017465000002,123.43469989999998,125.53840020000001,123.90650050000004,123.69000333333334,8522301,9881815.05,50.711495465622036,1.5,2.75,1.9361236667368655,0.8624226376307255,0.026296932055270728,-0.9405225151596852,-0.966819447214956,13.046752284311587,1.921348380109065,-144802233.0,2001-07-02,2001,0,183,7,1.39,123.47,124.10001000000001,123.05,377
2001-07-03 13:30:00,123.98,124.10001000000001,123.05,124.10001000000001,122.91388830508477,129.6005194805195,130.09177780000022,123.34449999999997,125.57560020000001,123.67150100000003,124.3293258032666,123.65624080541694,122.44077,124.37739635240982,120.50414364759015,130.09177780000022,123.34449999999997,125.57560020000001,123.67150100000003,123.75000666666666,3303100,9591189.95,50.581625589654905,1.5,2.75,1.874971976255661,0.34438896708536154,0.14791462930641908,-0.7819261605819321,-0.9298407898883512,13.053098533746187,1.364061207552164,-148105333.0,2001-07-03,2001,1,184,7,0.85,123.58,123.64998999999999,121.66,378
2001-07-05 13:30:00,123.07001000000001,123.64998999999999,121.66,121.67998999999999,123.12337983050848,129.51467532467532,129.9768965000002,123.24289989999995,125.5776,123.36900050000004,124.22543028156988,123.46802644299628,122.42769153846152,124.3823121409982,120.47307093592484,129.9768965000002,123.24289989999995,125.5776,123.36900050000004,122.32999333333332,5517801,9263835.1,41.37384323659924,1.5,2.75,1.9153318350945423,0.5956281540460495,0.07042547472994333,-0.841808946475922,-0.9122344212058652,17.703674816114333,-1.7283313092932175,-153623134.0,2001-07-05,2001,3,186,7,1.64,122.65,121.49001000000001,119.05,379
2001-07-06 13:30:00,121.31,121.49001000000001,119.05,119.05,123.3328713559322,129.4288311688312,129.84230275000021,123.09989979999996,125.49519999999998,122.91200050000003,124.02247223131224,123.0472620198538,122.25769230769228,124.86456707501459,119.65081754036994,129.84230275000021,123.09989979999996,125.49519999999998,122.91200050000003,119.86333666666668,11666199,9479380.0,34.10727838334134,1.5,2.75,1.966378846873504,1.2306921971690132,-0.14135819647803005,-1.0889321668034029,-0.9475739703253728,19.652481417874352,-3.093210981423608,-165289333.0,2001-07-06,2001,4,187,7,2.05,120.27,120.53998999999999,119.2,380
2001-07-09 13:30:00,119.491,120.53998999999999,119.2,119.7,123.54236288135591,129.342987012987,129.7163496500002,122.97429989999996,125.41479999999996,122.54700050000004,123.8529635163588,122.7284751608201,122.09692384615386,125.03596488211218,119.15788281019549,129.7163496500002,122.97429989999996,125.41479999999996,122.54700050000004,119.81333,8339301,9487814.95,37.049959782602784,1.5,2.75,1.9323510720968256,0.8789485296611946,-0.21656953592395745,-1.2182858902303195,-1.001716354306362,20.153634702340387,-1.6595465001643084,-156950032.0,2001-07-09,2001,0,190,7,1.12,119.87,120.64,118.21001000000001,381
2001-07-10 13:30:00,120.28998999999999,120.64,118.21001000000001,118.25998999999999,123.75185440677966,129.25714285714287,129.5817121000002,122.83629979999998,125.26439979999998,122.15499950000005,123.63363122159964,122.3029051455039,121.77615461538458,125.34296304743162,118.20934618333756,129.5817121000002,122.83629979999998,125.26439979999998,122.15499950000005,119.03666666666668,8630699,9568739.95,33.48248942467136,1.5,2.75,1.9678967098041955,0.9019681844316398,-0.3351232307482335,-1.420620392741654,-1.0854971619934204,20.560666805593986,-2.706713286713283,-165580731.0,2001-07-10,2001,1,191,7,2.06,119.43,118.89,117.09,382
2001-07-11 13:30:00,118.10001000000001,118.89,117.09,118.38,123.9613459322034,129.17129870129872,129.44720585000022,122.68669979999996,125.13379979999998,121.77999950000005,123.42760646781142,121.92929513164637,121.35769230769228,125.13727225873244,117.57811235665208,129.44720585000022,122.68669979999996,125.13379979999998,121.77999950000005,118.12,15329699,9866799.9,34.0524019810558,1.5,2.75,1.955904087675324,1.5536647297367403,-0.3743076481191532,-1.5533817221423618,-1.1790740740232086,20.670478197988654,-2.5518603885413307,-150251032.0,2001-07-11,2001,2,192,7,1.54,117.99,121.47,119.31,383
2001-07-12 13:30:00,119.5,121.47,119.31,121.19,124.17083745762713,129.08545454545455,129.3323746000002,122.59459989999998,125.01659979999997,121.59949950000002,123.3398571945639,121.85888607148958,121.2299992307692,124.91013789041193,117.54986057112647,129.3323746000002,122.59459989999998,125.01659979999997,121.59949950000002,120.65666666666668,12004801,10085570.05,45.768820041242684,1.5,2.75,2.0369109385556583,1.190294741941731,-0.18916882777539026,-1.4155351087424464,-1.226366280967056,25.559925326616238,-0.7859108297921308,-138246231.0,2001-07-12,2001,3,193,7,1.81,120.39,122.32001000000001,120.62,384
2001-07-13 13:30:00,120.84,122.32001000000001,120.62,122.24001000000001,124.38032898305084,128.9996103896104,129.23154340000022,122.53309999999998,124.92499979999997,121.61150000000002,123.29672593203199,121.89518358849057,121.26999999999997,124.98174174338816,117.55825825661177,129.23154340000022,122.53309999999998,124.92499979999997,121.61150000000002,121.72667333333334,10433602,9977085.1,49.387307857854594,1.5,2.75,2.012846585801682,1.0457565406553464,0.014978873095810474,-1.207642689597293,-1.2226215626931034,25.87703852139093,-0.293637822704908,-127812629.0,2001-07-13,2001,4,194,7,1.41,121.47,122.28,120.28998999999999,385
2001-07-16 13:30:00,121.77,122.28,120.28998999999999,120.71001000000001,124.58982050847456,128.91376623376624,129.11931220000022,122.48400009999996,124.83499979999996,121.5545,123.19528609156015,121.78230991339622,121.20538538461537,124.92461814960475,117.48615261962593,129.11931220000022,122.48400009999996,124.83499979999996,121.5545,121.09333333333336,6915301,9481785.35,44.70639661355168,1.5,2.75,2.0112154011015617,0.7293247784817234,0.055654861492732584,-1.1530529858271876,-1.2087078473199202,26.717029040319737,-2.7551679690646886,-134727930.0,2001-07-16,2001,0,197,7,1.65,121.28,121.95,119.83,386
2001-07-17 13:30:00,120.2,121.95,119.83,121.84,124.7993120338983,128.8279220779221,128.9978872000002,122.44430009999998,124.72499979999996,121.5835005,123.14213761738131,121.78780420735849,121.23307769230766,124.96541469839914,117.50074068621618,128.9978872000002,122.44430009999998,124.72499979999996,121.5835005,121.20666666666664,7470301,9286860.35,48.58248763777843,1.5,2.75,2.0189857295943083,0.8043946735992429,0.16136514384965528,-1.0070014175078512,-1.1683665613575065,26.18204603708537,-1.8211199177179715,-127257629.0,2001-07-17,2001,1,198,7,1.77,120.89,121.64,120.06,387
2001-07-18 13:30:00,120.56,121.64,120.06,121.00998999999999,125.00880355932205,128.74207792207793,128.88481215000022,122.4047999,124.62039939999997,121.54450049999998,123.05852398532714,121.71372666380054,121.14538538461537,124.84081600053568,117.44995476869501,128.88481215000022,122.4047999,124.62039939999997,121.54450049999998,120.90333000000001,7709301,9285710.35,46.03005674424438,1.5,2.75,2.0019153203375715,0.8302327672755806,0.17684574917168838,-0.947309374892896,-1.1241551240645844,26.30556462056833,-0.5506246343379891,-134966930.0,2001-07-18,2001,2,199,7,1.32,120.85,122.98,120.75998999999999,388
2001-07-19 13:30:00,122.17998999999999,122.98,120.75998999999999,122.07001000000001,125.21829508474578,128.65623376623378,128.7759434500002,122.34929999999996,124.53819979999996,121.5265015,123.01975873100059,121.74765841010527,121.10461615384612,124.74625840324295,117.46297390444927,128.7759434500002,122.34929999999996,124.53819979999996,121.5265015,121.93666666666668,10082898,9350495.3,49.6670464928422,1.5,2.75,2.017493511742031,1.0783276902989298,0.25517485396683104,-0.8051865566060457,-1.0603614105728767,24.515792647705368,2.5367576648467023,-124884032.0,2001-07-19,2001,3,200,7,1.84,121.87,121.94,120.92,389
2001-07-20 13:30:00,121.14998999999999,121.94,120.92,121.34,125.42778661016949,128.57038961038958,128.67014345000018,122.29829999999995,124.45199999999996,121.402501,122.9538858395888,121.70883379961904,120.89000076923072,124.09594455689087,117.68405698157059,128.67014345000018,122.29829999999995,124.45199999999996,121.402501,121.40000000000002,6705801,9072830.25,47.302884800029524,1.5,2.75,1.9555304037604568,0.7391079536619789,0.2539729116755973,-0.74289527097838,-0.9968681826539774,20.664098262179877,1.3700918964076862,-131589833.0,2001-07-20,2001,4,201,7,0.84,121.43,121.88,118.95,390
2001-07-23 13:30:00,121.8,121.88,118.95,118.95,125.63727813559322,128.48454545454547,128.54645595000022,122.24829999999996,124.31059999999997,121.2075005,122.79687070862455,121.44608772346486,120.49384615384614,123.2575108943676,117.73018141332464,128.54645595000022,122.24829999999996,124.31059999999997,121.2075005,119.92666666666666,8065199,8865490.2,40.5050341507381,1.5,2.75,2.025135374920424,0.909729616530398,0.09646991824421958,-0.8762807848487029,-0.9727507030929224,23.92566562001277,0.5834686777835859,-139655032.0,2001-07-23,2001,0,204,7,2.46,120.42,119.2,116.75,391
2001-07-24 13:30:00,119.0,119.2,116.75,117.8,116.75,128.3987012987013,128.4145184500002,122.18029989999997,124.16360019999996,121.0115005,122.60091499456085,121.09884127361104,120.19538538461536,123.20893602083063,117.18183474840008,128.4145184500002,122.18029989999997,124.16360019999996,121.0115005,117.91666666666669,12271000,9058700.15,37.69776401424347,1.5,2.75,2.055482848140393,1.3546093586064882,-0.07182895013384437,-1.062536890760228,-0.9907079406263836,23.543722558915324,-0.4899476262882229,-151926032.0,2001-07-24,2001,1,205,7,2.1,117.98,119.48,117.46001000000001,392
2001-07-25 13:30:00,117.92,119.48,117.46001000000001,119.10001000000001,116.60961576923077,128.31285714285715,128.30470600000018,122.13519999999995,124.03760059999996,120.889001,122.46362460261729,120.90847639041,120.19923230769226,123.20704681402651,117.191417801358,128.30470600000018,122.13519999999995,124.03760059999996,120.889001,118.68000666666669,12088898,9262825.15,42.54543647813555,1.5,2.75,2.0529476447017947,1.305098369475321,-0.08155433175978355,-1.092650855326113,-1.0110965235663294,24.43584381153531,-1.7245564815578844,-139837134.0,2001-07-25,2001,2,206,7,1.72,118.47,120.85001000000001,118.56,393
2001-07-26 13:30:00,119.06,120.85001000000001,118.56,120.35001000000001,116.46923153846156,128.22701298701298,128.20645605000018,122.09129999999996,123.92500079999998,120.83250149999999,122.3807377554558,120.85528911513285,120.249233076923,123.2437707376627,117.25469541618335,128.20645605000018,122.09129999999996,123.92500079999998,120.83250149999999,119.92000666666668,12930000,9404070.05,46.82943136274999,1.5,2.75,2.069880670080237,1.374936589290931,0.005615254058130237,-1.0040774559936665,-1.0096927100517967,20.870863962564627,-1.5461386169716451,-126907134.0,2001-07-26,2001,3,207,7,1.93,119.71,121.35001000000001,119.91,394
2001-07-27 13:30:00,120.83,121.35001000000001,119.91,120.81,116.32884730769231,128.14116883116884,128.12206855000022,122.03859999999996,123.7622008,120.765502,122.3191401964183,120.85097586607256,120.44538769230765,123.21893064436199,117.67184474025326,128.12206855000022,122.03859999999996,123.7622008,120.765502,120.69000333333334,8481801,9314610.1,48.35549141505517,1.5,2.75,2.024889907931649,0.9105910938773488,0.09851776368044683,-0.8865455054512381,-0.9850632691316851,20.259617845485586,0.08283488668421563,-118425333.0,2001-07-27,2001,4,208,7,1.2,120.63,121.35001000000001,120.3,395
2001-07-30 13:30:00,121.19,121.35001000000001,120.3,120.85001000000001,116.18846307692309,128.0553246753247,128.0436623500002,121.97730009999997,123.59620120000001,120.67800200000002,122.26152724753919,120.85088387882757,120.63538846153837,123.14256865755064,118.12820826552614,128.0436623500002,121.97730009999997,123.59620120000001,120.67800200000002,120.83333999999999,8547699,9250785.1,48.49396383812602,1.5,2.75,1.9552556287936742,0.9239971426857596,0.16311677144800485,-0.7811673048216792,-0.9442840762696838,18.910119757297963,-0.8125328299409109,-109877634.0,2001-07-30,2001,0,211,7,0.87,120.83,122.67998999999999,120.8,396
2001-07-31 13:30:00,121.0,122.67998999999999,120.8,121.35001000000001,116.04807884615386,127.96948051948051,127.98478740000016,121.91960019999996,123.42840120000001,120.5390025,122.22578147312588,120.89841969989159,120.64769692307684,123.16718809560136,118.12820575055235,127.98478740000016,121.91960019999996,123.42840120000001,120.5390025,121.61,11918602,9420600.15,50.28782187572028,1.5,2.75,1.9498795124512691,1.265163769847508,0.2355730169131919,-0.649817805128194,-0.8853908220413859,18.20940406295265,0.28098506577844984,-97959032.0,2001-07-31,2001,1,212,7,1.56,121.74,122.7,121.55,397
2001-08-01 13:30:00,121.97,122.7,121.55,122.11,115.9076946153846,127.88363636363636,127.90752490000015,121.90710019999996,123.2376014,120.43950200000002,122.22124102319937,121.01380829990192,120.63769615384605,123.13273957268841,118.14265273500372,127.90752490000015,121.90710019999996,123.2376014,120.43950200000002,122.12,11940801,9852485.2,52.96906451118875,1.5,2.75,1.9070302615618933,1.2119582783032246,0.32521078649060553,-0.4788773389281289,-0.8040881254187344,18.065394916805637,0.032759889181628706,-86018231.0,2001-08-01,2001,2,213,8,0.95,122.12,123.25,121.89,398
2001-08-02 13:30:00,123.23,123.25,121.89,122.61,115.7673103846154,123.25,127.8296374000002,121.95240019999996,123.06020139999998,120.4860025,122.23648647326998,121.16582655705412,120.78384923076914,123.49218957899024,118.07550888254805,127.8296374000002,121.95240019999996,123.06020139999998,120.4860025,122.58333333333331,11070199,10130105.1,54.70014379042989,1.5,2.75,1.8679566714503293,1.0928019887967402,0.4035854669377423,-0.2996062917465565,-0.7031917586842988,17.520463710435006,1.0466457886929257,-74948032.0,2001-08-02,2001,3,214,8,1.12,122.57,122.36,120.89998999999999,399
2001-08-03 13:30:00,122.36,122.36,120.89998999999999,121.94,115.62692615384616,123.0732,127.76558740000016,121.97160019999995,122.91400139999998,120.63050249999999,122.22485955274959,121.2395573611442,120.79154153846146,123.5123762581685,118.07070681875443,127.76558740000016,121.97160019999995,122.91400139999998,120.63050249999999,121.73333,10816500,10087620.15,51.94124856643282,1.5,2.75,1.8566747663467345,1.0722548865997894,0.3952056114804925,-0.2091847443336832,-0.6043903558141757,17.45326556667381,2.513661202185788,-85764532.0,2001-08-03,2001,4,215,8,1.21,121.63,121.50998999999999,120.10001000000001,400
2001-08-06 13:30:00,121.35001000000001,121.50998999999999,120.10001000000001,120.3,115.48654192307691,122.8964,127.69583740000016,121.99810029999996,122.72740139999998,120.66050250000004,122.1493748644065,121.15007570770192,120.73692692307684,123.46651847504108,118.00733537111259,127.69583740000016,121.99810029999996,122.72740139999998,120.66050250000004,120.63666666666668,8550398,10098175.0,45.84586996120564,1.5,2.75,1.8554829973219675,0.8467270571167562,0.2700850920695762,-0.2667839907272054,-0.5368690827967816,14.944254007022648,2.1222410865874366,-94314930.0,2001-08-06,2001,0,218,8,1.17,120.8,121.2,119.911,401
2001-08-07 13:30:00,120.27,121.2,119.911,120.77,115.34615769230768,122.7196,127.60328115000016,122.02900039999994,122.58080119999998,120.78600300000002,122.09528173246895,121.1138780212541,120.63692615384608,123.25688851236956,118.0169637953226,127.60328115000016,122.02900039999994,122.58080119999998,120.78600300000002,120.62700000000001,8865102,10109895.15,47.738681424807126,1.5,2.75,1.815019926084684,0.8768737824150431,0.21239250261221326,-0.271378454531515,-0.4837709571437282,13.283462472300766,1.4021745254261508,-85449828.0,2001-08-07,2001,1,219,8,1.07,120.56,121.16,118.42998999999999,402
2001-08-08 13:30:00,120.12,121.16,118.42998999999999,118.53,115.20577346153844,122.5428,127.49639990000016,122.06420049999996,122.4098012,120.79350300000004,121.95546676256822,120.86779440018229,120.42077230769225,123.2298833988044,117.61166121658006,127.49639990000016,122.06420049999996,122.4098012,120.79350300000004,119.37333,15183801,10102600.25,40.477258837584216,1.5,2.75,1.8803763599357777,1.5029596959456055,0.026556819803598364,-0.4505749323892303,-0.4771317521928287,16.79904959551485,-1.5122641036756013,-100633629.0,2001-08-08,2001,2,220,8,2.31,119.79,118.97,117.86,403
2001-08-09 13:30:00,118.7,118.97,117.86,118.88,115.06538923076923,122.366,127.38814365000015,122.07950039999994,122.28140119999998,120.67800300000003,121.83486022285965,120.67848064778394,120.41538769230759,123.23599989247481,117.59477549214041,127.38814365000015,122.07950039999994,122.28140119999998,120.67800300000003,118.57,14118500,10208285.2,41.962725838524925,1.5,2.75,1.825349477083222,1.383043255883956,-0.06462743687806399,-0.5579160482904086,-0.4932886114123447,15.521616759439032,-1.5975498716993684,-86515129.0,2001-08-09,2001,3,221,8,0.94,118.42,119.84,117.34,404
2001-08-10 13:30:00,118.8,119.84,117.34,119.28998999999999,114.925005,122.1892,127.28662485000015,122.13040029999992,122.148201,120.53050200000004,121.73506139059064,120.54624344323312,120.53000230769224,123.0176341998983,118.04237041548616,127.28662485000015,122.13040029999992,122.148201,120.53050200000004,118.82333,11173301,10245270.15,43.73411958511328,1.5,2.75,1.8735388001487063,1.090581393795653,-0.08773026330224654,-0.6029514405401528,-0.5152211772379063,15.478902832651393,-1.2908728762206925,-75341828.0,2001-08-10,2001,4,222,8,2.13,118.59,119.85001000000001,118.819,405
2001-08-13 13:30:00,119.60001000000001,119.85001000000001,118.819,119.32001000000001,114.78462076923077,122.0124,127.20166240000015,122.20100049999992,122.00000120000001,120.46100200000004,121.64035349292044,120.42945930578233,120.54692538461529,122.99814145385996,118.09570931537066,127.20166240000015,122.20100049999992,122.00000120000001,120.46100200000004,119.32967333333332,7435398,10271275.0,43.86921211846328,1.5,2.75,1.813358171566656,0.7239021445730934,-0.09099872256549467,-0.6289695804447746,-0.5379708578792799,15.47597517733967,-1.6728469985292964,-67906430.0,2001-08-13,2001,0,225,8,0.87,119.33,120.35001000000001,118.8,406
2001-08-14 13:30:00,120.14,120.35001000000001,118.8,119.27,114.64423653846156,121.8356,127.11457490000015,122.28250049999993,121.8386012,120.33250200000003,121.54739845398237,120.31903460999355,120.46384769230758,123.00759016473604,117.92010521987915,127.11457490000015,122.28250049999993,121.8386012,120.33250200000003,119.47333666666668,13178102,10556665.05,43.68105951109618,1.5,2.75,1.7945475878833232,1.2483205574472591,-0.08656396985181247,-0.6461758201940455,-0.5596118503422329,15.111670687734305,-2.3257718450577376,-81084532.0,2001-08-14,2001,1,226,8,1.3,119.58,119.61,118.08,407
2001-08-15 13:30:00,119.23,119.61,118.08,118.24001000000001,114.50385230769231,121.6588,127.0093687000002,122.32010059999992,121.6274014,120.19400300000004,121.41769694598308,120.12103226618464,120.26615615384607,123.05884447126385,117.4734678364283,127.0093687000002,122.32010059999992,121.6274014,120.19400300000004,118.64333666666666,8520602,10597230.1,39.88669303702161,1.5,2.75,1.7756513316059432,0.8040404822388447,-0.13987620756297714,-0.7344571097959545,-0.5945809022329773,14.650776473486225,-3.5641383247695964,-89605134.0,2001-08-15,2001,2,227,8,1.3,118.84,118.75,117.0,408
2001-08-16 13:30:00,117.8,118.75,117.0,118.64998999999999,114.36346807692308,121.48200000000001,126.8999624000002,122.34720049999993,121.44580120000002,120.02300200000003,121.30915941868963,119.98093300273848,120.09692384615374,122.99232573859676,117.20152195371072,126.8999624000002,122.34720049999993,121.44580120000002,120.02300200000003,118.13333,10734699,10629820.15,42.044703704677616,1.5,2.75,1.77381909363409,1.0098664745517825,-0.13437409699361036,-0.7625485234749902,-0.6281744264813799,14.5409781342459,-2.6980564211907456,-78870435.0,2001-08-16,2001,3,228,8,1.5,117.88,117.87,116.00998999999999,409
2001-08-17 13:30:00,117.64998999999999,117.87,116.00998999999999,116.75,114.22308384615386,121.3052,126.76894680000021,122.33160049999992,121.21700120000004,119.79350200000003,121.13036885325079,119.67322509771576,119.7430769230768,123.03642076152863,116.449733084625,126.76894680000021,122.33160049999992,121.21700120000004,119.79350200000003,116.87666333333334,11604602,10874760.2,35.656297295722105,1.5,2.75,1.8356891583745123,1.0671133695435415,-0.2394073452138852,-0.9274336079987364,-0.6880262627848512,16.306186027639836,-2.9509559434746446,-90475037.0,2001-08-17,2001,4,229,8,1.6,116.94,117.89998999999999,116.55,410
2001-08-20 13:30:00,116.8,117.89998999999999,116.55,117.83,114.0826996153846,121.1284,126.64575305000021,122.35950059999992,121.03360120000004,119.73750200000003,121.00094262371157,119.49767985031427,119.41384615384605,122.5467140998748,116.28097820781728,126.64575305000021,122.35950059999992,121.03360120000004,119.73750200000003,117.42666333333334,10417398,10992370.15,41.13174374428701,1.5,2.75,1.8009963613477618,0.9476935235846292,-0.21749434069997253,-0.9598941886598168,-0.7423998479598444,16.830267986250533,-2.43437939885733,-80057639.0,2001-08-20,2001,0,232,8,1.16,117.22,118.53998999999999,115.8,411
2001-08-21 13:30:00,117.8,118.53998999999999,115.8,115.82001000000001,113.94231538461538,120.9516,126.51133750000021,122.36290069999993,120.82800120000003,119.63850250000004,120.79776879533071,119.14742557885576,118.89153923076913,121.98257342172494,115.80050503981329,126.51133750000021,122.36290069999993,120.82800120000003,119.63850250000004,116.71999999999998,14481398,11102890.05,35.138622737253755,1.5,2.75,1.868067335537208,1.3042908589372186,-0.3138628296589111,-1.1347283850334833,-0.8208655553745722,18.37226495953836,-2.2863325740318947,-94539037.0,2001-08-21,2001,1,233,8,2.37,117.17,117.42998999999999,115.78,412
2001-08-22 13:30:00,116.75,117.42998999999999,115.78,117.02,113.80193115384616,120.7748,126.38253125000021,122.36620069999992,120.65080120000003,119.53450200000002,120.6496209994354,118.94481361896473,118.51307769230759,121.19633721775268,115.8298181668625,126.38253125000021,122.36620069999992,120.65080120000003,119.53450200000002,116.74333,11752898,11086090.05,40.694344050735715,1.5,2.75,1.852490382998836,1.0601481628773166,-0.2737472904225643,-1.1630496684027776,-0.8893023779802133,17.50180695794626,-1.564602960969044,-82786139.0,2001-08-22,2001,2,234,8,1.43,116.6,117.52,116.49001000000001,413
2001-08-23 13:30:00,116.96001000000001,117.52,116.49001000000001,116.60001000000001,113.66154692307691,120.598,126.2466250500002,122.39020079999992,120.48680140000003,119.34700200000002,120.49081272494772,118.72149898858713,118.22846307692295,120.8778915141972,115.57903463964873,126.2466250500002,122.39020079999992,120.48680140000003,119.34700200000002,116.87000666666664,8745301,10876855.1,39.42161855530854,1.5,2.75,1.7937403556417764,0.8040284548793888,-0.2529485428860666,-1.2054880565877966,-0.95253951370173,17.325436755543752,-2.254992225248745,-91531440.0,2001-08-23,2001,3,235,8,0.88,117.01,119.13,116.74001000000001,414
2001-08-24 13:30:00,117.21001000000001,119.13,116.74001000000001,119.02,113.52116269230768,120.4212,126.1229750500002,122.47650079999993,120.42720140000004,119.25750200000002,120.43313379455763,118.74992765634073,118.09384769230759,120.36370534558223,115.82399003903295,126.1229750500002,122.47650079999993,120.42720140000004,119.25750200000002,118.29667,11688301,11037180.1,49.267341623718,1.5,2.75,1.8463296159530782,1.0589934108260135,-0.06353008108841884,-1.0319521150622537,-0.9684220339738346,21.525987035003567,-0.2514330999469413,-79843139.0,2001-08-24,2001,4,236,8,2.05,117.94,119.2,118.25998999999999,415
2001-08-27 13:30:00,118.97,119.2,118.25998999999999,118.31,113.38077846153843,120.2444,126.01171255000021,122.55110069999992,120.35640120000004,119.1305015,120.34987364575144,118.7080297843083,118.07692461538453,120.33678129209564,115.8170679386734,126.01171255000021,122.55110069999992,120.35640120000004,119.1305015,118.58999666666666,7428102,10981200.25,46.86092790233744,1.5,2.75,1.7815925005278583,0.6764380787974429,0.022042470467781742,-0.9408689458891076,-0.9629114163568891,21.770657929055304,-0.8048964534249968,-87271241.0,2001-08-27,2001,0,239,8,0.79,118.73,118.49001000000001,116.58,416
2001-08-28 13:30:00,118.28,118.49001000000001,116.58,116.58,113.24039423076924,120.0676,125.89445630000021,122.56640069999992,120.26280140000006,118.892001,120.20203546356512,118.50536028104084,117.9000015384614,120.23939822606808,115.56060485085474,125.89445630000021,122.56640069999992,120.26280140000006,118.892001,117.21667,12046602,10987600.25,41.53714598533455,1.5,2.75,1.7907651790615826,1.0963815324460862,-0.027103693583216626,-0.99679103333591,-0.9696873397526934,23.167690410354773,-1.4039325605605073,-99317843.0,2001-08-28,2001,1,240,8,1.64,117.54,117.17998999999999,115.17,417
2001-08-29 13:30:00,117.13,117.17998999999999,115.17,115.53998999999999,113.10001000000001,119.8908,125.7890312500002,122.58880059999993,120.13780140000006,118.56350049999999,120.01921015126844,118.22294406379885,117.61153999999986,120.11337812860721,115.10970187139252,125.7890312500002,122.58880059999993,120.13780140000006,118.56350049999999,115.96332666666666,16181801,11199650.25,38.69137692282407,1.5,2.75,1.8064240948428985,1.4448487799875716,-0.11401729085408953,-1.1122089533203052,-0.9981916624662156,23.19723548926127,-2.621154877467752,-115499644.0,2001-08-29,2001,2,241,8,1.75,116.17,115.74001000000001,112.03998999999999,418
2001-08-30 13:30:00,114.85001000000001,115.74001000000001,112.03998999999999,113.32001000000001,112.95962576923077,119.714,125.67781880000021,122.57640069999992,119.95560180000008,118.099001,119.75649641984613,117.75599796248468,117.1500015384614,120.3399622231234,113.96004085379944,125.67781880000021,122.57640069999992,119.95560180000008,118.099001,113.70000333333331,17693104,11530795.5,33.426898882478,1.5,2.75,1.9416809452112624,1.5344218011671442,-0.295089689509322,-1.3670537743528683,-1.0719640848435463,24.76879049169689,-2.9378929336188464,-133192748.0,2001-08-30,2001,3,242,8,3.3,113.89,114.77,113.13,419
2001-08-31 13:30:00,113.39998999999999,114.77,113.13,114.14998999999999,112.81924153846155,119.5372,125.55294375000021,122.55140069999992,119.76220140000008,117.7095005,119.53663342298944,117.41256863272423,116.75615461538449,120.06398613238636,113.44832309838263,125.55294375000021,122.55140069999992,119.76220140000008,117.7095005,114.01666333333333,15985699,11789255.45,36.88454165754158,1.5,2.75,1.9201323062676008,1.3559549258897432,-0.33037299533747033,-1.484930329015384,-1.1545573336779138,24.42142843463857,-3.1231519986421077,-117207049.0,2001-08-31,2001,4,243,8,1.45,113.95,116.17,113.37,420
2001-09-04 13:30:00,113.85001000000001,116.17,113.37,113.42,112.67885730769231,119.3604,125.42223125000021,122.51830069999993,119.57360120000007,117.36550049999998,119.29676544561731,117.03232400103623,116.3853846153845,120.01015712085692,112.76061210991207,125.42223125000021,122.51830069999993,119.57360120000007,117.36550049999998,114.32,24475392,12585505.15,35.15510864111559,1.5,2.75,1.982979998677057,1.9447286150449037,-0.3712295671329575,-1.6185942925941106,-1.247364725461153,23.364203935133446,-2.072189425644148,-141682441.0,2001-09-04,2001,1,247,9,2.47,114.77,114.19,111.95,421
2001-09-05 13:30:00,113.7,114.19,111.95,113.7,112.53847307692308,119.1836,125.30385625000021,122.46680059999993,119.41320120000006,117.01200049999996,119.07728444774996,116.71495981046135,116.00461615384606,119.63778489099705,112.37144741669502,125.30385625000021,122.46680059999993,119.41320120000006,117.01200049999996,113.28,21477696,13216134.85,36.387163149288114,1.5,2.75,2.0013385702001245,1.625111747403213,-0.34813627550413484,-1.6825350698413215,-1.3343987943371869,21.92501097474276,-2.8371218595111887,-120204745.0,2001-09-05,2001,2,248,9,2.0,113.07,113.3,110.77,422
2001-09-06 13:30:00,112.64998999999999,113.3,110.77,110.77,112.39808884615385,119.0068,125.17450315000023,122.39850049999994,119.19760120000008,116.62400049999997,118.75150858705388,116.14877316184595,115.54461615384602,120.0848477028712,111.00438460482084,125.17450315000023,122.39850049999994,119.19760120000008,116.62400049999997,111.61333333333334,21654096,13539649.6,29.970096269988748,1.5,2.75,2.0676715294715446,1.5993099260116748,-0.4902322647648387,-1.9471891252932352,-1.4569568605283965,24.35569700288331,-5.000008147512167,-141858841.0,2001-09-06,2001,3,249,9,2.28,112.04,111.25,108.63,423
2001-09-07 13:30:00,110.02,111.25,108.63,108.72,112.2577046153846,118.83,125.04466565000023,122.29310059999992,118.94240120000008,116.11600049999996,118.35811609344393,115.44127095595587,114.8438469230768,120.44502624441186,109.2426676017417,125.04466565000023,122.29310059999992,118.94240120000008,116.11600049999996,109.53333333333336,33133904,14490419.8,26.454786847216138,1.5,2.75,2.1071235630807204,2.286607597110472,-0.6711399058246319,-2.2958817428091858,-1.6247418369845543,25.438159650261092,-8.65400772979331,-174992745.0,2001-09-07,2001,4,250,9,2.41,109.94,110.35001000000001,107.7,424
2001-09-10 13:30:00,107.7,110.35001000000001,107.7,110.05,112.11732038461538,118.6532,124.91804065000022,122.15360059999992,118.70040140000008,115.65400099999997,118.03230761919123,114.92781657919815,114.39999999999986,120.51253452659714,108.28746547340263,124.91804065000022,122.15360059999992,118.70040140000008,115.65400099999997,109.36667,23408704,15102189.95,32.02541830429291,1.5,2.75,2.1459011657178118,1.5500204988482482,-0.649657093538679,-2.4368132039079033,-1.7871561103692242,22.397596035571205,-6.981658355168627,-151584041.0,2001-09-10,2001,0,253,9,2.46,109.03,106.39998999999999,100.0,425
2001-09-17 13:30:00,101.0,106.39998999999999,100.0,104.3,111.97693615384615,118.4764,124.77883755000023,121.94010069999992,118.33440120000007,114.90300049999996,117.49378575177195,113.91564357165548,113.42153846153835,121.34675767873415,105.49631924434252,124.77883755000023,121.94010069999992,118.33440120000007,114.90300049999996,103.56666333333334,32393808,16350110.45,23.675957147855648,1.5,2.75,2.7104796538808245,1.9812592764472727,-0.9527943904697284,-2.9781490984563845,-2.025354707986656,34.409127943878616,-10.53353920054898,-183977849.0,2001-09-17,2001,0,260,9,6.4,103.2,105.3,103.36,426
2001-09-18 13:30:00,104.33,105.3,103.36,104.05,111.83655192307691,118.2996,124.62486880000023,121.7356006999999,117.93280120000007,114.14200049999997,116.96657846738876,112.97605846959307,112.45615307692293,121.56636762166474,103.34593853218115,124.62486880000023,121.7356006999999,117.93280120000007,114.14200049999997,104.23666666666668,22029200,16792665.35,23.39042267100825,1.5,2.75,2.655445392889337,1.3118346338033824,-1.0903375627621203,-3.3882766614393063,-2.297939098677186,34.85384872428423,-9.944600133685322,-206007049.0,2001-09-18,2001,1,261,9,1.88,104.33,104.5,98.56,427
2001-09-19 13:30:00,104.10001,104.5,98.56,101.95,111.69616769230768,118.1228,124.45446255000023,121.53270059999993,117.48980100000007,113.32749999999996,116.37769303729507,111.92595766296516,111.14307615384601,120.982056282133,101.30409602555906,124.45446255000023,121.53270059999993,117.48980100000007,113.32749999999996,101.67,42772096,18505240.05,21.089599171398547,1.5,2.75,2.890056436254384,2.3113505085279886,-1.2324568836559626,-3.838510203247139,-2.606053319591177,35.17941024342479,-10.03354129601647,-248779145.0,2001-09-19,2001,2,262,9,6.03,101.53,101.81,98.569,428
2001-09-20 13:30:00,100.39999,101.81,98.569,98.71001,111.55578346153843,117.946,124.27957510000023,121.30400069999992,117.03040140000007,112.33050099999996,115.68484272210705,110.66729598077801,109.6353846153845,120.56570335066392,98.70506588010508,124.27957510000023,121.30400069999992,117.03040140000007,112.33050099999996,99.69633666666668,36212800,19779145.1,18.1269570162532,1.5,2.75,2.9251238336647853,1.8308576946533448,-1.4399367962333993,-4.405974314882926,-2.9660375186495265,36.8381800946904,-13.526045862991321,-284991945.0,2001-09-20,2001,3,263,9,3.29,100.19,98.99001,93.8,429
2001-09-21 13:30:00,94.05,98.99001,93.8,97.28,93.8,117.7692,124.09878760000024,121.04510069999995,116.59500140000007,111.35700099999997,114.96308418398519,109.39231541118008,108.15076923076911,120.10012826229335,96.20141019924488,124.09878760000024,121.04510069999995,116.59500140000007,111.35700099999997,96.69000333333334,49783504,21688090.2,16.992352594628414,1.5,2.75,3.086901416974444,2.2954305123647996,-1.5587164191868643,-4.914433042633107,-3.3557166234462423,34.31151429363201,-14.230294480691235,-334775449.0,2001-09-21,2001,4,264,9,5.53,96.4,101.16,99.06,430
2001-09-24 13:30:00,99.729,101.16,99.06,100.7,93.19605263157897,117.5924,123.94088135000023,120.81490069999994,116.21500140000008,110.50050099999996,114.40374754931909,108.56447584821056,107.00923153846142,118.75043197144122,95.26803110548164,123.94088135000023,120.81490069999994,116.21500140000008,110.50050099999996,100.30666666666669,25549808,22444710.7,28.516232309257873,1.5,2.75,3.1435513157619828,1.1383442781465658,-1.3026048571973885,-4.9839726949429775,-3.681367837745589,44.88901379616075,-11.43359718557608,-309225641.0,2001-09-24,2001,0,267,9,2.12,100.11,102.0,99.89999,431
2001-09-25 13:30:00,100.75101,102.0,99.89999,101.75,92.59210526315788,117.4156,123.78853760000023,120.57460069999992,115.88480160000007,109.79700049999997,113.90752215522815,107.91547814838098,106.11923076923063,117.56230167912202,94.6761598593393,123.78853760000023,120.57460069999992,115.88480160000007,109.79700049999997,101.21666333333332,25466192,22993950.4,31.653452965565762,1.5,2.75,3.0690126503504134,1.1075170450050202,-0.9732235179070649,-4.89789723512942,-3.924673717222356,46.02672873316046,-8.142999006951339,-283759449.0,2001-09-25,2001,1,268,9,2.1,100.95,102.39999,100.42999,432
2001-09-26 13:30:00,102.35001,102.39999,100.42999,101.39,91.98815789473684,117.2388,123.62876885000023,120.33940069999993,115.54500160000008,109.01550049999996,113.41663893345451,107.29400403901137,105.13769307692301,115.82075950815846,94.45462664568753,123.62876885000023,120.33940069999993,115.54500160000008,109.01550049999996,101.40666,18587504,23335680.7,31.14870393100793,1.5,2.75,2.990511746753955,0.7965271825132575,-0.7029495484812225,-4.803360652823884,-4.100411104342661,45.15065966640957,-6.742089771891093,-302346953.0,2001-09-26,2001,2,269,9,1.96,101.41,102.28999,100.0,433
2001-09-27 13:30:00,101.25,102.28999,100.0,102.27,91.38421052631578,117.06200000000001,123.45152510000023,120.09160069999994,115.16660160000009,108.29899999999996,112.97951583802492,106.81552746386744,104.2800007692307,113.90336158630579,94.65663995215556,123.45152510000023,120.09160069999994,115.16660160000009,108.29899999999996,101.51999666666666,20536800,23925255.65,33.922489788702876,1.5,2.75,2.9404744791286723,0.8583732730145353,-0.40315507412328255,-4.6043549469967635,-4.201199872873482,45.69140901175888,-7.069513857337575,-281810153.0,2001-09-27,2001,3,270,9,2.29,101.14,109.92,102.5,434
2001-09-28 13:30:00,102.98,109.92,102.5,104.44,90.78026315789472,116.8852,123.29614700000023,119.86780059999997,114.81060140000008,107.56999999999996,112.64463286398473,106.5892867530229,103.56769307692299,111.52281206005159,95.61257409379436,123.29614700000023,119.86780059999997,114.81060140000008,107.56999999999996,105.62,21787696,24430225.4,40.308572242275375,1.5,2.75,3.2768691591909103,0.8918336054320646,-0.01732978262525009,-4.2228621011550445,-4.205532318529794,47.23617962106286,0.13422818791946364,-260022457.0,2001-09-28,2001,4,271,9,7.24,106.21,104.32001,102.83,435
2001-10-01 13:30:00,103.89999,104.32001,102.83,104.27,90.17631578947369,116.7084,123.14921575000022,119.65840049999996,114.48180120000009,106.86799999999997,112.31621588892652,106.36840230035405,103.06769307692299,109.88492787876258,96.25045827508335,123.14921575000022,119.65840049999996,114.48180120000009,106.86799999999997,103.80667,20457600,25081700.3,39.98256639541295,1.5,2.75,3.1578070763915598,0.8156384836477772,0.2528985237826333,-3.889409163801503,-4.142307687584136,35.79148288977936,0.2114368092263324,-280480057.0,2001-10-01,2001,0,274,10,1.45,103.58,105.58,103.64999,436
2001-10-02 13:30:00,104.0,105.58,103.64999,105.58,89.57236842105263,116.5316,123.00727200000023,119.44080049999997,114.1566012000001,106.31799999999996,112.052050559949,106.293316366987,102.82615461538452,109.01913886855326,96.63317036221576,123.00727200000023,119.44080049999997,114.1566012000001,106.31799999999996,104.93666333333331,19833600,25471050.2,43.757421242307025,1.5,2.75,3.0701072852207334,0.7786722512132618,0.5303808006270971,-3.4793316868002653,-4.009712487427362,36.442427877004796,3.5605689063266266,-260646457.0,2001-10-02,2001,1,275,10,1.86,104.61,107.881,104.35001,437
2001-10-03 13:30:00,104.60001,107.881,104.35001,107.35001000000001,88.96842105263157,116.3548,122.85089705000023,119.25190049999996,113.88340160000013,105.90850099999996,111.86765681250002,106.39395385584538,102.61846307692299,107.9495904131254,97.28733574072056,122.85089705000023,119.25190049999996,113.88340160000013,105.90850099999996,106.52700666666664,32070192,26265469.75,48.473117369863004,1.5,2.75,3.103027479133538,1.2210020344296335,0.8260115645416457,-2.9771980317503055,-3.803209596291951,34.463808944777696,8.752911685451151,-228576265.0,2001-10-03,2001,2,276,10,3.38,106.12,108.97,106.75,438
2001-10-04 13:30:00,108.28998999999999,108.97,106.75,107.44,88.36447368421051,116.178,122.69794080000023,119.06450059999996,113.59080140000007,105.61450049999996,111.69402321200981,106.49357729814581,102.86000153846143,108.73116200036793,96.98884107655495,122.69794080000023,119.06450059999996,113.59080140000007,105.61450049999996,107.71999999999998,32675504,27014589.75,48.70858352634948,1.5,2.75,3.039954087766857,1.2095502579305315,1.0084223963985446,-2.5426816007937703,-3.551103997192315,25.345408948480703,10.444078947368418,-195900761.0,2001-10-04,2001,3,277,10,2.08,107.86,107.62,105.521,439
2001-10-05 13:30:00,107.25,107.62,105.521,107.23,87.76052631578949,116.0012,122.55338770000023,118.88030069999996,113.30860140000007,105.26850099999996,111.5189634782055,106.56371279356053,103.10461692307683,109.40314227168665,96.80609157446706,122.55338770000023,118.88030069999996,113.30860140000007,105.26850099999996,106.79033333333336,29830192,27706814.4,48.15555095688772,1.5,2.75,2.9727430814977964,1.076637377698679,1.0888638314578096,-2.1900242078700534,-3.2788880393278625,21.95575957333197,6.484607745779544,-225730953.0,2001-10-05,2001,4,278,10,1.99,106.57,107.3,105.87,440
2001-10-08 13:30:00,106.27901000000001,107.3,105.87,106.53,87.15657894736843,115.8244,122.41400645000023,118.68540069999996,113.06020140000008,104.92400099999998,111.32331785160923,106.56050205131666,103.45692461538452,109.9665307678784,96.94731846289065,122.41400645000023,118.68540069999996,113.06020140000008,104.92400099999998,106.56666666666668,12971199,27131604.75,46.26970853496356,1.5,2.75,2.8625471471050963,0.4780844745278106,1.0674235549337672,-1.9446085956606536,-3.0120321505944214,17.102016152261776,4.697788697788699,-238702152.0,2001-10-08,2001,0,281,10,1.35,106.58,106.75,105.60001000000001,441
2001-10-09 13:30:00,106.61,106.75,105.60001000000001,105.96001000000001,86.55263157894737,115.6476,122.28896275000021,118.49350089999996,112.82340160000008,104.53700149999996,111.11299205350693,106.50331233214365,104.01461692307684,110.02505985294951,98.00417399320415,122.28896275000021,118.49350089999996,112.82340160000008,104.53700149999996,106.10333999999999,15976301,26856535.0,44.73351494392682,1.5,2.75,2.7402216365975893,0.594875735086451,0.9891137903634889,-1.7756399126400595,-2.7647537030035485,17.86978709386567,4.507357727586544,-254678453.0,2001-10-09,2001,1,282,10,1.09,106.18,108.55,105.52,442
2001-10-10 13:30:00,105.8,108.55,105.52,108.32001000000001,85.94868421052631,115.4708,122.1669690500002,118.32270109999996,112.60780160000007,104.41450199999996,111.00346334552626,106.67633115765379,104.86384846153835,109.86272367232836,99.86497325074836,122.1669690500002,118.32270109999996,112.60780160000007,104.41450199999996,107.46333666666663,19987392,26773199.8,51.860133533305074,1.5,2.75,2.7609200911263327,0.7465447592857392,1.0639951860941546,-1.4347597203858555,-2.4987549064800096,19.806608205340844,5.915723085948958,-234691061.0,2001-10-10,2001,2,283,10,2.87,107.04,110.3,108.95,443
2001-10-11 13:30:00,108.95,110.3,108.95,110.0,85.34473684210526,115.294,122.06689095000023,118.16290109999996,112.40080140000008,104.47850199999998,110.96411184178012,106.99287104740105,105.57923307692295,110.65110999106585,100.5073561627801,122.06689095000023,118.16290109999996,112.40080140000008,104.47850199999998,109.75,23008608,26266935.0,56.190905580272535,1.5,2.75,2.705139370331595,0.8759532849949947,1.1851467169697862,-1.0173215102677773,-2.2024682272375635,20.427067576977333,5.323630792799697,-211682453.0,2001-10-11,2001,3,284,10,1.24,109.62,109.89,107.3,444
2001-10-12 13:30:00,109.14998999999999,109.89,107.3,109.5,84.7407894736842,115.1172,121.98314095000023,117.96840109999997,112.17460140000007,104.45100199999996,110.90669569112207,107.23164523336284,106.17538692307684,111.12721596059916,101.22355788555448,121.98314095000023,117.96840109999997,112.17460140000007,104.45100199999996,108.89666666666666,31361504,26664575.0,54.616092335061815,1.5,2.75,2.704772272450767,1.1761486541600608,1.1871254506665223,-0.7185614139044105,-1.9056868645709328,19.391081004962142,5.01582430229213,-243043957.0,2001-10-12,2001,4,285,10,2.41,108.6,109.45,108.06,445
2001-10-15 13:30:00,108.63,109.45,108.06,109.3,84.13684210526316,114.9404,121.89401595000021,117.76990119999996,111.94360120000006,104.70100199999996,110.84368801696043,107.428631401614,106.78384846153835,111.14247680125963,102.42522012181705,121.89401595000021,117.76990119999996,111.94360120000006,104.70100199999996,108.93666666666668,16875008,25888635.0,53.96458909961913,1.5,2.75,2.614431395847141,0.6518307357649409,1.1307448554746269,-0.4922557952276492,-1.6230006507022758,19.415237719511236,3.523394582307254,-259918965.0,2001-10-15,2001,0,288,10,1.29,108.76,110.619,108.95,446
2001-10-16 13:30:00,109.8,110.619,108.95,109.99001000000001,83.5328947368421,114.7636,121.78927850000022,117.57240119999994,111.71640120000008,104.99800249999996,110.81021044766787,107.6725722205079,107.3776953846153,111.18305488263556,103.572335886595,121.78927850000022,117.57240119999994,111.71640120000008,104.99800249999996,109.85300333333332,15883602,25581355.1,55.91831749055454,1.5,2.75,2.5469005818580586,0.6209054187281893,1.0949624902304629,-0.25429753791419785,-1.3492600281446605,18.825687487805734,2.4592452296930394,-244035363.0,2001-10-16,2001,1,289,10,1.53,109.78,111.14998999999999,107.64998999999999,447
2001-10-17 13:30:00,111.07001000000001,111.14998999999999,107.64998999999999,107.64998999999999,82.92894736842105,114.5868,121.66580970000022,117.33240119999996,111.42720100000008,105.28300199999997,110.68628023403382,107.67042153284048,107.62461769230758,111.03112481391885,104.21811057069631,121.66580970000022,117.33240119999996,111.42720100000008,105.28300199999997,108.81665666666667,28601696,24872835.1,48.414287271049396,1.5,2.75,2.61497911172534,1.1499170032289563,0.8781013902763486,-0.25163329029922465,-1.1297346805755732,21.980474767217103,0.19544862248697392,-272637059.0,2001-10-17,2001,2,290,10,3.25,109.4,108.16,106.75,448
2001-10-18 13:30:00,107.82001000000001,108.16,106.75,107.42,82.32499999999997,114.41,121.53634720000022,117.09180119999996,111.12340100000007,105.71850149999996,110.55819081309131,107.64657186304615,107.86692538461529,110.6811247821134,105.05272598711716,121.53634720000022,117.09180119999996,111.12340100000007,105.71850149999996,107.44333333333331,16517398,23888065.0,47.73623571744645,1.5,2.75,2.5289091751735295,0.6914498097690206,0.6917676791847664,-0.26502508159461513,-0.9567927607793816,22.019026938424524,0.17718921943485752,-289154457.0,2001-10-18,2001,3,291,10,1.32,107.46,107.91,106.00998999999999,449
2001-10-19 13:30:00,107.0,107.91,106.00998999999999,107.35001000000001,81.72105263157894,114.2332,121.40450350000023,116.87280129999996,110.8316012000001,106.22200199999996,110.43237980081322,107.61832787608937,108.00307999999993,110.51675111722452,105.48940888277531,121.40450350000023,116.87280129999996,110.8316012000001,106.22200199999996,107.09,21916096,22494694.6,47.518133405763706,1.5,2.75,2.4839878055182782,0.9742784416375228,0.5429700127954353,-0.2780802447850874,-0.8210502575805227,21.98979371188132,0.7697456115648141,-311070553.0,2001-10-19,2001,4,292,10,1.79,106.96,109.57001000000001,107.21001000000001,450
2001-10-22 13:30:00,107.3,109.57001000000001,107.21001000000001,109.47,81.1171052631579,114.0564,121.29591600000023,116.67120129999996,110.6150012000001,106.66050199999998,110.39463941646758,107.7946776021761,108.16615615384607,110.7628935816572,105.56941872603498,121.29591600000023,116.67120129999996,110.6150012000001,106.66050199999998,108.75000666666664,17570896,22095749.0,54.32535355123697,1.5,2.75,2.4751315336955435,0.7952161295822106,0.5640213004967671,-0.11602363195956401,-0.6800449324563311,24.09308668787293,3.3125610312796328,-293499657.0,2001-10-22,2001,0,295,10,2.2,108.39,110.28,108.37899999999999,451
2001-10-23 13:30:00,109.96001000000001,110.28,108.37899999999999,108.91,80.51315789473685,113.8796,121.19640350000023,116.47930119999997,110.37780120000008,107.01850199999996,110.33641826288066,107.90089878292123,108.279233076923,110.86764957859992,105.69081657524609,121.19640350000023,116.47930119999997,110.37780120000008,107.01850199999996,109.18966666666664,22064496,21925664.2,52.392201267897775,1.5,2.75,2.4341221384315763,1.0063319313263952,0.5181108593258654,-0.032406358298999294,-0.5505172176248647,24.064512273786985,0.5446731402628197,-315564153.0,2001-10-23,2001,1,296,10,1.75,109.33,109.45,108.22,452
2001-10-24 13:30:00,108.98,109.45,108.22,108.62,79.90921052631579,113.7028,121.06450350000023,116.29470119999996,110.17960120000008,107.38000199999996,110.2691077427677,107.9693846131192,108.38615615384607,110.90630779301144,105.86600451468072,121.06450350000023,116.29470119999996,110.17960120000008,107.38000199999996,108.76333333333334,16065398,21799558.9,51.37269359870221,1.5,2.75,2.348113414257892,0.7369597739888214,0.4486866947310146,0.010341150788903521,-0.4383455439421111,20.780452909504852,-1.2545454545454504,-331629551.0,2001-10-24,2001,2,297,10,1.14,108.84,110.60001000000001,106.74001000000001,453
2001-10-25 13:30:00,107.45,110.60001000000001,106.74001000000001,110.57001000000001,79.30526315789473,113.52600000000001,120.94961920000023,116.14740129999996,110.01340140000008,107.79500249999997,110.28090783128658,108.21706322139356,108.69692615384608,111.22124918391596,106.17260312377623,120.94961920000023,116.14740129999996,110.01340140000008,107.79500249999997,109.30334333333332,27504000,22147918.9,57.378557899074785,1.5,2.75,2.4561053132394712,1.2418322517877742,0.5100934706475231,0.19927129436729274,-0.3108221762802303,21.453093708274093,0.9771780821917776,-304125551.0,2001-10-25,2001,3,298,10,3.62,108.67,111.78998999999999,109.67,454
2001-10-26 13:30:00,109.95,111.78998999999999,109.67,110.32001000000001,78.70131578947368,113.3492,120.85528175000023,115.99110139999996,109.8340018000001,108.08900299999996,110.28244124966749,108.41734386697512,109.03231076923069,111.13659842036564,106.92802311809577,120.85528175000023,115.99110139999996,109.8340018000001,108.08900299999996,110.59333333333332,18623296,21989698.9,56.41652595096132,1.5,2.75,2.4320970765795096,0.8469100047568182,0.5087213960202156,0.3250795687450392,-0.1836418272751764,21.294905481874753,0.9332204940530644,-322748847.0,2001-10-26,2001,4,299,10,1.93,110.73,110.55,107.45,455
2001-10-29 14:30:00,110.16,110.55,107.45,107.45,78.09736842105262,113.1724,120.74159425000023,115.79830139999996,109.59660160000007,108.24800299999997,110.17136512222956,108.32521587964416,108.96538692307686,111.20689718009228,106.72387666606146,120.74159425000023,115.79830139999996,109.59660160000007,108.24800299999997,108.48333333333332,18733808,21903509.3,46.73007971281722,1.5,2.75,2.4798044282524008,0.8552879697683877,0.2997102841754855,0.19099602794418047,-0.108714256231305,26.405731600728622,-2.3093097273106853,-341482655.0,2001-10-29,2001,0,302,10,2.89,109.0,107.7,105.56,456
2001-10-30 14:30:00,107.35001000000001,107.7,105.56,106.16,105.56,112.9956,120.62317550000023,115.58650139999996,109.33440160000008,108.27700299999997,110.01405668606371,108.11900484348757,108.67000230769226,111.27146292707499,106.06854168830955,120.62317550000023,115.58650139999996,109.33440160000008,108.27700299999997,106.4733333333333,26197904,22221724.5,43.14438432465586,1.5,2.75,2.4555326833772293,1.1789320851313767,0.07166120094264802,-0.019137755052994976,-0.09079895599564301,26.47342127364533,-1.384106027320584,-367680559.0,2001-10-30,2001,1,303,10,2.03,106.63,107.86,105.8,457
2001-10-31 14:30:00,106.89998999999999,107.86,105.8,105.8,105.99555555555555,112.8188,120.49155050000023,115.35650139999996,109.08560140000007,108.19950249999997,109.84879956112002,107.89814723934592,108.38538692307688,111.34613690888484,105.42463693726887,120.49155050000023,115.35650139999996,109.08560140000007,108.19950249999997,106.48666666666666,28130496,22024739.7,42.171867380613115,1.5,2.75,2.4272803488502848,1.2772226316027702,-0.09717870717525587,-0.21227233996471284,-0.11509363278945695,23.89863293586551,-1.5080990504561576,-395811055.0,2001-10-31,2001,2,304,10,1.95,106.83,109.00998999999999,105.69901000000002,458
2001-11-01 14:30:00,106.60001000000001,109.00998999999999,105.69901000000002,108.50998999999999,106.43111111111112,112.64200000000001,120.37285045000023,115.16430129999998,108.88280140000006,108.25300199999997,109.79629722538981,107.9564179784558,108.32461692307687,111.23986234056431,105.40937150558945,120.37285045000023,115.16430129999998,108.88280140000006,108.25300199999997,107.73966333333334,29807296,21881329.3,51.106451280744,1.5,2.75,2.490401752503836,1.3622251002821844,-0.023915504750729046,-0.1449880137278683,-0.12107250897713925,28.46405796471825,1.0805588187649022,-366003759.0,2001-11-01,2001,3,305,11,3.13,107.35,109.38,107.87,459
2001-11-02 14:30:00,108.44,109.38,107.87,109.25,106.86666666666667,112.4652,120.2591004500002,114.97490129999996,108.73280140000006,108.35400199999997,109.7748738047863,108.07961626622192,108.26769307692301,111.07763734226792,105.45774881157813,120.2591004500002,114.97490129999996,108.73280140000006,108.35400199999997,108.83333333333331,17577904,21268714.9,53.23137969979798,1.5,2.75,2.4203730558964183,0.8264676113553058,0.07158764581775176,-0.031587951704949546,-0.1031755975227013,28.62505645374845,-0.2009683018178486,-348425855.0,2001-11-02,2001,4,306,11,1.4,108.62,111.09,109.95,460
2001-11-05 14:30:00,110.12,111.09,109.95,110.67998999999999,107.30222222222223,112.2884,120.14828165000023,114.81170119999996,108.58980120000004,108.56150149999992,109.81036855753977,108.32727090753413,108.50076999999996,111.55880875276009,105.44273124723983,120.14828165000023,114.81170119999996,108.58980120000004,108.56150149999992,110.57333,15991301,21419720.0,57.110422802892025,1.5,2.75,2.3789178376181037,0.7465690961413127,0.2198936810146005,0.1716915037455493,-0.048202177269051176,27.35607352734272,1.6251859333394612,-332434554.0,2001-11-05,2001,0,309,11,1.04,110.52,112.48,109.85001000000001,461
2001-11-06 14:30:00,110.35001000000001,112.48,109.85001000000001,112.39998999999999,107.73777777777778,112.1116,120.04301600000024,114.67470099999996,108.52140080000004,108.88350049999994,109.91192233959706,108.71514891634041,108.88384615384614,112.50093553593815,105.26675677175406,120.04301600000024,114.67470099999996,108.52140080000004,108.88350049999994,111.57666666666668,23245904,21783200.15,61.27128441109314,1.5,2.75,2.396851563502525,1.067148253696783,0.4115276724103213,0.4662074132438505,0.05467974083352917,28.17175825368757,3.480012888970722,-309188650.0,2001-11-06,2001,1,310,11,2.39,111.17,113.12,111.64,462
2001-11-07 14:30:00,111.77,113.12,111.64,112.25,108.17333333333332,111.9348,119.93035975000024,114.53840099999998,108.42600080000004,109.07999999999996,110.00361165961284,109.05180140049843,109.2607684615384,113.16942802025568,105.35210890282112,119.93035975000024,114.53840099999998,108.42600080000004,109.07999999999996,112.33666666666664,19716800,21769670.55,60.718102161165284,1.5,2.75,2.3313621661094883,0.9057004310062928,0.4999966688890756,0.6796755769448737,0.17967890805579806,28.08157083626439,1.5193902939865915,-328905450.0,2001-11-07,2001,2,311,11,1.33,112.38,114.08,111.89998999999999,463
2001-11-08 14:30:00,112.87,114.08,111.89998999999999,112.60001000000001,108.60888888888891,111.758,119.82328170000022,114.4164011,108.34600080000004,109.21000049999996,110.10543120237313,109.38972602902241,109.50153846153842,113.79842131138253,105.20465561169428,119.82328170000022,114.4164011,108.34600080000004,109.21000049999996,112.86,22747808,21756630.55,61.58959332505327,1.5,2.75,2.320551297101667,1.0455574886801575,0.5499353925699499,0.8670981487682354,0.3171627561982855,26.531387404639297,2.0667148235392667,-306157642.0,2001-11-08,2001,3,312,11,1.95,112.99,112.96001000000001,111.44,464
2001-11-09 14:30:00,112.25,112.96001000000001,111.44,112.72,109.04444444444445,111.5812,119.71235045000023,114.32360109999998,108.22000080000004,109.37100049999997,110.207963312084,109.70689497863931,109.79461538461531,114.3988729821118,105.19035778711886,119.71235045000023,114.32360109999998,108.22000080000004,109.37100049999997,112.37333666666666,15897500,20983430.35,61.90164465551342,1.5,2.75,2.2633697758801192,0.7576215964135721,0.5571734642698634,1.0136295865356146,0.4564561222657513,26.412748360147656,4.904606793857604,-290260142.0,2001-11-09,2001,4,313,11,1.36,112.2,112.64998999999999,110.0,465
2001-11-12 14:30:00,111.0,112.64998999999999,110.0,112.03,109.48,111.4044,119.59265670000023,114.22540099999998,108.09440080000002,109.50750049999996,110.27941573121795,109.92814307591178,110.05692307692304,114.75127696625576,105.3625691875903,119.59265670000023,114.22540099999998,108.09440080000002,109.50750049999996,111.55999666666666,26071600,21443259.95,58.936471983593655,1.5,2.75,2.2959862204601107,1.215841250854211,0.4843065823330202,1.0618393501820265,0.5775327678490063,20.275390289833073,5.529389600602868,-316331742.0,2001-11-12,2001,0,316,11,2.41,111.32,114.55,113.17998999999999,466
2001-11-13 14:30:00,113.44,114.55,113.17998999999999,114.55,109.91555555555556,111.2276,119.48353170000023,114.15830109999996,108.05380080000003,109.73549999999996,110.44688962411136,110.36831992582493,110.36307615384614,115.63494958485556,105.09120272283664,119.48353170000023,114.15830109999996,108.05380080000003,109.73549999999996,114.09333000000001,15347102,21416434.95,65.44641323729468,1.5,2.75,2.31198720471296,0.7166039555990621,0.5688021378938408,1.2885354402163074,0.7197333023224666,19.77046125743599,8.2703213610586,-300984640.0,2001-11-13,2001,1,317,11,1.21,113.86,115.39998999999999,113.71001000000001,467
2001-11-14 14:30:00,115.17,115.39998999999999,113.71001000000001,114.66,110.35111111111112,111.0508,119.37667545000023,114.08700119999996,108.03620100000002,110.08600049999997,110.61210963885208,110.77705136146065,110.69692153846151,116.4438652078211,104.94997786910193,119.37667545000023,114.08700119999996,108.03620100000002,110.08600049999997,114.59,17591392,20865919.75,65.70201640163604,1.5,2.75,2.2675581186620346,0.8430681326664261,0.5924030390867306,1.4602371011808797,0.8678340620941493,19.029232505313765,5.667690136180084,-283393248.0,2001-11-14,2001,2,318,11,1.49,114.56,115.17998999999999,113.92998999999999,468
2001-11-15 14:30:00,114.37,115.17998999999999,113.92998999999999,114.87,110.78666666666668,110.874,119.27165045000022,114.01140129999996,108.0672008,110.45850049999994,110.77908573144613,111.16685599370251,111.26769076923073,117.08479821003544,105.45058332842602,119.27165045000022,114.01140129999996,108.0672008,110.45850049999994,114.65999333333332,19472400,21013669.85,66.21582072805985,1.5,2.75,2.194875395900461,0.9266539418863096,0.5816307124329891,1.5948724526353857,1.0132417402023963,15.732133254163275,5.144164759725403,-263920848.0,2001-11-15,2001,3,319,11,1.1,114.55,115.10001000000001,113.39998999999999,469
2001-11-16 14:30:00,115.08,115.10001000000001,113.39998999999999,114.36,111.22222222222223,110.6972,119.16045040000023,113.91680120000001,108.071401,110.80899999999994,110.91951374197764,111.4709649466832,111.89845999999994,117.11020606413595,106.68671393586392,119.16045040000023,113.91680120000001,108.071401,110.80899999999994,114.28666666666668,18135392,20824634.65,63.71929694011651,1.5,2.75,2.1595285819075705,0.8708624331135625,0.5026042436545306,1.64149704477056,1.1388928011160293,16.73355015315601,3.324909949847299,-282056240.0,2001-11-16,2001,4,320,11,1.5,114.25,115.85001000000001,114.45,470
2001-11-19 14:30:00,114.92,115.85001000000001,114.45,115.77,111.65777777777778,110.5204,119.05030040000022,113.8460011,108.118401,111.12399999999997,111.10972888935108,111.8803968565229,112.665383076923,116.90544294201209,108.42532321183396,119.05030040000022,113.8460011,108.118401,111.12399999999997,115.35667,13682500,20630214.85,67.38096271877049,1.5,2.75,2.1117058260570296,0.6632262484653667,0.5063244767654278,1.7717983970728142,1.2654739203073864,16.600562310539406,2.9982298041129662,-268373740.0,2001-11-19,2001,0,323,11,1.22,115.15,115.8,114.64,471
2001-11-20 14:30:00,115.37,115.8,114.64,114.8,112.09333333333332,110.3436,118.93920040000023,113.7768011,108.14040100000004,111.41849999999997,111.25444540349415,112.15845429875885,113.14922999999992,116.7728595316428,109.52560046835707,118.93920040000023,113.7768011,108.14040100000004,111.41849999999997,115.08,16223000,20338140.05,62.693248921709426,1.5,2.75,2.0437268384815277,0.7976638945408383,0.4086736629959997,1.776315999052386,1.3676423360563863,16.495997454050308,2.271714922048995,-284596740.0,2001-11-20,2001,1,324,11,1.01,115.22,114.67,113.50998999999999,472
2001-11-21 14:30:00,114.50101000000001,114.67,113.50998999999999,114.03998999999999,112.52888888888891,110.1668,118.81975040000023,113.701701,108.20580080000002,111.68949949999998,111.36368244649441,112.33764817506751,113.51769076923073,116.37314606517168,110.66223547328974,118.81975040000023,113.701701,108.20580080000002,111.68949949999998,114.07332666666667,11471102,20108425.25,59.217063000838095,1.5,2.75,1.989889921447132,0.570462473186457,0.26507407922454584,1.6989849350870685,1.4339108558625226,17.16764584531639,1.2788453571185343,-296067842.0,2001-11-21,2001,2,325,11,1.02,114.09,115.75,114.0,473
2001-11-23 14:30:00,114.03998999999999,115.75,114.0,115.67998999999999,112.96444444444445,109.99,118.72415035000027,113.64370090000001,108.3450006,111.94499850000001,111.53294940937698,112.6559664441087,113.90230615384607,116.45628925497299,111.3483230527192,118.72415035000027,113.64370090000001,108.3450006,111.94499850000001,115.14333,6716898,19069070.15,63.872204688638476,1.5,2.75,1.9727549270580509,0.3522404578285114,0.2527612979532923,1.749862478304138,1.4971011803508456,18.659042768459013,2.6259669978708344,-289350944.0,2001-11-23,2001,4,327,11,1.54,114.88,116.34,115.07001000000001,474
2001-11-26 14:30:00,115.75,116.34,115.07001000000001,115.92998999999999,113.4,109.8132,118.62485035000027,113.5815009,108.4626004,112.2254975,111.70538237371514,112.96777821133644,114.17384461538455,116.78124318025858,111.56644605051056,118.62485035000027,113.5815009,108.4626004,112.2254975,115.78000000000002,13729199,18824365.3,64.5367337558308,1.5,2.75,1.9225574322681909,0.7293313097786089,0.2340993505483371,1.789725368536267,1.55562601798793,18.63460749433491,3.4812014638936017,-275621745.0,2001-11-26,2001,0,330,11,1.1,115.71,116.89998999999999,114.09,475
2001-11-27 14:30:00,115.62,116.89998999999999,114.09,115.42998999999999,113.83555555555556,109.6364,118.52505030000027,113.5098007,108.68520019999998,112.62449700000002,111.85144541788314,113.20227457216154,114.4184592307692,116.84865800324795,111.98826045829041,118.52505030000027,113.5098007,108.68520019999998,112.62449700000002,115.47332666666664,19266400,18850994.9,62.0773822984327,1.5,2.75,1.9859454728204629,1.0220362427661578,0.1640393512983589,1.7606752071108789,1.5966358558125198,18.34283066607981,0.768214753382808,-294888145.0,2001-11-27,2001,1,331,11,2.46,115.49,115.17,113.25,476
2001-11-28 14:30:00,114.74001000000001,115.17,113.25,113.34,114.27111111111113,109.4596,118.41830030000028,113.40190070000004,108.87100019999998,112.98349700000004,111.90982010737795,113.21539127957472,114.47538153846149,116.76302456526949,112.18773851165354,118.41830030000028,113.40190070000004,108.87100019999998,112.98349700000004,113.92,20247200,18553459.7,52.98772024308232,1.5,2.75,1.9998057961904296,1.0912897285674434,-0.03640661632980291,1.5511275854002662,1.5875342017300693,17.499115090887635,-1.1512297226582882,-315135345.0,2001-11-28,2001,2,332,11,1.7,114.21,114.92,113.0,477
2001-11-29 14:30:00,113.662,114.92,113.0,114.87,114.70666666666668,109.2828,118.32705030000028,113.30960060000002,109.12940019999998,113.43699700000002,112.02590559336313,113.37297306247238,114.64076615384609,116.69593165123348,112.58560065645874,118.32705030000028,113.30960060000002,109.12940019999998,113.43699700000002,114.26333333333334,17265104,18010190.1,57.85305119573822,1.5,2.75,1.994105382176828,0.9586297481668448,-0.07696599121090086,1.4913267127164431,1.568292703927344,19.37790334481849,0.0,-297870241.0,2001-11-29,2001,3,333,11,1.7,113.96,114.912,114.02,478
2001-11-30 14:30:00,114.39998999999999,114.912,114.02,114.05,115.14222222222223,109.10600000000001,118.23810030000027,113.23330070000002,109.4362,113.71399750000003,112.10528184460381,113.4374518184274,114.79615076923074,116.2580851869684,113.33421635149305,118.23810030000027,113.23330070000002,109.4362,113.71399750000003,114.32733333333334,13680398,17203845.2,54.59214476417846,1.5,2.75,1.9153835691641985,0.7951942046072351,-0.16498144673263626,1.3620658955115488,1.5270473422441848,19.78037664774663,-0.27107380202868336,-311550639.0,2001-11-30,2001,4,334,11,0.78,114.47,114.08,113.00998999999999,479
2001-12-03 14:30:00,113.64998999999999,114.08,113.00998999999999,113.37,115.57777777777778,108.9292,118.13820025000028,113.17650070000003,109.758,113.91999750000002,112.15487863501149,113.43102783572003,114.7053815384615,116.35203576014521,113.0587273167778,118.13820025000028,113.17650070000003,109.758,113.91999750000002,113.48666333333333,15220398,17085969.9,51.97581133892661,1.5,2.75,1.8549997427953264,0.8908126427168762,-0.26881703958187897,1.1910260427668362,1.4598430823487152,19.904865819412173,-2.073075926405797,-326771037.0,2001-12-03,2001,0,337,12,0.95,113.54,115.3,113.35001000000001,480
2001-12-04 14:30:00,113.91799999999999,115.3,113.35001000000001,115.28998999999999,116.01333333333334,108.7524,118.05335025000029,113.13240060000004,110.04979979999999,114.15049750000004,112.27782417873651,113.60807185136574,114.75384230769228,116.42913384862074,113.0785507667638,118.05335025000029,113.13240060000004,110.04979979999999,114.15049750000004,114.64666666666666,17245808,17148695.25,58.084062108997095,1.5,2.75,1.861784761167089,1.0056629818528031,-0.21058717850507055,1.196609109217377,1.4071962877224475,21.12971724197653,0.4268205574912944,-309525229.0,2001-12-04,2001,1,338,12,1.72,114.33,118.0,115.56,481
2001-12-05 14:30:00,115.61,118.0,115.56,117.39998999999999,116.44888888888892,118.0,117.98005020000029,113.1238006,110.3627996,114.40049750000004,112.4786934266292,113.96920691314043,114.94845692307688,117.14058884270077,112.756325003453,117.98005020000029,113.1238006,110.3627996,114.40049750000004,116.98666333333334,25204000,17246600.05,63.568169894406935,1.5,2.75,1.9223722782265824,1.4613894870252992,-0.041224371095726964,1.3556658238527888,1.3968901949485155,22.869299827301564,2.946334877791553,-284321229.0,2001-12-05,2001,2,339,12,2.11,116.78,117.94,116.92998999999999,482
2001-12-06 14:30:00,117.34899999999999,117.94,116.92998999999999,117.34,116.88444444444444,117.93674698795179,117.90005020000028,113.11340060000002,110.6817996,114.65499750000004,112.66933290009472,114.29023482617468,115.17768769230769,117.67739701038963,112.67797837422572,117.90005020000028,113.11340060000002,110.6817996,114.65499750000004,117.40333000000001,17969200,17159220.05,63.314533660386715,1.5,2.75,1.8572035440675403,1.0472037742764422,0.050526402221597655,1.4600481977255129,1.4095217955039152,22.262089180316725,1.4350018529565916,-302290429.0,2001-12-06,2001,3,340,12,0.86,117.43,117.09,115.7,483
2001-12-07 14:30:00,116.89998999999999,117.09,115.7,116.56,117.32,117.87349397590359,117.83085025000028,113.06710060000002,110.9675996,114.85299700000004,112.82190808048315,114.50640293796756,115.23845692307691,117.8295495020928,112.64736434406099,117.83085025000028,113.06710060000002,110.9675996,114.85299700000004,116.45,18908000,16967229.65,59.96437537971735,1.5,2.75,1.8416890052055728,1.1143834550503653,0.04275721300029267,1.4629683117542809,1.4202110987539884,21.564515161684273,0.5434400537772829,-321198429.0,2001-12-07,2001,4,341,12,1.2,116.4,116.39,114.35001000000001,484
2001-12-10 14:30:00,115.85001000000001,116.39,114.35001000000001,114.38,117.75555555555556,117.81024096385542,117.76080025000029,112.9885005,111.1663996,114.93599700000004,112.8830097243858,114.49436456292301,115.2061492307692,117.8285883204458,112.58371014109262,117.76080025000029,112.9885005,111.1663996,114.93599700000004,115.04000333333332,13862801,16865494.7,51.72639587451848,1.5,2.75,1.8679962191194608,0.8219623110136224,-0.11642406866325827,1.2746810129249155,1.3911050815881738,24.267578907969064,-0.90963362294323,-335061230.0,2001-12-10,2001,0,344,12,1.78,115.37,115.72,113.89998999999999,485
2001-12-11 14:30:00,114.89998999999999,115.72,113.89998999999999,114.14998999999999,118.19111111111113,117.74698795180723,117.7034502000003,112.92290030000001,111.3639994,115.04199650000002,112.93269522539026,114.4615669855018,115.21461076923076,117.82261449928602,112.60660703917549,117.7034502000003,112.92290030000001,111.3639994,115.04199650000002,114.58999333333333,20833296,16603579.5,50.93135847147813,1.5,2.75,1.8645686320395,1.2547472669974569,-0.23745381044006544,1.094287818538092,1.3317416289781574,24.200204244292607,0.7146550202929232,-355894526.0,2001-12-11,2001,1,345,12,1.6,114.81,114.78,113.11,486
2001-12-12 14:30:00,114.55,114.78,113.11,114.28,118.62666666666668,117.68373493975905,117.64580020000028,112.8473003,111.5379994,115.02849650000003,112.98553070674751,114.44427489164448,115.1069192307692,117.74461190643268,112.46922655510576,117.64580020000028,112.8473003,111.5379994,115.02849650000003,114.05666666666666,16172398,16644844.3,51.386189131070225,1.5,2.75,1.850670872608107,0.9716160577122371,-0.3047094864843129,0.9508547708727662,1.255564257357079,21.59420395822505,-0.5136240968050869,-339722128.0,2001-12-12,2001,2,346,12,1.48,113.94,113.7,112.03998999999999,487
2001-12-13 14:30:00,113.45,113.7,112.03998999999999,112.06,119.06222222222223,117.62048192771084,117.5813001500003,112.7578004,111.6321992,114.89849650000004,112.94923538491429,114.21720109244025,114.80922769230766,117.85077748184843,111.76767790276686,117.5813001500003,112.7578004,111.6321992,114.89849650000004,112.59999666666666,19031904,16716869.9,43.90279282213196,1.5,2.75,1.8784808102789563,1.138484902607276,-0.4840126198232495,0.6505484825780172,1.1345611024012667,22.830860846739665,-1.7448487505480008,-358754032.0,2001-12-13,2001,3,347,12,1.48,112.87,113.49001000000001,112.0,488
2001-12-14 14:30:00,112.33,113.49001000000001,112.0,113.13,112.0,117.55722891566263,117.5088501500003,112.6684003,111.74599920000001,114.81149650000003,112.956324193349,114.11365813125545,114.63230538461536,117.77473814670631,111.48987262252442,117.5088501500003,112.6684003,111.74599920000001,114.81149650000003,112.87333666666666,16722699,16579384.85,47.8452053039915,1.5,2.75,1.8507328952590307,1.008644117456505,-0.5130822855141353,0.4932082455085976,1.0062905310227328,23.568456180473408,-0.21169621593014826,-342031333.0,2001-12-14,2001,4,348,12,1.33,112.75,114.36,112.89998999999999,489
2001-12-17 14:30:00,112.99001000000001,114.36,112.89998999999999,114.3,112.20125,117.49397590361444,117.4481501500003,112.59800029999998,111.88739920000002,114.80849650000003,113.00901736223729,114.1314049758978,114.70615153846151,117.76771741547205,111.64458566145098,117.4481501500003,112.59800029999998,111.88739920000002,114.80849650000003,113.85333,13947301,16369980.3,51.83151109534357,1.5,2.75,1.8228241170262425,0.852004751648968,-0.4389134595819581,0.4576487065452852,0.8965621661272433,24.104296494350272,-0.8586955380948562,-328084032.0,2001-12-17,2001,0,351,12,1.29,113.63,115.14998999999999,114.34,490
2001-12-18 14:30:00,114.63,115.14998999999999,114.34,114.98,112.4025,117.43072289156626,117.4033001500003,112.55830029999996,112.05639920000002,114.76899650000004,113.08631079901228,114.2122235496218,114.71461307692306,117.77855067193826,111.65067548190784,117.4033001500003,112.55830029999996,112.05639920000002,114.76899650000004,114.82333,13663898,16369050.2,54.030649062529996,1.5,2.75,1.7533359658100829,0.8347398189297508,-0.3341950822891394,0.478818313265819,0.8130133955549584,22.205615810580944,-2.0613204481533587,-314420134.0,2001-12-18,2001,1,352,12,0.71,114.74,115.92,114.0,491
2001-12-19 14:30:00,114.09,115.92,114.0,115.78998999999999,112.60375,117.36746987951807,117.3592500500003,112.53820019999998,112.25299880000004,114.81849600000004,113.19233743434513,114.36248702108641,114.84845846153844,117.93649515466755,111.76042176840937,117.3592500500003,112.53820019999998,112.25299880000004,114.81849600000004,115.23666333333333,20147392,16565269.8,56.573935941867724,1.5,2.75,1.7652405396807909,1.2162429132304262,-0.2067609921103192,0.5545621554170594,0.7613231475273786,19.604193892277642,-1.3209561956707008,-294272742.0,2001-12-19,2001,2,353,12,1.68,114.96,115.8,114.55,492
2001-12-20 14:30:00,115.5,115.8,114.55,114.64998999999999,112.805,117.30421686746989,117.3144500000003,112.49369999999998,112.37959840000002,114.84899600000004,113.24950028005709,114.3898682571734,114.94691923076924,117.91958578903223,111.9742526725062,117.3144500000003,112.49369999999998,112.37959840000002,114.84899600000004,114.99999666666668,14867898,16735109.6,52.19688647508809,1.5,2.75,1.728437643989306,0.8884254931918701,-0.1957419948964122,0.5166456539068633,0.7123876488032755,20.18139679663841,-1.6386496225120109,-309140640.0,2001-12-20,2001,3,354,12,1.09,115.18,115.07001000000001,114.2,493
2001-12-21 14:30:00,115.03,115.07001000000001,114.2,114.95,113.00625,117.2409638554217,117.2654999500003,112.43969989999998,112.4785984,114.81249650000002,113.3161865435843,114.4432141374426,114.92076615384615,117.88687451694615,111.95465779074615,117.2654999500003,112.43969989999998,112.4785984,114.81249650000002,114.74000333333336,14042199,17101374.65,53.22257832268804,1.5,2.75,1.667121383704355,0.8211152195300278,-0.16592314698478094,0.5049837150722993,0.6709068620570803,20.15231891047624,0.4983388704319002,-295098441.0,2001-12-21,2001,4,355,12,0.76,114.64,115.03998999999999,114.61,494
2001-12-24 14:30:00,114.83,115.03998999999999,114.61,114.73,113.2075,117.17771084337349,117.20874995000031,112.37889989999998,112.58319840000001,114.75249700000002,113.37163020854177,114.4705270767338,114.71538230769232,117.31326986379824,112.11749475158636,117.20874995000031,112.37889989999998,112.58319840000001,114.75249700000002,114.79333000000004,5728801,16701354.75,52.33576756905987,1.5,2.75,1.5787548562969014,0.3430141497952434,-0.15869172109732965,0.4725422106854182,0.6312339317827479,16.854411075895985,0.5081121776708009,-300827242.0,2001-12-24,2001,0,358,12,0.38,114.82,116.21001000000001,114.64998999999999,495
2001-12-26 14:30:00,114.64998999999999,116.21001000000001,114.64998999999999,115.36,113.40875,117.1144578313253,117.1506499500003,112.32399979999998,112.7043984,114.74899750000002,113.44960549448128,114.55523878371152,114.56307461538462,116.7228223861811,112.40332684458816,117.1506499500003,112.32399979999998,112.7043984,114.74899750000002,115.4066666666667,10307898,16253429.65,54.665297848521654,1.5,2.75,1.5774166522756938,0.6341983336421553,-0.11139003226050126,0.4919963914571213,0.6033864237176225,17.024110236944722,0.9450472523626168,-290519344.0,2001-12-26,2001,2,360,12,1.36,115.43,116.08,115.259,496
2001-12-27 14:30:00,115.30098999999998,116.08,115.259,116.06,113.61,117.05120481927709,117.09534995000031,112.27109969999998,112.82579820000001,114.8849975,113.55197390646242,114.698549375739,114.52461307692309,116.5546568623452,112.49456929150094,117.09534995000031,112.27109969999998,112.82579820000001,114.8849975,115.79966666666668,9407301,15711434.7,57.170054027477214,1.5,2.75,1.5233868913988584,0.5987550583143117,-0.03673159470551979,0.5574719303357227,0.5942035250412425,17.263973418080415,3.569516330537212,-281112043.0,2001-12-27,2001,3,361,12,0.71,115.67,116.75,115.92,497
2001-12-28 14:30:00,116.28998999999999,116.75,115.92,116.0,113.81125,116.98795180722892,117.0585499500003,112.20999969999997,112.99279840000001,114.9414975,113.64797492973841,114.82249705424006,114.64922846153844,116.82231414164991,112.476142781427,117.0585499500003,112.20999969999997,112.99279840000001,114.9414975,116.22333333333334,10593801,15377869.55,56.87996459991035,1.5,2.75,1.47385925629894,0.6888991329751526,0.0027420985268081788,0.5976311481997527,0.5948890496729445,11.082109656160462,2.5369044462123265,-291705844.0,2001-12-28,2001,4,362,12,0.72,116.34,116.39,114.23,498
2001-12-31 14:30:00,116.14998999999999,116.39,114.23,114.3,114.0125,116.92469879518072,117.03964995000031,112.12689969999997,113.1303984,114.9539975,113.67354454033692,114.77273543002673,114.66076769230769,116.82470071696699,112.49683466764833,117.03964995000031,112.12689969999997,113.1303984,114.9539975,114.97333333333334,14619500,15424824.65,49.25411595583498,1.5,2.75,1.5228693094204435,0.9477903530008686,-0.08657381902514871,0.4866717758915087,0.5732455949166574,14.46124765987796,0.0,-306325344.0,2001-12-31,2001,0,365,12,1.89,115.31,115.75,113.81,499
2002-01-02 14:30:00,115.11,115.75,113.81,115.53,114.21375,116.86144578313251,117.0171999500003,112.06279969999996,113.2939982,115.06199750000003,113.74634671522566,114.84485586526226,114.75692153846151,116.95544260786713,112.55840046905593,117.0171999500003,112.06279969999996,113.2939982,115.06199750000003,115.03000000000002,18651904,15596399.95,54.05386690886049,1.5,2.75,1.5526643587475546,1.1959108550560094,-0.06474740733027684,0.4923113357538114,0.5570587430840882,14.559788909034385,0.4783440598364908,-287673440.0,2002-01-02,2002,2,2,1,1.7,114.78,116.95,115.53998999999999,500
2002-01-03 14:30:00,115.64998999999999,116.95,115.53998999999999,116.84,114.415,116.7981927710843,117.01315000000031,112.02819969999996,113.44139819999998,115.13949800000003,113.8676664518835,115.03486959238016,115.1246138461538,116.96577729625878,113.28345039604886,117.01315000000031,112.02819969999996,113.44139819999998,115.13949800000003,116.44333,15731801,15520699.6,58.550505532041434,1.5,2.75,1.5431883331227294,1.0136012812205966,0.03084967212807599,0.5956208332441832,0.5647711611161073,15.502596374390633,0.9068227745766282,-271941639.0,2002-01-03,2002,3,3,1,1.22,116.24,117.98,116.55,501
2002-01-04 14:30:00,117.17,117.98,116.55,117.62,114.61625,116.73493975903614,117.01285005000028,111.99669969999997,113.61559819999998,115.15049850000004,114.01481678710373,115.28107248834394,115.46999846153842,117.36856553262251,113.57143139045436,117.01285005000028,111.99669969999997,113.61559819999998,115.15049850000004,117.38333333333333,20140608,15267530.0,60.99806453442741,1.5,2.75,1.535103452185392,1.3191791992548894,0.13377974562695716,0.7319958431498037,0.5982160975228465,15.45724834089787,2.5905017523333425,-251801031.0,2002-01-04,2002,4,4,1,1.23,117.26,117.99001000000001,116.56,502
2002-01-07 14:30:00,117.7,117.99001000000001,116.56,116.78998999999999,114.8175,117.99001000000001,117.0217500500003,111.97929959999996,113.778998,115.12299800000002,114.12364710917812,115.4247789180255,115.66153615384613,117.55170214771385,113.77137015997843,117.0217500500003,111.97929959999996,113.778998,115.12299800000002,117.11333333333332,13106500,15024395.0,57.13201946322997,1.5,2.75,1.5275967770292922,0.8723479381366105,0.13285824516583844,0.7642889039801446,0.6314306588143062,14.764540871816795,1.6006872553284035,-264907531.0,2002-01-07,2002,0,7,1,1.23,117.28,117.06,115.97,503
2002-01-08 14:30:00,116.79799999999999,117.06,115.97,116.52,115.01875,117.98953428571429,117.0176000000003,111.95569959999996,113.89799779999998,115.12099800000004,114.21762173234761,115.52908568773731,115.77999769230769,117.67747798113687,113.88251740347849,117.0176000000003,111.95569959999996,113.89799779999998,115.12099800000004,116.51666666666668,12687000,14713345.0,55.89110291834122,1.5,2.75,1.4963398643843429,0.8622784281888313,0.10232925393875404,0.7593422262377487,0.6570129722989947,14.940559619982245,1.5601847816612848,-277594531.0,2002-01-08,2002,1,8,1,0.94,116.52,117.78,115.34,504
2002-01-09 14:30:00,116.67998999999999,117.78,115.34,115.57001000000001,115.22,117.98905857142857,117.02445005000031,111.91849979999998,114.0029978,115.18049850000004,114.27065656637319,115.53298324128616,115.76307615384613,117.66381890630342,113.86233340138884,117.02445005000031,111.91849979999998,114.0029978,115.18049850000004,116.23000333333334,16616898,14851049.85,51.640871289610644,1.5,2.75,1.5637441597854609,1.1189039271859962,0.011214000794056987,0.6710304732915661,0.6598164724975091,15.846668308133161,0.1820475034674037,-294211429.0,2002-01-09,2002,2,9,1,2.12,116.56,116.35001000000001,115.3,505
2002-01-10 14:30:00,115.69501000000001,116.35001000000001,115.3,116.08,115.42125,117.98858285714287,117.0435501000003,111.88609969999996,114.1755978,115.27699900000002,114.34161121082913,115.58508007544935,115.87307692307688,117.6658704050468,114.08028344110694,117.0435501000003,111.88609969999996,114.1755978,115.27699900000002,115.91000333333334,12823398,14450554.95,53.67739829143815,1.5,2.75,1.5270488626579282,0.8873983071494428,-0.019952181594645516,0.6348762455042021,0.6548284270988476,15.740936093557046,0.017232465965876288,-281388031.0,2002-01-10,2002,3,10,1,0.91,115.83,116.28,114.7,506
2002-01-11 14:30:00,116.21001000000001,116.28,114.7,114.94,115.6225,117.98810714285715,117.06265010000031,111.84279969999996,114.3511978,115.30999900000002,114.36507743785543,115.52364387778752,115.87230769230766,117.66669264117594,114.07792274343934,117.06265010000031,111.84279969999996,114.3511978,115.30999900000002,115.30666666666669,13708398,14327354.95,48.73662392730194,1.5,2.75,1.5308310867537904,0.9567989379644706,-0.11716269712425065,0.5083750556935343,0.6255377528177849,16.36924398598196,-0.9137931034482778,-295096429.0,2002-01-11,2002,4,11,1,1.38,115.49,114.84,113.96001000000001,507
2002-01-14 14:30:00,114.64998999999999,114.84,113.96001000000001,114.22,115.82375,117.98763142857143,117.06135010000031,111.80259959999998,114.5195978,115.417999,114.35938812656698,115.39948731799824,115.83307692307687,117.74415012332277,113.92200372283101,117.06135010000031,111.80259959999998,114.5195978,115.417999,114.34000333333331,12301301,13990824.8,45.86518837490753,1.5,2.75,1.4914852948428057,0.8792405863019598,-0.22360212902864893,0.34603509153197365,0.5696372205606226,16.642451085336813,-0.0699912510936118,-307397730.0,2002-01-14,2002,0,14,1,0.77,114.4,115.39,113.89998999999999,508
2002-01-15 14:30:00,114.55,115.39,113.89998999999999,115.14998999999999,116.025,117.98715571428569,117.05740005000034,111.76759959999998,114.65239779999999,115.51899850000001,114.39039212160357,115.37572566866508,115.81692230769228,117.74717265915108,113.88667195623344,117.05740005000034,111.76759959999998,114.65239779999999,115.51899850000001,114.81332666666668,20221392,14165759.45,49.96573384262093,1.5,2.75,1.4913799166397477,1.427483790853162,-0.22443819441507476,0.2890894775417792,0.5135276719568539,15.104316753176287,-0.3289275512853792,-287176338.0,2002-01-15,2002,1,15,1,1.31,114.64,114.39998999999999,112.69,509
2002-01-16 14:30:00,114.3,114.39998999999999,112.69,112.82001000000001,116.22625,117.98668,117.0299501000003,111.72829969999997,114.723798,115.44499899999998,114.32880850899168,115.13232417641126,115.56769230769228,118.06223772769886,113.07314688768568,117.0299501000003,111.72829969999997,114.723798,115.44499899999998,113.30333333333333,17076704,14322229.6,41.48692496897024,1.5,2.75,1.5605663511654804,1.1923216200918885,-0.36657241708755023,0.05531215059741612,0.4218845676849664,17.896464100546954,-3.4405939746662164,-304253042.0,2002-01-16,2002,2,16,1,1.52,113.54,114.24001000000001,113.39998999999999,510
2002-01-17 14:30:00,113.75998999999999,114.24001000000001,113.39998999999999,113.67,116.4275,117.98620428571428,117.0231001500003,111.68669969999998,114.7835982,115.37949899999998,114.30297288118808,114.99305520722923,115.3884615384615,118.06144306201551,112.7154800149075,117.0231001500003,111.68669969999998,114.7835982,115.37949899999998,113.77,17391104,14508589.9,45.14399327170918,1.5,2.75,1.5505258975108034,1.1986763786052013,-0.38604492742977947,-0.06067159160225799,0.3253733358275215,16.952681418923113,-3.3582724026526125,-286861938.0,2002-01-17,2002,3,17,1,0.74,113.82,113.85001000000001,112.67,511
2002-01-18 14:30:00,113.0,113.85001000000001,112.67,113.14998999999999,116.62875,117.98572857142857,117.0114501000003,111.65999949999996,114.7985982,115.24749899999998,114.25775786623952,114.81752518749313,115.2999992307692,118.17936732390993,112.42063113762848,117.0114501000003,111.65999949999996,114.7985982,115.24749899999998,113.22333333333334,17028192,14352629.9,43.35858393356981,1.5,2.75,1.5240604762600314,1.1864161563867817,-0.41416499661846745,-0.19233290994556285,0.2218320866729046,15.866042378501673,-3.116705464226857,-303890130.0,2002-01-18,2002,4,18,1,1.05,113.26,113.92998999999999,112.02,512
2002-01-22 14:30:00,113.75,113.92998999999999,112.02,112.37,116.83,117.98525285714285,116.98985010000031,111.61349949999996,114.8009982,115.13349949999996,114.18372814599483,114.58442755058901,115.05692230769228,118.32489481783308,111.7889497975515,116.98985010000031,111.61349949999996,114.8009982,115.13349949999996,112.77333000000002,11689801,14193725.05,40.75494834507264,1.5,2.75,1.5516268708128869,0.8235893649355988,-0.4618784381030424,-0.35551596095589844,0.10636247714714396,15.854185104568838,-3.5616203226913763,-315579931.0,2002-01-22,2002,1,22,1,1.71,112.97,113.55,112.02,513
2002-01-23 14:30:00,112.63,113.55,112.02,113.23,117.03125,117.98477714285713,116.9850001000003,111.57979939999996,114.813598,115.0474995,114.14632704223033,114.45543445053292,114.77923,118.00721598288908,111.55124401711092,116.9850001000003,111.57979939999996,114.813598,115.0474995,112.93333333333334,12438898,14113560.0,44.69806424453022,1.5,2.75,1.550082094326252,0.8813437573510865,-0.4136583634374689,-0.4107104771496921,0.002947886287776757,17.175622782364414,-2.024755384203906,-303141033.0,2002-01-23,2002,2,23,1,1.37,112.78,114.25,113.32001000000001,514
2002-01-24 14:30:00,113.64,114.25,113.32001000000001,113.58,117.2325,117.98430142857143,117.00095010000034,111.52539939999996,114.830798,114.98999949999998,114.12411813861344,114.37205974095836,114.46846076923076,117.2956542458536,111.64126729260789,117.00095010000034,111.52539939999996,114.830798,114.98999949999998,113.71667,12162398,14435239.85,46.26551823267753,1.5,2.75,1.5122190875886623,0.8425490761762439,-0.33944099284613466,-0.4213533547698916,-0.08191236192375691,17.115740701506933,-2.15368711233632,-290978635.0,2002-01-24,2002,3,24,1,0.82,113.79,114.17998999999999,113.03998999999999,515
2002-01-25 14:30:00,113.12,114.17998999999999,113.03998999999999,113.55,117.43375,117.98382571428571,117.0144500500003,111.47779939999997,114.861198,114.89949949999998,114.10160370180508,114.29376833705757,114.21923076923076,116.73832059930523,111.70014093915628,117.0144500500003,111.47779939999997,114.861198,114.89949949999998,113.58999333333334,12810699,14560379.9,46.14478828308195,1.5,2.75,1.485632009903758,0.8798327439244906,-0.2762966755908215,-0.4272832064122838,-0.1509865308214623,16.708821177833105,-1.2093266051853149,-303789334.0,2002-01-25,2002,4,25,1,1.01,113.61,114.19,112.92,516
2002-01-28 14:30:00,113.89998999999999,114.19,112.92,113.86,117.635,117.98335,117.00850005000036,111.45059939999996,114.847398,114.7894995,114.09212904683235,114.2524570668616,114.01461538461537,116.1568733507068,111.87235741852392,117.00850005000036,111.45059939999996,114.847398,114.7894995,113.65666666666668,10589500,14619489.85,47.6645607902892,1.5,2.75,1.4702297234820605,0.7243412806227298,-0.201075121386629,-0.4023304325547485,-0.20125531116811954,16.149816079845277,-0.3151812292067934,-293199834.0,2002-01-28,2002,0,28,1,1.12,113.56,114.13,110.05,517
2002-01-29 14:30:00,113.851,114.13,110.05,110.28,117.83625,117.98287428571429,116.99340005000036,111.39799949999998,114.759798,114.50349950000002,113.94263379009381,113.87412782239859,113.60769153846151,116.34155852775274,110.87382454917031,116.99340005000036,111.39799949999998,114.759798,114.50349950000002,111.48666666666668,27735296,15476564.6,35.28200866699207,1.5,2.75,1.6566418860904846,1.7920834963593923,-0.3700194485827118,-0.6637796218965093,-0.2937601733137975,24.02504235139355,-4.229257857512624,-320935130.0,2002-01-29,2002,1,29,1,3.71,112.09,113.39,108.39998999999999,518
2002-01-30 14:30:00,110.39,113.39,108.39998999999999,111.87,118.0375,117.98239857142856,116.97995005000034,111.38349939999999,114.699798,114.38199949999998,113.86135403361956,113.6832585059797,113.28384538461539,115.754252624192,110.81343814503876,116.97995005000034,111.38349939999999,114.699798,114.38199949999998,111.21999666666666,34711808,16481180.0,42.43476795465035,1.5,2.75,1.8947396085125927,2.106148224823708,-0.352365208054552,-0.7342166833819874,-0.38185147532743546,25.347436965492005,-0.8420580710815323,-286223322.0,2002-01-30,2002,2,30,1,4.6,110.89,113.3,111.62,519
2002-01-31 14:30:00,112.14998999999999,113.3,111.62,113.17998999999999,118.23875,117.98192285714285,116.9626000500003,111.3737994,114.67619779999998,114.26449899999996,113.8346338754384,113.63532817207684,113.14846,115.42638901695128,110.87053098304871,116.9626000500003,111.3737994,114.67619779999998,114.26449899999996,112.69999666666668,19909200,16544044.8,47.57564498712762,1.5,2.75,1.8794010650474071,1.2034058321698935,-0.2357465372128231,-0.6765346468434643,-0.4407881096306413,23.865271885064818,-0.4310811999648087,-266314122.0,2002-01-31,2002,3,31,1,1.51,112.46,113.3,112.17,520
2002-02-01 14:30:00,113.09,113.3,112.17,112.64998999999999,118.44,117.98144714285714,116.94220000000034,111.3660993,114.61379759999998,114.05499849999997,113.78817725287216,113.54148644140287,113.02768999999998,115.23081967822479,110.82456032177515,116.94220000000034,111.3660993,114.61379759999998,114.05499849999997,112.70666333333334,15838500,16549379.75,45.793775150561096,1.5,2.75,1.8258724175440209,0.9570449309437109,-0.18009877134184415,-0.6659115738079464,-0.4858128024661023,23.54643431400392,-0.4418913337950803,-282152622.0,2002-02-01,2002,4,32,2,1.01,112.74,112.23,109.44901000000002,521
2002-02-04 14:30:00,112.23,112.23,109.44901000000002,109.85001000000001,118.64125,117.98097142857141,116.89720000000034,111.3275994,114.51479779999998,113.66649899999996,113.63373932138701,113.18991725650736,112.6199992307692,115.05105004511513,110.1889484164233,116.89720000000034,111.3275994,114.51479779999998,113.66649899999996,110.50967333333334,24243904,16754544.55,37.74981573928041,1.5,2.75,1.924094387719448,1.4470046576109403,-0.31003787432704066,-0.8733601453749031,-0.5633222710478625,27.36754100239164,-2.242582539823802,-306396526.0,2002-02-04,2002,0,35,2,2.54,110.84,110.49898999999999,108.53,522
2002-02-05 14:30:00,109.39998999999999,110.49898999999999,108.53,109.17,118.8425,117.98049571428572,116.85504995000035,111.3115994,114.41739799999998,113.28549949999996,113.45869072054829,112.80706799398286,112.33922923076922,115.3797354273899,109.29872303414854,116.85504995000035,111.3115994,114.41739799999998,113.28549949999996,109.39966333333336,33614000,17779919.55,36.091696445938396,1.5,2.75,1.9273012171680592,1.8905597354066768,-0.4134894370101423,-1.0801840673105405,-0.666694630300398,27.333172803321837,-3.585622184933324,-340010526.0,2002-02-05,2002,1,36,2,1.81,109.51,109.74001000000001,108.06,523
2002-02-06 14:30:00,109.64998999999999,109.74001000000001,108.06,108.7,119.04375,117.98002,116.80225000000036,111.3113994,114.27779819999998,112.89449949999997,113.27207539817385,112.41591866122258,111.95692153846151,115.44836922590805,108.46547385101499,116.80225000000036,111.3113994,114.27779819999998,112.89449949999997,108.83333666666664,29581008,18624619.95,34.949071196052714,1.5,2.75,1.909637558798912,1.5882744495948762,-0.4805712470737719,-1.2674086891426128,-0.786837442068841,26.500923017228427,-4.296531079415386,-369591534.0,2002-02-06,2002,2,37,2,1.55,108.9,109.86,108.0,524
2002-02-07 14:30:00,108.72,109.86,108.0,108.02,119.245,117.97954428571428,116.72235000000036,111.29109940000002,114.11959840000002,112.51699899999996,113.066111657069,111.99725974110613,111.56230692307692,115.549584475741,107.57502937041279,116.72235000000036,111.29109940000002,114.11959840000002,112.51699899999996,108.62666666666668,23450000,18966275.05,33.306150144143274,1.5,2.75,1.9060920188847041,1.236405142189478,-0.5336470517838076,-1.4538962567986005,-0.9202492050147928,26.11693630302279,-4.870101276970499,-393041534.0,2002-02-07,2002,3,38,2,1.72,108.93,110.75,108.3,525
2002-02-08 14:30:00,108.63,110.75,108.3,110.09,119.44625,117.97906857142857,116.64455005000036,111.34899940000004,114.0127986,112.21749899999998,112.94940139600747,111.81561595623889,111.38692230769227,115.41700858516492,107.35683603021963,116.64455005000036,111.34899940000004,114.0127986,112.21749899999998,109.71333333333332,19278096,19289009.95,42.211812854502185,1.5,2.75,1.964942588964368,0.9994341881709694,-0.3984469772178201,-1.4183079265370682,-1.019860949319248,29.50556186198898,-3.31108378710697,-373763438.0,2002-02-08,2002,4,39,2,2.26,109.52,111.64,109.82001000000001,526
2002-02-11 14:30:00,110.05,111.64,109.82001000000001,111.44,119.6475,117.97859285714287,116.57925005000034,111.42289940000003,113.9747986,112.04249899999998,112.89020918439934,111.77984300802568,111.24922999999997,115.13785632235022,107.36060367764972,116.57925005000034,111.42289940000003,113.9747986,112.04249899999998,110.96667,18792096,19543194.85,47.166726413900655,1.5,2.75,1.954588832609771,0.9615672434438219,-0.1973672170379166,-1.2665699706166436,-1.0692027535787272,30.662555393249878,1.0518679724338018,-354971342.0,2002-02-11,2002,0,42,2,1.66,110.73,111.71001000000001,110.03,527
2002-02-12 14:30:00,110.96001000000001,111.71001000000001,110.03,111.09,119.84875,117.97811714285713,116.52350000000031,111.51429940000004,113.8991986,111.885999,112.81961274579544,111.71414367392799,111.05769153846151,114.70610667695705,107.40927639996595,116.52350000000031,111.51429940000004,113.8991986,111.885999,110.94333666666664,13942500,19625254.8,46.063975596050646,1.5,2.75,1.9349760588519296,0.7104366359615366,-0.07357646819310326,-1.161173338820106,-1.0875968706270027,24.210976183141717,-0.6972378653794593,-368913842.0,2002-02-12,2002,1,43,2,1.53,110.87,112.53998999999999,111.35001000000001,528
2002-02-13 14:30:00,111.48100000000001,112.53998999999999,111.35001000000001,112.27,120.05,117.97764142857143,116.4769500000003,111.64989930000004,113.8635986,111.7419995,112.79805930478383,111.76708237164914,110.95922999999996,114.39624981343584,107.52221018656408,116.4769500000003,111.64989930000004,113.8635986,111.7419995,112.05333333333333,16783808,19453375.6,50.2841927207735,1.5,2.75,1.9003341975053636,0.8627709835613311,0.09309043136990436,-0.9712338314146224,-1.0643242627845266,23.52903370383882,-0.8040202159410048,-352130034.0,2002-02-13,2002,2,44,2,1.07,111.94,112.97,111.59100000000001,529
2002-02-14 14:30:00,112.50998999999999,112.97,111.59100000000001,112.06,120.25125,117.9771657142857,116.42140000000036,111.79769930000002,113.8373986,111.703999,112.76911580263548,111.79497928863493,110.82076846153844,113.90624756030873,107.73528936276813,116.42140000000036,111.79769930000002,113.8373986,111.703999,112.20700000000001,20458000,19622440.4,49.541267759127024,1.5,2.75,1.8630960405406949,1.0425818391070256,0.18897559264502428,-0.8281047719782464,-1.017080364623271,22.411605636201177,-0.5237372857290091,-372588034.0,2002-02-14,2002,3,45,2,1.24,112.28,112.24001000000001,110.71001000000001,530
2002-02-15 14:30:00,112.14998999999999,112.24001000000001,110.71001000000001,110.89,120.4525,117.97669,116.3572500000003,111.8995993,113.74939880000002,111.564999,112.69542498684584,111.70879078495541,110.86769153846151,113.93736095308942,107.7980221238336,116.3572500000003,111.8995993,113.74939880000002,111.564999,111.28000666666668,18392096,19672490.0,45.507185966116545,1.5,2.75,1.83930346621636,0.9349144922681368,0.173774002168263,-0.7998628619129421,-0.973636864081205,23.000134336309163,0.9467363726230004,-390980130.0,2002-02-15,2002,4,46,2,1.38,111.48,110.29799999999999,108.61,531
2002-02-19 14:30:00,110.14998999999999,110.29799999999999,108.61,108.75998999999999,120.65375,117.97621428571428,116.27214995000031,111.9696992,113.5765988,111.345499,112.54109420304796,111.42795261495964,110.62845999999998,113.83029118616464,107.42662881383532,116.27214995000031,111.9696992,113.5765988,111.345499,109.22266333333334,15988102,19620485.5,39.2423083252855,1.5,2.75,1.8707817900580483,0.8148678074250507,0.028080618750247255,-0.938536090643396,-0.9666167093936432,20.988043807912046,-0.37557021159659226,-406968232.0,2002-02-19,2002,1,50,2,1.55,109.45,110.59,107.82001000000001,532
2002-02-20 14:30:00,109.05,110.59,107.82001000000001,110.59,107.82001000000001,117.97573857142856,116.20054995000034,112.06169920000002,113.4415988,111.256499,112.46458070488922,111.34814760401112,110.42922999999996,113.27356416263159,107.58489583736834,116.20054995000034,112.06169920000002,113.4415988,111.256499,109.66667,29242896,20498140.25,46.107006171074225,1.5,2.75,1.935010947911045,1.426612153265953,0.06089021912941539,-0.890503935481874,-0.9513941546112894,22.925613973708728,1.7387304507819692,-377725336.0,2002-02-20,2002,2,51,2,2.57,109.21,110.63,108.25998999999999,533
2002-02-21 14:30:00,109.931,110.63,108.25998999999999,108.3,107.72501022727272,117.97526285714285,116.10679995000034,112.1219992,113.2763988,111.00999900000002,112.3012638145014,111.05784783220055,110.09461538461537,112.83685169143136,107.35237907779933,116.10679995000034,112.1219992,113.2763988,111.00999900000002,109.06333,26292608,21190825.75,40.01439918975593,1.5,2.75,1.9660823087745416,1.2407542919841148,-0.05920609612359463,-1.0254017747657826,-0.966195678642188,26.15720013056321,0.2592112571745984,-404017944.0,2002-02-21,2002,3,52,2,2.19,109.44,109.94,107.87,534
2002-02-22 14:30:00,108.35001000000001,109.94,107.87,109.64,107.63001045454546,117.97478714285714,116.0208999000003,112.17399920000001,113.18159880000002,110.81299900000002,112.1969005276582,110.92281470532429,110.07846076923077,112.82873323689668,107.32818830156485,116.0208999000003,112.17399920000001,113.18159880000002,110.81299900000002,109.15,26572896,21911350.65,44.62545531092882,1.5,2.75,1.9735050010049309,1.2127456871308844,-0.03705216739235096,-1.0125108878826268,-0.9754587204902758,26.78485078299475,-0.4087564719774756,-377445048.0,2002-02-22,2002,4,53,2,1.92,108.9,111.81,109.7,535
2002-02-25 14:30:00,109.74799999999999,111.81,109.7,111.45,107.53501068181818,117.97431142857144,115.95209985000034,112.2457992,113.127599,110.707999,112.1676103108873,110.97302282862677,110.25384538461536,113.04056871939731,107.4671220498334,115.95209985000034,112.2457992,113.127599,110.707999,110.98666666666666,17458704,22143750.9,50.194597532059916,1.5,2.75,1.9875403580760076,0.7884257765923478,0.10317886424998812,-0.8464851401777906,-0.9496640044277788,26.19843392535583,0.00897343862168442,-359986344.0,2002-02-25,2002,0,56,2,1.92,110.76,112.03998999999999,110.57001000000001,536
2002-02-26 14:30:00,111.60001000000001,112.03998999999999,110.57001000000001,111.22,107.4400109090909,117.97383571428571,115.87149985000036,112.3021992,113.06639900000002,110.57599899999998,112.13044912222506,110.99654446399565,110.44769153846151,113.12347838313471,107.77190469378831,115.87149985000036,112.3021992,113.06639900000002,110.57599899999998,111.27666666666669,22362000,22732375.9,49.5131496614389,1.5,2.75,1.9505717610705788,0.9837071187970282,0.17964399437329726,-0.7251090114611571,-0.9047530058344544,25.279527462251448,0.11702223422449855,-382348344.0,2002-02-26,2002,1,57,2,1.33,111.3,112.86,110.64998999999999,537
2002-02-27 14:30:00,111.961,112.86,110.64998999999999,111.64998999999999,107.34501113636364,117.97336000000001,115.79854975000036,112.345199,113.0581988,110.64449849999995,112.11160758802014,111.05877737218651,110.72692153846151,113.06771021560742,108.38613286131563,115.79854975000036,112.345199,113.0581988,110.64449849999995,111.71999333333332,28597904,22775506.3,50.8564026316716,1.5,2.75,1.969103063851252,1.2556429535882592,0.2538430392431936,-0.5874492067804624,-0.8412922460236558,25.300140487038387,-0.5522490424868562,-353750440.0,2002-02-27,2002,2,58,2,2.0,111.75,112.75,111.03,538
2002-02-28 14:30:00,111.834,112.75,111.03,111.14998999999999,107.25001136363636,117.97288428571429,115.72339975000037,112.38229889999998,113.0185986,110.60849799999997,112.07389709437227,111.06746428912115,110.80845923076922,113.128577698528,108.48834076301044,115.72339975000037,112.38229889999998,113.0185986,110.60849799999997,111.64333,23755504,22227691.1,49.216615006410805,1.5,2.75,1.9513099878618765,1.0687346649333271,0.2628037604300177,-0.5127875454861339,-0.7755913059161517,24.575497634461644,-0.8120738889880419,-377505944.0,2002-02-28,2002,3,59,2,1.55,111.89,113.85001000000001,111.50998999999999,539
2002-03-01 14:30:00,111.72,113.85001000000001,111.50998999999999,113.74001000000001,107.15501159090908,117.97240857142856,115.66384985000036,112.447399,113.00739879999999,110.63649899999996,112.1392348553773,111.32199245206199,110.98538307692307,113.77452720224571,108.19623895160042,115.66384985000036,112.447399,113.00739879999999,110.63649899999996,113.03333666666668,26179504,22541206.3,56.95850675678069,1.5,2.75,2.0047892744431706,1.1614065215311924,0.427003503017261,-0.2418369271445755,-0.6688404301618365,28.141250497541012,2.5701235458562515,-351326440.0,2002-03-01,2002,4,60,3,2.1,112.68,115.99001000000001,113.64998999999999,540
2002-03-04 14:30:00,113.90100000000001,115.99001000000001,113.64998999999999,115.75,107.06001181818182,117.97193285714285,115.61249985000036,112.53959899999998,113.02279880000002,110.79149949999996,112.28083348849978,111.74370745662752,111.3438446153846,115.11837484788781,107.56931438288142,115.61249985000036,112.53959899999998,113.02279880000002,110.79149949999996,115.13,27184800,23108521.3,61.82265332736196,1.5,2.75,2.0287343262686584,1.176397210668776,0.6419070480035659,0.13354337984262088,-0.508363668160945,28.366394634553927,6.4270050043219005,-324141640.0,2002-03-04,2002,0,63,3,2.06,114.82,116.39998999999999,114.97,541
2002-03-05 14:30:00,115.33,116.39998999999999,114.97,115.38,106.96501204545454,117.97145714285713,115.56364990000034,112.63379889999996,113.01459900000002,111.06799899999996,112.4023694301272,112.0900210321868,111.58307538461538,115.91513063844515,107.2510201307856,115.56364990000034,112.63379889999996,113.01459900000002,111.06799899999996,115.58333,22733008,23032976.5,60.46797171804881,1.5,2.75,1.985966874392325,0.9869765637975622,0.7239767173820202,0.39660722856658026,-0.3273694888154399,24.71463080724317,4.331313862012832,-346874648.0,2002-03-05,2002,1,64,3,1.24,115.68,117.14998999999999,115.07898999999999,542
2002-03-06 14:30:00,115.10001000000001,117.14998999999999,115.07898999999999,116.75,106.87001227272728,117.97098142857142,115.52039995000034,112.71809879999996,113.05659920000002,111.44699899999996,112.57286474659278,112.53382855293093,111.94384461538462,117.08102220166735,106.8066670291019,115.52039995000034,112.71809879999996,113.05659920000002,111.44699899999996,116.32632666666666,20143808,22359466.9,63.644570741018356,1.5,2.75,1.992040669078588,0.9009073467668408,0.8278791049251518,0.7074793923409999,-0.12039971258415195,24.088005977445718,7.8024007386888306,-326730840.0,2002-03-06,2002,2,65,3,1.8,116.11,117.5,115.57001000000001,543
2002-03-07 14:30:00,117.36098999999999,117.5,115.57001000000001,116.5,106.7750125,117.97050571428572,115.47299995000034,112.78309879999998,113.08759920000004,111.83699899999996,112.726870050648,112.91155916693751,112.37538307692309,118.00487852346079,106.74588763038535,115.47299995000034,112.78309879999998,113.08759920000004,111.83699899999996,116.52333666666668,19331808,21847006.9,62.65516527479989,1.5,2.75,1.9876084784301171,0.8848721515257086,0.8347475630708397,0.9230347412543978,0.08828717818355802,18.300529071986478,6.256840569135353,-346062648.0,2002-03-07,2002,3,66,3,1.67,116.54,117.90700000000001,116.48,544
2002-03-08 14:30:00,117.381,117.90700000000001,116.48,116.99001000000001,106.68001272727273,117.90700000000001,115.41320000000034,112.85799889999996,113.13279940000004,112.28549949999996,112.89405200944613,113.2999830558006,113.00846153846152,118.71971703378848,107.2972060431346,115.41320000000034,112.85799889999996,113.13279940000004,112.28549949999996,117.12567,19930304,21671022.1,63.841673844703905,1.5,2.75,1.9475650156851083,0.91967531148427,0.8257601290576118,1.1204873395055728,0.29472721044796096,18.080537188050016,4.9708479138627135,-326132344.0,2002-03-08,2002,4,67,3,1.23,117.19,117.89998999999999,116.42998999999999,545
2002-03-11 14:30:00,116.89101000000001,117.89998999999999,116.42998999999999,117.24001000000001,106.58501295454543,117.90502357142857,115.35365010000034,112.93739899999996,113.17039960000004,112.64299999999996,113.06448173456587,113.67522371715292,113.52000076923076,119.45983327143371,107.5801682670278,115.35365010000034,112.93739899999996,113.17039960000004,112.64299999999996,117.18999666666667,15622102,21488222.4,64.46204629581925,1.5,2.75,1.9134532288504575,0.7270076467562995,0.7901067132997797,1.2823606020726857,0.492253888772906,17.051633034646226,5.412704549541449,-310510242.0,2002-03-11,2002,0,70,3,1.26,117.16,117.25,115.94,546
2002-03-12 14:30:00,116.10898999999999,117.25,115.94,117.17,106.49001318181816,117.90304714285713,115.2908000500003,113.00919889999996,113.19259960000004,112.92949999999996,113.22548245085741,114.00805955361454,114.20230846153845,119.59995040036478,108.80466652271215,115.2908000500003,113.00919889999996,113.19259960000004,112.92949999999996,116.78666666666668,17154896,21406362.4,64.13021933939507,1.5,2.75,1.8703494267897107,0.8013923935063344,0.7173854841387778,1.3889857439463782,0.6716002598076004,16.84703453748661,4.944030895121442,-327665138.0,2002-03-12,2002,1,71,3,1.13,116.6,116.75,115.64,547
2002-03-13 14:30:00,116.631,116.75,115.64,116.03998999999999,106.39501340909092,117.90107071428572,115.21275005000031,113.09309889999996,113.19339940000003,113.17699949999997,113.33585529592185,114.20157673898458,114.6946153846154,119.46951468047656,109.9197160887542,115.21275005000031,113.09309889999996,113.19339940000003,113.17699949999997,116.14333,17175504,21568012.6,58.86327320701517,1.5,2.75,1.8460387534475888,0.7963415229087912,0.5559612443810612,1.3665518152839269,0.8105905709028657,18.9080638172737,4.399460584746792,-344840642.0,2002-03-13,2002,2,72,3,0.96,116.2,116.42998999999999,115.63,548
2002-03-14 14:30:00,116.03998999999999,116.42998999999999,115.63,115.88,106.30001363636364,117.89909428571428,115.1347500500003,113.17769889999997,113.22499940000006,113.35749949999996,113.43562567647392,114.361426573367,115.0353846153846,119.45446581742536,110.61630341334384,115.1347500500003,113.17769889999997,113.22499940000006,113.35749949999996,115.97999666666666,11169602,21287302.3,58.13527366263343,1.5,2.75,1.77132098534419,0.5247072570581196,0.4080390635542884,1.3206394003457262,0.9126003367914378,18.486540147811894,1.881475129112436,-356010244.0,2002-03-14,2002,3,73,3,0.69,116.03,116.95,115.89998999999999,549
2002-03-15 14:30:00,115.97,116.95,115.89998999999999,116.64998999999999,106.20501386363637,117.89711785714287,115.07175000000035,113.27069869999997,113.24739920000006,113.58699899999996,113.5616791793573,114.5793849949511,115.45307615384615,119.3458163627684,111.56033594492388,115.07175000000035,113.27069869999997,113.24739920000006,113.58699899999996,116.49999333333332,21221904,21325497.5,60.65718088455003,1.5,2.75,1.7212266292481768,0.9951422704206551,0.334753184269315,1.3310418171280816,0.9962886328587666,14.289557457684447,0.7775291576673887,-334788340.0,2002-03-15,2002,4,74,3,0.91,116.42,117.56700000000001,116.10001000000001,550
2002-03-18 14:30:00,117.10001000000001,117.56700000000001,116.10001000000001,116.67,106.11001409090908,117.89514142857142,115.0069500000003,113.34269869999996,113.24399920000003,113.87599899999998,113.68357411350014,114.77849118590815,115.83923076923077,119.08920472931256,112.58925680914896,115.0069500000003,113.34269869999996,113.24399920000003,113.87599899999998,116.77900333333334,17557504,21283767.9,60.72339665833597,1.5,2.75,1.7030668700161642,0.8249246130897716,0.26346471800608073,1.3256195303663674,1.0621548123602866,10.639761326084377,1.118044721788877,-317230836.0,2002-03-18,2002,0,77,3,1.26,116.83,117.74001000000001,116.82001000000001,551
2002-03-19 14:30:00,117.30098999999998,117.74001000000001,116.82001000000001,117.45,106.0150143181818,117.893165,114.95369995000034,113.42809869999998,113.24059920000003,114.31049949999996,113.83127708944131,115.03292059677405,116.32384692307691,118.2357599253179,114.41193392083592,114.95369995000034,113.42809869999998,113.24059920000003,114.31049949999996,117.33667333333334,17913008,21380013.2,63.315268505964276,1.5,2.75,1.6578485221578665,0.8378389588646279,0.2450655476676875,1.368486746944896,1.1234211992772083,10.789601967652676,0.5995717344753771,-299317828.0,2002-03-19,2002,1,78,3,0.79,117.28,116.58,115.19,552
2002-03-20 14:30:00,116.5,116.58,115.19,115.24001000000001,105.92001454545452,117.89118857142857,114.8945000000003,113.49429879999997,113.20959960000006,114.54299999999996,113.88652151730636,115.05264339708128,116.43923153846151,117.8210362807814,115.05742679614167,114.8945000000003,113.49429879999997,113.20959960000006,114.54299999999996,115.67000333333333,17115008,20773618.8,52.70326241614713,1.5,2.75,1.7008593420037332,0.8238818746399641,0.06940814769839809,1.2101813839002062,1.140773236201808,14.234483548581492,-1.0815364806866972,-316432836.0,2002-03-20,2002,2,79,3,1.21,115.88,115.83,114.12,553
2002-03-21 14:30:00,115.3,115.83,114.12,115.28998999999999,105.82501477272729,117.88921214285713,114.84444995000034,113.54149859999997,113.18499940000004,114.89249949999996,113.94155949701984,115.07524783545448,116.40384615384613,117.87510281121479,114.93258949647749,114.84444995000034,113.54149859999997,113.18499940000004,114.89249949999996,115.07999666666666,26886704,20803323.6,52.895545748771184,1.5,2.75,1.7015122461463232,1.292423485639573,-0.05153960234929289,1.076348733265192,1.1278883356144849,14.255477988879326,-1.4531326221785903,-289546132.0,2002-03-21,2002,3,80,3,1.5,114.98,115.94,114.7,554
2002-03-22 14:30:00,115.5,115.94,114.7,115.03998999999999,105.730015,117.88723571428572,114.78989990000036,113.58869839999996,113.17439900000004,115.16249899999998,113.98463520301908,115.07188994636357,116.37769153846149,117.93064280564873,114.82474027127428,114.78989990000036,113.58869839999996,113.17439900000004,115.16249899999998,115.22666333333332,15235398,20236448.7,51.761972180767934,1.5,2.75,1.6685470857072997,0.7528691533707691,-0.1508826764268738,0.9392849900808926,1.0901676665077664,13.86270961824567,-1.8765095635866929,-304781530.0,2002-03-22,2002,4,81,3,1.08,115.32,115.36,113.3,555
2002-03-25 14:30:00,115.09100000000001,115.36,113.3,113.61,105.63501522727272,117.88525928571428,114.72429990000036,113.65029839999997,113.12499900000005,115.270499,113.96994362643007,114.9326623324242,116.13615307692305,118.25572918960144,114.01657696424463,114.72429990000036,113.65029839999997,113.12499900000005,115.270499,114.09,17499600,20238493.5,45.725702063196714,1.5,2.75,1.6965080081567785,0.8646691019763897,-0.3064369430469349,0.7071214876990979,1.0135584307460328,14.893780784485207,-3.0383203891781188,-322281130.0,2002-03-25,2002,0,84,3,1.82,114.33,115.02,113.47,556
2002-03-26 14:30:00,113.521,115.02,113.47,114.27,105.54001545454544,117.88328285714287,114.65894990000037,113.73139839999996,113.11159900000006,115.422999,113.98171054304066,114.86955163409807,115.96461461538458,118.28963381269405,113.63959541807512,114.65894990000037,113.73139839999996,113.11159900000006,115.422999,114.25333333333334,19948608,20117823.9,48.69926449348311,1.5,2.75,1.6860431504312938,0.9915887572711084,-0.35499217348208456,0.5698182138934271,0.9248103873755116,15.720119258074256,-1.525327604733512,-302332522.0,2002-03-26,2002,1,85,3,1.37,114.24,115.00998999999999,113.75998999999999,557
2002-03-27 14:30:00,114.03299999999999,115.00998999999999,113.75998999999999,114.57001000000001,105.44501568181818,117.88130642857142,114.58779995000036,113.81909849999997,113.11859920000006,115.569,114.00478110998024,114.84102385942208,115.77846076923073,118.13261032341819,113.42431121504326,114.58779995000036,113.81909849999997,113.11859920000006,115.569,114.44666333333332,19020496,19638953.5,50.03921446437157,1.5,2.75,1.654897211114773,0.9685086326010192,-0.356101757366022,0.4796831906679842,0.8357849480340062,15.242879493984995,-1.1304711770797369,-283312026.0,2002-03-27,2002,2,86,3,1.1,114.38,115.77,114.5,558
2002-03-28 14:30:00,114.97,115.77,114.5,114.52,105.3500159090909,117.87933000000001,114.52174995000036,113.87919859999997,113.10599940000007,115.7375005,114.02498577233395,114.81045015852472,115.5692292307692,117.84890875467808,113.2895497068603,114.52174995000036,113.87919859999997,113.10599940000007,115.7375005,114.93,17535904,19327973.5,49.80568070051238,1.5,2.75,1.6274045531780033,0.9072810452684034,-0.3489409936983313,0.399608705911092,0.7485496996094233,15.250094825104036,-1.82596672318618,-300847930.0,2002-03-28,2002,3,87,3,1.11,115.14,115.10001000000001,113.5,559
2002-04-01 14:30:00,114.23,115.10001000000001,113.5,114.57001000000001,105.25501613636364,117.87735357142857,114.45365000000037,113.93239869999996,113.14099940000007,115.7790005,114.04635927145813,114.78755109580808,115.36922999999994,117.50363871968565,113.23482128031424,114.45365000000037,113.93239869999996,113.14099940000007,115.7790005,114.39000666666668,17711808,18904588.7,50.05669654974805,1.5,2.75,1.6254477993795742,0.9369052287289382,-0.32979356562940143,0.3363077425726715,0.6661013082020729,14.487846926164961,-1.7999400017142413,-283136122.0,2002-04-01,2002,0,91,4,1.41,114.3,114.95,113.77,560
2002-04-02 14:30:00,113.98,114.95,113.77,113.94,105.16001636363636,117.87537714285713,114.38835000000036,113.96499879999996,113.14639940000006,115.68850049999999,114.04218831963621,114.70683194382634,115.20769230769226,117.43062029853,112.98476431685451,114.38835000000036,113.96499879999996,113.14639940000006,115.68850049999999,114.21999999999998,15594500,18325073.7,46.876341846333396,1.5,2.75,1.5936300994238908,0.8509924846850685,-0.3467824898559001,0.23262319588219785,0.5794056857380979,14.571802677392274,-2.9885057471264416,-298730622.0,2002-04-02,2002,1,92,4,1.04,114.36,114.21700000000001,112.16,561
2002-04-03 14:30:00,114.01100000000001,114.21700000000001,112.16,113.14,105.06501659090908,117.87340071428572,114.32354995000036,113.97239889999996,113.14619960000007,115.5765005,114.00680838553284,114.55760985393812,114.99692307692304,117.43416142101944,112.55968473282664,114.32354995000036,113.97239889999996,113.14619960000007,115.5765005,113.17233333333333,25660704,18471458.5,43.129105765777375,1.5,2.75,1.6267279494650415,1.389208329163612,-0.3955883693739815,0.08492022402062105,0.4805085933946026,13.553477592026146,-1.8222924486035688,-324391326.0,2002-04-03,2002,2,93,4,1.83,113.19,113.39998999999999,112.23,562
2002-04-04 14:30:00,112.60001000000001,113.39998999999999,112.23,112.67,104.97001681818182,117.87142428571428,114.25749995000037,113.97659889999996,113.15219960000007,115.37250049999999,113.95438452727664,114.3778374868964,114.69077,117.21869888735523,112.16284111264473,114.25749995000037,113.97659889999996,113.15219960000007,115.37250049999999,112.76666333333334,23561008,18642318.5,41.05279376481815,1.5,2.75,1.5941038102175389,1.2638453741684543,-0.439816560246788,-0.06926210691388235,0.3705544533329056,9.527230655689731,-2.2725216647169466,-347952334.0,2002-04-04,2002,3,94,4,1.04,112.81,113.63,112.17998999999999,563
2002-04-05 14:30:00,113.19,113.63,112.17998999999999,112.69,104.87501704545454,117.86944785714287,114.19694995000036,113.97749879999996,113.14139960000007,115.18200049999999,113.90480082032465,114.21709105957295,114.38461615384615,116.84264014983307,111.9265921578592,114.19694995000036,113.97749879999996,113.14139960000007,115.18200049999999,112.83333000000002,19404896,18645972.9,41.18255504943063,1.5,2.75,1.5838113952019996,1.0407017163475552,-0.44658394353494224,-0.18767547608577215,0.2589084674491701,9.501943295601485,-2.0427592179032747,-328547438.0,2002-04-05,2002,4,95,4,1.29,112.9,113.03,111.23,564
2002-04-08 13:30:00,111.32001000000001,113.03,111.23,112.92998999999999,104.78001727272726,117.86747142857142,114.15159990000036,113.97959869999997,113.12839940000008,114.9789995,113.8665729450178,114.09451000628029,114.03692307692306,115.85849461519159,112.21535153865452,114.15159990000036,113.97959869999997,113.12839940000008,114.9789995,112.39666333333332,16471102,18473012.8,42.80942998445808,1.5,2.75,1.5992534384018566,0.8916305195219699,-0.4144597579457433,-0.2591662299830091,0.1552935279627342,9.833692426377587,-0.5985476630578257,-312076336.0,2002-04-08,2002,0,98,4,1.62,112.13,113.189,111.92998999999999,565
2002-04-09 13:30:00,113.189,113.189,111.92998999999999,112.14,104.6850175,117.865495,114.10304985000036,113.98069869999996,113.10019940000008,114.72399899999999,113.79886420207592,113.90836619615835,113.79846076923077,115.73559289220957,111.86132864625195,114.10304985000036,113.98069869999996,113.10019940000008,114.72399899999999,112.41966333333332,15122699,18448042.65,38.986667950600456,1.5,2.75,1.5749503356588659,0.8197454487129561,-0.4244293730843601,-0.3752431883927159,0.049186184691644194,7.9936951572336925,-1.8640063008663648,-327199035.0,2002-04-09,2002,1,99,4,1.12,112.56,113.53998999999999,112.09200000000001,566
2002-04-10 13:30:00,112.101,113.53998999999999,112.09200000000001,113.41,104.59001772727272,117.86351857142857,114.06379990000036,113.96929869999997,113.09119940000008,114.535999,113.78361462552392,113.86090274890516,113.65384615384615,115.39475052477398,111.91294178291834,114.06379990000036,113.96929869999997,113.09119940000008,114.535999,113.01399666666669,17204096,18450502.65,47.1562242553769,1.5,2.75,1.5658817402546616,0.932445924447484,-0.32782883364491955,-0.3605998573645053,-0.032771023719585714,10.101953675432013,-1.0124900923025142,-309994939.0,2002-04-10,2002,2,100,4,1.29,112.82,113.052,110.5,567
2002-04-11 13:30:00,112.89301,113.052,110.5,110.59,104.49501795454545,117.86154214285713,114.00779995000036,113.92859869999997,113.09739940000007,114.26349950000001,113.65837483628769,113.5493882013904,113.31153923076923,115.51590044652443,111.10717801501404,114.00779995000036,113.92859869999997,113.09739940000007,114.26349950000001,111.38066666666668,25459104,18864682.65,35.719350023811586,1.5,2.75,1.6618901873793284,1.3495643935467954,-0.429763202614587,-0.5699750269878194,-0.14021182437323246,16.953331588432473,-3.4317149842822148,-335454043.0,2002-04-11,2002,3,101,4,2.31,111.78,111.64998999999999,110.03998999999999,568
2002-04-12 13:30:00,111.02901000000001,111.64998999999999,110.03998999999999,111.42,104.40001818181815,117.85956571428572,113.95275000000035,113.89409869999996,113.08839940000007,114.04049949999998,113.57059543094307,113.3465893250675,113.1430776923077,115.555375560279,110.73077982433641,113.95275000000035,113.89409869999996,113.08839940000007,114.04049949999998,111.03666000000001,14950602,19053732.65,40.30812939478906,1.5,2.75,1.658183745423662,0.7846547589718595,-0.4168778476494077,-0.6613091339349921,-0.2444312862855844,18.05247976987948,-2.7494193288453013,-320503441.0,2002-04-12,2002,4,102,4,1.46,110.84,111.86,110.2,569
2002-04-15 13:30:00,111.62,111.86,110.2,110.57001000000001,104.3050184090909,117.85758928571428,113.88650000000034,113.85619879999994,113.03619980000009,113.7365005,113.45292541404335,113.0821531988706,112.85846307692309,115.53082823468142,110.18609791916477,113.88650000000034,113.85619879999994,113.03619980000009,113.7365005,110.87667,17402896,18862782.25,37.36630038778779,1.5,2.75,1.6583134778934,0.9226049354410588,-0.4389640738454131,-0.7931363785923509,-0.3541723047469377,18.12788277219851,-2.9576882569773577,-337906337.0,2002-04-15,2002,0,105,4,1.51,111.03,113.32001000000001,111.67,570
2002-04-16 13:30:00,111.70200000000001,113.32001000000001,111.67,113.2,104.21001863636364,117.85561285714287,113.83824995000036,113.83049879999994,113.04720000000009,113.56300049999996,113.44300677035538,113.09337670374006,112.7530776923077,115.24940521411341,110.256750170502,113.83824995000036,113.83049879999994,113.04720000000009,113.56300049999996,112.73000333333331,15097000,18739757.05,49.61865376623996,1.5,2.75,1.7362910866153,0.8056134324324125,-0.2587273314783952,-0.6775814690949318,-0.41885413761653656,23.743718232399626,0.05303164221318921,-322809337.0,2002-04-16,2002,1,106,4,1.48,112.5,113.67,112.60001000000001,571
2002-04-17 13:30:00,113.39,113.67,112.60001000000001,112.96001000000001,104.11501886363637,117.85363642857142,113.79445000000034,113.81209889999997,113.1094000000001,113.33850099999998,113.42406572053751,113.0806751129077,112.63307846153849,114.91925599020998,110.34690093286696,113.79445000000034,113.81209889999997,113.1094000000001,113.33850099999998,113.07667333333336,12920398,18490126.55,48.68279421279284,1.5,2.75,1.6886981518570643,0.6987728269496348,-0.1436925068051308,-0.5984697711229501,-0.4547772643178193,23.425295016338968,0.2573977101269151,-335729735.0,2002-04-17,2002,2,107,4,0.95,113.14,113.46001000000001,111.14998999999999,572
2002-04-18 13:30:00,112.89998999999999,113.46001000000001,111.14998999999999,112.47,104.02001909090907,117.85166000000001,113.74905000000037,113.79639899999997,113.1754000000001,113.20000049999996,113.38665137855568,113.02251557834505,112.47153923076924,114.46554037272026,110.47753808881822,113.74905000000037,113.79639899999997,113.1754000000001,113.20000049999996,112.36,25211008,18894926.55,46.74418713597614,1.5,2.75,1.7330782838672738,1.3342739350315178,-0.0911834845853206,-0.56875662004947,-0.4775731354641494,23.43704309413148,-0.19522584080219973,-360940743.0,2002-04-18,2002,3,108,4,2.08,112.3,113.24001000000001,112.56,573
2002-04-19 13:30:00,113.2,113.24001000000001,112.56,112.88,103.9250193181818,117.84968357142857,113.70605000000036,113.76839909999997,113.2590000000001,113.07950099999996,113.36678269704369,113.00894266612171,112.39000076923081,114.21682350079482,110.56317803766676,113.70605000000036,113.76839909999997,113.2590000000001,113.07950099999996,112.89333666666666,10602500,18080716.35,48.58892465836721,1.5,2.75,1.6642876921624683,0.5863982264176164,-0.022972672510643333,-0.5062889761024536,-0.4833163035918103,23.53992361634943,-0.04426636361165727,-350338243.0,2002-04-19,2002,4,109,4,0.6,112.9,112.42998999999999,110.84,574
2002-04-22 13:30:00,112.38,112.42998999999999,110.84,111.0,103.83001954545452,117.84770714285713,113.65030005000037,113.71909919999996,113.31860000000009,112.87750149999997,113.27396768931648,112.81761479315772,112.22538538461541,114.13596246779423,110.31480830143656,113.65030005000037,113.71909919999996,113.31860000000009,112.87750149999997,111.42333,13923301,18015111.5,41.49171512858854,1.5,2.75,1.6911242855794342,0.7728678781699464,-0.09458609700603482,-0.6015489248493537,-0.5069628278433189,25.39077626218668,-1.0165864098448374,-364261544.0,2002-04-22,2002,0,112,4,1.43,111.63,111.48,110.17,575
2002-04-23 13:30:00,111.09,111.48,110.17,110.52,103.73501977272728,117.84573071428572,113.58990000000036,113.66999929999994,113.32720000000009,112.72300149999994,113.16596895640212,112.5987943366665,112.06000076923078,114.15163765497104,109.96836388349054,113.58990000000036,113.66999929999994,113.32720000000009,112.72300149999994,110.72333333333334,16968608,17988561.9,39.889655428939,1.5,2.75,1.6639011223237603,0.9432998643432414,-0.16052423989770406,-0.7076181277154491,-0.5470938878177449,25.23244468204549,-2.5482761661229176,-381230152.0,2002-04-23,2002,1,113,4,1.19,110.82,111.81,109.39998999999999,576
2002-04-24 13:30:00,110.56,111.81,109.39998999999999,109.41,103.64002,117.84375428571428,113.51630000000036,113.63069929999996,113.28660000000009,112.48000149999993,113.01867605615105,112.29509963793636,111.80769307692309,114.2894174536223,109.32596870022384,113.51630000000036,113.63069929999996,113.28660000000009,112.48000149999993,110.20666333333334,18903296,17936296.3,36.39043736020864,1.5,2.75,1.7171946135863492,1.0539130087854314,-0.2592879008123248,-0.8712037638331509,-0.6119158630208261,24.25377832212451,-1.067004249932188,-400133448.0,2002-04-24,2002,2,114,4,2.2,110.6,109.741,108.72,577
2002-04-25 13:30:00,109.21001000000001,109.741,108.72,109.47,103.54502022727272,117.84177785714287,113.44314995000038,113.57669929999993,113.25420000000014,112.22500099999992,112.87951228924317,112.02604252956148,111.54154,114.21913812977958,108.86394187022042,113.44314995000038,113.57669929999993,113.25420000000014,112.22500099999992,109.31033333333336,25455504,18258046.7,36.71360956753676,1.5,2.75,1.6674664269016102,1.3942074099306585,-0.2981909699422545,-0.9846545754486442,-0.6864636055063897,20.00535315547076,-1.7501346257404442,-374677944.0,2002-04-25,2002,3,115,4,0.94,109.23,110.00998999999999,107.28998999999999,578
2002-04-26 13:30:00,109.78998999999999,110.00998999999999,107.28998999999999,107.39,103.45002045454544,117.83980142857142,113.37170000000036,113.51009929999992,113.15660000000014,111.86850099999992,112.66423729750815,111.58451466960324,111.1761553846154,114.61540983185768,107.73690093737312,113.37170000000036,113.51009929999992,113.15660000000014,111.86850099999992,108.22999333333333,19769904,18369746.7,30.86022054821743,1.5,2.75,1.7426473964086375,1.0762208278027046,-0.43342537969730294,-1.2282453301280185,-0.7948199504307155,21.64197249968142,-2.8760149338866805,-394447848.0,2002-04-26,2002,4,116,4,2.54,108.65,108.25998999999999,106.63,579
2002-04-29 13:30:00,107.931,108.25998999999999,106.63,106.86,103.35502068181816,117.837825,113.31075000000037,113.44499929999992,113.0526000000001,111.48300049999992,112.43662014858623,111.13456089154579,110.67230923076923,114.54654263296177,106.79807582857671,113.31075000000037,113.44499929999992,113.0526000000001,111.48300049999992,107.24999666666668,17725008,18370406.7,29.566679898864635,1.5,2.75,1.734600439522307,0.9648674789546168,-0.522043953253733,-1.4473748919978815,-0.9253309387441488,21.515698911417452,-5.60070671378092,-412172856.0,2002-04-29,2002,0,119,4,1.53,107.44,108.64,106.64,580
2002-04-30 13:30:00,107.02,108.64,106.64,107.86,103.2600209090909,117.83584857142857,113.25155000000036,113.37069939999995,112.99200000000008,111.17900049999994,112.25714484864169,110.82269794949379,110.46230923076921,114.61739815428952,106.30722030724891,113.25155000000036,113.37069939999995,112.99200000000008,111.17900049999994,107.71333333333332,19474496,18564406.5,35.09470489412305,1.5,2.75,1.7535575509849992,1.0490233555271482,-0.4779682223094632,-1.5227912166309778,-1.0448229943215146,15.817208670020168,-4.514880974249205,-392698360.0,2002-04-30,2002,1,120,4,1.88,107.64,109.25,106.8,581
2002-05-01 13:30:00,107.97,109.25,106.8,109.17998999999999,103.16502113636363,117.83387214285713,113.20615000000038,113.28849939999996,113.00040000000007,110.98099999999997,112.13647210947927,110.66624957335155,110.29000076923077,114.45770374111125,106.12229779735031,113.20615000000038,113.28849939999996,113.00040000000007,110.98099999999997,108.4099966666667,24580496,18510396.1,41.6093460819688,1.5,2.75,1.8033034402003565,1.3279292278353785,-0.3315223941611345,-1.4592259870229327,-1.1277035928617982,18.587328753495942,-2.9252333955721483,-368117864.0,2002-05-01,2002,2,121,5,2.29,108.02,109.91,107.78,582
2002-05-02 13:30:00,109.10001000000001,109.91,107.78,108.75998999999999,103.07002136363636,117.83189571428572,113.15804995000036,113.20269929999996,112.96379980000007,110.78549949999994,112.00406104636244,110.48470104255615,110.15076846153845,114.39203807275769,105.90949885031924,113.15804995000036,113.20269929999996,112.96379980000007,110.78549949999994,108.81666333333334,15667301,18115710.75,40.22584691790612,1.5,2.75,1.8266389087574733,0.8648460563436631,-0.2388763948951642,-1.4262990864807534,-1.1874226915855892,18.58033816112613,-3.6499025513819934,-383785165.0,2002-05-02,2002,3,122,5,1.98,108.84,108.75998999999999,107.2,583
2002-05-03 13:30:00,108.60001000000001,108.75998999999999,107.2,107.58,102.97502159090908,117.82991928571428,113.0899999500004,113.11289929999997,112.94939980000008,110.52999949999996,111.830568456309,110.208062848027,109.71846076923076,113.76981055383345,105.66711098462808,113.0899999500004,113.11289929999997,112.94939980000008,110.52999949999996,107.84666333333332,18186000,18054765.95,36.54898707387397,1.5,2.75,1.80759255813194,1.0072686652578844,-0.2327640811696534,-1.478377793047656,-1.2456137118780026,18.45224349584143,-3.0810810810810825,-401971165.0,2002-05-03,2002,4,123,5,1.46,107.98,107.99799999999999,105.31,584
2002-05-06 13:30:00,107.647,107.99799999999999,105.31,105.47,102.88002181818182,117.82794285714287,113.00614990000038,113.02379929999996,112.86599980000008,110.15699999999993,111.58113439919886,109.75681876726252,109.14230615384615,113.31437583621599,104.97023647147628,113.00614990000038,113.02379929999996,112.86599980000008,110.15699999999993,106.25933333333334,23636000,18413010.85,31.078556294530053,1.5,2.75,1.8704788039796585,1.283657528502461,-0.34003037179317475,-1.670651676619471,-1.3306213048262965,19.23100941650216,-4.569308722403184,-425607165.0,2002-05-06,2002,0,126,5,2.55,106.65,106.32201,104.89998999999999,585
2002-05-07 13:30:00,106.10898999999999,106.32201,104.89998999999999,105.10001000000001,104.89998999999999,117.82596642857142,112.92809990000038,112.93329949999996,112.73900000000008,109.80500049999992,111.3269726580538,109.31331317038038,108.57538384615385,112.78739735279844,104.36337033950926,112.92809990000038,112.93329949999996,112.73900000000008,109.80500049999992,105.44067,21921200,18752935.9,30.22428764288516,1.5,2.75,1.838446032266826,1.1689476312879628,-0.40091872769271375,-1.8317697144421885,-1.4308509867494748,19.248817859360628,-3.939301709167352,-447528365.0,2002-05-07,2002,1,127,5,1.36,105.61,109.36,106.78998999999999,586
2002-05-08 13:30:00,107.05299,109.36,106.78998999999999,109.00998999999999,104.84489528301887,117.82399,112.86394985000037,112.88059939999997,112.69479980000006,109.58499999999997,111.23611059303208,109.28442524939176,108.2776907692308,111.7045316502727,104.85084988818888,112.86394985000037,112.88059939999997,112.69479980000006,109.58499999999997,108.38666,27918496,19288655.9,46.8507544836462,1.5,2.75,2.011413458533481,1.4474049485221,-0.15549496288003994,-1.6252196903495246,-1.469724727469485,30.201348886133836,-0.4202155841783109,-419609869.0,2002-05-08,2002,2,128,5,2.41,108.07,109.10001000000001,107.58,587
2002-05-09 13:30:00,108.64998999999999,109.10001000000001,107.58,107.75,104.78980056603773,117.82201357142857,112.79764990000038,112.83749939999996,112.61680000000004,109.44299999999994,111.09940037369749,109.13828951135444,108.0276907692308,111.07705463116051,104.97832690730108,112.79764990000038,112.83749939999996,112.61680000000004,109.44299999999994,108.14333666666666,18087008,18920051.1,43.27239574404285,1.5,2.75,1.976313211495376,0.9559703567608228,-0.060527217285492714,-1.5453837490763505,-1.4848565317908575,30.865517947366566,0.3352267436446591,-437696877.0,2002-05-09,2002,3,129,5,1.41,108.34,108.05,105.60001000000001,588
2002-05-10 13:30:00,107.97,108.05,105.60001000000001,105.72,104.73470584905658,117.82003714285713,112.71589985000038,112.76339939999997,112.50820020000006,109.15799999999993,110.88844349629757,108.81273812932069,107.65846000000002,110.57061165339748,104.74630834660256,112.71589985000038,112.76339939999997,112.50820020000006,109.15799999999993,106.45667,18959504,19120496.2,38.208951504943045,1.5,2.75,2.0101472678171346,0.9915801243693666,-0.11384304141489256,-1.627160333559473,-1.5133172921445808,30.831544349457715,-1.0668163952835492,-456656381.0,2002-05-10,2002,4,130,5,2.32,106.83,107.95,105.79899999999999,589
2002-05-13 13:30:00,106.22,107.95,105.79899999999999,107.87,104.67961113207548,117.81806071428569,112.64854985000038,112.69909939999998,112.39080000000006,109.02299949999993,110.77007316310943,108.72295354557586,107.53999846153849,110.27756979400415,104.8024271290728,112.64854985000038,112.69909939999998,112.39080000000006,109.02299949999993,107.20633333333336,14686898,18984696.3,45.48474323335988,1.5,2.75,2.0258510344016254,0.7736177481016644,0.009712075361269612,-1.5011771979429938,-1.5108892733042634,33.09576337113833,0.00927127758205555,-441969483.0,2002-05-13,2002,0,133,5,2.03,106.87,110.37,109.0,590
2002-05-14 13:30:00,109.62,110.37,109.0,110.22,104.62451641509436,117.81608428571428,112.60489985000038,112.65149939999998,112.28020000000005,108.87399949999993,110.74850166651692,108.86552939837816,107.59769076923081,110.52084489701213,104.67453664144945,112.60489985000038,112.65149939999998,112.28020000000005,108.87399949999993,109.86333333333334,34212304,19940461.5,52.12087478751932,1.5,2.75,2.0597188176586516,1.7157227780309898,0.2503909049301498,-1.1979006421415759,-1.4482915470717257,34.918826072246084,0.9525646595131536,-407757179.0,2002-05-14,2002,1,134,5,1.26,109.68,110.91,109.28998999999999,591
2002-05-15 13:30:00,109.5,110.91,109.28998999999999,109.78998999999999,104.56942169811322,117.81410785714287,112.5648498000004,112.59149939999998,112.16839980000006,108.71549849999994,110.71091297371231,108.9535732651993,107.7823053846154,110.92460561552448,104.64000515370633,112.5648498000004,112.59149939999998,112.16839980000006,108.71549849999994,109.99666,29537808,20771332.0,50.89989304180344,1.5,2.75,2.0283110449687483,1.4220468865453595,0.3738793915542886,-0.9809423076288653,-1.354821699183154,34.45089414370435,0.9470394397792802,-437294987.0,2002-05-15,2002,2,135,5,1.48,110.1,110.48,109.33,592
2002-05-16 13:30:00,109.7,110.48,109.33,110.36,104.51432698113207,117.81213142857142,112.5211497500004,112.54859949999998,112.04059980000004,108.60999849999996,110.69715168062555,109.08751866851364,108.05153615384614,111.42301013071048,104.68006217698186,112.5211497500004,112.54859949999998,112.04059980000004,108.60999849999996,110.05666666666669,28095008,20915532.0,52.48874197856111,1.5,2.75,1.9655745417566948,1.3432605013346062,0.4804085644605425,-0.7543109936074757,-1.234719558068018,34.41769615161196,2.5841234430191498,-409199979.0,2002-05-16,2002,3,136,5,1.05,109.9,111.25,110.10001000000001,593
2002-05-17 13:30:00,110.66,111.25,110.10001000000001,110.89998999999999,104.45923226415094,111.25,112.47389965000042,112.50809939999998,111.92859960000006,108.51099799999994,110.70510612452259,109.26013498579806,108.28538153846156,111.97771601405078,104.59304706287232,112.47389965000042,112.50809939999998,111.92859960000006,108.51099799999994,110.75,27823696,21776591.8,54.007115911135685,1.5,2.75,1.907318503059788,1.2776882744342022,0.567712778247218,-0.5250785852589956,-1.0927913635062136,33.52468586921261,5.148373945197691,-381376283.0,2002-05-17,2002,4,137,5,1.04,110.68,110.69,109.492,594
2002-05-20 13:30:00,110.64,110.69,109.492,109.7,104.4041375471698,111.11414285714285,112.41834965000042,112.45779939999998,111.78279940000004,108.44599799999996,110.66569019807072,109.30202689191252,108.32538230769234,112.06656087152693,104.58420374385773,112.41834965000042,112.45779939999998,111.78279940000004,108.44599799999996,109.96066666666668,13833801,21772116.8,50.170016540343454,1.5,2.75,1.8716521814126603,0.6353907214019723,0.5260551380094327,-0.4352224409944228,-0.9612775790038556,31.641314865185205,4.3767740840367235,-395210084.0,2002-05-20,2002,0,140,5,1.09,110.09,110.48700000000001,108.32001000000001,595
2002-05-21 13:30:00,110.11,110.48700000000001,108.32001000000001,108.7,104.3490428301887,110.97828571428572,112.35759960000044,112.3911994,111.61199920000004,108.35499799999994,110.5886043079503,109.24469099744469,108.32076769230773,112.05993802971477,104.58159735490071,112.35759960000044,112.3911994,111.61199920000004,108.35499799999994,109.16900333333332,16877296,21767551.2,47.162839078441145,1.5,2.75,1.8927477398831845,0.7753419686455131,0.4173143769300112,-0.4396346078413416,-0.8569489847713527,32.28485491618988,-0.2843684326546577,-412087380.0,2002-05-21,2002,1,141,5,2.0,109.4,109.12,108.0,596
2002-05-22 13:30:00,108.22,109.12,108.0,108.94,104.29394811320756,110.84242857142857,112.29554955000044,112.3199994,111.44739920000002,108.33149799999994,110.52395315861895,109.21567280721183,108.42538307692313,112.15187732934405,104.69888882450218,112.29554955000044,112.3199994,111.44739920000002,108.33149799999994,108.68666666666668,15844301,21614601.45,47.96891074593522,1.5,2.75,1.837551472748672,0.7330369258323752,0.35041034495931395,-0.4189360535722102,-0.7693463985315242,24.46383417935528,1.1044083526682114,-396243079.0,2002-05-22,2002,2,142,5,1.04,108.56,110.36,108.48,597
2002-05-23 13:30:00,109.26100000000001,110.36,108.48,110.10001000000001,104.23885339622643,110.70657142857141,112.23549960000042,112.26099950000001,111.32859960000002,108.36299849999996,110.5073279367123,109.29989539700121,108.78153769230772,112.1807708575377,105.38230452707776,112.23549960000042,112.26099950000001,111.32859960000002,108.36299849999996,109.64667,13880199,21035836.2,51.796684564524405,1.5,2.75,1.8405835104094803,0.6598358566796598,0.37115021702339795,-0.3054086272522767,-0.6765588442756747,23.939901696823732,4.14302875520242,-382362880.0,2002-05-23,2002,3,143,5,1.73,109.42,110.2,108.61,598
2002-05-24 13:30:00,109.98,110.2,108.61,108.69,104.18375867924529,110.57071428571429,112.16589960000042,112.2048995,111.1847996,108.42799849999996,110.43606017448829,109.24181012109631,109.0576907692308,111.71888778607484,106.39649375238676,112.16589960000042,112.2048995,111.1847996,108.42799849999996,109.16666666666669,11875898,20641135.9,47.246795089827486,1.5,2.75,1.822684688237375,0.5753509912213698,0.2808777730420726,-0.325461627973084,-0.6063394010151566,22.151607915631782,0.7601742838601957,-394238778.0,2002-05-24,2002,4,144,5,1.46,109.4,109.13,107.45,599
2002-05-28 13:30:00,109.05,109.13,107.45,108.10001000000001,104.12866396226416,110.43485714285713,112.0966996500004,112.1305996,111.0138,108.48999899999995,110.34445036372404,109.13306725242049,108.98769230769236,111.69765006894623,106.27773454643848,112.0966996500004,112.1305996,111.0138,108.48999899999995,108.22667,24237104,20966740.7,45.44784417562229,1.5,2.75,1.812492924791848,1.1559786209403544,0.17744877413433158,-0.3845284333472421,-0.5619772074815736,19.52985576157397,-1.923416802758121,-418475882.0,2002-05-28,2002,1,148,5,1.56,108.29,108.02,107.13,600
2002-05-29 13:30:00,107.62899999999999,108.02,107.13,107.3,104.07356924528301,110.29899999999999,112.0316996500004,112.0351996,110.8264,108.46199899999996,110.22506015338192,108.95848941885662,108.95307692307695,111.73590487730135,106.17024896885259,112.0316996500004,112.0351996,110.8264,108.46199899999996,107.48333333333332,14779102,20731971.0,43.05399980691884,1.5,2.75,1.7523155730210018,0.7128652649572006,0.0573879931091581,-0.4902422160951261,-0.5476302092042842,14.34837911768257,-2.2679572154073484,-433254984.0,2002-05-29,2002,2,149,5,0.83,107.57,107.50998999999999,105.89998999999999,601
2002-05-30 13:30:00,106.55098999999998,107.50998999999999,105.89998999999999,107.0,104.01847452830191,110.16314285714287,111.96284965000041,111.92899959999998,110.61740000000002,108.35299949999997,110.09858720619049,108.77196661706074,109.0515384615385,111.43120355962078,106.67187336345621,111.96284965000041,111.92899959999998,110.61740000000002,108.35299949999997,106.80332666666668,18218096,20413851.0,42.15726187056641,1.5,2.75,1.7421501749480732,0.8924379824267357,-0.03502481096289911,-0.5914112229079079,-0.5563864119450089,14.327910637753464,-3.0445813700616164,-451473080.0,2002-05-30,2002,3,150,5,1.52,106.7,108.56,106.85001000000001,602
2002-05-31 13:30:00,107.39998999999999,108.56,106.85001000000001,107.22,103.96337981132076,110.02728571428571,111.90629965000042,111.83329969999998,110.45699979999999,108.27599999999997,109.9857014333987,108.62416027257878,109.0015384615385,111.50262249923594,106.50045442384106,111.90629965000042,111.83329969999998,110.45699979999999,108.27599999999997,107.54333666666666,19826304,20621801.15,43.093316983835045,1.5,2.75,1.7398530195946396,0.9614244583092588,-0.07199895300252923,-0.6463851031981704,-0.5743861501956412,13.81353830112556,-3.318296061162858,-431646776.0,2002-05-31,2002,4,151,5,1.6,107.71,107.60001000000001,104.13,603
2002-06-03 13:30:00,107.09,107.60001000000001,104.13,104.37,103.90828509433963,109.89142857142859,111.8337496500004,111.7117997,110.2386,108.11549999999997,109.76547784777523,108.2190021513808,108.55153846153848,111.9557945954364,105.14728232764057,111.8337496500004,111.7117997,110.2386,108.11549999999997,105.36667,26073904,21016196.35,35.15622110507127,1.5,2.75,1.8634356610521652,1.2406576130984803,-0.2680430978254621,-0.9094400224774688,-0.6413969246520067,18.520768240886053,-4.85870556061987,-457720680.0,2002-06-03,2002,0,154,6,3.33,105.87,105.2,103.55,604
2002-06-04 13:30:00,104.14999,105.2,103.55,104.63,103.85319037735849,109.75557142857143,111.76044970000041,111.60239959999998,110.0304002,108.07349999999997,109.56408655962721,107.87719242267788,108.15461615384615,112.05572865732452,104.25350365036779,111.76044970000041,111.60239959999998,110.0304002,108.07349999999997,104.46,25859808,21127386.75,36.308731294957035,1.5,2.75,1.8481902566912969,1.223994633411063,-0.3544284217632652,-1.0844324518560882,-0.7300040300928231,18.8354309695627,-3.7442502299908065,-431860872.0,2002-06-04,2002,1,155,6,1.59,104.38,105.67,104.35001,605
2002-06-05 13:30:00,104.95,105.67,104.35001,105.61,103.79809566037736,109.61971428571428,111.6918996500004,111.4976996,109.8704002,108.09899949999996,109.40902434160259,107.66126933480378,107.78923153846156,111.68544202575029,103.8930210511728,111.6918996500004,111.4976996,109.8704002,108.09899949999996,105.21000333333336,19718304,21017241.95,40.59460856626588,1.5,2.75,1.8104616669276328,0.9381965553287072,-0.3207967277734429,-1.1309999398096269,-0.8102032120361837,20.18064517164928,-3.0567284743895717,-412142568.0,2002-06-05,2002,2,156,6,1.26,105.01,105.60001000000001,103.14999,606
2002-06-06 13:30:00,105.54299999999999,105.60001000000001,103.14999,103.46001,103.74300094339623,109.48385714285715,111.6128497000004,111.3828997,109.6542004,107.82150049999996,109.17572966153976,107.26114939815581,107.21692538461541,111.29854938676729,103.13530138246351,111.6128497000004,111.3828997,109.6542004,107.82150049999996,104.07000333333336,23364704,20789552.35,35.02601404520284,1.5,2.75,1.856857976432802,1.1238675853450977,-0.41272120997484907,-1.3261047245047453,-0.913383514529896,22.204033482541924,-6.0308804694931455,-435507272.0,2002-06-06,2002,3,157,6,2.38,104.38,103.92,101.72,607
2002-06-07 13:30:00,101.789,103.92,101.72,103.34,103.6879062264151,109.348,111.5383496500004,111.2740997,109.42960019999998,107.60100049999996,108.94687751794996,106.88770659833143,106.72769461538464,111.02070361244087,102.4346856183284,111.5383496500004,111.2740997,109.42960019999998,107.60100049999996,102.99333333333335,24011600,21085781.95,34.73955197245337,1.5,2.75,1.8813681209733168,1.1387578633288484,-0.4480337814115398,-1.4734257412943208,-1.025391959882781,20.080866343837712,-4.922255957309775,-459518872.0,2002-06-07,2002,4,158,6,2.16,102.82,104.46001,103.02,608
2002-06-10 13:30:00,103.243,104.46001,103.02,103.74001,103.63281150943395,109.21214285714285,111.4637997500004,111.1599999,109.2140004,107.50200099999998,108.74268663489308,106.58792596991891,106.34615692307692,110.75038943286847,101.94192441328536,111.4637997500004,111.1599999,109.2140004,107.50200099999998,103.74000666666666,18760192,21075816.35,36.600775169252586,1.5,2.75,1.849842540903794,0.8901288419131627,-0.4118043394356854,-1.5401473841773878,-1.1283430447417024,20.37884523037134,-4.0333021245788965,-440758680.0,2002-06-10,2002,0,161,6,1.4,103.74,104.53999,101.73,609
2002-06-11 13:30:00,104.131,104.53999,101.73,101.96001,103.57771679245285,109.07628571428572,111.3898498000004,111.05139990000002,108.96180039999996,107.20650149999996,108.47669931587768,106.14717206802187,105.80923461538464,110.5095998576783,101.10886937309095,111.3898498000004,111.05139990000002,108.96180039999996,107.20650149999996,102.74333333333334,19990800,21341011.45,32.199920364376766,1.5,2.75,1.9184245022678088,0.9367316093164836,-0.4708175165767745,-1.7168649404626706,-1.246047423885896,21.64041962136561,-4.976691519105311,-460749480.0,2002-06-11,2002,1,162,6,2.76,103.13,102.81,100.78,610
2002-06-12 13:30:00,101.71001,102.81,100.78,102.58,103.5226220754717,108.94042857142857,111.3135998000004,110.94049990000002,108.73460039999998,106.82450149999997,108.24545620545109,105.80744139487692,105.2307723076923,109.50847187088684,100.95307274449776,111.3135998000004,110.94049990000002,108.73460039999998,106.82450149999997,102.05666666666666,31268304,21193811.45,35.12587530598884,1.5,2.75,1.9263941806772509,1.4753506736514823,-0.4321985106211983,-1.786295562162394,-1.3540970515411956,22.639060159334797,-4.130841121495329,-429481176.0,2002-06-12,2002,2,163,6,2.01,101.8,103.0,101.34,611
2002-06-13 13:30:00,102.13,103.0,101.34,101.55,103.46752735849056,108.80457142857144,111.2422497500004,110.8245,108.50280039999998,106.41250199999998,107.98288929543341,105.40197078584104,104.68154153846152,108.87425095834658,100.48883211857643,111.2422497500004,110.8245,108.50280039999998,106.41250199999998,101.96333333333332,21050896,20769465.85,32.608190533069354,1.5,2.75,1.9073660249145896,1.0135501871850017,-0.4387234551494259,-1.902501370477978,-1.4637779153285522,22.82435771504653,-5.288192501398995,-450532072.0,2002-06-13,2002,3,164,6,1.64,102.17,101.56,98.5,612
2002-06-14 13:30:00,100.31,101.56,98.5,101.39999,103.41243264150944,108.66871428571429,111.1641497000004,110.7147999,108.27740019999996,105.96450149999997,107.724736381887,105.02082975861806,104.16615538461537,108.19530670763004,100.13700406160069,111.1641497000004,110.7147999,108.27740019999996,105.96450149999997,100.48666333333334,39267504,21328090.65,32.24568596153564,1.5,2.75,1.9896970231349764,1.84111670586884,-0.4160428594013159,-1.9838314895801967,-1.5677886301788813,22.50052625106306,-2.84565488167098,-489799576.0,2002-06-14,2002,4,165,6,3.11,100.03,104.34,101.85001,613
2002-06-17 13:30:00,101.92101,104.34,101.85001,104.12,103.35733792452831,108.53285714285713,111.1017496500004,110.6236999,108.10600019999998,105.62550199999997,107.5833741708326,104.93503644827351,103.92153999999998,107.52341846590666,100.3196615340933,111.1017496500004,110.6236999,108.10600019999998,105.62550199999997,103.43666999999999,17648496,20819330.65,44.33047964470022,1.5,2.75,2.057576521482478,0.8476975699504538,-0.1921395337769813,-1.807963047400108,-1.6158235136231265,24.710318831570483,-0.4874319028959103,-472151080.0,2002-06-17,2002,0,168,6,2.44,103.1,105.03,103.631,614
2002-06-18 13:30:00,103.74001,105.03,103.631,104.97,103.30224320754719,108.397,111.0314996500004,110.5375999,107.9468004,105.38900199999996,107.48088890923134,104.93836631034269,103.76538615384615,106.97447553642724,100.55629677126505,111.0314996500004,110.5375999,107.9468004,105.38900199999996,104.54366666666664,21775104,21216395.8,47.4828452819499,1.5,2.75,2.010535341376587,1.0263337941687531,0.027247173637396926,-1.5817645465763803,-1.6090117202137773,25.14546791146017,-0.6060032193921036,-450375976.0,2002-06-18,2002,1,169,6,1.35,104.33,104.42999,102.24001,615
2002-06-19 13:30:00,103.5,104.42999,102.24001,102.52,103.24714849056605,108.26114285714287,110.9525496500004,110.42729990000002,107.7544004,105.08000199999996,107.28634424612423,104.70804570935766,103.40384769230766,105.9691023199138,100.83859306470151,110.9525496500004,110.42729990000002,107.7544004,105.08000199999996,103.06333333333332,21541392,21449600.6,40.38438132716927,1.5,2.75,2.061924959849688,1.0042793990299288,0.02164194611864767,-1.5819592875654678,-1.6036012336841154,27.791141906224727,-0.9085732738668796,-471917368.0,2002-06-19,2002,2,170,6,2.14,103.34,103.05,100.96001,616
2002-06-20 13:30:00,102.265,103.05,100.96001,101.21001,103.19205377358492,108.12528571428572,110.87569970000038,110.30080000000002,107.51040060000001,104.69350249999997,107.04805662862915,104.37489945132359,103.16077153846152,105.90628996015793,100.41525311676511,110.87569970000038,110.30080000000002,107.51040060000001,104.69350249999997,101.74000666666666,25692000,21941985.55,37.183534477525114,1.5,2.75,2.0639296055747103,1.1709058845861833,-0.051986583553492505,-1.6685844631259812,-1.616597879572489,26.321932316285118,-2.0611476678924,-497609368.0,2002-06-20,2002,3,171,6,2.07,102.01,100.92999,98.68700000000001,617
2002-06-21 13:30:00,100.47,100.92999,98.68700000000001,99.28,103.1369590566038,107.98942857142859,110.79439975000038,110.19080000000002,107.2842006,104.15250199999996,106.74342695691824,103.88967093214993,102.74923307692309,106.04015797637086,99.45830817747527,110.79439975000038,110.19080000000002,107.2842006,104.15250199999996,99.63232999999998,31190704,22807510.8,33.029843024607246,1.5,2.75,2.0967210623193737,1.36756282934655,-0.20384081197473125,-1.8713988945409028,-1.6675580825661716,28.047606835392127,-4.2992187874283,-528800072.0,2002-06-21,2002,4,172,6,2.27,99.81,100.69,97.25,618
2002-06-24 13:30:00,98.61,100.69,97.25,99.8,103.08186433962265,107.85357142857143,110.72679970000036,110.0701,107.0518006,103.70800199999996,106.47113570370573,103.50017846242136,102.30230999999999,105.49439020102469,99.11022979897535,110.72679970000036,110.0701,107.0518006,103.70800199999996,99.24666666666668,37173296,24072380.7,35.13236289945557,1.5,2.75,2.1926695578679896,1.544230147539998,-0.2399464343340603,-1.9674911254837468,-1.7275446911496866,28.19743245679711,-2.1184874344363047,-491626776.0,2002-06-24,2002,0,175,6,3.54,98.97,100.89,97.53999,619
2002-06-25 13:30:00,100.30299000000001,100.89,97.53999,97.56,103.02676962264151,107.71771428571431,110.64384975000036,109.9139001,106.7916004,103.18100149999997,106.12167940159964,102.934447180286,101.84846307692308,105.83254700765931,97.8643791461868,110.64384975000036,109.9139001,106.7916004,103.18100149999997,98.66333000000002,33389200,24529985.5,30.666078321617373,1.5,2.75,2.2753367323059903,1.3611585705992366,-0.3772002221278643,-2.199044968809517,-1.8218447466816523,29.283921482396412,-4.8937414700721344,-525015976.0,2002-06-25,2002,1,176,6,3.43,99.21,98.14999,95.19501,620
2002-06-26 13:30:00,95.2,98.14999,95.19501,97.72,102.97167490566038,107.58185714285715,110.5653497500004,109.7646002,106.48200039999999,102.70200149999994,105.79220177800751,102.4378331631159,101.41615538461541,105.85295815747492,96.97935261175587,110.5653497500004,109.7646002,106.48200039999999,102.70200149999994,97.02166666666666,37918496,25686955.2,31.337530516905797,1.5,2.75,2.32388267999842,1.4761771375690336,-0.4166345413247394,-2.3426379233375765,-1.9260033820128373,28.812399840235372,-3.771541112752337,-487097480.0,2002-06-26,2002,2,177,6,3.1,96.67,99.49001,96.57001,621
2002-06-27 13:30:00,98.5,99.49001,96.57001,99.42999,102.91658018867923,107.446,110.4939997000004,109.6604,106.2114,102.32350099999994,105.54270327690917,102.15137190948582,101.0846153846154,105.4202484189672,96.74898235026359,110.4939997000004,109.6604,106.2114,102.32350099999994,98.49667,31728800,26362490.4,38.22329756991949,1.5,2.75,2.3664624885699617,1.2035585226803915,-0.2928239653717466,-2.2920333387275207,-1.9992093733557743,31.185971427915767,-1.942800980552364,-455368680.0,2002-06-27,2002,3,178,6,3.02,98.03,100.5,98.88,622
2002-06-28 13:30:00,99.243,100.5,98.88,98.96001,102.86148547169813,107.31014285714286,110.43494975000038,109.5583001,105.94120019999998,101.91050149999992,105.28455844252058,101.84743268001098,100.85384615384615,105.29657208397354,96.41112022371878,110.43494975000038,109.5583001,105.94120019999998,101.91050149999992,99.44667,28184304,26780390.4,37.121433218710926,1.5,2.75,2.3131437393863936,1.0524231939501525,-0.2116381942400105,-2.2637571161557872,-2.0521189219157767,31.217826011562128,-4.955810603150217,-483552984.0,2002-06-28,2002,4,179,6,1.64,99.69,99.8,96.89,623
2002-07-01 13:30:00,99.18700000000001,99.8,96.89,97.03,102.806390754717,107.17428571428572,110.37649975000036,109.44160009999999,105.62420019999998,101.54350149999992,104.96085026830409,101.38862956762898,100.42692307692309,105.17991933754972,95.67392681629644,110.37649975000036,109.44160009999999,105.62420019999998,101.54350149999992,97.90666666666668,20282896,26490840.0,32.92405447953105,1.5,2.75,2.3557763294302227,0.7656569591602229,-0.25411805471542337,-2.3697664903100564,-2.115648435594633,26.466916973338357,-7.564065923597216,-503835880.0,2002-07-01,2002,0,182,7,3.0,98.34,97.2,94.77,624
2002-07-02 13:30:00,96.869,97.2,94.77,94.97,102.75129603773587,107.03842857142857,110.30109975000038,109.3111001,105.30360019999998,101.06050149999993,104.56905221856668,100.77733151356907,99.92076923076924,105.42899745654722,94.41254100499128,110.30109975000038,109.3111001,105.30360019999998,101.06050149999993,95.64666666666666,34218400,26908769.6,29.13708451177166,1.5,2.75,2.3610780201852077,1.2716449138573769,-0.3795987444701981,-2.59014686618238,-2.2105481217121814,25.69353536329958,-7.364416699180646,-538054280.0,2002-07-02,2002,1,183,7,2.56,95.98,95.84,93.72700999999999,625
2002-07-03 13:30:00,94.62,95.84,93.72700999999999,95.50999,102.69620132075472,106.90257142857143,110.25714970000037,109.1653,105.00339999999996,100.55550099999992,104.21379487666208,100.27567994084822,99.46769230769232,105.36958601604209,93.56579859934256,110.25714970000037,109.1653,105.00339999999996,100.55550099999992,95.02566666666668,30566896,27451199.2,31.365639334059352,1.5,2.75,2.343357447314834,1.1134994787404406,-0.3837343708471712,-2.6902160852711456,-2.306481714423975,25.515510964714604,-5.631873764265013,-507487384.0,2002-07-03,2002,2,184,7,2.25,94.78,99.53,96.66799999999999,626
2002-07-05 13:30:00,96.78,99.53,96.66799999999999,99.31,102.6411066037736,106.76671428571429,110.23344970000038,109.04399999999998,104.80139999999996,100.34800049999993,104.02148919522436,100.18371042267219,99.09769230769234,104.3543755372038,93.84100907818086,110.23344970000038,109.04399999999998,104.80139999999996,100.34800049999993,98.50266666666668,19014800,27233704.0,44.57529265562642,1.5,2.75,2.463118343935204,0.6982083671027636,-0.10267499732349794,-2.4348254610783466,-2.332150463754849,36.28045889661343,0.0302175664786474,-488472584.0,2002-07-05,2002,4,186,7,2.96,98.1,99.7,97.56,627
2002-07-08 13:30:00,98.98,99.7,97.56,98.07001,102.58601188679245,106.63085714285714,110.21404975000036,108.91380009999996,104.57340019999998,100.08450099999996,103.78809785423519,99.98240562051296,98.56692384615387,102.59437471337515,94.5394729789326,110.21404975000036,108.91380009999996,104.57340019999998,100.08450099999996,98.44333666666668,19120896,26989168.8,41.75145595168245,1.5,2.75,2.4400384622255467,0.7084655382199099,0.02099847165078961,-2.305902374191362,-2.326900845842152,35.301704361780466,-1.7334569138276559,-507593480.0,2002-07-08,2002,0,189,7,2.19,98.63,98.34,95.00999,628
2002-07-09 13:30:00,97.73,98.34,95.00999,95.60001,102.5309171698113,106.495,110.19849975000038,108.74710019999996,104.33760039999996,99.67750099999995,103.46699636975536,99.56503460903551,98.03461692307694,101.6383918538698,94.43084199228407,110.19849975000038,108.74710019999996,104.33760039999996,99.67750099999995,96.31666666666666,28623296,27482324.0,36.756385406184386,1.5,2.75,2.5036078577808647,1.0415165762546137,-0.039001887315972095,-2.375653204987117,-2.3366513176711448,37.57348944782208,-2.0090098400984058,-536216776.0,2002-07-09,2002,1,190,7,3.5,96.67,96.07001,92.03999,629
2002-07-10 13:30:00,96.0,96.07001,92.03999,92.12,102.4758224528302,106.35914285714287,110.17269975000038,108.54770019999998,104.04280039999998,99.18550049999992,103.02201611996105,98.85598369388927,97.3353853846154,101.6589142200505,93.01185654918028,110.17269975000038,108.54770019999998,104.04280039999998,99.18550049999992,93.41,50525392,29009053.6,31.109254807803534,1.5,2.75,2.6126372965108025,1.7417111463436366,-0.27534771076192,-2.680835956123545,-2.405488245361625,40.90067004687676,-5.73065902578796,-586742168.0,2002-07-10,2002,2,191,7,4.38,94.06,93.35001,90.32001,630
2002-07-11 13:30:00,91.76299999999999,93.35001,90.32001,92.87,102.42072773584907,106.22328571428572,110.13354975000036,108.36750020000001,103.7430004,98.70000049999994,102.62389784074688,98.28589000875698,96.84230846153848,101.60593499614895,92.07868192692798,110.13354975000036,108.36750020000001,103.7430004,98.70000049999994,92.18000666666669,59532896,30422283.2,33.48120129736306,1.5,2.75,2.6424489181886024,1.956884550992544,-0.3392568871007593,-2.8295593542375737,-2.490302467136815,41.49040807382425,-6.5975969624456345,-527209272.0,2002-07-11,2002,3,192,7,3.35,91.84,93.89,91.52,631
2002-07-12 13:30:00,93.33299,93.89,91.52,91.85001,102.36563301886792,106.08742857142856,110.08404980000036,108.1984004,103.3964008,98.21500099999994,102.20139243522742,97.67294905554205,96.2307707692308,101.34674376122051,91.11479777724108,110.08404980000036,108.1984004,103.3964008,98.21500099999994,92.42000333333333,39026096,31321043.2,31.873895598934308,1.5,2.75,2.6229882811751315,1.2460024320007324,-0.4039192807675702,-2.9952015680962774,-2.591282287328707,39.00259714906672,-7.184720373411442,-566235368.0,2002-07-12,2002,4,193,7,2.59,92.7,92.39999,87.89,632
2002-07-15 13:30:00,91.64301,92.39999,87.89,92.34,102.3105383018868,105.95157142857144,110.03879980000036,108.0159004,103.068001,97.76200149999997,101.8146711632577,97.1650491454904,95.82923230769232,101.27372281686468,90.38474179851995,110.03879980000036,108.0159004,103.068001,97.76200149999997,90.87666333333334,77320192,33223677.6,33.524841417744554,1.5,2.75,2.7577741182340505,2.3272616876104046,-0.3683800571810272,-3.0517573588049918,-2.683377301623964,39.722456482013015,-4.8335566319694925,-488915176.0,2002-07-15,2002,0,196,7,5.13,90.14,92.38,89.87,633
2002-07-16 13:30:00,91.12700000000001,92.38,89.87,90.56,102.25544358490566,105.81571428571431,109.98024980000037,107.8385004,102.727601,97.08400149999996,101.3733115097966,96.53599684591991,95.27846307692309,101.26779587380541,89.28913028004078,109.98024980000037,107.8385004,102.727601,97.08400149999996,90.93666666666668,53282400,35005372.8,30.621713191253704,1.5,2.75,2.740075966931617,1.52212062715127,-0.4159252719776978,-3.2032838915960866,-2.787358619618389,39.69557969159378,-4.643571654206587,-542197576.0,2002-07-16,2002,1,197,7,2.79,91.12,93.3,89.75,634
2002-07-17 13:30:00,92.46001,93.3,89.75,90.74001,102.20034886792452,105.67985714285713,109.91174985000038,107.6495005,102.43300120000002,96.37250199999997,100.95631929372614,95.98399809868944,94.61000307692308,100.53615957946465,88.6838465743815,109.91174985000038,107.6495005,102.43300120000002,96.37250199999997,91.26333666666666,48996096,36366422.4,31.269911217136002,1.5,2.75,2.797927683579359,1.3472894160740978,-0.3870225673284145,-3.2711368287789067,-2.8841142614504927,38.82189919475842,-4.994221023371486,-493201480.0,2002-07-17,2002,2,198,7,3.96,91.52,91.10001,87.75,635
2002-07-18 13:30:00,90.70299999999999,91.10001,87.75,87.8,102.14525415094342,105.544,109.82939985000036,107.41300049999998,102.087001,95.63650199999996,100.44038520377607,95.20456970833807,93.75154076923077,100.1248253743844,87.37825616407711,109.82939985000036,107.41300049999998,102.087001,95.63650199999996,88.88333666666666,32701808,36924443.2,26.856534815683517,1.5,2.75,2.837362134752261,0.8856411949903147,-0.5099492000967181,-3.5215507615713904,-3.0116015614746723,41.3347463963976,-11.589970798509722,-525903288.0,2002-07-18,2002,3,199,7,3.82,89.43,87.55299000000001,84.3,636
2002-07-19 13:30:00,86.76700000000001,87.55299000000001,84.3,84.71001,102.09015943396228,105.40814285714286,109.72504990000036,107.1479006,101.60100140000004,94.81150199999996,99.82350774480447,94.2050878313535,92.80384923076923,100.47670633749205,85.13099212404644,109.72504990000036,107.1479006,101.60100140000004,94.81150199999996,85.521,77690624,39524374.4,23.157202374277745,1.5,2.75,2.8846934108413858,1.9656382973641704,-0.7300045987591868,-3.924107309923656,-3.1941027111644686,30.938043066290287,-13.622921013263893,-603593912.0,2002-07-19,2002,4,200,7,3.86,85.93,85.91299000000001,81.45,637
2002-07-22 13:30:00,84.10699,85.91299000000001,81.45,82.2,102.03506471698114,105.27228571428572,109.59929985000036,106.8534007,101.09000140000002,93.95750199999996,99.13238979402784,93.06174613312936,91.82154153846152,101.21125330119877,82.4318297757243,109.59929985000036,106.8534007,101.09000140000002,93.95750199999996,83.18766333333333,78249376,41877308.0,20.666901530794725,1.5,2.75,2.997428881495572,1.8685388277584605,-0.9607259617587539,-4.395010163362912,-3.4342842016041577,31.86323819247948,-14.016745395737926,-681843288.0,2002-07-22,2002,0,203,7,5.48,83.68,83.24001,79.75,638
2002-07-23 13:30:00,82.55,83.24001,79.75,79.95,101.97997,105.13642857142858,109.46184985000038,106.54140079999999,100.5746014,92.96500199999996,98.38013921386988,91.81300840616464,90.62461923076923,101.65250667775723,79.59673178378122,109.46184985000038,106.54140079999999,100.5746014,92.96500199999996,80.98000333333333,74499632,43743624.8,18.723167667723104,1.5,2.75,3.0326132471030305,1.7030969047631372,-1.167254829902367,-4.8933527389821165,-3.7260979090797495,32.09046217794214,-13.211029092488062,-756342920.0,2002-07-23,2002,1,204,7,4.38,81.5,85.12,77.67999,639
2002-07-24 13:30:00,78.13699,85.12,77.67999,84.72,77.67999,105.00057142857143,109.3492998500004,106.2512007,100.1116014,92.32300199999996,97.84444747999264,91.13748379605371,89.50231153846156,99.7048858733159,79.2997372036072,109.3492998500004,106.2512007,100.1116014,92.32300199999996,82.50666333333334,106946000,47421464.8,33.090326297252545,1.5,2.75,3.3474273008813853,2.255223461591596,-0.8971333165471989,-4.847514554763748,-3.950381238216549,51.61627259662654,-8.775707978895236,-649396920.0,2002-07-24,2002,2,205,7,9.58,81.4,85.85001,81.60001,640
2002-07-25 13:30:00,84.27499,85.85001,81.60001,84.0,77.17591592592593,104.86471428571429,109.2366498500004,105.9337007,99.5872014,91.63700199999997,97.30152797097332,90.45772343452481,88.42000307692308,97.70096099168656,79.13904516215965,109.2366498500004,105.9337007,99.5872014,91.63700199999997,83.81667333333333,87194880,49885284.0,32.16605240943389,1.5,2.75,3.4118967793898576,1.7479078599612663,-0.6907310204648649,-4.81379501379763,-4.1230639933327655,50.54677250864185,-8.546553233908192,-736591800.0,2002-07-25,2002,3,206,7,5.21,83.73,85.92999,83.8,641
2002-07-26 13:30:00,84.65299999999999,85.92999,83.8,85.60001,76.67184185185185,104.72885714285715,109.1348498500004,105.63590080000002,99.1034018,90.94550299999996,96.8426449132881,89.99508405980816,87.65077230769229,96.03849480497058,79.26304981041402,109.1348498500004,105.63590080000002,99.1034018,90.94550299999996,85.11,41210496,50359368.8,36.41635581550814,1.5,2.75,3.3203320094334394,0.8183282869105382,-0.3854547107972604,-4.604882381829341,-4.219427671032081,53.169051709535246,-7.299101147931562,-695381304.0,2002-07-26,2002,4,207,7,2.54,84.86,90.34,87.3,642
2002-07-29 13:30:00,87.508,90.34,87.3,89.77,76.16776777777778,104.59299999999999,109.0420998000004,105.36610080000004,98.69160180000004,90.48600249999996,96.56528628923759,89.97364748268356,87.47000307692308,95.56069022850879,79.37931592533737,109.0420998000004,105.36610080000004,98.69160180000004,90.48600249999996,89.13666666666666,53496304,51624968.8,45.925889583660634,1.5,2.75,3.421736151616766,1.0362486456359854,0.13067947539317526,-4.056078326790612,-4.186757802183787,61.600360614085815,-0.8723498233215616,-641885000.0,2002-07-29,2002,0,210,7,3.48,88.82,91.39999,88.72,643
2002-07-30 13:30:00,89.323,91.39999,88.72,90.94,75.6636937037037,104.45714285714287,108.9467998000004,105.11050080000004,98.29240200000002,90.18150249999997,96.34468682691455,90.06568105576133,87.32154153846157,95.0741955060421,79.56888757088102,108.9467998000004,105.11050080000004,98.29240200000002,90.18150249999997,90.35333,47559008,52988774.4,48.263882421342466,1.5,2.75,3.36875428364414,0.8975298737990816,0.560168488446319,-3.4865471916258883,-4.046715680072207,61.204229558056745,0.2203989177431209,-594325992.0,2002-07-30,2002,1,211,7,3.02,90.06,91.55,89.25,644
2002-07-31 13:30:00,90.49699,91.55,89.25,91.16,75.15961962962962,104.32128571428572,108.8550998000004,104.85220070000004,97.92160200000002,89.99100249999996,96.14136577487871,90.16990190759357,87.26846384615386,94.90495426284572,79.63197342946205,108.8550998000004,104.85220070000004,97.92160200000002,89.99100249999996,90.65333333333336,44707696,53513239.2,48.71292059594197,1.5,2.75,3.2924146919552726,0.8354511270175549,0.8509319438893583,-2.983050750210509,-3.833982694099868,61.208749714028436,3.8268792710706143,-549618296.0,2002-07-31,2002,2,212,7,2.58,90.4,91.35001,88.33,645
2002-08-01 13:30:00,90.88,91.35001,88.33,88.78,74.65554555555556,104.18542857142856,108.75249980000041,104.56760060000003,97.52320200000004,89.65450299999996,95.85268476409914,90.03753029734658,86.99461769230774,94.12238192048656,79.86685346412891,108.75249980000041,104.56760060000003,97.52320200000004,89.65450299999996,89.48666999999999,66576320,55313710.4,44.23951061409677,1.5,2.75,3.2729572139584677,1.203613345019791,0.8716372346330172,-2.7444361508085953,-3.616073385441613,60.018947067256725,4.804615180661654,-616194616.0,2002-08-01,2002,3,213,8,3.42,89.84,88.91701,85.62,646
2002-08-02 13:30:00,88.5,88.91701,85.62,86.78999,74.15147148148148,104.04957142857144,108.6364997000004,104.26380050000004,97.08020180000004,89.02850249999996,95.49728496942858,89.72824074521833,86.70461692307696,93.52884841191539,79.8803854342385,108.6364997000004,104.26380050000004,97.08020180000004,89.02850249999996,87.109,51775696,56951755.2,40.860703796781614,1.5,2.75,3.2746752701042907,0.9091150188115712,0.7448915072249664,-2.684959001410405,-3.429850508635372,57.48352717920965,5.583929440389293,-667970312.0,2002-08-02,2002,4,214,8,3.85,87.27,86.93299999999999,83.55,647
2002-08-05 13:30:00,86.49799999999999,86.93299999999999,83.55,83.77,73.64739740740741,103.91371428571428,108.51709975000038,103.94110060000004,96.55360160000004,88.31350199999996,95.03739144121569,89.16078924567373,86.16846230769234,92.73043940802523,79.60648520735946,108.51709975000038,103.94110060000004,96.55360160000004,88.31350199999996,84.75099999999998,47196400,58355530.4,36.32640256555029,1.5,2.75,3.282412750811128,0.8087733874834252,0.4649418829085019,-2.8486731549997444,-3.3136150379082463,58.65469485796019,4.777986241400867,-715166712.0,2002-08-05,2002,0,217,8,4.05,85.24,87.89999,85.05,648
2002-08-06 13:30:00,85.23299999999999,87.89999,85.05,86.59,73.14332333333334,103.77785714285713,108.4129497500004,103.64820060000004,96.11160160000004,87.86300149999997,94.70612118861901,88.91595217465719,86.07538538461542,92.57619413832363,79.57457663090719,108.4129497500004,103.64820060000004,96.11160160000004,87.86300149999997,86.51333000000001,65087696,60178750.4,42.71855042690032,1.5,2.75,3.3429539828960477,1.08157274066628,0.4752772678833455,-2.7195184530540644,-3.19479572093741,57.79340895558207,2.207271010387163,-650079016.0,2002-08-06,2002,1,218,8,3.35,86.47,88.5,85.77,649
2002-08-07 13:30:00,87.87899999999999,88.5,85.77,88.10001,72.63924925925926,103.642,108.3166997500004,103.36270080000006,95.71160160000004,87.66200199999999,94.44705800475158,88.83824339611841,86.33615461538463,92.86885388479836,79.80345534597093,108.3166997500004,103.36270080000006,95.71160160000004,87.66200199999999,87.45666999999997,43696496,59837305.6,45.85310872254149,1.5,2.75,3.29917155554633,0.7302550735172141,0.5823321205112988,-2.4668805702982866,-3.0492126908095853,48.988660634674225,4.880964285714283,-606382520.0,2002-08-07,2002,2,219,8,3.18,87.14,91.10001,87.8,650
2002-08-08 13:30:00,88.42299999999999,91.10001,87.8,90.95,72.13517518518519,103.50614285714286,108.2240997500004,103.10550080000006,95.38460160000004,87.56600199999998,94.30991847515348,89.03936307267854,87.00923153846158,93.5015439230922,80.51691915383094,108.2240997500004,103.10550080000006,95.38460160000004,87.56600199999998,89.95000333333331,48373600,59279340.8,51.27288372597682,1.5,2.75,3.2992314444358777,0.8160279677064156,0.8285840098883135,-2.013482678449193,-2.8420666883375065,50.68018230983232,6.249987587618277,-558008920.0,2002-08-08,2002,3,220,8,3.76,89.45,91.94,89.35001,651
2002-08-09 13:30:00,90.10001,91.94,89.35001,91.28999,71.63110111111112,103.37028571428571,108.1359997000004,102.84390070000003,95.07040140000004,87.53800099999998,94.1914899075004,89.25370849432821,87.88153846153848,93.30479554793109,82.45828137514586,108.1359997000004,102.84390070000003,95.07040140000004,87.53800099999998,90.86,41880400,59422056.0,51.89152207394886,1.5,2.75,3.248571341261887,0.7047955392186362,0.9871021275056222,-1.6081890289554792,-2.595291156461101,50.23039047111845,1.6932048568564189,-516128520.0,2002-08-09,2002,4,221,8,2.9,90.65,91.27,89.55,652
2002-08-12 13:30:00,89.99699,91.27,89.55,90.62,71.12702703703705,103.23442857142858,108.0459997000004,102.59770060000008,94.73840140000004,87.45200099999998,94.0514314797553,89.38383149486839,88.33538461538464,93.60982911337544,83.06094011739383,108.0459997000004,102.59770060000008,94.73840140000004,87.45200099999998,90.48,25855696,56848831.2,50.53006838248663,1.5,2.75,3.1408155311717527,0.4548149091937707,1.0156162654839136,-1.3257708246062094,-2.341387090090123,43.185926585072345,-0.3518803606773622,-541984216.0,2002-08-12,2002,0,224,8,1.92,90.41,91.66,88.64999,653
2002-08-13 13:30:00,90.14999,91.66,88.64999,88.97,70.62295296296297,103.09857142857143,107.9379996500004,102.33450070000006,94.43040140000004,87.37250099999999,93.85215965701978,89.34441897154758,88.71769230769233,93.36266786182472,84.07271675355994,107.9379996500004,102.33450070000006,94.43040140000004,87.37250099999999,89.75999666666668,49637104,56666566.4,47.24274877653645,1.5,2.75,3.1314722789451985,0.8759504440346679,0.8962949257648463,-1.2210184328840654,-2.117313358648912,43.73561912408593,-2.402369460289598,-591621320.0,2002-08-13,2002,1,225,8,3.4,90.15,92.63,88.02,654
2002-08-14 13:30:00,89.02,92.63,88.02,92.22,70.1188788888889,102.96271428571428,107.8474996000004,102.10630080000006,94.18220140000004,87.44650049999998,93.78815339596018,89.61828383140019,89.22692230769233,93.84449615824488,84.60934845713982,107.8474996000004,102.10630080000006,94.18220140000004,87.44650049999998,90.95666666666666,57431904,57088356.8,53.64033869354458,1.5,2.75,3.2370814018776843,1.0060178155276664,1.0012319097403726,-0.8657734714734459,-1.8670053812138183,48.91968753115798,3.8747465645415606,-534189416.0,2002-08-14,2002,2,226,8,5.24,90.32,93.99001,92.2,655
2002-08-15 13:30:00,92.84700000000001,93.99001,92.2,93.5,69.61480481481483,102.82685714285715,107.7777496000004,101.90520080000006,93.94000140000006,87.7315005,93.77685326278528,89.98797108555256,89.51384538461542,94.66361754895307,84.36407322027777,107.7777496000004,101.90520080000006,93.94000140000006,87.7315005,93.23000333333334,45552096,57730871.2,55.908134782828704,1.5,2.75,3.1337191588864215,0.7890422412333178,1.1132258885303288,-0.4754730205509077,-1.5886989090812365,45.978056522100594,7.7313178628088295,-488637320.0,2002-08-15,2002,3,227,8,1.94,93.1,94.08,92.0,656
2002-08-16 13:30:00,92.82001,94.08,92.0,93.22,69.11073074074075,102.691,107.71304960000042,101.69470080000004,93.73520120000006,88.15700000000001,93.75501587993094,90.29578336311899,89.68923000000004,95.16623891118869,84.21222108881139,107.71304960000042,101.69470080000004,93.73520120000006,88.15700000000001,93.09999999999998,36517296,55672204.8,55.271199390851365,1.5,2.75,3.058453504680248,0.6559340721494114,1.121679322985874,-0.18659975534889384,-1.3082790783347682,42.908875637076825,11.280888146114366,-525154616.0,2002-08-16,2002,4,228,8,2.26,93.04,95.75,93.10001,657
2002-08-19 13:30:00,93.46001,95.75,93.10001,95.39999,68.60665666666667,102.55514285714287,107.66104955000044,101.50300060000004,93.57640100000006,88.81699949999998,93.81952466895322,90.78189828091719,90.0153830769231,96.25567439391656,83.77509175992965,107.66104955000044,101.50300060000004,93.57640100000006,88.81699949999998,94.75,33672304,53443351.2,59.17122846397211,1.5,2.75,3.0292775400602303,0.6300559984344694,1.2192266879088076,0.21575428155124146,-1.0034724063575662,33.88139167522782,10.174373484236053,-491482312.0,2002-08-19,2002,0,231,8,2.85,94.43,95.39999,93.62,658
2002-08-20 13:30:00,94.82200999999999,95.39999,93.62,94.39,68.1025825925926,102.41928571428572,107.59044960000044,101.30170060000003,93.38940080000006,89.53899949999997,93.84189625056291,91.12552701606792,90.4469215384616,97.05109707544642,83.8427460014768,107.59044960000044,101.30170060000003,93.38940080000006,89.53899949999997,94.46999666666666,30512096,51243974.4,56.70436921300304,1.5,2.75,2.940042715770214,0.5954279767964289,1.1611468728827898,0.44796118474592106,-0.7131856881368688,33.6826998830442,7.139601913779582,-521994408.0,2002-08-20,2002,1,232,8,1.9,94.51,95.78,93.57001,659
2002-08-21 13:30:00,95.06299999999999,95.78,93.57001,95.75,67.59850851851853,102.28342857142857,107.52294960000044,101.11350050000004,93.26520060000006,90.0904995,93.91672384858005,91.56595301453764,91.13615307692314,97.93712944610512,84.33517670774116,107.52294960000044,101.11350050000004,93.26520060000006,90.0904995,95.03333666666668,39632608,47878304.8,59.17263355942218,1.5,2.75,2.8878960932151987,0.8277780127252958,1.1571683328123366,0.7332747278785519,-0.42389360493378464,33.44522667448881,5.2776250687190736,-482361800.0,2002-08-21,2002,2,233,8,2.36,94.68,97.14999,95.07001,660
2002-08-22 13:30:00,95.493,97.14999,95.07001,96.67999,67.09443444444446,97.14999,107.45294960000042,100.94090040000003,93.14720040000006,90.724499,94.02508722706713,92.05300415601023,92.1292292307693,98.05119543433744,86.20726302720118,107.45294960000042,100.94090040000003,93.14720040000006,90.724499,96.29999666666669,38403808,45438751.2,60.817620516195745,1.5,2.75,2.830187800842685,0.8451774528521814,1.157228331093077,1.022641808932562,-0.1345865221605153,29.992407301744066,5.904261792557978,-443957992.0,2002-08-22,2002,3,234,8,2.19,96.11,96.14999,94.14999,661
2002-08-23 13:30:00,96.01700000000001,96.14999,94.14999,94.60001,66.59036037037038,96.93954208955223,107.36394970000042,100.75550050000004,93.00820060000004,91.174499,94.04763321816252,92.29557614115214,92.74538384615393,97.84327977971056,87.64748791259727,107.36394970000042,100.75550050000004,93.00820060000004,91.174499,94.96666333333332,33717504,45064101.6,55.437632245065615,1.5,2.75,2.808745815068208,0.7482120535606106,0.9650896507528136,1.0717755412805021,0.10668589052768816,34.0155580897621,4.391977488413147,-477675496.0,2002-08-23,2002,4,235,8,2.12,95.15,95.64,93.5,662
2002-08-26 13:30:00,94.91,95.64,93.5,95.25999,66.08628629629631,96.72909417910448,107.2789996500004,100.58140040000006,92.88540060000004,91.4489985,94.09517662137183,92.57790127056622,93.29615153846164,97.777326688673,88.81497638825027,107.2789996500004,100.58140040000006,92.88540060000004,91.4489985,94.79999666666669,33831104,44080841.6,56.74513661310181,1.5,2.75,2.7609782568490497,0.7674786318054326,0.8352150008998119,1.1507046416524531,0.3154896407526412,33.31941947720904,7.0697875688434335,-443844392.0,2002-08-26,2002,0,238,8,2.29,94.57,96.25,93.505,663
2002-08-27 13:30:00,95.7,96.25,93.505,94.16,65.58221222222222,96.51864626865671,107.1867996000004,100.39610040000004,92.68620060000003,91.6099985,94.09771871465138,92.72857734003608,93.54307461538471,97.82944689931654,89.25670233145289,107.1867996000004,100.39610040000004,92.68620060000003,91.6099985,94.63833333333332,35340704,43469926.4,53.90619653526975,1.5,2.75,2.759836952788404,0.8129920367198966,0.6369536851316556,1.111681747167211,0.4747280620355551,31.77824613744101,2.103665148557794,-479185096.0,2002-08-27,2002,1,239,8,2.94,94.88,93.49001,91.8,664
2002-08-28 13:30:00,93.287,93.49001,91.8,92.10001,65.07813814814816,96.30819835820895,107.0836996500004,100.18780060000003,92.42880080000003,91.65699899999998,94.01937719642977,92.66871378384218,93.60538384615394,97.78105633498748,89.4297113573204,107.0836996500004,100.18780060000003,92.42880080000003,91.65699899999998,92.46334,38973808,43183232.0,48.965596595246325,1.5,2.75,2.731277170446375,0.902521793644348,0.34350541426575565,0.9041098298677496,0.560604415601994,28.91173095203721,-1.4973155080213931,-518158904.0,2002-08-28,2002,2,240,8,1.84,92.65,93.05799999999999,90.81,665
2002-08-29 13:30:00,91.27,93.05799999999999,90.81,92.14,64.57406407407407,96.09775044776121,106.98424965000041,99.98780060000004,92.22120080000003,91.824999,93.94567612990309,92.61836009014291,93.72230692307706,97.63382413476087,89.8107897113932,106.98424965000041,99.98780060000004,92.22120080000003,91.824999,92.00266666666666,42967104,42002771.2,49.06319521421828,1.5,2.75,2.6967573725573493,1.0229587899190804,0.1390117466221279,0.7343690988796538,0.595357352257526,27.54685202942461,-1.1585496674533344,-475191800.0,2002-08-29,2002,3,241,8,2.48,91.93,93.39,91.39999,666
2002-08-30 13:30:00,91.686,93.39,91.39999,91.78,64.06999,95.88730253731345,106.8703996500004,99.77150060000004,92.03260060000004,92.0744995,93.86074765422063,92.53851627203407,93.93846076923089,96.99211609212207,90.88480544633968,106.8703996500004,99.77150060000004,92.03260060000004,92.0744995,92.18999666666666,30370896,40932531.2,48.17010768029346,1.5,2.75,2.646275417374681,0.7419745398007538,-0.0248502663313529,0.5642945193433349,0.5891447856746878,27.57044988850721,-3.7945391818175263,-505562696.0,2002-08-30,2002,4,242,8,2.18,92.39,91.0,88.14999,667
2002-09-03 13:30:00,90.735,91.0,88.14999,88.28,63.56591592592594,95.67685462686569,106.7384996500004,99.54840060000005,91.81260060000004,92.29999949999998,93.64189480503549,92.13294329374511,93.63538384615394,97.86628056818027,89.40448712412766,106.7384996500004,99.54840060000005,91.81260060000004,92.29999949999998,89.14332999999998,76682192,42406820.8,40.45919680841601,1.5,2.75,2.7165421732764896,1.8082513745053013,-0.35498605340663736,0.1454122189163911,0.5003982723230285,30.10177922955728,-6.473143341455662,-582244888.0,2002-09-03,2002,1,246,9,3.23,89.57,90.25,88.06,668
2002-09-04 13:30:00,88.61501,90.25,88.06,89.53999,63.06184185185187,95.46640671641792,106.6118496000004,99.32960050000004,91.60740040000003,92.447499,93.48103579307332,91.88599536100747,93.3307676923078,98.09357946492166,88.56795591969394,106.6118496000004,99.32960050000004,91.60740040000003,92.447499,89.28332999999998,51099504,41707411.2,43.93838113342313,1.5,2.75,2.6789320180424547,1.225190020904486,-0.4674522307437227,-0.08391701610662494,0.3835352146370978,32.49782294047309,-6.4856501305483,-531145384.0,2002-09-04,2002,2,247,9,2.49,89.16,89.42999,87.5,669
2002-09-05 13:30:00,88.49001,89.42999,87.5,88.78,62.55776777777778,95.25595880597015,106.4839496000004,99.11170040000006,91.43180040000004,92.4814985,93.29668144824691,91.59018627900677,92.98922923076931,98.3358315531036,87.64262690843503,106.4839496000004,99.11170040000006,91.43180040000004,92.4814985,88.56999666666668,67318320,42888502.4,42.33161364438385,1.5,2.75,2.6332933024679943,1.5696122791174911,-0.5654366371691184,-0.3232605818243002,0.24217605534481815,30.016645879897105,-8.171277220860286,-598463704.0,2002-09-05,2002,3,248,9,2.21,88.46,90.57001,89.34700000000001,670
2002-09-06 13:30:00,89.75,90.57001,89.34700000000001,90.0,62.05369370370371,95.0455108955224,106.3550996000004,98.87970040000006,91.27740040000002,92.4339985,93.16739982282549,91.43873996672043,92.57384538461548,97.9457284112955,87.20196235793543,106.3550996000004,98.87970040000006,91.27740040000002,92.4339985,89.97233666666666,38622896,42400967.2,45.76056093838268,1.5,2.75,2.5730587808631364,0.9108965797365112,-0.5215605649946873,-0.4097746508985409,0.11178591409614633,30.92380373711662,-4.862589337992668,-559840808.0,2002-09-06,2002,4,249,9,1.37,89.96,91.351,88.8,671
2002-09-09 13:30:00,89.10001,91.351,88.8,90.66,61.54961962962963,94.83506298507463,106.2343996000004,98.65670030000004,91.10200060000004,92.402499,93.0690704180088,91.3645742556042,92.28692230769241,97.63855260026921,86.93529201511558,106.2343996000004,98.65670030000004,91.10200060000004,92.402499,90.27033333333334,34074896,42010692.0,47.57656684820953,1.5,2.75,2.571483153658627,0.811100564589605,-0.4256182990426401,-0.4202369597071538,0.0053813393354862895,30.40006330316892,-4.828879364778441,-525765912.0,2002-09-09,2002,0,252,9,2.87,90.08,91.78,90.56,672
2002-09-10 13:30:00,91.14,91.78,90.56,91.7,61.04554555555556,94.62461507462689,106.1226996500004,98.44900030000008,90.95680040000003,92.456499,93.01538138200846,91.39651956459427,91.97538384615395,96.94203159304243,87.00873609926546,106.1226996500004,98.44900030000008,90.95680040000003,92.456499,91.34666666666668,41426704,42789242.4,50.39496236074065,1.5,2.75,2.4749486426830107,0.9681569870468192,-0.2768506211908975,-0.34068193715313555,-0.06383131596223808,31.098481924886173,-2.6125743415462974,-484339208.0,2002-09-10,2002,1,253,9,1.35,91.17,93.33,91.10001,673
2002-09-11 13:30:00,92.47,93.33,91.10001,91.13,60.541471481481494,94.41416716417909,105.9999497000004,98.23150030000005,90.83880040000004,92.564499,92.9414448572238,91.37113674891863,91.54846153846162,95.7135770039044,87.38334607301884,105.9999497000004,98.23150030000005,90.83880040000004,92.564499,91.85333666666666,27745600,41694667.2,48.84499432188387,1.5,2.75,2.4574515967770814,0.6654472109565128,-0.2048870862382572,-0.3199401737600596,-0.11505308752180238,30.756620964133788,-1.0532137835815676,-512084808.0,2002-09-11,2002,2,254,9,2.45,92.22,90.84299999999999,88.99001,674
2002-09-12 13:30:00,90.75301,90.84299999999999,88.99001,89.45,60.03739740740741,94.20371925373136,105.8675497500004,98.01600030000007,90.72840040000004,92.42599900000002,92.80452545105815,91.1881713442597,91.152306923077,95.0523266396362,87.2522872065178,105.8675497500004,98.01600030000007,90.72840040000004,92.42599900000002,89.76100333333332,43631504,41004647.2,44.500678774391574,1.5,2.75,2.4347757684358613,1.0640624168082098,-0.2552059752512708,-0.4340605565858908,-0.17885458133462007,30.02802707494316,-2.919470371174297,-555716312.0,2002-09-12,2002,3,255,9,2.08,89.92,89.89999,88.25,675
2002-09-13 13:30:00,88.698,89.89999,88.25,89.67,59.53332333333334,93.99327134328358,105.7387498000004,97.80750030000007,90.61160060000003,92.234499,92.68160288435,91.04358359718736,90.7223076923078,93.87744913591513,87.56716624870045,105.7387498000004,97.80750030000007,90.61160060000003,92.234499,89.27333,41131008,40783592.8,45.18818019959253,1.5,2.75,2.3787196421190138,1.0085185040392028,-0.2576960919976264,-0.5009746963316529,-0.24327860433402665,30.132655884501947,-2.2989758117236865,-514585304.0,2002-09-13,2002,4,256,9,1.87,89.07,89.89,88.46600000000001,676
2002-09-16 13:30:00,89.31700000000001,89.89,88.46600000000001,89.89,59.029249259259274,93.78282343283584,105.62149980000038,97.61230030000006,90.42320060000004,92.067999,92.5721282614343,90.93371849269332,90.39384615384623,92.8637236900738,87.9239686176187,105.62149980000038,97.61230030000006,90.42320060000004,92.067999,89.41533333333332,28167600,40366108.0,45.909768453549646,1.5,2.75,2.3105253819676563,0.6978032165003374,-0.2294901833297415,-0.5301413334962035,-0.30065115016646204,30.26090246131355,1.8237426370638867,-486417704.0,2002-09-16,2002,0,259,9,1.61,89.18,91.19,87.75,677
2002-09-17 13:30:00,90.89,91.19,87.75,87.83,58.525175185185184,93.57237552238806,105.4862998000004,97.39590030000005,90.21840040000002,91.6894995,92.38616244726042,90.63812625529395,90.06538384615395,92.67222299229664,87.45854470001123,105.4862998000004,97.39590030000005,90.21840040000002,91.6894995,88.92333333333332,47762096,41070597.6,40.52937141541921,1.5,2.75,2.391202140398537,1.1629267356947346,-0.3285044199088337,-0.7112816750525042,-0.3827772551436705,23.978618885111274,-1.9097500457616807,-534179800.0,2002-09-17,2002,1,260,9,3.92,89.47,88.5,86.28299999999999,678
2002-09-18 13:30:00,87.01700000000001,88.5,86.28299999999999,86.95,58.021101111111115,93.36192761194029,105.3507998000004,97.19150030000007,90.04540020000002,91.3174995,92.17297960619136,90.28687613574215,89.66615307692317,92.46259643430142,86.8697097195449,105.3507998000004,97.19150030000007,90.04540020000002,91.3174995,87.24433333333332,54829504,42286468.0,38.45601648879006,1.5,2.75,2.378759130370071,1.2966205642902122,-0.4260137176427933,-0.915294402197162,-0.4892806845543688,22.542999116580983,-2.061275061950888,-589009304.0,2002-09-18,2002,2,261,9,2.57,87.39,86.8,84.7,679
2002-09-19 13:30:00,85.995,86.8,84.7,84.7,57.51702703703704,93.15147970149256,105.20744980000042,96.96990030000008,89.89700020000002,90.76499950000002,91.87992158241914,89.7547926942429,89.12153769230778,92.70585227594201,85.53722310867356,105.20744980000042,96.96990030000008,89.89700020000002,90.76499950000002,85.39999999999998,48514000,42730537.6,33.70791297754066,1.5,2.75,2.3695620496293515,1.1353472884928084,-0.6039273783444208,-1.2441899074848948,-0.640262529140474,26.138392915259857,-5.8888888888888875,-637523304.0,2002-09-19,2002,3,262,9,2.48,85.75,85.2,84.05,680
2002-09-20 13:30:00,84.92,85.2,84.05,84.35001,57.01295296296297,92.9410317910448,105.0527499000004,96.73480040000008,89.72660040000002,90.1485005,91.58463093212822,89.24005148526739,88.81923076923088,93.20890356265356,84.4295579758082,105.0527499000004,96.73480040000008,89.72660040000002,90.1485005,84.53333666666667,46325696,43126632.0,33.024859568069175,1.5,2.75,2.2824504746558265,1.0741783870347217,-0.7002797358930575,-1.515612199006796,-0.8153324631137384,23.427322696943737,-6.960059563203176,-683849000.0,2002-09-20,2002,4,263,9,1.37,84.62,84.06599,82.69,681
2002-09-23 13:30:00,83.64999,84.06599,82.69,83.66,56.5088788888889,92.73058388059702,104.8840499500004,96.47960050000007,89.56280020000004,89.60150000000002,91.2738610916526,88.70861801048002,88.36692384615395,93.51290350425181,83.22094418805611,104.8840499500004,96.47960050000007,89.56280020000004,89.60150000000002,83.47199666666667,46904896,43786001.6,31.662618226274546,1.5,2.75,2.2379904407518394,1.071230399808874,-0.7605633018141551,-1.7660365903814323,-1.0054732885672772,21.71933932214229,-8.767720828789539,-730753896.0,2002-09-23,2002,0,266,9,1.66,83.38,83.64999,81.85001,682
2002-09-24 13:30:00,82.44,83.64999,81.85001,82.31,56.004804814814825,92.52013597014923,104.7088999500004,96.21510060000006,89.36220020000002,88.9540005,90.92233712727408,88.09922581900572,87.86923153846163,93.92942249568466,81.80904058123859,104.7088999500004,96.21510060000006,89.36220020000002,88.9540005,82.60333333333334,69554496,45572171.2,29.130821275332107,1.5,2.75,2.2074189806981366,1.526249335252212,-0.8354650261043131,-2.0498045711976687,-1.2143395450933556,18.181106779946056,-9.678481290464164,-800308392.0,2002-09-24,2002,1,267,9,2.2,82.75,84.77,82.03999,683
2002-09-25 13:30:00,83.37299999999999,84.77,82.03999,84.35001,55.50073074074075,92.3096880597015,104.54785000000038,95.98280070000006,89.23800040000002,88.46350100000002,90.66459880855743,87.74215764576708,87.43461692307703,93.6301090732144,81.23912477293965,104.54785000000038,95.98280070000006,89.23800040000002,88.46350100000002,83.72,59294496,46769860.8,37.29092458053428,1.5,2.75,2.2447469106482694,1.2677928688639588,-0.6973559443926749,-2.0860344755841997,-1.3886785311915244,27.256946028201238,-5.701498043599782,-741013896.0,2002-09-25,2002,2,268,9,3.33,83.4,85.97,84.45,684
2002-09-26 13:30:00,85.02,85.97,84.45,85.73,54.99665666666667,92.09924014925372,104.40460000000036,95.78540070000008,89.1378002,88.14500050000002,90.47108512979048,87.55052358426546,87.05538615384626,93.01373943337904,81.09703287431348,104.40460000000036,95.78540070000008,89.1378002,88.14500050000002,85.38333333333334,53670800,47504710.4,42.1439788365315,1.5,2.75,2.200121417030536,1.1297995408893178,-0.473507241677003,-1.9805625832877782,-1.507055341610775,29.410845544092737,-4.393888703022189,-687343096.0,2002-09-26,2002,3,269,9,1.8,85.21,85.63,82.75,685
2002-09-27 13:30:00,85.0,85.63,82.75,82.75,54.492582592592605,91.88879223880598,104.24760005000036,95.56190060000006,89.0368002,87.67550050000001,90.16829747764184,87.09333086195446,86.36692461538472,92.08285636517122,80.6509928655982,104.24760005000036,95.56190060000006,89.0368002,87.67550050000001,83.71,64776608,48595185.6,35.71602341557754,1.5,2.75,2.255827030099784,1.3329840641662247,-0.4848182817412332,-2.1130781937873166,-1.6282599120460834,33.912843275078274,-7.943041495160752,-752119704.0,2002-09-27,2002,4,270,9,3.48,84.19,82.8,80.00999,686
2002-09-30 13:30:00,82.0,82.8,80.00999,81.78999,53.988508518518536,91.67834432835821,104.08515000000038,95.28970060000003,88.9783998,87.17600000000002,89.83973640008725,86.58825077986357,85.6484623076924,91.13227329198601,80.16465132339881,104.08515000000038,95.28970060000003,88.9783998,87.17600000000002,81.53332666666667,73095312,50731406.4,33.92107840606033,1.5,2.75,2.2939829565212277,1.440829600182344,-0.5129139077000384,-2.269402296671132,-1.7564883889710932,33.279633259418446,-6.876932710918815,-825215016.0,2002-09-30,2002,0,273,9,3.49,81.4,85.77,81.47,687
2002-10-01 13:30:00,82.43799999999999,85.77,81.47,85.72,53.48443444444445,91.46789641791044,103.95345000000036,95.06940060000004,89.04879980000003,87.04800000000002,89.67817810988775,86.50556022940037,85.36153923076935,90.39122954699549,80.33184891454319,103.95345000000036,95.06940060000004,89.04879980000003,87.04800000000002,84.32000000000002,67274816,50261037.6,45.906102345066316,1.5,2.75,2.4372698881982817,1.3385083001151572,-0.23681828081841985,-2.0525112399941183,-1.815692959175698,44.93534722447768,-1.4146060954571638,-757940200.0,2002-10-01,2002,1,274,10,5.28,83.62,85.53,82.60001,688
2002-10-02 13:30:00,84.69,85.53,82.60001,83.14999,52.98036037037038,91.25744850746271,103.80354995000036,94.84370050000004,89.11279960000002,86.72850000000004,89.4221707330294,86.18598211231459,84.8600000000001,89.34161630186777,80.37838369813244,103.80354995000036,94.84370050000004,89.11279960000002,86.72850000000004,83.76,56846800,50548402.4,40.7065484951546,1.5,2.75,2.4860356104698336,1.1246013187550314,-0.19881119321050367,-2.064206950688828,-1.865395757478324,47.634825784774534,-1.8300000000000003,-814787000.0,2002-10-02,2002,2,275,10,3.55,84.07,84.60001,81.95,689
2002-10-03 13:30:00,83.14,84.60001,81.95,82.31,52.47628629629631,91.04700059701493,103.64359995000041,94.58810050000004,89.06459960000002,86.40500000000002,89.14326207683219,85.81684095876085,84.27692307692315,87.87426192770408,80.67958422614221,103.64359995000041,94.58810050000004,89.06459960000002,86.40500000000002,82.95333666666666,55548896,49959931.2,39.14589713081635,1.5,2.75,2.4977480668648453,1.1118689450877386,-0.2011668181314583,-2.116854280142647,-1.9156874620111888,45.81268763239638,-2.418505937343689,-870335896.0,2002-10-03,2002,3,276,10,3.23,83.28,82.92,79.58,690
2002-10-04 13:30:00,82.8,82.92,79.58,80.8,51.972212222222225,90.83655268656716,103.4726999500004,94.29390050000003,89.00059960000004,85.94500000000002,88.8160753287211,85.339046581736,83.73615384615394,87.14296976961278,80.32933792269509,103.4726999500004,94.29390050000003,89.00059960000004,85.94500000000002,81.10000000000002,68628368,51460204.8,36.44118167721015,1.5,2.75,2.557908919231642,1.3336201880020502,-0.2709974966230704,-2.2544343327900265,-1.983436836166956,46.691523839652426,-3.4185990915610804,-938964264.0,2002-10-04,2002,4,277,10,4.2,81.25,81.2,78.55,691
2002-10-07 13:30:00,80.065,81.2,78.55,79.13,51.46813814814816,90.6261047761194,103.28940000000038,93.98730060000004,88.87119940000002,85.36850000000003,88.43622923739872,84.74770881204684,83.13461538461547,86.81008911766827,79.45914165156267,103.28940000000038,93.98730060000004,88.87119940000002,85.36850000000003,79.62666666666667,53211104,52417015.2,33.67036753174983,1.5,2.75,2.56448685357224,1.015149447120751,-0.3890527600263591,-2.4697527861999045,-2.0807000261735458,47.63449481932684,-3.8634430810351192,-992175368.0,2002-10-07,2002,0,280,10,3.37,79.88,81.31,78.2,692
2002-10-08 13:30:00,79.81,81.31,78.2,80.37,50.96406407407408,90.41565686567164,103.11800005000038,93.68740060000003,88.6831994,84.802,88.11990652220663,84.33078416328048,82.80153846153856,86.63077997838141,78.9722969446957,103.11800005000038,93.68740060000003,88.6831994,84.802,79.96,79531632,54322261.6,37.47207634460889,1.5,2.75,2.6034520783170803,1.4640707079839252,-0.34454947535536995,-2.511386870367758,-2.1668373950123883,48.50813762052954,-4.718446387854598,-912643736.0,2002-10-08,2002,1,281,10,3.98,79.76,79.7,77.78,693
2002-10-09 13:30:00,79.09,79.7,77.78,78.10001,50.45999000000001,90.20520895522387,102.93375010000037,93.35940080000003,88.42639960000002,84.15050049999998,87.7269694036887,83.73737710011092,82.3207692307693,86.77072489203276,77.87081356950584,102.93375010000037,93.35940080000003,88.42639960000002,84.15050049999998,78.52667000000002,79893872,56929675.2,33.66779305262767,1.5,2.75,2.6024912155801454,1.4033783210482815,-0.4237046416283121,-2.6964681970477784,-2.2727635554194663,47.310918910574095,-8.900023329056348,-992537608.0,2002-10-09,2002,2,282,10,2.47,78.74,81.07001,77.07001,694
2002-10-10 13:30:00,77.94,81.07001,77.07001,80.63,77.07001,89.99476104477614,102.76325010000036,93.06870080000004,88.21579960000004,83.7095005,87.44865687805388,83.44143642390988,82.08769230769238,86.5500401191876,77.62534449619716,102.76325010000036,93.06870080000004,88.21579960000004,83.7095005,79.59000666666667,76752128,58585706.4,40.87276369487656,1.5,2.75,2.702313271610135,1.3100828293503346,-0.2689278661204697,-2.6089233880700533,-2.339995521949584,50.91367262351317,-2.561933534743208,-915785480.0,2002-10-10,2002,3,283,10,5.19,79.07,84.73,81.82001,695
2002-10-11 13:30:00,82.10001,84.73,81.82001,84.16,77.05891945454545,89.78431313432837,102.60725010000036,92.8233008,88.12339960000004,83.4340005,87.3196899416596,83.50987105020417,82.23000000000009,86.82757629127101,77.63242370872915,102.60725010000036,92.8233008,88.12339960000004,83.4340005,83.57000333333333,82321680,60645240.0,49.16893254740646,1.5,2.75,2.8021480379236974,1.3574301956757036,0.08879050715183423,-2.2290073880097907,-2.317797895161625,54.1514347608153,2.897677331908212,-833463800.0,2002-10-11,2002,4,284,10,3.56,83.28,84.85001,83.03999,696
2002-10-14 13:30:00,83.2,84.85001,83.03999,84.63,77.04782890909091,89.5738652238806,102.45010010000036,92.58020079999999,88.08019980000005,83.1710005,87.21421190473177,83.61654999780376,82.25153769230778,86.89106941476965,77.61200596984591,102.45010010000036,92.58020079999999,88.08019980000005,83.1710005,84.17333333333333,40638400,61268780.0,50.171414126018206,1.5,2.75,2.7312817495005755,0.6632807116446582,0.3594721312339795,-1.8684577311191504,-2.22792986235313,53.49662469357082,-1.2715818945403679,-792825400.0,2002-10-14,2002,0,287,10,2.18,83.94,88.72,86.85600000000001,697
2002-10-15 13:30:00,86.991,88.72,86.85600000000001,88.7,77.03673836363636,89.36341731343283,102.31360010000036,92.3662007,88.17879980000002,83.21450050000001,87.27247810454621,84.10068809325105,82.47999923076931,87.99254472126648,76.96745374027216,102.31360010000036,92.3662007,88.17879980000002,83.21450050000001,88.09200000000001,82538320,63007591.2,57.91219362322249,1.5,2.75,2.8283330531076776,1.3099742178367866,0.7903355091339739,-1.2400104759356625,-2.030345985069636,53.50843647472917,6.674697134659908,-710287080.0,2002-10-15,2002,1,288,10,2.15,87.79,87.8,85.92399999999999,698
2002-10-16 13:30:00,87.41701,87.8,85.92399999999999,86.55,77.02564781818181,89.15296940298508,102.17485010000036,92.1448007,88.17799980000002,83.1945005,87.24414562985812,84.3339558938938,82.77230692307701,88.69859125427055,76.84602259188347,102.17485010000036,92.1448007,88.17799980000002,83.1945005,86.758,63526896,63442460.8,53.20972523631837,1.5,2.75,2.8245949778857,1.001330894150941,0.9002639334136169,-0.9050160683026148,-1.805280001716232,52.23707650936123,5.1512574413801415,-773813976.0,2002-10-16,2002,2,289,10,2.18,86.86,89.3,87.85001,699
2002-10-17 13:30:00,88.87,89.3,87.85001,88.27,77.01455727272727,88.94252149253731,102.03855010000038,91.9465006,88.18139960000002,83.3730005,87.28437521300094,84.70881723733248,83.2707692307693,89.838110135304,76.70342832623463,102.03855010000038,91.9465006,88.18139960000002,83.3730005,88.47333666666668,68584368,64445979.2,56.26900963633218,1.5,2.75,2.819266765179578,1.0642148486433425,1.048196392023878,-0.4950345116863844,-1.5432309037102625,52.083242550163895,9.245049504950494,-705229608.0,2002-10-17,2002,3,290,10,1.65,88.58,89.11,86.92999,700
2002-10-18 13:30:00,87.64999,89.11,86.92999,88.64,77.00346672727272,88.73207358208954,101.89755010000036,91.7599006,88.13519960000004,83.5875,87.33753696935385,85.08321559568176,83.49538461538471,90.56311022229642,76.42765900847301,101.89755010000036,91.7599006,88.13519960000004,83.5875,88.22666333333332,47559104,64507649.6,56.92151285793486,1.5,2.75,2.7736055676667517,0.737263011362299,1.1236512814053374,-0.13866680195359038,-1.2623180833589278,49.591082921755344,12.018197902186284,-657670504.0,2002-10-18,2002,4,291,10,2.51,88.02,90.5,87.57001,701
2002-10-21 13:30:00,88.12100000000001,90.5,87.57001,90.17,76.99237618181817,88.52162567164179,101.76030010000036,91.59160059999999,88.11279980000003,83.913,87.44861395094782,85.56767125323589,84.03538538461547,91.93838976697441,76.13238100225655,101.76030010000036,91.59160059999999,88.11279980000003,83.913,89.41333666666668,45970704,64460940.0,59.605555305369045,1.5,2.75,2.7847758842619834,0.7131559670088584,1.2211906260002423,0.2641701991413754,-0.9570204268588672,45.7972504532791,12.193604578822939,-611699800.0,2002-10-21,2002,0,294,10,3.35,89.04,90.00999,88.52,702
2002-10-22 13:30:00,89.05,90.00999,88.52,89.52,76.98128563636364,88.31117776119405,101.62395015000037,91.4146006,88.09079980000004,84.2735,87.52984477640085,85.94408351483247,84.59000076923084,92.93067165537005,76.24932988309169,101.62395015000037,91.4146006,88.09079980000004,84.2735,89.34999666666666,41214704,63043950.4,57.95353464221584,1.5,2.75,2.7037204639575565,0.6537455812730923,1.1855530580755205,0.5249208957355336,-0.6606321623399869,47.186041964597685,14.622264452975099,-652914504.0,2002-10-22,2002,1,295,10,1.68,89.26,90.27,87.67999,703
2002-10-23 13:30:00,88.77,90.27,87.67999,90.2,76.97019509090909,88.10072985074629,101.49235015000036,91.2729006,88.11539980000003,84.5659995,87.63455674595377,86.34940889437223,85.3130776923078,93.84181883238405,76.78433655223155,101.49235015000036,91.2729006,88.11539980000003,84.5659995,89.38332999999999,55112496,62834850.4,59.22670007285984,1.5,2.75,2.695598287960588,0.8771007752729527,1.150486339293349,0.7774757617766994,-0.3730105775166496,40.18529185792871,11.869031377899056,-597802008.0,2002-10-23,2002,2,296,10,2.95,88.97,90.89999,88.10001,704
2002-10-24 13:30:00,90.75,90.89999,88.10001,88.36,76.95910454545455,87.89028194029852,101.35630010000037,91.11020060000004,88.03819980000002,84.69749949999998,87.66300550101441,86.54089376157488,86.0230776923078,93.8854147584821,78.16074062613347,101.35630010000037,91.11020060000004,88.03819980000002,84.69749949999998,89.12,55149808,62908800.8,54.42446812607064,1.5,2.75,2.703054124534832,0.8766628404717579,0.954172969130898,0.8197056338969729,-0.13446733523392507,43.01498486365082,4.9904942965779515,-652951816.0,2002-10-24,2002,3,297,10,3.18,89.5,90.39,87.944,705
2002-10-25 13:30:00,88.215,90.39,87.944,90.2,76.948014,87.67983402985075,101.22690010000036,90.95610060000004,87.97219980000001,85.0699995,87.76249548136677,86.88938006999632,86.77923153846163,94.19977513711643,79.35868793980683,101.22690010000036,90.95610060000004,87.97219980000001,85.0699995,89.51133333333333,43724496,61856195.2,58.084500494055796,1.5,2.75,2.6846931156394858,0.7068733513049958,0.8997586426494224,0.9902309680778528,0.09047232542843052,38.285130236215046,6.581590452558203,-609227320.0,2002-10-25,2002,4,298,10,2.78,89.17,91.28999,88.85001,706
2002-10-28 14:30:00,91.14999,91.28999,88.85001,89.61,76.93692345454545,87.46938611940298,101.10025010000038,90.81760050000004,87.8999998,85.46099999999998,87.83494663896023,87.14848672999668,87.66461538461546,93.2517743730668,82.07745639616417,101.10025010000038,90.81760050000004,87.8999998,85.46099999999998,89.91666666666669,39427008,60172780.0,56.51719852617215,1.5,2.75,2.6672136073795234,0.6552299561363129,0.780008721589461,1.0654832274152568,0.2854745058257958,39.066088442090155,1.0259301014656106,-648654328.0,2002-10-28,2002,0,301,10,2.75,90.07,89.49001,87.0,707
2002-10-29 14:30:00,89.08,89.49001,87.0,88.57001,76.92583290909091,87.25893820895523,100.97200015000037,90.66990060000002,87.76340020000002,85.60350049999998,87.86377265311864,87.28386989856844,88.27538538461546,92.11595941902009,84.43481135021085,100.97200015000037,90.66990060000002,87.76340020000002,85.60350049999998,88.35334,59529808,59785529.6,53.76334681259478,1.5,2.75,2.663126921138129,0.9957226840389151,0.5950900961504831,1.0293371260138997,0.43424702986341657,29.8304928468956,2.333922588099364,-708184136.0,2002-10-29,2002,1,302,10,2.86,88.25,89.96001,88.23,708
2002-10-30 14:30:00,88.67999,89.96001,88.23,89.42999,76.91474236363636,87.04849029850746,100.84340015000036,90.52680040000004,87.6642,85.91750049999997,87.92519294123166,87.48826228918095,88.68076923076931,91.72899065964606,85.63254780189257,100.84340015000036,90.52680040000004,87.6642,85.91750049999997,89.20666666666666,41703008,59028340.0,55.686185838925546,1.5,2.75,2.5964757124854048,0.7064912887606191,0.4989140452635732,1.0578895864428828,0.5589755411793098,25.79035391368659,1.3141384388807156,-666481128.0,2002-10-30,2002,2,303,10,1.96,89.1,90.3,88.19,709
2002-10-31 14:30:00,89.66,90.3,88.19,88.52,76.90365181818181,86.8380423880597,100.72190010000037,90.39240030000002,87.51960000000003,86.22800049999998,87.94851870824219,87.58652302354467,88.98000000000009,90.95296986608341,87.0070301339168,100.72190010000037,90.39240030000002,87.51960000000003,86.22800049999998,89.00333333333332,41621104,58331950.4,53.16660432631772,1.5,2.75,2.561727447307876,0.7135215557613174,0.349309351930968,0.9956122310930198,0.6463028791620518,24.511292913632296,-0.13537906137184627,-708102232.0,2002-10-31,2002,3,304,10,2.39,89.24,90.82001,88.05,710
2002-11-01 14:30:00,88.35001,90.82001,88.05,90.27,76.89256127272726,86.62759447761196,100.60490010000038,90.26930030000004,87.39140020000002,86.70150049999998,88.03955719027189,87.84209225939756,89.10076923076932,91.17975382820595,87.02178463333267,100.60490010000038,90.26930030000004,87.39140020000002,86.70150049999998,89.71333666666666,51889504,57495007.2,57.179169833741426,1.5,2.75,2.5766047725001706,0.9025045221665786,0.3430173467400197,1.0750745625870763,0.7320572158470566,26.878882896661874,0.11090163025395842,-656212728.0,2002-11-01,2002,4,305,11,3.15,89.44,92.94,90.89999,711
2002-11-04 14:30:00,91.8,92.94,90.89999,91.13,76.88147072727273,86.4171465671642,100.49480015000036,90.16510030000003,87.32200000000003,87.30150049999996,88.16075102594749,88.15522632993112,89.45307692307699,91.21112301712571,87.69503082902828,100.49480015000036,90.16510030000003,87.32200000000003,87.30150049999996,91.65666333333333,49081808,57288542.4,59.036579852596766,1.5,2.75,2.58327586017873,0.8567473694356029,0.3693012686410671,1.1936838016483904,0.8243825330073233,25.62063534902855,1.7984807864164427,-607130920.0,2002-11-04,2002,0,308,11,2.24,91.92,92.07001,90.84,712
2002-11-05 14:30:00,90.84,92.07001,90.84,91.85001,76.87038018181819,86.20669865671644,100.39220020000036,90.06960050000004,87.25380040000003,87.87550099999999,88.30542784845937,88.50711048898529,89.72846230769238,91.75934650028728,87.69757811509749,100.39220020000036,90.06960050000004,87.25380040000003,87.87550099999999,91.58667333333334,37282192,55176070.4,60.57832481048782,1.5,2.75,2.486614013023106,0.6756949476416502,0.4048497568735685,1.330444729099284,0.9255949722257156,25.296521975716185,1.8292793791574218,-569848728.0,2002-11-05,2002,1,309,11,1.35,91.46,93.07001,90.78999,713
2002-11-06 14:30:00,92.48,93.07001,90.78999,93.03999,76.85928963636363,85.99625074626866,100.29125015000038,89.95880040000002,87.23140020000004,88.62249999999997,88.49109695244135,88.93881329955812,90.06692307692312,92.65070896491986,87.48313718892643,100.29125015000038,89.95880040000002,87.23140020000004,88.62249999999997,92.29999666666669,65270000,54444876.8,63.05333711407754,1.5,2.75,2.4718572978071696,1.1988272145378425,0.4734112382797162,1.5173590200753608,1.0439477817956446,25.855654571755892,5.296502942507925,-504578728.0,2002-11-06,2002,2,310,11,2.51,91.93,92.22,90.22,714
2002-11-07 14:30:00,92.02699,92.22,90.22,90.75999,76.84819909090909,85.7858028358209,100.17715010000036,89.81670030000004,87.20459980000004,89.12899949999998,88.58007315038482,89.11225869960022,90.11230692307699,92.72233355519482,87.50228029095915,100.17715010000036,89.81670030000004,87.20459980000004,89.12899949999998,91.06666333333334,51574096,53185975.2,55.8218682239123,1.5,2.75,2.4967239193923723,0.9696935292821328,0.33654550102403946,1.4646296580756941,1.1280841570516544,27.331679754819714,0.6208314855875822,-556152824.0,2002-11-07,2002,3,311,11,2.22,91.22,91.57001,89.52,715
2002-11-08 14:30:00,90.53,91.57001,89.52,89.64999,76.83710854545456,85.57535492537312,100.05765005000038,89.68800020000002,87.15479960000002,89.40349899999998,88.62203067389916,89.1634712044002,90.12230615384621,92.72416267814975,87.52044962954267,100.05765005000038,89.68800020000002,87.15479960000002,89.40349899999998,90.24666666666668,37911104,50965446.4,52.655681670584485,1.5,2.75,2.464815782292917,0.7438589608821714,0.15199630239824713,1.3180795350494634,1.1660832326512165,25.92482897163268,0.04462671576833286,-594063928.0,2002-11-08,2002,4,312,11,2.29,90.55,89.56,87.8,716
2002-11-11 14:30:00,89.515,89.56,87.8,88.25999,76.82601799999998,85.36490701492538,99.92965000000036,89.55850000000002,87.08439940000002,89.58499849999998,88.60783300041292,89.0774253754097,89.97307461538466,92.75621401091782,87.18993521985149,99.92965000000036,89.55850000000002,87.08439940000002,89.58499849999998,88.53999666666668,33580800,50612566.4,48.91420023388821,1.5,2.75,2.42089965498628,0.6634873982600495,-0.07098096827493118,1.0773570223075524,1.1483379905824835,27.174567455200588,-0.3500281867417588,-627644728.0,2002-11-11,2002,0,315,11,2.0,88.68,89.92999,88.37,717
2002-11-12 14:30:00,88.66,89.92999,88.37,88.96001,76.81492745454545,85.15445910447761,99.82305005000036,89.45530010000002,87.09799960000002,89.59799899999999,88.62164386314183,89.06624295870401,90.01922923076927,92.71227771089515,87.32618075064343,99.82305005000036,89.45530010000002,87.09799960000002,89.59799899999999,89.08666666666666,37769392,48374120.0,50.80984467079874,1.5,2.75,2.3672639653444034,0.7807768286017399,-0.1728133993339216,0.9323212414150815,1.1051346407490032,26.81797154043748,-0.5255284049567787,-589875336.0,2002-11-12,2002,1,316,11,1.77,89.15,89.74899,87.45,718
2002-11-13 14:30:00,88.32001,89.74899,87.45,89.05,76.8038369090909,84.94401119402986,99.70895005000037,89.34780010000004,87.08819980000004,89.72299899999999,88.63844214301862,89.06469601025603,89.93076769230774,92.66941723820548,87.19211814640998,99.70895005000037,89.34780010000004,87.08819980000004,89.72299899999999,88.74966333333332,63905008,48393025.6,51.06125205243507,1.5,2.75,2.362387253534089,1.3205416939254155,-0.23191318034711486,0.8152431653151098,1.0471563456622246,26.182814680953523,0.5987347492092195,-525970328.0,2002-11-13,2002,2,317,11,2.63,88.6,91.0,89.759,719
2002-11-14 14:30:00,90.07001,91.0,89.759,90.73,76.79274636363634,84.7335632835821,99.59670010000036,89.27950010000002,87.12719980000001,89.84599899999998,88.720464019763,89.22329639023165,90.01692153846159,92.78014387151363,87.25369920540956,99.59670010000036,89.27950010000002,87.12719980000001,89.84599899999998,90.49633333333334,31938704,46560742.4,55.621344858859274,1.5,2.75,2.332931021138797,0.6859577909135745,-0.15913155530618694,0.8482419015294909,1.0073734568356778,27.446805179870648,0.5095823640190628,-494031624.0,2002-11-14,2002,3,318,11,1.38,90.38,91.55,89.95,720
2002-11-15 14:30:00,90.0,91.55,89.95,91.39999,76.7816558181818,84.52311537313433,99.49045010000036,89.21630000000003,87.15519960000002,89.98399849999996,88.82554346996834,89.4306005435429,90.23461230769236,92.95311343583953,87.5161111795452,99.49045010000036,89.21630000000003,87.15519960000002,89.98399849999996,90.96666333333332,39166192,46141096.8,57.328989415396755,1.5,2.75,2.280578805343168,0.8488353055361268,-0.07159833859745801,0.9178755335888552,0.9894738721863132,25.49012679692513,0.29626906616921656,-454865432.0,2002-11-15,2002,4,319,11,1.78,90.75,92.14999,90.35001,721
2002-11-18 14:30:00,92.14999,92.14999,90.35001,90.48,76.77056527272727,84.31266746268658,99.39360005000036,89.12680010000004,87.15159960000003,89.99949849999996,88.8904241182049,89.53054334891978,90.31538230769236,92.99558298909665,87.63518162628807,99.39360005000036,89.12680010000004,87.15159960000003,89.99949849999996,90.99333333333334,29019392,45293531.2,54.24251535785903,1.5,2.75,2.246250319247228,0.640696170759148,-0.08071336789911687,0.8885821623124173,0.969295530211534,25.652776691975692,-1.4915730548096766,-483884824.0,2002-11-18,2002,0,322,11,1.99,91.25,91.10001,89.75999,722
2002-11-19 14:30:00,90.02,91.10001,89.75999,90.36,76.75947472727272,84.10221955223882,99.29955005000038,89.04080000000002,87.12479959999999,90.04149849999996,88.94805454494195,89.60953922045124,90.4569207692308,92.92919523366949,87.98464630479215,99.29955005000038,89.04080000000002,87.12479959999999,90.04149849999996,90.40666666666668,32813696,44873480.8,53.83537987917392,1.5,2.75,2.18151958215814,0.731249179136556,-0.09869036554499222,0.8459325732802938,0.9446229388252859,25.064085969593922,-2.8804710748571702,-516698520.0,2002-11-19,2002,1,323,11,1.49,90.43,92.42,89.95,723
2002-11-20 14:30:00,89.98,92.42,89.95,92.37,76.74838418181817,83.89177164179105,99.21790005000037,88.99420000000002,87.14959959999999,90.14999849999997,89.082248484356,89.87244024707493,90.61845923076928,93.28737778671673,87.94954067482185,99.21790005000037,88.99420000000002,87.14959959999999,90.14999849999997,91.58,36815296,43958620.8,59.340431424104814,1.5,2.75,2.202125326289701,0.8374988871352398,0.014877069895741226,0.9632192761949624,0.9483422062992212,27.427243153898768,1.7739204246276388,-479883224.0,2002-11-20,2002,2,324,11,2.75,91.18,94.19,92.42999,724
2002-11-21 14:30:00,92.60001,94.19,92.42999,94.09,76.73729363636362,83.68132373134328,99.14825005000036,88.98540000000004,87.24239960000001,90.43649849999996,89.2786308967342,90.27411260449637,90.84615153846158,94.09321470680824,87.59908837011496,99.14825005000036,88.98540000000004,87.24239960000001,90.43649849999996,93.56999666666664,55170800,43959670.4,63.36621971809657,1.5,2.75,2.1748306601261507,1.255032157838927,0.18639958457016115,1.1813416870119229,0.9949421024417616,24.623629749277267,4.9526051257785975,-424712424.0,2002-11-21,2002,3,325,11,1.9,93.31,94.27,93.27299000000001,725
2002-11-22 14:30:00,93.48,94.27,93.27299000000001,93.42,76.72620309090908,83.47087582089553,99.06490005000036,88.96450010000002,87.31739959999999,90.59749849999996,89.4410375282348,90.57372092787766,90.96692000000006,94.46168405180036,87.47215594819977,99.06490005000036,88.96450010000002,87.31739959999999,90.59749849999996,93.65433,32514096,43399150.4,60.83923313021949,1.5,2.75,2.090700612974283,0.7491873850138779,0.2323066676028307,1.2853254369452998,1.053018769342469,23.56165264461995,5.846375010919442,-457226520.0,2002-11-22,2002,4,326,11,1.07,93.77,94.25999,92.77,726
2002-11-25 14:30:00,93.42999,94.25999,92.77,93.48,76.71511254545453,83.26042791044777,98.97510005000036,88.90620010000002,87.3891996,90.79099849999996,89.59942821340208,90.85050941093695,91.000766923077,94.58262420471591,87.41890964143805,98.97510005000036,88.90620010000002,87.3891996,90.79099849999996,93.50333,34059296,43130764.8,60.98926736776801,1.5,2.75,2.0477927120475488,0.7896752157754457,0.2431313272079616,1.3569329283524212,1.1138016011444596,20.18904829971878,5.0809234396444065,-423167224.0,2002-11-25,2002,0,329,11,1.61,93.51,93.45,91.62,727
2002-11-26 14:30:00,93.07401,93.45,91.62,91.7,76.704022,83.04998,98.87815005000036,88.84250000000004,87.4665996,90.94749799999997,89.6818035775824,90.931413276562,91.07307538461544,94.67048953484421,87.47566123438669,98.87815005000036,88.84250000000004,87.4665996,90.94749799999997,92.25666666666666,42290400,42268794.4,54.338110979260165,1.5,2.75,2.034378946901295,1.0005111477700441,0.11342091002517195,1.2555777386759246,1.1421568286507526,24.630224226319648,2.9758562605277996,-465457624.0,2002-11-26,2002,1,330,11,2.0,92.54,94.64999,92.42999,728
2002-11-27 14:30:00,92.52,94.64999,92.42999,94.28,76.69293145454544,82.83953208955225,98.78820005000036,88.82929990000004,87.61319959999999,91.18999849999996,89.86212500591247,91.2503262978418,91.42923000000003,95.29902255627312,87.55943744372698,98.78820005000036,88.82929990000004,87.61319959999999,91.18999849999996,93.78666,37773008,42072294.4,60.98031079166395,1.5,2.75,2.0997797364083453,0.8978119339267602,0.18041196878197274,1.3676717896282184,1.1872598208462457,28.319341046369725,3.9127080348286087,-427684616.0,2002-11-27,2002,2,331,11,2.4,93.54,94.95,93.77,729
2002-11-29 14:30:00,94.8,94.95,93.77,93.98,76.68184090909091,82.62908417910448,98.69780005000037,88.84789990000004,87.79879959999998,91.46299849999996,90.02361029979828,91.51029522185688,91.86923076923081,95.49033317290608,88.24812836555556,98.69780005000037,88.84789990000004,87.79879959999998,91.46299849999996,94.23333333333332,19385696,40960524.0,59.88938762027721,1.5,2.75,2.034081183807749,0.4732775391252319,0.1829738527540523,1.4159771367888112,1.2330032840347591,27.42018410170044,2.822768361353214,-447070312.0,2002-11-29,2002,4,333,11,1.26,94.36,96.05,93.22,730
2002-12-02 14:30:00,95.47,96.05,93.22,94.13,76.67075036363636,96.05,98.61400005000036,88.86049990000002,87.99439939999998,91.65599849999997,90.18464519000229,91.75979091501335,92.26692230769235,95.65044319857643,88.88340141680828,98.61400005000036,88.86049990000002,87.99439939999998,91.65599849999997,94.46666666666664,49794400,40855768.8,60.27208456790576,1.5,2.75,2.0909325278214816,1.2187850446226336,0.17331939427620524,1.4496525268800156,1.2763331326038103,27.324533567602593,4.034040671971697,-397275912.0,2002-12-02,2002,0,336,12,3.04,94.64,93.39999,92.35001,731
2002-12-03 14:30:00,93.25,93.39999,92.35001,92.87,76.65965981818181,96.03428585714285,98.53455010000036,88.87069980000004,88.17859939999998,91.74299849999996,90.28995322176691,91.8655251135835,92.56076846153853,95.39459248970171,89.72694443337534,98.53455010000036,88.87069980000004,88.17859939999998,91.74299849999996,92.87333333333332,34433296,40123343.2,55.48333391136531,1.5,2.75,2.068722347262804,0.8581861144611698,0.06613613574588695,1.359003302286169,1.292867166540282,27.970822063072077,2.7777777777777835,-431709208.0,2002-12-03,2002,1,337,12,1.14,92.88,93.14,91.42999,732
2002-12-04 14:30:00,91.77,93.14,91.42999,92.45,76.64856927272727,96.01857171428571,98.44385010000036,88.87179980000002,88.38139939999998,91.77299799999996,90.37466093856035,91.92118938848034,92.69307615384622,95.32613829544641,90.06001401224606,98.44385010000036,88.87179980000002,88.38139939999998,91.77299799999996,92.33999666666666,64137200,41466093.6,53.94475882156607,1.5,2.75,2.0431000367440317,1.546738417626106,-0.043101461710880695,1.2389903394016812,1.282091801112562,28.19484019326273,0.08660820612752873,-495846408.0,2002-12-04,2002,2,338,12,1.87,92.28,92.80099,91.10001,733
2002-12-05 14:30:00,92.7,92.80099,91.10001,91.42999,76.63747872727272,96.00285757142856,98.35950005000036,88.88049970000004,88.52299899999996,91.69249799999996,90.41604639195015,91.87440849433935,92.69538384615393,95.32395750939236,90.06681018291548,98.35950005000036,88.88049970000004,88.52299899999996,91.69249799999996,91.77699666666668,36778192,40041503.2,50.29690652771984,1.5,2.75,2.0186628912623155,0.9185017809221508,-0.1860932631597887,1.0494752221628258,1.2355684853226148,26.04749872935541,-2.8270910830056324,-532624600.0,2002-12-05,2002,3,339,12,1.87,91.95,92.17,89.98,734
2002-12-06 14:30:00,90.12,92.17,89.98,92.03,76.62638818181817,95.98714342857143,98.27145005000037,88.89339960000004,88.64899899999996,91.75599849999996,90.47933869030504,91.88922673297373,92.81461461538471,95.15526217664572,90.47396705412369,98.27145005000037,88.89339960000004,88.64899899999996,91.75599849999996,91.39333333333332,50132096,39969403.2,52.33861346275462,1.5,2.75,2.03090125617215,1.2542618099436622,-0.23893564330124795,0.9368989311960548,1.1758345744973029,23.574994597510944,-1.4879040890601594,-482492504.0,2002-12-06,2002,4,340,12,2.43,91.08,91.46001,89.48,735
2002-12-09 14:30:00,91.07001,91.46001,89.48,89.5,76.61529763636362,95.97142928571428,98.16170005000036,88.91039960000006,88.78399899999997,91.74849899999997,90.44093325146956,91.66168132983336,92.74846076923086,95.39189650561936,90.10502503284235,98.16170005000036,88.91039960000006,88.78399899999997,91.74849899999997,90.14667,36804096,39914052.8,44.110525403169724,1.5,2.75,2.0679797378741394,0.9220836627244228,-0.43170937102993423,0.6361978607098848,1.067907231739819,27.77744553085625,-4.257595207531026,-519296600.0,2002-12-09,2002,0,343,12,2.21,90.47,91.10001,89.75999,736
2002-12-10 14:30:00,90.02,91.10001,89.75999,90.7,76.60420709090909,95.95571514285713,98.05910005000037,88.97029950000004,88.96219919999996,91.87049949999997,90.45109273180408,91.570092631754,92.61999923076931,95.47811177634516,89.76188668519346,98.05910005000037,88.97029950000004,88.96219919999996,91.87049949999997,90.52,33449104,39907468.0,48.26491562767261,1.5,2.75,2.0345533280259858,0.8381665306353187,-0.4630600001322896,0.4890822315744572,0.9521422317067468,29.49552902480325,-1.0905125408942202,-485847496.0,2002-12-10,2002,1,344,12,1.49,90.43,91.62,90.16,737
2002-12-11 14:30:00,90.42,91.62,90.16,90.78,76.59311654545455,95.940001,97.95475010000037,89.05609950000006,89.06339919999996,91.96149899999998,90.46399105604704,91.4948457144441,92.36538384615393,95.24398082197573,89.48678687033214,97.95475010000037,89.05609950000006,89.06339919999996,91.96149899999998,90.85333333333334,39206096,39979303.2,48.53954331588411,1.5,2.75,1.9935138045955596,0.9806598130004426,-0.46201068258683503,0.37462887847320303,0.8366395610600379,27.657196453139747,-3.7123462028001697,-446641400.0,2002-12-11,2002,2,345,12,1.62,90.89,91.49001,90.2,738
2002-12-12 14:30:00,91.2,91.49001,90.2,90.77,76.58202599999998,95.92428685714287,97.85285015000035,89.16429950000006,89.21579939999997,92.04749899999996,90.4759914067903,91.42581278925894,92.16153769230776,95.0874633899732,89.23561199464235,97.85285015000035,89.16429950000006,89.21579939999997,92.04749899999996,90.82000333333332,34480496,38508077.6,48.504882457632924,1.5,2.75,1.943263532838733,0.8954094348246561,-0.44539928707629217,0.2798904522146728,0.7252897392909649,20.858805325075465,-3.4156203447542115,-481121896.0,2002-12-12,2002,3,346,12,1.43,90.85,90.48,89.27,739
2002-12-13 14:30:00,89.91,90.48,89.27,89.34,76.57093545454545,95.90857271428571,97.73085010000034,89.21049950000004,89.35639939999996,91.97799899999997,90.43144272417109,91.22716395218666,91.84307615384623,95.01641146231717,88.66974084537529,97.73085010000034,89.21049950000004,89.35639939999996,91.97799899999997,89.69666666666667,36873392,38754812.0,43.69937183806498,1.5,2.75,1.9116018519216809,0.9514532543726439,-0.5095106069372779,0.08840148061936759,0.5979120875566455,21.96330637828937,-5.088707107192173,-517995288.0,2002-12-13,2002,4,347,12,1.36,89.88,91.78999,89.66,740
2002-12-16 14:30:00,89.82001,91.78999,89.66,91.64999,76.55984490909091,95.89285857142856,97.61035005000036,89.28699940000006,89.57339919999997,91.99049899999996,90.47922889185064,91.26743309959744,91.83922923076929,95.01337014554683,88.66508831599178,97.61035005000036,89.28699940000006,89.57339919999997,91.99049899999996,91.03332666666668,37112304,38652117.6,51.9762880040281,1.5,2.75,1.9500581482129893,0.9601622447718104,-0.3810178373701845,0.12163979084391485,0.5026576282140993,28.0511380970116,-1.313675029611287,-480882984.0,2002-12-16,2002,0,350,12,2.38,90.72,91.74001,90.74001,741
2002-12-17 14:30:00,91.37199,91.74001,90.74001,90.85001,76.54875436363633,95.87714442857144,97.48770010000031,89.33949940000005,89.80779939999996,92.0089995,90.49376932746435,91.22767851868342,91.57538384615393,94.45023554722059,88.70053214508724,97.48770010000031,89.33949940000005,89.80779939999996,92.0089995,91.11001,32399904,38821143.2,49.27461803432242,1.5,2.75,1.882196851912061,0.8345942785116126,-0.33614296243547753,0.08247892516975243,0.41862188760523,27.51368728793604,-1.7306544077879993,-513282888.0,2002-12-17,2002,1,351,12,1.1,91.24,90.39999,89.33,742
2002-12-18 14:30:00,90.32001,90.39999,89.33,89.8,76.53766381818181,95.86143028571428,97.3529501000003,89.33979940000003,89.99639939999996,91.98099949999998,90.46656268717163,91.09170913595163,91.25384538461546,93.90750979849129,88.60018097073963,97.3529501000003,89.33979940000003,89.99639939999996,91.98099949999998,89.84333000000001,35643104,38962613.6,45.90206890569268,1.5,2.75,1.8563263624897712,0.9148026969114824,-0.3612207716830112,-0.03290407699853404,0.3283166946844772,28.028706223081322,-1.7827739016486892,-548925992.0,2002-12-18,2002,2,352,12,1.2,89.86,90.7,88.60001,743
2002-12-19 14:30:00,89.35001,90.7,88.60001,89.16,76.52657327272728,95.84571614285713,97.21625010000031,89.32199940000004,90.21759919999997,91.82049949999998,90.41532493473352,90.9077368372896,90.87153769230778,93.16521744073007,88.57785794388548,97.21625010000031,89.32199940000004,90.21759919999997,91.82049949999998,89.48666999999999,39287200,39086208.8,43.92849860632099,1.5,2.75,1.8737309080262168,1.0051422536534165,-0.4018397724194323,-0.1739830208398132,0.2278567515796191,27.69758776622341,-3.1185482994675695,-588213192.0,2002-12-19,2002,3,353,12,2.37,89.65,90.02,89.10001,744
2002-12-20 14:30:00,89.2,90.02,89.10001,89.99001,76.5154827272727,95.83000200000001,97.0812501000003,89.31029950000004,90.40479939999996,91.61549999999998,90.39864591768514,90.82033428135723,90.65000000000008,92.66863283518312,88.63136716481706,97.0812501000003,89.31029950000004,90.40479939999996,91.61549999999998,89.70333999999998,31181104,37886724.0,47.10482023453974,1.5,2.75,1.8056065574529152,0.8230087140814815,-0.355341897646062,-0.2163206204779584,0.1390212771681036,28.064379944464868,0.5474972067039084,-557032088.0,2002-12-20,2002,4,354,12,1.03,89.56,90.47,89.31,745
2002-12-23 14:30:00,89.59,90.47,89.31,90.02,76.50439218181819,95.81428785714287,96.94515005000031,89.32269950000004,90.52199939999996,91.44549999999998,90.38379705816808,90.74411196884705,90.463076923077,92.21245326238535,88.7137005837687,96.94515005000031,89.32269950000004,90.52199939999996,91.44549999999998,89.93333333333334,22645504,37393294.4,47.22115779964886,1.5,2.75,1.7594918033491354,0.6056033404748633,-0.30692385981160897,-0.24463354759640765,0.06229031221520132,22.82837076547909,-0.7497243660419038,-534386584.0,2002-12-23,2002,0,357,12,1.3,89.89,89.86,89.25,746
2002-12-24 14:30:00,89.59,89.86,89.25,89.355,76.49330163636363,95.79857371428572,96.8060750500003,89.34834960000003,90.61649939999997,91.23924999999998,90.34345207549481,90.61181559086158,90.30346230769241,92.04946847228732,88.55745614309744,96.8060750500003,89.34834960000003,90.61649939999997,91.23924999999998,89.48833333333334,10937000,36237179.6,44.864809097223436,1.5,2.75,1.6888138173956253,0.3018170873320395,-0.3034935511363224,-0.31707662670520165,-0.013583075568879265,21.668693535450945,-1.5697290152015828,-545323584.0,2002-12-24,2002,1,358,12,0.68,89.56,90.61,88.84,747
2002-12-26 14:30:00,89.7,90.61,88.84,89.39,76.48221109090908,95.78285957142856,96.67282510000031,89.40454960000002,90.63029939999996,91.12375,90.30606179802444,90.49545220125574,90.10038538461548,91.59139483820653,88.60937593102443,96.67282510000031,89.40454960000002,90.63029939999996,91.12375,89.61333333333332,17489200,34997119.6,45.0203112078436,1.5,2.75,1.6946128304387946,0.4997325551329087,-0.2830764141241009,-0.3674285932240053,-0.08435217909990447,21.650897240712126,-1.5203260989313603,-527834384.0,2002-12-26,2002,3,360,12,1.99,89.72,89.28999,87.38,748
2002-12-27 14:30:00,88.96001,89.28999,87.38,87.38,76.47112054545455,95.76714542857141,96.53032510000031,89.41244960000002,90.64689939999997,90.77874999999996,90.19131427653328,90.19874246780282,89.93730846153855,92.00682463120351,87.86779229187357,96.53032510000031,89.41244960000002,90.64689939999997,90.77874999999996,88.01666333333333,22213008,34219119.6,38.33376856811209,1.5,2.75,1.7171404854074523,0.6491402543272913,-0.38294449635859934,-0.5630327995481537,-0.18008830318955432,24.7659442350357,-2.1938661293933377,-550047392.0,2002-12-27,2002,4,361,12,2.19,88.33,88.47,87.22,749
2002-12-30 14:30:00,87.79700000000001,88.47,87.22,88.11,76.46002999999997,95.75143128571429,96.3876251500003,89.41254950000004,90.64369939999996,90.48524999999998,90.1096941088261,89.99981461372637,89.73807769230775,91.967997729654,87.50815765496155,96.3876251500003,89.41254950000004,90.64369939999996,90.48524999999998,87.93333333333334,29972192,34748444.4,41.719318572482685,1.5,2.75,1.6837733078783486,0.8625477346548498,-0.3772365669807716,-0.6516340119155188,-0.2743974449347472,24.340132323350826,-3.8625099686317514,-520075200.0,2002-12-30,2002,0,364,12,1.43,87.84,88.42999,87.11,750
2002-12-31 14:30:00,87.99001,88.42999,87.11,88.23,87.11,95.73571714285713,96.2454251500003,89.38534950000002,90.63549939999993,90.19024999999996,90.03598061436233,89.83126084099052,89.54192384615392,91.81884956604604,87.2649981262618,96.2454251500003,89.38534950000002,90.63549939999993,90.19024999999996,87.92333,34037504,33960599.6,42.280300608187936,1.5,2.75,1.6577887858870384,1.0022645183214018,-0.3437238344469976,-0.7040522379934941,-0.3603284035464966,17.592327364117914,-2.8838852081579227,-486037696.0,2002-12-31,2002,1,365,12,1.52,87.77,91.3,88.53999,751
2003-01-02 14:30:00,88.85001,91.3,88.53999,91.07001,87.28928553571428,95.720003,96.11352520000031,89.38314970000002,90.65349959999996,90.10025049999996,90.07653078634813,89.94923695137237,89.56500153846159,91.89667130005468,87.23333177686851,96.11352520000031,89.38314970000002,90.65349959999996,90.10025049999996,90.30333333333333,44641392,34471004.4,53.65101744965707,1.5,2.75,1.7586610154665352,1.2950418120105605,-0.12017228287261905,-0.5105437571372704,-0.39037147426465135,26.46447763790225,1.4142650334075717,-441396304.0,2003-01-02,2003,3,2,1,3.12,89.92,91.38699,90.5,752
2003-01-03 14:30:00,90.91,91.38699,90.5,91.35001,87.46857107142857,95.70428885714287,95.99407520000031,89.3904498,90.69009979999993,90.04525099999998,90.12647114766779,90.08264390838451,89.71961769230776,92.23076650085531,87.2084688837602,95.99407520000031,89.3904498,90.69009979999993,90.04525099999998,91.079,32226000,32875444.4,54.600608604156726,1.5,2.75,1.696398800076068,0.98024530430378,0.04767301646887512,-0.3307802036785574,-0.37845322014743255,25.37728073360509,2.456269627635712,-409170304.0,2003-01-03,2003,4,3,1,0.98,90.94,93.49001,91.17599,753
2003-01-06 14:30:00,91.24001,93.49001,91.17599,92.96001,87.64785660714287,95.68857471428569,95.88242530000029,89.43034990000002,90.74529999999993,90.12175199999996,90.23759031834749,90.35667877425269,89.82038846153854,92.70993809048694,86.9308388325901,95.88242530000029,89.43034990000002,90.74529999999993,90.12175199999996,92.54200333333334,41005696,33086819.6,59.711849127606314,1.5,2.75,1.7405146000706346,1.2393362824150074,0.2565728246072562,-0.05773718938836225,-0.3143100139956185,26.150580453993467,3.3003663406638126,-368164608.0,2003-01-06,2003,0,6,1,2.54,92.33,93.37,92.2,754
2003-01-07 14:30:00,92.89999,93.37,92.2,92.73,87.82714214285713,95.67286057142857,95.77087535000028,89.43544990000002,90.83269999999992,90.15675199999997,90.33533187449072,90.58270936718098,89.96500307692314,93.21223670195438,86.7177694518919,95.77087535000028,89.43544990000002,90.83269999999992,90.15675199999997,92.76666666666668,38655104,32512970.0,58.69516937880325,1.5,2.75,1.6997635572084466,1.1889133475040885,0.3622440094005887,0.1384949977551173,-0.2237490116454713,26.18205117589948,3.01044212397246,-406819712.0,2003-01-07,2003,1,7,1,1.27,92.78,92.39999,91.05,755
2003-01-08 14:30:00,92.2,92.39999,91.05,91.39,88.00642767857143,95.65714642857141,95.65977535000029,89.41434990000002,90.85649999999994,90.25125199999998,90.37669140882444,90.65959418935421,90.08731076923084,93.41914469181991,86.75547684664178,95.65977535000029,89.41434990000002,90.85649999999994,90.25125199999998,91.61333,38736704,32609600.4,53.03029292916782,1.5,2.75,1.6983518745507007,1.1878926305395634,0.3260114387989612,0.18376528685323024,-0.14224615194573098,28.058915750149016,2.277432712215317,-445556416.0,2003-01-08,2003,2,8,1,1.48,91.72,93.17999,91.41,756
2003-01-09 14:30:00,91.821,93.17999,91.41,92.81,88.1857132142857,95.64143228571429,95.5524753500003,89.41024990000003,90.92049999999996,90.35675199999996,90.47211527514506,90.86439474274906,90.36808000000006,93.94608782032095,86.79007217967917,95.5524753500003,89.41024990000003,90.92049999999996,90.35675199999996,92.46666333333332,34851200,32679705.2,57.69039358065322,1.5,2.75,1.7048974549399367,1.066447808715239,0.3781294207931668,0.33041562404572744,-0.047713796747439294,28.456997233352,3.82593131222732,-410705216.0,2003-01-09,2003,3,9,1,1.94,92.29,93.64,91.8,757
2003-01-10 14:30:00,91.95,93.64,91.8,93.06,88.36499875,95.62571814285714,95.44492530000029,89.38685000000002,91.01029979999996,90.47075199999998,90.57360095062955,91.07350000534441,90.60423307692314,94.44672680463181,86.76173934921448,95.44492530000029,89.38685000000002,91.01029979999996,90.47075199999998,92.83333333333331,37771600,32607980.4,58.471587973963736,1.5,2.75,1.7145476367299417,1.1583544744770518,0.4073632066784241,0.4614902116005908,0.05412700492216672,28.387107178047337,6.500343327992684,-372933616.0,2003-01-10,2003,4,10,1,2.0,92.72,93.86,92.44,758
2003-01-13 14:30:00,93.53999,93.86,92.44,93.03,88.54428428571428,93.86,95.33747530000029,89.37325000000004,91.08229999999996,90.58375199999998,90.66993032511465,91.25983333816872,90.83577153846159,94.86762737234626,86.80391570457694,95.33747530000029,89.37325000000004,91.08229999999996,90.58375199999998,93.11,31676096,32467760.4,58.33240185644189,1.5,2.75,1.6935085198206603,0.9756169076571108,0.4019237294024138,0.5565316666751841,0.1546079372727702,23.08425627664147,5.5839291794348,-404609712.0,2003-01-13,2003,0,13,1,1.54,93.15,93.83,92.41,759
2003-01-14 14:30:00,92.69,93.83,92.41,93.33,88.72356982142857,93.78178571428572,95.23127525000031,89.34905000000002,91.17849999999994,90.78325199999998,90.7742467829533,91.45699206786695,91.14154076923084,95.27934428685208,87.00373725160959,95.23127525000031,89.34905000000002,91.17849999999994,90.78325199999998,93.19,30902800,32169230.8,59.37385872822188,1.5,2.75,1.6739721969763277,0.9606322324623316,0.3951806324764915,0.6485837278683846,0.2534030953918931,23.10367942552147,5.780346820809243,-373706912.0,2003-01-14,2003,1,14,1,1.54,93.12,93.57001,91.91,760
2003-01-15 14:30:00,93.53999,93.57001,91.91,92.39999,88.90285535714285,93.70357142857141,95.1235752000003,89.30625000000002,91.22109979999992,90.82075199999996,90.83800141891592,91.54680139473676,91.37307846153851,95.42897565339993,87.31718126967709,95.1235752000003,89.30625000000002,91.22109979999992,90.82075199999996,92.62666666666668,33542000,31990715.6,54.80105278363966,1.5,2.75,1.6729748971923042,1.0484917067625708,0.3085768750220005,0.6391241891693937,0.33054731414739325,24.754472898617763,1.4603929438461754,-407248912.0,2003-01-15,2003,2,15,1,1.81,92.74,92.92999,91.455,761
2003-01-16 14:30:00,92.5,92.92999,91.455,92.02,89.08214089285713,93.62535714285713,95.01797520000031,89.28044990000002,91.23889979999994,90.87925149999997,90.88435430444862,91.59186792857136,91.7300015384616,95.07117546392269,88.3888276130005,95.01797520000031,89.28044990000002,91.23889979999994,90.87925149999997,92.13499666666668,45374496,32639445.2,53.00478209567626,1.5,2.75,1.6588331188214256,1.390173629544414,0.21085559711413165,0.5941168105400578,0.3832612134259262,18.070241249582704,0.7334317752127214,-452623408.0,2003-01-16,2003,3,16,1,1.61,92.19,92.3,90.14999,762
2003-01-17 14:30:00,90.99001,92.3,90.14999,90.66,89.26142642857144,93.54714285714287,94.9079252000003,89.23445000000002,91.21509959999996,90.92225149999996,90.87555609643104,91.50311860204077,91.92615538461544,94.6334952795482,89.2188154896827,94.9079252000003,89.23445000000002,91.21509959999996,90.92225149999996,91.03666333333337,35621008,32638340.4,47.0593888175253,1.5,2.75,1.693917181762752,1.0913853940931384,0.04826625235744947,0.44359402887273797,0.39532777651528855,20.14566660470754,-2.4741929352202097,-488244416.0,2003-01-17,2003,4,17,1,2.38,91.22,90.92,88.95,763
2003-01-21 14:30:00,90.87,90.92,88.95,89.25,89.4407119642857,93.46892857142859,94.79072520000031,89.18535000000001,91.13929979999992,90.92675149999997,90.81180879853176,91.28853587803688,92.004616923077,94.30790570839632,89.70132813775763,94.79072520000031,89.18535000000001,91.13929979999992,90.92675149999997,89.70666666666666,42370304,32792495.6,41.82178132834833,1.5,2.75,1.7136373830654124,1.2920731778645111,-0.1497588296217494,0.2081292394881018,0.3578880691098512,18.04634435822316,-3.752830799094149,-530614720.0,2003-01-21,2003,1,21,1,2.21,89.94,89.8,88.0,764
2003-01-22 14:30:00,88.77,89.8,88.0,88.17,89.6199975,93.39071428571428,94.6669252500003,89.14604990000002,91.08749999999996,90.83575099999996,90.70820845349131,90.99153246108101,91.78153923076931,94.84123111070669,88.72184735083195,94.6669252500003,89.14604990000002,91.08749999999996,90.83575099999996,88.65666666666668,42808608,33373870.8,38.3051031334726,1.5,2.75,1.719806141417883,1.2826983197885455,-0.33821238344378635,-0.06487741019488169,0.27333497324890466,18.58138051105314,-3.523361418098259,-573423328.0,2003-01-22,2003,2,22,1,2.05,88.9,89.38,87.95,765
2003-01-23 14:30:00,88.75,89.38,87.95,88.71001,89.79928303571428,93.3125,94.5497753000003,89.11175000000004,91.06870039999994,90.77025149999996,90.629847729825,90.7742446076447,91.57846230769242,95.0486661616928,88.10825845369196,94.5497753000003,89.11175000000004,91.06870039999994,90.77025149999996,88.68000333333332,56080800,35045635.6,40.97755580106266,1.5,2.75,1.6991057027451764,1.6002220830031115,-0.4066315341556879,-0.23495444444570526,0.1716770897099827,18.49367725718477,-4.4176166361383515,-517342528.0,2003-01-23,2003,3,23,1,1.63,88.66,88.67999,86.17,766
2003-01-24 14:30:00,88.59,88.67999,86.17,86.38,89.97856857142857,93.23428571428572,94.41462530000031,89.05775000000001,91.03110059999996,90.62150149999998,90.46318703453774,90.35574512120236,91.0723076923078,95.40189665732949,86.74271872728609,94.41462530000031,89.05775000000001,91.03110059999996,90.62150149999998,87.07666333333331,68700816,37933826.4,34.111566669463876,1.5,2.75,1.7591702954062352,1.811070026935116,-0.5784599775039014,-0.5513978821698942,0.02706209533400733,18.92100699677668,-7.178164624973142,-586043344.0,2003-01-24,2003,4,24,1,2.91,87.42,86.8,84.5,767
2003-01-27 14:30:00,85.73,86.8,84.5,85.2,90.15785410714285,93.15607142857141,94.2876753000003,89.02695000000001,90.95590039999996,90.41200149999996,90.25678754298723,89.86472177632594,90.493076923077,95.70539378939607,85.28076005675794,94.2876753000003,89.02695000000001,90.95590039999996,90.41200149999996,85.5,58287504,39973741.6,31.255354916765032,1.5,2.75,1.7978009885915038,1.4581448137444306,-0.7313864523062001,-0.8871709700487429,-0.1557845177425427,18.12060284481473,-8.41663979361496,-644330848.0,2003-01-27,2003,0,27,1,2.72,85.65,86.39999,85.13,768
2003-01-28 14:30:00,85.63,86.39999,85.13,85.83,90.33713964285714,93.07785714285713,94.1597253000003,88.98985010000004,90.89150039999996,90.33450149999996,90.08318803149756,89.48046255953301,90.06538461538472,95.79945685010887,84.33131238066052,94.1597253000003,88.98985010000004,90.89150039999996,90.33450149999996,85.78666333333331,46956704,41210926.4,34.41290575573196,1.5,2.75,1.7601002036921112,1.139423645666941,-0.7472719317286902,-1.0898744324034055,-0.3426025006747153,19.887302130618007,-8.036001285760205,-597374144.0,2003-01-28,2003,1,28,1,1.49,85.76,87.17999,84.77,769
2003-01-29 14:30:00,85.44,87.17999,84.77,86.48,90.51642517857141,92.99964285714287,94.03927525000034,88.96685010000002,90.80650039999996,90.25300149999997,89.94188654006626,89.19470422052986,89.57846153846162,95.37231757956111,83.78460549736212,94.03927525000034,88.96685010000002,90.80650039999996,90.25300149999997,86.14333,53780192,42401326.4,37.597617569501246,1.5,2.75,1.8065209034283891,1.2683610765534918,-0.6734504899252216,-1.1844156130812422,-0.5109651231560206,20.910459682004053,-6.40691627780479,-543593952.0,2003-01-29,2003,2,29,1,2.84,85.97,86.88,84.39999,770
2003-01-30 14:30:00,86.78999,86.88,84.39999,84.42999,90.69571071428572,92.92142857142859,93.8954252000003,88.91115000000002,90.66710039999994,90.06300099999996,89.72573373457345,88.74092191381273,88.9146146153847,94.93394601116456,82.89528321960486,93.8954252000003,88.91115000000002,90.66710039999994,90.06300099999996,85.23666,49883392,43193620.8,32.274789134313025,1.5,2.75,1.8546272674692184,1.1548786852340012,-0.7180457303654226,-1.4085222861127988,-0.6904765557473762,22.93062287280036,-8.248217778743744,-593477344.0,2003-01-30,2003,3,30,1,2.94,85.64,86.215,84.14999,771
2003-01-31 14:30:00,84.14999,86.215,84.14999,86.06,90.87499625,92.84321428571428,93.76092515000036,88.86515000000001,90.57870039999996,89.81250049999996,89.58197947047255,88.48559601725914,88.37846076923088,94.06868381205388,82.68823772640785,93.76092515000036,88.86515000000001,90.57870039999996,89.81250049999996,85.47499666666667,55321600,43727631.2,39.59726153381047,1.5,2.75,1.8696546055071317,1.2651405640285402,-0.5980376462620862,-1.438023613574984,-0.8399859673128978,28.043049833702486,-5.073902492830348,-538155744.0,2003-01-31,2003,4,31,1,2.45,85.18,86.81700000000001,85.92,772
2003-02-03 14:30:00,86.14,86.81700000000001,85.92,86.23,91.05428178571428,92.765,93.62972515000034,88.81045,90.49610039999996,89.55649999999999,89.45052929515991,88.27077734894873,87.83230692307703,92.8384884870073,82.82612535914677,93.62972515000034,88.81045,90.49610039999996,89.55649999999999,86.32233333333332,39799200,44106291.2,40.3219730616326,1.5,2.75,1.8001792765423357,0.9023474637559188,-0.4729617878878465,-1.4311882021727058,-0.9582264142848592,27.90990675307324,-3.383753501400556,-498356544.0,2003-02-03,2003,0,34,2,1.04,86.37,85.75,84.3,773
2003-02-04 14:30:00,85.31,85.75,84.3,85.38,91.23356732142857,92.68678571428572,93.49222515000034,88.75295,90.35630039999997,89.17749949999998,89.2909006953497,87.99546522047743,87.29230769230782,91.68847092752344,82.8961444570922,93.49222515000034,88.75295,90.35630039999997,89.17749949999998,85.14333333333333,43757296,44243871.2,37.87507048407024,1.5,2.75,1.8094521853607408,0.9890024270751424,-0.4152822714628366,-1.4773292536134048,-1.0620469821505685,27.29438132250996,-3.1643416127934736,-542113840.0,2003-02-04,2003,1,35,2,1.72,85.02,86.53999,84.48899999999999,774
2003-02-05 14:30:00,85.75399999999999,86.53999,84.48899999999999,84.85001,91.41285285714285,92.60857142857141,93.3614752000003,88.70695009999999,90.17150059999996,88.78349999999998,89.11674811906148,87.69589805662243,86.74077000000014,90.35567674814446,83.12586325185579,93.3614752000003,88.70695009999999,90.17150059999996,88.78349999999998,85.29299999999999,55297904,45076011.2,36.392155951964604,1.5,2.75,1.8267048864064024,1.2267701273443643,-0.3815003291514423,-1.5389223935898713,-1.157422064438429,26.888484615525797,-4.351256414016862,-597411744.0,2003-02-05,2003,2,36,2,2.43,85.51,84.89,83.64999,775
2003-02-06 14:30:00,84.37,84.89,83.64999,84.45,91.59213839285714,92.53035714285713,93.2311252000003,88.65475009999999,89.99210059999996,88.43649999999998,88.93373838890221,87.38676490837268,86.26307769230782,89.27026570986202,83.25588967475363,93.2311252000003,88.65475009999999,89.99210059999996,88.43649999999998,84.32999666666667,53655904,45821971.2,35.269742615180874,1.5,2.75,1.7847981088059446,1.170964552480885,-0.3553032921967481,-1.601551179684364,-1.246247887487616,26.132403046863452,-2.234313498495013,-651067648.0,2003-02-06,2003,3,37,2,1.48,84.27,84.99001,82.97,776
2003-02-07 14:30:00,84.91,84.99001,82.97,83.42,91.77142392857141,92.45214285714287,93.1011752000003,88.59005010000001,89.79090059999996,87.96699999999998,88.71751335404329,87.00897777424196,85.81461615384629,88.63962476568175,82.98960754201084,93.1011752000003,88.59005010000001,89.79090059999996,87.96699999999998,83.79333666666669,43168192,46237820.8,32.490936049123114,1.5,2.75,1.8015989581769485,0.93361216538994,-0.3746283008964242,-1.7145332636081465,-1.3399049627117219,22.875998793502607,-2.0892018779342734,-694235840.0,2003-02-07,2003,4,38,2,2.43,83.98,84.13,82.64999,777
2003-02-10 14:30:00,83.46600000000001,84.13,82.64999,84.00999,91.95070946428572,92.37392857142858,92.97387515000031,88.55185000000002,89.63710039999997,87.51449949999999,88.53290459506121,86.72335989098082,85.49461538461551,88.11493982004694,82.8742909491841,92.97387515000031,88.55185000000002,89.63710039999997,87.51449949999999,83.59666,45470400,46622760.8,35.619894659088246,1.5,2.75,1.778628318307166,0.9752832998255222,-0.31723476612934753,-1.7364484203734063,-1.419213654244059,22.572992064275216,-2.1204823488290767,-648765440.0,2003-02-10,2003,0,41,2,1.79,83.39,84.70700000000001,82.834,778
2003-02-11 14:30:00,84.37,84.70700000000001,82.834,83.42999,92.129995,92.29571428571428,92.8540751000003,88.5166499,89.42010019999996,87.034499,88.3327902972157,86.40970561564932,85.08846000000014,87.17093134025951,83.00598865974077,92.8540751000003,88.5166499,89.42010019999996,87.034499,83.65699666666667,46468704,47362391.2,33.953820214147875,1.5,2.75,1.7853691527137965,0.9811308682404531,-0.2887071848213183,-1.7800976352707067,-1.4913904504493884,22.025238391586342,-3.5268385753931546,-695234144.0,2003-02-11,2003,1,42,2,2.26,83.77,83.62,82.09,779
2003-02-12 14:30:00,83.16,83.62,82.09,82.10001,92.30928053571431,92.2175,92.73027515000031,88.49065,89.18250039999997,86.47299949999999,88.08836754046213,85.9992584141589,84.75923000000013,87.23669080263636,82.28176919736387,92.73027515000031,88.49065,89.18250039999997,86.47299949999999,82.60333666666666,35906304,47612566.4,30.438050610339232,1.5,2.75,1.7671284989485254,0.7541350260001948,-0.3269716363030386,-1.9001049958281868,-1.5731333595251482,22.12120767001771,-2.7596592158781568,-731140448.0,2003-02-12,2003,2,43,2,1.86,82.86,82.66,81.0,780
2003-02-13 14:30:00,82.14999,82.66,81.0,82.35001,81.0,92.13928571428572,92.60272520000031,88.47065,88.94690059999998,85.9705005,87.8633339114244,85.65171094614377,84.54000000000012,87.30979025036142,81.77020974963881,92.60272520000031,88.47065,88.94690059999998,85.9705005,82.00333666666667,58064496,48838691.2,31.866201020814643,1.5,2.75,1.7594764633093447,1.1889036043619448,-0.3035182872076656,-1.9525312185347303,-1.6490129313270647,18.935126493491317,-4.310934231931216,-673075952.0,2003-02-13,2003,3,44,2,2.05,81.83,84.2,81.82899,781
2003-02-14 14:30:00,82.37,84.2,81.82899,84.14999,80.79633333333334,92.06107142857141,92.4775752000003,88.4755499,88.77250039999996,85.57700000000001,87.71771258156461,85.50868990365389,84.4107684615386,87.0827913842815,81.7387455387957,92.4775752000003,88.4755499,88.77250039999996,85.57700000000001,83.39299333333334,59588304,49549381.6,41.22290104375447,1.5,2.75,1.80315743021582,1.2026043933512989,-0.14300299756135892,-1.8277666782787636,-1.6847636807174045,20.001127309237766,-2.4121651397425508,-613487648.0,2003-02-14,2003,4,45,2,2.9,83.01,85.8,84.39,782
2003-02-18 14:30:00,84.53,85.8,84.39,85.63,80.59266666666667,91.98285714285713,92.36192525000031,88.50874990000001,88.63610039999998,85.3255,87.63584149993464,85.52024324616305,84.34538384615401,86.8478918549282,81.84287583737978,92.36192525000031,88.50874990000001,88.63610039999998,85.3255,85.27333333333333,39512896,49743976.0,47.5954182146405,1.5,2.75,1.7922183280575463,0.7943252465383949,0.07491177923524939,-1.5911239566733428,-1.6660357359085922,22.93864031259864,0.29280862028578125,-573974752.0,2003-02-18,2003,1,49,2,1.67,85.1,85.47,84.28,783
2003-02-19 14:30:00,85.32001,85.47,84.28,85.17999,80.389,91.90464285714287,92.2499252000003,88.5170497,88.51110039999998,85.1219995,87.53953359797642,85.48783817509991,84.40307615384629,86.94499642043037,81.86115588726223,92.2499252000003,88.5170497,88.51110039999998,85.1219995,84.97666333333333,31440304,49197476.0,45.96364598906997,1.5,2.75,1.760631304624864,0.6390633535752932,0.19403988325869825,-1.4234858818352194,-1.6175257650939177,22.40702724809929,0.3888980095582855,-605415056.0,2003-02-19,2003,2,50,2,1.41,84.88,85.42,84.05,784
2003-02-20 14:30:00,85.21001,85.42,84.05,84.33,80.18533333333333,91.82642857142858,92.1442252000003,88.50304969999999,88.35710039999998,84.9299995,87.41366953531067,85.37756787270943,84.26999923076937,86.62529676224614,81.91470169929259,92.1442252000003,88.50304969999999,88.35710039999998,84.9299995,84.60000000000002,29299296,48522010.4,42.9671914608504,1.5,2.75,1.7327290685802317,0.6038351617846404,0.21903747722308387,-1.3437289185650627,-1.5627663957881466,22.879145996703844,-0.14209591474245653,-634714352.0,2003-02-20,2003,3,51,2,1.63,84.74,85.74001,83.46001,785
2003-02-21 14:30:00,84.38,85.74001,83.46001,85.17999,79.98166666666667,91.74821428571428,92.0446251000003,88.52734960000002,88.27070019999998,84.75349849999999,87.32607425941612,85.35875093245141,84.18922923076937,86.3326131030464,82.04584535849233,92.0446251000003,88.52734960000002,88.27070019999998,84.75349849999999,84.79333666666669,60965200,48766230.4,46.70859919795619,1.5,2.75,1.7718198493959292,1.2501519904232743,0.2917149973307356,-1.198122649124727,-1.4898376464554626,23.466815619427997,2.109793814432992,-573749152.0,2003-02-21,2003,4,52,2,2.73,84.6,85.0,83.59,786
2003-02-24 14:30:00,84.92999,85.0,83.59,83.8,79.778,91.67,91.91857515000031,88.54744970000002,88.13270019999999,84.6244985,87.18779683747826,85.21029846269413,84.06769076923092,86.10370047736745,82.03168106109439,91.91857515000031,88.54744970000002,88.13270019999999,84.6244985,84.13,30648800,46863629.6,41.90245738890097,1.5,2.75,1.7588320030105056,0.6539997064162525,0.2474905042864459,-1.180474516097405,-1.427965020383851,24.393687137794892,-0.2499583680464725,-604397952.0,2003-02-24,2003,0,55,2,1.69,84.3,84.49001,82.22,787
2003-02-25 14:30:00,82.95,84.49001,82.22,84.47,79.57433333333333,91.59178571428572,91.80217515000031,88.53494970000001,88.00650019999998,84.5879985,87.08121656934185,85.13979384719944,84.03845923076939,86.03930993747473,82.03760852406404,91.80217515000031,88.53494970000001,88.00650019999998,84.5879985,83.72667000000001,56901296,46794319.2,44.8685369902902,1.5,2.75,1.7953447170811836,1.215987260265558,0.26257390689788696,-1.0997476367614922,-1.3623215436593792,24.489492323762914,1.2465661328737965,-547496656.0,2003-02-25,2003,1,56,2,2.76,83.36,84.53,83.08,788
2003-02-26 14:30:00,84.024,84.53,83.08,83.24001,79.37066666666666,91.51357142857141,91.6897752000003,88.53584990000002,87.85590040000001,84.458499,86.93058101760296,84.95886205222806,83.94538307692324,85.97338669497447,81.91737945887202,91.6897752000003,88.53584990000002,87.85590040000001,84.458499,83.61667,37799392,46336453.6,40.7549828731273,1.5,2.75,1.7706772372896709,0.8157592794283246,0.19218827050844056,-1.1220862055238283,-1.314274476032269,25.72253541499773,1.388550378982902,-585296048.0,2003-02-26,2003,2,57,2,1.75,83.8,84.75,83.16,789
2003-02-27 14:30:00,83.7,84.75,83.16,84.34,79.167,91.43535714285713,91.57212520000034,88.55614990000002,87.75590039999999,84.351499,86.82898960514791,84.89992280915871,84.01615230769245,86.03004124660013,82.00226336878477,91.57212520000034,88.55614990000002,87.75590039999999,84.351499,84.08333333333333,51829008,46238894.4,45.56173189109462,1.5,2.75,1.7577717203404093,1.1208963508435443,0.2201778720476697,-1.039052135972682,-1.2592300080203516,24.57727083457395,2.4165024387975254,-533467040.0,2003-02-27,2003,3,58,2,1.91,83.96,85.23,84.16,790
2003-02-28 14:30:00,84.47,85.23,84.16,84.89999,78.96333333333334,91.35714285714286,91.44552515000035,88.59714980000004,87.62090040000001,84.374999,86.7533425618088,84.89992920828647,84.08461384615399,86.15278907027474,82.01643862203323,91.44552515000035,88.59714980000004,87.62090040000001,84.374999,84.76333000000001,43888800,45939164.8,47.88008474209979,1.5,2.75,1.7086451688875233,0.9553678259296522,0.27339653734287483,-0.917484336341758,-1.1908808736846328,24.681095345761808,0.8912657030618779,-489578240.0,2003-02-28,2003,4,59,2,1.27,84.7,85.78,83.72,791
2003-03-03 14:30:00,85.25999,85.78,83.72,84.09,78.75966666666666,91.27892857142858,91.3170252000003,88.64674980000004,87.4857002,84.276499,86.64889775546335,84.82279309321156,84.13538384615397,86.16890079850857,82.10186689379937,91.3170252000003,88.64674980000004,87.4857002,84.276499,84.53,42935392,45319854.4,44.901434436568756,1.5,2.75,1.7337419425384144,0.9473859209927206,0.2515864315697276,-0.8763978342224732,-1.1279842657922008,22.493985617029463,-1.7984351278757351,-532513632.0,2003-03-03,2003,0,62,3,2.46,84.75,84.00999,82.64999,792
2003-03-04 14:30:00,83.95,84.00999,82.64999,82.75,78.556,91.20071428571428,91.17897520000034,88.67054980000003,87.34470019999998,84.102499,86.4959998042687,84.6253842271914,84.18538307692322,86.04038994757472,82.33037620627171,91.17897520000034,88.67054980000003,87.34470019999998,84.102499,83.13665999999999,31475392,44903664.0,40.42135883262404,1.5,2.75,1.7127610894999563,0.7009537573593103,0.1494956510556622,-0.9411147019726228,-1.0906103530282851,21.13080089773525,-2.8527709383389266,-563989024.0,2003-03-04,2003,1,63,3,1.65,83.33,83.53999,82.36,793
2003-03-05 14:30:00,82.61,83.53999,82.36,83.45,78.35233333333333,91.1225,91.04172525000031,88.72404970000004,87.2305002,84.005999,86.37654883155227,84.51344287222079,84.26999769230784,85.86446242531122,82.67553295930446,91.04172525000031,88.72404970000004,87.2305002,84.005999,83.11666333333334,44105200,44921059.2,43.587832214969815,1.5,2.75,1.6747060116785308,0.9818379349345352,0.13228556968007554,-0.9252533909281908,-1.0575389606082664,22.127586236371183,-1.0435195066998642,-519883824.0,2003-03-05,2003,2,64,3,1.43,82.95,83.52,82.47,794
2003-03-06 14:30:00,82.87,83.52,82.47,82.75,78.14866666666667,91.04428571428572,90.9069752500003,88.74524970000004,87.08569999999996,83.90099849999999,86.23433123031494,84.3454959320093,84.16230615384629,85.95182752192007,82.37278478577254,90.9069752500003,88.74524970000004,87.08569999999996,83.90099849999999,82.91333333333334,41412400,44226784.0,41.22809727419015,1.5,2.75,1.6300841537014932,0.9363647151011476,0.07953301209947528,-0.9581226954839224,-1.0376557075833976,21.934651364160477,-2.8527709383389266,-561296224.0,2003-03-06,2003,3,65,3,1.27,83.0,83.99001,81.42999,795
2003-03-07 14:30:00,81.61,83.99001,81.42999,83.32001,77.945,90.96607142857141,90.7800753000003,88.73684980000004,86.95170019999998,83.84449899999998,86.12004412324377,84.24783060515126,83.98461461538477,85.60682856028762,82.36240067048189,90.7800753000003,88.73684980000004,86.95170019999998,83.84449899999998,82.91333666666667,63582704,44723124.0,43.89184480694975,1.5,2.75,1.6965081427228146,1.42169639133438,0.08813629464621077,-0.927485339275634,-1.015621633921845,21.374847179208906,-0.5727804295942731,-497713520.0,2003-03-07,2003,4,66,3,3.14,82.71,82.86,81.10001,796
2003-03-10 14:30:00,82.60001,82.86,81.10001,81.32001,77.74133333333333,90.88785714285713,90.64197535000031,88.70374990000003,86.79100039999999,83.73949949999998,85.93180749095968,83.96899054751779,83.6876930769232,85.69366209394231,81.68172405990406,90.64197535000031,88.70374990000003,86.79100039999999,83.73949949999998,81.76000666666667,41027504,44616089.6,37.474045987909946,1.5,2.75,1.7339004182426134,0.9195674557727264,-0.02946768379441189,-1.0524562386648595,-1.0229885548704478,23.660690714980568,-3.7291227654788712,-538741024.0,2003-03-10,2003,0,69,3,2.17,81.98,82.0,80.48,797
2003-03-11 14:30:00,81.48,82.0,80.48,80.52,77.53766666666667,90.80964285714286,90.4940753000003,88.62194990000003,86.61360040000001,83.56499999999997,85.71957974621617,83.64051525727801,83.39461615384629,85.97160373241155,80.81762857528102,90.4940753000003,88.62194990000003,86.61360040000001,83.56499999999997,81.0,48114496,44748294.4,35.25352483836956,1.5,2.75,1.7186218169395693,1.0752252492555336,-0.14336321228311433,-1.2021925702243408,-1.0588293579412265,22.83819724176039,-3.2676713998472637,-586855520.0,2003-03-11,2003,1,70,3,1.89,81.24,81.10001,79.383,798
2003-03-12 14:30:00,80.38,81.10001,79.383,81.06,79.383,90.73142857142858,90.35592530000037,88.56704990000004,86.4872004,83.44650049999997,85.5368511287175,83.39475189944201,83.07769384615395,85.71120377439965,80.44418391790828,90.35592530000037,88.56704990000004,86.4872004,83.44650049999997,80.51433666666667,62475392,45548628.8,37.92720029968617,1.5,2.75,1.7185066871581716,1.3716195996661924,-0.16312070292725145,-1.2627302366002908,-1.0996095336730394,22.74563836672203,-3.889020630780177,-524380128.0,2003-03-12,2003,2,71,3,2.16,80.24,83.91,81.53,799
2003-03-13 14:30:00,82.17999,83.91,81.53,83.86,79.29316666666666,90.65321428571428,90.23472525000037,88.52294990000004,86.40220040000001,83.53449999999995,85.47109226092465,83.4390612423523,83.08230923076935,85.72107159086434,80.44354687067434,90.23472525000037,88.52294990000004,86.40220040000001,83.53449999999995,83.10000000000002,72161184,47361372.8,49.55852745704753,1.5,2.75,1.7993276380754446,1.5236294839832007,0.021761130405804074,-1.0724081206657845,-1.0941692510715884,29.99834629186259,-1.2249589193120085,-452218944.0,2003-03-13,2003,3,72,3,2.92,82.72,84.77,83.35001,800
2003-03-14 14:30:00,84.2,84.77,83.35001,84.13,79.20333333333333,90.575,90.11887525000036,88.47784990000004,86.32020040000002,83.62349949999995,85.41850040755507,83.50486493355682,83.05615538461552,85.645663508188,80.46664726104301,90.11887525000036,88.47784990000004,86.32020040000002,83.62349949999995,84.08333666666665,63963808,47656338.4,50.521328134336244,1.5,2.75,1.772232092498627,1.3421888912892226,0.16370682880247855,-0.8895357150684902,-1.0532425438709687,29.76317615238809,0.04756808181709126,-388255136.0,2003-03-14,2003,4,73,3,1.7,84.06,86.95,83.22,801
2003-03-17 14:30:00,83.46001,86.95,83.22,86.78,79.11349999999999,90.49678571428572,90.01777525000034,88.44394990000004,86.2344002,83.75499999999995,85.47189254843526,83.81678255893237,83.32846230769245,86.59424281103105,80.0626818043538,90.01777525000034,88.44394990000004,86.2344002,83.75499999999995,85.65000000000002,88287008,49091273.6,58.827846140401896,1.5,2.75,1.9120726573201536,1.798425698208001,0.422812880476809,-0.5247264432749574,-0.9475393237517664,34.20820558940739,4.870090634441089,-299968128.0,2003-03-17,2003,0,76,3,4.48,85.08,87.35001,86.28,802
2003-03-18 14:30:00,87.15401,87.35001,86.28,87.28999,79.02366666666666,90.41857142857144,89.91812520000036,88.42164980000004,86.1531998,83.83799949999995,85.54319048771232,84.14756421998644,83.55538461538472,87.42492531869762,79.68584391207185,89.91812520000036,88.42164980000004,86.1531998,83.83799949999995,86.97333333333334,51081008,49669679.2,60.21221311498976,1.5,2.75,1.8519253246544285,1.028414292637509,0.6042358896038399,-0.19224446174696647,-0.7964803513508064,31.94701432085647,4.601545835829838,-248887120.0,2003-03-18,2003,1,77,3,1.24,86.82,88.16,86.67999,803
2003-03-19 14:30:00,87.28,88.16,86.67999,87.96001,78.93383333333333,90.34035714285713,89.83607525000036,88.39924990000004,86.0531998,83.97700049999995,85.63796772348829,84.51065429427344,83.79077076923089,88.28130258208824,79.30023895637353,89.83607525000036,88.39924990000004,86.0531998,83.97700049999995,87.6,49659200,50580624.0,62.019071081640504,1.5,2.75,1.8253599443219688,0.9817830638072002,0.7362937436310726,0.12388682818803433,-0.6124069154430383,31.922740890638558,6.296084592145013,-199227920.0,2003-03-19,2003,2,78,3,1.71,87.42,88.59,86.35001,804
2003-03-20 14:30:00,87.33,88.59,86.35001,88.14999,78.844,90.26214285714286,89.75367520000036,88.39714980000002,85.96159960000001,84.16799999999995,85.73647840099856,84.85725769481883,84.10307769230779,89.16214839025456,79.04400699436107,89.75367520000036,88.39714980000002,85.96159960000001,84.16799999999995,87.69666666666667,67461632,52488740.8,62.53854491257249,1.5,2.75,1.8549763768704,1.2852591045582866,0.7981745901626877,0.3853113222603213,-0.4128632679023664,30.82398502469137,5.796902808821082,-131766288.0,2003-03-20,2003,3,79,3,2.59,87.47,89.88,87.92999,805
2003-03-21 14:30:00,88.8,89.88,87.92999,89.67,78.75416666666666,90.18392857142858,89.67397520000036,88.39184980000002,85.92719960000002,84.39250049999995,85.89073414997902,85.31561410483609,84.6353853846155,90.41751630854765,78.85325446068336,89.67397520000036,88.39184980000002,85.92719960000002,84.39250049999995,89.15999666666666,71263632,53003662.4,66.48787394800814,1.5,2.75,1.861764492808228,1.3445039224308395,0.8958861577844798,0.7069944293282333,-0.18889172845624647,31.441455344769487,10.268063174119145,-60502656.0,2003-03-21,2003,4,80,3,2.22,88.9,88.14,86.35001,806
2003-03-24 14:30:00,88.02,88.14,86.35001,86.69,78.66433333333333,90.10571428571428,89.59012515000035,88.36264980000001,85.80479959999998,84.53700049999995,85.92207790880337,85.44650799961359,84.88461615384628,90.71995065972116,79.04928164797141,89.59012515000035,88.36264980000001,85.80479959999998,84.53700049999995,87.06000333333333,65430400,54742742.4,54.38308963583921,1.5,2.75,1.9659234576076403,1.1952342380275052,0.7217114942648821,0.7132476393748561,-0.008463854890025935,35.180641925862716,7.6626924987580765,-125933056.0,2003-03-24,2003,0,83,3,2.07,87.25,88.25999,86.44,807
2003-03-25 14:30:00,86.74001,88.25999,86.44,87.52,78.5745,90.0275,89.51102515000035,88.35214970000004,85.69399959999998,84.68950049999997,85.98474152022284,85.64398342822183,85.25153923076935,91.10368170236755,79.39939675917115,89.51102515000035,88.35214970000004,85.69399959999998,84.68950049999997,87.40666333333333,61177600,54956557.6,56.745175473287595,1.5,2.75,1.955499639207095,1.1131992736022458,0.627754704711789,0.7762295259997103,0.14847482128792133,33.626646953693985,7.969405378731794,-64755456.0,2003-03-25,2003,1,84,3,2.11,87.35,87.85001,86.8,808
2003-03-26 14:30:00,87.56,87.85001,86.8,87.08,78.48466666666666,89.94928571428572,89.42772510000036,88.32864980000002,85.5749996,84.88149999999995,86.02769283315527,85.78074691124833,85.54076923076936,91.35400529786301,79.72753316367572,89.42772510000036,88.32864980000002,85.5749996,84.88149999999995,87.24333666666666,45757808,55354478.4,55.115858242193156,1.5,2.75,1.8908218078351595,0.8266324482248215,0.5065230816448307,0.7816286733439597,0.27510559169912896,34.497036194144826,3.8397328881469104,-110513264.0,2003-03-26,2003,2,85,3,1.21,87.33,87.66,85.99001,809
2003-03-27 14:30:00,86.39999,87.66,85.99001,87.14999,78.39483333333331,89.87107142857144,89.35367500000038,88.31494970000001,85.45139939999999,85.02199949999995,86.07170448675703,85.91115101493897,85.98922923076935,91.30943279186508,80.66902566967363,89.35367500000038,88.31494970000001,85.45139939999999,85.02199949999995,86.93333333333334,53291392,55427597.6,55.33554644324207,1.5,2.75,1.8750481072755047,0.9614595311271438,0.40594318514787453,0.7825345731339723,0.3765913879860977,30.043633512090906,3.5896707476524514,-57221872.0,2003-03-27,2003,3,86,3,1.94,86.83,87.28,86.25,810
2003-03-28 14:30:00,86.47,87.28,86.25,86.71001,78.30499999999998,89.79285714285713,89.27432505000036,88.27934980000002,85.33759979999998,85.11250049999997,86.09673607551167,85.98723282304,86.46538384615397,90.7495045793936,82.18126311291434,89.27432505000036,88.27934980000002,85.33759979999998,85.11250049999997,86.74667,32600704,54863192.8,53.56077558232344,1.5,2.75,1.8146875281843973,0.5942181330722699,0.2901096344994117,0.7392284311103623,0.4491187966109506,30.47863180488741,-0.0806522240147548,-89822576.0,2003-03-28,2003,4,87,3,1.19,86.76,86.59,84.39999,811
2003-03-31 14:30:00,85.35001,86.59,84.39999,84.74001,78.21516666666666,89.71464285714286,89.19027510000036,88.21544990000002,85.19200000000001,85.14500099999997,86.04353113137394,85.8684496970362,86.74846153846167,89.90423795792977,83.59268511899356,89.19027510000036,88.21544990000002,85.19200000000001,85.14500099999997,85.24333333333334,60785904,55755718.4,46.38693475839095,1.5,2.75,1.8500684190283685,1.0902182905063242,0.07248405453758218,0.5397238647829283,0.4672398102453462,27.987690915447835,-2.921274249200859,-150608480.0,2003-03-31,2003,0,90,3,2.59,85.49,86.39,84.91,812
2003-04-01 14:30:00,85.25,86.39,84.91,86.03999,78.12533333333333,89.63642857142858,89.11347510000036,88.15734970000003,85.09959980000001,85.30950049999997,86.04339226347693,85.88478686874704,86.9161530769232,89.64264203448994,84.18966411935648,89.11347510000036,88.15734970000003,85.09959980000001,85.30950049999997,85.77999666666666,53780096,56870953.6,51.04648391214328,1.5,2.75,1.835777103383485,0.9456513843298734,0.010982773660441205,0.4809682773208976,0.4699855036604565,29.469298580067147,-2.182832857795257,-96828384.0,2003-04-01,2003,1,91,4,1.74,85.65,88.77,87.5,813
2003-04-02 14:30:00,87.53999,88.77,87.5,88.12,78.03549999999998,89.5582142857143,89.03347510000036,88.10814980000004,85.0769998,85.54300049999995,86.12482786098762,86.09766430981874,87.22307615384628,89.48456898859995,84.9615833190926,89.03347510000036,88.10814980000004,85.0769998,85.54300049999995,88.13,50498096,57190598.4,57.42272280366403,1.5,2.75,1.899650881713236,0.8829789757891395,0.1003158379338262,0.5953803010777392,0.495064463143913,32.60125962869313,-0.03402155802853518,-46330288.0,2003-04-02,2003,2,92,4,1.45,88.14,88.99001,87.64999,814
2003-04-03 14:30:00,88.87,88.99001,87.64999,87.7,77.94566666666665,89.48,88.94712510000036,88.07754990000004,85.06759979999998,85.79050049999995,86.18659931741949,86.25026770888365,87.29384538461552,89.5530262552269,85.03466451400415,88.94712510000036,88.07754990000004,85.06759979999998,85.79050049999995,88.11333333333334,49009392,57570448.0,55.84109898320774,1.5,2.75,1.859677247305147,0.851294261250147,0.11973252294836145,0.6447301168293649,0.5249975938810034,32.69004388510456,-2.1969443515110947,-95339680.0,2003-04-03,2003,3,93,4,1.53,88.32,88.59,87.62,815
2003-04-04 14:30:00,88.42999,88.59,87.62,88.22,77.85583333333331,89.40178571428572,88.87562510000036,88.06325000000002,85.0577996,86.03549999999996,86.26634052065793,86.43786126041853,87.36538461538477,89.67781819713717,85.05295103363234,88.87562510000036,88.06325000000002,85.0577996,86.03549999999996,88.14333333333332,36261808,56204403.2,57.40537348702961,1.5,2.75,1.7961288724976363,0.6451773515139824,0.15402483058520067,0.7175286321125043,0.5635038015273036,31.079980437436433,1.7649094474564553,-59077872.0,2003-04-04,2003,4,94,4,1.11,88.1,90.85001,87.97,816
2003-04-07 13:30:00,90.34,90.85001,87.97,88.05,77.76599999999998,89.32357142857144,88.80982505000038,88.06115010000002,85.0911996,86.37199949999996,86.33628795122038,86.59139828323582,87.37230692307706,89.69234541187781,85.0522684342763,88.80982505000038,88.06115010000002,85.0911996,86.37199949999996,88.95666999999997,69821184,57644087.2,56.69825102385295,1.5,2.75,1.87354895303352,1.2112462420950607,0.15145798908220087,0.7528262878800547,0.6013682987978538,23.478608642077305,0.6055758683729446,-128899056.0,2003-04-07,2003,0,97,4,3.27,89.41,88.64999,87.71001,817
2003-04-08 13:30:00,88.3,88.64999,87.71001,88.19,77.67616666666666,89.24535714285715,88.75437505000036,88.05345000000001,85.15099959999998,86.75549949999996,86.4089825413686,86.7436460657848,87.37538461538477,89.69964385402668,85.05112537674285,88.75437505000036,88.05345000000001,85.15099959999998,86.75549949999996,88.18333333333334,39741392,57225432.0,57.16619359179159,1.5,2.75,1.8068654563882685,0.6944708080141709,0.1453613774413932,0.7830700205995953,0.6377086431582021,22.929163691995157,1.2746899402847949,-89157664.0,2003-04-08,2003,1,98,4,1.07,88.18,89.10001,86.77,818
2003-04-09 13:30:00,88.36,89.10001,86.77,87.03,77.58633333333333,89.16714285714286,88.69052505000036,88.03325000000002,85.17499959999998,87.05399949999996,86.43333616719727,86.77091786904337,87.17230769230784,89.08381100481886,85.26080437979681,88.69052505000036,88.03325000000002,85.17499959999998,87.05399949999996,87.63333666666664,55678000,56885562.4,52.13858992297615,1.5,2.75,1.8442329237891064,0.978772075917808,0.05407769777185945,0.7053057653730264,0.6512280676011669,24.13660442377045,-0.13768217299852975,-144835664.0,2003-04-09,2003,2,99,4,2.69,87.94,87.63,85.71001,819
2003-04-10 13:30:00,87.095,87.63,85.71001,87.50999,77.4965,89.08892857142858,88.64027500000034,88.00104990000004,85.19559939999998,87.23649899999998,86.47555788613072,86.84130569103924,87.23538384615398,89.13313010342024,85.33763758888772,88.64027500000034,88.00104990000004,85.19559939999998,87.23649899999998,86.95,42126000,55383803.2,53.943564004879846,1.5,2.75,1.8496441435184559,0.7606194873955495,0.018722732009394002,0.6746314826129094,0.6559087506035154,24.34693801477469,0.9225924434791382,-102709664.0,2003-04-10,2003,3,100,4,2.24,86.67,88.70100000000001,86.86,820
2003-04-11 13:30:00,88.16,88.70100000000001,86.86,87.14999,77.40666666666667,89.0107142857143,88.58742495000034,87.95854990000004,85.24999940000001,87.38749849999996,86.50200620432167,86.87070419665454,87.20692153846169,89.09782585614715,85.31601722077622,88.58742495000034,87.95854990000004,85.24999940000001,87.38749849999996,87.57033,47735504,54572388.0,52.348975382488696,1.5,2.75,1.8490267046957087,0.8747189879248092,-0.0333727059924398,0.6141928681129656,0.6475655741054054,24.275728605491427,2.8439694543345047,-150445168.0,2003-04-11,2003,4,101,4,2.12,87.78,89.0,87.0,821
2003-04-14 13:30:00,87.47,89.0,87.0,88.95,77.3168333333333,88.9325,88.53502500000035,87.94324990000004,85.30779939999998,87.49599849999996,86.59800596101496,87.06873236840174,87.35076769230784,89.45378079362803,85.2477545909877,88.53502500000035,87.94324990000004,85.30779939999998,87.49599849999996,88.31666666666666,36947504,52005412.8,58.8921809030262,1.5,2.75,1.8598105115031582,0.7104549701795656,0.04469303643696332,0.7034318696516095,0.6587388332146462,21.545608207283653,3.3821598538075137,-113497664.0,2003-04-14,2003,0,104,4,2.3,88.0,89.78,88.42,822
2003-04-15 13:30:00,88.84,89.78,88.42,89.78,77.22699999999998,88.85428571428572,88.48912495000035,87.93744990000003,85.37879939999998,87.62049899999997,86.72279004097513,87.32694833331585,87.55307615384632,90.01524798970009,85.09090431799254,88.48912495000035,87.93744990000003,85.37879939999998,87.62049899999997,89.32666666666668,49957008,51949212.8,61.51629691501154,1.5,2.75,1.824109760681504,0.9616509145640028,0.13824331335360607,0.8315429749066539,0.6932996615530478,20.75634239676784,1.8837948252383077,-63540656.0,2003-04-15,2003,1,105,4,1.54,89.1,90.06599,88.03,823
2003-04-16 13:30:00,89.91,90.06599,88.03,88.25,77.13716666666666,88.77607142857143,88.44522495000034,87.89624990000004,85.43619939999998,87.63499849999997,86.78268062760357,87.41485801585718,87.67153692307708,90.10811440248268,85.2349594436715,88.44522495000034,87.89624990000004,85.43619939999998,87.63499849999997,88.78199666666669,51809296,52056717.6,54.59751710461296,1.5,2.75,1.839244063489968,0.9952470764311118,0.08567016531652083,0.8003873681986988,0.714717202882178,19.909719097509488,0.6271379703534745,-115349952.0,2003-04-16,2003,2,106,4,2.31,89.05,89.72,88.194,824
2003-04-17 13:30:00,88.3,89.72,88.194,89.56,77.04733333333333,88.69785714285715,88.41817495000036,87.85094990000003,85.53039919999998,87.70549899999996,86.8915951127956,87.61915725244222,88.04230538461556,90.00192067715656,86.08269009207453,88.41817495000036,87.85094990000003,85.53039919999998,87.70549899999996,89.15799999999999,37483392,50557805.6,58.86360770221039,1.5,2.75,1.8168694875263984,0.7413967349880392,0.12531256229884136,0.8713579057557297,0.7460453434568883,21.244254878324682,1.5189299478576326,-77866560.0,2003-04-17,2003,3,107,4,1.73,88.96,90.16,89.06,825
2003-04-21 13:30:00,89.86,90.16,89.06,89.64999,76.95749999999998,88.61964285714286,88.38887495000039,87.81324980000004,85.63439899999999,87.70449849999996,86.9997674613134,87.81256989506676,88.31999769230788,90.07877462750132,86.56122075711441,88.38887495000039,87.81324980000004,85.63439899999999,87.70449849999996,89.62333000000002,32082800,48598764.0,59.1475799498952,1.5,2.75,1.765664524131655,0.6601567068660429,0.1425319557197866,0.9242102881066216,0.7816783323868349,21.108516190579305,1.817137989778541,-45783760.0,2003-04-21,2003,0,111,4,1.24,89.61,91.56,88.89,826
2003-04-22 13:30:00,89.10001,91.56,88.89,91.34,76.86766666666666,88.54142857142858,88.34902495000038,87.79184980000004,85.792799,87.93699849999994,87.16997265890896,88.14851561934613,88.56769000000017,90.94295086865515,86.1924291313452,88.34902495000038,87.79184980000004,85.792799,87.93699849999994,90.59666666666664,59860608,48320274.4,64.15241033438372,1.5,2.75,1.8302599152651085,1.2388300510147765,0.2465790551605982,1.0899021513375828,0.8433230961769846,23.061558666179717,3.571833541217832,14076848.0,2003-04-22,2003,1,112,4,3.0,90.22,92.35001,91.24001,827
2003-04-23 13:30:00,91.62,92.35001,91.24001,92.17999,76.7778333333333,88.4632142857143,88.31957485000038,87.79664970000003,85.956199,88.16999799999996,87.36644392718705,88.53246556036078,88.91230461538478,91.90398610574007,85.92062312502951,88.31957485000038,87.79664970000003,85.956199,88.16999799999996,91.92333666666666,44250608,47473924.8,66.35846801950993,1.5,2.75,1.7788127784604577,0.9321034270164241,0.3447854635772869,1.2743049256485932,0.9295194620713064,23.219653843457927,5.9174882224520315,58327456.0,2003-04-23,2003,2,113,4,1.22,91.8,92.08,90.96001,828
2003-04-24 13:30:00,91.53,92.08,90.96001,91.36,76.68799999999997,88.385,88.29837480000039,87.76744970000004,86.11479920000001,88.38399799999996,87.52305396925811,88.80175455461212,89.15384307692324,92.38072584041494,85.92696031343151,88.29837480000039,87.76744970000004,86.11479920000001,88.38399799999996,91.46667,50017296,47686899.2,62.32622366846025,1.5,2.75,1.7388961514275685,1.0488687006094957,0.3274610164069758,1.338845732580026,1.0113847161730505,22.12961567483745,4.399509130329003,8310160.0,2003-04-24,2003,3,114,4,1.23,91.52,91.47,90.02,829
2003-04-25 13:30:00,91.3,91.47,90.02,90.23,76.59816666666666,88.30678571428572,88.28892480000039,87.72994970000003,86.27739899999997,88.53799849999996,87.62920871556173,88.93777793036335,89.32153538461556,92.52804727590159,86.1150234933295,88.28892480000039,87.72994970000003,86.27739899999997,88.53799849999996,90.57333333333334,43923696,47218514.4,57.170636989457094,1.5,2.75,1.7182607120398852,0.930221896180622,0.218101779452244,1.2840119404883552,1.0659101610361112,24.229529848145038,3.5341484261788225,-35613536.0,2003-04-25,2003,4,115,4,1.61,90.74,92.19,90.3,830
2003-04-28 13:30:00,90.44,92.19,90.3,91.78999,76.50833333333333,88.22857142857143,88.2835247500004,87.70654960000005,86.46619859999998,88.79199749999997,87.79237660906912,89.20941717509065,89.59845769230786,92.98310917884457,86.21380620577116,88.2835247500004,87.70654960000005,86.46619859999998,88.79199749999997,91.42666333333334,46469104,47911934.4,61.86098248494154,1.5,2.75,1.7355278040370357,0.9698857827789978,0.2279614905996055,1.3508620242856182,1.1229005336860127,24.981942889260846,3.1927937043282744,10855568.0,2003-04-28,2003,0,118,4,2.09,91.24,92.8,91.39999,831
2003-04-29 13:30:00,92.14,92.8,91.39999,91.78999,76.4185,88.15035714285715,88.2832246500004,87.69574950000002,86.6189986,89.14449649999996,87.94914576165462,89.4551860155582,89.96461076923094,93.18447782005195,86.74474371840991,88.2832246500004,87.69574950000002,86.6189986,89.14449649999996,91.99665999999999,52340192,47489648.8,61.86098248494154,1.5,2.75,1.7115622466058185,1.1021389570688929,0.21195397868390956,1.3878430070408996,1.1758890283569898,23.10207850364379,2.238794831811096,10855568.0,2003-04-29,2003,1,119,4,1.53,92.1,92.57001,91.41,832
2003-04-30 13:30:00,91.91,92.57001,91.41,91.91,76.32866666666666,88.07214285714286,88.2810746500004,87.69034950000002,86.74459859999997,89.43799699999997,88.10447337884466,89.68897782360027,90.30307307692324,93.33950093929913,87.26664521454741,88.2810746500004,87.69034950000002,86.74459859999997,89.43799699999997,91.96333666666666,48912496,47246268.8,62.23002374043168,1.5,2.75,1.672165657562546,1.035266852649325,0.1877482045529073,1.410574284048124,1.2228260794952168,22.777824038191238,4.147308781869683,59768064.0,2003-04-30,2003,2,120,4,1.27,91.99,92.73100000000001,90.5,833
2003-05-01 13:30:00,91.92,92.73100000000001,90.5,91.89999,76.23883333333332,87.99392857142858,88.28777460000042,87.69504950000002,86.87899859999997,89.62699649999998,88.25331716790957,89.89955041182883,90.66845769230787,93.20054651547396,88.13636886914179,88.28777460000042,87.69504950000002,86.87899859999997,89.62699649999998,91.71033,50405808,47241654.4,62.17598199141447,1.5,2.75,1.7120823963080782,1.066978043851064,0.1509473363848799,1.4115102499763168,1.2605629135914371,19.264308201041747,2.61276239392586,9362256.0,2003-05-01,2003,3,121,5,2.47,91.62,93.47,91.491,834
2003-05-02 13:30:00,91.56,93.47,91.491,93.21001,76.14899999999999,87.9157142857143,88.3001246000004,87.7068496,87.05659879999997,89.90249699999997,88.44769727897194,90.21483227736894,90.99615076923094,93.65337345959757,88.33892807886428,88.3001246000004,87.7068496,87.05659879999997,89.90249699999997,92.72367,50236608,47303015.2,66.30056950758029,1.5,2.75,1.7311479394289295,1.0620170360725758,0.19207846085798108,1.5006609896639134,1.3085825288059325,19.14926910626135,3.971021078753042,59598864.0,2003-05-02,2003,4,122,5,2.16,92.48,93.78,92.5,835
2003-05-05 13:30:00,93.47,93.78,92.5,93.03,76.05916666666666,87.8375,88.3262746000004,87.74214959999999,87.21359899999999,90.14299699999997,88.6273954248946,90.4829434890481,91.24615076923094,94.00813029264187,88.48417124582,88.3262746000004,87.74214959999999,87.21359899999999,90.14299699999997,93.10333333333334,35453296,47262589.6,65.24768351462707,1.5,2.75,1.6989230866125775,0.7501344361376254,0.18437166773010996,1.5390471134685697,1.3546754457384598,19.389199834672603,1.8502299102255284,24145568.0,2003-05-05,2003,0,125,5,1.38,93.14,94.38,93.0,836
2003-05-06 13:30:00,93.03999,94.38,93.0,93.91,75.96933333333331,87.75928571428572,88.3722745500004,87.77424959999999,87.41579899999998,90.43599699999996,88.83455638862421,90.80932982342445,91.68153538461556,94.18983678684532,89.17323398238578,88.3722745500004,87.77424959999999,87.41579899999998,90.43599699999996,93.76333333333332,44584096,46000735.2,67.92899564848639,1.5,2.75,1.6761428661402502,0.9692039878527854,0.21368535832632896,1.6217821436463709,1.4080967853200421,17.403394475123513,1.8767739072221563,68729664.0,2003-05-06,2003,1,126,5,1.48,93.69,94.14,92.97200000000001,837
2003-05-07 13:30:00,93.42,94.14,92.97200000000001,93.39,75.87949999999998,87.68107142857143,88.4282245500004,87.80034959999998,87.59419899999997,90.69599699999998,89.01320123612915,91.05510793547928,91.97615076923096,94.31230038147855,89.64000115698333,88.4282245500004,87.80034959999998,87.59419899999997,90.69599699999998,93.50066666666667,41442000,46085765.6,64.74986876032493,1.5,2.75,1.6398469471302328,0.8992364444955646,0.17483433731475673,1.6266397069634877,1.451805369648731,17.47684381951679,2.2219789842381803,27287664.0,2003-05-07,2003,2,127,5,1.26,93.56,93.33700999999999,92.28,838
2003-05-08 13:30:00,92.52,93.33700999999999,92.28,92.45,75.78966666666666,87.60285714285715,88.4907245500004,87.8171496,87.77839879999998,90.96699699999998,89.14797765824173,91.18795479876695,92.19153615384631,94.108874992607,90.27419731508566,88.4907245500004,87.8171496,87.77839879999998,90.96699699999998,92.68900333333332,40754800,45339605.6,59.343165084796745,1.5,2.75,1.6020007366209303,0.8988785733945599,0.06809372873352149,1.5369225305656329,1.4688288018321114,17.74051415832995,2.46037903136429,-13467136.0,2003-05-08,2003,3,128,5,1.15,92.81,93.8,92.61,839
2003-05-09 13:30:00,92.83,93.8,92.61,93.73,75.69983333333332,87.52464285714287,88.53577455000038,87.86104959999999,87.96619879999996,91.27799749999998,89.32766480889893,91.43005434174152,92.37538230769249,94.38688588618301,90.36387872920194,88.53577455000038,87.86104959999999,87.96619879999996,91.27799749999998,93.38,33639696,44915290.4,63.77850442964247,1.5,2.75,1.5840006840051493,0.7489586664233168,0.0659167752793044,1.551224770931242,1.4853079956519375,16.717399951693555,2.113531115974629,20172560.0,2003-05-09,2003,4,129,5,1.28,93.2,95.12,93.28,840
2003-05-12 13:30:00,93.5,95.12,93.28,94.88,75.60999999999999,87.44642857142858,88.5901745500004,87.89334969999999,88.16579899999996,91.66449799999998,89.54540344384405,91.758620594909,92.58307538461555,94.98974143773485,90.17640933149625,88.5901745500004,87.89334969999999,88.16579899999996,91.66449799999998,94.42666666666666,35680704,44312550.4,67.23672829968534,1.5,2.75,1.602286349433353,0.8052053803700724,0.12094588066063272,1.6364903464777285,1.5155444658170958,15.471064342961045,3.3663910411146056,55853264.0,2003-05-12,2003,0,132,5,1.97,94.2,95.189,94.25999,841
2003-05-13 13:30:00,94.53399999999999,95.189,94.25999,94.71001,75.52016666666665,87.3682142857143,88.63572455000038,87.93194969999998,88.37819919999995,91.95249849999998,89.74793703428153,92.03970530015577,92.84076846153864,95.38204602780027,90.29949089527702,88.63572455000038,87.93194969999998,88.37819919999995,91.95249849999998,94.71966666666668,39295904,44429970.4,66.23013831515277,1.5,2.75,1.5541951816166844,0.8844458739499859,0.1244315806296452,1.6710839416041523,1.5466523609745066,15.644310803530614,3.0464693722119467,16557360.0,2003-05-13,2003,1,133,5,0.99,94.72,95.24001,93.91,842
2003-05-14 13:30:00,95.09,95.24001,93.91,94.50999,75.43033333333331,87.29,88.65942450000038,87.9790496,88.61339899999996,92.18899799999998,89.93468420940775,92.27497050966473,93.16999846153864,95.35736677145971,90.98263015161757,88.65942450000038,87.9790496,88.61339899999996,92.18899799999998,94.55333333333334,32232096,43543724.8,64.99710509177575,1.5,2.75,1.5381819543583501,0.7402236751229881,0.09322809730907557,1.6631874826108517,1.569959385301776,15.910556809752496,2.8400438346075982,-15674736.0,2003-05-14,2003,2,134,5,1.42,94.58,95.33,94.25,843
2003-05-15 13:30:00,94.89,95.33,94.25,95.11,75.34049999999998,87.21178571428571,88.6802745000004,88.03854960000002,88.84659899999996,92.53199799999996,90.13763776982313,92.54497331826806,93.42538384615402,95.6827605391023,91.16800715320572,88.6802745000004,88.03854960000002,88.84659899999996,92.53199799999996,94.89666666666666,43932096,43149864.8,66.98287152473222,1.5,2.75,1.505454671904182,1.0181282422001934,0.09276140399288924,1.6859111402928877,1.5931497362999982,15.910318029984966,2.0383969489972187,28257360.0,2003-05-15,2003,3,135,5,1.15,94.79,95.45,94.25999,844
2003-05-16 13:30:00,94.89,95.45,94.25999,94.87,75.25066666666666,87.13357142857143,88.6988245000004,88.08734950000002,89.08899899999994,92.79749799999998,90.32322060237908,92.76640443081399,93.66230769230785,95.82804515559314,91.49657022902257,88.6988245000004,88.08734950000002,89.08899899999994,92.79749799999998,94.85999666666667,38905904,43220990.4,65.38500751216156,1.5,2.75,1.4829229096253118,0.9001622507937718,0.057765502228819036,1.665356614086022,1.6075911118572033,14.628568421176045,1.9778566053961124,-10648544.0,2003-05-16,2003,4,136,5,1.26,94.85,94.8905,92.33,845
2003-05-19 13:30:00,94.14999,94.8905,92.33,92.64999,75.16083333333331,87.05535714285715,88.7181744500004,88.11364940000001,89.27559859999994,92.94749799999997,90.41446646110931,92.75531734216506,93.71923000000015,95.73118992411116,91.70727007588916,88.7181744500004,88.11364940000001,89.27559859999994,92.94749799999997,93.29016333333334,43235296,43778615.2,52.830746033108156,1.5,2.75,1.559892701794933,0.9875893927316366,-0.12352936724995467,1.4531794027947598,1.5767087700447144,20.68916437416496,-1.3417207965072881,-53883840.0,2003-05-19,2003,0,139,5,2.77,93.61,93.03,91.59700000000001,846
2003-05-20 13:30:00,92.82001,93.03,91.59700000000001,92.46001,75.07099999999998,86.97714285714287,88.7465245500004,88.14469950000004,89.49839859999994,93.00349849999998,90.4946838547913,92.72719283338742,93.76230846153864,95.6358341320318,91.88878279104546,88.7465245500004,88.14469950000004,89.49839859999994,93.00349849999998,92.36233666666668,55450896,43558129.6,51.91216022905606,1.5,2.75,1.5508289373810094,1.2730320725249873,-0.25718449828150103,1.2552281471928382,1.5124126454743392,19.723072260152886,-0.9958132562372884,-109334736.0,2003-05-20,2003,1,140,5,1.56,92.31,92.88,91.91,847
2003-05-21 13:30:00,92.11,92.88,91.91,92.64999,74.98116666666667,86.89892857142858,88.7909245000004,88.17729940000002,89.74099839999991,93.02699849999996,90.57920566440731,92.7198401825886,93.71923000000015,95.66589688649924,91.77256311350108,88.7909245000004,88.17729940000002,89.74099839999991,93.02699849999996,92.47999666666664,49848400,43838019.2,52.79604581079688,1.5,2.75,1.5093411561395087,1.137104296902174,-0.3291392063273157,1.1009886375651945,1.4301278438925102,19.64209231976779,0.21632233639805265,-59486336.0,2003-05-21,2003,2,141,5,1.06,92.4,94.05,92.67999,848
2003-05-22 13:30:00,92.95,94.05,92.67999,93.57001,74.89133333333331,86.8207142857143,88.82582455000038,88.23919950000004,89.99119859999992,93.13749899999996,90.69649210894038,92.80080873662779,93.76076923076941,95.66951113686312,91.85202732467569,88.82582455000038,88.23919950000004,89.99119859999992,93.13749899999996,93.43333333333332,38456704,43259989.6,56.925174140187366,1.5,2.75,1.5015317878438292,0.8889670190766759,-0.31130967776353197,1.0409907466880952,1.3523004244516272,19.522090581316252,-0.1706924143817429,-21029632.0,2003-05-22,2003,3,142,5,1.48,93.36,93.98,93.14,849
2003-05-23 13:30:00,93.53,93.98,93.14,93.75999,74.80149999999998,86.7425,88.8541244500004,88.29569940000003,90.18919839999992,93.31399849999997,90.8166292811388,92.89215933313943,93.74923000000015,95.65603648794149,91.84242351205879,88.8541244500004,88.29569940000003,90.18919839999992,93.31399849999997,93.62666333333333,26157696,42371689.6,57.74709846992171,1.5,2.75,1.4542795172835559,0.6173389885306816,-0.2840196920181257,0.9972758094289702,1.281295501447096,17.85753002864166,-1.1804489881956088,5128064.0,2003-05-23,2003,4,143,5,0.9,93.56,95.84,93.17999,850
2003-05-27 13:30:00,93.3,95.84,93.17999,95.39999,74.71166666666664,86.66428571428574,88.8763744000004,88.36739930000005,90.41459819999993,93.49449849999998,90.99636891717256,93.13100034903091,93.90384461538477,95.98688228237957,91.82080694838994,88.8763744000004,88.36739930000005,90.41459819999993,93.49449849999998,94.80666,43732608,42234864.8,64.11307708873325,1.5,2.75,1.5404031231918736,1.0354622468212566,-0.1590464339198594,1.0824874590472715,1.2415338929671311,19.32034790503905,0.7285185589147395,48860672.0,2003-05-27,2003,1,147,5,2.85,94.51,96.47,95.42999,851
2003-05-28 13:30:00,95.85001,96.47,95.42999,95.67,74.62183333333331,86.58607142857143,88.89827445000039,88.41339920000004,90.59239819999992,93.68849899999998,91.17964856747952,93.3728098395994,94.15153692307709,96.24988577528393,92.05318807087026,88.89827445000039,88.41339920000004,90.59239819999992,93.68849899999998,95.85666333333334,37749808,41505345.6,65.0467963328979,1.5,2.75,1.5068036143924537,0.9095167731840303,-0.06646556010719372,1.1584519428331392,1.2249175029403327,19.297556254005407,1.227394056437843,86610480.0,2003-05-28,2003,2,148,5,1.09,95.95,96.82001,95.08,852
2003-05-29 13:30:00,95.88,96.82001,95.08,95.42,74.53199999999998,86.50785714285715,88.92227445000039,88.45409910000004,90.75499839999992,93.86399899999998,91.3459368589509,93.56778033106613,94.28153692307708,96.46691320773505,92.09616063841914,88.92227445000039,88.45409910000004,90.75499839999992,93.86399899999998,95.77333666666668,50978400,41608640.8,63.40194182073765,1.5,2.75,1.5234612133644208,1.2251878220448864,-0.03207518251360009,1.1848235247983323,1.2168987073119326,19.32935271799477,0.3259383871306932,35632080.0,2003-05-29,2003,3,149,5,1.83,95.95,97.09,95.56,853
2003-05-30 13:30:00,95.90100000000001,97.09,95.56,96.95,74.44216666666667,86.42964285714287,88.96217445000038,88.49399900000004,90.93479819999992,94.1164995,91.56570404095284,93.8898964900122,94.44076769230787,97.03985068676096,91.8416846978548,88.96217445000038,88.49399900000004,90.93479819999992,94.1164995,96.53333333333336,52537600,41715230.4,68.63012166732672,1.5,2.75,1.5339282695526768,1.2594344918205225,0.07770826639079575,1.3140340403004274,1.2363257739096316,21.007496719980463,2.1924739116685967,88169680.0,2003-05-30,2003,4,150,5,1.6,96.32,98.45,96.67,854
2003-06-02 13:30:00,97.53,98.45,96.67,97.35001,74.3523333333333,86.35142857142858,88.98782450000039,88.54019910000004,91.11879859999992,94.3234995,91.7925395687586,94.21943111001104,94.6438446153848,97.67240515931587,91.61528407145374,88.98782450000039,88.54019910000004,91.11879859999992,94.3234995,97.49000333333332,50700608,41738430.4,69.84307376600316,1.5,2.75,1.5515048217274856,1.214722439586516,0.15670116719098434,1.432202232898362,1.2755010657073778,20.839102015474968,5.072876964152932,138870288.0,2003-06-02,2003,0,153,6,1.84,97.56,97.84,96.85001,855
2003-06-03 13:30:00,97.14999,97.84,96.85001,97.75,74.26249999999997,86.2732142857143,89.00907450000038,88.60379910000003,91.28039859999993,94.5594995,92.02616546802298,94.55567576620048,94.89307615384634,98.34081133844902,91.44534096924366,89.00907450000038,88.60379910000003,91.28039859999993,94.5594995,97.48000333333334,39551808,41943356.0,71.04856452748875,1.5,2.75,1.511396620175523,0.9429814819777416,0.21189578055128466,1.5403707913964837,1.328475010845199,12.46036201661318,5.721381600542767,178422096.0,2003-06-03,2003,1,154,6,1.02,97.35,99.35001,97.569,856
2003-06-04 13:30:00,97.66,99.35001,97.569,99.16,74.17266666666664,86.19500000000002,89.03877450000036,88.66729910000004,91.52979859999992,94.8219995,92.30592368496326,94.99418283608614,95.20461461538478,99.33816237710279,91.07106685366684,89.03877450000036,88.66729910000004,91.52979859999992,94.8219995,98.69300333333337,49432704,42185786.4,74.86311170203402,1.5,2.75,1.5306547187344135,1.171785765264293,0.3132542208430753,1.7200427868990433,1.4067885660559678,12.439865920919509,7.026455156660021,227854800.0,2003-06-04,2003,2,155,6,1.83,98.46,99.64999,98.27,857
2003-06-05 13:30:00,98.584,99.64999,98.27,99.64999,74.08283333333331,86.11678571428574,89.06002450000038,88.73319900000006,91.77239839999993,95.13499899999998,92.59392628555294,95.43759304217319,95.57230615384636,100.32534693155044,90.81926537614227,89.06002450000038,88.73319900000006,91.77239839999993,95.13499899999998,99.18999333333332,46407104,42434041.6,76.04433993230775,1.5,2.75,1.5198929531105276,1.093629130061465,0.3788070179635932,1.8802973385104595,1.5014903205468662,12.127989578628736,6.497787058054183,274261904.0,2003-06-05,2003,3,156,6,1.4,98.96,101.39999,99.13,858
2003-06-06 13:30:00,100.39999,101.39999,99.13,99.25999,73.99299999999998,86.03857142857143,89.08437445000034,88.79549890000006,92.0159981999999,95.4754985,92.85534054886459,95.8016308476805,96.08076769230793,100.88845988580452,91.27307549881132,89.08437445000034,88.79549890000006,92.0159981999999,95.4754985,99.92999333333334,60397600,43416181.6,73.09991003732229,1.5,2.75,1.5734713136026333,1.391131089243463,0.36145886186738907,1.9533138978811024,1.5918550360137134,13.546120014118982,5.8660415812757645,213864304.0,2003-06-06,2003,4,157,6,2.29,100.26,99.10001,97.77,859
2003-06-09 13:30:00,98.76899999999999,99.10001,97.77,98.25,73.90316666666666,85.96035714285715,89.09687445000036,88.84469890000004,92.23799839999992,95.7014985,93.06689582145813,96.03480886218712,96.52615153846176,100.96850376576126,92.08379931116228,89.09687445000036,88.84469890000004,92.23799839999992,95.7014985,98.37333666666666,38388800,43653636.8,65.97542215825541,1.5,2.75,1.567508362631017,0.8793952305939376,0.2526692621102131,1.90769161365148,1.6550223515412663,16.355606931321837,2.9874321789761167,175475504.0,2003-06-09,2003,0,160,6,1.36,98.44,99.25999,98.19,860
2003-06-10 13:30:00,98.46001,99.25999,98.19,99.25,73.8133333333333,85.88214285714288,89.10972450000034,88.91319900000006,92.4887981999999,95.91999849999998,93.30937049512644,96.34101754197884,97.03384461538485,101.07901442437479,92.9886748063949,89.10972450000034,88.91319900000006,92.4887981999999,95.91999849999998,98.89999666666668,30105504,43374876.8,69.17843784527462,1.5,2.75,1.5319713367288017,0.6940769915915934,0.21996584930583046,1.9299796631735544,1.7100138138677243,14.762103289128476,3.742029894428764,205581008.0,2003-06-10,2003,1,161,6,1.09,98.72,100.39,98.71001,861
2003-06-11 13:30:00,99.16,100.39,98.71001,100.3,73.72349999999997,85.80392857142857,89.13822445000038,88.99599900000004,92.7999979999999,96.19949799999998,93.58351282865091,96.7180634903618,97.55153615384636,101.40925999144602,93.69381231624672,89.13822445000038,88.99599900000004,92.7999979999999,96.19949799999998,99.80000333333334,37617296,43290946.4,72.14370394236744,1.5,2.75,1.5425440983910303,0.8689414098833377,0.2393556879139007,2.0092084237601,1.7698527358461993,15.199795571436587,5.114231817229086,243198304.0,2003-06-11,2003,2,162,6,1.7,99.55,100.89999,99.62,862
2003-06-12 13:30:00,100.75399999999999,100.89999,99.62,100.61,73.63366666666664,85.72571428571429,89.16497450000038,89.09549900000006,93.0913981999999,96.50449849999997,93.85906134517441,97.08872411032736,98.0784600000002,101.57507608589559,94.58184391410481,89.16497450000038,89.09549900000006,93.0913981999999,96.50449849999997,100.37666333333334,36488608,43503772.0,72.97051056379756,1.5,2.75,1.5237902342202423,0.8387458448430632,0.24260950865876876,2.07311462166966,1.8305051130108916,14.530996088160505,3.775141825683338,279686912.0,2003-06-12,2003,3,163,6,1.28,100.26,100.74899,98.95,863
2003-06-13 13:30:00,100.61,100.74899,98.95,99.56,73.54383333333331,85.64750000000002,89.19197450000038,89.19859900000004,93.32019819999992,96.72699849999997,94.08262756693226,97.32408371886758,98.39846076923098,101.60542943138714,95.19149210707481,89.19197450000038,89.19859900000004,93.32019819999992,96.72699849999997,99.75299666666666,48635296,43738932.0,65.84204321691355,1.5,2.75,1.5434473603473684,1.1119452116480577,0.14823403641637078,2.015797658531355,1.867563622114984,15.34905335579275,2.2701487139035783,231051616.0,2003-06-13,2003,4,164,6,1.82,99.85,101.7,99.8,864
2003-06-16 13:30:00,99.96001,101.7,99.8,101.66,73.45399999999998,85.56928571428574,89.23977445000038,89.33349900000003,93.59939819999992,97.06649849999997,94.37977942705255,97.73702812659451,98.85923000000021,102.08691020017656,95.63154979982392,89.23977445000038,89.33349900000003,93.59939819999992,97.06649849999997,101.05333333333333,36338608,43610567.2,71.77981289427186,1.5,2.75,1.5860582631796991,0.8332523590750269,0.19830151859826084,2.11544052036281,1.917139001764549,18.592851365563615,3.999999999999997,267390224.0,2003-06-16,2003,0,167,6,1.9,100.75,102.179,101.23,865
2003-06-17 13:30:00,102.07001,102.179,101.23,101.66,73.36416666666666,102.179,89.28737445000039,89.46299890000004,93.86819819999991,97.51699899999996,94.6652782730505,98.11064449549026,99.33923000000021,102.21507357617176,96.46338642382868,89.28737445000039,89.46299890000004,93.86819819999991,97.51699899999996,101.68966666666664,36818192,43289712.0,71.77981289427186,1.5,2.75,1.5405541015240063,0.8505067439580102,0.2018093628494317,2.169400705326339,1.9675913424769076,18.759287247286,2.5211778943122227,267390224.0,2003-06-17,2003,1,168,6,0.94,101.7,102.14,101.0,866
2003-06-18 13:30:00,101.28999,102.14,101.0,101.57001,73.27433333333332,102.25674766355141,89.33632450000039,89.61489900000004,94.1385983999999,97.97249899999996,94.93605206626421,98.44010787687216,99.69461538461559,102.44052833506487,96.94870243416632,89.33632450000039,89.61489900000004,94.1385983999999,97.97249899999996,101.57000333333332,35550096,42294672.0,71.16500102021622,1.5,2.75,1.5119430942722918,0.8405336728938341,0.16974772513689285,2.179775998898023,2.0100282737611304,17.675756819361176,1.9267638662081088,231840128.0,2003-06-18,2003,2,169,6,1.13,101.57,101.73,99.84,867
2003-06-19 13:30:00,101.64,101.73,99.84,100.02,73.18449999999999,102.3344953271028,89.3950245000004,89.76309900000004,94.37519839999992,98.34099949999998,95.13542257346954,98.59057379336052,99.89999923076944,102.29007172404755,97.50992673749136,89.3950245000004,89.76309900000004,94.37519839999992,98.34099949999998,100.53,43559904,41980247.2,61.40851451698017,1.5,2.75,1.5389471589671282,1.037628573087583,0.02351059432403924,2.0394165166661797,2.0159059223421396,20.259028301965113,0.7656760795563188,188280224.0,2003-06-19,2003,3,170,6,1.89,100.78,100.5,99.42,868
2003-06-20 13:30:00,100.39,100.5,99.42,99.44,73.09466666666664,102.4122429906542,89.44452455000038,89.89919900000004,94.62339839999993,98.63449899999998,95.3042295313727,98.6714715273262,100.02999923076945,102.10066272905097,97.95933573248794,89.44452455000038,89.89919900000004,94.62339839999993,98.63449899999998,99.78666666666668,41551696,42134996.8,58.193523114875326,1.5,2.75,1.5061652190409045,0.9861563820030954,-0.1247733448950139,1.8599392412233728,1.9847125861183863,20.433852669529248,1.2111959287531784,146728528.0,2003-06-20,2003,4,171,6,1.09,99.96,99.66,97.92,869
2003-06-23 13:30:00,99.45,99.66,97.92,98.42,73.00483333333331,102.48999065420558,89.49272455000037,90.01859900000004,94.84159859999993,98.86749949999998,95.42641660857376,98.64752185805705,99.97307615384638,102.17293136480049,97.77322094289222,89.49272455000037,90.01859900000004,94.84159859999993,98.86749949999998,98.66666666666669,34317808,42543002.4,52.94394520126478,1.5,2.75,1.522867703395125,0.8066616379665766,-0.2943622832360311,1.6167597320733478,1.9111220153093789,20.44935113485574,-0.8362720403022653,112410720.0,2003-06-23,2003,0,174,6,1.78,98.79,99.09,98.02,870
2003-06-24 13:30:00,98.22301,99.09,98.02,98.52,72.91499999999998,102.56773831775699,89.53532455000038,90.15949910000003,95.06899879999992,99.02349999999998,95.547733604316,98.63537691919446,99.88615384615406,102.21568030132437,97.55662739098378,89.53532455000038,90.15949910000003,95.06899879999992,99.02349999999998,98.54333333333334,36220896,42167416.8,53.38789408801068,1.5,2.75,1.4905200102954737,0.8589783000413723,-0.39626795523737823,1.415787071262656,1.8120550265000344,19.474129668264588,-1.7746759720837502,148631616.0,2003-06-24,2003,1,175,6,1.09,98.56,99.44,97.53,871
2003-06-25 13:30:00,98.53,99.44,97.53,97.53,72.82516666666666,102.6454859813084,89.56967455000039,90.27419910000006,95.24059879999993,99.1165,95.62546954140163,98.53010292689022,99.75307769230791,102.3881029154545,97.1180524691613,89.56967455000039,90.27419910000006,95.24059879999993,99.1165,98.16666666666669,47856800,42672766.4,48.50860937065824,1.5,2.75,1.5204828667029395,1.1214834199265789,-0.5190670821568242,1.163221173804004,1.6822882559608283,18.692511492986835,-3.0613259119371814,100774816.0,2003-06-25,2003,2,176,6,1.96,98.48,98.979,96.96001,872
2003-06-26 13:30:00,97.78,98.979,96.96001,98.8,72.73533333333332,102.7232336448598,89.60517455000038,90.39989910000006,95.42099879999996,99.2855,95.74996093193491,98.55580741004351,99.7953853846156,102.34892040458759,97.24185036464355,89.60517455000038,90.39989910000006,95.42099879999996,99.2855,98.24633666666666,33543504,41801021.6,54.281089573591096,1.5,2.75,1.5560905190813012,0.8024565600568958,-0.5031135095917769,1.0533963689711072,1.556509878562884,20.58218674690524,-0.7633587786259594,134318320.0,2003-06-26,2003,3,177,6,2.08,97.97,99.19,97.58,873
2003-06-27 13:30:00,98.74699,99.19,97.58,97.66,72.64549999999997,102.80098130841122,89.63782455000039,90.52269910000008,95.60919879999994,99.321,95.82486442480021,98.47049241861082,99.67307769230791,102.46094783946032,96.88520754515548,89.63782455000039,90.52269910000008,95.60919879999994,99.321,98.14333333333332,54211104,41884696.8,48.97374857384797,1.5,2.75,1.5599411962897796,1.2942938147280558,-0.5536826180550345,0.8644066059940911,1.4180892240491256,20.762754786538988,-3.9346842415896126,80107216.0,2003-06-27,2003,4,178,6,1.65,98.38,98.67,97.47,874
2003-06-30 13:30:00,98.22,98.67,97.47,97.63,72.55566666666664,102.87872897196263,89.67872455000038,90.65049900000004,95.77059879999992,99.33499949999998,95.8956540552002,98.39044552160027,99.46769307692327,102.42859069629542,96.50679545755119,89.67872455000038,90.65049900000004,95.77059879999992,99.33499949999998,97.92333333333332,33863696,41042851.2,48.83841949575292,1.5,2.75,1.5342311108405098,0.8250814699735091,-0.5711963764785648,0.7040937534509197,1.2752901299294843,15.030920400645115,-3.9641943734015364,46243520.0,2003-06-30,2003,0,181,6,1.23,98.07,98.85001,96.42999,875
2003-07-01 13:30:00,97.25301,98.85001,96.42999,98.53,96.42999,102.95647663551401,89.72302455000037,90.79129900000004,95.94819899999992,99.3739995,95.99896173930998,98.403736424305,99.30769307692327,102.22891916383765,96.38646699000894,89.72302455000037,90.79129900000004,95.94819899999992,99.3739995,97.93666666666668,51416400,41636080.8,53.031563854858675,1.5,2.75,1.597501745780473,1.2349000917492696,-0.5064212822955116,0.6422635270600949,1.1486848093556066,16.753653100966734,-2.993019297723802,97659920.0,2003-07-01,2003,1,182,7,2.51,97.64,99.78999,98.57001,876
2003-07-02 13:30:00,98.77,99.78999,98.57001,99.77,96.65137948051948,103.03422429906544,89.77242455000038,90.95479900000004,96.11679899999994,99.4044995,96.14684559267036,98.53385676484736,99.32384692307713,102.25278753572228,96.39490631043198,89.77242455000038,90.95479900000004,96.11679899999994,99.4044995,99.37666666666668,34678000,40898345.6,58.123992891916345,1.5,2.75,1.5733937639390108,0.847907158376597,-0.37061250473263296,0.6854191784398154,1.0560316831724483,19.013566189861148,-0.2499500099980004,132337920.0,2003-07-02,2003,2,183,7,1.24,99.18,99.85001,97.90401,877
2003-07-03 13:30:00,99.07001,99.85001,97.90401,98.74001,96.87276896103896,103.1119719626168,89.82697460000038,91.10209920000004,96.24799939999996,99.3590005,96.24853831452644,98.55349040629049,99.0992323076925,101.70739314148241,96.49107147390265,89.82697460000038,91.10209920000004,96.24799939999996,99.3590005,98.83134333333334,30868400,40121410.4,52.98510987569053,1.5,2.75,1.600008495086224,0.7693747476035887,-0.3414212689355957,0.6292550970029538,0.9706763659385494,17.891864922082632,-0.7039320193081252,101469520.0,2003-07-03,2003,3,184,7,1.99,98.88,100.89999,99.64999,878
2003-07-07 13:30:00,99.65299999999999,100.89999,99.64999,100.7,97.09415844155843,103.18971962616823,89.89572460000038,91.27479930000004,96.43479939999996,99.431001,96.42310543944694,98.75791989140569,99.02538615384636,101.38153478841532,96.6692375192774,89.89572460000038,91.27479930000004,96.43479939999996,99.431001,100.41666,31426608,38672860.8,60.19679651915654,1.5,2.75,1.6400064597229227,0.8126269262190192,-0.18899438901319576,0.7344333796720548,0.9234277686852506,21.190951829527464,2.3166023166023177,132896128.0,2003-07-07,2003,0,188,7,1.25,100.27,101.28999,100.17,879
2003-07-08 13:30:00,100.5,101.28999,100.17,101.14999,97.31554792207793,103.26746728971963,89.97797455000038,91.46529910000004,96.65319919999996,99.5760005,96.60847346142944,98.9857360922242,98.99307692307713,101.21654813325577,96.76960571289848,89.97797455000038,91.46529910000004,96.65319919999996,99.5760005,100.86999333333334,33158192,38411330.4,61.65120640864947,1.5,2.75,1.6028624268855711,0.8632398736181239,-0.06325017966567525,0.8443650441031565,0.9076152237688316,19.899107843633946,2.6694985789687444,166054320.0,2003-07-08,2003,1,189,7,1.12,100.73,101.39999,100.03,880
2003-07-09 13:30:00,100.92,101.39999,100.03,100.58,97.5369374025974,103.34521495327104,90.0591245000004,91.64759900000004,96.82899939999996,99.64250049999998,96.76421960019691,99.1375707501076,99.03615384615404,101.35709924320734,96.71520844910073,90.0591245000004,91.64759900000004,96.82899939999996,99.64250049999998,100.66999666666668,36629296,38737520.0,58.724127552701795,1.5,2.75,1.5862286821080305,0.9455766915383328,-0.02577045132880118,0.8754021596078303,0.9011726109366316,20.46819687544588,3.1272428996206267,129425024.0,2003-07-09,2003,2,190,7,1.37,100.71,100.03999,98.63,881
2003-07-10 13:30:00,99.84,100.03999,98.63,99.3,97.75832688311691,103.42296261682243,90.1373245000004,91.79909910000003,96.97919959999996,99.5925005,96.86366196881664,99.15304020247831,99.0253846153848,101.34002530037505,96.71074393039456,90.1373245000004,91.79909910000003,96.97919959999996,99.5925005,99.32333,49815600,39347435.2,52.67584875674163,1.5,2.75,1.612212347671743,1.266044400271355,-0.09083038242975304,0.7876346328994401,0.8784650153291932,21.10486672060217,0.5060728744939271,79609424.0,2003-07-10,2003,3,191,7,1.43,99.33,100.45,99.39,882
2003-07-11 13:30:00,99.39,100.45,99.39,100.24001,97.97971636363636,103.50071028037384,90.2269745500004,91.94519920000003,97.14579979999996,99.574001,96.99606777396109,99.2565611355756,99.16538538461556,101.53611045185488,96.79466031737623,90.2269745500004,91.94519920000003,97.14579979999996,99.574001,100.02667,40076400,39526824.8,56.24033091403484,1.5,2.75,1.5791971799809044,1.0139038539721006,-0.07486676378176392,0.7848815606019883,0.8597483243837523,20.515544883723685,2.641828793774321,119685824.0,2003-07-11,2003,4,192,7,1.07,99.92,101.89999,99.91499,883
2003-07-14 13:30:00,101.2,101.89999,99.91499,100.73,98.20110584415585,101.89999,90.3088745000004,92.10069930000004,97.32239999999996,99.632501,97.14249648870769,99.39688864647316,99.33538538461555,101.8112313453658,96.85953942386531,90.3088745000004,92.10069930000004,97.32239999999996,99.632501,100.84832666666668,42141504,39202135.2,58.015509008767616,1.5,2.75,1.608183095696554,1.0749798138546292,-0.03750458167887183,0.8128675972851624,0.8503721789640343,18.790429959044236,3.1752535081429976,161827328.0,2003-07-14,2003,0,195,7,1.99,100.91,101.46001,99.95,884
2003-07-15 13:30:00,101.38,101.46001,99.95,100.50999,98.42249532467531,101.88448944444444,90.3827744500004,92.26249920000004,97.46839959999996,99.5750005,97.274555057778,99.50289829919001,99.56461538461555,101.87573029885657,97.25350047037456,90.3827744500004,92.26249920000004,97.46839959999996,99.5750005,100.64,63620400,40566224.8,56.89937766355483,1.5,2.75,1.6011707317182282,1.568309605186628,-0.03391384266793507,0.8079798756291154,0.8418937182970505,18.944872337535887,2.0095300923576582,98206928.0,2003-07-15,2003,1,196,7,1.51,100.71,100.87,99.23,885
2003-07-16 13:30:00,100.81,100.87,99.23,99.92,98.64388480519482,101.86898888888891,90.4686244500004,92.40989930000003,97.60619959999997,99.48800049999998,97.37829799668866,99.54262227069573,99.65076923076944,101.92465027142673,97.37688819011213,90.4686244500004,92.40989930000003,97.60619959999997,99.48800049999998,100.00666666666667,40194192,40735024.8,53.9044735658751,1.5,2.75,1.6039442508812118,0.9867231503440744,-0.07521258514955742,0.7478779868601038,0.8230905720096612,19.092184430335763,0.15034579532926298,58012736.0,2003-07-16,2003,2,197,7,1.65,100.05,99.88,98.16,886
2003-07-17 13:30:00,99.14999,99.88,98.16,98.5,98.86527428571428,101.85348833333332,90.55217450000038,92.55689930000004,97.69799959999996,99.3345,97.422286310544,99.44332491158184,99.71538461538479,101.79909945466557,97.63166977610408,90.55217450000038,92.55689930000004,97.69799959999996,99.3345,98.84666666666664,48913600,41403200.0,47.433246601061384,1.5,2.75,1.6150910901039828,1.181396607025544,-0.19528011110295407,0.5789904331309685,0.7742705442339226,19.57988075812818,-0.2430726916069768,9099136.0,2003-07-17,2003,3,198,7,1.75,99.02,99.8,98.46001,887
2003-07-18 13:30:00,99.02,99.8,98.46001,99.50999,99.08666376623377,101.83798777777778,90.62112445000037,92.70729920000004,97.82039939999996,99.3089995,97.50415704346383,99.44967396762165,99.85999923076942,101.57262684761291,98.14737161392594,90.62112445000037,92.70729920000004,97.82039939999996,99.3089995,99.25666666666666,35701696,41010289.6,51.85996259018633,1.5,2.75,1.5954410122394125,0.8705545936939689,-0.20290287864425616,0.5206419459286025,0.7235448245728586,19.64279109447142,-1.1817378351539234,44800832.0,2003-07-18,2003,4,199,7,1.36,99.13,99.494,97.85001,888
2003-07-21 13:30:00,99.45,99.494,97.85001,98.28,99.30805324675323,101.82248722222221,90.69677450000036,92.85769910000006,97.93699939999996,99.2509995,97.53458225744566,99.33827644689579,99.84076846153864,101.6171299392592,98.06440698381807,90.69677450000036,92.85769910000006,97.93699939999996,99.2509995,98.54133666666668,35092304,40687320.0,46.70203223843015,1.5,2.75,1.6000509399365976,0.8624874776711762,-0.2821356858541352,0.3708752172551897,0.6530109031093249,16.789629254259687,-2.8373606364172663,9708528.0,2003-07-21,2003,0,202,7,1.68,98.67,99.41,97.91,889
2003-07-22 13:30:00,98.69,99.41,97.91,99.17,99.52944272727274,101.80698666666667,90.78107450000034,93.00599910000008,98.04579939999996,99.2884995,97.59871628656543,99.32225011861999,99.79461461538479,101.60675106546852,97.98247816530107,90.78107450000034,93.00599910000008,98.04579939999996,99.2884995,98.83,50006704,41471764.8,50.53564903139491,1.5,2.75,1.5929044442268407,1.2058012057398628,-0.2661629105162594,0.32030726496400064,0.58647017548026,17.653111387590343,-1.4018691588785013,59715232.0,2003-07-22,2003,1,203,7,1.53,98.66,99.45,98.28,890
2003-07-23 13:30:00,99.21001,99.45,98.28,99.24001,99.7508322077922,101.79148611111113,90.87327455000036,93.14939930000006,98.13299959999996,99.3245,97.6630807459158,99.3144177263705,99.83307615384636,101.57386640631121,98.09228590138149,90.87327455000036,93.14939930000006,98.13299959999996,99.3245,98.99000333333332,37298304,41525635.2,50.835224922635746,1.5,2.75,1.5626969839249238,0.898199481365188,-0.2430776467946217,0.28262311698698284,0.5257007637816046,17.545850178907965,-0.060412890231620435,97013536.0,2003-07-23,2003,2,204,7,1.19,98.86,100.34,98.37,891
2003-07-24 13:30:00,99.99001,100.34,98.37,98.49001,99.97222168831169,101.77598555555555,90.97007460000036,93.29339940000006,98.2085996,99.37250050000002,97.6955093441152,99.23590270481138,99.66307692307713,101.46266772473568,97.86348612141857,90.97007460000036,93.29339940000006,98.2085996,99.37250050000002,99.06667,41173296,41191460.0,47.51525979261303,1.5,2.75,1.5917900565017151,0.9995590348096426,-0.2685216801972422,0.1900486635350518,0.458570343732294,16.525878584177672,-1.7458098817029248,55840240.0,2003-07-24,2003,3,205,7,2.0,99.36,100.28999,98.03999,892
2003-07-25 13:30:00,98.66,100.28999,98.03999,100.23,100.19361116883115,101.760485,91.06937460000036,93.46819940000003,98.32299979999998,99.4440005,97.79490113454204,99.33057863768649,99.59230846153864,101.2162256556626,97.96839126741469,91.06937460000036,93.46819940000003,98.32299979999998,99.4440005,99.51999333333336,43325104,41680540.0,54.877822325449344,1.5,2.75,1.6388050524658782,1.039456398597523,-0.16353175863852404,0.2541556454341389,0.41768740407266297,18.84386967132385,-0.4963764519011218,99165344.0,2003-07-25,2003,4,206,7,2.29,99.16,100.98,99.67,893
2003-07-28 13:30:00,100.37,100.98,99.67,99.86,100.41500064935066,101.74498444444444,91.17817455000036,93.63229940000004,98.41799979999998,99.5540005,97.8758854037757,99.38099971981157,99.53692384615402,101.06882514695185,98.0050225453562,91.17817455000036,93.63229940000004,98.41799979999998,99.5540005,100.17,34416304,40690800.0,53.169773008893365,1.5,2.75,1.6153189772897445,0.8458006232367021,-0.11657401673302036,0.2719698831563875,0.3885438998894079,18.67240551409584,-0.6466919357966332,64749040.0,2003-07-28,2003,0,209,7,1.31,100.32,100.27,98.67999,894
2003-07-29 13:30:00,100.14,100.27,98.67999,99.39999,100.63639012987015,101.72948388888891,91.27202450000036,93.79879930000004,98.50859959999998,99.6425,97.93565421147076,99.38280831792477,99.54461538461555,101.07268043331295,98.01655033591815,91.27202450000036,93.79879930000004,98.50859959999998,99.6425,99.44999333333334,53569808,41676105.6,51.0426764382845,1.5,2.75,1.6135111931976192,1.2853842082596123,-0.1139298553442658,0.2461315807090756,0.3600614360533414,18.786699890708352,-0.5204263410728575,11179232.0,2003-07-29,2003,1,210,7,1.61,99.47,99.78999,98.92999,895
2003-07-30 13:30:00,99.60001,99.78999,98.92999,99.16,100.8577796103896,101.71398333333332,91.34702450000036,93.95719920000003,98.63879979999996,99.674,97.98366777180523,99.3615884781224,99.46153769230787,100.94615882107384,97.97691656354193,91.34702450000036,93.95719920000003,98.63879979999996,99.674,99.29332666666667,28417600,40526165.6,49.920624482610656,1.5,2.75,1.5596889651120749,0.7012161051821789,-0.12489836745681834,0.20393847673231846,0.32883684418913683,18.56867261266541,0.6700507614213164,-17238368.0,2003-07-30,2003,2,211,7,0.87,99.36,100.94,99.05,896
2003-07-31 13:30:00,99.98,100.94,99.05,99.39,101.07916909090908,101.69848277777778,91.42082450000036,94.13789910000006,98.7773996,99.655,98.03881805526385,99.36429433734884,99.35846076923096,100.65000994043804,98.06691159802388,91.42082450000036,94.13789910000006,98.7773996,99.655,99.79333333333334,59112000,41747865.6,51.03162583335743,1.5,2.75,1.5832826104612123,1.4159286744470116,-0.11354571960772235,0.1869046946794839,0.30045041428720626,16.466676201747063,-0.12058085826357873,41873632.0,2003-07-31,2003,3,212,7,1.91,100.0,99.53,98.24001,897
2003-08-01 13:30:00,99.19,99.53,98.24001,98.50999,101.30055857142858,101.68298222222221,91.46987445000036,94.31779900000004,98.89459959999998,99.643499,98.05729538642996,99.28293201950609,99.20461461538478,100.38229334519058,98.02693588557905,91.46987445000036,94.31779900000004,98.89459959999998,99.643499,98.76,49324496,42670670.4,46.75746288912529,1.5,2.75,1.562333138285412,1.1559344050052704,-0.1593771770382953,0.10122894298933716,0.26060612002763245,16.163699216791752,0.23401505901505984,-7450864.0,2003-08-01,2003,4,213,8,1.31,98.89,99.0,97.0,898
2003-08-04 13:30:00,98.31,99.0,97.0,98.50999,101.52194805194807,101.66748166666667,91.52967440000036,94.49229890000008,98.99339919999996,99.5339985,98.07504811637388,99.20931849383886,99.0961523076925,100.24978303635832,97.94252157902667,91.52967440000036,94.49229890000008,98.99339919999996,99.5339985,98.16999666666668,55544400,43876560.0,46.75746288912529,1.5,2.75,1.5935950569793111,1.2659242201302927,-0.182124527925226,0.032950460121099916,0.21507498804632594,14.433532884126524,-0.6655339316325499,-7450864.0,2003-08-04,2003,0,216,8,2.06,98.0,98.75999,96.34,899
2003-08-05 13:30:00,98.411,98.75999,96.34,96.42,96.34,101.65198111111113,91.5704244000003,94.61789890000006,99.04659939999998,99.297499,98.01014426867296,98.94366911347326,98.93615230769251,100.75899042775777,97.11331418762724,91.5704244000003,94.61789890000006,99.04659939999998,99.297499,97.17333,61736704,45305485.6,37.992738960990316,1.5,2.75,1.652623267195075,1.3626761347416172,-0.3221739348854845,-0.18764243056052976,0.13453150432495478,17.8282178805099,-2.8416059208377717,-69187568.0,2003-08-05,2003,1,217,8,2.51,97.55,98.06,96.42299999999999,900
2003-08-06 13:30:00,96.69,98.06,96.42299999999999,96.98,96.33625041666667,101.63648055555555,91.61212440000034,94.74639890000006,99.07819959999998,99.117499,97.9697464542152,98.75665300742818,98.74153769230792,100.80243893368849,96.68063645092731,91.61212440000034,94.74639890000006,99.07819959999998,99.117499,97.15433333333333,51180000,46033020.8,41.17459642556374,1.5,2.75,1.6517216052525694,1.1118105896713173,-0.35855390623363564,-0.3136608784670898,0.04489302776654587,18.422825781808,-1.533160571310729,-18007568.0,2003-08-06,2003,2,218,8,1.7,97.24,98.07001,96.758,901
2003-08-07 13:30:00,97.17,98.07001,96.758,98.0,96.33250083333334,101.62098,91.65127440000036,94.85859890000003,99.12479959999996,99.052499,97.9709328677754,98.68459081624457,98.71999923076945,100.80545071115057,96.63454775038828,91.65127440000036,94.85859890000003,99.12479959999996,99.052499,97.60933666666666,43546800,45719580.8,46.554180974755106,1.5,2.75,1.6274564905916715,0.9524759247136404,-0.297875443301289,-0.32745127636006544,-0.0295758330587764,19.41166324584332,-2.2248827696298554,25539232.0,2003-08-07,2003,3,219,8,1.36,97.41,98.54700000000001,97.75999,902
2003-08-08 13:30:00,98.32001,98.54700000000001,97.75999,98.28,96.32875125,101.60547944444444,91.69507440000034,94.96849900000008,99.18199959999995,98.9544985,97.9830531474705,98.6460583575546,98.65153769230787,100.73183119688585,96.57124418772993,91.69507440000034,94.96849900000008,99.18199959999995,98.9544985,98.19566333333334,27359504,45083736.0,47.961053855440426,1.5,2.75,1.5674245984065518,0.6068597331862647,-0.2260896522253764,-0.3121878983404969,-0.08609824611512049,15.958151129170432,-1.5822151011415966,52898736.0,2003-08-08,2003,4,220,8,0.81,98.15,99.03999,97.84,903
2003-08-11 13:30:00,98.25999,99.03999,97.84,98.64999,96.32500166666668,101.58997888888891,91.73732435000036,95.07539880000006,99.21599939999996,98.850498,98.00920753384419,98.64643279969223,98.60615153846176,100.6586691266436,96.5536339502799,91.73732435000036,95.07539880000006,99.21599939999996,98.850498,98.50999333333334,34633904,44708356.0,49.8400039832087,1.5,2.75,1.5411792699489408,0.7746628840478947,-0.14484687722475126,-0.26715684264605954,-0.1223099654213083,16.232321598517462,-0.7545272388860401,87532640.0,2003-08-11,2003,0,223,8,1.23,98.44,99.59,98.42,904
2003-08-12 13:30:00,98.71001,99.59,98.42,99.55,96.32125208333332,101.57447833333332,91.7932743500003,95.18939890000006,99.25999919999997,98.8024985,98.06963076781106,98.73248681876915,98.68768923076945,100.79865870435076,96.57671975718813,91.7932743500003,95.18939890000006,99.25999919999997,98.8024985,99.18666666666668,43347008,43694686.4,54.17447625731531,1.5,2.75,1.5146664649525885,0.9920430050277236,-0.02778075491586407,-0.1570359090661384,-0.12925515415027433,17.063242989303482,0.3933037515127073,130879648.0,2003-08-12,2003,1,224,8,1.19,99.0,99.84899999999999,98.53,905
2003-08-13 13:30:00,99.82001,99.84899999999999,98.53,99.03999,96.3175025,101.55897777777778,91.83747430000034,95.28309880000003,99.28579899999997,98.758498,98.10768407103417,98.76177283602924,98.59615000000021,100.52719874717393,96.6651012528265,91.83747430000034,95.28309880000003,99.28579899999997,98.758498,99.13966333333332,36155504,43492752.0,51.46072120849097,1.5,2.75,1.5006902888845466,0.8312995231941175,0.015681083521987826,-0.10965379974778956,-0.12533488326977738,17.282368754551772,-0.3521581648053099,94724144.0,2003-08-13,2003,2,225,8,1.34,99.19,99.75,98.45,906
2003-08-14 13:30:00,99.10001,99.75,98.45,99.31,96.31375291666667,101.54347722222221,91.88597430000034,95.40929880000004,99.28879899999998,98.798998,98.15483371530735,98.81398494688361,98.5538423076925,100.39425036253724,96.7134342528478,91.88597430000034,95.40929880000004,99.28879899999998,98.798998,99.17,36247392,42859441.6,52.808520901497324,1.5,2.75,1.4863552682499361,0.8457271174526921,0.060474155162982525,-0.049742189316049235,-0.11021634447903177,17.304810947069107,0.8121105280794367,130971536.0,2003-08-14,2003,3,226,8,1.32,99.1,99.78999,99.12,907
2003-08-15 13:30:00,99.36,99.78999,99.12,99.62,96.31000333333334,101.52797666666667,91.94122425000036,95.53029880000004,99.28819919999998,98.8044985,98.21229121666784,98.89074828527565,98.57076615384638,100.44570892379835,96.6958233838944,91.94122425000036,95.53029880000004,99.28819919999998,98.8044985,99.50999666666668,12567199,41702716.75,54.374919221487865,1.5,2.75,1.4280434633749404,0.30135204560743634,0.1061677266967567,0.022493313891914116,-0.08367441280484259,16.418687694847055,1.1267994240990205,143538735.0,2003-08-15,2003,4,227,8,0.68,99.45,100.60001,99.74001,908
2003-08-18 13:30:00,99.92999,100.60001,99.74001,100.48,96.30625375,101.51247611111113,91.9964743000003,95.66429880000004,99.31259939999998,98.9144985,98.30122097287695,99.04210559143988,98.67230461538485,100.79101469857905,96.55359453219063,91.9964743000003,95.66429880000004,99.31259939999998,98.9144985,100.27334000000002,22882096,41092206.35,58.49115901743986,1.5,2.75,1.3960410731338726,0.556847588204521,0.1848881189679244,0.14743573590506287,-0.037452383062861486,16.93558887518338,4.210744658784487,166420831.0,2003-08-18,2003,0,230,8,0.86,100.17,100.94,100.0,909
2003-08-19 13:30:00,100.68700000000001,100.94,100.0,100.86,96.30250416666668,101.49697555555555,92.0581743000003,95.80139890000004,99.36479939999998,98.9989985,98.40156524845041,99.21523839225512,98.78538153846172,101.18369708246351,96.38706599445996,92.0581743000003,95.80139890000004,99.36479939999998,98.9989985,100.6,37456800,40464711.15,60.19980484756967,1.5,2.75,1.3634667107671672,0.9256658193147635,0.2491285535447148,0.273958308868032,0.024829755323317198,8.031159624772098,4.000824912353058,203877631.0,2003-08-19,2003,1,231,8,0.94,100.47,100.89,100.164,910
2003-08-20 13:30:00,100.28999,100.89,100.164,100.45,96.29875458333332,101.481475,92.10907430000034,95.93879880000004,99.38879939999997,99.059498,98.48189602302095,99.33283473584987,98.93461307692327,101.48257365831549,96.3866524955311,92.10907430000034,95.93879880000004,99.38879939999997,99.059498,100.50133333333332,23206192,39760105.55,57.45190547642209,1.5,2.75,1.3179333742837982,0.5836551910260208,0.2499418726462352,0.3372570961311112,0.08731522348487598,9.337118625817084,2.500000000000003,180671439.0,2003-08-20,2003,2,232,8,0.72,100.53,101.52,100.39999,911
2003-08-21 13:30:00,101.05,101.52,100.39999,100.77,96.295005,101.46597444444444,92.15727430000034,96.09909870000006,99.39819939999998,99.17349749999998,98.57162559074564,99.46970761814991,99.1084600000002,101.81996141601404,96.39695858398638,92.15727430000034,96.09909870000006,99.39819939999998,99.17349749999998,100.89666333333332,46550496,40028965.55,59.024025980848144,1.5,2.75,1.3037959904063836,1.1629202843589348,0.25697489552512937,0.4085338428912877,0.15155894736615833,8.226243709027193,2.533577533577528,227221935.0,2003-08-21,2003,3,233,8,1.12,100.96,101.81799000000001,99.73,912
2003-08-22 13:30:00,101.75,101.81799000000001,99.73,99.77,96.29125541666667,101.45047388888891,92.19687425000036,96.23639880000006,99.3813994,99.1504975,98.61862066561837,99.4983068926118,99.3661523076925,101.60162359089992,97.13068102448507,92.19687425000036,96.23639880000006,99.3813994,99.1504975,100.43933,52045008,40464960.75,52.4962037315893,1.5,2.75,1.3598098482344985,1.2861746813877732,0.18271261154827428,0.3799497118015012,0.19723710025322688,11.004439256135026,1.1353371652647846,175176927.0,2003-08-22,2003,4,234,8,2.09,100.77,100.0,99.28,913
2003-08-25 13:30:00,99.71001,100.0,99.28,99.92999,96.28750583333334,101.43497333333332,92.23132425000034,96.35449870000005,99.38879919999998,99.153997,98.67004691402548,99.53941956950592,99.59307461538481,101.36430626925608,97.82184296151355,92.23132425000034,96.35449870000005,99.38879919999998,99.153997,99.73666333333334,23485808,39918435.95,53.38447896963472,1.5,2.75,1.314109144789177,0.5883448948104391,0.13500036867589427,0.3659875610980947,0.23098719242220045,10.912335054443801,0.3817076845806193,198662735.0,2003-08-25,2003,0,237,8,0.73,99.64,100.39,98.83,914
2003-08-26 13:30:00,99.5,100.39,98.83,100.11,96.28375625,101.41947277777778,92.27807430000036,96.47859870000006,99.35779919999996,99.1894975,98.72651566249507,99.59376056288632,99.75538230769251,101.28286953541357,98.22789507997145,92.27807430000036,96.47859870000006,99.35779919999996,99.1894975,99.77666666666664,45076608,39493775.95,54.41725974361883,1.5,2.75,1.3316727773042358,1.14135979444123,0.10740026830178896,0.36523752779943663,0.2578372594976477,9.75055900826521,1.0803817730595453,243739343.0,2003-08-26,2003,1,238,8,1.58,99.61,100.36,99.57001,915
2003-08-27 13:30:00,100.05,100.36,99.57001,100.14,96.28000666666668,101.40397222222221,92.33052435000036,96.59779870000006,99.3273992,99.23849749999998,98.78194642082859,99.64578336642096,99.89845923076945,101.17402978047836,98.6228886810605,92.33052435000036,96.59779870000006,99.3273992,99.23849749999998,100.02333666666664,18987808,39022286.35,54.597795756160814,1.5,2.75,1.2929811503539337,0.4865888131129456,0.08403483739167611,0.3628808062372429,0.2788459688455667,9.064890796964539,0.835766790856911,262727151.0,2003-08-27,2003,2,239,8,0.79,99.97,101.0,99.66,916
2003-08-28 13:30:00,100.39999,101.0,99.66,100.75999,96.27625708333332,101.38847166666667,92.39302435000036,96.72489860000007,99.31119879999996,99.30699699999997,98.85951675726672,99.75189828390468,100.06076692307713,101.18792827990771,98.93360556624657,92.39302435000036,96.72489860000007,99.31119879999996,99.30699699999997,100.47333,27426400,37438006.35,58.27570133137778,1.5,2.75,1.2963396396143672,0.7325817444336215,0.1020087208431329,0.4063568698994828,0.30434814905634994,9.495037783298603,1.1443384862477388,290153551.0,2003-08-28,2003,3,240,8,1.34,100.33,101.48,100.48,917
2003-08-29 13:30:00,100.61,101.48,100.48,101.44,96.27250749999999,101.37297111111113,92.45542430000036,96.85739860000008,99.33959879999996,99.45349749999995,98.96071217855035,99.91266987591378,100.20615153846174,101.50653319388991,98.9057698830336,92.45542430000036,96.85739860000008,99.33959879999996,99.45349749999995,101.13333333333333,28721200,36407841.55,61.919402019629004,1.5,2.75,1.2751725224990549,0.7888740111263202,0.14854890266315307,0.4900342773852913,0.3414853747221382,9.94124464425556,0.9554140127388472,318874751.0,2003-08-29,2003,4,241,8,1.0,100.98,102.88,101.05,918
2003-09-02 13:30:00,101.64,102.88,101.05,102.8,96.26875791666669,101.35747055555555,92.52417430000034,97.01509860000006,99.40679879999996,99.66799799999997,99.11127248527387,100.1876536972553,100.49538307692328,102.22977093989395,98.7609952139526,92.52417430000034,97.01509860000006,99.40679879999996,99.66799799999997,102.24333333333335,50860608,36173651.95,67.94800878522167,1.5,2.75,1.3148030566062654,1.4060125328319248,0.2536109738662632,0.6584990920549672,0.404888118188704,11.381704871128123,1.9234582589728315,369735359.0,2003-09-02,2003,1,245,9,1.81,101.96,103.7,102.78,919
2003-09-03 13:30:00,103.03,103.7,102.78,103.36,96.26500833333334,101.34196999999999,92.58732430000036,97.17359870000006,99.50559879999996,100.01499799999996,99.2778892505573,100.48978191656431,100.80692153846174,102.97774168834032,98.63610138858314,92.58732430000036,97.17359870000006,99.50559879999996,100.01499799999996,103.28000000000002,44923904,35333011.95,70.05051079180735,1.5,2.75,1.2866028382772463,1.2714428100149553,0.3382137424341784,0.8276552962314271,0.4894415537972486,11.500089924701252,2.8969636635141827,414659263.0,2003-09-03,2003,2,246,9,0.9,103.24,103.55,102.75999,920
2003-09-04 13:30:00,103.10001,103.55,102.75999,103.41,96.26125875,101.32646944444444,92.6473743500003,97.33619880000006,99.60339879999994,100.33649799999996,99.43993280935894,100.76789792451058,101.09846000000022,103.55283125706065,98.64408874293974,92.6473743500003,97.33619880000006,99.60339879999994,100.33649799999996,103.23999666666668,28404400,34194231.95,70.23822918693077,1.5,2.75,1.2511319212574428,0.8306781109028535,0.3722401334655279,0.9547417206291584,0.5825015871636305,10.834132042451124,2.61982732956237,443063663.0,2003-09-04,2003,3,247,9,0.77,103.15,103.54899999999999,102.39999,921
2003-09-05 13:30:00,102.94,103.54899999999999,102.39999,102.83,96.25750916666668,101.31096888888891,92.70912435000037,97.47499880000004,99.70939879999996,100.57799799999997,99.57287662075665,100.96428859836672,101.27922923076943,103.8672923424148,98.69116611912405,92.70912435000037,97.47499880000004,99.70939879999996,100.57799799999997,102.92633,31654496,33599616.75,65.13794758219211,1.5,2.75,1.243837498310483,0.9421088411670648,0.3317289724746756,0.997162802756975,0.6654338302822994,11.877298693981896,3.067054224716851,411409167.0,2003-09-05,2003,4,248,9,1.12,102.97,103.88,102.92999,922
2003-09-08 13:30:00,103.03999,103.88,102.92999,103.67999,96.25375958333332,101.29546833333332,92.77572430000036,97.61399870000004,99.80699859999993,100.84799749999996,99.73393989053088,101.2229268270937,101.49615153846176,104.3648103010034,98.62749277592009,92.77572430000036,97.61399870000004,99.80699859999993,100.84799749999996,103.49665999999999,32655392,33864411.15,68.7224126598325,1.5,2.75,1.229991962716877,0.9642982379157656,0.33712532356177904,1.0868404847345232,0.7497151611727442,9.513651943312725,3.752627214312741,444064559.0,2003-09-08,2003,0,251,9,0.92,103.4,103.46001,102.67999,923
2003-09-09 13:30:00,103.37,103.46001,102.67999,103.0,96.25001,101.27996777777778,92.82887430000036,97.76149870000003,99.91379859999994,101.06549799999998,99.86202067913752,101.39217189118,101.69230538461558,104.59651161313974,98.78809915609142,92.82887430000036,97.76149870000003,99.91379859999994,101.06549799999998,103.04666666666668,35083504,33886891.15,63.13022032332485,1.5,2.75,1.2135639653799573,1.0353119690060444,0.27260460210842474,1.090470913808275,0.8178663116998504,11.220272144083776,2.8868244930576368,408981055.0,2003-09-09,2003,1,252,9,0.76,103.07,102.8,101.55,924
2003-09-10 13:30:00,102.53999,102.8,101.55,101.96001,96.24626041666669,101.26446722222221,92.86822435000036,97.88549880000005,100.00039879999993,101.18599849999997,99.94429477015171,101.44625171106762,101.78384461538481,104.64062768226611,98.92706154850352,92.86822435000036,97.88549880000005,100.00039879999993,101.18599849999997,102.10333666666666,45944704,34016775.95,55.66902153873783,1.5,2.75,1.2304522535671032,1.3506483997052636,0.14404781693470592,0.9979260828682328,0.8538782659335269,13.545649312521155,1.8174655482324709,363036351.0,2003-09-10,2003,2,253,9,1.23,102.18,102.75999,101.84,925
2003-09-11 13:30:00,102.10001,102.75999,101.84,102.25999,96.24251083333334,101.24896666666667,92.91242430000037,98.01159880000006,100.07499859999993,101.34699849999996,100.03510634779283,101.52375059572785,101.97538230769251,104.59002440412027,99.36074021126474,92.91242430000037,98.01159880000006,100.07499859999993,101.34699849999996,102.28666,38797008,34148851.15,57.2389068488024,1.5,2.75,1.2082763783123105,1.1361145893190612,0.06727906758768876,0.937977100418138,0.8706980328304491,13.521151472274914,1.4886861342483262,401833359.0,2003-09-11,2003,3,254,9,0.9,102.3,102.64,101.35001,926
2003-09-12 13:30:00,101.91,102.64,101.35001,102.45,96.23876125,101.23346611111113,92.95727430000036,98.12269880000008,100.12859859999992,101.50399849999997,100.12980805964406,101.61196482470615,102.16922923076945,104.50762343832119,99.83083502321767,92.95727430000036,98.12269880000008,100.12859859999992,101.50399849999997,102.14666999999996,42441200,34458541.55,58.24749074613777,1.5,2.75,1.2141130655757169,1.2316597885727991,0.01982302939677349,0.8954768195764159,0.8756537901796425,13.270072182253823,0.9956624605678284,444274559.0,2003-09-12,2003,4,255,9,1.27,102.0,102.63,101.95,927
2003-09-15 13:30:00,102.52,102.63,101.95,102.09,96.23501166666668,101.21796555555555,93.00922430000037,98.22179890000008,100.19559839999992,101.62749849999996,100.20667833181491,101.65749198425794,102.32153692307712,104.33957613079126,100.303497715363,93.00922430000037,98.22179890000008,100.19559839999992,101.62749849999996,102.22333333333331,21321904,34896276.8,55.57301939115764,1.5,2.75,1.1759621323203078,0.6110079915459635,-0.041918179353878426,0.8232560659872945,0.8651742453411729,13.14207430757093,-0.6906614785992157,422952655.0,2003-09-15,2003,0,258,9,0.67,102.29,103.64,102.17,928
2003-09-16 13:30:00,102.23199,103.64,102.17,103.58,96.23126208333332,101.202465,93.05572430000036,98.34399890000006,100.25319839999992,101.78249849999996,100.3389654560575,101.84058798575718,102.58615230769252,104.26405542571331,100.9082491896717,93.05572430000036,98.34399890000006,100.25319839999992,101.78249849999996,103.13,37946496,35649496.8,63.1206759912965,1.5,2.75,1.2026791228688574,1.0644328645895502,0.008781737996201744,0.8761514178364251,0.8673696798402234,13.565002918624725,0.2128482972136212,460899151.0,2003-09-16,2003,1,259,9,1.44,102.9,103.785,103.05,929
2003-09-17 13:30:00,103.48,103.785,103.05,103.38,96.2275125,101.18696444444444,93.10272430000038,98.47549890000006,100.29779859999992,101.90849849999998,100.45822171268264,101.98719865378031,102.78769153846173,104.13701694521687,101.43836613170656,93.10272430000038,98.47549890000006,100.29779859999992,101.90849849999998,103.405,32072400,35380276.8,61.607711206967146,1.5,2.75,1.1692734712353676,0.9065050615997444,0.01942793418536426,0.8916545975719288,0.8722266633865645,13.292262891420345,-0.02901073397157058,428826751.0,2003-09-17,2003,2,260,9,0.71,103.42,104.7,103.17,930
2003-09-18 13:30:00,103.39999,104.7,103.17,104.60001,96.22376291666669,104.7,93.15507435000036,98.60359910000008,100.37819879999992,102.11599899999996,100.62064478277355,102.23603782961077,103.03076923076941,104.45768680242838,101.60385165911043,93.15507435000036,98.60359910000008,100.37819879999992,102.11599899999996,104.15666999999999,30295008,35734717.6,66.83062174862782,1.5,2.75,1.1950396518614128,0.8477752179018199,0.09498858333000038,0.9909623925490648,0.8959738092190646,14.901722573182758,1.7212972867840115,459121759.0,2003-09-18,2003,3,261,9,1.48,103.94,104.60001,103.39999,931
2003-09-19 13:30:00,104.27,104.60001,103.39999,103.67,96.22001333333334,104.75957468085106,93.20907435000036,98.72239920000008,100.46559879999992,102.26099899999996,100.74022734031185,102.37260565536214,103.09769230769251,104.55629471247663,101.63908990290837,93.20907435000036,98.72239920000008,100.46559879999992,102.26099899999996,103.89,34381600,35126272.8,60.1167507254064,1.5,2.75,1.1953953910141686,0.9788001190949016,0.06984958814210263,0.9832857943966928,0.9134362062545902,15.556016565759805,-0.009635417596010514,424740159.0,2003-09-19,2003,4,262,9,1.16,104.0,102.96001,102.03,932
2003-09-22 13:30:00,102.85001,102.96001,102.03,102.55,96.21626375,104.81914936170212,93.25957435000036,98.82879920000006,100.5117985999999,102.39999899999998,100.81119881716236,102.38950035485144,103.03538461538479,104.51292263802864,101.55784659274099,93.25957435000036,98.82879920000006,100.5117985999999,102.39999899999998,102.51333666666666,36700608,34359052.8,53.186993474294795,1.5,2.75,1.2271528630845852,1.0681495853110363,-0.02937208485837106,0.8767211001816264,0.9060931850399976,16.07338799370876,-0.4368932038834979,388039551.0,2003-09-22,2003,0,265,9,0.91,102.5,103.28999,102.36,933
2003-09-23 13:30:00,102.59,103.28999,102.36,102.94,96.21251416666668,104.8787240425532,93.31712440000034,98.93919930000007,100.55599859999992,102.55049949999996,100.89468121648932,102.44192889248464,102.99923076923096,104.46125304707546,101.5372084913865,93.31712440000034,98.93919930000007,100.55599859999992,102.55049949999996,102.86333,32513200,34810422.4,55.126724712185705,1.5,2.75,1.205926944292829,0.9340076264055904,-0.07339436374964348,0.8143502303529431,0.8877445941025865,15.880171734678516,0.9611513376666015,420552751.0,2003-09-23,2003,1,266,9,0.91,102.82,103.22,101.07001,934
2003-09-24 13:30:00,103.118,103.22,101.07001,101.11,96.20876458333332,104.93829872340427,93.36252440000037,99.01819920000008,100.56799879999993,102.60049949999998,100.90312509035248,102.3150785217718,102.86692307692327,104.64368671414913,101.09015943969742,93.36252440000037,99.01819920000008,100.56799879999993,102.60049949999998,101.80000333333334,41717504,34642467.2,45.58243319410963,1.5,2.75,1.2733600197004846,1.2042301652233358,-0.22201894427447635,0.6102209137594912,0.8322398580339675,18.151598196417467,-1.1245747237018138,378835247.0,2003-09-24,2003,2,267,9,2.13,102.15,101.88,100.2,935
2003-09-25 13:30:00,101.41,101.88,100.2,100.28,96.205015,104.99787340425532,93.41642440000034,99.09069920000007,100.57519879999992,102.6074995,100.87868881229944,102.12126151969831,102.60538538461556,104.78231031314472,100.42846045608641,93.41642440000034,99.09069920000007,100.57519879999992,102.6074995,100.78666666666668,53174496,36351801.6,42.02829007019048,1.5,2.75,1.302405732579021,1.4627747088056289,-0.3640913849768215,0.3771256268129406,0.7412170117897621,18.431875759903733,-2.1181063933626176,325660751.0,2003-09-25,2003,3,268,9,1.68,101.04,100.66,99.84599,936
2003-09-26 13:30:00,100.44,100.66,99.84599,99.95,96.20126541666669,105.05744808510642,93.46267440000034,99.15109920000008,100.6041987999999,102.56699999999998,100.84226964318964,101.9144747082985,102.3707700000002,104.94768114395883,99.79385885604155,93.46267440000034,99.15109920000008,100.6041987999999,102.56699999999998,100.15199666666666,42916096,37126286.4,40.67048540897676,1.5,2.75,1.2675203231090908,1.1559490636262506,-0.4618707294459605,0.16387859998231136,0.6257493294282719,18.278909146743096,-2.0961896365951618,282744655.0,2003-09-26,2003,4,269,9,0.82,100.25,100.99001,99.78999,937
2003-09-29 13:30:00,100.3,100.99001,99.78999,100.92999,96.19751583333334,105.11702276595743,93.51342435000036,99.2264991000001,100.63259879999993,102.5414995,100.8457096571822,101.82071425988907,102.29153769230787,104.97522306087244,99.6078523237433,93.51342435000036,99.2264991000001,100.63259879999993,102.5414995,100.56999666666668,36785200,37529486.4,46.22641754622554,1.5,2.75,1.2626988714584408,0.980167956681656,-0.4421090662424815,0.07311299662517001,0.5152220628676515,19.54108834499736,-2.55841861363197,319529855.0,2003-09-29,2003,0,272,9,1.2,100.39,100.75999,99.25,938
2003-09-30 13:30:00,100.48,100.75999,99.25,99.95,99.25,105.17659744680851,93.55932435000037,99.30149910000007,100.66599879999993,102.39899949999996,100.81058378827309,101.6425509970425,102.11384615384635,105.07401148667358,99.15368082101914,93.55932435000037,99.30149910000007,100.66599879999993,102.39899949999996,99.98666333333334,70775872,38525249.6,41.99161293550314,1.5,2.75,1.292505380639981,1.8371294861124012,-0.4737846043551495,-0.0770086925762854,0.3967759117788641,17.2709892150548,-3.3178564519249303,248753983.0,2003-09-30,2003,1,273,9,1.52,100.0,102.17999,100.2,939
2003-10-01 13:30:00,100.24001,102.17999,100.2,102.08,99.32461538461538,105.23617212765957,93.62302435000036,99.3849991000001,100.72419879999991,102.3349995,100.86036481618395,101.684212806848,102.08538461538478,105.03918250842753,99.13158672234208,93.62302435000036,99.3849991000001,100.72419879999991,102.3349995,101.48666333333334,65802816,39569195.2,52.23406743504478,1.5,2.75,1.3594685677371257,1.6629809038926318,-0.33648735245300565,-0.023833278787392945,0.3126540736656127,22.356830772860132,-2.409187150173312,314556799.0,2003-10-01,2003,2,274,10,1.98,101.19,102.56,101.63,940
2003-10-02 13:30:00,101.92999,102.56,101.63,102.45,99.39923076923077,105.29574680851064,93.67702440000036,99.46069910000013,100.78839859999991,102.2869995,100.92270345084341,101.75714492048151,102.11307692307713,105.07327183989914,99.1528820062551,93.67702440000036,99.46069910000013,100.78839859999991,102.2869995,102.21333333333334,44638800,40380915.2,53.761369775931136,1.5,2.75,1.3287922414701885,1.105442998973931,-0.2120307437126032,0.04761564402485874,0.2596463877374619,21.082395621443094,-1.1768110350149499,359195599.0,2003-10-02,2003,3,275,10,0.92,102.1,104.28,103.08,941
2003-10-03 13:30:00,103.67,104.28,103.08,103.39,99.47384615384615,105.3553214893617,93.73972435000036,99.5474990000001,100.88639839999986,102.3149995,101.01946017826131,101.91265492805469,102.09846153846176,105.03129123693334,99.16563183999016,93.73972435000036,99.5474990000001,100.88639839999986,102.3149995,103.58333333333331,48820496,41239215.2,57.48100663954544,1.5,2.75,1.3645927956508892,1.1838366895013075,-0.06528729309596898,0.1780372713675007,0.2433245644634697,21.477420373728,0.8191126279863514,408016095.0,2003-10-03,2003,4,276,10,1.16,103.68,103.99001,103.2,942
2003-10-06 13:30:00,103.48199,103.99001,103.2,103.86,99.54846153846155,105.41489617021277,93.81002435000036,99.6409991000001,100.95899839999987,102.324,101.13085389676088,102.09811636347807,102.1353846153848,105.14295437169106,99.12781485907858,93.81002435000036,99.6409991000001,100.95899839999987,102.324,103.68333666666666,20242496,40618570.4,59.24630166444098,1.5,2.75,1.3235511673901108,0.4983556979149616,0.05788708503035411,0.3156834207514123,0.2577963357210582,20.496539750620943,0.8937244997085698,428258591.0,2003-10-06,2003,0,279,10,0.77,103.6,104.31,102.91,943
2003-10-07 13:30:00,103.25999,104.31,102.91,104.25999,99.62307692307692,105.47447085106384,93.88552430000036,99.73249900000009,101.04699819999986,102.3869995,101.25356511649576,102.30400909076586,102.10922923076943,105.03542249831484,99.18303596322399,93.88552430000036,99.73249900000009,101.04699819999986,102.3869995,103.82666333333334,42619392,40995364.8,60.740191125679466,1.5,2.75,1.3290117982908178,1.0396148981213604,0.15523200967117728,0.4518363478100298,0.2966043381388525,20.498719289208037,3.1154089605380304,470877983.0,2003-10-07,2003,1,280,10,1.36,103.61,104.39,103.41,944
2003-10-08 13:30:00,104.33,104.39,103.41,104.0,99.69769230769232,105.5340455319149,93.95557425000037,99.8237990000001,101.13899839999986,102.48899899999999,101.36126844526062,102.46553203450243,102.13461384615402,105.11965886122343,99.14956883108464,93.95557425000037,99.8237990000001,101.13899839999986,102.48899899999999,103.93333333333334,30943808,40245320.0,59.22063518808061,1.5,2.75,1.3040823841271882,0.7688796610388487,0.18881236454578515,0.5326197938210839,0.3438074292752988,16.792034057355053,3.709613083366573,439934175.0,2003-10-08,2003,2,281,10,0.95,103.9,105.22,103.83,945
2003-10-09 13:30:00,104.88,105.22,103.83,104.28,99.77230769230768,105.59362021276596,94.02687425000036,99.9400991000001,101.24139839999991,102.58999950000002,101.4757285062308,102.63833850740696,102.26769076923095,105.46186901563608,99.07351252282585,94.02687425000036,99.9400991000001,101.24139839999991,102.58999950000002,104.44333333333334,40094800,40310209.6,60.37049592806882,1.5,2.75,1.310219356689532,0.9946562024326462,0.2146965434377784,0.6121781085725218,0.39748156513474336,15.263064811648894,4.332166083041519,480028975.0,2003-10-09,2003,3,282,10,1.34,104.52,104.60001,103.91,946
2003-10-10 13:30:00,104.27,104.60001,103.91,104.57001,99.84692307692309,105.65319489361704,94.10294930000036,100.06119910000008,101.34499859999987,102.69600000000004,101.59707287853549,102.82230722098727,102.39307615384632,105.80361693590295,98.98253537178968,94.10294930000036,100.06119910000008,101.34499859999987,102.69600000000004,104.36000666666666,22686000,39322449.6,61.57890547363513,1.5,2.75,1.2659186883545654,0.5769223492119372,0.23454949485816035,0.6906684337074438,0.4561189388492834,14.598732631206206,3.6064800957574583,502714975.0,2003-10-10,2003,4,283,10,0.66,104.26,105.28998999999999,104.50999,947
2003-10-13 13:30:00,104.715,105.28998999999999,104.50999,104.89998999999999,99.92153846153845,105.71276957446808,94.18049925000037,100.18369910000007,101.47279859999986,102.83649950000002,101.72659904016152,103.02018177136942,102.68461384615401,106.250983258906,99.118244433402,94.18049925000037,100.18369910000007,101.47279859999986,102.83649950000002,104.89999000000002,23829504,39447829.6,62.9627692614613,1.5,2.75,1.2312102106149538,0.6040764280729909,0.2515976715042394,0.7706160282295826,0.5190183567253432,14.219608872877009,4.9524662331165565,526544479.0,2003-10-13,2003,0,286,10,0.75,104.9,105.42998999999999,104.36,948
2003-10-14 13:30:00,104.8,105.42998999999999,104.36,105.27,99.99615384615385,105.77234425531915,94.26994925000037,100.3006990000001,101.60799879999992,102.92099950000002,101.86555594054735,103.23445017409614,103.06846000000016,106.59084475028617,99.54607524971418,94.26994925000037,100.3006990000001,101.60799879999992,102.92099950000002,105.01999666666666,38504400,39475724.8,64.50653888249772,1.5,2.75,1.2196944812853143,0.9753943770527046,0.2679753551650238,0.8539875506816229,0.5860121955165992,11.320039575748849,3.1249999999999982,565048879.0,2003-10-14,2003,1,287,10,1.03,104.89,105.89,104.64,949
2003-10-15 13:30:00,105.86,105.89,104.64,104.99001000000001,100.07076923076923,105.8319189361702,94.35434930000037,100.41299920000007,101.77939899999993,103.0015,101.98808355072195,103.40164634799173,103.45615307692324,106.61048910193243,100.30181705191404,94.35434930000037,100.41299920000007,101.77939899999993,103.0015,105.17333666666669,39881200,39866164.8,62.387422688635176,1.5,2.75,1.2218591611935063,1.0003771418714449,0.2409819900501613,0.8872396830793008,0.6462576930291395,6.144576193498755,2.4792679355783265,525167679.0,2003-10-15,2003,2,288,10,1.19,105.26,105.73,104.64999,950
2003-10-16 13:30:00,104.67999,105.73,104.64999,105.41,100.1453846153846,105.89149361702127,94.44024930000036,100.51309930000008,101.94799899999992,103.0419995,102.12227635265444,103.5929181243735,103.8007692307694,106.74795042943927,100.85358803209951,94.44024930000036,100.51309930000008,101.94799899999992,103.0419995,105.26333000000001,32793504,39991089.6,64.2828574860531,1.5,2.75,1.2117270782511131,0.8200202677148362,0.23234137022142445,0.93668440580592,0.7043430355844956,6.166227476462648,1.9537672889060802,557961183.0,2003-10-16,2003,3,289,10,1.03,105.19,105.63,103.98,951
2003-10-17 13:30:00,105.47,105.63,103.98,104.25999,100.22,105.95106829787235,94.50619920000037,100.5989992000001,102.07319879999993,103.071499,102.20610826039349,103.65644877919506,104.13230692307708,106.0684121503223,102.19620169583185,94.50619920000037,100.5989992000001,102.07319879999993,103.071499,104.62333,32801200,39912069.6,55.96619815774215,1.5,2.75,1.2430322869474617,0.8218366105475021,0.1349335659813543,0.8730099930611885,0.7380764270798342,8.862607185879362,0.38512420566146977,525159983.0,2003-10-17,2003,4,290,10,1.59,104.8,105.03998999999999,103.94,952
2003-10-20 13:30:00,104.44700999999999,105.03998999999999,103.94,105.03998999999999,100.29461538461538,106.01064297872341,94.57464910000036,100.69519910000008,102.20839859999992,103.1959985,102.31724087763295,103.78821460974793,104.35999846153862,105.94070875955204,102.7792881635252,94.57464910000036,100.69519910000008,102.20839859999992,103.1959985,104.67332666666664,27778096,39465944.0,59.76810840399663,1.5,2.75,1.2328149807369289,0.7038497799520518,0.10985567676901686,0.8753960230411053,0.7655403462720884,9.445567748536412,0.7481297475666371,552938079.0,2003-10-20,2003,0,293,10,1.06,104.49,105.28,104.32001,953
2003-10-21 13:30:00,104.82001,105.28,104.32001,104.86,100.36923076923077,106.0702176595745,94.63414905000036,100.77429910000008,102.33259879999993,103.2919985,102.41695692164735,103.89028940881954,104.54538307692324,105.69238276073513,103.39838339311136,94.63414905000036,100.77429910000008,102.33259879999993,103.2919985,104.82000333333332,26763696,39178468.8,58.51264554758674,1.5,2.75,1.2133274821128628,0.6831225624621655,0.06991269902732823,0.8529312200562487,0.7830185210289204,9.399781845211026,0.8269230769230764,526174383.0,2003-10-21,2003,1,294,10,0.92,104.8,104.19,103.19,954
2003-10-22 13:30:00,104.03,104.19,103.19,103.53999,100.44384615384615,106.12979234042555,94.68819900000038,100.83619890000007,102.41239859999992,103.413498,102.46099743452393,103.8569275603605,104.55692076923091,105.65935186443001,103.45448967403185,94.68819900000038,100.83619890000007,102.41239859999992,103.413498,103.63999666666666,34121696,38798678.4,50.18665135116353,1.5,2.75,1.2459469476762297,0.8794551105122179,-0.05016630961246071,0.7203106340133445,0.7704769436258052,12.04747647316457,-0.7096375143843481,492052687.0,2003-10-22,2003,2,295,10,0.97,103.69,103.95,102.84,955
2003-10-23 13:30:00,102.89,103.95,102.84,103.35001,100.51846153846155,106.1893670212766,94.74799905000036,100.89219900000008,102.49859899999993,103.5669985,102.49586067238577,103.80864969746905,104.51769076923094,105.74567594547537,103.28970559298651,94.74799905000036,100.89219900000008,102.49859899999993,103.5669985,103.38000333333332,46399808,38459944.0,49.103682957792905,1.5,2.75,1.236236451413642,1.2064450223848477,-0.14194807606114335,0.593041848549376,0.7349899246105194,11.896316407125195,-1.1666824933840965,445652879.0,2003-10-23,2003,3,296,10,1.08,103.4,103.58,102.17999,956
2003-10-24 13:30:00,102.83,103.58,102.17999,103.58,102.17999,106.24894170212768,94.80184905000038,100.93639900000008,102.5839989999999,103.7484985,102.53837594013531,103.78687353580533,104.465383846154,105.78716769734396,103.143599994964,94.80184905000038,100.93639900000008,102.5839989999999,103.7484985,103.11333,51735104,38900894.4,50.4963601047555,1.5,2.75,1.2479345620269526,1.3299206817208808,-0.18405729480171185,0.5049183061083795,0.6889756009100914,11.837945319206991,-1.2583318644739665,497387983.0,2003-10-24,2003,4,297,10,1.37,102.88,104.17999,103.27,957
2003-10-27 14:30:00,103.74001,104.17999,103.27,103.63,102.34276722222221,106.30851638297872,94.85469905000038,100.97619910000007,102.66419899999993,103.883499,102.58118472679668,103.77193319906195,104.43692230769246,105.81240757165766,103.06143704372722,94.85469905000038,100.97619910000007,102.66419899999993,103.883499,103.69333,32499008,38686584.8,50.81147838406407,1.5,2.75,1.2237956647393136,0.840058851615147,-0.20389232563215445,0.4341101938698984,0.6380025195020528,11.5968223093264,-1.5578987365821229,529886991.0,2003-10-27,2003,0,300,10,0.88,103.72,105.14998999999999,103.82001,958
2003-10-28 14:30:00,103.98,105.14998999999999,103.82001,105.03998999999999,102.50554444444445,106.36809106382981,94.9147490000004,101.03399910000006,102.75539879999992,104.13799850000002,102.67760846300072,103.89270051343702,104.49538307692322,105.90343743479636,103.08732871905006,94.9147490000004,101.03399910000006,102.75539879999992,104.13799850000002,104.66999666666668,35035200,36899551.2,58.77996013783015,1.5,2.75,1.2449524029722203,0.9494749627198718,-0.12147044544261733,0.4861644626987811,0.6076349081413984,14.20787695655369,0.04760452923092876,564922191.0,2003-10-28,2003,1,301,10,1.28,104.48,105.42998999999999,103.87,959
2003-10-29 14:30:00,104.77,105.42998999999999,103.87,105.17998999999999,102.66832166666669,106.42766574468084,94.97399895000041,101.10329900000006,102.84179859999992,104.29299800000004,102.77574107229479,104.01529951215728,104.5423046153848,105.99705828252944,103.08755094824012,94.97399895000041,101.10329900000006,102.84179859999992,104.29299800000004,104.82666,30965296,35157675.2,59.48183274345924,1.5,2.75,1.2674550884742044,0.8807549368338211,-0.06004754478224673,0.53257547716359,0.5926230219458367,14.141346396303616,-0.2182051038800806,595887487.0,2003-10-29,2003,2,302,10,1.5,104.65,105.97,104.8,960
2003-10-30 14:30:00,105.78998999999999,105.97,104.8,105.39998999999999,102.83109888888887,106.48724042553192,95.0389989500004,101.16479890000005,102.94079839999992,104.44049750000003,102.87865279494991,104.14717479671373,104.58076615384633,106.09647430209246,103.06505800560015,95.0389989500004,101.16479890000005,102.94079839999992,104.44049750000003,105.38999666666666,39144800,34882975.2,60.61669047776682,1.5,2.75,1.2604940107260472,1.1221749227399616,-0.009764014015726684,0.5804180044261784,0.5901820184419051,13.995450569300337,1.0934204002896994,635032287.0,2003-10-30,2003,3,303,10,1.12,105.38,105.74001000000001,105.22,961
2003-10-31 14:30:00,105.39998999999999,105.74001000000001,105.22,105.3,102.99387611111112,106.54681510638298,95.10539895000038,101.21479890000006,103.03139839999993,104.53599750000004,102.97360758730484,104.2569676732172,104.58307384615401,106.10305777011898,103.06308992218905,95.10539895000038,101.21479890000006,103.03139839999993,104.53599750000004,105.42000333333334,25764704,33730185.6,59.796926068702184,1.5,2.75,1.2076022956741868,0.7638470865692479,0.010502869652386893,0.6033106055073887,0.5928077358550018,12.193553853382982,0.24753429622374684,609267583.0,2003-10-31,2003,4,304,10,0.49,105.48,106.61,105.71001000000001,962
2003-11-03 14:30:00,105.75,106.61,105.71001000000001,105.99001000000001,103.15665333333334,106.60638978723404,95.1820490000004,101.26859900000004,103.15579859999993,104.64249800000003,103.09189787799878,104.42201932338699,104.65999692307709,106.34664953884176,102.97334430731243,95.1820490000004,101.26859900000004,103.15579859999993,104.64249800000003,106.10333999999999,37599200,34598020.8,63.46846592908516,1.5,2.75,1.2149164174117453,1.0867442452083849,0.0612854931584953,0.6694146023031209,0.6081291091446256,12.025528778116813,1.0776368491321748,646866783.0,2003-11-03,2003,0,307,11,0.85,106.16,106.27,105.58,963
2003-11-04 14:30:00,105.99001000000001,106.27,105.58,105.75998999999999,103.31943055555556,106.66596446808512,95.26459895000038,101.33059890000006,103.27239859999992,104.71749800000003,103.19652894160666,104.54944510211205,104.6869192307694,106.43080066779802,102.94303779374077,95.26459895000038,101.33059890000006,103.27239859999992,104.71749800000003,105.86999666666664,31433760,34038739.2,61.45366710753881,1.5,2.75,1.1774223875966203,0.9234701619030588,0.06967883489059122,0.6952276527578647,0.6255488178672735,12.064646390441427,2.144099106055543,615433023.0,2003-11-04,2003,1,308,11,0.65,105.92,105.97,104.89998999999999,964
2003-11-05 14:30:00,105.53998999999999,105.97,104.89998999999999,105.84,103.4822077777778,106.72553914893619,95.3529489500004,101.37239890000006,103.38699859999993,104.80949800000003,103.30019447330835,104.67235509238708,104.8084584615386,106.63467283164779,102.98224409142941,95.3529489500004,101.37239890000006,103.38699859999993,104.80949800000003,105.56999666666668,33637008,34173399.2,61.906654543653936,1.5,2.75,1.1697500741968614,0.9843038382906899,0.07068998133474569,0.7139112945357056,0.6432213132009599,8.499113989372063,2.4092789154060132,649070031.0,2003-11-05,2003,2,309,11,1.02,105.43,106.44,105.10001000000001,965
2003-11-06 14:30:00,105.60001000000001,106.44,105.10001000000001,106.39998999999999,103.64498499999999,106.78511382978724,95.4413988500004,101.41979880000008,103.51219839999992,104.91549750000004,103.42175508219822,104.83689175025499,104.913073846154,106.92656911326401,102.899578579044,95.4413988500004,101.41979880000008,103.51219839999992,104.91549750000004,105.98000000000002,28409392,33589128.8,65.00631060033335,1.5,2.75,1.1819100688970856,0.8457912728001449,0.09749119033450104,0.7650853011190861,0.6675941107845851,8.240860848215315,2.7225236532149104,677479423.0,2003-11-06,2003,3,310,11,1.27,105.77,106.72,105.57001000000001,966
2003-11-07 14:30:00,106.64,106.72,105.57001000000001,105.61,103.80776222222221,106.84468851063829,95.5375488500004,101.46019870000008,103.60919859999993,104.96749700000004,103.50756860838652,104.91052110737357,104.97076615384633,107.01757608223856,102.92395622545406,95.5375488500004,101.46019870000008,103.60919859999993,104.96749700000004,105.96667,31737008,34041679.2,57.8543309164675,1.5,2.75,1.1796300639758657,0.9322985453667044,0.052677375301112266,0.7334408299109754,0.6807634546098631,10.17374140256925,1.9106436360127412,645742415.0,2003-11-07,2003,4,311,11,1.09,106.15,105.84,105.00998999999999,967
2003-11-10 14:30:00,105.74001000000001,105.84,105.00998999999999,105.17998999999999,103.97053944444444,106.90426319148935,95.6374488000004,101.51179860000008,103.68399839999992,104.98149700000006,103.57315376099882,104.93618481143322,105.09692000000015,106.97024795414622,103.22359204585413,95.6374488000004,101.51179860000008,103.68399839999992,104.98149700000006,105.34332666666668,25538304,34127119.2,54.34919006224987,1.5,2.75,1.1546572022633037,0.748328736754317,-0.011821114920078757,0.6659870609597647,0.6778081758798434,10.733152298249566,0.13328257171387828,620204111.0,2003-11-10,2003,0,314,11,0.79,105.42,105.33,104.8,968
2003-11-11 14:30:00,105.09,105.33,104.8,105.14998999999999,104.13331666666667,106.96383787234043,95.7340487500004,101.56889850000007,103.73099819999992,104.97549650000003,103.63499047625378,104.95654721034435,105.23538000000015,106.81479653524192,103.65596346475836,95.7340487500004,101.56889850000007,103.73099819999992,104.97549650000003,105.09333000000001,26809008,33542349.6,54.102916575125974,1.5,2.75,1.1100388306730675,0.7992584991720436,-0.05972181434159196,0.6031559079528535,0.6628777222944454,7.521520215615787,-0.02852253551269698,593395103.0,2003-11-11,2003,1,315,11,0.51,105.06,106.47,105.16,969
2003-11-12 14:30:00,105.23,106.47,105.16,106.33,104.29609388888888,107.02341255319149,95.8332987500004,101.64799850000007,103.79039819999993,105.04249600000006,103.74067712424385,105.0873522379306,105.44691846153862,106.80378001607723,104.090056907,95.8332987500004,101.64799850000007,103.79039819999993,105.04249600000006,105.98666666666666,28053696,32950974.4,61.493914361710424,1.5,2.75,1.125036771339277,0.8513768260522214,-0.017352176735282998,0.6411875013753416,0.6585396781106246,9.854231118038232,0.8823625125581092,621448799.0,2003-11-12,2003,2,316,11,1.25,105.82,106.53998999999999,105.78,970
2003-11-13 14:30:00,106.00998999999999,106.53998999999999,105.78,106.36,104.45887111111112,107.08298723404256,95.9429488000004,101.72639850000007,103.84939819999992,105.08999600000007,103.84339566839114,105.20855678669909,105.6569184615386,106.60846996451322,104.705366958564,95.9429488000004,101.72639850000007,103.84939819999992,105.08999600000007,106.22666333333336,29723600,32797479.2,61.66294172577635,1.5,2.75,1.0989620019579005,0.9062769677737916,0.006024670430989088,0.666070516149361,0.6600458457183719,9.841589627155015,1.006647673314342,651172399.0,2003-11-13,2003,3,317,11,0.72,106.16,106.95,105.28998999999999,971
2003-11-14 14:30:00,106.39998999999999,106.95,105.28998999999999,105.46001000000001,104.62164833333334,107.14256191489363,96.0399488500004,101.80569860000007,103.90199839999993,105.14999700000006,103.90679230884638,105.23250471177538,105.68922769230784,106.58147033722612,104.79698504738957,96.0399488500004,101.80569860000007,103.90199839999993,105.14999700000006,105.9,49162704,33615554.4,54.004217423924544,1.5,2.75,1.1390368589609077,1.4624986818602046,-0.04309176907228207,0.6061811343780192,0.6492729034503013,11.216142003021544,-0.5000471270830158,602009695.0,2003-11-14,2003,4,318,11,1.58,106.12,105.14,104.03999,972
2003-11-17 14:30:00,104.91,105.14,104.03999,104.92998999999999,104.78442555555556,107.20213659574469,96.1334488000004,101.86699850000008,103.92699839999992,105.14449700000004,103.94691770849946,105.20369378684437,105.6699969230771,106.61455643791115,104.72543740824301,96.1334488000004,101.86699850000008,103.92699839999992,105.14449700000004,104.70332666666664,44438704,34448584.8,50.06082955779448,1.5,2.75,1.159107083320842,1.2900008594837835,-0.11136199537094617,0.5100704092366186,0.6214324046075648,10.76538552557524,-0.7847958381993023,557570991.0,2003-11-17,2003,0,321,11,1.06,104.59,105.45,103.7,973
2003-11-18 14:30:00,105.24001000000001,105.45,103.7,103.84,104.9472027777778,107.26171127659576,96.2257488000004,101.92879850000007,103.94379839999992,105.09349700000004,103.94272485718577,105.0738181880973,105.54999769230784,106.90741759791159,104.19257778670408,96.2257488000004,101.92879850000007,103.94379839999992,105.09349700000004,104.33,41167600,35168780.0,43.09208886578368,1.5,2.75,1.2013137202264963,1.1705723087351907,-0.223540766782984,0.3420064461288348,0.5655472129118188,12.058423039079564,-1.889644746787604,516403391.0,2003-11-18,2003,1,322,11,1.69,104.58,105.00998999999999,103.92,974
2003-11-19 14:30:00,104.03,105.00998999999999,103.92,104.72,105.10998,107.3212859574468,96.32509875000042,101.99969850000008,103.99899819999992,105.15249750000002,103.97320623533531,105.04012121780231,105.50538230769243,106.92923774552051,104.08152686986436,96.32509875000042,101.99969850000008,103.99899819999992,105.15249750000002,104.54999666666669,29836704,34954530.4,49.236151620491064,1.5,2.75,1.1990763116388894,0.8535861777733967,-0.23113031288885,0.2766343218007563,0.5077646346896063,13.390698447016664,-1.5789381183212552,546240095.0,2003-11-19,2003,2,323,11,1.05,104.46,105.24001000000001,103.75,975
2003-11-20 14:30:00,103.91,105.24001000000001,103.75,103.78,105.27275722222221,107.38086063829788,96.4217487500004,102.05219850000007,104.02939839999992,105.17399700000004,103.96562952022413,104.92010967324973,105.33538153846169,106.99534545910194,103.67541761782141,96.4217487500004,102.05219850000007,104.02939839999992,105.17399700000004,104.25667,53631696,35316124.8,43.79670965839644,1.5,2.75,1.2198572893789683,1.518617807127015,-0.2883888576670293,0.14727856260581973,0.435667420272849,13.426266824951362,-1.7327904554492932,492608399.0,2003-11-20,2003,3,324,11,1.44,104.5,104.33,103.62,976
2003-11-21 14:30:00,104.24001,104.33,103.62,104.21001,103.62,107.44043531914896,96.5256988000004,102.09659860000008,104.06459859999994,105.20549750000002,103.97521306845064,104.85248113294024,105.21615230769243,106.95765268105036,103.47465193433456,96.5256988000004,102.09659860000008,104.06459859999994,105.20549750000002,104.05333666666668,30025504,34230644.8,46.69773356528234,1.5,2.75,1.1834389115661843,0.877152743555681,-0.2856892468835547,0.07855586166840567,0.3642451085519604,13.506387041233005,-0.9222096332201656,522633903.0,2003-11-21,2003,4,325,11,0.69,103.98,105.78,104.67999,977
2003-11-24 14:30:00,104.69,105.78,104.67999,105.59,103.6920005,107.50001,96.6335988500004,102.1650985000001,104.13459859999992,105.30349750000002,104.03853804615845,104.92272102504116,105.19692153846168,106.91581608485895,103.4780269920644,96.6335988500004,102.1650985000001,104.13459859999992,105.30349750000002,105.34999666666664,28967104,34054049.6,54.76688916796906,1.5,2.75,1.2110497035971717,0.8506214191923888,-0.1842738959785533,0.13390273857876878,0.31817663455732204,15.66727625837533,0.4184593835910026,551601007.0,2003-11-24,2003,0,328,11,1.05,105.23,106.42,105.45,978
2003-11-25 14:30:00,105.71001000000001,106.42,105.45,105.99001000000001,103.764001,107.55958468085106,96.74639895000044,102.21799860000007,104.18279879999994,105.35099850000002,104.1150663580738,105.02436759408484,105.16538461538477,106.80819000928987,103.52257922147966,96.74639895000044,102.21799860000007,104.18279879999994,105.35099850000002,105.95333666666666,37582304,34181404.8,56.807994318948346,1.5,2.75,1.193831867625945,1.09949559475098,-0.08842182858675507,0.2076493488238782,0.2960711774106333,15.776370444570675,-0.3197498354180384,589183311.0,2003-11-25,2003,1,329,11,0.92,105.94,106.45,105.39,979
2003-11-26 14:30:00,106.42,106.45,105.39,106.37,103.8360015,107.61915936170212,96.86774890000042,102.2701987000001,104.24259879999994,105.410499,104.20349512834544,105.15252306131487,105.2238461538463,106.9762173555373,103.47147495215529,96.86774890000042,102.2701987000001,104.24259879999994,105.410499,106.07,33076304,34286955.2,58.713889009886934,1.5,2.75,1.1842724485098064,0.9646906179642336,-0.0021575416794078484,0.29337425031137343,0.2955317919907813,14.505792065399785,0.00940203083866596,622259615.0,2003-11-26,2003,2,330,11,1.01,105.92,106.66,106.20100000000001,980
2003-11-28 14:30:00,106.31,106.66,106.20100000000001,106.45,103.908002,107.6787340425532,96.98824885000045,102.3288987000001,104.27959859999993,105.46299950000001,104.29159335860642,105.2760922935706,105.32153923076936,107.19093439418634,103.4521440673524,96.98824885000045,102.3288987000001,104.27959859999993,105.46299950000001,106.43700000000001,10507801,32855105.25,59.122846975967256,1.5,2.75,1.1324672736162489,0.3198224726429693,0.05443545020705304,0.3635761047495976,0.3091406545425445,14.511178836044268,0.9387349764142882,632767416.0,2003-11-28,2003,4,332,11,0.43,106.43,107.67998999999999,106.8,981
2003-12-01 14:30:00,106.92998999999999,107.67998999999999,106.8,107.60001000000001,103.9800025,107.73830872340427,97.10549895000042,102.41189880000009,104.35819879999994,105.57799999999999,104.42133518768068,105.49741778942102,105.51000230769249,107.73280968023649,103.28719493514843,97.10549895000042,102.41189880000009,104.35819879999994,105.57799999999999,107.36,38710704,33502405.25,64.55775537107364,1.5,2.75,1.13943318264366,1.1554604426498605,0.1576258201121059,0.5061729296826769,0.34854710957057106,14.548434136763152,2.5445728146929145,671478120.0,2003-12-01,2003,0,335,12,0.82,107.24,107.77,107.07001000000001,982
2003-12-02 14:30:00,107.42998999999999,107.77,107.07001000000001,107.33,104.052003,107.79788340425532,97.21399895000042,102.48279870000013,104.45379879999993,105.64499950000001,104.53540047443829,105.67194942852377,105.58692538461555,107.9805649248514,103.19328584437969,97.21399895000042,102.48279870000013,104.45379879999993,105.64499950000001,107.39000333333333,35369904,33390940.45,62.45802864745368,1.5,2.75,1.1080443838833984,1.0592664813668045,0.19363149401075666,0.5905864770840168,0.39695498307326016,14.168912321957455,3.360939907550072,636108216.0,2003-12-02,2003,1,336,12,0.65,107.42,108.08,107.07001000000001,983
2003-12-03 14:30:00,107.64998999999999,108.08,107.07001000000001,107.16,104.1240035,107.85745808510642,97.32389900000042,102.54709870000013,104.53819879999992,105.715,104.63832594602894,105.81366853056913,105.64846384615402,108.15682505945057,103.14010263285743,97.32389900000042,102.54709870000013,104.53819879999992,105.715,107.43666999999999,39108096,33774657.25,61.11036052561428,1.5,2.75,1.101040499320299,1.1579124463209765,0.1915807043300425,0.6364308634858133,0.4448501591557708,12.016296573570141,2.3300229182582104,597000120.0,2003-12-03,2003,2,337,12,0.94,107.58,107.72,106.94,984
2003-12-04 14:30:00,107.17,107.72,106.94,107.60001000000001,104.196004,107.91703276595743,97.4402490500004,102.61799890000013,104.66799899999997,105.80300049999998,104.75447041873369,105.98379628956256,105.81307923076942,108.52313671177185,103.103021749767,97.4402490500004,102.61799890000013,104.66799899999997,105.80300049999998,107.42000333333333,36094896,33897551.65,63.31664754699633,1.5,2.75,1.0781090350831346,1.0648230991042682,0.20427712826528305,0.7001965694873746,0.4959194412220916,11.567737963791707,3.6808730005781434,633095016.0,2003-12-04,2003,3,338,12,0.73,107.33,107.8,106.62,985
2003-12-05 14:30:00,107.12,107.8,106.62,106.85001000000001,104.2680045,107.97660744680852,97.54859915000038,102.68729900000014,104.79939919999997,105.82550149999999,104.83664844152844,106.06629283341374,105.96077307692323,108.6715005541207,103.2500455997258,97.54859915000038,102.68729900000014,104.79939919999997,105.82550149999999,107.09000333333334,28842704,33919217.25,57.34483956067292,1.5,2.75,1.0853869611486244,0.8503351886753814,0.1491420054554915,0.6823469480414559,0.5332049425859644,10.855425329472768,2.5333458849106734,604252312.0,2003-12-05,2003,4,339,12,1.11,107.21,107.64,106.67998999999999,986
2003-12-08 14:30:00,106.74001000000001,107.64,106.67998999999999,107.57001000000001,104.340005,108.03618212765957,97.6674492000004,102.7779991000001,104.95179939999996,105.92350199999998,104.94383909088027,106.20950399213623,106.24769692307709,108.78376762375423,103.71162622239991,97.6674492000004,102.7779991000001,104.95179939999996,105.92350199999998,107.29666666666668,32493104,33957022.05,61.13456202232597,1.5,2.75,1.0764314639237225,0.9568890921045888,0.1478536985187049,0.7180220657343455,0.5701683672156406,11.060120971240618,1.8751870442276664,636745416.0,2003-12-08,2003,0,342,12,0.9,107.16,107.92998999999999,106.53998999999999,987
2003-12-09 14:30:00,107.89998999999999,107.92998999999999,106.53998999999999,106.74001000000001,104.4120055,108.09575680851064,97.7787992500004,102.85029930000009,105.06799979999998,106.001503,105.01427716574771,106.26002837383754,106.40308230769249,108.78877760659029,104.01738700879466,97.7787992500004,102.85029930000009,105.06799979999998,106.001503,107.06999666666668,43621504,34861182.05,55.0614190510903,1.5,2.75,1.0988292165005995,1.2512915923916583,0.08112870035937703,0.6715792426648619,0.5904505423054849,10.655033283105233,0.7076138590797378,593123912.0,2003-12-09,2003,1,343,12,1.3,107.23,106.98,105.96001000000001,988
2003-12-10 14:30:00,106.8,106.98,105.96001000000001,106.73,104.484006,108.1553314893617,97.89624920000038,102.93479930000008,105.20359979999998,106.0805035,105.08156041414976,106.30478757632922,106.63000538461556,108.47428160287701,104.78572916635409,97.89624920000038,102.93479930000008,105.20359979999998,106.0805035,106.55667,36924800,35366971.65,54.99046866068778,1.5,2.75,1.0931978438934142,1.0440475471130704,0.029032023957533463,0.6267405722524018,0.5977085482948683,10.52760937312077,0.3384412898373596,556199112.0,2003-12-10,2003,2,344,12,0.96,106.47,108.10001000000001,106.67,989
2003-12-11 14:30:00,106.67998999999999,108.10001000000001,106.67,107.92998999999999,104.5560065,108.21490617021277,98.01419915000038,103.0223992000001,105.32059959999997,106.160503,105.1932635351635,106.45956875953594,106.91615769230785,108.25475678517392,105.57755859944182,98.01419915000038,103.0223992000001,105.32059959999997,106.160503,107.56666666666668,45474304,36238002.05,61.41008969695113,1.5,2.75,1.1172558550438842,1.2548788958413342,0.06598829346248157,0.6801939151229703,0.6142056216604888,12.075265860367367,1.3903147017379058,601673416.0,2003-12-11,2003,3,345,12,1.34,107.39,108.2,106.64998999999999,990
2003-12-12 14:30:00,107.99001000000001,108.2,106.64998999999999,108.14,104.628007,108.27448085106384,98.13039920000037,103.11139910000007,105.43439959999998,106.24950299999998,105.30882182790218,106.6196098300563,107.11231153846173,108.36037563181252,105.86424744511093,98.13039920000037,103.11139910000007,105.43439959999998,106.24950299999998,107.66333,34144896,36459066.85,62.420285156864,1.5,2.75,1.1481668653978925,0.936526876578576,0.09349530400967276,0.7310747516725797,0.637579447662907,12.069222732043952,0.5018493957389066,635818312.0,2003-12-12,2003,4,346,12,1.45,107.42,109.23,107.48,991
2003-12-15 14:30:00,109.17,109.23,107.48,107.60001000000001,104.7000075,108.3340555319149,98.24794925000036,103.2024991000001,105.51859979999998,106.356503,105.39867234445505,106.71298127481288,107.23615769230787,108.32332828639223,106.14898709822351,98.24794925000036,103.2024991000001,105.51859979999998,106.356503,108.10333666666668,38688192,35935341.25,58.20141995533516,1.5,2.75,1.1911549464409,1.0766056660168772,0.06556139658540118,0.7195311933946584,0.6539697968092573,11.032895654661742,0.25156992453181704,597130120.0,2003-12-15,2003,0,349,12,1.63,108.36,108.5,107.52,992
2003-12-16 14:30:00,107.67998999999999,108.5,107.52,108.16,104.772008,108.39363021276596,98.37499925000036,103.2817991000001,105.60459979999996,106.5180035,105.506959703496,106.85079258197358,107.3738500000002,108.44056182868994,106.30713817131044,98.37499925000036,103.2817991000001,105.60459979999996,106.5180035,108.06,32905296,35358670.85,61.13506197941948,1.5,2.75,1.1760724502665505,0.9306146189598641,0.074391263593105,0.7469588763006385,0.6725676127075335,11.273400961568015,0.9331840238895109,630035416.0,2003-12-16,2003,1,350,12,0.91,108.01,108.5,107.8,993
2003-12-17 14:30:00,108.06,108.5,107.8,108.5,104.8440085,108.45320489361704,98.50024925000037,103.3681991000001,105.6894,106.75100349999998,105.62433383277069,107.00785995511892,107.53154230769249,108.6113623321564,106.45172228322856,98.50024925000037,103.3681991000001,105.6894,106.75100349999998,108.26666666666664,23204896,34460535.65,62.840360482361056,1.5,2.75,1.1420672752475114,0.6733759520072927,0.09159227536209047,0.7870579569101466,0.6954656815480561,11.238196571251084,0.836421855351131,653240312.0,2003-12-17,2003,2,351,12,0.65,108.15,109.73,108.39,994
2003-12-18 14:30:00,108.55,109.73,108.39,109.72,104.916009,108.51277957446808,98.63509925000037,103.47139920000008,105.8038,107.00100349999998,105.78494819226988,107.26615900701236,107.69461846153864,109.28579375118713,106.10344317189016,98.63509925000037,103.47139920000008,105.8038,107.00100349999998,109.28000000000002,29790496,34458225.25,68.22751265881303,1.5,2.75,1.1562053270155466,0.8645394759557444,0.1690892398679591,0.9068272313830049,0.7377379915150459,12.551687551309213,2.685998812728236,683030808.0,2003-12-18,2003,3,352,12,1.24,109.06,109.37,108.58,995
2003-12-19 14:30:00,109.3,109.37,108.58,108.89998999999999,104.9880095,108.57235425531915,98.76299915000038,103.56879910000008,105.8961998,107.25700299999995,105.90710669453381,107.4217619587255,107.81538692307709,109.51233846620278,106.11843537995144,98.76299915000038,103.56879910000008,105.8961998,107.25700299999995,108.94999666666668,41466608,33849970.85,61.747833839871845,1.5,2.75,1.155047803657293,1.2250116309922907,0.14974195953997282,0.924915440940012,0.7751734814000392,12.686238426106279,1.2363854944328871,641564200.0,2003-12-19,2003,4,353,12,0.73,108.98,109.66,108.78,996
2003-12-22 14:30:00,108.83,109.66,108.78,109.66,105.06001,108.6319289361702,98.9046991000004,103.67149910000008,105.9979996,107.52950249999996,106.05427898102266,107.63492748646591,108.00769461538479,109.91727700290907,106.09811222786051,98.9046991000004,103.67149910000008,105.9979996,107.52950249999996,109.36666666666667,27635200,33730455.65,65.05992732367139,1.5,2.75,1.1354015319674864,0.8192951879083199,0.1712006921092718,0.9891743465366291,0.8179736544273571,12.720033353948768,2.7356096369112186,669199400.0,2003-12-22,2003,0,356,12,0.81,109.22,109.95,109.38,997
2003-12-23 14:30:00,109.48,109.95,109.38,109.73,105.13201049999999,108.69150361702127,99.05074910000036,103.78369920000007,106.09459979999998,107.73650249999996,106.19842490333548,107.83445820204058,108.17154000000019,110.26932498343893,106.07375501656144,99.05074910000036,103.78369920000007,106.09459979999998,107.73650249999996,109.68666666666668,24755808,33519890.85,65.35744983007721,1.5,2.75,1.0950157082555236,0.7385408297055955,0.1726859135801233,1.0338310464025111,0.8611451328223879,11.211865102443976,2.81083106905275,693955208.0,2003-12-23,2003,1,357,12,0.52,109.66,109.88,109.42998999999999,998
2003-12-24 14:30:00,109.52,109.88,109.42998999999999,109.62,105.204011,108.75107829787235,99.19354910000037,103.89479930000007,106.18159979999996,107.91800199999996,106.33260431889096,108.00450980184624,108.38461615384632,110.4648274585556,106.304404849137,99.19354910000037,103.89479930000007,106.18159979999996,107.91800199999996,109.64333,8055801,32043565.7,64.42900358657866,1.5,2.75,1.0489438719515571,0.25140151615523865,0.1496935018669534,1.0482620101560798,0.8985685082891264,11.308107444921738,1.565839114781722,685899407.0,2003-12-24,2003,2,358,12,0.41,109.65,110.08,109.63,999
2003-12-26 14:30:00,109.71001000000001,110.08,109.63,109.7,105.2760115,108.81065297872341,99.32274910000037,104.02759930000008,106.27579959999996,108.08450199999996,106.46465905148348,108.16598505881326,108.54846153846172,110.68108862410112,106.41583445282231,99.32274910000037,104.02759930000008,106.27579959999996,108.08450199999996,109.80333333333333,8308398,30805170.4,64.82041578168159,1.5,2.75,1.0068764525264455,0.26970790591698857,0.12434845845449805,1.0540040813572489,0.9296556229027508,9.941731749521175,1.4425744405400427,694207805.0,2003-12-26,2003,4,360,12,0.41,109.85,111.27,109.7843,1000
2003-12-29 14:30:00,110.10001000000001,111.27,109.7843,111.16,105.348012,108.8702276595745,99.45789910000036,104.1693993000001,106.39079959999997,108.32000199999996,106.64879006907236,108.45112933892628,108.88846076923096,111.16395986240856,106.61296167605336,99.45789910000036,104.1693993000001,106.39079959999997,108.32000199999996,110.7381,22547600,31407160.35,71.07571994372378,1.5,2.75,1.0470995630602704,0.7179127227272554,0.1866424209058033,1.1629586490350048,0.9763162281292016,11.967781428714346,3.3085405847081235,716755405.0,2003-12-29,2003,0,363,12,1.35,110.53,111.27,110.85001000000001,1001
2003-12-30 14:30:00,111.09,111.27,110.85001000000001,111.17998999999999,105.4200125,108.92980234042555,99.57989905000036,104.3011992000001,106.52919959999996,108.49900099999996,106.8264841840107,108.71102083045713,109.23076769230785,111.44241889157179,107.01911649304394,99.57989905000036,104.3011992000001,106.52919959999996,108.49900099999996,111.09999999999997,19581696,30450709.95,71.15135580536355,1.5,2.75,1.0023060228416796,0.6430620511690237,0.20827779203004135,1.2366634681667534,1.028385676136712,11.076294103042017,2.7921505177514856,736337101.0,2003-12-30,2003,1,364,12,0.38,111.06,111.52,110.84,1002
2003-12-31 14:30:00,111.22,111.52,110.84,111.28,105.49201299999999,108.98937702127658,99.69984910000036,104.4311992000001,106.65399979999997,108.69650099999996,107.00113186306908,108.95568551327072,109.48846076923094,111.81166210160627,107.1652594368556,99.69984910000036,104.4311992000001,106.65399979999997,108.69650099999996,111.21333333333332,31503392,30257384.35,71.55215777583511,1.5,2.75,0.9792841640672734,1.04118028298768,0.20792696613358075,1.288294383803688,1.0803674176701072,11.078186358317943,2.5622119815668207,767840493.0,2003-12-31,2003,2,365,12,0.61,111.18,112.19,110.73,1003
2004-01-02 14:30:00,111.74001000000001,112.19,110.73,111.23,105.5640135,109.04895170212768,99.81619905000036,104.5569993000001,106.78139979999996,108.90000099999996,107.16696982922323,109.1722868929592,109.72615307692324,112.08093561565569,107.3713705381908,99.81619905000036,104.5569993000001,106.78139979999996,108.90000099999996,111.38333333333334,38075600,30205759.55,71.02090416114042,1.5,2.75,1.0136210094910392,1.2605410546612128,0.18376681339676404,1.3100759344160622,1.126309121019298,11.233126294142076,1.3762304046664282,729764893.0,2004-01-02,2004,4,2,1,1.32,111.46,112.52,111.59,1004
2004-01-05 14:30:00,111.78,112.52,111.59,112.44,105.63601399999999,109.10852638297872,99.93764910000034,104.68589930000013,106.95939999999992,109.14200049999997,107.37375532611642,109.48349766505835,110.09846000000016,112.52039638797754,107.67652361202278,99.93764910000034,104.68589930000013,106.95939999999992,109.14200049999997,112.18333333333334,27967392,29799384.35,75.71921671719514,1.5,2.75,1.0333623659559643,0.9385224765557951,0.2259413656592688,1.4087358280933842,1.1827944624341151,11.13233091519349,3.250698186473658,757732285.0,2004-01-05,2004,0,5,1,0.83,112.06,112.73,112.0,1005
2004-01-06 14:30:00,112.16,112.73,112.0,112.55,105.7080145,109.16810106382981,100.05204910000036,104.82099940000009,107.14339979999994,109.42699999999998,107.57674531332758,109.77554550648136,110.43615230769244,112.90651344842662,107.96579116695827,100.05204910000036,104.82099940000009,107.14339979999994,109.42699999999998,112.42666666666668,20501200,29382309.15,76.09859503132994,1.5,2.75,1.0116936255305384,0.6977395784429012,0.2367679699037937,1.478754424813857,1.2419864549100637,9.2711554387035,2.6354185664782057,778233485.0,2004-01-06,2004,1,6,1,0.65,112.36,113.06,111.89,1006
2004-01-07 14:30:00,112.35001000000001,113.06,111.89,112.92998999999999,105.78001499999999,109.22767574468084,100.18324905000036,104.95719930000013,107.33039959999992,109.69499899999998,107.7866764775108,110.07596879157835,110.77692076923091,113.30641833797353,108.24742320048834,100.18324905000036,104.95719930000013,107.33039959999992,109.69499899999998,112.62666333333334,30180000,29266653.95,77.41158021570942,1.5,2.75,1.0230012237069286,1.031207737364182,0.2440692281142094,1.5470729900528255,1.303003761938616,8.977941533527241,2.9162398614781733,808413485.0,2004-01-07,2004,2,7,1,1.05,112.48,113.41,112.77,1007
2004-01-08 14:30:00,113.25,113.41,112.77,113.38,105.8520155,109.28725042553192,100.31254905000036,105.09479930000009,107.52539959999993,110.0269985,108.00602249800059,110.39063843047566,111.0584592307694,113.85533509988052,108.26158336165823,100.31254905000036,105.09479930000009,107.52539959999993,110.0269985,113.18666666666668,37044608,28937809.15,78.89051401388294,1.5,2.75,0.9956439934421479,1.2801455634729697,0.2526903533870919,1.6188667036724809,1.3661763502853892,8.868994867915626,3.4300310162379044,845458093.0,2004-01-08,2004,3,8,1,0.57,113.09,113.5,112.27,1008
2004-01-09 14:30:00,112.83,113.5,112.27,112.39,105.924016,109.34682510638298,100.43909905000037,105.21389930000014,107.67239979999994,110.30999849999998,108.17794318435351,110.58105381804941,111.32692153846172,113.90494987272513,108.7488932041983,100.43909905000037,105.21389930000014,107.67239979999994,110.30999849999998,112.71999999999998,54092304,29796184.35,68.29653163339647,1.5,2.75,1.0123837081962803,1.8154104352626608,0.16921280562869212,1.5776923573212542,1.408479551692562,11.077762500714057,2.4521422060164064,791365789.0,2004-01-09,2004,4,9,1,1.1,112.88,113.25,112.36,1009
2004-01-12 14:30:00,112.55,113.25,112.36,113.22,105.9960165,109.40639978723404,100.56944910000034,105.33749930000008,107.83319999999996,110.57449899999996,108.37567090261416,110.83238202585423,111.60076769230787,114.16864464468824,109.03289073992752,100.56944910000034,105.33749930000008,107.83319999999996,110.57449899999996,112.94333333333334,33566496,29200793.95,71.72475012605281,1.5,2.75,1.003642014753689,1.1495062790921136,0.1481481027915632,1.5936646801820158,1.4455165773904528,11.34038664590843,1.8531845987765403,824932285.0,2004-01-12,2004,0,12,1,0.79,112.8,113.23,111.75998999999999,1010
2004-01-13 14:30:00,113.09,113.23,111.75998999999999,112.56,106.068017,109.46597446808512,100.69869905000036,105.45859930000007,107.97640019999996,110.79549899999998,108.53976223976652,110.99691707101096,111.81846000000016,114.18715063273005,109.44976936727028,100.69869905000036,105.45859930000007,107.97640019999996,110.79549899999998,112.51666333333333,54286400,30207869.15,65.64592031868489,1.5,2.75,1.0369540136998543,1.7970946487630692,0.07188082996197842,1.5353676148429258,1.4634867848809474,10.390842592945363,1.2412395431947771,770645885.0,2004-01-13,2004,1,13,1,1.32,112.49,113.66,112.67,1011
2004-01-14 14:30:00,112.75998999999999,113.66,112.67,113.5,106.1400175,109.5255491489362,100.84249900000036,105.58589930000008,108.14040019999996,111.09049849999997,108.7342813676188,111.23530592139088,112.11692153846172,114.27035024635214,109.96349283057128,100.84249900000036,105.58589930000008,108.14040019999996,111.09049849999997,113.27666666666666,30141392,29780529.15,69.59796782245367,1.5,2.75,1.0414572984355783,1.0121174089346228,0.06695614333683153,1.5471819640519868,1.4802258207151553,11.10638391539772,1.9949676491732555,800787277.0,2004-01-14,2004,2,14,1,0.88,113.16,114.06,112.58,1012
2004-01-15 14:30:00,113.57001000000001,114.06,112.58,113.78,106.212018,109.58512382978724,100.98119905000034,105.72599930000008,108.29619999999994,111.3714985,108.93215268653572,111.47765773840126,112.43076769230787,114.24650296091028,110.61503242370544,100.98119905000034,105.72599930000008,108.29619999999994,111.3714985,113.47333333333331,38432608,30056894.75,70.67995792443375,1.5,2.75,1.0727817771187518,1.2786619615787156,0.06473350310544101,1.5611426995969566,1.4964091964915156,11.082602181842546,2.2925469747370286,839219885.0,2004-01-15,2004,3,15,1,1.31,113.32,114.31,113.63,1013
2004-01-16 14:30:00,114.03998999999999,114.31,113.63,114.23,106.2840185,109.64469851063829,101.11174905000034,105.86899940000006,108.46560019999994,111.6579985,109.13991140471079,111.73978557283924,112.66692153846172,114.5571638021287,110.77667927479472,101.11174905000034,105.86899940000006,108.46560019999994,111.6579985,114.05666666666669,31925808,30492940.35,72.3811945728917,1.5,2.75,1.0447259358959842,1.046990143736663,0.07502242978116325,1.5901872337179697,1.5151648039368064,10.981846575910486,1.5919601565279315,871145693.0,2004-01-16,2004,4,16,1,0.6,113.97,114.64998999999999,113.82001000000001,1014
2004-01-20 14:30:00,114.53,114.64998999999999,113.82001000000001,114.2,106.35601899999999,109.70427319148935,101.24424905000036,106.00989940000008,108.63280019999992,111.88199849999998,109.33834625158491,111.9740917087593,112.89923000000016,114.74314654175876,111.05531345824156,101.24424905000036,106.00989940000008,108.63280019999992,111.88199849999998,114.22333333333334,29879504,30497390.75,72.08092321675302,1.5,2.75,1.0293869404748428,0.9797396847794266,0.06181053174153073,1.5924279686137195,1.530617436872189,9.744007418966746,1.4660151043980505,841266189.0,2004-01-20,2004,1,20,1,0.73,114.24,115.3,113.72,1015
2004-01-21 14:30:00,114.13,115.3,113.72,115.10001000000001,106.4280195,109.76384787234043,101.3786491000003,106.15949950000008,108.80680059999992,112.19199950000001,109.56429384956196,112.271798212687,113.19307692307709,115.12651708730353,111.25963675885069,101.3786491000003,106.15949950000008,108.80680059999992,112.19199950000001,114.70667,30743008,29961210.75,75.38063340582599,1.5,2.75,1.0687164447266395,1.026093646766261,0.09377154840605216,1.6478318723797545,1.5540603239737019,10.371781787870992,1.921562199730996,872009197.0,2004-01-21,2004,2,21,1,1.39,114.51,115.38,114.58,1016
2004-01-22 14:30:00,115.14,115.38,114.58,114.8,106.50001999999999,109.82342255319149,101.51239910000031,106.29989960000006,108.99060059999994,112.4489995,109.76961565938306,112.51257933528824,113.46769230769249,115.21277543722849,111.72260917815645,101.51239910000031,106.29989960000006,108.99060059999994,112.4489995,114.92,29914000,30075150.75,72.3125883644321,1.5,2.75,1.0495224129604508,0.9946417309313073,0.07557442629439404,1.6485283568416946,1.5729539305473006,10.695281006533019,1.252425471864528,842095197.0,2004-01-22,2004,3,22,1,0.7,114.98,115.37,113.95,1017
2004-01-23 14:30:00,115.0,115.37,113.95,114.42998999999999,106.5720205,109.88299723404256,101.6435990500003,106.42979950000006,109.17560059999994,112.683999,109.95237543744648,112.6951898747846,113.62076846153865,115.32709330419569,111.91444361888159,101.6435990500003,106.42979950000006,109.17560059999994,112.683999,114.58333,49968608,31335790.75,68.60395811887075,1.5,2.75,1.0759850977489902,1.59461774552474,0.02225359186096432,1.6007709203735059,1.5785173285125418,10.916210839790836,1.815099208114604,792126589.0,2004-01-23,2004,4,23,1,1.25,114.66,115.92998999999999,114.38,1018
2004-01-26 14:30:00,114.44,115.92998999999999,114.38,115.87,106.644021,109.94257191489363,101.78779905000034,106.56049950000008,109.39000079999994,112.996499,110.18443914578192,112.99755274385271,113.87615307692323,115.83944231189643,111.91286384195006,101.78779905000034,106.56049950000008,109.39000079999994,112.996499,115.39333,30474096,32456705.5,74.15856139563428,1.5,2.75,1.1098425907669198,0.9389152574342458,0.06517358867909406,1.6599843143614097,1.5948107256823154,10.832094514667293,2.34057586998764,822600685.0,2004-01-26,2004,0,26,1,1.36,115.15,116.5,114.64998999999999,1019
2004-01-27 14:30:00,115.85001000000001,116.5,114.64998999999999,114.67998999999999,106.7160215,116.5,101.92364905000036,106.67369940000007,109.55700059999994,113.24549850000002,110.36073525771204,113.15778486348579,114.01076846153865,115.9357054094127,112.08583151366457,101.92364905000036,106.67369940000007,109.55700059999994,113.24549850000002,115.27666,35353008,33808936.0,64.07053353362122,1.5,2.75,1.1627116914264255,1.0456705292352295,-0.0018247391097763188,1.5925298017950948,1.5943545409048714,12.822664998588625,1.8834310589907617,787247677.0,2004-01-27,2004,1,27,1,1.61,115.57,115.28,112.94,1020
2004-01-28 14:30:00,114.98,115.28,112.94,113.37,106.788022,116.63258426966291,102.05474910000035,106.77329940000007,109.69720059999996,113.35599850000004,110.47874563976255,113.1779958288681,114.00999923076941,115.9359515426773,112.08404691886149,102.05474910000035,106.77329940000007,109.69720059999996,113.35599850000004,113.86333333333332,52884096,35325760.8,55.17292951502594,1.5,2.75,1.2468037134673955,1.4970405393222277,-0.14185826459360928,1.4170317101628598,1.558889974756469,14.291154129243262,-0.1145374449339167,734363581.0,2004-01-28,2004,2,28,1,2.07,114.11,113.85001000000001,112.56,1021
2004-01-29 14:30:00,113.56,113.85001000000001,112.56,113.48,106.8600225,116.76516853932584,102.1773991000003,106.87979940000008,109.85760039999994,113.47099900000003,110.59644188918362,113.20675813088069,114.09384538461555,115.81433810200669,112.37335266722442,102.1773991000003,106.87979940000008,109.85760039999994,113.47099900000003,113.29666999999999,60119904,37352671.2,55.72889076802633,1.5,2.75,1.2498898767911526,1.6095208741055176,-0.2293842801410171,1.2721596245801976,1.501543904721215,13.461478780795,-0.26366672525926976,794483485.0,2004-01-29,2004,3,29,1,1.15,113.21,113.72,113.09,1022
2004-01-30 14:30:00,113.52,113.72,113.09,113.48,106.932023,116.89775280898876,102.2958991000003,106.97779950000007,110.02860059999992,113.58099900000002,110.70952259941171,113.23278116603491,114.11384538461556,115.79892102952343,112.42876973970765,102.2958991000003,106.97779950000007,110.02860059999992,113.58099900000002,113.43,30992800,37327141.6,55.72889076802633,1.5,2.75,1.2056120284489271,0.8303019912995427,-0.28590847718074697,1.1441583082452809,1.4300667854260278,13.36945181579392,-0.6565700779129826,794483485.0,2004-01-30,2004,4,30,1,0.56,113.4,114.67998999999999,113.12,1023
2004-02-02 14:30:00,113.7,114.67998999999999,113.12,113.97,107.00402350000002,117.0303370786517,102.4244991000003,107.08749950000006,110.23120059999994,113.717999,110.8373844582583,113.30299248355541,114.22230692307708,115.65614362825116,112.788470217903,102.4244991000003,107.08749950000006,110.23120059999994,113.717999,113.92333,38850192,37365871.2,58.39467991890349,1.5,2.75,1.230924740702575,1.0397239714298432,-0.2881159446507635,1.0699218546125735,1.358037799263337,13.41254297952358,-0.20140105078809456,833333677.0,2004-02-02,2004,0,33,2,1.38,113.9,114.14,113.44,1024
2004-02-03 14:30:00,113.74001000000001,114.14,113.44,113.78,107.076024,117.1629213483146,102.5455991000003,107.20569940000007,110.41240059999993,113.784999,110.95278114616976,113.34842177083584,114.24384538461555,115.64159218345877,112.84609858577237,102.5455991000003,107.20569940000007,110.41240059999993,113.784999,113.78666666666668,25155904,37225296.8,56.962374349971476,1.5,2.75,1.1930015449381055,0.6757744373444459,-0.29890235610225296,0.9844098541355208,1.283312210237774,13.438052397134351,-1.1468374329420097,808177773.0,2004-02-03,2004,1,34,2,0.62,113.79,113.73,112.78998999999999,1025
2004-02-04 14:30:00,113.19,113.73,112.78998999999999,112.85001000000001,107.1480245,117.29550561797753,102.66159920000031,107.31159960000005,110.59380079999994,113.7999995,111.0271822776925,113.30095398313719,114.17230769230787,115.7422765866179,112.60233879799783,102.66159920000031,107.31159960000005,110.59380079999994,113.7999995,113.12333333333332,39597600,38180116.8,50.44078304030522,1.5,2.75,1.1785021488710978,1.0371262143441111,-0.36104361604472457,0.8320076901818679,1.1930513062265926,12.997845955302875,-1.6985975609756094,768580173.0,2004-02-04,2004,2,35,2,0.83,113.26,113.53998999999999,112.78,1026
2004-02-05 14:30:00,113.08,113.53998999999999,112.78,113.17998999999999,107.220025,117.42808988764044,102.7707991500003,107.41889950000008,110.77320039999994,113.81249950000002,111.11160610993986,113.28943360379078,114.09153769230787,115.74703336634134,112.4360420182744,102.7707991500003,107.41889950000008,110.77320039999994,113.81249950000002,113.16666000000002,35990704,38470652.0,52.51803053081733,1.5,2.75,1.1486084239517338,0.9355366267252242,-0.3708843192699303,0.7294459071391799,1.1003302264091102,13.282413088124404,-1.0923709772237156,804570877.0,2004-02-05,2004,3,36,2,0.67,113.16,114.7,113.2,1027
2004-02-06 14:30:00,113.42,114.7,113.2,114.45,107.2920255,117.56067415730335,102.8821492000003,107.54249950000006,110.95040039999992,113.86599950000002,111.24252351739321,113.39996373676307,114.11076846153864,115.77663277621376,112.44490414686355,102.8821492000003,107.54249950000006,110.95040039999992,113.86599950000002,114.11666666666667,37237296,38480286.4,59.545994717028464,1.5,2.75,1.1751371079551811,0.9676979950960032,-0.28659234194652505,0.7420897989759538,1.0286821409224791,15.01459516281006,-1.2255113489255214,841808173.0,2004-02-06,2004,4,37,2,1.33,113.95,114.87,114.28998999999999,1028
2004-02-09 14:30:00,114.67,114.87,114.28998999999999,114.48,107.364026,117.69325842696631,102.9977492000003,107.65149950000006,111.12020019999993,113.97049950000002,111.3694833794562,113.50282433326186,114.06307538461556,115.6463777413212,112.47977302790994,102.9977492000003,107.65149950000006,111.12020019999993,113.97049950000002,114.54666333333336,24859904,37018666.4,59.69774480845486,1.5,2.75,1.1326280288155255,0.6715505018840981,-0.2261998882370861,0.7459322806261213,0.9721321688632074,12.769682650359078,-0.17438962106641245,866668077.0,2004-02-09,2004,0,40,2,0.51,114.58,115.14,114.25998999999999,1029
2004-02-10 14:30:00,114.28,115.14,114.25998999999999,114.85001000000001,107.4360265,117.8258426966292,103.1208492500003,107.76619960000008,111.28980039999992,114.05200000000002,111.50597461947754,113.63112773009405,114.06692230769251,115.6575938119452,112.47625080343978,103.1208492500003,107.76619960000008,111.28980039999992,114.05200000000002,114.75,27933296,36737006.4,61.610489055249616,1.5,2.75,1.1145838839001307,0.760358525021244,-0.16173886595995213,0.7699585864132672,0.9316974523732192,11.54137540412157,1.3054688189115224,894601373.0,2004-02-10,2004,1,41,2,0.77,114.7,116.39,114.17,1030
2004-02-11 14:30:00,114.8,116.39,114.17,116.07001000000001,107.508027,117.95842696629214,103.24224935000031,107.88089960000006,111.48220059999993,114.22750050000002,111.68495639910587,113.86340223198984,114.19307769230787,116.10634403043278,112.27981135418298,103.24224935000031,107.88089960000006,111.48220059999993,114.22750050000002,115.54333666666666,42976896,36171531.2,67.14697249756402,1.5,2.75,1.1935421779072644,1.1881414630299092,-0.043493885370086915,0.8773300956606107,0.9208239810306976,10.278094180997131,2.2823493126542056,937578269.0,2004-02-11,2004,2,42,2,1.94,115.28,116.27,115.58,1031
2004-02-12 14:30:00,115.98,116.27,115.58,115.64998999999999,107.5800275,118.09101123595505,103.3615493500003,108.00069950000008,111.64320019999992,114.335,111.84044791286642,114.0335534479908,114.17615384615404,116.03284344722671,112.3194642450814,103.3615493500003,108.00069950000008,111.64320019999992,114.335,115.83333,27828496,36055886.4,63.738810693922794,1.5,2.75,1.1575748794853171,0.7718156112229153,-0.0022998726029105354,0.9179491402770594,0.92024901287997,10.826695861086797,1.912222418047232,909749773.0,2004-02-12,2004,3,43,2,0.6,115.92,116.2,114.75,1032
2004-02-13 14:30:00,115.82001000000001,116.2,114.75,115.13,107.652028,118.22359550561798,103.4776493500003,108.12649950000008,111.79920019999993,114.4025,111.96944995549913,114.13797692913454,114.21077000000021,116.11978560558887,112.3017543944115,103.4776493500003,108.12649950000008,111.79920019999993,114.4025,115.36,44741904,36371351.2,59.69891709830488,1.5,2.75,1.1784623880935088,1.230141375666021,-0.01793398193779505,0.8978315354577262,0.9157655173955211,11.406993520205097,1.0178117048346027,865007869.0,2004-02-13,2004,4,44,2,1.26,115.48,116.42998999999999,115.77,1033
2004-02-17 14:30:00,115.85001000000001,116.42998999999999,115.77,116.17,107.72402849999999,118.35617977528088,103.59899940000028,108.25879950000008,111.97940019999993,114.4995,112.13417740822464,114.33150293588363,114.42615461538485,116.52909892274856,112.32321030802109,103.59899940000028,108.25879950000008,111.97940019999993,114.4995,116.12333000000002,23988000,35974460.8,64.53985497411915,1.5,2.75,1.187142931801116,0.666806380597649,0.031228501134335732,0.954801143813441,0.9235726426791052,12.129460933873794,2.1005449112322028,888995869.0,2004-02-17,2004,1,48,2,0.57,116.1,116.60001000000001,115.35001000000001,1034
2004-02-18 14:30:00,116.2,116.60001000000001,115.35001000000001,115.66,107.796029,118.4887640449438,103.71124935000029,108.40429950000004,112.14059999999992,114.57250000000002,112.27244496084327,114.45802646579948,114.59384692307717,116.71584269018032,112.471851155974,103.71124935000029,108.40429950000004,112.14059999999992,114.57250000000002,115.87000666666664,28660400,35913505.6,60.689940970622864,1.5,2.75,1.1916327223867504,0.7980396099232373,0.019438499420447952,0.9478707669546652,0.9284322675342171,12.51851499188322,2.490021932652021,860335469.0,2004-02-18,2004,2,49,2,1.08,115.98,116.39,115.06,1035
2004-02-19 14:30:00,116.33,116.39,115.06,115.23,107.86802949999999,118.62134831460672,103.82224935000029,108.55379950000004,112.30819979999993,114.5789995,112.38842751139843,114.53154775477094,114.72846230769255,116.77129393687395,112.68563067851109,103.82224935000029,108.55379950000004,112.30819979999993,114.5789995,115.56,51183104,36935510.4,57.57166331132729,1.5,2.75,1.2015160993591252,1.3857424317601958,-0.024876178706345287,0.8973370441512856,0.9222132228576309,11.449702321910284,1.8112830722109097,809152365.0,2004-02-19,2004,3,50,2,1.16,115.72,115.5616,114.32001000000001,1036
2004-02-20 14:30:00,115.48,115.5616,114.32001000000001,114.88,107.94003,118.75393258426966,103.9270993500003,108.70309950000002,112.4543995999999,114.58299950000001,112.48613623644164,114.56473368288799,114.7984623076925,116.79436365116531,112.80256096421972,103.9270993500003,108.70309950000002,112.4543995999999,114.58299950000001,114.92053666666668,46728800,37776250.4,55.090479752425324,1.5,2.75,1.2043785208334736,1.2369888357156802,-0.08209153429848659,0.8195988049845226,0.9016903392830092,11.796078430449422,0.3757099169943142,762423565.0,2004-02-20,2004,4,51,2,1.09,114.94,115.25998999999999,114.17,1037
2004-02-23 14:30:00,115.22,115.25998999999999,114.17,114.59,108.0120305,118.88651685393259,104.0330993500003,108.83969960000002,112.61139939999991,114.591,112.56864069775769,114.56713999880344,114.86077000000022,116.77448518599907,112.94705481400135,104.0330993500003,108.83969960000002,112.61139939999991,114.591,114.67333,36361600,37095900.0,53.0503716282342,1.5,2.75,1.196207912202511,0.9802053596219528,-0.1403772980730893,0.7262187166916476,0.8665960147647369,10.202418954868604,0.09608665269042578,726061965.0,2004-02-23,2004,0,54,2,0.95,114.71,114.99001000000001,113.89998999999999,1038
2004-02-24 14:30:00,114.27,114.99001000000001,113.89998999999999,114.39,108.084031,119.0191011235955,104.1427993500003,108.9840996,112.76459939999992,114.517,112.64006655274756,114.55026952272692,114.97923076923098,116.53817855124586,113.4202829872161,104.1427993500003,108.9840996,112.76459939999992,114.517,114.42666666666665,43958896,37770140.0,51.63033911042261,1.5,2.75,1.188623061330903,1.1638531390140463,-0.19021499890817384,0.6288272661295196,0.8190422650376934,10.257196513246532,-0.4005310926834024,682103069.0,2004-02-24,2004,1,55,2,0.96,114.44,115.06,114.32001000000001,1039
2004-02-25 14:30:00,114.46001000000001,115.06,114.32001000000001,114.87,108.1560315,119.15168539325843,104.24849935000029,109.11199960000002,112.90339959999993,114.52650049999998,112.72751492322806,114.58072004437194,115.10923153846173,116.27983237342971,113.93863070349373,104.24849935000029,109.11199960000002,112.90339959999993,114.52650049999998,114.75000333333332,31234304,37564204.8,54.76020960600288,1.5,2.75,1.1565778426644104,0.8314911540467377,-0.18831549307321804,0.5836478986961708,0.7719633917693889,10.38416556646699,-1.0338674046810126,713337373.0,2004-02-25,2004,2,56,2,0.65,114.69,115.28998999999999,114.34,1040
2004-02-26 14:30:00,114.61,115.28998999999999,114.34,114.94,108.228032,119.28426966292135,104.34879935000029,109.23689960000002,113.03939959999992,114.60500049999999,112.81427904388579,114.61493718300319,115.14692384615404,116.26034952116314,114.03349817114494,104.34879935000029,109.23689960000002,113.03939959999992,114.60500049999999,114.85666333333334,29685600,36404280.0,55.215327814397256,1.5,2.75,1.1418215681883812,0.8154425798285256,-0.17982371671259822,0.547183745878641,0.7270074625912393,7.982552628355074,-0.6139127206150253,743022973.0,2004-02-26,2004,3,57,2,0.83,114.81,115.74001000000001,114.63,1041
2004-02-27 14:30:00,115.19,115.74001000000001,114.63,115.02,108.3000325,119.41685393258429,104.45034930000028,109.35319960000002,113.18779939999992,114.68200049999999,112.90077790490986,114.65351459414578,115.1884623076925,116.23770685081907,114.13921776456594,104.45034930000028,109.35319960000002,113.18779939999992,114.68200049999999,115.13000333333332,39275008,35362035.2,55.76305635462899,1.5,2.75,1.1395493133177828,1.1106546265753392,-0.16659715458565127,0.5187610193591752,0.6853581739448265,7.842535418823483,-0.09554416746286758,782297981.0,2004-02-27,2004,4,58,2,0.97,115.19,116.34,115.25,1042
2004-03-01 14:30:00,115.42998999999999,116.34,115.25,116.16,108.372033,119.5494382022472,104.55859935000029,109.47619960000002,113.34779939999993,114.81600049999999,113.02859053608988,114.79698939470329,115.28923076923095,116.43617328776243,114.14228825069948,104.55859935000029,109.47619960000002,113.34779939999993,114.81600049999999,115.91666666666669,33192800,35472035.2,62.75372022137547,1.5,2.75,1.1524386480807989,0.9357455757148098,-0.08306984644981907,0.5815208658825526,0.6645907123323717,9.369633664547989,-0.008608074373766993,815490781.0,2004-03-01,2004,0,61,3,0.95,115.8,116.97,115.23,1043
2004-03-02 14:30:00,115.94,116.97,115.23,115.48,108.4440335,116.97,104.66044935000029,109.5883997,113.4873993999999,114.89150049999999,113.12472424055693,114.86203802377918,115.24384538461557,116.307265059946,114.18042570928516,104.66044935000029,109.5883997,113.4873993999999,114.89150049999999,115.89333333333332,38607392,35459895.2,56.970471563860386,1.5,2.75,1.194407316075027,1.0887621574245374,-0.07581684734697257,0.5698196531486559,0.6456365004956285,8.512045394915347,-0.15562856648797566,776883389.0,2004-03-02,2004,1,62,3,1.51,116.1,115.87,114.92,1044
2004-03-03 14:30:00,115.25,115.87,114.92,115.69,108.516034,116.98958333333331,104.76454935000031,109.7052997,113.60679939999987,114.9870005,113.22532328994686,114.94089154532402,115.2469230769233,116.31524698673442,114.17859916711214,104.76454935000031,109.7052997,113.60679939999987,114.9870005,115.49333333333335,31355392,35769869.6,58.2500971727833,1.5,2.75,1.1769496506410968,0.8765867013392746,-0.05978079893608445,0.5709105018255229,0.6306913007616074,8.23935393211097,0.3992015968063818,808238781.0,2004-03-03,2004,2,63,3,0.83,115.4,116.10001000000001,115.52,1045
2004-03-04 14:30:00,115.72,116.10001000000001,115.52,115.99001000000001,108.58803449999999,117.00916666666666,104.88124945000028,109.82239979999999,113.74859979999992,115.1440005,113.3337423766156,115.04080758862648,115.31307769230791,116.4486413221244,114.1775140624914,104.88124945000028,109.82239979999999,113.74859979999992,115.1440005,115.87000666666664,21073296,34843654.4,60.07669904532016,1.5,2.75,1.1343111041667329,0.6047958046558974,-0.03319986107744277,0.5891914744148039,0.6223913354922467,7.980999890696403,0.9662343314763254,829312077.0,2004-03-04,2004,3,64,3,0.5,115.81,116.95,115.28,1046
2004-03-05 14:30:00,115.42,116.95,115.28,116.38,108.660035,117.02875,105.00084940000029,109.9404997,113.88299979999992,115.304001,113.4532034598856,115.16834972304302,115.32923153846174,116.51783194656944,114.14063113035404,105.00084940000029,109.9404997,113.88299979999992,115.304001,116.20333333333332,55923008,35840269.6,62.38079452543837,1.5,2.75,1.172574596726252,1.560340048334904,0.00441497510247979,0.6279100543703464,0.6234950792678666,7.737313138696422,1.5620909328911703,885235085.0,2004-03-05,2004,4,65,3,1.45,116.12,116.62,114.91,1047
2004-03-08 14:30:00,116.34,116.62,114.91,114.96001000000001,108.7320355,117.04833333333332,105.11239950000028,110.0410999,113.98759999999993,115.3295015,113.51229391243908,115.14850784465796,115.27538615384636,116.46259115351894,114.08818115417378,105.11239950000028,110.0410999,113.98759999999993,115.3295015,115.49667,39289600,35942884.8,50.868984901089675,1.5,2.75,1.2109621255315202,1.0931120364606906,-0.06854494465809291,0.5378138984452505,0.6063588431033434,10.876867522609585,0.4983040475566014,845945485.0,2004-03-08,2004,0,68,3,1.49,115.76,115.21001000000001,114.24001000000001,1048
2004-03-09 14:30:00,115.10001000000001,115.21001000000001,114.24001000000001,114.5,108.804036,117.06791666666666,105.21704945000029,110.1333999,114.08519999999993,115.33050149999998,113.55102748450031,115.08674519278578,115.21923230769251,116.476690371033,113.961774244352,105.21704945000029,110.1333999,114.08519999999993,115.33050149999998,114.65000666666666,39749504,36687364.8,47.79207184085127,1.5,2.75,1.1937505451364114,1.0834657713000964,-0.1455663909929794,0.4244008543621192,0.5699672453550986,11.10881754150333,-0.3221032471489549,806195981.0,2004-03-09,2004,1,69,3,0.85,114.73,114.77,112.56,1049
2004-03-10 14:30:00,114.72,114.77,112.56,112.58,108.8760365,117.0875,105.31114950000031,110.2092998,114.14279999999992,115.21700099999998,113.5129479753042,114.84800755537762,115.04230923076942,116.93012017933724,113.1544982822016,105.31114950000031,110.2092998,114.14279999999992,115.21700099999998,113.30333333333333,67802816,38680840.8,37.57586309736375,1.5,2.75,1.2663397919123816,1.7528785465283891,-0.3139373077580533,0.17754561065753194,0.4914829184155852,14.374251534942195,-2.0532451713937703,738393165.0,2004-03-10,2004,2,70,3,1.96,113.66,113.27,111.10001000000001,1050
2004-03-11 14:30:00,112.39998999999999,113.27,111.10001000000001,111.12,108.948037,117.10708333333334,105.38974955000029,110.26639980000002,114.14199999999992,114.96950049999998,113.41910687823345,114.49295921677023,114.77538615384634,117.59488698591218,111.95588532178049,105.38974955000029,110.26639980000002,114.14199999999992,114.96950049999998,111.83000333333332,89377632,41000877.6,31.97800838505229,1.5,2.75,1.3308862353472113,2.1798955835033147,-0.5006663691953693,-0.1343500430786264,0.3663163261167429,15.549243855618816,-3.390714658320285,649015533.0,2004-03-11,2004,3,71,3,1.95,112.19,112.71001000000001,111.58,1051
2004-03-12 14:30:00,111.73,112.71001000000001,111.58,112.58,109.0200375,117.12666666666668,105.47429955000031,110.34959990000002,114.17000019999992,114.816001,113.38620072614587,114.31077262469688,114.63615538461555,117.68727579654012,111.58503497269098,105.47429955000031,110.34959990000002,114.17000019999992,114.816001,112.29000333333332,54026608,42310783.2,41.382300510033325,1.5,2.75,1.3493950756795527,1.2768992657172085,-0.5016246158238326,-0.2607144436630477,0.2409101721607848,18.130409474099654,-3.0819559228650117,703042141.0,2004-03-12,2004,4,72,3,1.01,112.15,112.35001000000001,110.89998999999999,1052
2004-03-15 14:30:00,112.27,112.35001000000001,110.89998999999999,111.2,109.09203799999999,117.14625,105.5531995500003,110.41120000000002,114.16840019999992,114.61950099999996,113.30046736433624,114.01450856520194,114.35384769230784,117.90443821907905,110.80325716553665,105.5531995500003,110.41120000000002,114.16840019999992,114.61950099999996,111.48333333333332,57687296,42958052.8,36.27702333214399,1.5,2.75,1.3730104274167272,1.3428750196982857,-0.5661939431116281,-0.4668322567287504,0.09936168638287772,17.204848548661143,-3.7062694838933163,645354845.0,2004-03-15,2004,0,75,3,1.31,111.62,112.06,110.84,1053
2004-03-16 14:30:00,111.78,112.06,110.84,111.78998999999999,109.1640385,117.16583333333332,105.62739950000031,110.4804999,114.17959999999994,114.40050049999998,113.2412329578917,113.80264965423031,114.11153923076941,117.8915787177536,110.33149974378522,105.62739950000031,110.4804999,114.17959999999994,114.40050049999998,111.56333,60105504,44763928.0,39.70200174334125,1.5,2.75,1.3620811111726752,1.3427218451428122,-0.5402380025033268,-0.5759358167462807,-0.035697814242953964,18.01825193288926,-3.3710865243322625,705460349.0,2004-03-16,2004,1,76,3,1.1,111.45,113.25998999999999,112.10001000000001,1054
2004-03-17 14:30:00,112.17998999999999,113.25998999999999,112.10001000000001,113.03998999999999,109.23603899999999,117.18541666666668,105.7058494000003,110.5754999,114.19159979999996,114.2695,113.23334107719006,113.73001540144648,113.95923076923091,117.74013886967742,110.1783226687844,105.7058494000003,110.5754999,114.19159979999996,114.2695,112.79999666666669,41879200,45424868.0,46.28883138213738,1.5,2.75,1.3697896032317696,0.9219443411481129,-0.4155516230575563,-0.5551373430648994,-0.13958572000734304,19.684479361649046,-2.5433397238262114,747339549.0,2004-03-17,2004,2,77,3,1.03,112.68,113.27,111.92998999999999,1055
2004-03-18 14:30:00,112.71001000000001,113.27,111.92998999999999,113.07001000000001,109.3080395,117.205,105.7824494500003,110.6726999,114.20199999999996,114.1615005,113.22693593690808,113.66715774416586,113.72153923076937,117.30236331299463,110.14071514854412,105.7824494500003,110.6726999,114.20199999999996,114.1615005,112.75666666666666,60025008,45866963.2,46.44015204320383,1.5,2.75,1.3676624887152142,1.308676306697366,-0.3124283306178113,-0.5301211332796072,-0.21769280266179586,19.517357289227792,-2.8441227014951016,807364557.0,2004-03-18,2004,3,78,3,1.2,112.6,112.57001000000001,111.03998999999999,1056
2004-03-19 14:30:00,112.41,112.57001000000001,111.03998999999999,111.06,109.38004,117.22458333333331,105.84194945000034,110.7474999,114.16460019999997,113.9705005,113.1419580570293,113.41885700662624,113.38153923076936,117.06774158760645,109.69533687393229,105.84194945000034,110.7474999,114.16460019999997,113.9705005,111.55666666666669,48643296,45962688.0,38.59896968512197,1.5,2.75,1.4149737395212696,1.0583213932135562,-0.3577041181145932,-0.6648229503050374,-0.30711883219044417,20.92991633090704,-3.392492745955741,758721261.0,2004-03-19,2004,4,79,3,1.38,111.8,110.57001000000001,109.10001000000001,1057
2004-03-22 14:30:00,110.53998999999999,110.57001000000001,109.10001000000001,109.64998999999999,109.4520405,117.24416666666669,105.89194945000034,110.8076998,114.08999999999996,113.72349999999996,113.00501813322424,113.05991729170948,112.91692307692324,116.83730248257078,108.99654367127569,105.89194945000034,110.8076998,114.08999999999996,113.72349999999996,109.77333666666668,62759008,47282558.4,34.23245767440636,1.5,2.75,1.4539034724126076,1.3273183627051788,-0.4545142640205053,-0.8752616622160758,-0.4207473981955705,20.998130959603923,-4.235816593886462,695962253.0,2004-03-22,2004,0,82,3,1.35,109.84,110.39998999999999,109.36,1058
2004-03-23 14:30:00,110.25,110.39998999999999,109.36,109.46001000000001,109.524041,117.26375,105.94294955000035,110.85190000000004,114.03140019999996,113.47700049999996,112.86599820643114,112.7170689782133,112.41461538461552,116.30451486038028,108.52471590885081,105.94294955000035,110.85190000000004,114.03140019999996,113.47700049999996,109.74,54104304,47789828.8,33.67962141247429,1.5,2.75,1.424338224383136,1.1321301071494947,-0.49965480523731204,-1.0453159047422105,-0.5456610995048985,21.066977951021357,-2.7713537040326885,641857949.0,2004-03-23,2004,1,83,3,0.95,109.88,110.14,108.85001000000001,1059
2004-03-24 14:30:00,109.58,110.14,108.85001000000001,109.55,108.85001000000001,117.28333333333332,105.99944955000035,110.8956001,113.95800019999996,113.21100049999998,112.73595906108092,112.41544336124063,111.8892307692309,115.31178728147076,108.46667425699106,105.99944955000035,110.8956001,113.95800019999996,113.21100049999998,109.51333666666666,51594800,48807853.6,34.221514193835894,1.5,2.75,1.4147419226414837,1.0571003679620936,-0.491037651769829,-1.1594581642171846,-0.6684205124473557,19.659047868123537,-1.4128869690424832,693452749.0,2004-03-24,2004,2,84,3,1.19,109.5,111.3,109.78998999999999,1060
2004-03-25 14:30:00,110.08,111.3,109.78998999999999,111.0,108.9130221686747,117.30291666666666,106.05819955000034,110.95160020000002,113.92680019999996,113.01400049999998,112.66788223515616,112.28063923159868,111.58461461538477,114.53157736838884,108.63765186238065,106.05819955000034,110.95160020000002,113.92680019999996,113.01400049999998,110.69666333333336,49982096,49822678.4,42.38968898468698,1.5,2.75,1.4386889281670918,1.0031996995167567,-0.3612661070540293,-1.1200031462648925,-0.758737039210863,20.35977835869707,-1.4034464380884688,743434845.0,2004-03-25,2004,3,85,3,1.38,110.54,111.78998999999999,110.8,1061
2004-03-26 14:30:00,110.955,111.78998999999999,110.8,111.03,108.97603433734942,117.3225,106.1118495500003,111.00890020000004,113.87740019999994,112.81450049999998,112.60365155926769,112.16153073335116,111.31769153846169,113.74236078623619,108.89302229068716,106.1118495500003,111.00890020000004,113.87740019999994,112.81450049999998,111.20666333333334,37413104,49729583.2,42.54864587424094,1.5,2.75,1.4066390047265858,0.7523309384985957,-0.25215785995218953,-1.0739343641511,-0.8217765041989104,18.58445283105683,-0.15287769784172814,780847949.0,2004-03-26,2004,4,86,3,0.89,111.29,112.74001000000001,111.58,1062
2004-03-29 14:30:00,111.63,112.74001000000001,111.58,112.59,109.03904650602408,117.34208333333332,106.1717495500003,111.07490010000004,113.85360019999996,112.6360005,112.60311620400229,112.20233733017487,111.3184607692309,113.74473721999271,108.89218431846909,106.1717495500003,111.07490010000004,113.85360019999996,112.6360005,112.30333666666668,44116800,50275783.2,50.23761857402995,1.5,2.75,1.4283083615318295,0.8774960267550839,-0.0635048576759556,-0.9011575762938548,-0.8376527186178993,19.03406843718617,0.7156365252380829,824964749.0,2004-03-29,2004,0,89,3,1.04,112.16,113.07001000000001,112.22,1063
2004-03-30 14:30:00,112.3,113.07001000000001,112.22,112.97,109.1020586746988,117.36166666666666,106.23879955000034,111.14700020000002,113.82840019999996,112.5105005,112.61750380384535,112.2754480606344,111.4607684615386,114.03621958100901,108.88531734206822,106.23879955000034,111.14700020000002,113.82840019999996,112.5105005,112.75333666666666,39061392,50298483.2,51.925442077981366,1.5,2.75,1.3870013357081272,0.7765918476046609,0.08995565110349979,-0.7252081547385245,-0.8151638058420243,18.916324128441953,-0.061916141358473425,864026141.0,2004-03-30,2004,1,90,3,0.76,112.65,113.39998999999999,112.38,1064
2004-03-31 14:30:00,112.99001000000001,113.39998999999999,112.38,113.10001000000001,109.16507084337348,117.38125,106.2959996000003,111.21960030000002,113.80640039999996,112.381001,112.63642561545923,112.35397776914542,111.50076923076941,114.15932380093494,108.84221466060382,106.2959996000003,111.21960030000002,113.80640039999996,112.381001,112.96,48596496,51160538.4,52.51881168725718,1.5,2.75,1.3607862403004043,0.9498824195329424,0.19715472839657625,-0.5687203953463039,-0.7658751237428802,17.809923971415422,0.026532234321020347,912622637.0,2004-03-31,2004,2,91,3,0.91,112.89,113.87,113.05,1065
2004-04-01 14:30:00,113.07001000000001,113.87,113.05,113.78,109.2280830120482,117.40083333333334,106.35659960000031,111.29340040000002,113.78000019999996,112.27050049999998,112.68127166975495,112.4897894101792,111.69923076923092,114.61143930509941,108.78702223336245,106.35659960000031,111.29340040000002,113.78000019999996,112.27050049999998,113.56666666666668,45114304,52362588.8,55.605213216568956,1.5,2.75,1.3221586517075188,0.8615751251779209,0.3043875671371949,-0.3853906648213865,-0.6897782319585815,18.13457416502781,2.4491265982351877,957736941.0,2004-04-01,2004,3,92,4,0.73,113.46,114.84,113.89998999999999,1066
2004-04-02 14:30:00,114.81,114.84,113.89998999999999,114.64,109.29109518072286,117.42041666666668,106.4219495500003,111.3837004,113.77680019999997,112.1835005,112.75808454545084,112.6945713711145,111.9184623076925,115.227107843347,108.60981677203793,106.4219495500003,111.3837004,113.77680019999997,112.1835005,114.45999666666668,50997696,52116323.2,59.21599563568685,1.5,2.75,1.3034330337284104,0.9785359532040051,0.4168143011254506,-0.16876035555176827,-0.5855746566772189,14.029310114119319,4.550853128212777,1008734637.0,2004-04-02,2004,4,93,4,0.83,114.37,115.38,114.44,1067
2004-04-05 13:30:00,114.46001000000001,115.38,114.44,115.27,109.35410734939758,117.44,106.49819955000031,111.4846005,113.79360039999996,112.199,112.85659103386452,112.93985028815122,112.09000153846169,115.81809183120829,108.3619112457151,106.49819955000031,111.4846005,113.79360039999996,112.199,115.03,30280096,51665848.0,61.67510104306582,1.5,2.75,1.277473531319238,0.5860756606569199,0.5109748060772363,0.053143850919326496,-0.4578309551579098,9.682128759152377,5.307865402168335,1039014733.0,2004-04-05,2004,0,96,4,0.82,114.91,115.17998999999999,114.62,1068
2004-04-06 13:30:00,114.83,115.17998999999999,114.62,114.89998999999999,109.41711951807228,117.45958333333333,106.5754995000003,111.5821005,113.77420019999998,112.21899950000001,112.93672432665414,113.12653026070824,112.23076923076941,116.22494393162043,108.2365945299184,106.5754995000003,111.5821005,113.77420019999998,112.21899950000001,114.89999333333334,28480096,51102377.6,59.4094128779107,1.5,2.75,1.2326539933678633,0.5573144995899368,0.5237674263452563,0.19687832777366052,-0.3268890985715957,10.086764648354128,4.883605659516207,1010534637.0,2004-04-06,2004,1,97,4,0.49,114.9,114.98,114.11,1069
2004-04-07 13:30:00,114.98,114.98,114.11,114.63,109.480131686747,117.47916666666666,106.65654950000037,111.6651005,113.7732004,112.32149950000002,113.00312729423635,113.26971785492651,112.50538461538478,116.62863513585062,108.38213409491898,106.65654950000037,111.6651005,113.7732004,112.32149950000002,114.57333333333334,45898400,50007156.8,57.742530409641724,1.5,2.75,1.2067501366987303,0.9178366245369104,0.49007889338126703,0.285709518154988,-0.20436937522627896,10.695233143058118,3.2702702702702657,964636237.0,2004-04-07,2004,2,98,4,0.76,114.54,115.41,113.74001000000001,1070
2004-04-08 13:30:00,115.41,115.41,113.74001000000001,114.37,109.54314385542169,115.41,106.73579950000034,111.7452005,113.7932004,112.4839995,113.05673014544277,113.37450663064779,112.86846230769251,116.7459581316931,108.99096648369188,106.73579950000034,111.7452005,113.7932004,112.4839995,114.50667,46937808,47885165.6,56.10985731766665,1.5,2.75,1.239838698363107,0.9802160525471796,0.4285434321574263,0.3313099149705039,-0.0972335171869224,9.772768206051307,3.0081959830676426,917698429.0,2004-04-08,2004,3,99,4,1.47,114.58,115.08,114.57001000000001,1071
2004-04-12 13:30:00,114.58,115.08,114.57001000000001,114.82001000000001,109.60615602409638,115.35222222222221,106.82224955000035,111.8388005,113.8200006,112.596,113.12587837503322,113.51217361820515,113.28077000000015,116.73796704573923,109.82357295426114,106.82224955000035,111.8388005,113.8200006,112.596,114.82334,23087200,46338195.2,58.307200933276434,1.5,2.75,1.2019930770514562,0.498232611355567,0.3971142886647048,0.39915934364395866,0.0020450549792538357,9.624817800303623,1.980646593836036,940785629.0,2004-04-12,2004,0,103,4,0.45,114.83,115.3,113.02,1072
2004-04-13 13:30:00,115.25998999999999,115.3,113.02,113.21001000000001,109.66916819277107,115.29444444444445,106.89429960000034,111.9216007,113.8146008,112.69650049999998,113.12917765444372,113.48339613075704,113.56230923076943,116.27414158757796,110.85047687396087,106.89429960000034,111.9216007,113.8146008,112.69650049999998,113.84333666666667,56235504,46265605.6,48.87876594384181,1.5,2.75,1.2789935715477807,1.2154926596270472,0.2538326400727968,0.31933585507024986,0.06550321499745304,11.592549285644646,0.2124546339736196,884550125.0,2004-04-13,2004,1,104,4,2.02,114.16,113.64,112.55,1073
2004-04-14 13:30:00,112.61,113.64,112.55,113.39,109.73218036144578,115.23666666666666,106.9729496000003,112.0171007,113.80300079999999,112.77650099999998,113.13940598172043,113.47450126116114,113.74615538461558,116.02822478599882,111.46408598323235,106.9729496000003,112.0171007,113.80300079999999,112.77650099999998,113.19333333333331,62334304,46377045.6,49.85499621499081,1.5,2.75,1.2654940307229394,1.3440766481252526,0.1616095131339046,0.2675151064148338,0.1059055932809292,11.478794478702465,0.25640139200695305,946884429.0,2004-04-14,2004,2,105,4,0.97,113.1,113.78,112.36,1074
2004-04-15 13:30:00,113.45,113.78,112.36,112.96001000000001,109.79519253012049,115.17888888888888,107.0495996500003,112.09950079999999,113.786601,112.77250199999996,113.13237084518238,113.42550209343149,113.89461769230788,115.63813078597292,112.15110459864285,107.0495996500003,112.09950079999999,113.786601,112.77250199999996,113.03333666666666,61621008,47364136.0,47.520328706744955,1.5,2.75,1.2765301713855866,1.3010056385278514,0.06692752775863439,0.18956500297922216,0.1226374752205878,11.704498122634526,-0.7206802601511726,885263421.0,2004-04-15,2004,3,106,4,1.26,113.07,114.05,112.98,1075
2004-04-16 13:30:00,113.36,114.05,112.98,113.83,109.85820469879519,115.12111111111109,107.12609965000034,112.2000008,113.80620079999998,112.81050149999996,113.15972885125366,113.46402570358087,113.9900023076925,115.5651305711108,112.4148740442742,107.12609965000034,112.2000008,113.80620079999998,112.81050149999996,113.62,47059296,46715850.4,52.379385095891685,1.5,2.75,1.263205873429473,1.0073518002360928,0.05847690891525701,0.19573361136465905,0.13725670244940205,12.058787488613419,-0.706559665038383,932322717.0,2004-04-16,2004,4,107,4,0.95,113.52,113.99001000000001,113.27,1076
2004-04-19 13:30:00,113.57001000000001,113.99001000000001,113.27,113.83,109.92121686746988,115.06333333333332,107.19639965000034,112.2962007,113.819201,112.94900149999997,113.18601399434178,113.49888039847795,114.05615615384636,115.52287914938974,112.58943315830295,107.19639965000034,112.2962007,113.819201,112.94900149999997,113.69667,28278000,45697585.6,52.379385095891685,1.5,2.75,1.2244061681845109,0.6188073095923037,0.04886342538984853,0.19833598418671272,0.1494725587968642,11.085589926552586,-1.2492409126398871,932322717.0,2004-04-19,2004,0,110,4,0.64,113.63,114.32001000000001,111.78,1077
2004-04-20 13:30:00,114.08,114.32001000000001,111.78,111.92,109.98422903614455,115.00555555555556,107.2622996000003,112.35950069999998,113.76860100000002,113.06250199999997,113.13636638672052,113.34851083671816,113.96538615384634,115.76568410027649,112.1650882074162,107.2622996000003,112.35950069999998,113.76860100000002,113.06250199999997,112.67333666666669,53345104,45226890.4,42.38676124417689,1.5,2.75,1.3183778704570457,1.1794997075456686,-0.08297807202016402,0.04574996877165916,0.12872804079182318,13.657612364355426,-2.5935511395605872,878977613.0,2004-04-20,2004,1,111,4,2.27,113.05,112.95,111.87,1078
2004-04-21 13:30:00,112.2,112.95,111.87,112.67,110.04724120481927,114.94777777777777,107.3221496000003,112.4263006,113.73240100000002,113.22300149999998,113.1180775088099,113.28389075703069,113.88000153846173,115.80812271245438,111.95188036446908,107.3221496000003,112.4263006,113.73240100000002,113.22300149999998,112.49666666666668,50301296,45036740.0,46.68766228502901,1.5,2.75,1.3013508797101137,1.1168946953087635,-0.11457426186508088,-0.014489786539527929,0.10008447532555297,14.723027429465091,-1.7098490796475565,929278909.0,2004-04-21,2004,2,112,4,0.97,112.41,114.67,112.44,1079
2004-04-22 13:30:00,112.48,114.67,112.44,114.25,110.11025337349398,114.89,107.3876496500003,112.5051006,113.72040080000002,113.45800149999998,113.1624666261115,113.37590116112301,113.85000153846173,115.74168111779026,111.9583219591332,107.3876496500003,112.5051006,113.72040080000002,113.45800149999998,113.78666666666668,62142800,45564140.0,54.40906442229482,1.5,2.75,1.36768295973082,1.3638532407283448,-0.028452511633185632,0.06451883578407093,0.09297134741725653,17.295934480233793,-0.10492261956807253,991421709.0,2004-04-22,2004,3,113,4,1.98,113.56,114.57001000000001,113.78998999999999,1080
2004-04-23 13:30:00,114.42,114.57001000000001,113.78998999999999,114.36,110.17326554216865,114.8322222222222,107.45654965000031,112.5842006,113.6862006,113.6260015,113.20942871920515,113.46962486006369,113.78000153846172,115.51737095582516,112.0426321210983,107.45654965000031,112.5842006,113.6862006,113.6260015,114.24,29422096,44536140.0,54.898816921454674,1.5,2.75,1.3257070340357608,0.6606341726067864,0.033190801624168126,0.1344598494474667,0.10126904782329857,17.262893672899118,-0.4006357428465621,1020843805.0,2004-04-23,2004,4,114,4,0.69,114.18,114.94,113.60001000000001,1081
2004-04-26 13:30:00,114.5,114.94,113.60001000000001,114.2,110.23627771084335,114.77444444444444,107.5310496500003,112.65020049999998,113.6572008,113.78450149999996,113.24827465178534,113.53918439720049,113.72615615384636,115.3617509807864,112.0905613269063,107.5310496500003,112.65020049999998,113.6572008,113.78450149999996,114.24667,35565200,44443744.8,53.9903146948053,1.5,2.75,1.3267272458903494,0.8002295972143194,0.058953642688830785,0.17496110118433705,0.11600745849550627,17.088724657066688,0.8744721425252113,985278605.0,2004-04-26,2004,0,117,4,1.18,114.27,115.12,113.96001000000001,1082
2004-04-27 13:30:00,114.23,115.12,113.96001000000001,114.3,110.29928987951807,114.71666666666668,107.6013496000003,112.71990049999998,113.64060080000002,113.87000149999996,113.28951878308789,113.61164302603855,113.70077153846174,115.28902554466036,112.11251753226313,107.6013496000003,112.71990049999998,113.64060080000002,113.87000149999996,114.46000333333336,43490496,44412429.6,54.49714936613197,1.5,2.75,1.3148174426124677,0.9792415409761775,0.07733499351951134,0.21267620039489546,0.1353412068753841,14.739033995299584,0.8025399065173265,1028769101.0,2004-04-27,2004,1,118,4,1.02,114.54,114.00998999999999,112.5,1083
2004-04-28 13:30:00,113.89,114.00998999999999,112.5,112.82001000000001,110.36230204819277,114.65888888888887,107.6617996500003,112.77650059999998,113.573601,113.86250199999998,113.27110667394716,113.53624940451105,113.58154153846175,115.18359396321905,111.97948911370442,107.6617996500003,112.77650059999998,113.573601,113.86250199999998,113.11,50173504,44968035.2,46.357901311667995,1.5,2.75,1.3494733395687195,1.1157593116276514,-0.010881344258293707,0.12173952655251695,0.13262087081081067,16.755279936255032,-0.123937666082006,978595597.0,2004-04-28,2004,2,119,4,1.34,113.25,113.32001000000001,111.16,1084
2004-04-29 13:30:00,112.72,113.32001000000001,111.16,111.83,110.42531421686745,114.60111111111112,107.7183997000003,112.81880049999998,113.497001,113.79900149999996,113.21459268673357,113.37374946122429,113.35154076923095,115.03290907086223,111.67017246759968,107.7183997000003,112.81880049999998,113.497001,113.79900149999996,112.10333666666666,69703376,46023379.2,41.8547107321424,1.5,2.75,1.407368815313811,1.5145210371688655,-0.12999242221659374,-0.029869656959931486,0.10012276525666224,17.351160031766074,-1.7570060616709129,908892221.0,2004-04-29,2004,3,120,4,1.94,112.24,112.38,110.89998999999999,1085
2004-04-30 13:30:00,112.12,112.38,110.89998999999999,110.96001000000001,110.48832638554217,114.54333333333332,107.7735997500003,112.85990049999998,113.41160120000002,113.65800199999994,113.12617767941069,113.14386951253628,113.17846384615405,115.29053270599348,111.06639498631462,107.7735997500003,112.85990049999998,113.41160120000002,113.65800199999994,111.41333333333334,48683904,46201859.2,38.33095672755389,1.5,2.75,1.412557471362824,1.0537217515263977,-0.2542680502247364,-0.21771229752425825,0.03655575270047813,16.784786940512546,-2.5212949134674525,860208317.0,2004-04-30,2004,4,121,4,1.33,111.64,112.28998999999999,111.35001000000001,1086
2004-05-03 13:30:00,111.37,112.28998999999999,111.35001000000001,112.14998999999999,110.55133855421688,114.48555555555555,107.84184970000031,112.9057003,113.35700100000004,113.53350149999994,113.08789580962986,113.04921432086617,113.08307846153863,115.25934522970807,110.90681169336922,107.84184970000031,112.9057003,113.35700100000004,113.53350149999994,111.92999666666668,33764608,45340204.8,45.134994970551865,1.5,2.75,1.406659080551194,0.7446946512248661,-0.2432239831201729,-0.26747422619973804,-0.024250243079565102,18.41181582383139,0.2054949964260193,893972925.0,2004-05-03,2004,0,124,5,0.84,111.82,113.25998999999999,111.66,1087
2004-05-04 13:30:00,112.25,113.25998999999999,111.66,112.06,110.61435072289156,114.42777777777779,107.90459975000034,112.9589002,113.30640100000002,113.37300149999994,113.04758617003651,112.95500343316462,113.01384692307708,115.25758556243423,110.77010828371996,107.90459975000034,112.9589002,113.30640100000002,113.37300149999994,112.32666333333331,51193904,46385895.2,44.733049339969156,1.5,2.75,1.4204684319403948,1.1036523878491409,-0.2290734394441974,-0.31059204238481186,-0.08151860294061447,15.579674034840856,-0.5414041004703998,842779021.0,2004-05-04,2004,1,125,5,1.43,112.46,112.96001000000001,112.16,1088
2004-05-05 13:30:00,112.41,112.96001000000001,112.16,112.78,110.67736289156626,114.37,107.97709975000036,113.0194002,113.274201,113.26700199999996,113.03709259474094,112.93833643952988,112.93307769230788,115.12855912623155,110.73759625838422,107.97709975000036,113.0194002,113.274201,113.26700199999996,112.63333666666664,34430304,46683405.6,48.671584268841066,1.5,2.75,1.3832928296589375,0.7375276837129465,-0.16150383709690835,-0.2833983993117499,-0.12189456221484155,15.538297507756505,-1.286652078774616,877209325.0,2004-05-05,2004,2,126,5,0.71,112.56,112.58948999999998,111.0,1089
2004-05-06 13:30:00,112.02,112.58948999999998,111.0,111.81,110.74037506024095,114.31222222222222,108.04029975000036,113.0582003,113.21300100000002,113.12600199999994,112.98897131651584,112.83087582624132,112.77769307692327,114.98316932520477,110.57221682864171,108.04029975000036,113.0582003,113.21300100000002,113.12600199999994,111.79983,55006896,47138830.4,44.11081405100893,1.5,2.75,1.4116290561118707,1.1669126181798521,-0.17147806582034336,-0.3362421444902708,-0.16476407866992746,13.450405364443087,-2.2298006295907635,822202429.0,2004-05-06,2004,3,127,5,1.43,111.79,112.23,109.96001000000001,1090
2004-05-07 13:30:00,111.22,112.23,109.96001000000001,109.96001000000001,110.80338722891564,114.25444444444445,108.09389975000036,113.0764004,113.11340120000004,112.90550249999994,112.87018851978972,112.55746003326595,112.6269246153848,115.27073326937555,109.98311596139402,108.09389975000036,113.0764004,113.11340120000004,112.90550249999994,110.71667333333332,60957104,47839795.2,36.99137860939597,1.5,2.75,1.4729405521038803,1.2741924112584828,-0.2853004728183961,-0.5213896696929226,-0.23608919687452645,15.588534294708008,-3.7127758318739104,761245325.0,2004-05-07,2004,4,128,5,2.06,111.1,109.75,108.36,1091
2004-05-10 13:30:00,109.44,109.75,108.36,108.83,110.86639939759036,114.19666666666666,108.14559970000036,113.0887003,112.9896012,112.60600199999996,112.71174975430776,112.20246383962156,112.33154000000015,115.65960748126905,109.00347251873129,108.14559970000036,113.0887003,112.9896012,112.60600199999996,108.98,75336320,50452251.2,33.440980338244074,1.5,2.75,1.4820169412393174,1.4932201875661792,-0.4116484483446504,-0.7506497573053394,-0.33900130896068903,15.898033447612322,-4.785651793525808,685909005.0,2004-05-10,2004,0,131,5,1.28,109.06,110.05,109.33,1092
2004-05-11 13:30:00,109.46001000000001,110.05,109.33,109.75,110.92941156626507,114.13888888888887,108.19319970000036,113.1046003,112.86140120000002,112.43300149999996,112.59560270511923,111.9688958548957,111.98538615384632,115.37874053974228,108.59203176795036,108.19319970000036,113.1046003,112.86140120000002,112.43300149999996,109.71,48348704,50057911.2,38.60732457524527,1.5,2.75,1.4633014454365088,0.9658554030916096,-0.4074587588220315,-0.8483247574882284,-0.4408659986661969,17.40047398990851,-2.7211573549762997,734257709.0,2004-05-11,2004,1,132,5,0.66,109.69,110.53998999999999,108.06,1093
2004-05-12 13:30:00,109.61,110.53998999999999,108.06,110.45,108.06,114.08111111111108,108.24614970000034,113.1241003,112.76080120000002,112.28600149999995,112.51146142256552,111.8242391068104,111.68461692307709,114.8694795571232,108.499754289031,108.24614970000034,113.1241003,112.76080120000002,112.28600149999995,109.68333,90896000,51485996.0,42.27853012621006,1.5,2.75,1.5359220564767582,1.7654509393194997,-0.33478142533759897,-0.8593427803381957,-0.5245613550005966,17.30058568439957,-1.2340159170168965,825153709.0,2004-05-12,2004,2,133,5,2.3,109.3,110.81,109.63,1094
2004-05-13 13:30:00,109.75998999999999,110.81,109.63,109.99001000000001,108.03676441176472,114.02333333333333,108.29909980000036,113.1268004,112.64680140000004,112.13750149999996,112.41258097462179,111.6495506204475,111.3607715384617,114.30366609795477,108.41787697896864,108.29909980000036,113.1268004,112.64680140000004,112.13750149999996,110.14333666666666,57500704,51279980.8,40.562018557972436,1.5,2.75,1.5104990524427044,1.1213090001780968,-0.2962520466231038,-0.8948764132794764,-0.5986243666563726,16.84395666724572,-0.8741888181156426,767653005.0,2004-05-13,2004,3,134,5,1.08,110.22,110.74001000000001,109.27,1095
2004-05-14 13:30:00,109.98,110.74001000000001,109.27,110.03998999999999,108.01352882352941,113.96555555555555,108.35349975000037,113.1382004,112.52780100000004,111.94800099999998,112.3195381913033,111.49625913278584,111.03307846153864,113.50485554885849,108.56130137421879,108.35349975000037,113.1382004,112.52780100000004,111.94800099999998,110.01666666666668,54131808,51633606.4,40.84305660933431,1.5,2.75,1.5076069772682257,1.048383248317902,-0.24792540574459945,-0.908531123837122,-0.6606057180925224,16.402639894529994,-1.881408995221488,821784813.0,2004-05-14,2004,4,135,5,1.35,110.01,109.5,108.41,1096
2004-05-17 13:30:00,108.89,109.5,108.41,109.10001000000001,107.99029323529413,113.90777777777777,108.40204980000036,113.1326005,112.38220120000004,111.71150149999998,112.19328218380122,111.26804492966338,110.74692461538478,113.18606717889442,108.30778205187515,108.40204980000036,113.1326005,112.38220120000004,111.71150149999998,109.00333666666666,55069504,52973181.6,37.273544858013786,1.5,2.75,1.5163486217490671,1.0395732772071218,-0.25860325544013296,-0.9838597873926886,-0.7252565319525557,15.137953158444018,-2.6414331608067148,766715309.0,2004-05-17,2004,0,138,5,1.01,108.96,109.94,109.33,1097
2004-05-18 13:30:00,109.49001000000001,109.94,109.33,109.64998999999999,107.96705764705881,113.85,108.45774980000036,113.13180040000002,112.27600080000003,111.59800099999998,112.09354523541685,111.11394446017162,110.57923153846173,112.99712917093949,108.16133390598394,108.45774980000036,113.13180040000002,112.27600080000003,111.59800099999998,109.63999666666666,30203104,51816081.6,40.5475067416118,1.5,2.75,1.4680372916241338,0.5828905441587848,-0.21002905068421351,-0.9877928453078226,-0.7777637946236091,15.768545407613068,-2.7753236389430738,796918413.0,2004-05-18,2004,1,139,5,0.56,109.64,111.17998999999999,109.14998999999999,1098
2004-05-19 13:30:00,110.5,111.17998999999999,109.14998999999999,109.27,107.94382205882351,113.79222222222221,108.51154985000038,113.1283004,112.17140080000004,111.42800099999997,111.98281797128284,110.93833070206006,110.44923076923094,112.95151504923132,107.94694648923054,108.51154985000038,113.1283004,112.17140080000004,111.42800099999997,109.86666,55014304,52051732.0,39.031678291724326,1.5,2.75,1.5081774850795528,1.0569159158815309,-0.1857329603090312,-1.0099299950098979,-0.8241970347008669,14.793227355724785,-2.271710938198736,741904109.0,2004-05-19,2004,2,140,5,1.86,110.16,109.87,109.03998999999999,1099
2004-05-20 13:30:00,109.45,109.87,109.03998999999999,109.62,107.92058647058823,113.73444444444445,108.57754985000038,113.1275004,112.11220080000004,111.19650099999996,111.89015844299723,110.81277539710193,110.25461615384634,112.5851694183122,107.9240628893805,108.57754985000038,113.1275004,112.11220080000004,111.19650099999996,109.50999666666668,38126192,50850901.6,41.21168326622375,1.5,2.75,1.4597369504310134,0.7497643266958318,-0.13091798349060402,-0.987844514064122,-0.8569265305735179,14.749323410224367,-0.3092124127671436,780030301.0,2004-05-20,2004,3,141,5,0.76,109.45,110.55,109.47,1100
2004-05-21 13:30:00,109.97,110.55,109.47,109.81,107.89735088235294,113.67666666666666,108.6416998500004,113.1140004,112.08600080000004,110.96900099999996,111.80858360209538,110.71727297833031,110.08153923076942,112.17189472505218,107.99118373648666,108.6416998500004,113.1140004,112.08600080000004,110.96900099999996,109.94333333333331,47486608,51754127.2,42.41541504275411,1.5,2.75,1.432612882543084,0.9175424370792984,-0.06976028920537325,-0.9441268920802344,-0.8743666028748611,11.45637327389802,0.9004869980703887,827516909.0,2004-05-21,2004,4,142,5,0.99,110.01,110.75998999999999,109.67998999999999,1101
2004-05-24 13:30:00,110.53,110.75998999999999,109.67998999999999,110.27,107.87411529411764,113.61888888888888,108.70304985000038,113.10490049999999,112.03980080000008,110.77250099999996,111.7482469902485,110.67467555182269,109.88846230769249,111.29944763303473,108.47747698235024,108.70304985000038,113.10490049999999,112.03980080000008,110.77250099999996,110.23666000000001,40976800,52024707.2,45.333825018989,1.5,2.75,1.4074262480757207,0.7876411460130236,0.009556677157391169,-0.8624207564281221,-0.8719774335855133,9.61464820223247,0.4738041002277868,868493709.0,2004-05-24,2004,0,145,5,0.98,110.22,111.98,109.60001000000001,1102
2004-05-25 13:30:00,109.89998999999999,111.98,109.60001000000001,111.85001000000001,107.85087970588236,113.56111111111109,108.7708999000004,113.11060060000001,112.05280100000007,110.65000149999996,111.75223769651328,110.7866121659348,109.89154000000019,111.31935142580635,108.463728574194,108.7708999000004,113.11060060000001,112.05280100000007,110.65000149999996,111.14334,51714096,52435887.2,53.96407911509372,1.5,2.75,1.476895087498884,0.9862347861637782,0.1675522370650354,-0.662537137254219,-0.8300893743192544,11.56063280199194,1.2675509280217243,920207805.0,2004-05-25,2004,1,146,5,2.17,110.79,112.28998999999999,111.50998999999999,1103
2004-05-26 13:30:00,111.66,112.28998999999999,111.50998999999999,112.24001000000001,107.82764411764708,113.50333333333332,108.83885000000038,113.1207007,112.06180140000008,110.62100149999996,111.7713660221402,110.92503100727434,110.06692461538479,111.96723584874329,108.16661338202628,108.83885000000038,113.1207007,112.06180140000008,110.62100149999996,112.01333000000001,35982704,51726347.2,55.81819881071596,1.5,2.75,1.4271168669632497,0.6956358982951728,0.290254083263071,-0.4672717702404157,-0.7575258535034867,11.26920099175756,2.0456403267896786,956190509.0,2004-05-26,2004,2,147,5,0.7,111.9,113.03,112.06,1104
2004-05-27 13:30:00,112.53998999999999,113.03,112.06,112.87,107.80440852941177,113.44555555555556,108.9054500000004,113.1250007,112.05840160000008,110.67300149999996,111.81444970754649,111.11026614943869,110.37769384615405,112.65183513546192,108.10355255684617,108.9054500000004,113.1250007,112.05840160000008,110.67300149999996,112.65333333333336,45311904,50506773.6,58.71106499801424,1.5,2.75,1.3944656621801599,0.8971450910497281,0.3990563332993523,-0.25870543687929626,-0.6577617701786486,10.822265783630009,2.5718013969285183,1001502413.0,2004-05-27,2004,3,148,5,0.87,112.54,112.88,112.36,1105
2004-05-28 13:30:00,112.73,112.88,112.36,112.86,107.7811729411765,113.38777777777777,108.97455005000036,113.12810070000002,112.05420140000004,110.76800099999998,111.85545167979956,111.27690746853978,110.61692461538479,113.20874144454895,108.02510778622066,108.97455005000036,113.12810070000002,112.05420140000004,110.76800099999998,112.7,23369008,49241028.8,58.64542476833129,1.5,2.75,1.332003829167291,0.474584072865675,0.4516907952362401,-0.09314827613334843,-0.5448390713695885,10.865660803842573,3.4463699865838717,978133405.0,2004-05-28,2004,4,149,5,0.46,112.62,112.86,111.87,1106
2004-06-01 13:30:00,112.46001000000001,112.86,111.87,112.71001000000001,107.75793735294118,113.33,109.04155010000036,113.12590090000002,112.08720160000004,110.79600199999996,111.8889637707878,111.41339342391693,110.79077153846173,113.60787145816772,107.97367161875572,109.04155010000036,113.12590090000002,112.08720160000004,110.79600199999996,112.48000333333334,41059200,49605758.4,57.605125603011004,1.5,2.75,1.3075749842267699,0.8277103571104761,0.4563978608264119,0.025658254663426302,-0.4307396061629856,8.748534675133326,2.790716168783959,937074205.0,2004-06-01,2004,1,153,6,0.88,112.36,113.48,112.46001000000001,1107
2004-06-02 13:30:00,113.03,113.48,112.46001000000001,113.13,107.73470176470586,113.2722222222222,109.10910010000038,113.12340090000002,112.15680180000004,110.849502,111.93763185820791,111.57687976449628,111.0323092307694,114.06365895186077,108.00095950967804,109.10910010000038,113.12340090000002,112.15680180000004,110.849502,113.02333666666668,39780496,49035088.0,59.75774735880312,1.5,2.75,1.2870331996391442,0.8112659245151146,0.4661527797163089,0.15195136848240054,-0.3142014112339083,8.683629742299269,3.5325340898691318,976854701.0,2004-06-02,2004,2,154,6,0.91,112.97,113.19,112.07001000000001,1108
2004-06-03 13:30:00,112.81,113.19,112.07001000000001,112.09,107.71146617647058,113.21444444444445,109.16715010000038,113.12040090000002,112.20940160000004,110.81500199999998,111.94360707945464,111.62574835835376,111.1900023076925,114.21173149173627,108.16827312364869,109.16715010000038,113.12040090000002,112.20940160000004,110.81500199999998,112.45000333333331,38719008,49249523.2,52.631235529879,1.5,2.75,1.2751015425220624,0.7861803624527272,0.3843246188187197,0.16620436228949131,-0.2181202565292284,10.680497543364586,2.2532384601350106,938135693.0,2004-06-03,2004,3,155,6,1.0,112.63,113.58,112.71001000000001,1109
2004-06-04 13:30:00,112.98,113.58,112.71001000000001,112.98,107.6882305882353,113.15666666666668,109.22775010000038,113.11800090000004,112.27800160000004,110.873502,111.98424993908388,111.75472470517721,111.48846307692324,114.38956380663592,108.58736234721056,109.22775010000038,113.11800090000004,112.27800160000004,110.873502,113.09000333333334,32759904,48137173.6,57.32184989982647,1.5,2.75,1.2904514323419147,0.6805531266173052,0.3716756627992222,0.2464743219697993,-0.12520134082942286,11.117454450267186,2.8868044804662616,970895597.0,2004-06-04,2004,4,156,6,0.77,113.15,114.81,113.42,1110
2004-06-07 13:30:00,113.5,114.81,113.42,114.7,107.66499499999999,113.09888888888888,109.29900010000036,113.13940090000004,112.35200160000004,111.11050149999998,112.09074994147274,112.03522711420796,111.87692538461556,115.03070213433563,108.72314863489544,109.29900010000036,113.13940090000004,112.35200160000004,111.11050149999998,114.31,31673600,46672998.4,64.61451052776803,1.5,2.75,1.3289906157460636,0.6786279237633038,0.4551715083002611,0.4437630445459035,-0.011408463754357584,13.031245953375693,4.017411807381887,1002569197.0,2004-06-07,2004,0,159,6,1.23,114.12,114.92,114.17,1111
2004-06-08 13:30:00,114.37,114.92,114.17,114.86,107.64175941176472,113.04111111111109,109.36945010000038,113.15300090000004,112.42860160000004,111.41200149999999,112.1993479829836,112.30425310333099,112.30692538461555,115.44598327895208,109.16786749027901,109.36945010000038,113.15300090000004,112.42860160000004,111.41200149999999,114.65,32852400,44548802.4,65.21004985052346,1.5,2.75,1.2876341431927734,0.7374474336037371,0.4939590790738128,0.6060403850879084,0.1120813060140956,13.142405157770856,2.6910949762096603,1035421597.0,2004-06-08,2004,1,160,6,0.66,114.54,114.7,113.72,1112
2004-06-09 13:30:00,114.50998999999999,114.7,113.72,113.78998999999999,107.61852382352942,112.98333333333332,109.43955005000038,113.15310080000003,112.45260140000003,111.614001,112.261726101298,112.44575185539473,112.627693846154,115.43793806559704,109.81744962671095,109.43955005000038,113.15310080000003,112.45260140000003,111.614001,114.06999666666668,36802496,43971492.0,58.16043459064719,1.5,2.75,1.2770888472504325,0.8369626393391427,0.4230688635067922,0.6409173853975858,0.21784852189079365,13.443668451474199,1.3809514093949251,998619101.0,2004-06-09,2004,2,161,6,0.86,114.21,114.35001000000001,113.92998999999999,1113
2004-06-10 13:30:00,114.03998999999999,114.35001000000001,113.92998999999999,114.35001000000001,107.59528823529413,112.92555555555555,109.51165015000036,113.15430090000004,112.48020160000004,111.80900150000002,112.34361958752159,112.62710977392857,112.97692538461556,115.4016851987738,110.55216557045729,109.51165015000036,113.15430090000004,112.48020160000004,111.80900150000002,114.21000333333332,21718608,40512622.4,60.56341676067053,1.5,2.75,1.2258696438754009,0.5360948443564592,0.3902113655486176,0.7056127288265657,0.3154013632779481,13.536601218373134,1.3112518826969015,1020337709.0,2004-06-10,2004,3,162,6,0.37,114.14,113.85001000000001,112.87,1114
2004-06-14 13:30:00,113.82001000000001,113.85001000000001,112.87,113.22,107.57205264705885,112.86777777777776,109.57720015000037,113.14450090000004,112.48260140000004,111.970501,112.37798744683448,112.68357550974487,113.20384846153864,115.05778088599956,111.34991603707772,109.57720015000037,113.14450090000004,112.48260140000004,111.970501,113.31333666666669,34634896,39369332.0,53.84355219660593,1.5,2.75,1.2440225264557292,0.8797430446622767,0.2741713454933984,0.6581155451446961,0.3839441996512977,14.83627032199936,0.3189792663476869,985702813.0,2004-06-14,2004,0,166,6,0.87,113.36,114.44501000000001,113.50998999999999,1115
2004-06-15 13:30:00,113.89998999999999,114.44501000000001,113.50998999999999,114.02,107.5488170588235,112.81,109.64660015000038,113.13370080000004,112.48740140000004,112.1695015,112.44238009597821,112.81085403262631,113.37077076923096,115.09315441963264,111.64838711882929,109.64660015000038,113.13370080000004,112.48740140000004,112.1695015,113.99166666666666,37446000,38535041.6,57.44359350322328,1.5,2.75,1.2426644888517484,0.9717389276154303,0.23462097908852556,0.6772204235119546,0.4425994444234289,15.321247278661108,1.1622658892497648,1023148813.0,2004-06-15,2004,1,167,6,0.82,113.98,114.2,113.7,1116
2004-06-16 13:30:00,114.0,114.2,113.7,114.0,107.52558147058822,112.75222222222222,109.7128002000004,113.12570080000003,112.47460140000004,112.414501,112.50346322946926,112.92410602951904,113.50615461538479,115.12531897436564,111.88699025640398,109.7128002000004,113.12570080000003,112.47460140000004,112.414501,113.96666666666664,26638704,37113501.6,57.323220145020244,1.5,2.75,1.189617025362338,0.7177631549592184,0.19222090830090235,0.6828755797995569,0.4906546714986546,15.270753122260695,0.7690267833465965,996510109.0,2004-06-16,2004,2,168,6,0.44,113.95,114.07001000000001,113.33,1117
2004-06-17 13:30:00,113.78998999999999,114.07001000000001,113.33,113.83,107.50234588235294,112.69444444444444,109.7747502000004,113.11970090000004,112.44580140000004,112.62350149999999,112.55548427929399,113.01038164575532,113.58000076923096,115.16355021955856,111.99645131890335,109.7747502000004,113.11970090000004,112.44580140000004,112.62350149999999,113.74333666666668,28473904,37027041.6,56.2443448511406,1.5,2.75,1.1575022378364566,0.7690029440537318,0.1402466198826392,0.6659629463519536,0.5257163264693144,15.241316976226075,1.5523240253367785,968036205.0,2004-06-17,2004,3,169,6,0.65,113.7,114.22,113.17998999999999,1118
2004-06-18 13:30:00,113.27,114.22,113.17998999999999,113.63,107.47911029411765,112.63666666666666,109.8289002000004,113.0973009,112.42040160000003,112.84150149999999,112.59762215069422,113.06939291758816,113.63923153846174,115.16725539282122,112.11120768410228,109.8289002000004,113.0973009,112.42040160000003,112.84150149999999,113.67666333333332,31803104,35866481.6,54.93440648164464,1.5,2.75,1.149109935133852,0.886708218405231,0.0827617950890217,0.6291685703305916,0.5464067752415699,14.031635072490927,0.5753230660293782,936233101.0,2004-06-18,2004,4,170,6,0.92,113.7,114.14,113.13,1119
2004-06-21 13:30:00,113.75,114.14,113.13,113.2,107.45587470588237,112.57888888888887,109.8781002000004,113.082501,112.39180160000004,113.0205015,112.6212448114513,113.08183168734169,113.67692307692327,115.13392612567849,112.21992002816809,109.8781002000004,113.082501,112.39180160000004,113.0205015,113.49,24740800,35197212.0,52.1236085900974,1.5,2.75,1.1391735111957202,0.7029193107681371,0.009969828806954628,0.5588690612502631,0.5488992324433085,13.636781734104742,-1.3077593722755012,911492301.0,2004-06-21,2004,0,173,6,0.89,113.64,113.88,112.67,1120
2004-06-22 13:30:00,113.13,113.88,112.67,113.77,107.43263911764707,112.52111111111108,109.92990020000042,113.086501,112.37980160000004,113.21850149999999,112.66629403453163,113.14737152664247,113.72615384615406,115.14875372963259,112.30355396267551,109.92990020000042,113.086501,112.37980160000004,113.21850149999999,113.44,37337392,34689751.2,55.38258118142046,1.5,2.75,1.144232546110311,1.0763234300740674,-0.004805541494821486,0.5428923055747816,0.5476978470696031,10.467263342888288,-0.948981368622674,948829693.0,2004-06-22,2004,1,174,6,1.07,113.28,114.84,113.42,1121
2004-06-23 13:30:00,113.58,114.84,113.42,114.75,107.40940352941178,112.46333333333332,109.9895002000004,113.099201,112.37840140000004,113.44250149999999,112.74800799396178,113.30000280981938,113.93076923076946,115.09488705560983,112.76665140592907,109.9895002000004,113.099201,112.37840140000004,113.44250149999999,114.33666666666666,35760304,34428926.4,60.3765669809385,1.5,2.75,1.1639302213881462,1.038670319966759,0.04373351088835031,0.602364735680041,0.5586312247916907,11.751216679542232,0.8436682347893667,984589997.0,2004-06-23,2004,2,175,6,1.25,114.13,114.92998999999999,114.25998999999999,1122
2004-06-24 13:30:00,114.5,114.92998999999999,114.25998999999999,114.39,107.3861679411765,112.40555555555555,110.0430502500004,113.108301,112.40200120000004,113.569501,112.81239983733583,113.40381206602707,114.039230769231,115.08558760023676,112.99287393822523,110.0430502500004,113.108301,112.40200120000004,113.569501,114.52666,39410608,33813752.0,57.81647494410304,1.5,2.75,1.1286494912889928,1.1655201114623424,0.043796972439968274,0.613377440341651,0.5695804679016827,10.428095452547565,0.03497157542881114,945179389.0,2004-06-24,2004,3,176,6,0.59,114.59,114.94,113.67998999999999,1123
2004-06-25 13:30:00,114.41,114.94,113.67998999999999,113.84,107.36293235294121,114.94,110.0972502500004,113.10700100000004,112.41100120000004,113.64950049999999,112.85269788293051,113.44535377402448,113.97307692307714,114.95043413252351,112.99571971363078,110.0972502500004,113.10700100000004,112.41100120000004,113.64950049999999,114.15333000000001,32872704,33658252.0,54.046003787885596,1.5,2.75,1.1380323847683502,0.9766610577400158,0.0012483677424635074,0.5711409275797621,0.5698925598372986,10.42625001160292,0.5476064299593751,912306685.0,2004-06-25,2004,4,177,6,1.11,114.31,114.61,113.41,1124
2004-06-28 13:30:00,114.53,114.61,113.41,113.45,107.33969676470586,114.93113207547171,110.1547002000004,113.10370100000002,112.42080100000004,113.67850049999998,112.87612149536459,113.44579627173643,113.86461538461563,114.73082450434843,112.99840626488279,110.1547002000004,113.10370100000002,112.42080100000004,113.67850049999998,113.82333333333332,41277392,33456526.4,51.482183540511805,1.5,2.75,1.1424586429991823,1.2337620321516702,-0.055570205452385564,0.5004298030218166,0.5560000084742022,8.808229306976324,-0.4999122960883996,871029293.0,2004-06-28,2004,0,180,6,1.06,114.01,114.17,113.42,1125
2004-06-29 13:30:00,113.5,114.17,113.42,113.92,107.31646117647058,114.92226415094342,110.2130002500004,113.11440090000002,112.42260100000004,113.7315005,112.91705790731108,113.49095853157108,113.8746161538464,114.74014979709408,113.00908251059867,110.2130002500004,113.11440090000002,112.42260100000004,113.7315005,113.83666666666666,28426896,33709420.8,54.296002229294174,1.5,2.75,1.1144258827849554,0.8432923297216665,-0.06334454832891823,0.4768193230630544,0.5401638713919726,8.114821468938915,-0.07017543859648973,899456189.0,2004-06-29,2004,1,181,6,0.66,113.8,114.78998999999999,113.64998999999999,1126
2004-06-30 13:30:00,114.07001000000001,114.78998999999999,113.64998999999999,114.53,107.2932255882353,114.91339622641509,110.2734002500004,113.12790100000002,112.43660100000004,113.82250000000002,112.98031053839694,113.58991486189764,113.88846153846175,114.78902020791668,112.98790286900686,110.2734002500004,113.12790100000002,112.43660100000004,113.82250000000002,114.32332666666666,52610400,34286980.8,57.72301359878765,1.5,2.75,1.116252605443173,1.5344133187720046,-0.030892525913069683,0.5015482140006355,0.5324407399137052,8.688583412731633,0.6149521215848219,952066589.0,2004-06-30,2004,2,182,6,1.0,114.22,114.39998999999999,112.58,1127
2004-07-01 13:30:00,114.25,114.39998999999999,112.58,112.94,107.26998999999999,114.90452830188678,110.3276502500004,113.11280100000002,112.45700100000003,113.81300000000002,112.97872973296958,113.52801820838356,113.8669230769233,114.84080933200426,112.89303682184234,110.3276502500004,113.11280100000002,112.45700100000003,113.81300000000002,113.30666333333332,57778192,35186865.6,47.68600553777286,1.5,2.75,1.1758059907686609,1.642038613408067,-0.11525703576900992,0.3883694452024429,0.5036264809714528,12.022964930201342,-0.6072340051042838,894288397.0,2004-07-01,2004,3,183,7,1.62,113.49,113.28998999999999,112.60001000000001,1128
2004-07-02 13:30:00,113.16,113.28998999999999,112.60001000000001,112.88,107.24675441176471,114.8956603773585,110.37415025000038,113.096801,112.46120100000003,113.8525,112.9748579787355,113.46630218853753,113.77923076923099,114.87931360633509,112.67914793212688,110.37415025000038,113.096801,112.46120100000003,113.8525,112.92333333333332,34620496,34981940.0,47.35140475446822,1.5,2.75,1.141104134285185,0.9896676971031336,-0.17051363818857598,0.2904844332357328,0.4609980714243088,12.00725587135378,-0.2826855123674977,859667901.0,2004-07-02,2004,4,184,7,0.61,112.94,112.45,111.63,1129
2004-07-06 13:30:00,112.37,112.45,111.63,111.89,107.22351882352942,114.8867924528302,110.41670025000036,113.0672009,112.41400100000004,113.79799999999999,112.932314528589,113.31617817058157,113.6169230769233,115.09612004440176,112.13772610944484,110.41670025000036,113.0672009,112.41400100000004,113.79799999999999,111.99,38710608,35279475.2,42.10202898866646,1.5,2.75,1.1488824104076722,1.0972557777730207,-0.2635911180124897,0.13150917390869665,0.3951002919211864,12.802603940183609,-1.6524567109079682,820957293.0,2004-07-06,2004,1,188,7,0.73,112.04,112.57001000000001,111.75,1130
2004-07-07 13:30:00,111.81,112.57001000000001,111.75,112.22,107.20028323529414,114.87792452830188,110.4548002000004,113.0287008,112.37120100000006,113.67399999999999,112.90438062550707,113.21178024957378,113.49307692307717,115.1402354949536,111.8459183512007,110.4548002000004,113.0287008,112.37120100000006,113.67399999999999,112.18000333333332,30039296,35197760.0,44.317945895362065,1.5,2.75,1.1253915239499812,0.8534434009436964,-0.2906546220694092,0.031782014334424964,0.3224366364038341,12.487642313215778,-2.2047930283224413,850996589.0,2004-07-07,2004,2,189,7,0.73,112.16,112.32001000000001,111.2,1131
2004-07-08 13:30:00,111.75,112.32001000000001,111.2,111.42,107.17704764705886,114.8690566037736,110.4935502000004,112.9864009,112.31560100000006,113.50200000000001,112.84616962058523,113.04113451151913,113.32307692307717,115.30148941199032,111.344664434164,110.4935502000004,112.9864009,112.31560100000006,113.50200000000001,111.64667,45292000,35819740.0,40.291985266339495,1.5,2.75,1.1250071293821249,1.264442455472876,-0.34637463085270914,-0.1105316521620523,0.23584297869065685,11.089935352581527,-2.596380802517701,805704589.0,2004-07-08,2004,3,190,7,1.01,111.76,111.94,111.38,1132
2004-07-09 13:30:00,111.67,111.94,111.38,111.73,107.1538120588235,114.86018867924528,110.5394502000004,112.9524009,112.26420100000004,113.3990005,112.80239826291523,112.91626455804114,113.21000000000024,115.36388021950043,111.05611978050005,110.5394502000004,112.9524009,112.26420100000004,113.3990005,111.68333333333334,27411392,35350184.8,42.472803649993814,1.5,2.75,1.084649477283402,0.775424291417,-0.3455079820106686,-0.19604199882267886,0.1494659831879897,11.560666991564505,-1.8534785664089943,833115981.0,2004-07-09,2004,4,191,7,0.5,111.66,112.03998999999999,111.0,1133
2004-07-12 13:30:00,111.52,112.03998999999999,111.0,111.78,107.13057647058822,114.851320754717,110.5836502000004,112.90850090000002,112.24340080000003,113.2705,112.76230421338914,112.80804888584672,113.05692307692331,115.31040427603621,110.80344187781044,110.5836502000004,112.90850090000002,112.24340080000003,113.2705,111.60666333333332,35691296,36048819.2,42.835469367459886,1.5,2.75,1.081459514620302,0.9900822493514572,-0.3250244536116915,-0.2568145838266247,0.06820986978506682,11.544580767769975,-1.4720141031291332,868807277.0,2004-07-12,2004,0,194,7,0.94,111.52,112.02,111.60001000000001,1134
2004-07-13 13:30:00,111.92,112.02,111.60001000000001,111.86,107.10734088235294,114.84245283018869,110.6374002000004,112.87050090000002,112.24400080000004,113.2025,112.72691973443271,112.71775851576609,112.83461538461559,114.94157988556285,110.72765088366836,110.6374002000004,112.87050090000002,112.24400080000004,113.2025,111.82667,26816096,35657879.2,43.44975793046178,1.5,2.75,1.0342116921474234,0.7520384442830239,-0.2906638991646348,-0.2951200041707267,-0.004456105006091879,11.578702397724344,-1.8082865168539344,895623373.0,2004-07-13,2004,1,195,7,0.38,111.81,112.39,111.12,1135
2004-07-14 13:30:00,111.25998999999999,112.39,111.12,111.52,107.08410529411763,114.83358490566036,110.6936002000004,112.83340090000004,112.25520060000004,113.0775,112.67958954876869,112.60368627616931,112.61384615384635,114.62176185022624,110.60593045746651,110.6936002000004,112.83340090000004,112.25520060000004,113.0775,111.67666666666666,54236096,36497384.0,41.41292545098021,1.5,2.75,1.0510537141368927,1.48602694373931,-0.27554766765750305,-0.34889068957797065,-0.07334302192046763,11.042339712620352,-2.628132367065402,841387277.0,2004-07-14,2004,2,196,7,1.14,111.76,111.91,110.7,1136
2004-07-15 13:30:00,111.74001000000001,111.91,110.7,110.8,107.06086970588235,114.82471698113207,110.7478502000004,112.79260090000004,112.22820080000004,112.91750000000002,112.60588015469935,112.43190663081987,112.38000000000021,114.46870957585938,110.29129042414104,110.7478502000004,112.79260090000004,112.22820080000004,112.91750000000002,111.13666666666668,38432800,37087088.8,37.413192618057316,1.5,2.75,1.0624070202699714,1.0362851667127888,-0.29690850615718106,-0.4444786546169439,-0.1475701484597629,10.167146718653896,-1.8948114042854616,802954477.0,2004-07-15,2004,3,197,7,1.09,111.3,111.67,110.44,1137
2004-07-16 13:30:00,111.57001000000001,111.67,110.44,110.71001000000001,107.03763411764707,114.81584905660378,110.79675030000038,112.75380100000004,112.20120100000004,112.7615005,112.53153230549543,112.2679164755037,112.16923153846174,114.33506860336605,110.00339447355744,110.79675030000038,112.75380100000004,112.20120100000004,112.7615005,110.94000333333337,40873200,37707053.6,36.93306481089461,1.5,2.75,1.074377947393545,1.0839669530689608,-0.29913021408186796,-0.521482916062098,-0.22235270198022994,7.600857798071308,-1.9223866052445064,762081277.0,2004-07-16,2004,4,198,7,1.11,111.06,110.96001000000001,109.99001000000001,1138
2004-07-19 13:30:00,110.75,110.96001000000001,109.99001000000001,110.24001000000001,107.01439852941178,114.80698113207546,110.84820035000038,112.71230110000003,112.15040120000003,112.592001,112.4416686856721,112.07478252545572,111.88615538461559,114.02446897220041,109.74784179703077,110.84820035000038,112.71230110000003,112.15040120000003,112.592001,110.39667666666666,39598096,38096803.2,34.446683174342155,1.5,2.75,1.0669223797225775,1.0394073169897886,-0.3128089923097586,-0.6133639423674282,-0.3005549500576696,7.638751754274298,-1.4746536777191908,722483181.0,2004-07-19,2004,0,201,7,0.88,110.48,111.89998999999999,110.25,1139
2004-07-20 13:30:00,110.53,111.89998999999999,110.25,111.64,106.9911629411765,114.79811320754715,110.89600035000038,112.68000110000004,112.14700120000003,112.514001,112.4102306979987,112.0333746658885,111.66384769230793,113.16138003571491,110.16631534890092,110.89600035000038,112.68000110000004,112.14700120000003,112.514001,111.26333000000001,47290096,39224268.0,46.08904793878629,1.5,2.75,1.1092836383138225,1.205633614373632,-0.21290042795491526,-0.5666804850013136,-0.3537800570463984,10.412153588239727,-0.5168419176617344,769773277.0,2004-07-20,2004,1,202,7,1.5,111.07,112.06,109.45,1140
2004-07-21 13:30:00,111.82001000000001,112.06,109.45,109.58,106.9679273529412,114.78924528301887,110.93165035000038,112.62640110000002,112.13940100000003,112.304501,112.29924125886149,111.79971993580386,111.40538615384637,113.0818188005623,109.72895350713041,110.93165035000038,112.62640110000002,112.13940100000003,112.304501,110.36333333333332,56264192,40170608.0,35.96683036691864,1.5,2.75,1.2164776641485493,1.4006308293865006,-0.26735812534812586,-0.6879777137315557,-0.4206195883834298,14.53796989176209,-1.651409082749958,713509085.0,2004-07-21,2004,2,203,7,2.38,110.76,110.39,108.77,1141
2004-07-22 13:30:00,109.36,110.39,108.77,109.88,106.94469176470591,114.78037735849057,110.96410035000041,112.5750011,112.16040100000004,112.061001,112.20436905263162,111.61688946572731,111.17461692307712,112.80073973917915,109.5484941069751,110.96410035000041,112.5750011,112.16040100000004,112.061001,109.68,72660128,42015599.2,38.09896469004051,1.5,2.75,1.2453006881379391,1.72936074656767,-0.2644957926907875,-0.7512393292469142,-0.4867435365561267,14.457312707688295,-1.6557773203257933,786169213.0,2004-07-22,2004,3,204,7,1.49,109.58,109.71001000000001,108.69,1142
2004-07-23 13:30:00,109.62,109.71001000000001,108.69,108.96001000000001,106.92145617647058,114.7715094339623,110.98960040000038,112.5030012,112.14460120000004,111.78950149999999,112.07713928586176,111.36385332613425,110.94923307692328,112.89671536115543,109.00175079269111,110.98960040000038,112.5030012,112.14460120000004,111.78950149999999,109.12000666666668,49610608,42525599.2,34.32446124338797,1.5,2.75,1.2413506389852291,1.1666057370921183,-0.3031104961463311,-0.8656316567390405,-0.5625211605927094,14.69919915219656,-2.522803721595996,736558605.0,2004-07-23,2004,4,205,7,0.94,109.2,109.42998999999999,108.21001000000001,1143
2004-07-26 13:30:00,109.21001000000001,109.42998999999999,108.21001000000001,108.75,106.8982205882353,114.76264150943396,111.0120504500004,112.43570120000004,112.11060120000006,111.5350015,111.94666323543579,111.11491491412144,110.68231000000021,112.803397386658,108.5612226133424,111.0120504500004,112.43570120000004,112.11060120000006,111.5350015,108.79666666666668,49687904,43366359.2,33.50836488557171,1.5,2.75,1.239824164771999,1.1457707060637914,-0.3196978406398669,-0.962143461392543,-0.6424456207526761,14.587331779443224,-2.7802610405864465,686870701.0,2004-07-26,2004,0,208,7,1.13,108.82,110.11,108.97,1144
2004-07-27 13:30:00,109.05,110.11,108.97,109.77,106.874985,114.75377358490566,111.04090045000041,112.37650120000002,112.10620100000006,111.3510015,111.86130389286969,110.9868277794432,110.55538692307712,112.68217489153956,108.42859895461466,111.04090045000041,112.37650120000002,112.10620100000006,111.3510015,109.61666666666666,51311392,43868059.2,40.8627100517481,1.5,2.75,1.2484081530025704,1.1696754526126836,-0.2423843065498248,-0.9454260039399572,-0.7030416973901323,16.093327997619305,-1.5692252510760405,738182093.0,2004-07-27,2004,1,209,7,1.05,109.54,110.37,108.59,1145
2004-07-28 13:30:00,109.55,110.37,108.59,110.10001000000001,106.85174941176471,114.74490566037736,111.0700005000004,112.31760120000004,112.10740140000006,111.160002,111.7922335441297,110.90236894330576,110.43000307692327,112.45475497437843,108.40525117946808,111.0700005000004,112.31760120000004,112.10740140000006,111.160002,109.68666999999999,66079120,45750670.4,43.057169982191105,1.5,2.75,1.2863789992166723,1.4443311851447755,-0.15374953113108758,-0.8952286113039918,-0.7414790801729042,16.30619730772464,-0.6317599277978336,804261213.0,2004-07-28,2004,2,210,7,1.64,109.48,110.87,110.0,1146
2004-07-29 13:30:00,110.53998999999999,110.87,110.0,110.57001000000001,106.82851382352942,114.73603773584905,111.1000005000004,112.25950130000004,112.13680140000004,110.9620025,111.7443032090658,110.87071571060996,110.33692692307709,112.2104883060416,108.46336554011259,111.1000005000004,112.25950130000004,112.13680140000004,110.9620025,110.48000333333331,52353600,45737830.4,46.12351441729931,1.5,2.75,1.2566376421297676,1.144645461801354,-0.0533809413262849,-0.8082052568307603,-0.7548243155044754,16.21846145692415,-0.12645649657153907,856614813.0,2004-07-29,2004,3,211,7,0.79,110.44,110.89998999999999,110.10001000000001,1147
2004-07-30 13:30:00,110.32001000000001,110.89998999999999,110.10001000000001,110.84,106.80527823529414,114.72716981132076,111.12970055000038,112.21830120000004,112.16060160000006,110.8570025,111.70884033812204,110.86779040483759,110.25846538461556,111.94657356424919,108.57035720498196,111.12970055000038,112.21830120000004,112.16060160000006,110.8570025,110.61333333333332,41589696,44928405.6,47.86044984430967,1.5,2.75,1.2240192391204991,0.9256882242890008,0.03643818370811425,-0.7092765858693326,-0.7457147695774469,16.2811495046158,0.5442579332131822,898204509.0,2004-07-30,2004,4,212,7,0.73,110.5,113.61,110.05,1148
2004-08-02 13:30:00,110.19,113.61,110.05,111.07001000000001,106.78204264705884,113.61,111.15870060000036,112.18400130000002,112.19660180000008,110.766503,111.6837881679996,110.88704941390068,110.22385076923094,111.8231885005526,108.62451303790928,111.15870060000036,112.18400130000002,112.19660180000008,110.766503,111.57667,38802608,45137511.2,49.35832694797738,1.5,2.75,1.3908750077547491,0.8596532455692859,0.11230216145736473,-0.6053370677557409,-0.7176392292131057,16.063458215978446,-0.5105607309208207,937007117.0,2004-08-02,2004,0,215,8,3.23,111.83,111.06,110.16,1149
2004-08-03 13:30:00,110.92998999999999,111.06,110.16,110.21001000000001,106.75880705882355,113.5568,111.18480060000036,112.16030140000002,112.20840200000006,110.68250349999998,111.6259929457251,110.8225694697197,110.17846692307708,111.74293600938331,108.61399783677086,111.18480060000036,112.16030140000002,112.20840200000006,110.68250349999998,110.47667,40988096,45251385.6,44.2407138951484,1.5,2.75,1.3565275072008387,0.905786540158452,0.10562455709127803,-0.5856085328490082,-0.6912330899402862,14.76307009988056,0.5749315568534392,896019021.0,2004-08-03,2004,1,216,8,0.82,110.61,110.75,109.64,1150
2004-08-04 13:30:00,109.89,110.75,109.64,110.2,106.73557147058823,113.5036,111.20875060000036,112.15110140000004,112.21620200000004,110.58150349999998,111.57007165373587,110.76327713927016,110.13923538461556,111.67371085003326,108.60475991919786,111.20875060000036,112.15110140000004,112.21620200000004,110.58150349999998,110.19666666666667,40787008,45788771.2,44.18329096027063,1.5,2.75,1.3389183995436358,0.8907644151848302,0.10156517554367173,-0.5642766205106966,-0.6658417960543683,9.810544257319744,0.2912267928649503,855232013.0,2004-08-04,2004,2,217,8,1.01,110.2,110.38,108.27,1151
2004-08-05 13:30:00,110.28998999999999,110.38,108.27,108.39998999999999,106.71233588235296,113.4504,111.22945060000038,112.10930130000004,112.17880180000004,110.43050299999996,111.4457547261384,110.53820217362541,109.99769538461555,111.78714146602448,108.20824930320666,111.22945060000038,112.10930130000004,112.17880180000004,110.43050299999996,109.01666333333333,50819296,46065136.0,35.308338027768585,1.5,2.75,1.3939956567190903,1.1032051658330069,-0.015105460989398469,-0.6847236222911164,-0.6696181613017179,13.673520607832758,-0.5139683816108263,804412717.0,2004-08-05,2004,3,218,8,1.95,109.32,107.965,106.62,1152
2004-08-06 13:30:00,107.63,107.965,106.62,106.85001000000001,106.68910029411764,113.3972,111.23850070000036,112.0658014,112.07880180000004,110.1865035,111.26552944276041,110.18694577613725,109.62923461538479,111.83779952258385,107.42066970818577,111.23850070000036,112.0658014,112.07880180000004,110.1865035,107.14500333333336,74748624,48431997.6,29.764156549736,1.5,2.75,1.421566681239155,1.5433727226646543,-0.18025182406319876,-0.8949329413807163,-0.7146811173175176,15.153337886056875,-1.7471172413793126,729664093.0,2004-08-06,2004,4,219,8,1.26,107.29,107.48,106.87,1153
2004-08-09 13:30:00,107.02,107.48,106.87,107.0,106.66586470588236,113.344,111.24920070000036,112.01790150000002,111.97400160000002,109.94750349999997,111.09825377833843,109.88342713079086,109.43077307692327,112.04735548864582,106.81419066520071,111.24920070000036,112.01790150000002,111.97400160000002,109.94750349999997,107.11666666666667,37481104,48521488.0,30.894969360679692,1.5,2.75,1.365025489722073,0.7724640266596935,-0.2582256438297297,-1.0374631721046796,-0.77923752827495,15.275292524591846,-2.52345813974674,767145197.0,2004-08-09,2004,0,222,8,0.57,107.18,108.41,107.25998999999999,1154
2004-08-10 13:30:00,107.31,108.41,107.25998999999999,108.22,106.64262911764708,113.2908,111.27260075000036,111.96970160000002,111.88100160000003,109.76550349999997,110.98538108114869,109.72500549928695,109.30308076923096,111.98081424341568,106.62534729504624,111.27260075000036,111.96970160000002,111.88100160000003,109.76550349999997,107.96333,56101696,49985768.0,39.436317103377796,1.5,2.75,1.3682379547419248,1.1223533866679811,-0.20859979884879554,-1.0399872768359444,-0.8313874779871488,15.832354876422404,-1.7075475288331023,823246893.0,2004-08-10,2004,1,223,8,1.07,107.83,108.33,107.10001000000001,1155
2004-08-11 13:30:00,107.66,108.33,107.10001000000001,108.16,106.61939352941178,113.2376,111.29665070000036,111.92060150000003,111.78700160000004,109.59750349999996,110.87458182306445,109.57595735649772,109.24154153846172,111.98397380580963,106.49910927111384,111.29665070000036,111.92060150000003,111.78700160000004,109.59750349999996,107.86333666666668,53001200,49924023.2,39.17983595115288,1.5,2.75,1.3583631008317874,1.061637195938167,-0.16280959336679712,-1.0348994696956453,-0.8720898763288482,15.599130823008013,-2.1796235706228115,770245693.0,2004-08-11,2004,2,224,8,1.15,107.72,107.95,106.63,1156
2004-08-12 13:30:00,107.62,107.95,106.63,106.98,106.59615794117649,113.1844,111.31365070000037,111.87980150000004,111.67240140000004,109.40650349999994,110.72185312412071,109.32872332254557,109.10538769230787,112.09640000597632,106.11437537863944,111.31365070000037,111.87980150000004,111.67240140000004,109.40650349999994,107.18666666666668,50037808,50504273.6,34.436407207476435,1.5,2.75,1.370622879343803,0.990763839042722,-0.19292859812963625,-1.1132506239908937,-0.9203220258612572,15.887164313284847,-3.4824972933958853,720207885.0,2004-08-12,2004,3,225,8,1.24,107.29,107.35001000000001,106.59,1157
2004-08-13 13:30:00,107.12,107.35001000000001,106.59,107.19,106.59,113.1312,111.33145070000036,111.85520160000004,111.55360140000002,109.23050299999996,110.58334908003755,109.12503538706505,108.90692615384636,112.03446991212007,105.77938239557264,111.33145070000036,111.85520160000004,111.55360140000002,109.23050299999996,107.04333666666665,41640800,50542653.6,35.923207047379215,1.5,2.75,1.3270076736763878,0.8238744314762294,-0.17990086126207785,-1.1451981024388544,-0.9652972411767766,15.826408517236507,-3.493301207049498,761848685.0,2004-08-13,2004,4,226,8,0.71,106.97,108.64,107.10001000000001,1158
2004-08-16 13:30:00,107.14,108.64,107.10001000000001,108.3,106.56703125,113.07799999999999,111.34775075000034,111.84360150000002,111.47780140000003,109.13350249999996,110.49380597885964,109.04646058829692,108.76846384615403,111.83117501933435,105.70575267297373,111.34775075000034,111.84360150000002,111.47780140000003,109.13350249999996,108.01333666666666,45747008,50850099.2,43.24895528912741,1.5,2.75,1.3422206969852175,0.8996444199660479,-0.0826665902368584,-1.0686304789728496,-0.9859638887359912,17.472538004268827,-1.7330639930075316,807595693.0,2004-08-16,2004,0,229,8,1.44,107.87,109.28,108.53,1159
2004-08-17 13:30:00,108.75,109.28,108.53,108.91,106.5440625,113.0248,111.3664008000003,111.83720150000003,111.39640140000004,108.99700249999997,110.43169594047298,109.03346434179242,108.64077076923098,111.52564598462595,105.755895553836,111.3664008000003,111.83720150000003,111.39640140000004,108.99700249999997,108.90666666666668,40775104,50524349.6,46.84547933364205,1.5,2.75,1.3163477900577023,0.8070386719040515,0.030529105859610994,-0.9478025064114776,-0.9783316122710884,17.68879258457735,-1.1705989110707857,848370797.0,2004-08-17,2004,1,230,8,0.69,108.9,110.17,108.49001000000001,1160
2004-08-18 13:30:00,108.53998999999999,110.17,108.49001000000001,110.03,106.52109375,112.9716,111.3895508500003,111.82750150000004,111.30300140000004,109.01950249999996,110.41594315849363,109.12837249971695,108.5784630769233,111.30107611435535,105.85585003949123,111.3895508500003,111.82750150000004,111.30300140000004,109.01950249999996,109.56333666666669,43204192,49871349.6,52.76450773849104,1.5,2.75,1.3423222336250091,0.8663128699448711,0.1802726350695114,-0.7529908184341991,-0.9332634535037104,18.87193233284446,1.5036994007102755,891574989.0,2004-08-18,2004,2,231,8,1.55,109.33,110.02,109.17998999999999,1161
2004-08-19 13:30:00,109.81,110.02,109.17998999999999,109.71001000000001,106.498125,112.9184,111.41160090000031,111.81430160000004,111.20000160000004,109.01100299999996,110.38825950521938,109.18376654736298,108.47384769230793,110.89308699670521,106.05460838791065,111.41160090000031,111.81430160000004,111.20000160000004,109.01100299999996,109.63666666666668,39968800,48236783.2,51.016575516629565,1.5,2.75,1.3071570740803653,0.8285958836492231,0.25276615926355617,-0.6173057544242653,-0.8700719136878214,15.970873993545869,2.6766492581516834,851606189.0,2004-08-19,2004,3,232,8,0.77,109.6,110.63,109.50998999999999,1162
2004-08-20 13:30:00,109.61,110.63,109.50998999999999,110.48,106.47515625,112.8652,111.4340508500003,111.79320160000003,111.1338018,109.08700249999997,110.39185717168137,109.30721735237604,108.49461615384638,110.97692998666064,106.01230232103212,111.4340508500003,111.79320160000003,111.1338018,109.08700249999997,110.20666333333334,44893696,48000937.6,54.889127748009976,1.5,2.75,1.2937894259317673,0.9352670644500076,0.3420245185685173,-0.4425412654771748,-0.7845657840456921,12.7178848825904,3.2523364485981348,896499885.0,2004-08-20,2004,4,233,8,1.02,110.07,110.77,110.05,1163
2004-08-23 13:30:00,110.55,110.77,110.05,110.2,106.4521875,112.81200000000001,111.4562509000003,111.76550160000004,111.0508016,109.15950249999996,110.3843333610272,109.39224427119736,108.49461615384638,110.97692998666064,106.01230232103212,111.4562509000003,111.76550160000004,111.0508016,109.15950249999996,110.34,33850304,47209057.6,53.24077506560837,1.5,2.75,1.252804466936641,0.7170298608121336,0.369324229150785,-0.3229104976072108,-0.6922347267579958,13.13087596912767,1.8296063574200736,862649581.0,2004-08-23,2004,0,236,8,0.65,110.41,110.73,109.85001000000001,1164
2004-08-24 13:30:00,110.69,110.73,109.85001000000001,110.35001000000001,106.42921875,112.7588,111.4788009500003,111.73800160000003,110.99340180000002,109.18850299999997,110.38298734686926,109.48346005489284,108.64461769230793,111.31451498795148,105.97472039666435,111.4788009500003,111.73800160000003,110.99340180000002,109.18850299999997,110.31000666666668,30553600,46171168.0,54.03715007306181,1.5,2.75,1.226174862155453,0.6617463088653075,0.3829588321061982,-0.2135361866252481,-0.5964950187314463,12.000367998253909,2.024787352071007,893203181.0,2004-08-24,2004,1,237,8,0.8,110.29,111.27,109.89998999999999,1165
2004-08-25 13:30:00,110.33,111.27,109.89998999999999,111.10001000000001,106.40625,112.7056,111.5023010500003,111.71120170000003,110.935002,109.23850299999997,110.41110588228615,109.6374171925221,108.971540769231,111.72198432163401,106.221097216828,111.5023010500003,111.71120170000003,110.935002,109.23850299999997,110.75666666666666,38582000,44796312.0,57.897966289194926,1.5,2.75,1.23644880057292,0.8612762586348626,0.4247307813921684,-0.06558154199123578,-0.4903123233834042,12.176053184634625,3.8511964853243534,931785181.0,2004-08-25,2004,2,238,8,1.25,110.58,111.31,110.85001000000001,1166
2004-08-26 13:30:00,110.99001000000001,111.31,110.85001000000001,111.10001000000001,106.38328125,112.6524,111.52975110000028,111.67580180000004,110.8770022,109.26500299999998,110.43812173003964,109.77671174561523,109.2869261538464,112.00078682536751,106.57306548232529,111.52975110000028,111.67580180000004,110.8770022,109.26500299999998,111.08667333333334,26634096,43510336.8,57.897966289194926,1.5,2.75,1.1809874576748545,0.6121326093711139,0.43311762441247575,0.05108470713219049,-0.3820329172802853,8.858072378860918,3.647737662095345,931785181.0,2004-08-26,2004,3,239,8,0.41,111.08,111.63,111.05,1167
2004-08-27 13:30:00,111.23,111.63,111.05,111.45,106.3603125,112.5992,111.56110115000028,111.63760180000004,110.82940220000002,109.29550299999997,110.47780323082242,109.93607253174713,109.53538769230794,112.40026279745614,106.67051258715976,111.56110115000028,111.63760180000004,110.82940220000002,109.29550299999997,111.37666666666668,24904704,42676087.2,59.72872576217011,1.5,2.75,1.1380597821266505,0.5835751502541685,0.441488058915548,0.1698271563641498,-0.27166090255139824,8.795149389122304,2.908587257617734,956689885.0,2004-08-27,2004,4,240,8,0.52,111.34,111.34,110.45,1168
2004-08-30 13:30:00,111.23,111.34,110.45,110.53,106.33734375,112.546,111.58800120000029,111.59390190000003,110.7674022,109.26850249999998,110.479850162947,109.9926370525331,109.7176953846156,112.5099868921008,106.9254038771304,111.58800120000029,111.59390190000003,110.7674022,109.26850249999998,110.77333333333335,26729808,42072447.2,53.1821931822191,1.5,2.75,1.128198369117604,0.6353281013803257,0.36735538140784063,0.18753332420840246,-0.17982205719943808,10.196627397812968,1.4874667156367685,929960077.0,2004-08-30,2004,0,243,8,0.81,110.9,111.16,110.10001000000001,1169
2004-08-31 13:30:00,110.66,111.16,110.10001000000001,111.11,106.314375,112.4928,111.61190120000026,111.55870190000007,110.72560220000001,109.313502,110.50456192126282,110.0990525713395,110.03538769230794,112.41939630395868,107.65137908065716,111.61190120000026,111.55870190000007,110.72560220000001,109.313502,110.79000333333332,44207808,42233432.8,56.42478631717707,1.5,2.75,1.1233263427520608,1.0467491053675373,0.3402867275999656,0.24553635230051896,-0.09475037529944666,10.149824609323476,0.9815504862310264,974167885.0,2004-08-31,2004,1,244,8,0.96,110.63,111.64,110.48,1170
2004-09-01 13:30:00,110.94,111.64,110.48,111.32001000000001,106.29140625,112.4396,111.63670125000027,111.52820200000004,110.6766024,109.3695025,110.53654027729172,110.21533423121191,110.35308076923097,112.16868096375748,108.53748057470447,111.63670125000027,111.52820200000004,110.6766024,109.3695025,111.14667,52792608,42833712.8,57.57067949815938,1.5,2.75,1.125945889698342,1.2325013301205119,0.3197483959059061,0.30493511958293595,-0.014813276322970137,8.703592546791004,1.4675051073279453,1026960493.0,2004-09-01,2004,2,245,9,1.05,111.06,112.7,111.24001000000001,1171
2004-09-02 13:30:00,111.24001000000001,112.7,111.24001000000001,112.58,106.2684375,112.3864,111.67230120000029,111.50580190000008,110.6332024,109.578503,110.61667595269208,110.440540494906,110.68231153846176,112.44065290190213,108.92397017502138,111.67230120000029,111.50580190000008,110.6332024,109.578503,112.17333666666669,42831392,42434317.6,63.73280311439622,1.5,2.75,1.1498061832913178,1.0093573886056788,0.37065829626735797,0.44850959401122736,0.07785129774386937,9.975578551991957,1.9007965242577791,1069791885.0,2004-09-02,2004,3,246,9,1.31,111.97,112.82001000000001,112.00998999999999,1172
2004-09-03 13:30:00,112.27,112.82001000000001,112.00998999999999,112.12,106.24546875,112.3332,111.70825125000029,111.49490180000005,110.5878024,109.8420025,110.6756298369002,110.6004890192007,110.92923461538479,112.51585860602293,109.34261062474673,111.70825125000029,111.49490180000005,110.5878024,109.8420025,112.31666666666666,30491600,40221466.4,60.290203647373545,1.5,2.75,1.1255357416276517,0.7580926984800336,0.3530712343739709,0.519190340711333,0.1661191063373621,10.207451196806954,1.742286751361163,1039300285.0,2004-09-03,2004,4,247,9,0.72,112.42,113.13,112.32001000000001,1173
2004-09-07 13:30:00,112.53998999999999,113.13,112.32001000000001,112.86,106.2225,112.28,111.75335125000026,111.48960180000007,110.56820239999998,110.13500249999998,110.76129141192374,110.81568054118156,111.14692692307713,112.94304528743784,109.35080855871641,111.75335125000026,111.48960180000007,110.56820239999998,110.13500249999998,112.77000333333332,37352496,40215036.0,63.68824949467658,1.5,2.75,1.1172831886542474,0.9288191610719929,0.3692500222107129,0.6276816341007532,0.2584316118900403,10.237092856019943,2.2745716108226923,1076652781.0,2004-09-07,2004,1,251,9,0.72,112.73,113.06,112.31,1174
2004-09-08 13:30:00,112.62,113.06,112.31,112.58,106.19953125,112.2268,111.79265125000029,111.48580170000008,110.55080239999998,110.35300249999999,110.83261331733848,110.98371096583092,111.36769538461556,113.10772179946177,109.6276689697694,111.79265125000029,111.48580170000008,110.55080239999998,110.35300249999999,112.65,33004800,39060191.2,61.542315299450166,1.5,2.75,1.091048675178944,0.8449728223552576,0.3398088591262581,0.6831926857978629,0.34338382667160483,10.607967280696089,1.3321240925180842,1043647981.0,2004-09-08,2004,2,252,9,0.67,112.68,112.88,112.03,1175
2004-09-09 13:30:00,112.57001000000001,112.88,112.03,112.48,106.1765625,112.1736,111.83615125000028,111.47230170000006,110.52200239999996,110.5690025,110.89721671665855,111.12621468337083,111.52154153846172,113.27403645520808,109.76904662171536,111.83615125000028,111.47230170000006,110.52200239999996,110.5690025,112.46333333333332,34332400,38126751.2,60.754969442029754,1.5,2.75,1.073830912666162,0.900480605334136,0.2940300353887838,0.7109213709075846,0.4168913355188008,10.252724465357998,1.2421150997196189,1009315581.0,2004-09-09,2004,3,253,9,0.76,112.46,113.27,112.08,1176
2004-09-10 13:30:00,112.52,113.27,112.08,113.06,106.15359375,112.1204,111.88040120000029,111.46460170000006,110.49260239999998,110.8730025,110.98203174737782,111.310384713526,111.74154153846172,113.49326221412208,109.98982086280137,111.88040120000029,111.46460170000006,110.49260239999998,110.8730025,112.80333333333333,27914608,37020591.2,63.65900052343048,1.5,2.75,1.0821287046185788,0.7540292333310982,0.2831367415225238,0.7708122624219556,0.4876755208994317,10.448599171919994,1.4445939883355758,1037230189.0,2004-09-10,2004,4,254,9,1.06,112.68,113.74001000000001,113.00998999999999,1177
2004-09-13 13:30:00,113.31,113.74001000000001,113.00998999999999,113.42998999999999,106.130625,113.74001000000001,111.91960115000029,111.47970160000006,110.50240219999998,111.185002,111.07803011022574,111.51225188366638,111.97846307692328,113.7463381066759,110.21058804717062,111.91960115000029,111.47970160000006,110.50240219999998,111.185002,113.39332999999998,44537904,37165446.4,65.41702768900632,1.5,2.75,1.0569780828601083,1.1983686007872087,0.2806323929143543,0.8384660120423746,0.5578336191280203,10.454777309385168,2.6237130190898417,1081768093.0,2004-09-13,2004,0,257,9,0.65,113.38,113.69,113.19,1178
2004-09-14 13:30:00,113.3,113.69,113.19,113.66,106.10765625,113.74449310344828,111.95795110000029,111.48960160000006,110.51800219999996,111.453002,111.17928383139336,111.7167993233172,112.1753853846156,114.07350261934653,110.27726814988468,111.95795110000029,111.48960160000006,110.51800219999996,111.453002,113.51333333333334,28067296,36281460.8,66.50192825977061,1.5,2.75,1.0171939340843863,0.7735988403201229,0.2739445401945987,0.9002642943712686,0.62631975417667,8.28119489871284,2.2950229502295,1109835389.0,2004-09-14,2004,1,258,9,0.44,113.44,113.36,112.67998999999999,1179
2004-09-15 13:30:00,113.3,113.36,112.67998999999999,112.8,106.0846875,113.74897620689656,111.99010110000029,111.47510160000006,110.53620219999998,111.647502,111.24284132820145,111.81996129252511,112.30615384615406,114.12237693415535,110.4899307581528,111.99010110000029,111.47510160000006,110.53620219999998,111.647502,112.94666333333332,38458800,36165645.6,59.0436705508492,1.5,2.75,1.014537938792644,1.063406980905658,0.19479886967810112,0.8698183412742964,0.6750194715961952,9.989012228940878,1.3294914364452544,1071376589.0,2004-09-15,2004,2,259,9,0.6,113.02,113.37,112.8,1180
2004-09-16 13:30:00,112.94,113.37,112.8,113.14,106.06171875,113.75345931034481,112.02355110000029,111.46290160000004,110.55460219999998,111.803002,111.31723970748767,111.94567926466557,112.43615384615406,114.2304409762928,110.64186671601531,112.02355110000029,111.46290160000004,110.55460219999998,111.803002,113.10333333333334,23917504,35201311.2,60.91018727886604,1.5,2.75,0.9827852288788844,0.6794492359705055,0.15052420009173384,0.8631747217108625,0.7126505216191287,10.025141082061012,0.4974240540060422,1095294093.0,2004-09-16,2004,3,260,9,0.51,113.08,113.36,112.69,1181
2004-09-17 13:30:00,112.91,113.36,112.69,113.14998999999999,106.03875,113.75794241379309,112.05130100000031,111.45240150000004,110.58920199999996,111.975001,111.38911226797836,112.06037552517358,112.63769153846177,114.08538236004536,111.19000071687815,112.05130100000031,111.45240150000004,110.58920199999996,111.975001,113.06666333333334,33694496,34887596.0,60.96647580500238,1.5,2.75,0.9604434268161071,0.9658015989407812,0.10902340732856974,0.8489297807798408,0.7399063734512711,7.933327815042392,0.9186496610774152,1128988589.0,2004-09-17,2004,4,261,9,0.59,113.02,112.99001000000001,112.28,1182
2004-09-20 13:30:00,112.67,112.99001000000001,112.28,112.47,106.01578125,113.76242551724138,112.07700100000031,111.43410150000004,110.60400199999998,112.07450099999998,111.43150002217527,112.09938737991895,112.74230692307714,113.90100385905761,111.58360998709664,112.07700100000031,111.43410150000004,110.60400199999998,112.07450099999998,112.58000333333332,37189808,34502401.6,55.14559343271532,1.5,2.75,0.9539824677578136,1.0778904156051559,0.02715536887333636,0.7738505845429415,0.7466952156696052,8.405781196984632,-0.34556087187666185,1091798781.0,2004-09-20,2004,0,264,9,0.63,112.64,113.47,112.53998999999999,1183
2004-09-21 13:30:00,112.75,113.47,112.53998999999999,112.96001000000001,105.9928125,113.76690862068963,112.10600105000029,111.43550150000004,110.62760219999998,112.2125015,111.49144158993313,112.1813514389743,112.86846076923099,113.68764501642904,112.04927652203295,112.10600105000029,111.43550150000004,110.62760219999998,112.2125015,112.99,40929392,34856356.0,58.239787389779956,1.5,2.75,0.9572694343465412,1.1742303756594636,-0.0011176451937909835,0.7452981591773664,0.7464158043711574,7.879463104648012,0.3375466335050619,1132728173.0,2004-09-21,2004,1,265,9,0.83,113.0,112.52,111.47,1184
2004-09-22 13:30:00,112.5,112.52,111.47,111.55,105.96984375,113.77139172413791,112.12575100000029,111.43270150000004,110.6214022,112.272501,111.49373799817104,112.12122273050056,112.78923000000023,113.86404314190628,111.7144168580942,112.12575100000029,111.43270150000004,110.6214022,112.272501,111.84666666666668,49169200,35787136.0,47.98260313833235,1.5,2.75,0.9953223318932168,1.373935036321431,-0.11556850843363994,0.6019551688291074,0.7175236772627474,10.694280856221688,-0.8268136557610302,1083558973.0,2004-09-22,2004,2,266,9,0.94,112.0,111.7,110.95,1185
2004-09-23 13:30:00,111.60001000000001,111.7,110.95,110.95,105.946875,113.77587482758621,112.14625095000031,111.43260140000004,110.61000219999998,112.26500049999996,111.47241493941921,112.00967770854812,112.69923000000023,114.12256021116488,111.27589978883562,112.14625095000031,111.43260140000004,110.61000219999998,112.26500049999996,111.2,44090304,36062551.2,44.399187843451706,1.5,2.75,0.9777993081865584,1.222606347384541,-0.2260779247437087,0.43492627133311146,0.6610041960768201,10.996965758311417,-1.8662656996285152,1039468669.0,2004-09-23,2004,3,267,9,0.68,111.32,111.73,111.13,1186
2004-09-24 13:30:00,111.17,111.73,111.13,111.46001000000001,105.92390625,113.78035793103449,112.1657009500003,111.42570160000004,110.62320239999997,112.28300049999996,111.47192847120672,111.95732840297212,112.59153846153869,114.15488064378741,111.02819627928999,112.1657009500003,111.42570160000004,110.62320239999997,112.28300049999996,111.44000333333334,35011600,36481426.4,47.957036582295494,1.5,2.75,0.9636707861732328,0.9597102815036859,-0.2569703099299569,0.33979130866437396,0.5967616185943311,10.880579008560872,-1.736736466255535,1074480269.0,2004-09-24,2004,4,268,9,0.54,111.43,111.2,110.58,1187
2004-09-27 13:30:00,111.10001000000001,111.2,110.58,110.75,105.9009375,113.78484103448277,112.1857509000003,111.41260160000006,110.62400219999998,112.24800049999996,111.44361755076723,111.84234474554621,112.45076923076948,114.29690024603744,110.60463821550152,112.1857509000003,111.41260160000006,110.62400219999998,112.24800049999996,110.8433333333333,39672096,37219796.0,43.75901788608965,1.5,2.75,0.9576950157322875,1.0658869812182743,-0.3136139914620477,0.20474412926677127,0.518358120728819,10.767732761802304,-2.5602674643674086,1034808173.0,2004-09-27,2004,0,271,9,0.56,110.89,111.50998999999999,110.41,1188
2004-09-28 13:30:00,110.91,111.50998999999999,110.41,111.28,110.41,113.78932413793105,112.20850090000029,111.39760160000006,110.64480199999996,112.28550049999996,111.43720117622732,111.78878810311323,112.3584615384618,114.3066935599523,110.4102295169713,112.20850090000029,111.39760160000006,110.64480199999996,112.28550049999996,111.06666333333332,41702304,37968420.8,47.45650822167677,1.5,2.75,0.9678589431799816,1.0983418093596349,-0.3035794002383788,0.1388838704308455,0.4424632706692243,11.282156294029207,-1.3475177304964503,1076510477.0,2004-09-28,2004,1,272,9,1.0,110.96,111.85001000000001,111.0,1189
2004-09-29 13:30:00,111.21001000000001,111.85001000000001,111.0,111.84,110.53322580645158,113.79380724137931,112.22805095000031,111.39790160000004,110.64880199999996,112.32200049999996,111.45299720853214,111.79366542662626,112.26461538461564,114.18598347710787,110.34324729212341,112.22805095000031,111.39790160000004,110.64880199999996,112.32200049999996,111.56333666666669,33866704,37451365.6,51.11362499057908,1.5,2.75,0.9594411615242684,0.9042848894140192,-0.2496717405020507,0.1303735950416609,0.3800453355437116,11.362562605169401,-1.1490189146190537,1110377181.0,2004-09-29,2004,2,273,9,0.77,111.43,111.98,111.25998999999999,1190
2004-09-30 13:30:00,111.55,111.98,111.25998999999999,111.75998999999999,110.65645161290323,113.79829034482758,112.24615090000029,111.41590140000004,110.69240179999996,112.34399949999997,111.46503614153087,111.79045824313805,112.13615384615407,113.9489203585581,110.32338733375008,112.24615090000029,111.41590140000004,110.69240179999996,112.34399949999997,111.66666000000001,43592096,36991340.0,50.57203422997893,1.5,2.75,0.9423389357011066,1.1784405755509262,-0.21136611060606947,0.1158376972861248,0.3272038078921943,11.09764415242053,-1.2284579079503235,1066785085.0,2004-09-30,2004,3,274,9,0.65,111.62,113.64998999999999,112.21001000000001,1191
2004-10-01 13:30:00,112.25998999999999,113.64998999999999,112.21001000000001,113.64998999999999,110.77967741935484,113.80277344827586,112.2764008000003,111.46410130000004,110.76780159999994,112.39749899999997,111.55072060656887,111.96755650569632,112.13538384615408,113.94556726100964,110.32520043129853,112.2764008000003,111.46410130000004,110.76780159999994,112.39749899999997,113.16999666666668,62844304,37991985.6,61.066497972061995,1.5,2.75,1.0100290117224562,1.6541463418537408,-0.058644393150192826,0.2538983164544533,0.3125427096046461,15.185209218117233,1.049159775940254,1129629389.0,2004-10-01,2004,4,275,10,1.28,112.93,114.44,113.8,1192
2004-10-04 13:30:00,114.09,114.44,113.8,113.84,110.90290322580644,113.80725655172415,112.30480080000031,111.50500130000006,110.86540139999997,112.48349899999998,111.64049626905636,112.14588445753478,112.21538384615408,114.21771207445946,110.21305561784868,112.30480080000031,111.50500130000006,110.86540139999997,112.48349899999998,114.02666666666669,33587104,38146760.8,61.94136108164332,1.5,2.75,0.9943133680279946,0.8804706689538894,0.04942945871168525,0.3743295329942527,0.3249000742825674,14.618696770213528,0.7790279055393201,1163216493.0,2004-10-04,2004,0,278,10,0.56,114.12,114.16,113.53998999999999,1193
2004-10-05 13:30:00,113.85001000000001,114.16,113.53998999999999,113.89998999999999,111.02612903225805,113.81173965517243,112.33180075000031,111.53950120000003,110.96840119999996,112.53549849999996,111.72910386634828,112.31294212824574,112.27384461538485,114.41995650914042,110.12773272162927,112.33180075000031,111.53950120000003,110.96840119999996,112.53549849999996,113.86666,37162704,38137271.2,62.22993129223134,1.5,2.75,0.9675774131688516,0.974445806704702,0.11544325110944535,0.4692041381693741,0.35376088705992875,14.482861964844144,2.106669654863295,1200379197.0,2004-10-05,2004,1,279,10,0.55,113.85,114.67998999999999,113.67998999999999,1194
2004-10-06 13:30:00,113.77,114.67998999999999,113.67998999999999,114.62,111.14935483870968,114.67998999999999,112.3563007500003,111.58580110000008,111.06540119999994,112.63749849999996,111.84247234217777,112.53266192555569,112.38692230769257,114.83888709988723,109.93495751549787,112.3563007500003,111.58580110000008,111.06540119999994,112.63749849999996,114.32666,42297808,38601921.6,65.60114709362301,1.5,2.75,0.9698933122282194,1.0957435859876985,0.19349187694563608,0.5956257332419739,0.4021338562963378,11.92733304235102,3.307796304641732,1242677005.0,2004-10-06,2004,2,280,10,0.88,114.18,114.39998999999999,113.36,1195
2004-10-07 13:30:00,114.38,114.39998999999999,113.36,113.45,111.27258064516128,114.7352829411765,112.3790508000003,111.61990120000007,111.13240099999993,112.68599849999997,111.90551264248451,112.62002745645512,112.46230692307716,114.97925148197828,109.94536236417606,112.3790508000003,111.61990120000007,111.13240099999993,112.68599849999997,113.73666333333334,39410304,38855816.8,56.73876139795736,1.5,2.75,0.9906152184976328,1.0142703781741118,0.1539352353730295,0.5945529005126247,0.4406176651395952,13.373437786500672,1.7853847312592257,1203266701.0,2004-10-07,2004,3,281,10,0.92,113.88,113.7,112.35001000000001,1196
2004-10-08 13:30:00,113.14998999999999,113.7,112.35001000000001,112.50998999999999,111.39580645161291,114.79057588235294,112.39330075000031,111.65400100000008,111.17120059999992,112.65849799999997,111.92921763689688,112.6095476986975,112.42769000000023,114.92862946847832,109.92675053152216,112.39330075000031,111.65400100000008,111.17120059999992,112.65849799999997,112.85333333333334,51882800,40054226.4,50.80075482448703,1.5,2.75,1.0162848457478022,1.2953139946300398,0.05706609005883601,0.5119502777131402,0.4548841876543042,14.537981350173744,1.5891557562076768,1151383901.0,2004-10-08,2004,4,282,10,1.2,113.03,113.02,112.64,1197
2004-10-11 13:30:00,112.78,113.02,112.64,112.97,111.51903225806451,114.84586882352941,112.40950075000029,111.68720110000008,111.21380059999993,112.63549849999997,111.97003263152835,112.64387648929774,112.53692076923102,114.99871635775095,110.07512518071108,112.40950075000029,111.68720110000008,111.21380059999993,112.63549849999997,112.87666666666668,20246192,38839640.8,53.37246914726009,1.5,2.75,0.9801223567658158,0.5212764995499135,0.01856855892862957,0.4780948863150911,0.4595263273864616,13.833122314856348,1.5186915887850447,1171630093.0,2004-10-11,2004,0,285,10,0.34,112.83,112.83,111.94,1198
2004-10-12 13:30:00,112.2,112.83,111.94,112.53,111.64225806451613,114.90116176470586,112.42405075000029,111.71980110000008,111.24300039999993,112.57899849999997,111.99199213617432,112.63303110936462,112.65845923076948,114.94461297342363,110.37230548811534,112.42405075000029,111.71980110000008,111.24300039999993,112.57899849999997,112.43333333333332,41855296,39529040.8,50.64552973390846,1.5,2.75,0.9836850455682576,1.0588492701295196,-0.03880352819549426,0.4110219171420937,0.449825445337588,14.08608019616318,0.6169527896995688,1129774797.0,2004-10-12,2004,1,286,10,0.8,112.38,113.07001000000001,111.32001000000001,1199
2004-10-13 13:30:00,113.0,113.07001000000001,111.32001000000001,111.53998999999999,111.76548387096773,114.95645470588236,112.4332507000003,111.73900100000006,111.26959999999993,112.51599799999997,111.97426656220671,112.52893195609181,112.66461153846178,114.93822759012696,110.39099548679658,112.4332507000003,111.73900100000006,111.26959999999993,112.51599799999997,111.97667,54434304,40327816.0,45.06621493529766,1.5,2.75,1.0384218280276678,1.3497954860734338,-0.14001019393221564,0.2748127029223184,0.4148228968545341,14.900104887446695,-0.19685041131445954,1075340493.0,2004-10-13,2004,2,287,10,1.57,112.2,111.92998999999999,110.58,1200
2004-10-14 13:30:00,111.75,111.92998999999999,110.58,110.64,111.88870967741934,115.01174764705885,112.4306507000003,111.74730100000006,111.27839999999992,112.39099799999997,111.92194238329662,112.34903367455924,112.65615000000022,114.95883780127384,110.35346219872669,112.4306507000003,111.74730100000006,111.27839999999992,112.39099799999997,111.04999666666669,64549392,42359410.4,40.67896452356933,1.5,2.75,1.0606766974542634,1.5238501053357438,-0.2573221260224296,0.09317023932649704,0.35049236534892664,15.567380003595893,-2.648473616231732,1010791101.0,2004-10-14,2004,3,288,10,1.22,111.25,111.74001000000001,110.57001000000001,1201
2004-10-15 13:30:00,111.03998999999999,111.74001000000001,110.57001000000001,111.25998999999999,112.01193548387094,115.0670405882353,112.43105070000028,111.75720090000006,111.33559999999993,112.29649799999996,111.89598346630459,112.24531522936311,112.65461076923106,114.96099983715195,110.34822170131012,112.43105070000028,111.75720090000006,111.33559999999993,112.29649799999996,111.19000333333334,63483392,43848855.2,44.67470061672024,1.5,2.75,1.0684855047789592,1.4477776377614529,-0.2809907798974901,-0.0007461095229359671,0.2802446703745541,11.76042839648281,-2.266347505270556,1074274493.0,2004-10-15,2004,4,289,10,1.06,111.16,111.89998999999999,110.7,1202
2004-10-18 13:30:00,110.89,111.89998999999999,110.7,111.67998999999999,112.13516129032257,115.12233352941178,112.43305065000031,111.75550070000007,111.43219959999992,112.25699749999998,111.88751313429266,112.19147473132851,112.64230230769256,114.96757977285922,110.3170248425259,112.43305065000031,111.75550070000007,111.43219959999992,112.25699749999998,111.42666,43762608,44177495.2,47.26605963470955,1.5,2.75,1.0778786830090332,0.9906086300700904,-0.2568473509732686,-0.04081451834203165,0.21603283263123696,12.065007207404456,-1.9490783098400613,1118037101.0,2004-10-18,2004,0,292,10,1.08,111.3,112.23,110.59,1203
2004-10-19 13:30:00,112.02,112.23,110.59,110.74001000000001,112.2583870967742,115.17762647058822,112.43060070000031,111.74050070000007,111.50699979999992,112.14599750000001,111.84251301137922,112.05323999501152,112.56384230769257,115.06508434238391,110.06260027300121,112.43060070000031,111.74050070000007,111.50699979999992,112.14599750000001,111.18667,56057808,44933916.0,42.47143359037137,1.5,2.75,1.1180302056512452,1.2475611518034615,-0.2902072126347618,-0.1467261831622153,0.14348102947254648,12.49159788173008,-3.3850898621532077,1061979293.0,2004-10-19,2004,1,293,10,1.48,111.41,110.82001000000001,109.75,1204
2004-10-20 13:30:00,110.38,110.82001000000001,109.75,110.52,112.3816129032258,115.23291941176471,112.4210007000003,111.71700070000006,111.55299979999992,112.0944975,111.79064975603102,111.90721713834377,112.32307384615412,114.95872643033495,109.68742126197328,112.4210007000003,111.71700070000006,111.55299979999992,112.0944975,110.36333666666668,57174896,45334200.8,41.41255573431553,1.5,2.75,1.1146001909618704,1.2611868079959625,-0.31125199937937953,-0.245583969751678,0.06566802962770159,11.11097888671176,-2.5826355222565067,1004804397.0,2004-10-20,2004,2,294,10,0.97,110.29,111.32001000000001,110.21001000000001,1205
2004-10-21 13:30:00,110.78998999999999,111.32001000000001,110.21001000000001,111.24001000000001,112.50483870967741,115.2882123529412,112.4144507500003,111.70080080000004,111.61459999999994,112.108998,111.76905604010824,111.84367360135865,112.12307461538491,114.660706831456,109.58544239931379,112.4144507500003,111.70080080000004,111.61459999999994,112.108998,110.92334333333332,53261696,45792770.4,46.14470209834794,1.5,2.75,1.1142716058931652,1.1631027241802343,-0.2627754466444684,-0.26280127867788394,-2.5832033415523762e-05,11.60714856735393,-1.128770876257303,1058066093.0,2004-10-21,2004,3,295,10,1.01,110.77,111.25,109.86,1206
2004-10-22 13:30:00,111.19,111.25,109.86,109.99001000000001,112.62806451612906,115.34350529411765,112.3997508500003,111.67360080000003,111.67480019999996,112.035498,111.69928952873144,111.66713421075303,111.8223069230772,114.37303332434529,109.2715805218091,112.3997508500003,111.67360080000003,111.67480019999996,112.035498,110.36667,48759808,46480180.8,40.0905685260932,1.5,2.75,1.1339664911865106,1.0490451448502112,-0.298388003674529,-0.3730108366265768,-0.07462283295204776,12.307148840056655,-2.6378596087456856,1009306285.0,2004-10-22,2004,4,296,10,1.27,110.56,110.12,109.35001000000001,1207
2004-10-25 13:30:00,109.75,110.12,109.35001000000001,109.86,109.35001000000001,115.39879823529414,112.3821508500003,111.64090080000004,111.72820019999996,111.99099800000002,111.6271605276047,111.4950261906813,111.45615307692331,113.63477906706484,109.27752708678179,112.3821508500003,111.64090080000004,111.72820019999996,111.99099800000002,109.77667000000002,44055392,46699345.6,39.50995372643194,1.5,2.75,1.1079681703874746,0.94338349786212,-0.3126838846248324,-0.4654776887330882,-0.15279380410825588,11.669860612774483,-2.3727006131698234,965250893.0,2004-10-25,2004,0,299,10,0.7,109.74,111.60001000000001,109.88,1208
2004-10-26 13:30:00,110.10001000000001,111.60001000000001,109.88,111.53998999999999,109.29422105263157,115.45409117647058,112.3779008000003,111.63540070000003,111.79299999999996,112.0039975,111.62374207554177,111.49930845823549,111.30922923076947,113.16368859445599,109.45476986708296,112.3779008000003,111.63540070000003,111.79299999999996,112.0039975,111.00666666666666,54483296,47338395.2,49.65622143250618,1.5,2.75,1.153114015359798,1.1509324676050698,-0.1966468309462702,-0.3986023427910936,-0.20195551184482344,15.501218343827007,0.0,1019734189.0,2004-10-26,2004,1,300,10,1.57,110.74,113.10001000000001,111.12,1209
2004-10-27 13:30:00,111.38,113.10001000000001,111.12,112.88,109.23843210526316,115.50938411764707,112.3762008000003,111.63440070000004,111.87239999999996,112.05599750000002,111.67300709218719,111.6308028907845,111.3376915384618,113.27452293366619,109.40086014325743,112.3762008000003,111.63440070000004,111.87239999999996,112.05599750000002,112.36667,73928496,49341484.8,55.99633804569842,1.5,2.75,1.212178014262669,1.4983030263410315,-0.026251004346266062,-0.234769267277656,-0.20851826293138995,16.17050067928459,2.0245842371655773,1093662685.0,2004-10-27,2004,2,301,10,1.78,112.11,113.56,112.49001000000001,1210
2004-10-28 13:30:00,112.78,113.56,112.49001000000001,113.22,109.18264315789473,115.5646770588235,112.3795008000003,111.61960070000003,111.93619999999996,112.128998,111.73367348072887,111.78215499642408,111.35692230769257,113.36196388118469,109.35188073420042,112.3795008000003,111.61960070000003,111.93619999999996,112.128998,113.09000333333331,54427008,49883230.4,57.46020755498847,1.5,2.75,1.2020217275296214,1.0910882788376914,0.10552494657496092,-0.0766120797126888,-0.18213702628764966,15.054602706793554,1.7616485494920473,1148089693.0,2004-10-28,2004,3,302,10,0.95,113.03,113.64,112.89998999999999,1211
2004-10-29 13:30:00,113.17998999999999,113.64,112.89998999999999,113.2,109.12685421052632,115.61997,112.37800080000034,111.60300070000002,112.00599979999996,112.10649850000001,111.79117648148458,111.91718785390749,111.40846076923106,113.56051999064549,109.25640154781658,112.37800080000034,111.60300070000002,112.00599979999996,112.10649850000001,113.24666333333334,48824800,49182255.2,57.3393699180748,1.5,2.75,1.169020889848934,0.9927320290916629,0.1829719228422287,0.04657787726513618,-0.13639404557709253,14.958022155340819,1.3610405946490496,1099264893.0,2004-10-29,2004,4,303,10,0.66,113.27,113.84,113.2,1212
2004-11-01 14:30:00,113.56,113.84,113.2,113.50998999999999,109.07106526315788,115.67526294117648,112.37665075000034,111.60020070000004,112.06659959999998,112.089998,111.85858093319106,112.0688832963925,111.55999923076948,113.98756596442206,109.13243249711695,112.37665075000034,111.60020070000004,112.06659959999998,112.089998,113.51666333333334,36770896,49341444.8,58.786079423415444,1.5,2.75,1.1312336834311532,0.7452334675047863,0.2429488127121666,0.1672919703131157,-0.07565684239905088,14.918281124965821,2.501336237914376,1136035789.0,2004-11-01,2004,0,306,11,0.57,113.52,114.57001000000001,113.22,1213
2004-11-02 14:30:00,113.67,114.57001000000001,113.22,113.55,109.01527631578949,115.73055588235296,112.37325075000034,111.59220060000004,112.13359959999998,112.0724985,111.92491109267378,112.20994203006941,111.78384538461563,114.36274335854569,109.20494741068559,112.37325075000034,111.59220060000004,112.13359959999998,112.0724985,113.78000333333334,56258496,50296234.4,58.97943701881013,1.5,2.75,1.1468605631860704,1.1185429022893214,0.27104848084083705,0.2631537586519954,-0.007894722188841616,13.536899570070254,2.7415852334419117,1192294285.0,2004-11-02,2004,1,307,11,1.19,113.9,115.36,114.24001000000001,1214
2004-11-03 14:30:00,115.03,115.36,114.24001000000001,114.98,108.95948736842104,115.78584882352942,112.37715075000031,111.60980060000004,112.22619939999996,112.0904985,112.04471850080421,112.47375707482469,112.07000000000023,115.13299525605707,109.00700474394344,112.37715075000031,111.60980060000004,112.22619939999996,112.0904985,114.86000333333332,77030000,52032844.0,65.25388751807499,1.5,2.75,1.194227665815637,1.48041110341768,0.3657832331252771,0.4493343192177548,0.08355108609247767,14.309545778283846,3.362090672232056,1269324285.0,2004-11-03,2004,2,308,11,0.98,114.8,116.67,114.67998999999999,1215
2004-11-04 14:30:00,114.78,116.67,114.67998999999999,116.55,108.90369842105262,115.84114176470591,112.3844007000003,111.63510060000004,112.33519919999998,112.24549850000002,112.22139620665504,112.86197068674616,112.4446161538464,116.31104812402519,108.57818418366762,112.3844007000003,111.63510060000004,112.33519919999998,112.24549850000002,115.96666333333332,55456704,52835164.0,70.57537781270302,1.5,2.75,1.25106926111452,1.0496173343949495,0.5054181919217906,0.7153238259947159,0.2099056340729253,15.305872178963373,5.964168927705343,1324780989.0,2004-11-04,2004,3,309,11,1.74,115.67,117.64,116.49001000000001,1216
2004-11-05 14:30:00,117.05,117.64,116.49001000000001,117.28,108.8479094736842,115.89643470588236,112.3968007000003,111.66790060000002,112.45879899999996,112.48399900000004,112.41977282600192,113.28273538324652,112.94769230769256,117.44625120068329,108.4491334147018,112.3968007000003,111.66790060000002,112.45879899999996,112.48399900000004,117.13666999999998,63308496,53406448.8,72.67120480902895,1.5,2.75,1.2438493138920546,1.1854092047400837,0.6111170471207625,0.9738019429738785,0.362684895853116,11.442533431141063,6.7540506098671065,1388089485.0,2004-11-05,2004,4,310,11,0.99,117.07,117.23,116.72,1217
2004-11-08 14:30:00,116.98,117.23,116.72,117.11,108.79212052631578,115.95172764705885,112.4102007500003,111.70070060000003,112.57199899999996,112.69099900000006,112.6037033034136,113.64723677531828,113.45461538461564,118.22183830390995,108.6873924653213,112.4102007500003,111.70070060000003,112.57199899999996,112.69099900000006,117.02,34161200,54102199.2,71.39585800910078,1.5,2.75,1.1950029343283366,0.6314198037258345,0.6311757445852023,1.1516545765846191,0.5204788319994166,11.508312465739056,4.993733637594907,1353928285.0,2004-11-08,2004,0,313,11,0.44,116.98,117.5,116.75998999999999,1218
2004-11-09 14:30:00,117.08,117.5,116.75998999999999,116.88,108.73633157894736,116.0070205882353,112.41525075000034,111.73320060000003,112.69899899999996,112.90849900000003,112.77140121308365,113.95511898719272,113.88846076923102,118.79505745282505,108.981864085637,112.41525075000034,111.73320060000003,112.69899899999996,112.90849900000003,117.04666333333334,44713200,54245094.4,69.61578722217742,1.5,2.75,1.1625034390191695,0.8242809878859756,0.5912377032160031,1.2595259610194205,0.6682882578034174,10.910119404824481,3.5435861091424523,1309215085.0,2004-11-09,2004,1,314,11,0.63,117.13,117.55,116.75998999999999,1219
2004-11-10 14:30:00,117.06,117.55,116.75998999999999,116.97,108.68054263157894,116.06231352941177,112.42670080000036,111.77090060000002,112.81619899999998,113.17999950000004,112.93605214590391,114.242250512222,114.42538307692331,119.02615221303564,109.824613940811,112.42670080000036,111.77090060000002,112.81619899999998,113.17999950000004,117.09333000000001,45270192,53786888.8,69.93170381162177,1.5,2.75,1.1358967648035143,0.8416584972656014,0.5348625884998518,1.3368664934282322,0.8020039049283804,10.038784693058409,3.3121356650768417,1354485277.0,2004-11-10,2004,2,315,11,0.68,117.15,118.12,117.10001000000001,1220
2004-11-11 14:30:00,117.17998999999999,118.12,117.10001000000001,117.86,108.6247536842105,116.11760647058823,112.44915080000037,111.81180060000004,112.94699879999996,113.54099950000004,113.1291481401822,114.58679808248655,115.04076769230792,119.1479393913858,110.93359599323007,112.44915080000037,111.81180060000004,112.94699879999996,113.54099950000004,117.69333666666668,38408000,52479819.2,72.92919425111323,1.5,2.75,1.1369041387461207,0.7318622774523582,0.5209753823411034,1.4532231328547596,0.9322477505136562,10.286096684463704,4.116607773851587,1392893277.0,2004-11-11,2004,3,316,11,0.87,117.61,119.0,117.67998999999999,1221
2004-11-12 14:30:00,117.97,119.0,117.67998999999999,118.78998999999999,108.5689647368421,116.17289941176472,112.47570075000036,111.85220050000002,113.07119859999996,113.91749950000003,113.35114193860642,114.98710207463068,115.59846000000023,119.6207726592814,111.57614734071907,112.47570075000036,111.85220050000002,113.07119859999996,113.91749950000003,118.48999333333336,55641808,52087740.0,75.65972698697703,1.5,2.75,1.1499831288356834,1.0682323325988037,0.53581142453015,1.6020120311763435,1.0662006066461935,10.120281174156858,4.651572958468238,1448535085.0,2004-11-12,2004,4,317,11,1.12,118.34,118.77,118.23,1222
2004-11-15 14:30:00,118.5,118.77,118.23,118.73,108.51317578947369,116.2281923529412,112.50195075000036,111.8956005,113.20339859999996,114.27000000000004,113.56207754885712,115.34356854371349,116.04846000000026,120.06250323955382,112.0344167604467,112.50195075000036,111.8956005,113.20339859999996,114.27000000000004,118.57666666666668,35299392,51664579.2,75.13326895428574,1.5,2.75,1.1078407624902773,0.6832416434352764,0.5034734790286375,1.6955424554319904,1.192068976403353,10.526173048221617,4.561867018934397,1413235693.0,2004-11-15,2004,0,320,11,0.46,118.5,118.41,117.73,1223
2004-11-16 14:30:00,118.36,118.41,117.73,117.88,108.45738684210528,116.28348529411764,112.52150075000036,111.93600049999999,113.30379859999998,114.62699950000004,113.73140784105878,115.5851334443122,116.4069215384618,120.17111262329011,112.64273045363348,112.52150075000036,111.93600049999999,113.30379859999998,114.62699950000004,118.00666666666666,40136704,50868524.0,67.92166216112938,1.5,2.75,1.1001378508838289,0.7890282800420944,0.3916988900002898,1.681692588903715,1.2899936989034253,12.339449477380779,2.522177770046957,1373098989.0,2004-11-16,2004,1,321,11,0.58,118.07,119.14,118.07001000000001,1224
2004-11-17 14:30:00,118.37,119.14,118.07001000000001,118.58,108.40159789473684,116.33877823529413,112.54550075000036,111.98730049999999,113.42379859999996,115.02999950000006,113.9215487100369,115.87035883056818,116.82076769230795,120.25189754159037,113.38963784302555,112.54550075000036,111.98730049999999,113.42379859999996,115.02999950000006,118.59666999999999,54935008,50756529.6,70.43815173543547,1.5,2.75,1.1115565758206989,1.0823239577829609,0.3340189783229828,1.7075174218071538,1.373498443484171,11.149765043379004,1.741741741741743,1428033997.0,2004-11-17,2004,2,322,11,0.91,118.61,118.8,118.23,1225
2004-11-18 14:30:00,118.49001000000001,118.8,118.23,118.74001000000001,108.34580894736843,116.39407117647059,112.57495075000038,112.0355006,113.5489988,115.40499950000006,114.11050797630995,116.14365894194263,117.22307692307716,120.20400480769524,114.24214903845913,112.57495075000038,112.0355006,113.5489988,115.40499950000006,118.59000333333334,31910704,49688980.0,70.99822093139521,1.5,2.75,1.072873963262077,0.6422088760928479,0.2780460416013246,1.7210559954858269,1.4430099538845025,8.938036626876551,1.2448925648021802,1459944701.0,2004-11-18,2004,3,323,11,0.48,118.52,118.72,117.14,1226
2004-11-19 14:30:00,118.7,118.72,117.14,117.42,108.29002,116.44936411764708,112.59615080000036,112.06440059999998,113.6361988,115.77649900000006,114.24029197723898,116.26521523318621,117.52076923076949,119.61651520097324,115.42502326056572,112.59615080000036,112.06440059999998,113.6361988,115.77649900000006,117.76,54280096,49964994.4,60.76971739616582,1.5,2.75,1.1105265373147857,1.0863624954193931,0.1309920555709565,1.6067500233481982,1.4757579677772414,11.129710515592546,0.2647083938177801,1405664605.0,2004-11-19,2004,4,324,11,1.35,117.93,118.12,117.03,1227
2004-11-22 14:30:00,117.17,118.12,117.03,117.98,108.23423105263157,116.50465705882355,112.61380080000038,112.11480059999998,113.72719899999998,116.18249900000004,114.38694719381785,116.42852806812084,117.75153846153871,119.2541073623877,116.24896956068977,112.61380080000038,112.11480059999998,113.72719899999998,116.18249900000004,117.71,37566496,49640549.6,63.19240576862818,1.5,2.75,1.1090603560780152,0.756770348086557,0.054238334072169714,1.5435558853674536,1.489317551295284,11.37618024264357,0.9411362080766672,1443231101.0,2004-11-22,2004,0,327,11,0.93,117.58,118.25998999999999,117.37,1228
2004-11-23 14:30:00,117.92998999999999,118.25998999999999,117.37,118.16,108.17844210526316,116.55995,112.63220080000038,112.1676006,113.817199,116.51349950000004,114.53491004896223,116.59343015687124,117.87538461538489,119.21832307860151,116.53244615216823,112.63220080000038,112.1676006,113.817199,116.51349950000004,117.92999666666664,41973008,49015035.2,63.962770992282074,1.5,2.75,1.093412473501014,0.8563292432359612,0.0011966809644738954,1.4908134025008764,1.4896167215364025,11.248314923795784,1.017354877318969,1485204109.0,2004-11-23,2004,1,328,11,0.76,117.81,118.59,118.05,1229
2004-11-24 14:30:00,118.27,118.59,118.05,118.44,108.12265315789473,116.61524294117649,112.65015075000038,112.2331006,113.92999899999997,116.79149950000004,114.68805083135588,116.76929395145493,117.96461538461566,119.29151136650972,116.6377194027216,112.65015075000038,112.2331006,113.92999899999997,116.79149950000004,118.36,29732800,46805250.4,65.18348721579804,1.5,2.75,1.0538830111080848,0.6352449724315544,-0.0278231370479336,1.4548378002264857,1.482660937274419,11.268987526890964,0.492109282199218,1514936909.0,2004-11-24,2004,2,329,11,0.46,118.32,118.98,118.3,1230
2004-11-26 14:30:00,118.50998999999999,118.98,118.3,118.35001000000001,108.06686421052632,116.67053588235297,112.66155075000036,112.2944007,114.03419919999996,117.04800000000004,114.83165707326349,116.91983833703064,118.06000076923107,119.30307447829723,116.81692706016491,112.66155075000036,112.2944007,114.03419919999996,117.04800000000004,118.54333666666668,15490000,44858400.0,64.42811732191011,1.5,2.75,1.0271770817432222,0.3453087938936743,-0.06381375026824254,1.4028937494391158,1.4667074997073584,10.54960821992374,-0.3703847436976849,1499446909.0,2004-11-26,2004,4,331,11,0.57,118.64,119.00998999999999,117.48,1231
2004-11-29 14:30:00,118.78998999999999,119.00998999999999,117.48,117.81,108.01107526315788,116.72582882352944,112.67235080000036,112.3583007,114.12739939999996,117.27850000000004,114.9484548350963,117.00461563826583,118.13153923076952,119.18774034799749,117.0753381135416,112.67235080000036,112.3583007,114.12739939999996,117.27850000000004,118.09999666666666,61760608,45505190.4,59.93935721688045,1.5,2.75,1.0630922901901347,1.357221175367283,-0.1308606160876058,1.3031317295978508,1.4339923456854569,9.721316299926768,-0.7748673460793408,1437686301.0,2004-11-29,2004,0,334,11,1.3,118.24,118.24001000000001,117.64,1232
2004-11-30 14:30:00,118.0,118.24001000000001,117.64,117.89,107.9552863157895,116.7811217647059,112.68615080000036,112.4199007,114.23579939999998,117.49750050000004,115.06380954744544,117.08893795843099,118.20230846153878,119.03798096330704,117.36663595977049,112.68615080000036,112.4199007,114.23579939999998,117.49750050000004,117.92333666666669,54476096,46390450.4,60.37975084367735,1.5,2.75,1.0300149837479822,1.1742954752601409,-0.17399238432248287,1.2165018652823534,1.3904942496048365,9.759296456801458,0.008483203257554391,1492162397.0,2004-11-30,2004,1,335,11,0.51,117.94,119.5,118.10001000000001,1233
2004-12-01 14:30:00,118.16,119.5,118.10001000000001,119.23,107.89949736842104,116.83641470588238,112.70145080000036,112.4944007,114.36119919999996,117.78150050000004,115.2271895651927,117.29284862905659,118.30769307692341,119.27869265950552,117.33669349434123,112.70145080000036,112.4944007,114.36119919999996,117.78150050000004,118.94333666666664,49909904,46073020.8,66.93628408726646,1.5,2.75,1.0714424849088402,1.0832783076381225,-0.1190667738919342,1.2416607822399186,1.3607275561318528,10.960639989161573,0.5481531455557478,1542072301.0,2004-12-01,2004,2,336,12,1.19,118.8,119.87,119.00998999999999,1234
2004-12-02 14:30:00,119.10001000000001,119.87,119.00998999999999,119.33,107.84370842105265,116.89170764705885,112.71980080000036,112.56910069999998,114.51679919999997,117.99900050000004,115.38808409204788,117.48686304533692,118.34923230769262,119.43824034445768,117.26022427092757,112.71980080000036,112.56910069999998,114.51679919999997,117.99900050000004,119.40333000000001,60177104,45230376.0,67.3702451471137,1.5,2.75,1.0563401645582091,1.330457743707459,-0.08442251533149703,1.2551994119674816,1.3396219272989789,10.529922695852358,0.4968754845144449,1602249405.0,2004-12-02,2004,3,337,12,0.72,119.44,120.14,119.09,1235
2004-12-03 14:30:00,119.27,120.14,119.09,119.25,107.7879194736842,116.94700058823533,112.73990080000038,112.64640069999996,114.68279919999998,118.13400050000004,115.5395317747127,117.65478085054292,118.38923230769258,119.56591585294414,117.21254876244109,112.73990080000038,112.64640069999996,114.68279919999998,118.13400050000004,119.49333333333334,49073696,44911225.6,66.61696141213328,1.5,2.75,1.0558872956611938,1.0926821823361683,-0.0756010879866611,1.2451205673156522,1.3207216553023131,10.543255283075931,1.5585079202861507,1553175709.0,2004-12-03,2004,4,338,12,0.88,119.62,119.64,118.84,1236
2004-12-06 14:30:00,119.21001000000001,119.64,118.84,119.21001000000001,107.7321305263158,117.00229352941179,112.76155085000036,112.7305008,114.83779919999998,118.230501,115.68347209727295,117.80289791239599,118.49154076923107,119.70406334488524,117.27901819357693,112.76155085000036,112.7305008,114.83779919999998,118.230501,119.23000333333334,33045104,43398056.0,66.21838175769595,1.5,2.75,1.037609631685394,0.7614420332560519,-0.08070168987313098,1.2198445429608995,1.3005462328340305,7.6093540543191684,1.0425580606882463,1520130605.0,2004-12-06,2004,0,341,12,0.67,119.24,119.62,118.03998999999999,1237
2004-12-07 14:30:00,119.49001000000001,119.62,118.03998999999999,118.10001000000001,107.67634157894736,117.05758647058822,112.77910090000036,112.80440079999998,114.98479939999996,118.28000149999998,115.77823828953676,117.8311943016916,118.45461846153879,119.68324304685372,117.22599387622385,112.77910090000036,112.80440079999998,114.98479939999996,118.28000149999998,118.58666666666667,52105696,44295280.8,56.17206328478195,1.5,2.75,1.0763525151364373,1.1763261245653962,-0.1623625709740455,1.0975930191164736,1.259955590090519,9.481540679737307,-0.050770142180094034,1468024909.0,2004-12-07,2004,1,342,12,1.34,118.83,118.82001000000001,118.00998999999999,1238
2004-12-08 14:30:00,118.21001000000001,118.82001000000001,118.00998999999999,118.78998999999999,107.62055263157896,117.11287941176472,112.80110085000037,112.88990059999998,115.13499919999998,118.375501,115.89634619975101,117.922508177721,118.45846307692341,119.69094254062878,117.22598361321803,112.80110085000037,112.88990059999998,115.13499919999998,118.375501,118.53999666666664,43901104,44254676.0,60.21287946588546,1.5,2.75,1.0573287640552629,0.9920105165836036,-0.17248857788165894,1.0443448677384453,1.2168334456201042,10.0221286373559,0.29549983113813355,1511926013.0,2004-12-08,2004,2,343,12,0.69,118.42,119.46001000000001,117.73,1239
2004-12-09 14:30:00,118.14,119.46001000000001,117.73,119.21001000000001,107.5647636842105,117.16817235294121,112.82280090000036,112.9656007,115.28239939999996,118.4875015,116.02629379976078,118.0451273988904,118.5961561538465,119.72979746509763,117.46251484259531,112.82280090000036,112.9656007,115.28239939999996,118.4875015,118.80000666666666,60953104,45038821.6,62.48061266666251,1.5,2.75,1.1053774237656009,1.3533458877174531,-0.1540821696555501,1.0242307335506666,1.1783129032062167,10.1215010215981,0.7266581557534295,1572879117.0,2004-12-09,2004,3,344,12,1.47,118.6,119.56,118.85001000000001,1240
2004-12-10 14:30:00,118.88,119.56,118.85001000000001,119.33,107.50897473684209,117.22346529411766,112.84475090000038,113.0631007,115.4337996,118.56100149999999,116.15585090565253,118.16749621804372,118.70000230769264,119.8361766713851,117.56382794400015,112.84475090000038,113.0631007,115.4337996,118.56100149999999,119.24667,47852800,45511061.6,63.12718264731053,1.5,2.75,1.077135464925201,1.0514542688672417,-0.13755311996568276,1.0063715032491132,1.143924623214796,10.082361281914883,1.2902130549189341,1620731917.0,2004-12-10,2004,4,345,12,0.6,119.21,120.39998999999999,119.35001000000001,1241
2004-12-13 14:30:00,119.75998999999999,120.39998999999999,119.35001000000001,120.37,107.4531857894737,117.27875823529413,112.87150090000036,113.1680007,115.5681998,118.64000199999998,116.32111165445043,118.37725848299192,118.87000230769263,120.26416479687069,117.47583981851456,112.87150090000036,113.1680007,115.5681998,118.64000199999998,120.04,38708896,44664416.0,68.23648217082544,1.5,2.75,1.0766250745734012,0.8666607439801742,-0.06404084206011085,1.0638735706396574,1.1279144126997682,10.349835099290775,2.103655950462299,1659440813.0,2004-12-13,2004,0,348,12,0.88,119.88,120.96001000000001,120.17998999999999,1242
2004-12-14 14:30:00,120.17998999999999,120.96001000000001,120.17998999999999,120.78998999999999,107.39739684210528,117.33405117647058,112.89465085000036,113.2863005,115.70719959999998,118.7430015,116.49636178564847,118.6070424369927,119.05077076923106,120.7508735785533,117.35066795990885,112.89465085000036,113.2863005,115.70719959999998,118.7430015,120.64333,41736096,44986251.2,70.04182893283706,1.5,2.75,1.0554389978181578,0.9277522551156696,0.001912156550973432,1.1303046083884851,1.1283924518375117,10.329147896602494,1.3083871508848437,1701176909.0,2004-12-14,2004,1,349,12,0.65,120.57,121.11,120.31,1243
2004-12-15 14:30:00,120.7,121.11,120.31,120.88,107.34160789473684,117.38934411764707,112.9216508500004,113.4076005,115.8467998,118.89300149999998,116.66826916660344,118.82351458585053,119.24538538461569,121.14730967086878,117.3434610983626,112.9216508500004,113.4076005,115.8467998,118.89300149999998,120.76666666666668,46759296,45317380.8,70.42973251023025,1.5,2.75,1.0371933551168606,1.0318181495608414,0.03860686928037582,1.1766510384379814,1.1380441691576055,8.656084805139908,1.2989189642168752,1747936205.0,2004-12-15,2004,2,350,12,0.66,120.71,121.24001000000001,120.03998999999999,1244
2004-12-16 14:30:00,120.72,121.24001000000001,120.03998999999999,120.81,107.28581894736843,117.44463705882356,112.9472508500004,113.5180005,115.97059979999999,119.0045015,116.83068998359937,119.01270367291237,119.47615461538493,121.35327655065186,117.59903268011794,112.9472508500004,113.5180005,115.97059979999999,119.0045015,120.69666666666666,51650192,45153140.0,69.67416681045947,1.5,2.75,1.04882382975137,1.1438892621864172,0.044740000517996086,1.1939691698051007,1.1492291692871046,8.725977644570044,1.3081761006289327,1696286013.0,2004-12-16,2004,3,351,12,1.0,120.64,119.97,119.16,1245
2004-12-17 14:30:00,119.46001000000001,119.97,119.16,119.44,107.23003,117.49993000000002,112.9645008000004,113.61140039999998,116.09039979999999,119.039501,116.93301586659548,119.05339856120644,119.59538538461568,121.23642351472724,117.95434725450413,112.9645008000004,113.61140039999998,116.09039979999999,119.039501,119.52333333333333,71183008,47116755.2,56.82529238520663,1.5,2.75,1.0917649847691298,1.5107790784370483,-0.05166871879531043,1.0846432707929663,1.136311989588277,11.353766455581644,0.1929284294162888,1625103005.0,2004-12-17,2004,4,352,12,0.68,119.56,120.28998999999999,119.17,1246
2004-12-20 14:30:00,119.75,120.28998999999999,119.17,119.47,107.17424105263157,117.5552229411765,112.97995080000038,113.70040029999998,116.2296,119.14200099999998,117.03250544045449,119.09307488871059,119.61384692307722,121.24338713342688,117.98430671272754,112.97995080000038,113.70040029999998,116.2296,119.14200099999998,119.64333,47201392,46762820.0,57.01224152526702,1.5,2.75,1.0937810572856206,1.0093786473955164,-0.11783228628755582,0.989021631728832,1.106853918016388,11.349416262162485,1.1600253039775368,1672304397.0,2004-12-20,2004,0,355,12,0.94,119.73,120.48,119.07001000000001,1247
2004-12-21 14:30:00,119.60001000000001,120.48,119.07001000000001,120.39,107.11845210526316,117.61051588235296,113.0071007500004,113.79590029999996,116.378,119.26250099999996,117.16417189377,119.21659156597624,119.69538538461569,121.36552752223888,118.02524324699249,113.0071007500004,113.79590029999996,116.378,119.26250099999996,119.98000333333331,33197600,46544375.2,62.390513133102274,1.5,2.75,1.1163674103366483,0.7132462270113359,-0.1045040906130712,0.9762238047500488,1.08072789536312,10.249728515276995,1.346923255065513,1705501997.0,2004-12-21,2004,1,356,12,1.18,119.78,121.08,120.05,1248
2004-12-22 14:30:00,120.38,121.08,120.05,120.67998999999999,107.06266315789473,117.66580882352943,113.0380007000004,113.8920001,116.5409998,119.3885005,117.30204711362215,119.35596284540709,119.80538461538494,121.53113959196068,118.07962963880921,113.0380007000004,113.8920001,116.5409998,119.3885005,120.60333,31507904,46021120.0,63.92270034144557,1.5,2.75,1.1101983095983163,0.6846400956778106,-0.08201826425834757,0.9782050650401856,1.0602233292985332,9.957440412919672,1.2331011464557438,1737009901.0,2004-12-22,2004,2,357,12,0.86,120.56,121.28,120.09,1249
2004-12-23 14:30:00,120.87,121.28,120.09,120.77,107.00687421052632,117.7211017647059,113.0789507000004,113.99759999999998,116.7256,119.50500049999998,117.43804526602914,119.4906330506064,119.92538384615416,121.68545924531706,118.16530844699128,113.0789507000004,113.99759999999998,116.7256,119.50500049999998,120.71333333333332,25647696,45816864.8,64.40739322561195,1.5,2.75,1.1158984303412935,0.5597872336301807,-0.06754667677505166,0.9757899833297188,1.0433366601047704,9.885925551281463,1.2067376183692262,1762657597.0,2004-12-23,2004,3,358,12,0.99,120.68,121.36,120.39,1250
2004-12-27 14:30:00,121.2,121.36,120.39,120.52,106.95108526315788,117.77639470588238,113.1259507000004,114.10079999999998,116.9232,119.61349999999996,117.55890623598877,119.58866799816771,120.11153692307722,121.54080814054348,118.68226570561096,113.1259507000004,114.10079999999998,116.9232,119.61349999999996,120.75666666666666,29984304,46541580.0,61.91915712709061,1.5,2.75,1.105477113888344,0.6442476598344964,-0.08040157481877896,0.9428346915812966,1.0232362664000756,10.074972200560914,0.12461576804851,1732673293.0,2004-12-27,2004,0,362,12,0.81,120.88,121.33,120.60001000000001,1251
2004-12-28 14:30:00,120.64,121.33,120.60001000000001,121.17998999999999,106.8952963157895,117.83168764705884,113.16895065000038,114.2286,117.12160000000002,119.78199949999998,117.70090952085194,119.74022247453269,120.29538307692341,121.6074414823463,118.98332467150044,113.16895065000038,114.2286,117.12160000000002,119.78199949999998,121.03666666666668,23429296,44625014.4,65.68781152791829,1.5,2.75,1.0843716057534625,0.5250260714761809,-0.05145362224168326,0.9589192385979716,1.0103728608396547,9.319814482534897,0.3228744368635187,1756102589.0,2004-12-28,2004,1,363,12,0.61,120.97,121.39998999999999,120.95,1252
2004-12-29 14:30:00,121.08,121.39998999999999,120.95,121.36,106.83950736842104,117.88698058823532,113.2197506500004,114.3736999,117.31520020000002,119.95549950000002,117.84440326513227,119.89448700076763,120.46076692307724,121.72502918335618,119.19650466279829,113.2197506500004,114.3736999,117.31520020000002,119.95549950000002,121.23666333333334,23770192,43089719.2,66.65704370507375,1.5,2.75,1.0390586339139292,0.5516441610972485,-0.02833588132566733,0.9749530091825704,1.0032888905082378,9.168847143544738,0.3970880211780311,1779872781.0,2004-12-29,2004,2,364,12,0.37,121.17,121.57001000000001,121.03998999999999,1253
2004-12-30 14:30:00,121.39998999999999,121.57001000000001,121.03998999999999,121.13,106.78371842105264,117.94227352941179,113.2664507000004,114.51499989999998,117.523,120.05049950000002,117.9732501959114,120.01215490545644,120.59922846153877,121.72441907946327,119.47403784361424,113.2664507000004,114.51499989999998,117.523,120.05049950000002,121.24666666666668,21079696,41648208.8,64.16313324991317,1.5,2.75,1.002698731491505,0.5061369169854911,-0.03618557144448609,0.9580569262026302,0.9942424976471164,9.264550989772742,0.26487873520403377,1758793085.0,2004-12-30,2004,3,365,12,0.44,121.3,121.66,120.8,1254
2004-12-31 14:30:00,121.3,121.66,120.8,120.87,106.7279294736842,117.99756647058823,113.30560075000038,114.64149990000001,117.73,120.12749950000001,118.08684822744429,120.09385443827013,120.6376900000003,121.763091265995,119.51228873400558,113.30560075000038,114.64149990000001,117.73,120.12749950000001,121.11,28655600,40072133.6,61.367972569727705,1.5,2.75,0.9925059649563976,0.7151004307891407,-0.06486560934772145,0.9131604859624644,0.978026095310186,9.356361702534024,1.1972538513061008,1730137485.0,2004-12-31,2004,4,366,12,0.71,121.23,121.75998999999999,119.89998999999999,1255
2005-01-03 14:30:00,121.56,121.75998999999999,119.89998999999999,120.3,106.6721405263158,121.75998999999999,113.34175070000038,114.76289990000001,117.9111998,120.1799995,118.1736384930347,120.11348734891105,120.59999846153877,121.73524994843044,119.46474697464708,113.34175070000038,114.76289990000001,117.9111998,120.1799995,120.65332666666669,55997600,40418328.8,55.644857947158954,1.5,2.75,1.0544698246023692,1.3854506522793195,-0.12473388465172207,0.8221087394955333,0.9468426241472554,6.8081640263003695,0.6947350799363843,1674139885.0,2005-01-03,2005,0,3,1,1.55,120.83,120.53998999999999,118.44,1256
2005-01-04 14:30:00,120.46001000000001,120.53998999999999,118.44,118.73,106.61635157894736,121.8760555737705,113.38010070000037,114.8803999,118.08599959999998,120.15599900000002,118.19545659134708,119.98172664901476,120.43461384615414,121.92834466955972,118.94088302274857,113.38010070000037,114.8803999,118.08599959999998,120.15599900000002,119.23666333333334,69258880,42229017.6,43.587283506555956,1.5,2.75,1.1291498371307718,1.6400779354147232,-0.26454531908637224,0.61616097528929,0.8807062943756623,10.477883999214935,-1.3788520641249244,1604881005.0,2005-01-04,2005,1,4,1,1.77,119.49,119.25,118.0,1257
2005-01-05 14:30:00,118.74001000000001,119.25,118.0,118.00998999999999,106.56056263157896,121.99212114754098,113.42190070000036,114.9885998,118.24899939999996,120.15149800000002,118.18818339168641,119.79394220625144,120.21922846153878,122.171450711,118.26700621207752,113.42190070000036,114.9885998,118.24899939999996,120.15149800000002,118.41999666666668,65871680,42917316.8,39.37358522604765,1.5,2.75,1.137781991621431,1.5348508460342518,-0.3922871021246512,0.3903474167198482,0.7826345188444994,9.416404857402993,-2.2124628946356406,1539009325.0,2005-01-05,2005,2,5,1,1.06,118.62,119.14998999999999,118.25998999999999,1258
2005-01-06 14:30:00,118.44,119.14998999999999,118.25998999999999,118.61,106.5047736842105,122.1081867213115,113.46765065000037,115.09169979999999,118.39039959999997,120.14249850000002,118.20472521946341,119.68118580565607,120.15538230769259,122.25415374320228,118.0566108721829,113.46765065000037,115.09169979999999,118.39039959999997,120.14249850000002,118.67332666666668,48281808,43136352.0,44.21349667869092,1.5,2.75,1.1379404207913288,1.119283522167104,-0.4206327318956793,0.25684360397490025,0.6774763358705795,9.978478397906152,-1.7885236399768127,1587291133.0,2005-01-06,2005,3,6,1,0.75,118.7,119.23,118.13,1259
2005-01-07 14:30:00,118.97,119.23,118.13,118.44,106.44898473684209,122.22425229508195,113.51210065000036,115.1869998,118.50159959999996,120.10399800000002,118.21395168144522,119.56297763368885,120.07615153846184,122.34343828437693,117.80886479254671,113.51210065000036,115.1869998,118.50159959999996,120.10399800000002,118.6,55853600,42881376.8,43.162131640648816,1.5,2.75,1.1352303907348058,1.3025141487527985,-0.4333743859057447,0.1357583534883986,0.5691327393941433,9.858567911579057,-1.7258546299369386,1531437533.0,2005-01-07,2005,4,7,1,0.93,118.68,119.46001000000001,118.34,1260
2005-01-10 14:30:00,118.34,119.46001000000001,118.34,119.0,106.39319578947368,122.34031786885248,113.55210065000037,115.27669979999999,118.61719959999996,120.08749800000002,118.24477710570228,119.50936071619465,119.96922846153872,122.29750898003886,117.64094794303864,113.55210065000037,115.27669979999999,118.61719959999996,120.08749800000002,118.93333666666666,56796496,43328561.6,47.58381712565639,1.5,2.75,1.1341432199680337,1.3108327140959142,-0.3880931891752833,0.08401625292503923,0.4721094421003225,10.569678109881703,-1.7989686251005659,1588234029.0,2005-01-10,2005,0,10,1,0.95,118.9,118.74001000000001,117.99001000000001,1261
2005-01-11 14:30:00,118.64,118.74001000000001,117.99001000000001,118.17998999999999,106.33740684210528,122.45638344262295,113.58785060000037,115.3613996,118.71679939999994,119.97799750000004,118.24223643489043,119.38275398131898,119.77692076923105,122.24725653828592,117.3065850001762,113.58785060000037,115.3613996,118.71679939999994,119.97799750000004,118.30333666666668,63353392,44560786.4,42.384216040437614,1.5,2.75,1.12527513282746,1.4217296667816437,-0.3960025802100207,-0.022893783162203363,0.37310879704781735,10.061134996243137,-2.6203114700065884,1524880637.0,2005-01-11,2005,1,11,1,0.64,118.37,118.84,117.52,1262
2005-01-12 14:30:00,118.39998999999999,118.84,117.52,118.57001000000001,106.28161789473684,122.57244901639343,113.61775065000036,115.44229969999999,118.81799979999997,119.86699850000002,118.25509030018884,119.30534979262194,119.60769076923106,122.08412984283831,117.13125169562376,113.61775065000036,115.44229969999999,118.81799979999997,119.86699850000002,118.31000333333334,74303376,46189150.4,45.43810076640219,1.5,2.75,1.1391840519112133,1.608675963002775,-0.3587123201026977,-0.07528160308055476,0.2834307170221429,10.371976085085436,-2.1134235944852637,1599184013.0,2005-01-12,2005,2,12,1,1.12,118.18,118.73,117.5,1263
2005-01-13 14:30:00,118.64,118.73,117.5,117.62,106.22582894736843,122.68851459016392,113.64100065000036,115.5164997,118.89939979999996,119.7039985,118.23018479822063,119.1448402885627,119.38461384615412,122.01011731211595,116.75911038019228,113.64100065000036,115.5164997,118.89939979999996,119.7039985,117.95,55780000,46640185.6,39.89160532829187,1.5,2.75,1.1456709053461271,1.1959643659737065,-0.3797466174843868,-0.19125255483334055,0.18849406265104626,10.865922096959267,-2.6888392487796806,1543404013.0,2005-01-13,2005,3,13,1,1.05,118.12,118.53,117.75998999999999,1264
2005-01-14 14:30:00,117.97,118.53,117.75998999999999,118.24001000000001,106.17003999999999,122.80458016393445,113.66670065000037,115.5953997,118.96459999999998,119.575499,118.2305701002512,119.05866597536622,119.1584615384618,121.62827820129884,116.68864487562479,113.66670065000037,115.5953997,118.96459999999998,119.575499,118.17666666666666,42033600,46159356.0,44.641036926956,1.5,2.75,1.1288372692499749,0.9106192902691276,-0.3351744370363581,-0.2304739836444014,0.1047004533919567,11.847693939158905,-1.7123773898586858,1585437613.0,2005-01-14,2005,4,14,1,0.65,118.14,119.62,117.95,1265
2005-01-18 14:30:00,118.05,119.62,117.95,119.47,106.11425105263157,122.92064573770493,113.69515065000036,115.6790996,119.02299999999997,119.576999,118.279175194359,119.097840644379,119.01307692307721,121.14708646262473,116.8790673835297,113.69515065000036,115.6790996,119.02299999999997,119.576999,119.01333333333332,57437008,45472056.0,52.63640933168749,1.5,2.75,1.167491750017834,1.2631275788365497,-0.2121265057281452,-0.1604576787682248,0.0516688269599204,13.682742279003394,0.6232628653246819,1642874621.0,2005-01-18,2005,1,18,1,1.42,118.78,119.52,118.21001000000001,1266
2005-01-19 14:30:00,119.42998999999999,119.52,118.21001000000001,118.22,106.05846210526316,123.03671131147541,113.71305065000038,115.75029949999998,119.04179999999998,119.514499,118.2768545985018,119.01423677348578,118.78923076923107,120.5691793171465,117.00928222131563,113.71305065000038,115.75029949999998,119.04179999999998,119.514499,118.65000333333334,54907808,45857376.8,45.45191720973864,1.5,2.75,1.1776701964451315,1.1973604211918203,-0.2041255588707898,-0.2034881216285669,0.0006374372422229407,12.871738102293866,0.17795951003808824,1587966813.0,2005-01-19,2005,2,19,1,1.11,118.87,118.2,117.28998999999999,1267
2005-01-20 14:30:00,117.89,118.2,117.28998999999999,117.5,106.00267315789472,123.15277688524591,113.72420065000038,115.81079949999996,119.0496,119.36999899999999,118.24638971228605,118.87002374743948,118.5300000000003,119.97175239529646,117.08824760470414,113.72420065000038,115.81079949999996,119.0496,119.36999899999999,117.66333000000002,72090000,47801996.8,41.90400762119264,1.5,2.75,1.1599801824133362,1.5080959965254004,-0.2343646506295761,-0.2923183760447472,-0.05795372541517109,12.875951288731454,-0.9358401483854644,1515876813.0,2005-01-20,2005,3,20,1,0.78,117.74,118.0,116.64998999999999,1268
2005-01-21 14:30:00,117.78998999999999,118.0,116.64998999999999,116.78,105.94688421052632,123.2688424590164,113.73360070000037,115.87329949999996,119.0476,119.1749995,118.18888423337286,118.67097386673096,118.25923076923107,119.58728367688921,116.93117786157299,113.73360070000037,115.87329949999996,119.0476,119.1749995,117.14333,63274704,49390336.8,38.65458613149464,1.5,2.75,1.1735537408123835,1.2811150540686331,-0.28645251015670103,-0.41601936311104737,-0.12956685295434633,12.729955605136087,-1.4015535292131007,1452602109.0,2005-01-21,2005,4,21,1,1.16,117.32,117.34,116.37,1269
2005-01-24 14:30:00,117.09,117.34,116.37,116.55,116.37,123.38490803278688,113.74320070000036,115.92769949999996,119.03919999999998,118.96399950000004,118.12461426343668,118.46897635561373,118.09153846153878,119.66696334987866,116.51611357319887,113.74320070000036,115.92769949999996,119.03919999999998,118.96399950000004,116.75333333333332,58554800,51035692.0,37.65020655195103,1.5,2.75,1.159014187897213,1.147330382039299,-0.31758068388783833,-0.5265427078141443,-0.20896202392630592,12.731820949249046,-2.0588235294117667,1394047309.0,2005-01-24,2005,0,24,1,0.83,116.86,117.47,116.72,1270
2005-01-25 14:30:00,116.91,117.47,116.72,116.88,116.4832256451613,123.50097360655737,113.75575070000038,115.98329939999996,119.0196,118.78199950000004,118.07580586094895,118.3176452741267,118.00461615384644,119.7079464289591,116.3012858787338,113.75575070000038,115.98329939999996,119.0196,118.78199950000004,117.02333333333333,68335312,52953242.4,40.05682571799474,1.5,2.75,1.141941745904555,1.2904839987664287,-0.2974782199583487,-0.5808097988742418,-0.2833315789158931,12.431679508558096,-1.100008554747727,1462382621.0,2005-01-25,2005,1,25,1,0.64,117.1,117.60001000000001,117.03998999999999,1271
2005-01-26 14:30:00,117.32001000000001,117.60001000000001,117.03998999999999,117.23,116.59645129032259,123.61703918032785,113.76780065000037,116.02979939999996,118.98840019999996,118.58450000000002,118.04263700365685,118.21406000992417,117.89846230769258,119.60963679070663,116.18728782467858,113.76780065000037,116.02979939999996,118.98840019999996,118.58450000000002,117.29,57442896,54653922.4,42.58795404150025,1.5,2.75,1.1118037640542302,1.0510297061496907,-0.244364822909198,-0.5887876075523906,-0.3444227846431926,12.238245591589806,-1.1301424365233608,1519825517.0,2005-01-26,2005,2,26,1,0.48,117.32,117.75,116.98,1272
2005-01-27 14:30:00,117.19,117.75,116.98,117.42998999999999,116.70967693548387,123.73310475409836,113.78890055000038,116.08289929999997,118.96239999999996,118.38799950000002,118.01861163096443,118.1393866756457,117.82076923076951,119.51819862733257,116.12333983420649,113.78890055000038,116.08289929999997,118.96239999999996,118.38799950000002,117.38666333333332,56600496,56295437.6,44.04194581814621,1.5,2.75,1.0873892094789277,1.0054188831813966,-0.18236143543569505,-0.5723745789378114,-0.3900131435021164,12.076569769362848,-0.16154565550076594,1576426013.0,2005-01-27,2005,3,27,1,0.66,117.36,117.55,116.61,1273
2005-01-28 14:30:00,117.49001000000001,117.55,116.61,117.42998999999999,116.82290258064516,123.84917032786885,113.80910050000038,116.12859919999997,118.95339979999996,118.20299900000002,117.99552842975014,118.07182508748896,117.69999923076954,119.2627019585797,116.1372965029594,113.80910050000038,116.12859919999997,118.95339979999996,118.20299900000002,117.19666333333332,60814096,58282157.6,44.04194581814621,1.5,2.75,1.076861408801861,1.0434427705538478,-0.13038355020664782,-0.5529925812604262,-0.4226090310537784,11.20421540047557,-0.685064218110261,1576426013.0,2005-01-28,2005,4,28,1,0.81,117.08,118.25,117.71001000000001,1274
2005-01-31 14:30:00,117.97,118.25,117.71001000000001,118.16,116.93612822580644,123.96523590163936,113.8351004500004,116.18439919999996,118.94499979999996,118.06749900000004,118.00197829525013,118.0802226982043,117.69846153846184,119.25931024557114,116.13761283135254,113.8351004500004,116.18439919999996,118.94499979999996,118.06749900000004,118.04000333333332,54141296,59556442.4,49.460458788442104,1.5,2.75,1.058514879601728,0.9090753882908224,-0.040529518942937666,-0.4732709297324504,-0.4327414107895128,11.381681246998337,-1.0965095839959842,1630567309.0,2005-01-31,2005,0,31,1,0.46,117.98,119.08,118.10001000000001,1275
2005-02-01 14:30:00,118.25,119.08,118.10001000000001,118.91,117.04935387096776,124.08130147540984,113.8605004500004,116.24869919999996,118.94839959999996,117.997999,118.03758698955404,118.15924910789913,117.72461461538494,119.35293561656368,116.0962936142062,113.8605004500004,116.24869919999996,118.94839959999996,117.997999,118.69667,52014000,59357262.4,54.351091495898984,1.5,2.75,1.0529059596301757,0.8762870438580065,0.06972234014850337,-0.3455884856038836,-0.4153108257523869,10.21155689741476,0.5836575875486362,1682581309.0,2005-02-01,2005,1,32,2,0.83,118.59,119.59,118.89998999999999,1276
2005-02-02 14:30:00,119.06,119.59,118.89998999999999,119.27,117.16257951612906,124.19736704918031,113.88770045000038,116.31079919999996,118.98539959999997,118.024999,118.08591691153231,118.2650349071468,117.851537692308,119.67320167058905,116.02987371402695,113.88770045000038,116.31079919999996,118.98539959999997,118.024999,119.25333,52606304,58524633.6,56.5257533597222,1.5,2.75,1.026984819656592,0.8988745552778651,0.16193177770915218,-0.21289610361594669,-0.3748278813250989,8.073645396101886,1.5063829787234009,1735187613.0,2005-02-02,2005,2,33,2,0.58,119.24,119.16,118.57001000000001,1277
2005-02-03 14:30:00,119.06,119.16,118.57001000000001,118.96001000000001,117.27580516129032,124.31343262295084,113.92290050000038,116.36609939999997,119.00499979999996,118.0725,118.12019507186442,118.33122301122806,117.90692230769262,119.8142294760232,115.99961513936205,113.92290050000038,116.36609939999997,119.00499979999996,118.0725,118.89667333333334,49143104,57688204.8,54.13429041494094,1.5,2.75,1.0036280468239782,0.8518743852469475,0.19487253205029087,-0.13123721626223528,-0.3261097483125261,7.163933192864008,1.8667665696180815,1686044509.0,2005-02-03,2005,3,34,2,0.5,118.87,120.42998999999999,118.98,1278
2005-02-04 14:30:00,119.0,120.42998999999999,118.98,120.23,117.38903080645159,124.42949819672131,113.9607005000004,116.43179939999996,119.04639979999996,118.15349999999998,118.20293252002656,118.51205891492063,117.96538384615415,120.0944475179132,115.83632017439513,113.9607005000004,116.43179939999996,119.04639979999996,118.15349999999998,119.87999666666668,50015008,57774864.8,61.34895069398472,1.5,2.75,1.036938900622266,0.8656880145568078,0.2893244937594721,0.035545868886813985,-0.2537786248726581,7.3019661967086105,3.1574431574431627,1736059517.0,2005-02-04,2005,4,35,2,1.22,119.7,120.52,119.96001000000001,1279
2005-02-07 14:30:00,120.25,120.52,119.96001000000001,120.07001000000001,117.50225645161294,124.5455637704918,113.98980055000038,116.50449949999997,119.07899999999998,118.23500049999998,118.27615124473141,118.66043520873772,118.10769230769262,120.51494507761684,115.7004395377684,113.98980055000038,116.50449949999997,119.07899999999998,118.23500049999998,120.18333999999999,46212800,57292824.8,60.06708782819354,1.5,2.75,1.00287112200639,0.8066071128683465,0.3254617487179807,0.1530485610248178,-0.17241318769316294,7.153485945827768,2.729303559206024,1689846717.0,2005-02-07,2005,0,38,2,0.47,120.24,120.64998999999999,120.07001000000001,1280
2005-02-08 14:30:00,120.17,120.64998999999999,120.07001000000001,120.21001000000001,117.6154820967742,124.6616293442623,114.01905060000037,116.57519959999998,119.11619999999998,118.29550099999996,118.35198884297724,118.8080137602865,118.31615461538492,120.93671409584655,115.69559513492328,114.01905060000037,116.57519959999998,119.11619999999998,118.29550099999996,120.31000333333333,39454800,56425740.0,60.83819894661623,1.5,2.75,0.9726646132916484,0.6992340729603191,0.3415569684190672,0.25453302283067103,-0.08702394558839614,7.229073790373706,2.542019960760891,1729301517.0,2005-02-08,2005,1,39,2,0.48,120.36,120.49001000000001,119.25,1281
2005-02-09 14:30:00,120.42,120.49001000000001,119.25,119.31,117.7287077419355,124.7776949180328,114.04460060000038,116.63679969999995,119.14619999999996,118.35200149999996,118.3895579079585,118.85582197359255,118.5107700000003,121.01948770449093,116.00205229550969,114.04460060000038,116.63679969999995,119.14619999999996,118.35200149999996,119.68333666666668,55382896,56027215.2,53.66400597673154,1.5,2.75,0.9917607123422448,0.9884998888897124,0.27709700471881205,0.2593473103101189,-0.017749694408693114,9.33413139362122,1.6009624117314485,1673918621.0,2005-02-09,2005,2,40,2,1.04,119.87,120.02,119.25998999999999,1282
2005-02-10 14:30:00,119.66,120.02,119.25998999999999,119.74001000000001,117.84193338709677,124.89376049180328,114.07180065000038,116.70949979999996,119.18320019999996,118.41050149999997,118.44251681352877,118.94003035705991,118.75615538461571,121.06586997548095,116.44644079375044,114.07180065000038,116.70949979999996,119.18320019999996,118.41050149999997,119.67333333333332,46020608,54613076.8,56.31463286412843,1.5,2.75,0.9752070900320842,0.8426664582281876,0.24977291959409104,0.29446645508392066,0.044693535489829635,9.392998635266416,1.9671465525969936,1719939229.0,2005-02-10,2005,3,41,2,0.64,119.64,121.03998999999999,119.46001000000001,1283
2005-02-11 14:30:00,119.7,121.03998999999999,119.46001000000001,120.77,117.95515903225807,125.00982606557379,114.11155060000038,116.78759969999996,119.2140002,118.56800149999997,118.53379066397864,119.11431318019707,119.05538615384646,121.32285802710226,116.78791428059066,114.11155060000038,116.78759969999996,119.2140002,118.56800149999997,120.42333333333332,53271104,54487632.0,61.931960580921434,1.5,2.75,1.0184051550297926,0.9776733185982462,0.2848772963418563,0.4007901559171501,0.11591285957529375,10.007361300204293,2.2088693297224102,1773210333.0,2005-02-11,2005,4,42,2,1.32,120.25,120.86,120.48,1284
2005-02-14 14:30:00,120.69,120.86,120.48,120.67998999999999,118.06838467741936,125.12589163934427,114.15580055000038,116.87889959999998,119.241,118.69000049999997,118.61795534382259,119.2634252582735,119.32077000000031,121.47636199028969,117.1651780097109,114.15580055000038,116.87889959999998,119.241,118.69000049999997,120.67333,32548896,54013396.8,61.19145727039064,1.5,2.75,0.9728047868133786,0.6026078330256023,0.28514531765575457,0.472344506644987,0.1871991889892324,9.939148784472367,1.4885123202422061,1740661437.0,2005-02-14,2005,0,45,2,0.32,120.67,121.42998999999999,120.67998999999999,1285
2005-02-15 14:30:00,120.8,121.42998999999999,120.67998999999999,121.13,118.18161032258064,125.24195721311476,114.2066505000004,116.98069959999997,119.27859999999998,118.7730005,118.71646689896679,119.44119428129508,119.60538615384644,121.66201193873992,117.54876036895298,114.2066505000004,116.98069959999997,119.27859999999998,118.7730005,121.07999333333332,44440096,53363551.2,63.538712230330006,1.5,2.75,0.9568901591838516,0.8327799593667221,0.29737744711281416,0.5589209978802501,0.2615435507674359,9.643458703994376,1.559486878510941,1785101533.0,2005-02-15,2005,1,46,2,0.62,121.05,121.46001000000001,120.67,1286
2005-02-16 14:30:00,120.92998999999999,121.46001000000001,120.67,121.21001000000001,118.29483596774195,125.35802278688524,114.25195060000038,117.07819959999998,119.3186,118.92250099999998,118.8142529029289,119.60965292117176,119.8961569230772,121.69272683440359,118.09958701175086,114.25195060000038,117.07819959999998,119.3186,118.92250099999998,121.11334,51789008,53207611.2,63.95613019076528,1.5,2.75,0.944970147813576,0.9733383407372364,0.2921769003641478,0.6267646762226207,0.3345877758584729,9.633616595880838,1.8913919055655763,1836890541.0,2005-02-16,2005,2,47,2,0.65,121.07,121.33,120.22,1287
2005-02-17 14:30:00,121.23,121.33,120.22,120.23,118.40806161290324,125.47408836065573,114.29280060000038,117.17299959999997,119.36119979999998,119.059001,118.86977239693171,119.66873359534588,120.055387692308,121.54973693030384,118.56103845431214,114.29280060000038,117.17299959999997,119.36119979999998,119.059001,120.59333333333336,58153808,52510801.6,55.56515262150842,1.5,2.75,0.9567579943983208,1.1074637260917382,0.2080085808936308,0.5945985019755113,0.38658992108188056,10.944194019241712,0.0,1778736733.0,2005-02-17,2005,3,48,2,0.92,120.78,120.48,119.89998999999999,1288
2005-02-18 14:30:00,120.17,120.48,119.89998999999999,120.39,118.52128725806452,125.59015393442623,114.33085060000036,117.26409959999997,119.39319999999998,119.23950099999998,118.9293891656795,119.73742563388436,120.16923384615414,121.51534722230377,118.82312047000453,114.33085060000036,117.26409959999997,119.39319999999998,119.23950099999998,120.25666333333336,49544192,51824276.0,56.567051417773285,1.5,2.75,0.9298474233698693,0.9560035532382546,0.15103571502633978,0.5753845648648053,0.4243488498384655,9.127560561881094,0.26650285112827443,1828280925.0,2005-02-18,2005,4,49,2,0.48,120.19,120.47,118.58,1289
2005-02-22 14:30:00,119.89998999999999,120.47,118.58,118.60001000000001,118.6345129032258,125.70621950819671,114.36480065000036,117.33169969999996,119.381,119.34200149999997,118.91647233565284,119.62910033541918,120.11769615384644,121.63765376463756,118.59773854305534,114.36480065000036,117.33169969999996,119.381,119.34200149999997,119.21667,80842192,52938645.6,44.48306625520323,1.5,2.75,0.9984297502720214,1.5270921853731747,-0.010693002827712628,0.4109825963038247,0.42167559913153735,12.613332928819053,-1.339322740260981,1747438733.0,2005-02-22,2005,1,53,2,1.59,119.52,119.57001000000001,118.62468999999999,1290
2005-02-23 14:30:00,118.92998999999999,119.57001000000001,118.62468999999999,119.45,118.74773854838709,125.8222850819672,114.41225060000038,117.40859979999996,119.38339999999998,119.47050149999995,118.93739498915664,119.61204316061735,120.15538769230801,121.57995171701529,118.7308236676007,114.41225060000038,117.40859979999996,119.38339999999998,119.47050149999995,119.2149,68308688,52937314.4,49.950622019493686,1.5,2.75,0.9963990538240198,1.2903693505086462,-0.06110084497325202,0.34529954291497233,0.4064003878882244,13.464220702545646,0.11734137959936347,1815747421.0,2005-02-23,2005,2,54,2,0.8,119.1,120.32001000000001,118.98,1291
2005-02-24 14:30:00,119.24001000000001,120.32001000000001,118.98,120.24001000000001,118.86096419354841,125.93835065573772,114.46930065000036,117.47449999999996,119.38080020000001,119.62100199999996,118.98847793075836,119.67184952627285,120.156157692308,121.58089301211099,118.731422372505,114.46930065000036,117.47449999999996,119.38080020000001,119.62100199999996,119.84667333333331,69306368,53530488.0,54.44158816704457,1.5,2.75,1.0209426928365892,1.2947083165018036,-0.04278097877881781,0.3529241644147021,0.3957051431935199,13.2589326456814,0.4175713698370328,1885053789.0,2005-02-24,2005,3,55,2,1.13,119.65,121.67,120.17998999999999,1292
2005-02-25 14:30:00,120.27,121.67,120.17998999999999,121.42998999999999,118.97418983870968,126.0544162295082,114.52770060000036,117.55039989999996,119.39360019999998,119.82100199999996,119.08422350210115,119.83929147615164,120.26077153846184,121.83655309908094,118.68498997784278,114.52770060000036,117.55039989999996,119.39360019999998,119.82100199999996,121.09332666666668,61173392,53759132.8,60.230337679921334,1.5,2.75,1.0544475004911185,1.1379162723398693,0.04327838336958279,0.4498031224054984,0.4065247390359156,14.19526126898119,0.5464850542353297,1946227181.0,2005-02-25,2005,4,56,2,1.24,120.92,121.3,120.03998999999999,1293
2005-02-28 14:30:00,121.14998999999999,121.3,120.03998999999999,120.63,119.08741548387094,126.17048180327869,114.57860060000036,117.61769999999996,119.38860019999998,119.98100249999996,119.14484218829328,119.9145970498515,120.29307846153877,121.88055045285856,118.705606470219,114.57860060000036,117.61769999999996,119.38860019999998,119.98100249999996,120.65666333333333,69426688,54189762.4,55.156436970929775,1.5,2.75,1.0784155361703245,1.281177198887294,0.04019029862238355,0.456762612313895,0.4165723136915115,14.063996733499579,-0.04142360303477668,1876800493.0,2005-02-28,2005,0,59,2,1.05,120.67,121.52,120.78,1294
2005-03-01 14:30:00,120.78,121.52,120.78,121.23,119.20064112903226,126.28654737704916,114.63480055000036,117.68379999999992,119.39700019999997,120.13450249999997,119.22661308286999,120.03987352129421,120.4407707692311,121.99175341332176,118.8897881251404,114.63480055000036,117.68379999999992,119.39700019999997,120.13450249999997,121.17666666666666,47569296,53861162.4,58.013302247478286,1.5,2.75,1.0649572835867296,0.8831836128363988,0.07064069308719845,0.5048731800505095,0.4342324869633111,14.34826519912317,0.08255593164369564,1924369789.0,2005-03-01,2005,1,60,3,0.61,121.15,121.92998999999999,120.64998999999999,1295
2005-03-02 14:30:00,120.75998999999999,121.92998999999999,120.64998999999999,121.17,119.31386677419356,126.40261295081969,114.69045060000036,117.76099999999992,119.43160019999998,120.24750249999997,119.30282433452216,120.14750461450429,120.55077000000034,122.09014450760587,119.0113954923948,114.69045060000036,117.76099999999992,119.43160019999998,120.24750249999997,121.24999333333334,64233296,54472127.2,57.61799708219589,1.5,2.75,1.080317477616249,1.1791956602715523,0.07823543403071592,0.532026779501706,0.4537913454709901,14.200577960300624,-0.033008824931204286,1860136493.0,2005-03-02,2005,2,61,3,1.06,121.29,121.89998999999999,120.7,1296
2005-03-03 14:30:00,121.66,121.89998999999999,120.7,121.22,119.42709241935484,126.51867852459014,114.75105055000036,117.84810009999993,119.46660019999996,120.34500249999996,119.37800769395264,120.24964703217053,120.58538538461573,122.16269274645691,119.00807802277454,114.75105055000036,117.84810009999993,119.46660019999996,120.34500249999996,121.27333,62098608,54946742.4,57.87559486475804,1.5,2.75,1.088865514929374,1.1301599564890674,0.07794819390506924,0.5512265878523266,0.4732783939472574,14.197292899026134,0.8234217749313772,1922235101.0,2005-03-03,2005,3,62,3,0.99,121.3,122.83,121.78998999999999,1297
2005-03-04 14:30:00,122.05,122.83,121.78998999999999,122.73,119.54031806451614,126.63474409836066,114.81645060000037,117.94570009999993,119.51340019999996,120.53350199999996,119.5094583726212,120.48587112434477,120.74307846153879,122.6926598446343,118.79349707844328,114.81645060000037,117.94570009999993,119.51340019999996,120.53350199999996,122.44999666666666,56172608,55298217.6,64.82819063785793,1.5,2.75,1.126089406720133,1.0158122709546429,0.16573186781924698,0.680443228721316,0.514711360902069,14.764430476845908,1.9436830301520087,1978407709.0,2005-03-04,2005,4,63,3,0.85,122.31,123.25,122.59,1298
2005-03-07 14:30:00,122.66,123.25,122.59,122.78998999999999,119.65354370967744,123.25,114.88405055000037,118.04829999999993,119.55560019999996,120.6615015,119.63810667173408,120.70531101726431,120.87077000000036,123.10208499639224,118.63945500360846,114.88405055000037,118.04829999999993,119.55560019999996,120.6615015,122.87666333333334,43808192,54987876.8,65.07481643078322,1.5,2.75,1.0927973062401233,0.7966881892773864,0.21120093203109055,0.7787125259409322,0.5675115939098416,14.787427338709033,3.5328664812085644,2022215901.0,2005-03-07,2005,0,66,3,0.54,122.92,123.0,122.11,1299
2005-03-08 14:30:00,122.67,123.0,122.11,122.33,119.76676935483871,123.28465139534883,114.94760055000036,118.15620009999992,119.58680019999996,120.774501,119.74367111597981,120.8600433013344,120.95692307692343,123.31676461810694,118.59708153573987,114.94760055000036,118.15620009999992,119.58680019999996,120.774501,122.48,44665808,54910527.2,61.51305139075768,1.5,2.75,1.0783117843658288,0.8134288683354691,0.19409917669411256,0.8101355647774824,0.6160363880833698,11.005767634796056,2.4110506488070285,1977550093.0,2005-03-08,2005,1,67,3,0.73,122.56,122.28998999999999,120.96001000000001,1300
2005-03-09 14:30:00,121.97,122.28998999999999,120.96001000000001,120.97,119.879995,123.31930279069769,115.00340055000036,118.25950009999993,119.59580019999996,120.81250049999998,119.79176244476491,120.87051536787395,121.01384615384649,123.33620570280421,118.69148660488878,115.00340055000036,118.25950009999993,119.59580019999996,120.81250049999998,121.4066666666667,73601376,56617856.0,52.383990649471066,1.5,2.75,1.0991459426254129,1.2999675579379055,0.08079681923777815,0.7170324121305924,0.6362355928928143,13.315242283550315,0.607110727951537,1903948717.0,2005-03-09,2005,2,68,3,1.1,121.62,121.5,120.39998999999999,1301
2005-03-10 14:30:00,121.2,121.5,120.39998999999999,121.24001000000001,119.9932206451613,123.35395418604652,115.05825060000038,118.3593002999999,119.59700059999996,120.909001,119.84855646653885,120.90570533283837,121.07923153846187,123.37536795383066,118.78309512309308,115.05825060000038,118.3593002999999,119.59700059999996,120.909001,121.04666666666668,65303392,57113880.8,53.848428493303906,1.5,2.75,1.0992076610093116,1.143389156633881,0.016976562794402184,0.657456296385817,0.6404797335914149,12.906647745777075,-0.15645228991619414,1969252109.0,2005-03-10,2005,3,69,3,0.91,120.95,121.72,120.16,1302
2005-03-11 14:30:00,121.31,121.72,120.16,120.39,120.1064462903226,123.38860558139535,115.10095055000038,118.44640039999986,119.57760059999998,120.9415005,119.86978954628242,120.8565905392347,121.21692307692341,123.07469859730236,119.35914755654444,115.10095055000038,118.44640039999986,119.57760059999998,120.9415005,120.75666666666666,58132704,57719485.6,48.763957625820034,1.5,2.75,1.1321213995086463,1.0071590797406549,-0.08399946091058907,0.5354804074531785,0.6194798683637676,12.208741961190693,-0.19895548371051555,1911119405.0,2005-03-11,2005,4,70,3,1.3,120.94,121.16,120.28,1303
2005-03-14 14:30:00,120.61,121.16,120.28,121.14,120.21967193548387,123.4232569767442,115.14545050000036,118.55040029999991,119.5778006,120.96000049999998,119.91960172093799,120.88358191645044,121.3469230769234,122.90414171414713,119.78970443969969,115.14545050000036,118.55040029999991,119.5778006,120.96000049999998,120.86,36338704,56872865.6,52.98242654212143,1.5,2.75,1.1141127281151717,0.6389462464504339,-0.10067031764308387,0.4936419713099127,0.5943122889529966,12.216176787648914,-0.07423904974016614,1947458109.0,2005-03-14,2005,0,73,3,0.73,120.72,121.46001000000001,120.08,1304
2005-03-15 14:30:00,121.42,121.46001000000001,120.08,120.14,120.33289758064517,123.45790837209304,115.18180050000038,118.64660029999986,119.5632006,120.93300099999996,119.92824479070515,120.8127645910742,121.33923000000034,122.91907025409498,119.75938974590572,115.18180050000038,118.64660029999986,119.5632006,120.93300099999996,120.56000333333333,62465808,58368711.2,47.380904557088,1.5,2.75,1.1331053903926591,1.0701933744255774,-0.17507787878601389,0.3754649404704793,0.5505428192564932,12.767194124507494,-0.8500453907732947,1884992301.0,2005-03-15,2005,1,74,3,1.15,120.77,119.88,118.89998999999999,1305
2005-03-16 14:30:00,119.7,119.88,118.89998999999999,119.12,120.44612322580645,123.49255976744186,115.21310050000037,118.72540019999991,119.5396006,120.83250099999997,119.89654891655985,120.6515489157338,121.1615384615388,123.13192992837853,119.19114699469911,115.21310050000037,118.72540019999991,119.5396006,120.83250099999997,119.29999666666666,76723872,59982900.0,42.45091386528871,1.5,2.75,1.1407414339360404,1.2790957422865517,-0.28265043577575943,0.1972297745367939,0.4798802103125534,13.483219511543634,-1.7323873948193318,1808268429.0,2005-03-16,2005,2,75,3,0.82,119.39,119.74001000000001,118.98,1306
2005-03-17 14:30:00,119.31,119.74001000000001,118.98,119.36,120.55934887096777,123.52721116279068,115.24635045000038,118.8191000999999,119.5522006,120.74000049999998,119.87550778257709,120.52854425709248,121.0638461538465,123.244662986877,118.88302932081601,115.24635045000038,118.8191000999999,119.5522006,120.74000049999998,119.36000333333334,62726400,60529769.6,43.92925556447445,1.5,2.75,1.113546331512037,1.036290083615319,-0.3243165645292341,0.07448450465101075,0.3988010691802448,13.605642327482025,-2.7458649067057803,1870994829.0,2005-03-17,2005,3,76,3,0.64,119.36,119.53,118.14998999999999,1307
2005-03-18 14:30:00,119.11,119.53,118.14998999999999,118.53998999999999,120.67257451612906,123.56186255813955,115.27340040000037,118.90589999999986,119.5628006,120.6555,119.82313453620155,120.33915813736941,120.85692230769266,123.41351211937315,118.30033249601216,115.27340040000037,118.90589999999986,119.5628006,120.6555,118.73999333333336,61884192,60716288.8,40.13559323245472,1.5,2.75,1.1325794506897486,1.0192354180909688,-0.38939779233495003,-0.08794617123844263,0.30145162109650736,10.545432472047992,-3.46119419017788,1809110637.0,2005-03-18,2005,4,77,3,1.17,118.84,118.78,117.75998999999999,1308
2005-03-21 14:30:00,118.71001000000001,118.78,117.75998999999999,118.10001000000001,120.78580016129033,123.59651395348835,115.30345045000037,118.97150019999991,119.55260080000002,120.5410005,119.75556102497795,120.1259059338104,120.62076923076955,123.55701762248846,117.68452083905063,115.30345045000037,118.97150019999991,119.55260080000002,120.5410005,118.21333333333332,61430608,61310609.6,38.22800375202539,1.5,2.75,1.1245387756404808,1.0019572207939684,-0.44060334198110496,-0.24930255637987386,0.1913007856012311,10.239700204129836,-3.457851712580725,1747680029.0,2005-03-21,2005,0,80,3,0.87,118.27,118.92998999999999,116.89998999999999,1309
2005-03-22 14:30:00,118.37,118.92998999999999,116.89998999999999,116.89998999999999,120.89902580645163,123.6311653488372,115.32305040000037,119.01170009999993,119.52180060000002,120.4559995,119.64357784752785,119.81867584487608,120.28846076923107,123.79974355917072,116.77717797929144,115.32305040000037,119.01170009999993,119.52180060000002,120.4559995,117.57665666666666,93324624,61934731.2,33.54501178058429,1.5,2.75,1.1892145773804466,1.5068221366560155,-0.5279273589145098,-0.4686084130419062,0.05931894587260364,10.857892685907569,-3.3644787963957983,1654355405.0,2005-03-22,2005,1,81,3,1.74,117.91,117.72,116.75,1310
2005-03-23 14:30:00,116.94501000000001,117.72,116.75,117.0,121.01225145161293,123.66581674418605,115.33455040000037,119.04950009999992,119.48180060000004,120.3334995,119.53990812801695,119.55023052631643,119.84769153846186,123.45950335413902,116.23587972278472,115.33455040000037,119.04950009999992,119.48180060000004,120.3334995,117.15666666666668,71946000,62116596.8,34.267715263188016,1.5,2.75,1.1735563932818434,1.1582411739594851,-0.5491439314162669,-0.6271109683977301,-0.07796703698146312,10.351001580419947,-3.4972036046516317,1726301405.0,2005-03-23,2005,2,82,3,0.83,117.24,117.99001000000001,117.06,1311
2005-03-24 14:30:00,117.46001000000001,117.99001000000001,117.06,117.14,121.12547709677419,123.70046813953488,115.34595040000036,119.0889000999999,119.46100080000004,120.178499,119.44579408378098,119.32068476190537,119.41307692307724,122.86007137414276,115.96608247201172,115.34595040000036,119.0889000999999,119.46100080000004,120.178499,117.39667,52019200,61252238.4,35.327989518035466,1.5,2.75,1.1604459366188544,0.8492620246838196,-0.5240097521968432,-0.7329792272275171,-0.20896947503067392,10.163358895304905,-2.6995597641000084,1778320605.0,2005-03-24,2005,3,83,3,0.79,117.53,117.94,117.31,1312
2005-03-28 14:30:00,117.42,117.94,117.31,117.31,121.2387027419355,123.73511953488372,115.36355045000036,119.12690019999991,119.43580060000004,119.97249949999998,119.3620374530445,119.12919097505724,119.02692307692341,122.19366150693784,115.86018464690895,115.36355045000036,119.12690019999991,119.43580060000004,119.97249949999998,117.52,46941504,60540644.0,36.6639572917202,1.5,2.75,1.134699798288936,0.7753717320879507,-0.4680325408327662,-0.7940101510716318,-0.3259776102388655,10.231157480207964,-3.1616311705464737,1825262109.0,2005-03-28,2005,0,87,3,0.54,117.62,117.89998999999999,116.25,1313
2005-03-29 14:30:00,117.14,117.89998999999999,116.25,116.53,121.3519283870968,123.76977093023257,115.37445040000036,119.1567001999999,119.41400060000004,119.7674995,119.25097716076824,118.88164897743276,118.68538461538492,121.89759215141918,115.47317707935068,115.37445040000036,119.1567001999999,119.41400060000004,119.7674995,116.89333,73040192,60721319.2,33.268181224177674,1.5,2.75,1.171506241268298,1.2028755791590244,-0.4552179721598805,-0.8950000754387162,-0.4397821032788357,8.741606503957472,-3.0048277010154814,1752221917.0,2005-03-29,2005,1,88,3,1.42,117.07,118.2,116.77,1314
2005-03-30 14:30:00,116.78,118.2,116.77,118.17998999999999,121.46515403225807,123.8044223255814,115.39925035000036,119.18870009999992,119.41280020000002,119.61499899999998,119.20897766426752,118.81482431291536,118.4499984615388,121.30783129297136,115.59216563010622,115.39925035000036,119.18870009999992,119.41280020000002,119.61499899999998,117.71666333333332,62896704,61487689.6,44.89502655341708,1.5,2.75,1.2071129383205623,1.0229153902051964,-0.31401485385142225,-0.8323006705931135,-0.5182858167416913,12.983029341091692,-0.7891286098052391,1815118621.0,2005-03-30,2005,2,89,3,1.22,117.48,118.46001000000001,117.87,1315
2005-03-31 14:30:00,118.19,118.46001000000001,117.87,117.96001000000001,121.57837967741936,123.83907372093023,115.41895040000037,119.20280019999993,119.38260040000002,119.45449949999997,119.15999854017859,118.73341342597101,118.2630761538465,120.8980883993353,115.62806390835766,115.41895040000037,119.20280019999993,119.38260040000002,119.45449949999997,118.09667333333334,65048800,61528464.8,43.7993480318586,1.5,2.75,1.1630341570119502,1.0572147413630903,-0.21836379415824791,-0.7912405594395011,-0.5728767652812532,12.234033074348025,-1.1729138739946399,1750069821.0,2005-03-31,2005,3,90,3,0.5,118.17,118.99001000000001,116.91,1316
2005-04-01 14:30:00,118.63,118.99001000000001,116.91,117.42998999999999,121.69160532258066,123.87372511627909,115.43610035000036,119.20430009999993,119.36680020000001,119.264999,119.09215506801472,118.60927786159284,117.97769076923107,120.04756628220957,115.90781525625259,115.43610035000036,119.20430009999993,119.36680020000001,119.264999,117.77666666666669,97394816,63293275.2,41.190912700818075,1.5,2.75,1.2285324315110968,1.5387861615984124,-0.17556640215281993,-0.7923347679722781,-0.6167683658194582,12.222542293299036,-0.93639285780267,1652675005.0,2005-04-01,2005,4,91,4,1.78,117.95,117.86,116.74001000000001,1317
2005-04-04 13:30:00,117.36,117.86,116.74001000000001,117.63,121.80483096774195,123.9083765116279,115.45510035000036,119.20950009999993,119.36940020000002,119.009999,119.03481565358278,118.51601330334587,117.78461384615416,119.43804242032364,116.1311852719847,115.45510035000036,119.20950009999993,119.36940020000002,119.009999,117.41000333333334,71609504,64065120.0,42.580594142851616,1.5,2.75,1.2207794006888757,1.1177611780013836,-0.12115121465586375,-0.7682073841392878,-0.6470561694834239,11.858902686721954,-0.3979762575803356,1724284509.0,2005-04-04,2005,0,94,4,0.96,117.3,118.38,117.67,1318
2005-04-05 13:30:00,117.78,118.38,117.67,118.19,121.91805661290323,123.94302790697674,115.47790035000034,119.22260009999992,119.39760020000001,118.7799995,119.00168562795209,118.48496441731295,117.7130753846157,119.20143903399854,116.22471173523287,115.47790035000034,119.22260009999992,119.39760020000001,118.7799995,118.08,50079904,64378705.6,46.39967819193895,1.5,2.75,1.1871523006396705,0.7778954785322679,-0.03905690314205379,-0.6958772984109913,-0.6568203952689375,12.081643090172609,1.1035159198901516,1774364413.0,2005-04-05,2005,1,95,4,0.6,118.02,118.95,118.17998999999999,1319
2005-04-06 13:30:00,118.45,118.95,118.17998999999999,118.60001000000001,122.03128225806452,123.97767930232557,115.50490040000034,119.23890019999992,119.4386004,118.5935,118.98593364254221,118.4959211394736,117.65461461538494,118.92309018379204,116.38613904697785,115.50490040000034,119.23890019999992,119.4386004,118.5935,118.57666666666668,53311696,64811000.0,49.070594232904064,1.5,2.75,1.157356422022551,0.8225717239357516,0.046599634794438516,-0.5985708517758894,-0.6451704865703279,10.231549832508392,1.3675299145299125,1827676109.0,2005-04-06,2005,2,96,4,0.65,118.56,119.25998999999999,118.32001000000001,1320
2005-04-07 13:30:00,118.41,119.25998999999999,118.32001000000001,119.24001000000001,122.1445079032258,124.01233069767441,115.5322504500003,119.25270029999993,119.4858006,118.50700049999999,118.99589742126602,118.56678674523806,117.70846230769264,119.1677817341231,116.2491428812622,115.5322504500003,119.25270029999993,119.4858006,118.50700049999999,118.94000333333334,47225504,63492206.4,53.006969549333604,1.5,2.75,1.1418295347352263,0.7438000138549289,0.14456986448912426,-0.4644581559589227,-0.6090280204480469,10.462820797127703,1.792735188663136,1874901613.0,2005-04-07,2005,3,97,4,0.79,118.79,119.21001000000001,118.0,1321
2005-04-08 13:30:00,119.17,119.21001000000001,118.0,118.0,122.25773354838712,124.04698209302326,115.5485004500003,119.24480039999992,119.5012006,118.345,118.95684262043207,118.51280705521536,117.70076923076955,119.15278725441028,116.24875120712885,115.5485004500003,119.24480039999992,119.5012006,118.345,118.40333666666668,64288800,63441476.8,45.645627914157885,1.5,2.75,1.1488424251112814,1.0133559816501625,0.12481496617477585,-0.4530093127295771,-0.5778242789043531,12.649513575319213,0.5881851504560547,1810612813.0,2005-04-08,2005,4,98,4,1.03,118.61,118.42,117.83,1322
2005-04-11 13:30:00,118.28998999999999,118.42,117.83,118.09,122.37095919354842,124.08163348837208,115.56700045000035,119.23840039999992,119.51440080000002,118.23000000000002,118.9228487921798,118.47253971662342,117.79230846153877,119.17944482813265,116.40517209494487,115.56700045000035,119.23840039999992,119.51440080000002,118.23000000000002,118.11333333333336,45858000,62827741.6,46.2293036820775,1.5,2.75,1.1089251090319043,0.7299004998772708,0.11690147525091088,-0.4316974348407143,-0.5485989100916252,12.641389674361227,1.338711061529222,1856470813.0,2005-04-11,2005,0,101,4,0.5,118.12,119.06,117.07001000000001,1323
2005-04-12 13:30:00,117.89,119.06,117.07001000000001,118.7,122.4841848387097,124.11628488372091,115.59130045000036,119.24660039999996,119.53980100000004,118.10800000000002,118.91410962385905,118.4942026007545,117.92307769230801,119.30731002739913,116.53884535721687,115.59130045000036,119.24660039999996,119.53980100000004,118.10800000000002,118.27667,86547680,65338190.4,50.13755730772069,1.5,2.75,1.1718583155296258,1.324610912395272,0.14974353042021982,-0.3614194970663505,-0.5111630274865703,11.934275894589836,0.4400152682361872,1943018493.0,2005-04-12,2005,1,102,4,1.7,118.07,118.8,117.13,1324
2005-04-13 13:30:00,118.56,118.8,117.13,117.3,122.59741048387095,124.15093627906977,115.6105504500003,119.23380039999996,119.52260100000004,117.96600000000004,118.85081120723713,118.38046901973028,117.93538538461569,119.29415951194716,116.5766112572842,115.6105504500003,119.23380039999996,119.52260100000004,117.96600000000004,117.74333333333334,66058192,65517809.6,42.50217006975667,1.5,2.75,1.207439864420367,1.0082478703622595,0.0777939374443542,-0.4139206056811275,-0.4917145431254818,11.490801536647705,-0.5595201288979204,1876960301.0,2005-04-13,2005,2,103,4,1.43,117.96,117.5,115.77,1325
2005-04-14 13:30:00,117.44,117.5,115.77,115.77,122.71063612903228,124.1855876744186,115.61980045000037,119.20410029999996,119.45980100000004,117.79850000000003,118.72999508146313,118.13185292261312,117.81692384615415,119.58116038924985,116.05268730305849,115.61980045000037,119.20410029999996,119.45980100000004,117.79850000000003,116.34666666666664,99638816,66663556.8,36.042240852630684,1.5,2.75,1.2447655883903412,1.494651962524748,-0.06453891829827453,-0.5723881909983248,-0.5078492727000503,13.524418604492476,-1.4135997116239283,1777321485.0,2005-04-14,2005,3,104,4,1.49,116.64,116.2,114.10001000000001,1326
2005-04-15 13:30:00,115.74001000000001,116.2,114.10001000000001,114.14998999999999,122.82386177419356,124.22023906976743,115.61790040000037,119.17140019999997,119.35740080000004,117.53799950000004,118.5503870390528,117.75262788236424,117.63384615384645,120.20410375798252,115.0635885497104,115.61790040000037,119.17140019999997,119.35740080000004,117.53799950000004,114.81666666666666,134028816,70228677.6,30.718388201244426,1.5,2.75,1.30585304636246,1.9084627616567853,-0.24912244677136,-0.8192523311642503,-0.5701298843928904,15.215746760417224,-2.9584374734336425,1643292669.0,2005-04-15,2005,4,105,4,1.84,115.15,114.96001000000001,113.96001000000001,1327
2005-04-18 13:30:00,114.12,114.96001000000001,113.96001000000001,114.5,122.93708741935484,124.25489046511628,115.62570040000037,119.13660019999996,119.26820060000004,117.336,118.39154833163894,117.44285379832957,117.35077000000031,120.38651751624008,114.31502248376052,115.62570040000037,119.13660019999996,119.26820060000004,117.336,114.47334000000002,100314816,72150208.8,33.020383024941985,1.5,2.75,1.2840064001937128,1.3903607164612946,-0.3242218302853933,-0.975407172249632,-0.6511853419642387,15.382703356228554,-3.122091547508248,1743607485.0,2005-04-18,2005,0,108,4,0.88,114.46,115.71001000000001,114.83,1328
2005-04-19 13:30:00,115.10001000000001,115.71001000000001,114.83,115.41,123.05031306451616,124.28954186046512,115.63835040000036,119.10910019999996,119.17180060000004,117.20149950000001,118.27462486765312,117.24924867467915,117.15461538461571,120.33370322075592,113.97552754847547,115.63835040000036,119.10910019999996,119.17180060000004,117.20149950000001,115.31667,68397120,72498534.4,38.72126169223885,1.5,2.75,1.2787209430370188,0.9434276232762024,-0.2902856183240128,-1.0140423648692547,-0.7237567465452419,16.035461245838672,-2.6897215270049317,1812004605.0,2005-04-19,2005,1,109,4,0.77,115.27,115.63,113.55,1329
2005-04-20 13:30:00,115.39998999999999,115.63,113.55,113.8,113.55,124.32419325581397,115.64790040000037,119.06270019999994,119.04640040000004,117.0465,118.09914938264713,116.92074880090016,116.87538538461568,120.51324017807282,113.23753059115856,115.64790040000037,119.06270019999994,119.04640040000004,117.0465,114.32666666666668,114822128,73573409.6,33.31809391439923,1.5,2.75,1.3359551613915173,1.5606470955234897,-0.34994589297469325,-1.1611891127636085,-0.8112432197889152,16.827784356164464,-4.562235444294244,1697182477.0,2005-04-20,2005,2,110,4,1.83,114.59,116.21001000000001,114.38,1330
2005-04-21 13:30:00,114.78998999999999,116.21001000000001,114.38,116.00998999999999,113.50299999999999,124.35884465116278,115.66685035000036,119.03929999999997,118.96240000000004,116.99699950000002,118.01722156371979,116.8340098674811,116.75076923076952,120.38767602756771,113.11386243397136,115.66685035000036,119.03929999999997,118.96240000000004,116.99699950000002,115.53333333333336,87459504,74349084.8,44.720841104706615,1.5,2.75,1.412673364149266,1.176335986317346,-0.22056270690372204,-1.0869466034185675,-0.8663838965148457,21.033384300937854,-1.6864491525423713,1784641981.0,2005-04-21,2005,3,111,4,1.6,115.3,116.5,114.27,1331
2005-04-22 13:30:00,115.74001000000001,116.5,114.27,115.57001000000001,113.456,124.39349604651164,115.68760040000036,119.01690009999994,118.88760020000004,116.91850000000002,117.9212524827896,116.713628927721,116.54923153846184,120.13479345444885,112.96366962247481,115.68760040000036,119.01690009999994,118.88760020000004,116.91850000000002,115.44667,89839504,76240100.0,43.139224787202224,1.5,2.75,1.4710538381386045,1.1783759989821632,-0.1480854100048885,-1.0514906590209565,-0.9034052490160678,20.481925110119327,-2.1339571513252658,1694802477.0,2005-04-22,2005,4,112,4,1.95,115.38,116.5,115.72,1332
2005-04-25 13:30:00,115.86,116.5,115.72,116.33,113.409,124.42814744186045,115.71060040000036,119.00130009999997,118.81940000000004,116.86950000000002,117.858850424641,116.6770928393666,116.37461538461564,119.75914198836064,112.99008878087069,115.71060040000036,119.00130009999997,118.81940000000004,116.86950000000002,116.18333333333334,52363504,76511200.0,46.64910662434743,1.5,2.75,1.4324064211287044,0.6843900500841706,-0.03815820300009687,-0.9511030027661888,-0.912944799766092,21.036909587034767,-1.9966301600674008,1747165981.0,2005-04-25,2005,0,115,4,0.67,116.11,116.77,115.14998999999999,1333
2005-04-26 13:30:00,115.96001000000001,116.77,115.14998999999999,115.2,113.36200000000001,124.4627988372093,115.72770040000036,118.96100009999996,118.708,116.803,117.75458178053742,116.5364173308555,116.06384538461565,119.05832939921059,113.06936137002073,115.72770040000036,118.96100009999996,118.708,116.803,115.70666333333334,75363808,76627380.8,42.45302779415773,1.5,2.75,1.4458066767623678,0.9835101658596688,-0.031048459878981968,-0.9517553746148196,-0.9207069147358375,21.05170698224028,-1.7902813299232692,1671802173.0,2005-04-26,2005,1,116,4,1.41,115.96,116.07001000000001,114.44,1334
2005-04-27 13:30:00,114.86,116.07001000000001,114.44,115.64998999999999,113.315,124.49745023255814,115.74665035000038,118.92419999999996,118.6074,116.6765,117.67204876953596,116.45199568029786,115.8830753846157,118.66434833315552,113.1018024360758,115.74665035000038,118.92419999999996,118.6074,116.6765,115.38666666666668,85186128,77741852.0,44.5904676104749,1.5,2.75,1.4589640569936273,1.0957563501317154,0.012146620678202602,-0.9055236388880844,-0.9176702595662868,20.55997464635721,-0.10366243413664464,1756988301.0,2005-04-27,2005,2,117,4,1.42,115.26,115.67998999999999,114.2,1335
2005-04-28 13:30:00,115.27,115.67998999999999,114.2,114.2,113.26799999999999,124.53210162790695,115.76005035000038,118.87369999999996,118.46880000000002,116.4884995,117.53588999426005,116.23751990122184,115.5838446153849,118.18198159563063,112.98570763513919,115.76005035000038,118.87369999999996,118.46880000000002,116.4884995,114.69333,74218192,78200321.6,39.499401260614576,1.5,2.75,1.4604659100655113,0.9490778360174928,-0.045585035353945313,-0.9746515537587186,-0.9290665184047732,20.455282943404733,0.043810779133664685,1682770109.0,2005-04-28,2005,3,118,4,1.3,114.94,115.87,113.97,1336
2005-04-29 13:30:00,115.07001000000001,115.87,113.97,115.75,113.221,124.5667530232558,115.78480035000038,118.83909989999997,118.3595998,116.40449999999998,117.46585509252435,116.1910894344388,115.35692153846183,117.24504526324075,113.4687978136829,115.78480035000038,118.83909989999997,118.3595998,116.40449999999998,115.19666666666667,104283312,78544746.4,46.52765360849485,1.5,2.75,1.4918612022036897,1.3276930256916584,0.028007024994581745,-0.8940577371615461,-0.922064762156128,20.2978943477932,1.091703056768559,1787053421.0,2005-04-29,2005,4,119,4,1.67,114.92,116.41,115.52,1337
2005-05-02 13:30:00,116.07001000000001,116.41,115.52,116.39998999999999,113.174,124.60140441860464,115.8132502500004,118.82209969999997,118.28299960000002,116.34299949999998,117.42405646144495,116.21098472639702,115.28769000000031,116.93659781858145,113.63878218141916,115.8132502500004,118.82209969999997,118.28299960000002,116.34299949999998,116.10999666666667,56057104,77767126.4,49.1931004601233,1.5,2.75,1.4488711163319976,0.7208329096753149,0.12255205991102867,-0.7688746872673421,-0.8914267471783707,20.42582898503557,0.8578026167576518,1843110525.0,2005-05-02,2005,0,122,5,0.77,115.96,116.85001000000001,115.69,1338
2005-05-03 13:30:00,116.07001000000001,116.85001000000001,115.69,116.60001000000001,113.12700000000001,124.63605581395348,115.84505025000038,118.80019989999997,118.2071998,116.26349999999998,117.39174091393733,116.24803475245443,115.35153692307722,117.12943390829884,113.57363993785559,115.84505025000038,118.80019989999997,118.2071998,116.26349999999998,116.38000666666667,86824192,79604340.8,50.01875670852221,1.5,2.75,1.4282381794511405,1.0906967023084753,0.1962784512792033,-0.6460786830793666,-0.8423571343585698,20.036528559964605,2.4604657293497367,1929934717.0,2005-05-03,2005,1,123,5,1.0,116.27,117.75,116.28,1339
2005-05-04 13:30:00,116.64998999999999,117.75,116.28,117.5,113.08,124.67070720930231,115.8743502500004,118.78309979999996,118.18519960000002,116.20849949999996,117.39598636829271,116.36726953793494,115.60923000000031,117.5768045860252,113.64165541397543,115.8743502500004,118.78309979999996,118.18519960000002,116.20849949999996,117.17666666666666,82477632,81062637.6,53.66725038006585,1.5,2.75,1.4312211666332018,1.0174555682111188,0.29731435278178364,-0.4707141933813404,-0.768028546163124,17.817964228561546,1.2843807675528616,2012412349.0,2005-05-04,2005,2,124,5,1.26,117.02,118.0,116.74001000000001,1340
2005-05-05 13:30:00,117.67,118.0,116.74001000000001,117.46001000000001,113.03299999999999,124.70535860465117,115.91375030000036,118.76439989999996,118.14539979999999,116.11949949999996,117.3984970989479,116.47134005813163,115.83692307692337,117.9200352695855,113.75381088426128,115.91375030000036,118.76439989999996,118.14539979999999,116.11949949999996,117.40000666666666,97322816,83567503.2,53.48044046574022,1.5,2.75,1.4189903690165449,1.1646012178571346,0.3495058900669855,-0.3311461835793921,-0.6806520736463776,14.636562392264425,1.6353723600093144,1915089533.0,2005-05-05,2005,3,125,5,1.08,117.37,117.99001000000001,117.06,1341
2005-05-06 13:30:00,117.92998999999999,117.99001000000001,117.06,117.09,112.986,124.74001000000001,115.94980030000038,118.73159989999996,118.0823996,116.07399949999996,117.38639917349896,116.5302600525953,115.96615384615414,118.13401270422716,113.79829498808112,115.94980030000038,118.73159989999996,118.0823996,116.07399949999996,117.38000333333332,69602880,83833207.2,51.68767166186422,1.5,2.75,1.3840631998010773,0.8302542909273307,0.3464890594720653,-0.24754074930629605,-0.5940298087783613,14.559959639473345,0.6533138485343464,1845486653.0,2005-05-06,2005,4,126,5,0.79,117.53,118.08,117.05,1342
2005-05-09 13:30:00,117.21001000000001,118.08,117.05,117.82001000000001,112.939,124.77466139534883,115.99410030000037,118.70190009999996,118.01020000000004,116.06049999999996,117.40340351963627,116.65309338091957,116.27538538461569,118.25801653226094,114.29275423697041,115.99410030000037,118.70190009999996,118.01020000000004,116.06049999999996,117.65000333333334,43971808,83738897.6,54.899903022579096,1.5,2.75,1.3587729712438572,0.5251061246356795,0.3784378285971931,-0.12098252303186995,-0.4994203516290631,14.516564417483835,2.2743142361111053,1889458461.0,2005-05-09,2005,0,129,5,0.88,117.56,117.5,116.39,1343
2005-05-10 13:30:00,117.36,117.5,116.39,116.60001000000001,112.89200000000001,124.80931279069769,116.03335035000036,118.65910019999995,117.92960020000002,115.95550049999996,117.37189789141523,116.64803782083195,116.32077153846184,118.30403637294431,114.33750670397936,116.03335035000036,118.65910019999995,117.92960020000002,115.95550049999996,116.83000333333332,75030624,83163044.8,49.03246776950223,1.5,2.75,1.363861330440724,0.9022111225057022,0.30531993197768703,-0.1177704366569543,-0.4230903686346413,14.699798994883347,0.8214613766935863,1814427837.0,2005-05-10,2005,1,130,5,0.95,116.94,117.39998999999999,115.85001000000001,1344
2005-05-11 13:30:00,116.92998999999999,117.39998999999999,115.85001000000001,117.24001000000001,112.845,124.8439641860465,116.07070040000036,118.62340029999996,117.84980040000003,115.95250099999996,117.36672581724207,116.70441612360986,116.44923307692338,118.43767496824628,114.46079118560048,116.07070040000036,118.62340029999996,117.84980040000003,115.95250099999996,116.83000333333332,92009312,84460600.8,51.934580588366345,1.5,2.75,1.37715552112353,1.0893755328342396,0.2881862145274071,-0.06285760047538247,-0.3510438150027896,14.832172704131098,2.662005253940451,1906437149.0,2005-05-11,2005,2,131,5,1.34,116.62,117.59,115.41,1345
2005-05-12 13:30:00,117.32001000000001,117.59,115.41,115.95,112.79799999999999,124.87861558139537,116.09995035000038,118.58850029999998,117.74540040000004,115.96150099999996,117.31116794205612,116.63256696898036,116.42000230769258,118.42569330317377,114.41431131221144,116.09995035000038,118.58850029999998,117.74540040000004,115.96150099999996,116.31666666666666,95571312,84257225.6,46.22159182755989,1.5,2.75,1.4345015553289926,1.1342803103167929,0.18321490974576032,-0.1220251778205892,-0.3052400875663495,14.315551982291106,0.172786177105834,1810865837.0,2005-05-12,2005,3,132,5,1.89,116.5,116.62,114.8,1346
2005-05-13 13:30:00,116.3,116.62,114.8,115.72,112.751,124.9132669767442,116.1257003000004,118.55100029999998,117.63540040000004,116.04000149999996,117.24876919923037,116.54565582907745,116.46000230769262,118.38592952098531,114.53407509439992,116.1257003000004,118.55100029999998,117.63540040000004,116.04000149999996,115.71333333333332,85440496,81827809.6,45.265513152472856,1.5,2.75,1.4620371585197791,1.0441498607583406,0.09592125415865904,-0.18533851986802571,-0.2812597740266848,12.185038057940929,-0.5841838989848742,1725425341.0,2005-05-13,2005,4,133,5,1.59,115.71,116.84,115.66,1347
2005-05-16 13:30:00,115.7,116.84,115.66,116.8,112.704,124.94791837209304,116.15550030000038,118.51510029999996,117.51680040000004,116.15500149999997,117.2311704071037,116.56987908345104,116.54846461538492,118.42238537178619,114.67454385898368,116.15550030000038,118.51510029999996,117.51680040000004,116.15500149999997,116.43333333333334,49351008,79279619.2,50.448565207046784,1.5,2.75,1.4418916471969383,0.6224930000672859,0.10766619994556514,-0.14667702409472838,-0.2543432240402935,12.965370967895673,0.17151799558164674,1774776349.0,2005-05-16,2005,0,136,5,1.02,116.25,117.7,116.16,1348
2005-05-17 13:30:00,116.42998999999999,117.7,116.16,117.58,112.65700000000001,124.98256976744186,116.1880502500004,118.48410039999996,117.41260060000003,116.26350149999996,117.24484999898199,116.66608107550331,116.80846461538492,118.17651892764064,115.4404103031292,116.1880502500004,118.48410039999996,117.41260060000003,116.26350149999996,117.14666666666666,61411904,78930358.4,53.847736540194674,1.5,2.75,1.4488993866828717,0.7780517565722848,0.16148024071778416,-0.052492923143063315,-0.21397316386084747,13.456129919311369,0.06808510638297728,1836188253.0,2005-05-17,2005,1,137,5,1.33,116.93,119.08,118.00998999999999,1349
2005-05-18 13:30:00,118.07001000000001,119.08,118.00998999999999,118.78998999999999,112.61,125.01722116279068,116.2309501500004,118.46430029999996,117.34180040000004,116.51300099999996,117.3054437245121,116.86835811593158,117.0423100000003,118.6285798219594,115.4560401780412,116.2309501500004,118.46430029999996,117.34180040000004,116.51300099999996,118.62666000000002,78052688,77091886.4,58.59302077848955,1.5,2.75,1.4525494304912379,1.0124630703030766,0.265914265404494,0.11841966789477,-0.147494597509724,13.998332123968156,1.1322832340981464,1914240941.0,2005-05-18,2005,2,138,5,0.91,118.54,119.41,118.7,1350
2005-05-19 13:30:00,119.02,119.41,118.7,119.28998999999999,112.563,125.05187255813955,116.27640010000042,118.45200019999994,117.30820020000004,116.67700099999998,117.38326906864887,117.0989897239381,117.26461769230801,119.20010332013806,115.32913206447792,116.27640010000042,118.45200019999994,117.30820020000004,116.67700099999998,119.13333,62850096,75861416.0,60.404717820468996,1.5,2.75,1.3995101854561491,0.8284856691839235,0.3506853356599468,0.29086207206520953,-0.059823263594737275,14.07048889306954,1.8788880348449908,1977091037.0,2005-05-19,2005,3,139,5,0.6,119.06,119.39,118.74001000000001,1351
2005-05-20 13:30:00,119.34,119.39,118.74001000000001,119.12,112.516,125.08652395348835,116.3300001500004,118.43140029999996,117.26580000000004,116.85450049999996,117.45137616399599,117.29146689308685,117.45846307692335,119.58428177479652,115.3326443790502,116.3300001500004,118.43140029999996,117.26580000000004,116.85450049999996,119.08333666666668,46424800,73690680.8,59.45231893463245,1.5,2.75,1.3459730293521388,0.6299955366947838,0.3751317280347624,0.4090913964487157,0.03395966841395333,13.89342044926174,1.1033694531175209,1930666237.0,2005-05-20,2005,4,140,5,0.55,119.07,120.03998999999999,119.19,1352
2005-05-23 13:30:00,119.21001000000001,120.03998999999999,119.19,119.78,112.469,125.1211753488372,116.3946501000004,118.41560029999997,117.25360000000002,117.0270005,117.54269474580006,117.52847004612622,117.63384769230795,120.09430563210606,115.17338975250988,116.3946501000004,118.41560029999997,117.25360000000002,117.0270005,119.66999666666668,51291600,73637085.6,61.96011631371681,1.5,2.75,1.3155456701127002,0.6965457633483529,0.4125992824156609,0.5497087714335294,0.1371094890178685,13.817342054481408,2.7272639170442643,1981957837.0,2005-05-23,2005,0,143,5,0.71,119.61,119.83,119.2,1353
2005-05-24 13:30:00,119.44,119.83,119.2,119.5,112.42200000000001,125.15582674418604,116.4571501000004,118.39930029999996,117.2208,117.2420005,117.61945181459221,117.716234803638,117.79077000000028,120.43984578035551,115.14169421964505,116.4571501000004,118.39930029999996,117.2208,117.2420005,119.51,50997600,72418775.2,60.257425572237146,1.5,2.75,1.2665781222475072,0.7042041219167153,0.3953351365538126,0.6312784097101343,0.2359432731563217,11.886105564863918,1.9276610433588344,1930960237.0,2005-05-24,2005,1,144,5,0.53,119.52,119.87,118.83,1354
2005-05-25 13:30:00,119.35001000000001,119.87,118.83,119.41,112.375,125.19047813953487,116.5131001000004,118.38470029999996,117.2062,117.430001,117.68966939049056,117.87754577472008,117.96923153846184,120.71620215091274,115.22226092601092,116.5131001000004,118.38470029999996,117.2062,117.430001,119.37,48481008,70583519.2,59.689630521976525,1.5,2.75,1.2503939706584,0.6868601700437742,0.3558955437438624,0.6808127028361497,0.3249171590922873,11.844944882161519,2.9840448469167686,1882479229.0,2005-05-25,2005,2,145,5,0.88,119.35,120.21001000000001,119.62,1355
2005-05-26 13:30:00,119.78998999999999,120.21001000000001,119.62,120.05,112.328,125.22512953488373,116.57255010000038,118.38220029999997,117.22480000000002,117.722501,117.78223137517722,118.0844461771277,118.14076923076952,121.09939716162113,115.1821412999179,116.57255010000038,118.38220029999997,117.22480000000002,117.722501,119.96000333333336,43554192,69050319.2,62.402693703364,1.5,2.75,1.218223687039943,0.6307601833649452,0.3504000356749825,0.7629172036860155,0.41251716801103294,8.617008491114698,3.7417905288627713,1926033421.0,2005-05-26,2005,3,146,5,0.49,119.92,120.25,119.8,1356
2005-05-27 13:30:00,120.06,120.25,119.8,120.25,112.281,125.25978093023257,116.6389001000004,118.39740029999996,117.24260000000002,117.94750100000002,117.87900661536631,118.29068939835363,118.42153769230801,121.43427582137836,115.40879956323765,116.6389001000004,118.39740029999996,117.24260000000002,117.94750100000002,120.1,24641504,65068228.8,63.23542968113079,1.5,2.75,1.16335056653709,0.37870254737900605,0.33758970128978016,0.8345042946232581,0.496914593333478,8.004965909829481,2.9537671232876734,1950674925.0,2005-05-27,2005,4,147,5,0.38,120.02,120.17,119.39998999999999,1357
2005-05-31 13:30:00,120.08,120.17,119.39998999999999,119.48,112.234,125.2944323255814,116.7003501000004,118.41210039999994,117.2614002,118.1015015,117.94179066966568,118.40395707470093,118.59384461538492,121.5726048038433,115.61508442692651,116.7003501000004,118.41210039999994,117.2614002,118.1015015,119.68333,44926800,64511713.6,57.91679084369183,1.5,2.75,1.1409690974987263,0.6964130619528296,0.25819354525803584,0.8196565249060228,0.5614629796479871,9.092781627224296,1.6159210750127622,1905748125.0,2005-05-31,2005,1,151,5,0.64,119.78,120.92,119.45,1358
2005-06-01 13:30:00,119.52,120.92,119.45,120.5,112.18700000000001,125.32908372093023,116.7613501000004,118.43100039999996,117.3094,118.296501,118.04211260418859,118.60358021044368,118.94384461538492,121.65497857320992,116.23271065755993,116.7613501000004,118.43100039999996,117.3094,118.296501,120.29,69917680,63666388.0,62.42526961965199,1.5,2.75,1.1644713048202455,1.0981882622271582,0.2548699068118689,0.8800503631628231,0.6251804563509542,9.471292353160095,1.4395236500987978,1975665805.0,2005-06-01,2005,2,152,6,1.23,120.18,120.84,120.10001000000001,1359
2005-06-02 13:30:00,120.23,120.84,120.10001000000001,120.75998999999999,112.14,125.36373511627909,116.8206000500004,118.45420029999994,117.3866,118.45950050000002,118.14869603147531,118.8089525713538,119.33153615384646,121.46835998828463,117.1947123194083,116.8206000500004,118.45420029999994,117.3866,118.45950050000002,120.56666666666666,40481008,61566556.8,63.498692278744876,1.5,2.75,1.1341512116188002,0.6575161922974391,0.2503183164875903,0.938078351960442,0.6877600354728518,8.076581574248534,1.2322911587133158,2016146813.0,2005-06-02,2005,3,153,6,0.62,120.47,120.89,119.73,1360
2005-06-03 13:30:00,120.55,120.89,119.73,120.14998999999999,112.093,125.3983865116279,116.8712000000004,118.46570019999994,117.44959979999999,118.59399950000002,118.22717814788805,118.93667042170107,119.589227692308,121.1812732701474,117.99718211446856,116.8712000000004,118.46570019999994,117.44959979999999,118.59399950000002,120.25666333333334,61052000,59753016.0,59.22376461571147,1.5,2.75,1.1359975536460285,1.0217392206612634,0.18914441617925806,0.9241905556969244,0.7350461395176663,8.72601377839594,0.8646658831430473,1955094813.0,2005-06-03,2005,4,154,6,0.97,120.31,120.2,119.55,1361
2005-06-06 13:30:00,120.02,120.2,119.55,120.03998999999999,112.046,125.43303790697674,116.9228499000004,118.48430019999992,117.5075996,118.74149900000002,118.29826880875518,119.04174847677716,119.77845769230801,120.87924992128565,118.67766546333034,116.9228499000004,118.48430019999992,117.5075996,118.74149900000002,119.92999666666668,36332000,58089472.0,58.459460278678044,1.5,2.75,1.1012834426713127,0.6254489625934283,0.12716531939297304,0.8940027887588826,0.7668374693659096,8.685061758473136,0.21705626982801965,1918762813.0,2005-06-06,2005,0,157,6,0.54,119.88,121.25,120.00998999999999,1362
2005-06-07 13:30:00,120.39,121.25,120.00998999999999,120.13,111.999,125.46768930232557,116.97109990000044,118.49990009999992,117.5639996,118.85699850000003,118.37010140449028,119.14539147898886,119.88153538461569,120.8337077920664,118.92936297716496,116.97109990000044,118.49990009999992,117.5639996,118.85699850000003,120.46333,66684192,59225091.2,58.92656483128304,1.5,2.75,1.1111924824805046,1.1259449440915341,0.08040492317705973,0.8673436233372342,0.7869387001601745,8.145051900571316,0.5271966527196614,1985447005.0,2005-06-07,2005,1,158,6,1.03,120.63,120.59,119.67,1363
2005-06-08 13:30:00,120.42998999999999,120.59,119.67,119.91,111.95200000000001,125.50234069767441,117.01964990000042,118.52280009999993,117.6315996,119.022498,118.43048958470635,119.21821133813278,119.92922846153877,120.8181117819947,119.04034514108284,117.01964990000042,118.52280009999993,117.6315996,119.022498,120.05666666666664,50022192,57974669.6,57.232608887847604,1.5,2.75,1.0975358765890402,0.862828410151043,0.025667197836688027,0.8190226974560346,0.7933554996193466,8.09021713077909,0.4187253998827569,1935424813.0,2005-06-08,2005,2,159,6,0.77,120.13,120.58,119.44,1364
2005-06-09 13:30:00,119.74001000000001,120.58,119.44,120.48,111.905,125.53699209302326,117.07029985000042,118.54519999999992,117.6775998,119.18449750000002,118.51086254216885,119.33838168688204,120.03384384615416,120.83270663845894,119.23498105384935,117.07029985000042,118.54519999999992,117.6775998,119.18449750000002,120.16666666666669,57162896,56232348.8,60.408257633260575,1.5,2.75,1.1005690282612517,1.0165482541607795,0.01915633283993423,0.8173009156692643,0.7981445828293301,8.424758330163979,0.3581840899625213,1992587709.0,2005-06-09,2005,3,160,6,0.95,120.01,120.64998999999999,119.60001000000001,1365
2005-06-10 13:30:00,120.56,120.64998999999999,119.60001000000001,120.2,111.858,125.57164348837208,117.11579980000045,118.55249999999992,117.7223996,119.39699750000004,118.57710322678969,119.42044057384564,120.06615153846184,120.85524891207932,119.27705416484436,117.11579980000045,118.55249999999992,117.7223996,119.39699750000004,120.15,36504096,53278988.0,58.12502221750564,1.5,2.75,1.0969555262425912,0.6851499506709849,-0.011074235503627737,0.7843017884497954,0.7953760239534231,8.085246131129804,-0.041580041580039216,1956083613.0,2005-06-10,2005,4,161,6,0.88,120.12,121.08,119.81,1366
2005-06-13 13:30:00,119.94,121.08,119.81,120.58,111.811,125.6062948837209,117.16319975000046,118.57609999999994,117.7853998,119.63999750000002,118.65564819828812,119.53087480490795,120.14922846153877,120.90928559734535,119.38917132573219,117.16319975000046,118.57609999999994,117.7853998,119.63999750000002,120.49,49501696,51482048.0,60.317157751756994,1.5,2.75,1.1093158457966916,0.9615331542365992,-0.012442219489298469,0.7798232495917999,0.7922654690810985,8.232806054228806,0.9206561767659812,2005585309.0,2005-06-13,2005,0,164,6,1.06,120.44,121.2,120.38,1367
2005-06-14 13:30:00,120.45,121.2,120.38,120.86,111.764,125.64094627906977,117.21024975000046,118.60969999999992,117.8499998,119.84299750000002,118.74209336698271,119.65745815682148,120.2607669230772,120.97856032679114,119.54297351936329,117.21024975000046,118.60969999999992,117.8499998,119.84299750000002,120.81333333333332,34001600,50714577.6,61.899857490141315,1.5,2.75,1.0886504282397855,0.6704502257354895,-0.002001390826351201,0.7897637305481595,0.7917651213745107,7.081023401659966,0.29875518672199125,2039586909.0,2005-06-14,2005,1,165,6,0.68,120.79,121.24001000000001,120.23,1368
2005-06-15 13:30:00,121.16,121.24001000000001,120.23,121.09,111.71700000000001,125.6755976744186,117.26304975000046,118.65279999999993,117.90799979999998,120.01849750000004,118.83416813690495,119.79389071331468,120.3407669230772,121.16994515461019,119.51158869154423,117.26304975000046,118.65279999999993,117.90799979999998,120.01849750000004,120.85333666666668,53889904,50338477.6,63.19828672540589,1.5,2.75,1.0830332547940862,1.0705509298119893,0.012107325722524487,0.8068992785276663,0.7947919528051418,5.387679457072151,0.2732775979858904,2093476813.0,2005-06-15,2005,2,166,6,0.84,120.74,121.64,120.92,1369
2005-06-16 13:30:00,121.09,121.64,120.92,121.39998999999999,111.67,125.71024906976744,117.31449970000048,118.70129989999994,117.9639994,120.14899750000002,118.93478860212437,119.94685255014187,120.42922769230799,121.42868595267711,119.42976943193882,117.31449970000048,118.70129989999994,117.9639994,120.14899750000002,121.31999666666668,46642304,48767958.4,64.9328748930447,1.5,2.75,1.05710230802308,0.9564128893285802,0.032852580988855795,0.8358576790412116,0.8030050980523558,5.4376945467363536,1.04036629549449,2140119117.0,2005-06-16,2005,3,167,6,0.6,121.28,121.89998999999999,120.49001000000001,1370
2005-06-17 13:30:00,121.53998999999999,121.89998999999999,120.49001000000001,121.36,111.623,125.74490046511627,117.36469965000047,118.74609989999996,118.00639919999998,120.25249800000002,119.0298949314528,120.08143802155693,120.57384307692335,121.52494067769274,119.62274547615395,117.36469965000047,118.74609989999996,118.00639919999998,120.25249800000002,121.25,53732800,48312093.6,64.51045259542803,1.5,2.75,1.0823078574500031,1.1122018524984807,0.03426020593081813,0.8458303554658784,0.8115701495350602,4.195516303238724,1.0996418776775942,2086386317.0,2005-06-17,2005,4,168,6,1.17,121.2,121.84,120.94,1371
2005-06-20 13:30:00,121.08,121.84,120.94,121.39998999999999,111.57600000000001,125.77955186046512,117.40879960000048,118.78779979999996,118.07439899999996,120.3664975,119.12283983610172,120.20701440045626,120.64307307692336,121.68889498129415,119.59725117255256,117.40879960000048,118.78779979999996,118.07439899999996,120.3664975,121.39333,42228096,48102258.4,64.75736068059538,1.5,2.75,1.0692858676321462,0.8778817752972696,0.028499639604874893,0.8471946990411539,0.8186950594362791,4.045756172711855,1.057179721967874,2128614413.0,2005-06-20,2005,0,171,6,0.74,121.39,121.64998999999999,121.03,1372
2005-06-21 13:30:00,121.5,121.64998999999999,121.03,121.47,111.529,125.81420325581396,117.45554960000048,118.82819989999994,118.14199899999998,120.45099750000001,119.21488533272516,120.32729874326996,120.69768923076953,121.83259373840376,119.56278472313524,117.45554960000048,118.82819989999994,118.14199899999998,120.45099750000001,121.38333,40059200,47540638.4,65.21364664681406,1.5,2.75,1.0371933056584215,0.8426306702688284,0.020399018093099408,0.8441938320526532,0.8237948139595538,4.052851083837579,1.3009757317988508,2168673613.0,2005-06-21,2005,1,172,6,0.51,121.34,121.94,121.07001000000001,1373
2005-06-22 13:30:00,121.67998999999999,121.94,121.07001000000001,121.57001000000001,111.482,125.84885465116278,117.49909965000047,118.86960009999993,118.1993992,120.554498,119.3072431628144,120.44565219629186,120.8069215384618,121.98255672523092,119.6312863516927,117.49909965000047,118.86960009999993,118.1993992,120.554498,121.52667333333332,46678400,47324678.4,65.89297625408886,1.5,2.75,1.0252502123971057,0.9863437339280472,0.013124379716530798,0.8402002886052173,0.8270759088886865,3.6108384935021967,0.9047227755644028,2215352013.0,2005-06-22,2005,2,173,6,0.72,121.51,121.60001000000001,119.83,1374
2005-06-23 13:30:00,121.32001000000001,121.60001000000001,119.83,119.86,111.435,125.88350604651166,117.53549965000047,118.88660009999994,118.25059919999998,120.576998,119.32891990152756,120.38987579664499,120.7930761538464,122.0080934927243,119.57805881496851,117.53549965000047,118.88660009999994,118.25059919999998,120.576998,120.43000333333332,62813392,48041297.6,48.46521243707354,1.5,2.75,1.0784473400830266,1.3074874147446007,-0.10879236084776857,0.6910854578289758,0.7998778186767443,9.165328573864935,-0.2828618968386052,2152538621.0,2005-06-23,2005,3,174,6,1.48,120.72,120.0078,118.84,1375
2005-06-24 13:30:00,119.88,120.0078,118.84,118.98,111.388,125.91815744186044,117.56799965000047,118.88730009999992,118.31479919999997,120.523498,119.31523676813431,120.25560191125022,120.70461461538488,122.22814417829329,119.18108505247645,117.56799965000047,118.88730009999992,118.31479919999997,120.523498,119.27593333333334,59186608,48822918.4,42.269411596335786,1.5,2.75,1.0848296729342388,1.2122709977124186,-0.2429562141364128,0.4961825510062283,0.7391387651426411,9.950898123355506,-1.3269198872118049,2093352013.0,2005-06-24,2005,4,175,6,0.98,119.42,119.41,118.75,1376
2005-06-27 13:30:00,118.97,119.41,118.75,119.14998999999999,111.34100000000001,125.9528088372093,117.59844960000048,118.88609999999993,118.41479919999996,120.46849749999998,119.30875650271729,120.15030553875023,120.64615230769256,122.33637085876116,118.95593375662392,117.59844960000048,118.88609999999993,118.41479919999996,120.46849749999998,119.10333,51163600,50149023.2,43.7649574789296,1.5,2.75,1.0544846962960783,1.0202312375248817,-0.31020157434111284,0.3513867972162501,0.6615883715573629,9.73300718854934,-1.4148684428264082,2144515613.0,2005-06-27,2005,0,178,6,0.56,119.08,120.24001000000001,119.37,1377
2005-06-28 13:30:00,119.39998999999999,120.24001000000001,119.37,120.14998999999999,111.294,125.98746023255812,117.63204960000047,118.89799979999992,118.52779899999996,120.501997,119.34174605163034,120.15027548744068,120.62076692307717,122.33001047633832,118.911523369816,117.63204960000047,118.89799979999992,118.52779899999996,120.501997,119.92,42615392,50033452.8,51.6929868854458,1.5,2.75,1.0570229322749298,0.8517379795943246,-0.2783022953272665,0.3137105023982798,0.5920127977255463,11.054044162885273,-0.7762903625402601,2187131005.0,2005-06-28,2005,1,179,6,0.73,119.81,120.39998999999999,119.75998999999999,1378
2005-06-29 13:30:00,120.37,120.39998999999999,119.75998999999999,119.83,111.247,126.02211162790695,117.66289960000047,118.89399979999992,118.61619899999997,120.468497,119.36089326529188,120.11977306006538,120.59230538461563,122.34050496026865,118.8441058089626,117.66289960000047,118.89399979999992,118.61619899999997,120.468497,119.99666,43059008,48690519.2,49.297971205272376,1.5,2.75,1.0272355799695778,0.8843407034361629,-0.26953766095590603,0.2550907215306637,0.5246283824865697,10.98826492879627,-1.2932373388169176,2144071997.0,2005-06-29,2005,2,180,6,0.53,120.08,120.32001000000001,118.95,1379
2005-06-30 13:30:00,120.22,120.32001000000001,118.95,119.17998999999999,111.2,126.05676302325581,117.6947995500005,118.88509959999992,118.72379879999997,120.38949699999998,119.35379901959419,120.03026991148774,120.48461230769257,122.38816102978569,118.58106358559942,117.6947995500005,118.88509959999992,118.72379879999997,120.38949699999998,119.48333333333336,62301600,49781548.8,44.76120102175718,1.5,2.75,1.0517194671146075,1.2514998328055231,-0.2961796048324582,0.15440387644599696,0.4505834812784552,10.987054033017676,-1.7963167435728378,2081770397.0,2005-06-30,2005,3,181,6,1.15,119.64,119.8,119.21001000000001,1380
2005-07-01 13:30:00,119.45,119.8,119.21001000000001,119.53,111.153,126.09141441860464,117.72674955000048,118.87829949999994,118.79419899999996,120.35849750000001,119.36070886196305,119.98262515801271,120.38230461538488,122.33644555622679,118.42816367454296,117.72674955000048,118.87829949999994,118.79419899999996,120.35849750000001,119.51333666666666,49786400,49218268.8,47.55971740984342,1.5,2.75,1.0208830766064207,1.011543095965212,-0.27912309789233936,0.10167960891303096,0.3808027068053703,11.305796372932775,-1.5403543278710332,2131556797.0,2005-07-01,2005,4,182,7,0.49,119.51,120.64998999999999,119.19,1381
2005-07-05 13:30:00,119.25,120.64998999999999,119.19,120.49001000000001,111.10600000000001,126.12606581395347,117.7634496500005,118.89009959999994,118.89259899999996,120.3809985,119.40499518110174,120.03094752391623,120.3361515384618,122.24916313616127,118.42313994076231,117.7634496500005,118.89009959999994,118.89259899999996,120.3809985,120.11,51550192,49979178.4,54.385692522064325,1.5,2.75,1.0522478568488196,1.0314333618577451,-0.1960064259086618,0.13579467441954307,0.3318011003282049,12.549830346988227,-0.8067753354737802,2183106989.0,2005-07-05,2005,1,186,7,1.22,119.92,120.64998999999999,119.41,1382
2005-07-06 13:30:00,120.39,120.64998999999999,119.41,119.48,111.059,126.1607172093023,117.79849965000048,118.88749949999992,118.95559899999996,120.34849849999998,119.40793654654871,119.97847633116231,120.18846000000029,122.04578813633593,118.33113186366462,117.79849965000048,118.88749949999992,118.95559899999996,120.34849849999998,119.84666333333332,54068800,49348408.8,47.395748979663146,1.5,2.75,1.065658009931047,1.0956543749795635,-0.20111697134433226,0.08040488614778951,0.2815218574921218,13.241901489649011,-1.7191822226550713,2129038189.0,2005-07-06,2005,2,187,7,1.04,120.03,119.95,118.25998999999999,1383
2005-07-07 13:30:00,118.28998999999999,119.95,118.25998999999999,119.95,118.25998999999999,126.19536860465116,117.83344960000048,118.87929949999996,119.05059899999996,120.3504985,119.42919393688015,119.97576429962305,120.07999846153874,121.81141378302792,118.34858314004956,117.83344960000048,118.87929949999996,119.05059899999996,120.3504985,119.38666333333332,103262368,52010417.6,50.57890713735359,1.5,2.75,1.1102545806502584,1.985417013840704,-0.1663495572904469,0.07358491087906316,0.2399344681695101,13.568968858159735,0.0750876022025725,2232300557.0,2005-07-07,2005,3,188,7,1.43,119.1,121.32001000000001,119.72,1384
2005-07-08 13:30:00,119.97,121.32001000000001,119.72,121.32001000000001,118.34721203703705,126.23002,117.88229965000048,118.88569969999992,119.16399939999997,120.39249899999996,119.50334358641426,120.10378769965895,120.07384615384643,121.7869275603832,118.36076474730966,117.88229965000048,118.88569969999992,119.16399939999997,120.39249899999996,120.78667333333333,64550608,52379803.2,58.468056722468326,1.5,2.75,1.145237110603811,1.2323568256552746,-0.05059429618544437,0.1766915979377046,0.22728589412314895,12.616102377550636,1.9667255000840411,2296851165.0,2005-07-08,2005,4,189,7,1.34,120.52,122.10001000000001,121.31,1385
2005-07-11 13:30:00,121.33,122.10001000000001,121.31,121.94,118.43443407407408,126.26467139534884,117.93724965000048,118.89379969999996,119.31879939999996,120.479499,119.59889873988821,120.2786650615962,120.11000000000028,121.95423409162842,118.26576590837216,117.93724965000048,118.89379969999996,119.31879939999996,120.479499,121.78333666666668,49762496,53042723.2,61.46589853962869,1.5,2.75,1.1198637455606817,0.9381587708528508,0.06210528681090755,0.3049175026367834,0.2428122158258759,11.495171693434525,2.341594825144337,2346613661.0,2005-07-11,2005,0,192,7,0.65,121.71,122.63,121.64,1386
2005-07-12 13:30:00,121.89,122.63,121.64,122.25998999999999,118.52165611111113,126.29932279069769,117.99124955000048,118.90429949999994,119.44899919999996,120.56349850000001,119.7032552598926,120.4673626747775,120.1630753846157,122.20178574971204,118.12436501951932,117.99124955000048,118.90429949999994,119.44899919999996,120.56349850000001,122.17666333333334,52165008,53175888.8,62.95226049451995,1.5,2.75,1.1105877637349182,0.9809898654669972,0.1476948819426207,0.42743081825415175,0.27973593631153104,11.476488435071078,1.7561383067946983,2398778669.0,2005-07-12,2005,1,193,7,0.81,122.14,122.52,121.99001000000001,1387
2005-07-13 13:30:00,122.27,122.52,121.99001000000001,122.42998999999999,118.60887814814815,126.3339741860465,118.04964950000047,118.92629939999996,119.56959919999994,120.641998,119.81018603401445,120.65427956289395,120.36076692307724,122.71723669171715,118.00429715443731,118.04964950000047,118.92629939999996,119.56959919999994,120.641998,122.31333333333332,41266000,53539108.8,63.75220189236597,1.5,2.75,1.0691164948967096,0.7707636702387546,0.20189707597406328,0.5321072812791101,0.3302102053050469,10.874430314257904,2.169732120504052,2440044669.0,2005-07-13,2005,2,194,7,0.43,122.26,123.44,122.49001000000001,1388
2005-07-14 13:30:00,122.98,123.44,122.49001000000001,122.91,118.6961001851852,126.36862558139536,118.1077995000005,118.95149939999996,119.69579899999994,120.73299799999998,119.93174736601391,120.86911008071355,120.66307461538493,123.2321863749677,118.09396285580219,118.1077995000005,118.95149939999996,119.69579899999994,120.73299799999998,122.94667,64775808,54083404.0,65.98549951157068,1.5,2.75,1.064894602404087,1.1977021268853565,0.2529088361792361,0.646346250529092,0.3934374143498559,10.518390077647794,3.129728404910919,2504820477.0,2005-07-14,2005,3,195,7,0.78,122.97,123.03998999999999,122.36,1389
2005-07-15 13:30:00,122.78998999999999,123.03998999999999,122.36,122.84,118.78332222222221,126.4032769767442,118.16279950000047,118.99389929999997,119.80259899999993,120.80499849999998,120.04579648891531,121.05681388255036,120.94692153846184,123.59867106835912,118.29517200856459,118.16279950000047,118.99389929999997,119.80259899999993,120.80499849999998,122.74666333333334,56137808,54558179.2,65.353140267545,1.5,2.75,1.0374014165180812,1.0289531069981162,0.2635699898359962,0.7228999016448512,0.459329911808855,9.49050362107792,2.769179285535014,2448682669.0,2005-07-15,2005,4,196,7,0.56,122.7,122.63,122.05,1390
2005-07-18 13:30:00,122.5,122.63,122.05,122.35001000000001,118.87054425925926,126.437928372093,118.21574960000048,119.02289939999996,119.90039899999994,120.854499,120.13615780307549,121.17997541754559,121.11615384615419,123.82309725396952,118.40921043833885,118.21574960000048,119.02289939999996,119.90039899999994,120.854499,122.34333666666667,56816304,54712354.4,60.94999610098318,1.5,2.75,1.01972988676679,1.0384547443273615,0.2209777797896063,0.7355521365458628,0.5145743567562565,10.310652566567104,1.5436964442114325,2391866365.0,2005-07-18,2005,0,199,7,0.48,122.34,123.11,122.41,1391
2005-07-19 13:30:00,122.71001000000001,123.11,122.41,123.02,118.95776629629628,126.47257976744186,118.26259965000048,119.05069929999996,120.01899899999997,120.9354995,120.24924965393528,121.35521585396981,121.36153846153879,124.13516008905856,118.58791683401905,118.26259965000048,119.05069929999996,120.01899899999997,120.9354995,122.84666666666664,59507296,55576314.4,64.47453274824919,1.5,2.75,1.0011770377120195,1.0707312394216628,0.2207637077099659,0.7905289913937139,0.5697652836837479,9.895655945039632,2.962838968865076,2451373661.0,2005-07-19,2005,1,200,7,0.57,122.76,123.73,122.3,1392
2005-07-20 13:30:00,122.59,123.73,122.3,123.44,119.04498833333334,126.50723116279067,118.31059965000048,119.07079939999996,120.13139879999993,121.0339995,120.37437711848685,121.55376672502031,121.68923153846188,124.35912337858,119.01933969834371,118.31059965000048,119.07079939999996,120.13139879999993,121.0339995,123.15666666666668,69602496,57053479.2,66.51485508877771,1.5,2.75,1.0318072493040185,1.2199518237268163,0.23066571059551036,0.8580974219281359,0.6274317113326255,7.297642537538443,2.9095456440183365,2520976157.0,2005-07-20,2005,2,201,7,1.17,123.02,123.61,122.47,1393
2005-07-21 13:30:00,123.55,123.61,122.47,122.72,119.13221037037034,126.54188255813952,118.35469970000048,119.09169939999997,120.25379859999994,121.091499,120.46636232952656,121.6648365607327,121.93461615384649,124.338745536315,119.53048677137801,118.35469970000048,119.09169939999997,120.25379859999994,121.091499,122.93333333333332,100791120,59759115.2,60.13840743669486,1.5,2.75,1.0395353029251602,1.6866233655347025,0.1731113233692957,0.8438208655442452,0.6707095421749495,8.938745129887202,1.1539646262805308,2420185037.0,2005-07-21,2005,3,202,7,0.93,123.04,123.56,122.63,1394
2005-07-22 13:30:00,122.88,123.56,122.63,123.53998999999999,119.2194324074074,126.57653395348835,118.39929965000047,119.11479929999996,120.37979819999993,121.27549850000001,120.5868967479765,121.84342260256766,122.16923000000034,124.55890294141476,119.77955705858594,118.39929965000047,119.11479929999996,120.37979819999993,121.27549850000001,123.24333,55933008,59415096.0,64.33211592715648,1.5,2.75,1.0317113527162205,0.941393884140152,0.17417768213077622,0.8884316448384197,0.7142539627076435,7.485693809233867,1.3121125143513248,2476118045.0,2005-07-22,2005,4,203,7,0.76,123.1,123.95,122.85001000000001,1395
2005-07-25 13:30:00,123.41,123.95,122.85001000000001,123.19,119.30665444444445,126.61118534883721,118.44799965000048,119.13499929999996,120.52459819999993,121.4859985,120.688979228448,121.97166806898979,122.45461461538495,124.32013009122194,120.58909913954795,118.44799965000048,119.13499929999996,120.52459819999993,121.4859985,123.33000333333332,57591504,59335340.8,61.364598662420995,1.5,2.75,1.0365883989507767,0.970610486491046,0.13686811203291505,0.8853391027487874,0.7484709907158723,7.595700032948142,0.7606822150075391,2418526541.0,2005-07-25,2005,0,206,7,0.9,123.4,123.53,122.37,1396
2005-07-26 13:30:00,123.23,123.53,122.37,123.34,119.39387648148147,126.64583674418604,118.50214970000047,119.15619929999997,120.67699819999993,121.695499,120.7929408273324,122.10198539575266,122.7153838461542,123.94792795487619,121.48283973743216,118.50214970000047,119.15619929999997,120.67699819999993,121.695499,123.08,42847504,58919536.0,62.17001764997497,1.5,2.75,1.0454035133114352,0.7272206624301997,0.10905732612629948,0.8847926483737467,0.7757353222474472,7.530040192938856,0.7432901040014785,2461374045.0,2005-07-26,2005,1,207,7,0.95,122.95,123.89,123.05,1397
2005-07-27 13:30:00,123.5,123.89,123.05,123.78998999999999,119.48109851851852,126.68048813953487,118.55624965000048,119.16679919999996,120.81679799999992,121.87749900000004,120.910472167437,122.26274773901432,122.90538230769265,123.96886049092188,121.84190412446341,118.55624965000048,119.16679919999996,120.81679799999992,121.87749900000004,123.57666333333331,45262704,59051901.6,64.55707204052429,1.5,2.75,1.0307318337891902,0.7664902022393127,0.10755417874347173,0.9101780456767871,0.8026238669333152,7.694566352431514,0.7159628996826999,2506636749.0,2005-07-27,2005,2,208,7,0.68,123.47,124.64,123.64,1398
2005-07-28 13:30:00,123.99001000000001,124.64,123.64,124.57001000000001,119.56832055555556,126.71513953488373,118.61644970000047,119.18459939999997,120.95659819999992,122.11449950000004,121.0539834549885,122.48248700196535,123.10769076923108,124.3458846247177,121.86949691374451,118.61644970000047,119.18459939999997,120.95659819999992,122.11449950000004,124.28333666666668,48448496,59321376.0,68.29200273302135,1.5,2.75,1.0285367028042478,0.8167122758581999,0.14343555285376064,0.981918308000516,0.8384827551467554,8.118143480110033,1.4083441875610492,2555085245.0,2005-07-28,2005,3,209,7,0.81,124.14,124.63,123.5,1399
2005-07-29 13:30:00,124.41,124.63,123.5,123.74001000000001,119.6555425925926,126.74979093023256,118.67744980000047,119.19869949999996,121.05559859999994,122.34250050000004,121.1593178293027,122.60225109701626,123.22153846153877,124.39763202546885,122.04544489760872,118.67744980000047,119.19869949999996,121.05559859999994,122.34250050000004,123.95667,62446304,59328611.2,60.93385281842947,1.5,2.75,1.035784081175373,1.0525495665066231,0.09779322611667662,0.9607242877926012,0.8629310616759246,9.312489706828963,1.1360849091879932,2492638941.0,2005-07-29,2005,4,210,7,0.91,124.06,124.03998999999999,123.45,1400
2005-08-01 13:30:00,123.83,124.03998999999999,123.45,123.64998999999999,119.74276462962965,126.7844423255814,118.74249975000048,119.22549939999998,121.14279859999995,122.54850000000002,121.2569912477614,122.70203575444329,123.31538461538493,124.41614193194077,122.21462729882907,118.74249975000048,119.22549939999998,121.14279859999995,122.54850000000002,123.71332666666667,42940704,58986326.4,60.17654639263613,1.5,2.75,1.0039416468057034,0.7279772554203342,0.05044697358086825,0.92598977865201,0.8755428050711417,8.885544608328754,0.5121037229718798,2449698237.0,2005-08-01,2005,0,213,8,0.48,123.74,124.60001000000001,123.74001000000001,1401
2005-08-02 13:30:00,123.87,124.60001000000001,123.74001000000001,124.39,119.82998666666668,126.81909372093023,118.80814980000049,119.25699929999998,121.24819859999994,122.7434995,121.37985433608448,122.86279425402012,123.42923076923107,124.63942921552456,122.21903232293761,118.80814980000049,119.25699929999998,121.24819859999994,122.7434995,124.24334,46241200,58720876.8,64.12386281925558,1.5,2.75,1.0000901006052956,0.7874746175452203,0.05737029880025935,0.947255678571466,0.8898853797712065,8.981265728355998,0.7696046662346102,2495939437.0,2005-08-02,2005,1,214,8,0.7,124.17,124.74001000000001,124.12,1402
2005-08-03 13:30:00,124.25,124.74001000000001,124.12,124.72,119.91720870370372,124.74001000000001,118.87334985000051,119.30029929999996,121.34699859999996,123.00549950000001,121.51084044055176,123.03967099173248,123.57384615384649,124.91053566875955,122.23715663893341,118.87334985000051,119.30029929999996,121.34699859999996,123.00549950000001,124.52667,37197600,57877316.8,65.75403495325176,1.5,2.75,0.9729415219906312,0.642697382267037,0.07164917297425966,0.9794468459890312,0.9077976730147714,8.920638074635091,1.6297262059973925,2533137037.0,2005-08-03,2005,2,215,8,0.5,124.43,124.31,123.57001000000001,1403
2005-08-04 13:30:00,124.23,124.31,123.57001000000001,123.72,120.00443074074074,124.75433701923076,118.93824980000049,119.32609929999997,121.43139859999997,123.1939995,121.59747414876541,123.10446423061512,123.6792300000003,124.81414612602285,122.5443138739778,118.93824980000049,119.32609929999997,121.43139859999997,123.1939995,123.86666999999998,51043696,55266383.2,57.262795664189355,1.5,2.75,0.9855878418484432,0.92359392897634,0.004749044717583195,0.9137339789117505,0.9089849341941671,9.603228493083114,0.1457099033276559,2482093341.0,2005-08-04,2005,3,216,8,0.6,123.94,123.98,122.67,1404
2005-08-05 13:30:00,123.45,123.98,122.67,122.88,120.09165277777778,124.76866403846155,119.00004980000051,119.35349929999997,121.50079859999997,123.271999,121.64776928018637,123.08308668484224,123.66846076923109,124.83052646316679,122.50639507529543,119.00004980000051,119.35349929999997,121.50079859999997,123.271999,123.17666666666665,53711104,54724408.0,51.2731313611249,1.5,2.75,1.0087601388592689,0.981483509150067,-0.09932549211630548,0.7848280690487854,0.8841535611650909,9.712443985660363,-0.2516438022566785,2428382237.0,2005-08-05,2005,4,217,8,1.07,123.32,123.41,122.38,1405
2005-08-08 13:30:00,123.17,123.41,122.38,122.64998999999999,120.17887481481482,124.7829910576923,119.05709970000049,119.38879919999997,121.55279839999996,123.30749850000001,121.6870720535124,123.04183938152391,123.60769076923108,124.88781920958536,122.32756232887684,119.05709970000049,119.38879919999997,121.55279839999996,123.30749850000001,122.81332999999998,48227008,54647633.6,49.73894327812833,1.5,2.75,1.0102772717978925,0.8825086252225202,-0.18208994922240307,0.6565411246370871,0.8386310738594902,9.644578788552726,-0.5594373277120163,2380155229.0,2005-08-08,2005,0,220,8,0.84,122.9,123.59,122.87,1406
2005-08-09 13:30:00,123.06,123.59,122.87,123.39,120.26609685185187,124.79731807692309,119.1240996500005,119.42909919999994,121.61559839999997,123.363999,121.75385354160994,123.07499753566452,123.65922923076955,124.84254039699906,122.47591806454008,119.1240996500005,119.42909919999994,121.61559839999997,123.363999,123.28333333333332,47522304,54415498.4,54.46017852884089,1.5,2.75,1.005258180955186,0.8733229575638694,-0.1848395815130074,0.607581596968231,0.7924211784812384,10.314228838202864,-0.3231198257629737,2427677533.0,2005-08-09,2005,1,221,8,0.59,123.23,124.5,122.82001000000001,1407
2005-08-10 13:30:00,123.82001000000001,124.5,122.82001000000001,123.33,120.35331888888891,124.81164509615385,119.19144965000052,119.47699929999996,121.69259839999997,123.40899949999998,121.81566320664484,123.09928348464884,123.6430761538465,124.83813188927157,122.44802041842141,119.19144965000052,119.47699929999996,121.69259839999997,123.40899949999998,123.55000333333334,73115632,56007980.0,54.017127391330824,1.5,2.75,1.0534533108869586,1.3054502590523709,-0.18792681392108407,0.5575126610798833,0.7454394750009674,10.05629597348586,-0.9954322071580456,2354561901.0,2005-08-10,2005,2,222,8,1.37,123.66,124.03,123.00998999999999,1408
2005-08-11 13:30:00,123.27,124.03,123.00998999999999,123.82001000000001,120.44054092592592,124.82597211538462,119.2528497500005,119.53419929999994,121.75899859999998,123.45449999999998,121.89426504167837,123.16792410515848,123.69153846153877,124.85997068284858,122.52310624022898,119.2528497500005,119.53419929999994,121.75899859999998,123.45449999999998,123.62,58860304,55712204.8,57.087538958187295,1.5,2.75,1.0510645029664614,1.0565064551169945,-0.15553513321918033,0.551020558476992,0.7065556916961724,9.57296029336252,0.06465168380057372,2413422205.0,2005-08-11,2005,3,223,8,0.83,123.52,123.69,122.75,1409
2005-08-12 13:30:00,123.57001000000001,123.69,122.75,123.06,120.52776296296295,124.84029913461538,119.30374975000048,119.59579939999996,121.8049988,123.46549999999998,121.93998013808313,123.15764561895293,123.6700000000003,124.87335950258881,122.4666404974118,119.30374975000048,119.59579939999996,121.8049988,123.46549999999998,123.16666666666669,54814608,55646044.8,51.359329535663726,1.5,2.75,1.052417752754571,0.9850584744524375,-0.18202284264304347,0.4790271383923681,0.6610499810354116,9.454523924589473,-0.4771452064007448,2358607597.0,2005-08-12,2005,4,224,8,0.77,123.22,123.87,122.83,1410
2005-08-15 13:30:00,123.22,123.87,122.83,123.82001000000001,120.614985,124.85462615384616,119.35674980000047,119.66399949999992,121.8783992,123.53899999999996,122.01370679933477,123.22072794095742,123.67230923076954,124.87669568516232,122.46792277637677,119.35674980000047,119.66399949999992,121.8783992,123.53899999999996,123.50667,36227504,54616604.8,56.102828274662286,1.5,2.75,1.0515307704149592,0.6633056765915996,-0.14660749138358276,0.4777906168059332,0.6243981081895159,10.201498231155963,-0.4582281533885394,2394835101.0,2005-08-15,2005,0,227,8,0.85,123.35,123.52,122.09,1411
2005-08-16 13:30:00,123.44,123.52,122.09,122.21001000000001,120.70220703703704,124.86895317307692,119.40179985000047,119.71469959999996,121.9217996,123.49850049999996,122.02140496406678,123.12446908943764,123.49077076923108,124.8055738814213,122.17596765704089,119.40179985000047,119.71469959999996,121.9217996,123.49850049999996,122.60667,72265008,55254490.4,45.892644220500365,1.5,2.75,1.099993572528176,1.3078576506064383,-0.2251633854795092,0.3429438763401293,0.5681072618196386,11.927152388785279,-2.012500000000001,2322570093.0,2005-08-16,2005,1,228,8,1.17,122.8,122.87,122.03,1412
2005-08-17 13:30:00,122.19,122.87,122.03,122.2,120.78942907407408,124.8832801923077,119.44524990000048,119.76359959999996,121.96319960000001,123.43650049999994,122.02840869096607,123.03642441425312,123.37230846153878,124.84407708084237,121.9005398422352,119.44524990000048,119.76359959999996,121.96319960000001,123.43650049999994,122.36666666666667,62507696,54899750.4,45.83679001272835,1.5,2.75,1.081422603061878,1.138578874121803,-0.26841540156527033,0.23258800986305064,0.5010034114283209,11.65760044117768,-1.228580666020042,2260062397.0,2005-08-17,2005,2,229,8,0.69,122.45,122.56,121.84,1413
2005-08-18 13:30:00,122.05,122.56,121.84,122.19,120.87665111111113,124.89760721153844,119.48844990000048,119.82019959999997,122.0087996,123.41000049999997,122.03474560504586,122.95581256527664,123.26000153846185,124.84809314600146,121.67190993092228,119.48844990000048,119.82019959999997,122.0087996,123.41000049999997,122.19666666666667,53546096,52537499.2,45.77685103451513,1.5,2.75,1.0556067028431724,1.0191976553006543,-0.28665987753859623,0.14267856450507566,0.4293384420436719,11.036468298843603,-0.5615234374999982,2206516301.0,2005-08-18,2005,3,230,8,0.59,122.2,122.82001000000001,122.2,1414
2005-08-19 13:30:00,122.63,122.82001000000001,122.2,122.47,120.96387314814815,124.91193423076923,119.5258999000005,119.86309969999996,122.0485996,123.35650099999994,122.05181440484795,122.90954470191696,123.11230923076954,124.60694067772378,121.61767778381528,119.5258999000005,119.86309969999996,122.0485996,123.35650099999994,122.49667,39955808,51738639.2,47.833816127455556,1.5,2.75,1.0252069383543745,0.7722624448151315,-0.26911322791455594,0.09294690715047693,0.3620601350650329,10.583925328833583,-0.1467509292092104,2246472109.0,2005-08-19,2005,4,231,8,0.51,122.51,123.23,121.88,1415
2005-08-22 13:30:00,122.58,123.23,121.88,122.47,121.0510951851852,124.92626125,119.5554999000005,119.90819959999992,122.0939996,123.32050099999992,122.068213839952,122.8676833017344,122.93923230769262,124.141629751108,121.73683486427723,119.5554999000005,119.90819959999992,122.0939996,123.32050099999992,122.52666666666669,69948320,52356480.0,47.833816127455556,1.5,2.75,1.0484064427576338,1.3360011979414963,-0.24730880090968155,0.05292413392793094,0.3002329348376125,10.53884251371649,-0.7456033714239417,2246472109.0,2005-08-22,2005,0,234,8,1.11,122.56,122.61,121.14998999999999,1416
2005-08-23 13:30:00,122.5,122.61,121.14998999999999,122.24001000000001,121.13831722222223,124.94058826923077,119.58029995000051,119.95629979999993,122.1271998,123.26550149999993,122.07495094426758,122.8079048920454,122.82538692307725,123.99019689163595,121.66057695451849,119.58029995000051,119.95629979999993,122.1271998,123.26550149999993,122.0,56743296,53051269.6,46.165493806470224,1.5,2.75,1.077806696846374,1.0695935540815031,-0.23809246334178874,0.0026173556603765746,0.2407098190021653,9.799379951802822,-0.8837995621503286,2189728813.0,2005-08-23,2005,1,235,8,1.21,121.88,122.73,121.09,1417
2005-08-24 13:30:00,121.94,122.73,121.09,121.14998999999999,121.22553925925926,124.95491528846155,119.60049990000051,119.99149969999992,122.13299960000002,123.13350149999991,122.03867796606102,122.65000823566014,122.69230923076954,124.15815515377628,121.22646330776277,119.60049990000051,119.99149969999992,122.13299960000002,123.13350149999991,121.65666333333333,79135312,54744900.0,39.189244144154884,1.5,2.75,1.1179633613573474,1.445528478451874,-0.2915916765337576,-0.1237797766650317,0.1678118998687259,10.808140119884868,-2.15637197897173,2110593501.0,2005-08-24,2005,2,236,8,1.35,121.91,121.67,121.21001000000001,1418
2005-08-25 13:30:00,121.35001000000001,121.67,121.21001000000001,121.59,121.31276129629629,124.96924230769231,119.62404990000051,120.02549969999993,122.14299960000002,122.98450099999992,122.02108275170569,122.54905507035916,122.61077153846183,124.1904652246339,121.03107785228977,119.62404990000051,120.02549969999993,122.14299960000002,122.98450099999992,121.49000333333332,35642000,54104575.2,42.93781472294989,1.5,2.75,1.0752524069746798,0.6587612945531452,-0.2832877281964118,-0.1862977603767888,0.09698996781962296,10.743711367235255,-1.1945392491467568,2146235501.0,2005-08-25,2005,3,237,8,0.38,121.44,121.49001000000001,120.67998999999999,1419
2005-08-26 13:30:00,121.48,121.49001000000001,120.67998999999999,120.75998999999999,121.39998333333334,124.98356932692309,119.64299985000049,120.04709949999993,122.1301996,122.83549999999993,121.97162813399171,122.37866792080116,122.40846307692335,124.19699719890438,120.61992895494237,119.64299985000049,120.04709949999993,122.1301996,122.83549999999993,120.97666333333336,61962304,54080375.2,38.1593173757998,1.5,2.75,1.0634493779050598,1.14574471369422,-0.3170861015981121,-0.2993676591780172,0.017718442420094918,10.85262998098222,-2.4713453019427107,2084273197.0,2005-08-26,2005,4,238,8,0.67,121.08,121.78,120.38,1420
2005-08-29 13:30:00,120.41,121.78,120.38,121.69,120.38,124.99789634615385,119.66214985000049,120.07159939999994,122.13679960000002,122.73750049999992,121.96058389344304,122.3130804997725,122.28230923076951,124.02378014551675,120.5408383160223,119.66214985000049,120.07159939999994,122.13679960000002,122.73750049999992,121.28333333333332,56183392,54742509.6,45.48066366734318,1.5,2.75,1.0874887080546989,1.0263210877712483,-0.2624585599876051,-0.31035475756441144,-0.04789619757680635,11.2884238933426,-0.4255052429829596,2140456589.0,2005-08-29,2005,0,241,8,1.16,121.08,121.3,120.39,1421
2005-08-30 13:30:00,121.25,121.3,120.39,121.05,120.43729756756755,125.0122233653846,119.67344990000048,120.10209939999993,122.1297998,122.57050049999994,121.92487472115114,122.19278711884176,122.06923153846184,123.67883522819685,120.45962784872684,119.67344990000048,120.10209939999993,122.1297998,122.57050049999994,120.91333333333334,74179872,56139443.2,41.812102850596574,1.5,2.75,1.1026680860507914,1.3213503335921934,-0.2548672081633056,-0.3664802077809384,-0.11161299961763277,9.095306407488108,-0.94108019639935,2066276717.0,2005-08-30,2005,1,242,8,0.76,120.84,122.66,120.74001000000001,1422
2005-08-31 13:30:00,121.19,122.66,120.74001000000001,122.58,120.49459513513511,125.02655038461538,119.69269990000048,120.14699939999993,122.1519998,122.46350049999994,121.95056590855698,122.22966453609492,122.03230846153878,123.5697105983609,120.49490632471662,119.69269990000048,120.14699939999993,122.1519998,122.46350049999994,121.99333666666666,102979312,59428528.8,51.8178828400871,1.5,2.75,1.1610482227614491,1.7328262045080276,-0.1380899556552446,-0.2842254441866885,-0.1461354885314439,11.96963513590497,0.319175055241837,2169256029.0,2005-08-31,2005,2,243,8,1.59,121.7,123.14998999999999,121.14,1423
2005-09-01 13:30:00,122.50998999999999,123.14998999999999,121.14,122.49001000000001,120.55189270270269,125.04087740384615,119.7157499500005,120.18489949999993,122.1703998,122.40200099999996,121.97172057880964,122.25445934218114,121.93000076923107,123.1144203934657,120.74558114499641,119.7157499500005,120.18489949999993,122.1703998,122.40200099999996,122.26,74582624,60605475.2,51.259566014550025,1.5,2.75,1.2216869211356314,1.2306251828547659,-0.06206799468907176,-0.2237204818927836,-0.16165248720371184,11.983277724570335,0.01633869519065828,2094673405.0,2005-09-01,2005,3,244,9,1.66,122.14,122.88,122.03998999999999,1424
2005-09-02 13:30:00,122.85001000000001,122.88,122.03998999999999,122.27,120.60919027027028,125.05520442307692,119.73419995000047,120.23459949999993,122.21859980000004,122.37150099999994,121.9834178110132,122.25593940483051,121.93461538461568,123.12382061077179,120.74541015845959,119.73419995000047,120.23459949999993,122.21859980000004,122.37150099999994,122.39666333333332,47656304,60302735.2,49.84553110423993,1.5,2.75,1.1944242839116572,0.7902842854796409,-0.023731964848922173,-0.19131744326486452,-0.16758547841594235,11.95777396308526,-0.16330529925696322,2047017101.0,2005-09-02,2005,4,245,9,0.69,122.46,123.8,122.64998999999999,1425
2005-09-06 13:30:00,122.66,123.8,122.64998999999999,123.7,120.66648783783785,125.06953144230768,119.75899990000048,120.31389949999992,122.31299980000004,122.42400149999996,122.05073475960093,122.39346898532284,122.05000000000031,123.56599232800494,120.5340076719957,119.75899990000048,120.31389949999992,122.31299980000004,122.42400149999996,123.38333,57253808,60754075.2,57.962601904073715,1.5,2.75,1.2183939779179676,0.9423862977343124,0.0943274888518872,-0.04967611735108335,-0.14400360620297056,13.74004863374044,1.1943634494139888,2104270909.0,2005-09-06,2005,1,249,9,0.94,123.22,124.13,123.46001000000001,1426
2005-09-07 13:30:00,123.63,124.13,123.46001000000001,123.91,120.72378540540541,125.08385846153843,119.7914499000005,120.41149959999993,122.40820000000004,122.45000149999994,122.12364712196951,122.5379005105302,122.182307692308,123.99522605099293,120.36938933362309,119.7914499000005,120.41149959999993,122.40820000000004,122.45000149999994,123.83333666666664,41754304,60465675.2,59.011703406401644,1.5,2.75,1.179222265209541,0.6905455675784796,0.17809462719704816,0.07861467779333964,-0.09947994940370852,13.618887405608964,2.2781760031511302,2146025213.0,2005-09-07,2005,2,250,9,0.54,123.8,124.0,123.31,1427
2005-09-08 13:30:00,123.66,124.0,123.31,123.5,120.78108297297294,125.09818548076923,119.8190499000005,120.50149959999992,122.47520020000003,122.45850149999994,122.17762174463738,122.62952903333685,122.26153846153878,124.20327643254014,120.31980049053742,119.8190499000005,120.50149959999992,122.47520020000003,122.45850149999994,123.60333333333334,39070800,58763433.6,56.06959709209453,1.5,2.75,1.1442778176945738,0.6648828634819596,0.19600392957198126,0.145524962561268,-0.05047896701071322,12.387437767019026,1.5708528661896508,2106954413.0,2005-09-08,2005,3,251,9,0.56,123.66,124.74001000000001,123.8,1428
2005-09-09 13:30:00,123.83,124.74001000000001,123.8,124.60001000000001,120.83838054054054,125.1125125,119.8512499500005,120.59339969999995,122.57060040000003,122.49750149999996,122.27261736249474,122.81719388730477,122.4253853846157,124.73453927359024,120.11623149564112,119.8512499500005,120.59339969999995,122.57060040000003,122.49750149999996,124.38000666666665,44112304,58026033.6,61.60102551472083,1.5,2.75,1.1511158307163898,0.7602157387507527,0.26761455895316,0.28403923168073675,0.016424672727576767,12.99990150048645,3.1798777061839734,2151066717.0,2005-09-09,2005,4,252,9,0.76,124.27,124.67,124.27,1429
2005-09-12 13:30:00,124.45,124.67,124.27,124.35001000000001,120.8956781081081,125.12683951923077,119.88080000000048,120.69889979999996,122.67400080000004,122.56200199999996,122.35408374043614,122.96317637422814,122.58769307692336,125.10880208904732,120.0665840647994,119.88080000000048,120.69889979999996,122.67400080000004,122.56200199999996,124.43000333333332,33024608,56936533.6,59.75937912498895,1.5,2.75,1.097464699950934,0.5800249139157287,0.2823657601679576,0.3693818729375238,0.08701611276956618,11.993611105227115,2.185890377187937,2118042109.0,2005-09-12,2005,0,255,9,0.32,124.47,124.42,123.52,1430
2005-09-13 13:30:00,124.13,124.42,123.52,123.66,120.95297567567567,125.14116653846152,119.9073499500005,120.77539989999994,122.75660080000006,122.55400149999996,122.40529614277195,123.02954052906355,122.78077076923105,125.21483635694332,120.3467051815188,119.9073499500005,120.77539989999994,122.75660080000006,122.55400149999996,123.86666666666667,58479008,58049108.8,54.882394210673205,1.5,2.75,1.0833600785258677,1.0074057846689974,0.2319813120747953,0.3769927528630603,0.14501144078826503,12.473047854519768,2.156133828996282,2059563101.0,2005-09-13,2005,1,256,9,0.73,123.97,123.92,123.02,1431
2005-09-14 13:30:00,123.75,123.92,123.02,123.21001000000001,121.01027324324323,125.15549355769232,119.93435000000048,120.85179989999996,122.81100080000004,122.60400149999997,122.43685354893776,123.04672809772416,122.90538692307722,125.24695947515768,120.56381437099677,119.93435000000048,120.85179989999996,122.81100080000004,122.60400149999997,123.38333666666666,55195392,57195628.0,51.90726622317996,1.5,2.75,1.0702629300597348,0.9650281661388525,0.15820112024233718,0.3427628410911865,0.1845617208488493,12.176777399760056,0.5139582313591113,2004367709.0,2005-09-14,2005,2,257,9,0.73,123.47,123.64998999999999,122.89998999999999,1432
2005-09-15 13:30:00,123.50998999999999,123.64998999999999,122.89998999999999,123.14998999999999,121.06757081081079,125.16982057692309,119.9606499500005,120.91999979999996,122.88440060000003,122.65150099999997,122.46481968427355,123.05656256460756,123.08923307692335,125.07668114719752,121.10178500664921,119.9606499500005,120.91999979999996,122.88440060000003,122.65150099999997,123.23332333333332,73655808,57753033.6,51.50620564664301,1.5,2.75,1.0473870064840394,1.2753582523498816,0.09815101106195116,0.30725048467628824,0.2090994736143371,10.070301107527632,0.5388031236180032,1930711901.0,2005-09-15,2005,3,258,9,0.61,123.27,123.74001000000001,122.87,1433
2005-09-16 13:30:00,123.28,123.74001000000001,122.87,123.5,121.12486837837835,125.18414759615385,119.9819999500005,121.00299979999994,122.95540060000003,122.71700099999997,122.50541499077259,123.09879470131163,123.22846384615411,125.0510744441136,121.40585324819466,119.9819999500005,121.00299979999994,122.95540060000003,122.71700099999997,123.37000333333332,75425808,58847019.2,53.75039249749457,1.5,2.75,1.0347172203066075,1.2817269086078025,0.07579802833035397,0.3038470090272796,0.2280489806969256,10.12316285275135,1.0059703933916777,2006137709.0,2005-09-16,2005,4,259,9,0.71,123.31,123.55,122.64,1434
2005-09-19 13:30:00,123.47,123.55,122.64,123.09,121.18216594594593,125.1984746153846,120.0007999500005,121.07739989999996,122.99080040000004,122.74800099999996,122.52833989309522,123.09795711071051,123.3853869230772,124.71545921192669,122.0553146342277,120.0007999500005,121.07739989999996,122.99080040000004,122.74800099999996,123.09333333333332,53373696,59517913.6,50.785553434482864,1.5,2.75,1.0258088474275642,0.8967669189264054,0.02956983271650424,0.2650112715925559,0.23544143887605165,10.3036640880169,-0.4931285367825379,1952764013.0,2005-09-19,2005,0,262,9,0.74,123.1,123.61,121.87,1435
2005-09-20 13:30:00,123.21001000000001,123.61,121.87,122.05,121.23946351351351,125.2128016346154,120.0147999500005,121.15589989999994,122.99300040000006,122.727001,122.50958146591505,122.99815167159521,123.34461769230795,124.79773660852815,121.89149877608776,120.0147999500005,121.15589989999994,122.99300040000006,122.727001,122.51,84997120,60270353.6,44.13527954790942,1.5,2.75,1.0768225011827377,1.4102641667594265,-0.06947204922490749,0.1486013773449173,0.2180734265698248,8.839938761944008,-1.5010895004438702,1867766893.0,2005-09-20,2005,1,263,9,1.43,122.74,121.87,120.78,1436
2005-09-21 13:30:00,121.78998999999999,121.87,120.78,120.91,121.29676108108109,125.22712865384615,120.0232999000005,121.20749989999992,122.96600060000006,122.66050049999998,122.44685278097721,122.79928008382423,123.22307846153878,125.13398064074792,121.31217628232956,120.0232999000005,121.20749989999992,122.96600060000006,122.66050049999998,121.18666666666664,94497808,62158079.2,38.22623737004611,1.5,2.75,1.0906208939553987,1.5202819845179514,-0.20264801300380209,-0.03523658968492782,0.16741142331887424,9.689936705734905,-2.0971659919028367,1773269085.0,2005-09-21,2005,2,264,9,0.9,121.32,121.66,120.44,1437
2005-09-22 13:30:00,120.95,121.66,120.44,121.34,121.35405864864865,125.24145567307691,120.0394998500005,121.25689999999993,122.94420080000008,122.670001,122.4034467895663,122.66030102822194,123.15154000000028,125.25930026730305,121.04377973269753,120.0394998500005,121.25689999999993,122.94420080000008,122.670001,121.14666666666666,84600368,62431332.0,41.41252012592954,1.5,2.75,1.09986225867287,1.3550947143014664,-0.24958164590040585,-0.14456563405663306,0.1050160118437728,10.24924766175394,-2.616380207353109,1857869453.0,2005-09-22,2005,3,265,9,1.01,121.05,121.89,120.89998999999999,1438
2005-09-23 13:30:00,121.24001000000001,121.89,120.89998999999999,121.44,121.4113562162162,125.25578269230768,120.05274990000048,121.30529989999994,122.91480080000008,122.662501,122.36566456252451,122.544081882677,122.97769384615411,125.24276588519821,120.71262180711004,120.05274990000048,121.30529989999994,122.91480080000008,122.662501,121.40999666666669,59368704,63617667.2,42.159703155097596,1.5,2.75,1.092015668767665,0.9332109555881356,-0.26049090000464026,-0.22059761316202756,0.03989328684261273,7.991950886031518,-2.3401767317911752,1917238157.0,2005-09-23,2005,4,266,9,0.82,121.39,122.24001000000001,121.08,1439
2005-09-26 13:30:00,122.02,122.24001000000001,121.08,121.58,121.46865378378378,125.27010971153842,120.06459985000049,121.34609989999994,122.88960080000008,122.7035015,122.33485418752356,122.45226456051728,122.79846307692335,125.1083773272438,120.4885488266029,120.06459985000049,121.34609989999994,122.88960080000008,122.7035015,121.63333666666666,70425808,64040842.4,43.250877265444544,1.5,2.75,1.0968724067128317,1.0997014617659058,-0.24510247225747414,-0.26648480347923,-0.021382331221755813,8.27319679003738,-1.6820313763545192,1987663965.0,2005-09-26,2005,0,269,9,0.96,121.66,121.99001000000001,121.02,1440
2005-09-27 13:30:00,121.52,121.99001000000001,121.02,121.55,121.52595135135134,125.28443673076923,120.07569985000048,121.38699979999993,122.87360060000006,122.6965015,122.30407559193442,122.36633460237276,122.6484630769233,125.0093653485463,120.28756080530034,120.07569985000048,121.38699979999993,122.87360060000006,122.6965015,121.52000333333332,66151376,64539241.6,43.063399506558426,1.5,2.75,1.0878108062333438,1.0249791345549373,-0.2243282185428619,-0.3017926044003332,-0.07746438585747129,8.054785950018161,-1.3473012460594718,1921512589.0,2005-09-27,2005,1,270,9,0.8,121.51,122.12,121.2,1441
2005-09-28 13:30:00,121.91,122.12,121.2,121.67,121.58324891891891,125.29876375,120.08219985000048,121.43279979999993,122.84660060000006,122.7275015,122.27920988244676,122.30001702119442,122.42307769230796,124.54283941053212,120.30331597408377,120.08219985000048,121.43279979999993,122.84660060000006,122.7275015,121.66333333333334,58708496,63765672.8,44.10705343599253,1.5,2.75,1.0758243200738191,0.9206912343595628,-0.1911833152005641,-0.3164435298581765,-0.12526021465761233,8.088301643648856,-1.2017784167095755,1980221085.0,2005-09-28,2005,2,271,9,0.76,121.66,122.86,121.08,1442
2005-09-29 13:30:00,121.55,122.86,121.08,122.66,121.64054648648649,125.31309076923077,120.09154990000047,121.48119969999992,122.83100060000008,122.7315015,122.29414282823316,122.334301114414,122.29307692307721,124.10982618591946,120.47632766023493,120.09154990000047,121.48119969999992,122.83100060000008,122.7315015,122.2,66645632,61948988.8,51.93476293749278,1.5,2.75,1.1261225829256891,1.0758146870671759,-0.0960651259643805,-0.245341622113088,-0.14927649614870747,9.721036683776342,-0.6801619433198408,2046866717.0,2005-09-29,2005,3,272,9,1.47,121.97,123.03998999999999,122.45,1443
2005-09-30 13:30:00,122.62,123.03998999999999,122.45,123.03998999999999,121.69784405405404,125.32741778846152,120.10234985000048,121.54559949999992,122.83740040000006,122.75900049999998,122.3233917369299,122.4015095797079,122.24538384615411,123.944859637259,120.54590805504921,120.10234985000048,121.54559949999992,122.83740040000006,122.75900049999998,122.84332666666668,47827104,60611212.8,54.56497132010893,1.5,2.75,1.0878273984309972,0.7890801353507977,-0.005799995658453072,-0.15652649072177385,-0.15072649506332075,9.753075008949358,-0.040628808189130165,2094693821.0,2005-09-30,2005,4,273,9,0.48,122.74,123.34,122.45,1444
2005-10-03 13:30:00,122.96001000000001,123.34,122.45,122.60001000000001,121.75514162162163,125.34174480769232,120.11129990000046,121.59919949999993,122.81860080000006,122.775501,122.33423951195226,122.4204143816405,122.19846076923105,123.8207422965552,120.57617924190693,120.11129990000046,121.59919949999993,122.81860080000006,122.775501,122.79667,51015104,60779152.8,51.07957780380764,1.5,2.75,1.0736968699716405,0.8393520088684093,0.024376133605423483,-0.1202563280565414,-0.1446324616619649,9.78253201692202,0.45064317902498996,2043678717.0,2005-10-03,2005,0,276,10,0.73,122.9,123.03,121.16,1445
2005-10-04 13:30:00,122.78998999999999,123.03,121.16,121.22,121.81243918918919,125.35607182692308,120.12019990000047,121.65189949999993,122.77920080000007,122.651501,122.29054384481688,122.30608920243662,122.05000000000028,123.64988376501263,120.45011623498795,120.12019990000047,121.65189949999993,122.77920080000007,122.651501,121.80333333333333,60779696,60955447.2,42.01450802214532,1.5,2.75,1.1305756649736662,0.9971167269198544,-0.044738318083948285,-0.20055535926690027,-0.15581704118295198,10.727210491033468,0.2563890497063951,1982899021.0,2005-10-04,2005,1,277,10,1.54,122.1,121.31,119.57001000000001,1446
2005-10-05 13:30:00,121.25,121.31,119.57001000000001,119.63,121.86973675675677,125.37039884615385,120.12099990000047,121.6909994999999,122.70500080000005,122.43750100000004,122.18620879207896,122.0512235641093,121.75230769230801,123.58539017139836,119.91922521321762,120.12099990000047,121.6909994999999,122.70500080000005,122.43750100000004,120.17000333333333,106061184,64170791.2,34.432389208950994,1.5,2.75,1.1741052603326902,1.652795329723159,-0.1857621921213572,-0.3880197813346484,-0.20225758921329126,12.00520544380126,-1.40926322729521,1876837837.0,2005-10-05,2005,2,278,10,1.46,120.44,120.25998999999999,118.17,1447
2005-10-06 13:30:00,119.78,120.25998999999999,118.17,119.2,121.92703432432432,125.3847258653846,120.11504990000047,121.71499949999992,122.61320100000006,122.222501,122.0691025649386,121.77967846276556,121.45307692307723,123.56396212733931,119.34219171881513,120.11504990000047,121.71499949999992,122.61320100000006,122.222501,119.20999666666668,141120816,69273292.0,32.71302446845594,1.5,2.75,1.2395255988803553,2.0371605264551307,-0.2900129148213961,-0.5647737327400364,-0.2747608179186403,11.697667441306304,-1.844532279314884,1735717021.0,2005-10-06,2005,3,279,10,1.77,119.21,120.05,119.13,1448
2005-10-07 13:30:00,119.7,120.05,119.13,119.61,121.98433189189188,125.3990528846154,120.10969995000048,121.73529949999993,122.51400080000003,121.9730005,121.97266717023511,121.57304241869268,121.26538461538492,123.55678084926005,118.9739883815098,120.10969995000048,121.73529949999993,122.51400080000003,121.9730005,119.59666666666668,75663120,70850832.8,35.9948526768416,1.5,2.75,1.216702341817473,1.0679213921674608,-0.31148210782412755,-0.6641134526987997,-0.3526313448746722,12.00136110142316,-1.6203322914953109,1811380141.0,2005-10-07,2005,4,280,10,0.77,119.59,119.71001000000001,118.3,1449
2005-10-10 13:30:00,119.67998999999999,119.71001000000001,118.3,118.60001000000001,122.04162945945944,125.41337990384615,120.09885000000048,121.73339969999994,122.41120080000003,121.68550050000002,121.84040610473569,121.2898964740553,121.08769307692341,123.7842191734776,118.39116698036919,120.09885000000048,121.73339969999994,122.41120080000003,121.68550050000002,118.87000666666664,52678608,71833532.8,31.871039643669434,1.5,2.75,1.2305100316876536,0.7333428546061986,-0.36985050489830185,-0.8149444759975495,-0.4450939710992477,12.479261628071386,-2.4269765528589056,1758701533.0,2005-10-10,2005,0,283,10,1.19,119.01,119.39,118.32001000000001,1450
2005-10-11 13:30:00,118.99001000000001,119.39,118.32001000000001,118.42998999999999,122.09892702702702,125.42770692307691,120.08839995000048,121.72479969999996,122.30680080000003,121.42400000000002,121.70666429670686,121.01752442890717,120.8638461538465,123.90104639762251,117.82664591007044,120.08839995000048,121.72479969999996,122.30680080000003,121.42400000000002,118.71333333333334,75640688,72691616.8,31.22256241510188,1.5,2.75,1.219044315138536,1.0405696190265503,-0.3938389532136111,-0.9373926626162614,-0.5435537094026504,12.420050198571234,-2.662948960302456,1683060845.0,2005-10-11,2005,1,284,10,0.9,118.86,119.13,117.41,1451
2005-10-12 13:30:00,118.39,119.13,117.41,117.5,122.15622459459459,125.44203394230769,120.07000000000048,121.70859969999994,122.16900080000003,121.13849950000004,121.54169706938501,120.68252210234456,120.56076923076954,124.0588692384868,117.06266922305224,120.07000000000048,121.70859969999994,122.16900080000003,121.13849950000004,118.01333333333332,100520496,74957872.0,27.880861077597427,1.5,2.75,1.2548268640572118,1.3410265435496889,-0.4426230729291272,-1.0968325505640593,-0.6542094776349321,12.525066350829167,-4.2067503668677615,1582540349.0,2005-10-12,2005,2,285,10,1.46,118.27,118.08,116.88,1452
2005-10-13 13:30:00,117.46001000000001,118.08,116.88,117.42998999999999,116.88,125.45636096153845,120.05034995000048,121.68509959999994,122.02320060000002,120.85249950000004,121.38045365489936,120.3727571402165,120.241537692308,124.05275272416249,116.43032266045356,120.05034995000048,121.68509959999994,122.02320060000002,120.85249950000004,117.46333,99073120,76228737.6,27.64102215125236,1.5,2.75,1.2509106594816968,1.2996820243813143,-0.4485005528923383,-1.214835168750355,-0.7663346158580167,10.398357519021346,-4.559493218424352,1483467229.0,2005-10-13,2005,3,286,10,1.03,117.48,118.81,117.56,1453
2005-10-14 13:30:00,118.12,118.81,117.56,118.67,116.770625,125.47068798076923,120.03804995000046,121.67679959999994,121.9222006,120.61099950000003,121.2741613547072,120.21058979352922,120.01999923076956,123.83604012719334,116.2039583343458,120.03804995000046,121.67679959999994,121.9222006,120.61099950000003,118.34666666666668,88654368,76890165.6,37.840355861455016,1.5,2.75,1.2601320409472898,1.1530000918609025,-0.3425522356500075,-1.1945249104205258,-0.8519726747705185,12.902573432397284,-3.2055543878014334,1572121597.0,2005-10-14,2005,4,287,10,1.06,118.18,119.27,118.45,1454
2005-10-17 13:30:00,118.77,119.27,118.45,119.11,116.66125,125.48501499999999,120.02924995000046,121.67379959999997,121.8468006,120.41199950000004,121.1892922819736,120.105771717955,119.82307615384649,123.54116165727034,116.1049906504226,120.02924995000046,121.67379959999997,121.8468006,120.41199950000004,118.94333333333331,68967808,77669871.2,41.017345959334534,1.5,2.75,1.2286940380224831,0.8879608905544316,-0.2223416844006152,-1.1298997802712876,-0.9075580958706724,13.567697184213207,-1.7406368586041905,1641089405.0,2005-10-17,2005,0,290,10,0.69,118.86,118.96001000000001,117.8,1455
2005-10-18 13:30:00,118.94,118.96001000000001,117.8,117.82001000000001,116.551875,125.49934201923077,120.01685000000047,121.65149969999996,121.75020100000002,120.20050000000003,121.05716356503343,119.88808012576881,119.45076923076954,122.91889640030364,115.98264206123545,120.01685000000047,121.65149969999996,121.75020100000002,120.20050000000003,118.19333999999998,75013312,77170680.8,35.318036448854535,1.5,2.75,1.234501606735163,0.9720441911664462,-0.20939063547005846,-1.1692963902082454,-0.9599057547381871,13.471901555969687,-1.512990052662375,1566076093.0,2005-10-18,2005,1,291,10,0.98,118.38,119.8,117.12,1456
2005-10-19 13:30:00,117.56,119.8,117.12,119.78,116.4425,125.51366903846152,120.02210000000046,121.64679969999996,121.678001,120.14400000000003,121.00707871934586,119.87778678045751,119.20000076923107,122.00104888077864,116.39895265768352,120.02210000000046,121.64679969999996,121.678001,120.14400000000003,118.90000000000002,116569184,78274249.6,47.29976404885651,1.5,2.75,1.3377514919683653,1.4892405177398214,-0.056463305348882324,-1.0304848864242901,-0.9740215810754076,15.706675023383713,0.4865771812080522,1682645277.0,2005-10-19,2005,2,292,10,2.29,118.46,119.81,117.3,1457
2005-10-20 13:30:00,119.49001000000001,119.81,117.3,117.67,116.333125,125.5279960576923,120.02040005000046,121.62869969999996,121.564801,119.96050000000004,120.87621288721463,119.66752137279491,118.82076923076956,120.9264614069734,116.71507705456571,120.02040005000046,121.62869969999996,121.564801,119.96050000000004,118.26,132087632,80648612.8,38.9375995923485,1.5,2.75,1.4214835282563396,1.6378165403484783,-0.08342681958101628,-1.078305105551678,-0.9948782859706616,18.740968329879173,-1.6219379650530874,1550557645.0,2005-10-20,2005,3,293,10,2.14,118.56,118.78,117.50998999999999,1458
2005-10-21 13:30:00,118.28998999999999,118.78,117.50998999999999,118.13,116.22375,125.54232307692308,120.01800005000048,121.60499969999996,121.45100079999999,119.79500000000004,120.76851826418662,119.52109076586204,118.58307692307724,120.19043386715126,116.97571997900324,120.01800005000048,121.60499969999996,121.45100079999999,119.79500000000004,118.13999666666665,96580624,82509208.8,41.371100605650845,1.5,2.75,1.4106639905237441,1.1705435721012514,-0.05752741540914785,-1.0667875552320965,-1.0092601398229486,18.785898633349152,-0.396298448878716,1647138269.0,2005-10-21,2005,4,294,10,1.08,118.14,120.09,118.41,1459
2005-10-24 13:30:00,118.44,120.09,118.41,119.96001000000001,116.114375,125.55665009615385,120.02560010000046,121.59699989999996,121.38900100000001,119.71400050000004,120.73681205774794,119.56289259768472,118.60846230769265,120.28987265544761,116.92705195993764,120.02560010000046,121.59699989999996,121.38900100000001,119.71400050000004,119.48666999999999,72345120,82605174.4,49.92154849821144,1.5,2.75,1.4499022769149057,0.8757940471099592,0.08770970655316968,-0.8996230066314865,-0.9873327131846562,20.342901591650907,1.2919193862973333,1719483389.0,2005-10-24,2005,0,297,10,1.42,119.25,120.24001000000001,118.94,1460
2005-10-25 13:30:00,119.72,120.24001000000001,118.94,119.72,116.005,125.5709771153846,120.02920010000048,121.59269999999997,121.30700079999998,119.62250050000004,120.69693707509116,119.57785520742901,118.64846230769264,120.40722119369026,116.889703421695,120.02920010000048,121.59269999999997,121.30700079999998,119.62250050000004,119.63333666666664,77054816,83150346.4,48.913988862066994,1.5,2.75,1.4391956857066983,0.9266926637842604,0.16782807952559975,-0.7775476137776565,-0.9453756933032562,20.37173553859524,1.8893617021276583,1642428573.0,2005-10-25,2005,1,298,10,1.09,119.59,120.53998999999999,119.19,1461
2005-10-26 13:30:00,119.50998999999999,120.53998999999999,119.19,119.37,115.895625,125.58530413461538,120.03515015000046,121.58600009999996,121.2502006,119.50750050000002,120.64490032704836,119.55805947338816,118.63000076923107,120.35266755699976,116.90733398146244,120.03515015000046,121.58600009999996,121.2502006,119.50750050000002,119.69999666666664,82692496,84349546.4,47.41123661300953,1.5,2.75,1.432823851013363,0.9803549577831516,0.19552952570574667,-0.7009637861710729,-0.8964933118768196,19.76448816581587,1.65205668500866,1559736077.0,2005-10-26,2005,2,299,10,1.13,119.86,119.37,117.92998999999999,1462
2005-10-27 13:30:00,119.2,119.37,117.92998999999999,118.10001000000001,115.78625,125.59963115384615,120.03280015000044,121.56570019999998,121.1682008,119.27950100000002,120.5451007063798,119.41919761877978,118.59153923076951,120.33733839099158,116.84574007054749,120.03280015000044,121.56570019999998,121.1682008,119.27950100000002,118.46666666666664,68286816,84431605.6,42.32947666745317,1.5,2.75,1.4333371473695515,0.8087826296175518,0.12976763819763915,-0.7342837641297706,-0.8640514023274097,20.980517189217284,-0.4803151596865292,1491449261.0,2005-10-27,2005,3,300,10,1.22,118.65,119.95,118.10001000000001,1463
2005-10-28 13:30:00,118.42998999999999,119.95,118.10001000000001,119.8,115.676875,125.61395817307691,120.04370015000046,121.56460019999996,121.1204008,119.11750150000003,120.51588107083548,119.45546451222931,118.6969246153849,120.55291682744713,116.8409324033227,120.04370015000046,121.56460019999996,121.1204008,119.11750150000003,119.28333666666668,72959872,85688244.0,50.04772709434994,1.5,2.75,1.463098065414584,0.8514571963920745,0.19811350911738068,-0.6164095159306839,-0.8145230250480646,21.733980507971346,0.5792964486608998,1564409133.0,2005-10-28,2005,4,301,10,1.57,119.03,121.3,120.13,1464
2005-10-31 14:30:00,120.28998999999999,121.3,120.13,120.13,115.5675,125.62828519230769,120.05315010000044,121.56110019999996,121.0736008,118.99400100000004,120.5007484798223,119.51970598725512,118.89923230769259,120.76258786968785,117.03587674569735,120.05315010000044,121.56110019999996,121.0736008,118.99400100000004,120.52,80144880,87144732.8,51.4072566334546,1.5,2.75,1.4657339178849706,0.9196755492260802,0.2590516194157688,-0.4907085007783536,-0.7497601201941224,21.696840892995144,1.960609237768694,1644554013.0,2005-10-31,2005,0,304,10,0.97,120.72,120.89998999999999,120.22,1465
2005-11-01 14:30:00,120.58,120.89998999999999,120.22,120.49001000000001,115.458125,125.64261221153845,120.05825015000046,121.56400029999996,121.034001,118.95750150000003,120.50032736296656,119.61211589323081,119.13461846153874,120.96898439332732,117.30025252975014,120.05825015000046,121.56400029999996,121.034001,118.95750150000003,120.53666666666668,66996128,87455554.4,52.912895064035396,1.5,2.75,1.4160379237503304,0.76605915381402,0.31347694948134186,-0.35791393334244503,-0.6713908828237869,20.373167251282478,0.5927617298380339,1711550141.0,2005-11-01,2005,1,305,11,0.57,120.56,121.75,120.13,1466
2005-11-02 14:30:00,120.17,121.75,120.13,121.75,115.34875,125.65693923076924,120.07590015000044,121.57570029999997,121.02420079999999,119.06350150000004,120.5493341330463,119.8157239033993,119.3715415384618,121.64720184216615,117.09588123475744,120.07590015000044,121.57570029999997,121.02420079999999,119.06350150000004,121.21,74690880,85887039.2,57.83690553434639,1.5,2.75,1.43060664348245,0.8696408759192621,0.4176872730397696,-0.14928179152407495,-0.5669690645638445,19.07425860120432,3.4673238718449886,1786241021.0,2005-11-02,2005,2,306,11,1.35,120.94,122.66,121.75,1467
2005-11-03 14:30:00,122.14998999999999,122.66,121.75,122.27,115.239375,125.67126625,120.09975015000046,121.58980029999996,121.046601,119.21700150000004,120.61681122586802,120.04946448402794,119.61461846153874,122.35435911787724,116.87487780520023,120.09975015000046,121.58980029999996,121.046601,119.21700150000004,122.22666666666667,84900880,83076042.4,59.70948693205891,1.5,2.75,1.3934204546622748,1.0219658706322774,0.4994625618304399,0.05735913772420531,-0.4421034241062346,14.5328784089042,3.504613561330738,1871141901.0,2005-11-03,2005,3,307,11,0.75,122.2,122.46001000000001,121.55,1468
2005-11-04 14:30:00,122.39998999999999,122.46001000000001,121.55,122.11,115.13,125.68559326923076,120.12640015000046,121.60000029999996,121.057001,119.34200150000004,120.675367648383,120.24570596173956,119.94461769230794,122.77226675116995,117.11696863344595,120.12640015000046,121.60000029999996,121.057001,119.34200150000004,122.04000333333332,59156400,82250706.4,58.843506469370794,1.5,2.75,1.3588911364721123,0.7192205707305633,0.5183548220965567,0.20584010351446125,-0.31251471858209545,14.828036816325367,1.7922556025128729,1811985501.0,2005-11-04,2005,4,308,11,0.75,122.01,122.62,121.85001000000001,1469
2005-11-07 14:30:00,122.39998999999999,122.62,121.85001000000001,122.23,115.020625,125.69992028846156,120.15480015000048,121.60830039999996,121.08640120000001,119.52350100000004,120.73633362295622,120.4346863463358,120.13307923076952,123.20753177434231,117.05862668719669,120.15480015000048,121.60830039999996,121.08640120000001,119.52350100000004,122.23333666666667,46765696,81955060.8,59.32003756411919,1.5,2.75,1.3168267695812477,0.5706260912199824,0.5135303652060444,0.3293982379254601,-0.18413212728058434,12.697136998854587,2.0965586368192493,1858751197.0,2005-11-07,2005,0,311,11,0.63,122.24,122.42,121.78998999999999,1470
2005-11-08 14:30:00,121.95,122.42,121.78998999999999,122.23,114.91125,125.7142473076923,120.18155015000046,121.61700039999994,121.09720120000001,119.71350150000004,120.79490877499715,120.60566859906572,120.48384846153871,123.39010958918988,117.57758733388758,120.18155015000046,121.61700039999994,121.09720120000001,119.71350150000004,122.14666333333334,42153696,80280711.2,59.32003756411919,1.5,2.75,1.2677684288968727,0.5250787564024469,0.4852650762362317,0.4224492180147053,-0.06281585822152641,12.524622350202856,2.395911870654268,1858751197.0,2005-11-08,2005,1,312,11,0.52,122.1,122.95,121.86,1471
2005-11-09 14:30:00,122.08,122.95,121.86,122.39,114.801875,125.72857432692308,120.20735015000044,121.62690049999992,121.1240012,119.95800150000002,120.85746137205611,120.7756049229642,120.81154076923106,123.53734292575753,118.08573861270456,120.20735015000044,121.62690049999992,121.1240012,119.95800150000002,122.4,57668704,78138121.6,60.035578544713935,1.5,2.75,1.2550706839756676,0.738035453363138,0.4528940499405167,0.5033017042041195,0.05040765426360276,12.136355839719815,3.6325060429715488,1916419901.0,2005-11-09,2005,2,313,11,0.89,122.4,123.86,121.75,1472
2005-11-10 14:30:00,122.34,123.86,121.75,123.34,114.6925,125.74290134615386,120.23690020000043,121.64560049999994,121.13920120000002,120.25350200000004,120.95481582805391,121.01983302553906,121.07154000000028,124.05542998402548,118.08765001597506,120.23690020000043,121.64560049999994,121.13920120000002,120.25350200000004,122.98333333333332,79143376,77141634.4,64.07600245605725,1.5,2.75,1.3161370636916914,1.0259489135221125,0.4690302869843709,0.6366955129940663,0.1676652260096955,9.019315147953336,2.9549248747913244,1995563277.0,2005-11-10,2005,3,314,11,1.73,122.8,123.84,122.42998999999999,1473
2005-11-11 14:30:00,123.35001000000001,123.84,122.42998999999999,123.75998999999999,114.583125,125.75722836538459,120.26855020000043,121.66750029999996,121.1646008,120.50800150000002,121.06482265832628,121.28080035644008,121.38230846153871,124.57278948258785,118.1918274404896,120.26855020000043,121.66750029999996,121.1646008,120.50800150000002,123.34332666666666,34867008,74452266.4,65.72576413475676,1.5,2.75,1.3228422734279992,0.4683135878318944,0.4798310338388037,0.7674540183082001,0.28762298446939644,6.418811297421288,3.0217181386830987,2030430285.0,2005-11-11,2005,4,315,11,1.15,123.13,124.02,123.38,1474
2005-11-14 14:30:00,123.75998999999999,124.02,123.38,123.69,114.47375,125.77155538461538,120.29620020000044,121.70580029999996,121.19300079999998,120.73700150000002,121.16777078937231,121.51024794154104,121.71461615384639,124.89739604110694,118.53183626658584,120.29620020000044,121.70580029999996,121.19300079999998,120.73700150000002,123.69666666666666,45092800,73258516.0,65.18849825983453,1.5,2.75,1.2740678253259994,0.6155298040708332,0.4543583949072833,0.8555709781035006,0.4012125831962173,6.7843847201247005,2.655813540060292,1985337485.0,2005-11-14,2005,0,318,11,0.52,123.7,124.09,122.86,1475
2005-11-15 14:30:00,123.58,124.09,122.86,123.24001000000001,114.364375,125.78588240384614,120.31785025000043,121.74840039999997,121.183801,121.00800150000002,121.24903507214205,121.6749871852038,122.11000076923101,124.60010161367269,119.61989992478935,120.31785025000043,121.74840039999997,121.183801,121.00800150000002,123.39667,69592496,72987475.2,61.69656335811803,1.5,2.75,1.2709201235169998,0.9534854549948866,0.3821993313817717,0.8789617474234319,0.4967624160416602,7.755625636834423,1.2238275154004092,1915744989.0,2005-11-15,2005,1,319,11,1.0,123.48,123.55,122.98,1476
2005-11-16 14:30:00,123.37,123.55,122.98,123.49001000000001,114.255,125.80020942307692,120.33895030000043,121.79180059999996,121.17540120000001,121.193502,121.33691644186196,121.84784650089868,122.39384769230793,124.58984973369913,120.19784565091679,120.33895030000043,121.79180059999996,121.17540120000001,121.193502,123.34000333333334,51133904,69715711.2,62.886035671770465,1.5,2.75,1.220854400408642,0.7334631336300561,0.3283614356428316,0.9072142105951996,0.5788527749523681,5.7780887036654445,0.9977999509282752,1966878893.0,2005-11-16,2005,2,320,11,0.46,123.26,124.64998999999999,123.14,1477
2005-11-17 14:30:00,123.75,124.64998999999999,123.14,124.64,114.145625,125.81453644230768,120.36735025000046,121.83670069999997,121.19820120000001,121.542002,121.46644913041641,122.11376588176546,122.74077076923102,124.81837677891579,120.66316475954626,120.36735025000046,121.83670069999997,121.19820120000001,121.542002,124.14333,55717504,65897204.8,67.83425508294974,1.5,2.75,1.2415069432365964,0.845521508372082,0.34551602151677685,1.0107478018483391,0.6652317803315623,7.212136557307781,2.0719023830972083,2022596397.0,2005-11-17,2005,3,321,11,1.23,123.89,125.756,124.33,1478
2005-11-18 14:30:00,125.03998999999999,125.756,124.33,125.13,114.03625,125.82886346153845,120.39185025000046,121.88970069999992,121.208801,121.892002,121.61011779196869,122.40102627397829,123.0976930769233,125.09883338382019,121.09655277002649,120.39185025000046,121.88970069999992,121.208801,121.892002,125.07200000000002,72437184,64690032.8,69.6886554452106,1.5,2.75,1.2546850187196967,1.119758034811199,0.3633615269278757,1.119433688991407,0.7560721620635312,6.976731680800191,2.3725762905996817,2095033581.0,2005-11-18,2005,4,322,11,1.15,125.04,125.91,124.98,1479
2005-11-21 14:30:00,125.14998999999999,125.91,124.98,125.75998999999999,113.926875,125.84319048076921,120.42030015000046,121.95550069999994,121.2370006,122.182001,121.77285787855816,122.72092758121843,123.40615384615411,125.69656542439662,121.11574226791159,120.42030015000046,121.95550069999994,121.2370006,122.182001,125.54999666666669,50021200,63573836.8,71.92935936267908,1.5,2.75,1.2314932316682892,0.7868205305488185,0.3888102567750713,1.2420849830323704,0.853274726257299,7.051793053186872,2.8879898551910315,2145054781.0,2005-11-21,2005,0,325,11,0.74,125.44,126.52,125.42,1480
2005-11-22 14:30:00,125.56,126.52,125.42,126.3,113.8175,125.8575175,120.45075010000046,122.02320069999992,121.2898006,122.51100100000004,121.95039286371274,123.06179162110242,123.7161538461541,126.36966541750336,121.06264227480484,120.45075010000046,122.02320069999992,121.2898006,122.51100100000004,126.08,66439872,63043089.6,73.72250693309294,1.5,2.75,1.2221008579776966,1.0538803288600247,0.4110619853155282,1.3671022079017092,0.9560402225861808,6.844961502269328,3.1947054497916474,2211494653.0,2005-11-22,2005,1,326,11,0.88,125.97,127.41,126.21001000000001,1481
2005-11-23 14:30:00,126.25,127.41,126.21001000000001,127.03,113.708125,125.87184451923076,120.48935010000044,122.08860059999995,121.3662004,122.89400100000003,122.14959314356716,123.43971622861643,124.09461538461564,127.10349799230518,121.08573277692612,120.48935010000044,122.08860059999995,121.3662004,122.89400100000003,126.88333666666664,50854704,61451200.0,75.95831421268635,1.5,2.75,1.22052151097929,0.8275624235165464,0.4413312475286839,1.507704281997036,1.066373034468352,6.853839273196763,2.991730176747201,2262349357.0,2005-11-23,2005,2,327,11,0.95,126.81,127.22,126.81,1482
2005-11-25 14:30:00,126.98,127.22,126.81,127.13,113.59875,125.88617153846155,120.52630005000044,122.16510059999992,121.4458006,123.34550050000004,122.34490321636845,123.79117182589107,124.47153846153871,127.6731396682046,121.2699372548728,120.52630005000044,122.16510059999992,121.4458006,123.34550050000004,127.05333333333333,15270000,58800359.2,76.25634412036865,1.5,2.75,1.1626271173379121,0.25969229113144604,0.43382796838928095,1.608657994954953,1.174830026565672,6.518021639037513,2.7230205820152324,2277619357.0,2005-11-25,2005,4,329,11,0.32,127.02,127.27,126.03998999999999,1483
2005-11-28 14:30:00,127.25,127.27,126.03998999999999,126.23,113.489375,125.9004985576923,120.55360005000044,122.22790059999993,121.5004006,123.66700050000004,122.49725995298144,124.0234411758062,124.77923076923102,127.82504689116834,121.7334146472937,120.55360005000044,122.22790059999993,121.5004006,123.66700050000004,126.51333000000001,54503296,57877530.4,68.07693185127074,1.5,2.75,1.1674401803852033,0.9417004426989166,0.33823648088489344,1.5976256276717888,1.2593891467868956,8.710336620033075,2.0535208990217533,2223116061.0,2005-11-28,2005,0,332,11,0.98,126.65,126.98,126.09,1484
2005-11-29 14:30:00,126.64998999999999,126.98,126.09,126.09,113.38,125.91482557692308,120.58065010000044,122.27560049999992,121.56040060000001,123.96500050000004,122.6381517195312,124.2202563019199,125.0638461538464,127.8432678918664,122.2844244158264,120.58065010000044,122.27560049999992,121.56040060000001,123.96500050000004,126.38666666666666,51809504,56460761.6,66.87527108138892,1.5,2.75,1.1476230246434032,0.9176196447197764,0.2401745898052172,1.5596073840434173,1.3194327942381998,8.773632182404194,2.3125525549697743,2171306557.0,2005-11-29,2005,1,333,11,0.71,126.54,126.52,125.28998999999999,1485
2005-11-30 14:30:00,126.16,126.52,125.28998999999999,125.41,113.270625,125.92915259615386,120.60205010000044,122.31030049999993,121.62760060000001,124.21100000000004,122.74685165209858,124.33356522554656,125.22307692307716,127.82043778029688,122.62571606585745,120.60205010000044,122.31030049999993,121.62760060000001,124.21100000000004,125.73999666666666,56075392,55914724.8,61.22253418894896,1.5,2.75,1.153507808597445,1.0028734327241111,0.1106959190601824,1.457802693063428,1.3471067740032456,9.22827218803717,1.5547735399810871,2115231165.0,2005-11-30,2005,2,334,11,0.98,125.9,127.03,125.98,1486
2005-12-01 14:30:00,126.02,127.03,125.98,126.69,113.16125,125.94347961538462,120.62945005000044,122.35460059999993,121.74320059999998,124.45800000000004,122.90148492064372,124.55798758501835,125.44846230769257,128.0070845127576,122.8898401026275,120.62945005000044,122.35460059999993,121.74320059999998,124.45800000000004,126.56666666666666,65510800,55455720.8,66.89500737837307,1.5,2.75,1.1868286794119136,1.1813172573531856,0.09314362803047938,1.4635363090413451,1.3703926810108655,10.417882772305203,1.6447368421052608,2180741965.0,2005-12-01,2005,3,335,12,0.83,126.5,127.08,126.5,1487
2005-12-02 14:30:00,126.77,127.08,126.5,126.85001000000001,113.051875,125.95780663461538,120.66255010000044,122.39880079999992,121.85340079999996,124.68700050000004,123.0563290414028,124.77627543406422,125.69154000000027,128.1334999927174,123.24958000728313,120.66255010000044,122.39880079999992,121.85340079999996,124.68700050000004,126.81000333333333,46724704,53546912.0,67.53435766911525,1.5,2.75,1.143483773739634,0.8725938108251695,0.0749773050631608,1.4641143123398166,1.3891370072766558,9.506125343573569,1.3745784384240407,2227466669.0,2005-12-02,2005,4,336,12,0.46,126.79,126.73,126.17998999999999,1488
2005-12-05 14:30:00,126.64,126.73,126.17998999999999,126.58,112.9425,125.97213365384614,120.69350010000043,122.43550079999993,121.9562008,124.91050050000004,123.19451221624978,124.94805872605812,125.94846230769257,127.97152486514128,123.92539975024384,120.69350010000043,122.43550079999993,121.9562008,124.91050050000004,126.49666333333332,59367104,53557447.2,65.24450918334043,1.5,2.75,1.109664932758231,1.1084752374082534,0.029764667202019087,1.4263428412791797,1.3965781740771606,9.635077740094456,0.6520436269118631,2168099565.0,2005-12-05,2005,0,339,12,0.44,126.45,127.74001000000001,126.63,1489
2005-12-06 14:30:00,127.05,127.74001000000001,126.63,126.82001000000001,112.833125,125.98646067307692,120.73460010000043,122.47530089999992,122.061001,125.14000100000004,123.33668859992625,125.12633979976684,126.2046161538464,127.68932355158998,124.7199087561028,120.73460010000043,122.47530089999992,122.061001,125.14000100000004,127.06334,57942800,54116302.4,66.33712467410234,1.5,2.75,1.1132610089897859,1.0707087777674922,0.0024504895296124647,1.3996412859891765,1.3971907964595638,9.338756203056215,0.4117260490894689,2226042365.0,2005-12-06,2005,1,340,12,0.88,127.19,126.87,125.67998999999999,1490
2005-12-07 14:30:00,126.78998999999999,126.87,125.67998999999999,126.08,112.72375,126.00078769230768,120.76775010000046,122.51260079999993,122.151601,125.33250100000002,123.44426943914482,125.21716458074144,126.31538538461564,127.50147851490395,125.12929225432728,120.76775010000046,122.51260079999993,122.151601,125.33250100000002,126.20999666666668,66826000,55349917.6,60.06704407998942,1.5,2.75,1.11874307977623,1.2073369373904903,-0.07476159777506441,1.3037387992407332,1.3785003970157976,9.770999631688241,-0.747854837439977,2159216365.0,2005-12-07,2005,2,341,12,0.95,126.27,126.82001000000001,125.48,1491
2005-12-08 14:30:00,126.22,126.82001000000001,125.48,126.0,112.614375,126.01511471153844,120.79655005000043,122.54240079999992,122.238201,125.51300100000003,123.5444941670215,125.29172033495655,126.38230846153871,127.37586637645259,125.38875054662485,120.79655005000043,122.54240079999992,122.238201,125.51300100000003,126.10000333333332,62586704,55595817.6,59.41325612378297,1.5,2.75,1.134547859792213,1.125744825812221,-0.1369104498503353,1.2073623347028786,1.344272784553214,9.010418302289995,-0.8888539290490014,2096629661.0,2005-12-08,2005,3,342,12,1.07,126.15,126.78,125.82001000000001,1492
2005-12-09 14:30:00,126.16,126.78,125.82001000000001,126.33,112.505,126.02944173076922,120.82105010000043,122.5713007999999,122.311601,125.66250100000002,123.6537296898834,125.39060411257972,126.42615538461563,127.35413483504986,125.4981759341814,120.82105010000043,122.5713007999999,122.311601,125.66250100000002,126.31000333333333,50744704,54175884.0,61.28517322510634,1.5,2.75,1.1220794412356268,0.9366659157790576,-0.15988272361068012,1.1444193800398637,1.3043021036505438,9.188228659367311,0.07922047056959068,2147374365.0,2005-12-09,2005,4,343,12,0.76,126.3,126.86,125.96001000000001,1493
2005-12-12 14:30:00,126.71001000000001,126.86,125.96001000000001,126.45,112.395625,126.04376875,120.85015010000043,122.60860079999992,122.3798012,125.7970015,123.76338734910368,125.49149895900072,126.43769384615408,127.36283777037943,125.51254992192877,120.85015010000043,122.60860079999992,122.3798012,125.7970015,126.42333666666669,48393808,54852224.0,61.972016557603986,1.5,2.75,1.1062159097187965,0.8822579007917709,-0.17013293684294828,1.0916359325968583,1.2617688694398068,8.226371622824724,0.285510349750178,2195768173.0,2005-12-12,2005,0,346,12,0.71,126.41,127.7,126.28998999999999,1494
2005-12-13 14:30:00,126.39998999999999,127.7,126.28998999999999,127.31,112.28625,126.05809576923076,120.88055010000043,122.64630089999993,122.474001,125.97800149999999,123.90247019815844,125.66468953433396,126.45923230769256,127.44929172140199,125.4691728939831,120.88055010000043,122.64630089999993,122.474001,125.97800149999999,127.09999666666668,88650880,57030128.0,66.55189334426383,1.5,2.75,1.1279154875960251,1.554456970533189,-0.12425903728566355,1.1064450728327273,1.2307041101183909,8.984380782164298,1.51503069930628,2284419053.0,2005-12-13,2005,1,347,12,1.12,126.99,128.09,127.14,1495
2005-12-14 14:30:00,127.19,128.09,127.14,127.81,112.176875,126.07242278846155,120.91375010000047,122.6925008999999,122.605801,126.206501,124.05570666097574,125.86900481677836,126.51154000000022,127.6914724843026,125.3316075156979,120.91375010000047,122.6925008999999,122.605801,126.206501,127.68,64374896,56769248.0,68.89723307387335,1.5,2.75,1.1152072384820235,1.1339747886038585,-0.06830356424784068,1.14532465480859,1.2136282190564307,8.119234229412196,0.8840476754282142,2348793949.0,2005-12-14,2005,2,348,12,0.75,127.62,128.0,127.17998999999999,1496
2005-12-15 14:30:00,127.84,128.0,127.17998999999999,127.44,112.0675,126.0867498076923,120.94485010000044,122.73350089999992,122.76200099999998,126.4040005,124.18842404681983,126.01862340565658,126.60461692307716,127.86891147158966,125.34032237456469,120.94485010000044,122.73350089999992,122.76200099999998,126.4040005,127.53999666666668,55903104,57007708.0,65.25105271825133,1.5,2.75,1.0941217214475931,0.9806236026889557,-0.0643281245056635,1.1332180634243514,1.1975461879300149,6.572330664643107,0.465108359076992,2292890845.0,2005-12-15,2005,3,349,12,0.64,127.59,128.57001,126.36,1497
2005-12-16 14:30:00,127.27,128.57001,126.36,126.36,111.958125,126.10107682692309,120.96300010000046,122.75920099999992,122.90520099999998,126.49000050000002,124.273583888121,126.05113546226076,126.62538615384639,127.86378853182056,125.38698377587222,120.96300010000046,122.75920099999992,122.90520099999998,126.49000050000002,127.09666999999999,46239008,56533783.2,55.944286217922496,1.5,2.75,1.173828027058479,0.8179004726504842,-0.1383050862355497,1.0246648301355776,1.1629699163711271,8.353234351218108,-0.17380312845631132,2246651837.0,2005-12-16,2005,4,350,12,1.75,127.47,126.87,125.69,1498
2005-12-19 14:30:00,126.73,126.87,125.69,125.71001000000001,111.84875,126.11540384615385,120.97760020000044,122.77060099999993,123.02720119999998,126.519001,124.32991432388096,126.01864732299782,126.64846384615407,127.80380700841314,125.49312068389506,120.97760020000044,122.77060099999993,123.02720119999998,126.519001,126.09000333333334,48819504,55352899.2,51.2102079115171,1.5,2.75,1.1742688822685885,0.8819683287700312,-0.2295056495581451,0.8760878544234458,1.105593503981591,8.754300556689314,-0.8752561997117012,2197832333.0,2005-12-19,2005,0,353,12,0.94,126.28,126.59,125.48,1499
2005-12-20 14:30:00,125.86,126.59,125.48,125.83,111.739375,126.12973086538462,120.99510020000044,122.79150089999992,123.17180099999996,126.52250149999999,124.3887412131405,126.00068091128374,126.58231000000023,127.81636814987229,125.34825185012821,120.99510020000044,122.79150089999992,123.17180099999996,126.52250149999999,125.96666666666664,46604704,55182074.4,52.017417624999005,1.5,2.75,1.169678247820832,0.8445623783943867,-0.27705933386539217,0.7592693366498509,1.036328670515243,8.669172682171942,-0.19828680203045684,2244437037.0,2005-12-20,2005,1,354,12,0.88,126.04,126.75998999999999,125.8,1500
2005-12-21 14:30:00,126.17,126.75998999999999,125.8,126.03,111.63,126.14405788461538,121.02040020000044,122.81530099999996,123.32380119999998,126.5090015,124.45310430282129,126.0034732054472,126.51923230769256,127.77573320472051,125.2627314106646,121.02040020000044,122.81530099999996,123.32380119999998,126.5090015,126.19666333333332,51801200,54450140.8,53.401305138167245,1.5,2.75,1.15470051583363,0.9513510752941892,-0.2890256317289843,0.6750466308540126,0.9640722625829968,8.112373945375003,0.02380952380952471,2296238237.0,2005-12-21,2005,2,355,12,0.76,126.28,126.69,126.08,1501
2005-12-22 14:30:00,126.31,126.69,126.08,126.69,111.520625,126.15838490384616,121.04765015000042,122.83830099999996,123.50760119999997,126.4920015,124.54082570271065,126.06885670969031,126.5276938461541,127.78719561111556,125.2681920811926,121.04765015000042,122.83830099999996,123.50760119999997,126.4920015,126.48666666666666,32250496,53519930.4,57.73353709429679,1.5,2.75,1.119364764702656,0.6025885265351542,-0.24804427886984534,0.6540169139956902,0.9020611928655357,8.633567427315725,0.28496794110662504,2328488733.0,2005-12-22,2005,3,356,12,0.48,126.38,126.86,126.42,1502
2005-12-23 14:30:00,126.78998999999999,126.86,126.42,126.75998999999999,111.41125,126.17271192307692,121.07950010000042,122.85870089999996,123.69420119999997,126.47350099999998,124.62785175358476,126.13467892781506,126.52307692307718,127.77869272949378,125.26746111666056,121.07950010000042,122.85870089999996,123.69420119999997,126.47350099999998,126.67999666666664,27977296,54155295.2,58.1775789002376,1.5,2.75,1.0708387100810377,0.5166123810548446,-0.213112391282815,0.6356707037620168,0.8487830950448318,8.533456349207269,0.2451482799525497,2356466029.0,2005-12-23,2005,4,357,12,0.35,126.64,127.05,125.38,1503
2005-12-27 14:30:00,126.92,127.05,125.38,125.47,111.301875,126.1870389423077,121.10115010000044,122.87620089999996,123.83020119999998,126.43550099999996,124.6608771750128,126.07137617278505,126.47615384615412,127.83577898595622,125.116528706352,121.10115010000044,122.87620089999996,123.83020119999998,126.43550099999996,125.96666666666668,44500704,53655165.6,48.139233027287986,1.5,2.75,1.113635945075249,0.8293834060965045,-0.2701083987910537,0.5111475965560146,0.7812559953470684,10.435130511163058,-1.4452910219150132,2311965325.0,2005-12-27,2005,1,361,12,1.33,126.22,125.99001000000001,125.5,1504
2005-12-28 14:30:00,125.73,125.99001000000001,125.5,125.75,111.1925,126.20136596153844,121.12920010000043,122.90490089999996,123.96300119999998,126.41850099999996,124.70358787403192,126.04076891823411,126.45692307692335,127.84961343660406,125.06423271724265,121.12920010000043,122.90490089999996,123.96300119999998,126.41850099999996,125.74666999999998,30764304,52602905.6,50.149850033914525,1.5,2.75,1.0712340918555887,0.5848403933032931,-0.2809264794154627,0.43009789607774,0.7110243754932026,9.518283300503494,-1.6117674673343259,2342729629.0,2005-12-28,2005,2,362,12,0.39,125.75,125.96001000000001,125.06,1505
2005-12-29 14:30:00,125.72,125.96001000000001,125.06,125.19,111.083125,126.21569298076923,121.15955010000044,122.930301,124.11040099999997,126.40750099999998,124.722662859364,125.9597433069737,126.36923076923105,127.9176961443108,124.82076539415131,121.15955010000044,122.930301,124.11040099999997,126.40750099999998,125.40333666666668,33033600,51450816.0,46.28489555281761,1.5,2.75,1.059003799580189,0.6420422953058703,-0.3152005777564965,0.3170236532975821,0.6322242310540785,9.063704772661742,-1.7655367231638417,2309696029.0,2005-12-29,2005,3,363,12,0.72,125.51,125.06,124.36,1506
2005-12-30 14:30:00,124.8,125.06,124.36,124.50998999999999,124.36,126.23002,121.18530005000042,122.94150090000001,124.20500079999997,126.29850049999996,124.71432274723207,125.82167156345241,126.2199992307695,128.05583173530698,124.38416672623201,121.18530005000042,122.94150090000001,124.20500079999997,126.29850049999996,124.64333,44646096,50407580.8,42.04725293282589,1.5,2.75,1.0426463853244612,0.8857020172648318,-0.3693201006729713,0.17057410521286442,0.5398942058858357,9.264031262125926,-1.4640788224121537,2265049933.0,2005-12-30,2005,4,364,12,0.56,124.71,127.0,124.39,1507
2006-01-03 14:30:00,125.10001000000001,127.0,124.39,126.7,124.49851851851852,126.24434701923077,121.22610010000042,122.9752009,124.38560079999996,126.29099999999997,124.79219244341905,125.90532189074264,126.17307615384644,127.92430334421205,124.42184896348084,121.22610010000042,122.9752009,124.38560079999996,126.29099999999997,126.03,73388816,51740786.4,56.01448143472096,1.5,2.75,1.1546002149441426,1.4183939036535402,-0.2490415896988387,0.2285922187622873,0.477633808461126,13.778061120695552,0.7875188300438493,2338438749.0,2006-01-03,2006,1,3,1,2.1,125.7,127.49001000000001,126.7,1508
2006-01-04 14:30:00,126.86,127.49001000000001,126.7,127.3,124.63703703703705,126.25867403846155,121.27210005000043,123.01000079999999,124.56900079999996,126.32699999999996,124.89053783779478,126.0381483773386,126.13384538461568,127.75462574457754,124.5130650246538,121.27210005000043,123.01000079999999,124.56900079999996,126.32699999999996,127.16333666666668,52243200,51384591.2,58.934610162734344,1.5,2.75,1.1285580567338462,1.0167094605590634,-0.1266620755173829,0.3193062140643974,0.4459682895817803,13.5192978591081,1.1682428673607241,2390681949.0,2006-01-04,2006,2,4,1,0.62,127.1,127.59,126.88,1509
2006-01-05 14:30:00,127.17,127.59,126.88,127.38,124.77555555555556,126.2730010576923,121.32450010000042,123.05320079999998,124.71740059999996,126.3549995,124.98816380494007,126.165943769973,126.12923000000029,127.73538198941736,124.5230780105832,121.32450010000042,123.05320079999998,124.71740059999996,126.3549995,127.28333333333336,47310496,50852976.0,59.32237753325892,1.5,2.75,1.098661052681429,0.9303387868588064,-0.04227752627868625,0.3931213817334225,0.4353989080121087,13.523250682018242,1.0711735301118737,2437992445.0,2006-01-05,2006,3,5,1,0.56,127.24,128.58,127.36,1510
2006-01-06 14:30:00,128.03999,128.58,127.36,128.44,124.91407407407408,126.28732807692309,121.38170010000042,123.0994007,124.89180059999997,126.4729995,125.12352993023657,126.3825205537851,126.2892300000003,128.31504090260756,124.26341909739307,121.38170010000042,123.0994007,124.89180059999997,126.4729995,128.1266666666667,62892608,50656306.4,64.15246671965191,1.5,2.75,1.1073281203470424,1.2415553456143815,0.07650660708428247,0.5310321668674618,0.4545255597831793,14.120889016882279,1.381324492856579,2500885053.0,2006-01-06,2006,4,6,1,0.96,127.97,129.06,128.38,1511
2006-01-09 14:30:00,128.42,129.06,128.38,128.77,125.0525925925926,126.30165509615385,121.43985010000044,123.1650006,125.07980059999996,126.61149950000001,125.26652875650178,126.60989954866272,126.52461384615414,128.9063493905856,124.14287830172266,121.43985010000044,123.1650006,125.07980059999996,126.61149950000001,128.73666666666668,43532704,49703606.4,65.52492018160311,1.5,2.75,1.076804683179397,0.8758459828782162,0.16386360417316076,0.6593550649996303,0.4954914608264695,13.973600957759366,1.5856817281225792,2544417757.0,2006-01-09,2006,0,9,1,0.53,128.72,128.98,128.25999,1512
2006-01-10 14:30:00,128.39,128.98,128.25999,128.89999,125.19111111111113,126.3159821153846,121.49780005000042,123.23200049999998,125.29580019999996,126.73999899999998,125.4090174327174,126.82800340117102,126.7607669230772,129.41355034107596,124.1079835050785,121.49780005000042,123.23200049999998,125.29580019999996,126.73999899999998,128.71332666666666,44961392,49414440.8,66.07588961444404,1.5,2.75,1.051319348666583,0.9098836549011398,0.21380563371196948,0.7627485029664314,0.5489428692544619,13.96321132271748,2.73371323822428,2589379149.0,2006-01-10,2006,1,10,1,0.56,128.62,129.44,128.73,1513
2006-01-11 14:30:00,129.02,129.44,128.73,129.31,125.32962962962965,129.44,121.56170005000044,123.3032005,125.48600019999996,126.882999,125.5619971412383,127.06438402963093,127.01307461538492,129.94869638456427,124.07745284620556,121.56170005000044,123.3032005,125.48600019999996,126.882999,129.16,49603904,49474945.6,67.8226818710192,1.5,2.75,1.0269393951903991,1.002606539500672,0.2550615586596099,0.8677698175789743,0.6127082589193644,11.727020931679045,2.8310139165009964,2638983053.0,2006-01-11,2006,2,11,1,0.55,129.08,129.28,128.44,1514
2006-01-12 14:30:00,129.08,129.28,128.44,128.8,125.46814814814816,129.48234225225224,121.61480010000042,123.3665005,125.65940019999996,126.957499,125.68897764550344,127.22968078871368,127.17538230769259,130.25156126619265,124.0992033491925,121.61480010000042,123.3665005,125.65940019999996,126.957499,128.84,40509296,47067866.4,63.446448084652225,1.5,2.75,1.015729438391085,0.860657155260388,0.2294162719946635,0.8994785989126939,0.6700623269180304,12.394237072342616,2.883616902308502,2598473757.0,2006-01-12,2006,3,12,1,0.65,128.86,128.89999,128.2,1515
2006-01-13 14:30:00,128.57001,128.89999,128.2,128.67999,125.60666666666668,129.5246845045045,121.66840000000043,123.4286004,125.82319979999994,127.0009985,125.80627224764058,127.36780547550283,127.32307461538493,130.48837078614272,124.15777844462707,121.66840000000043,123.4286004,125.82319979999994,127.0009985,128.59332666666668,44858896,46092066.4,62.4256945742867,1.5,2.75,0.9931766213631515,0.9732454954547232,0.18754833490882966,0.9044977455540676,0.7169494106452378,11.833465391719267,3.349128853034204,2553614861.0,2006-01-13,2006,4,13,1,0.55,128.55,128.42,127.81,1516
2006-01-17 14:30:00,128.2,128.42,127.81,128.33,125.74518518518518,129.56702675675677,121.72290005000043,123.4895003,125.95479979999996,127.0454985,125.9052419634194,127.4594430492645,127.54307461538491,130.55652588022292,124.52962335054691,121.72290005000043,123.4895003,125.95479979999996,127.0454985,128.1866666666667,52181600,45905991.2,59.423132508114406,1.5,2.75,0.9843775769800692,1.1367056594564935,0.12260289435249995,0.8702030285858626,0.7476001342333627,11.232716967145288,1.2865035516969294,2501433261.0,2006-01-17,2006,1,17,1,0.48,128.12,128.89999,127.16,1517
2006-01-18 14:30:00,127.58,128.89999,127.16,127.82001000000001,125.8837037037037,129.609369009009,121.77385010000044,123.5562005,126.06579999999994,127.118499,125.9803309060304,127.49378275885833,127.70230615384642,130.5331719339974,124.87144037369544,121.77385010000044,123.5562005,126.06579999999994,127.118499,127.96,75066496,47347365.6,55.2527738728121,1.5,2.75,1.0383498929100647,1.5854418730321083,0.03610720601054973,0.7927341417465499,0.7566269357360002,7.176277541635772,0.40849175176747776,2426366765.0,2006-01-18,2006,2,18,1,1.37,128.03,128.77,127.81,1518
2006-01-19 14:30:00,128.09,128.77,127.81,128.31,126.02222222222224,129.65171126126128,121.82445010000043,123.6234005,126.18979999999996,127.2484985,126.07169047834292,127.57151773420514,127.94230615384642,130.3825875412818,125.50202476641104,121.82445010000043,123.6234005,126.18979999999996,127.2484985,128.29666666666668,78049184,48808849.6,58.28212933003086,1.5,2.75,1.0327534719879181,1.5990785408718176,0.004372578602642396,0.7620926589893031,0.7577200803866607,7.017340886357425,0.7300989166274194,2504415949.0,2006-01-19,2006,3,19,1,0.75,128.29,128.31,125.97,1519
2006-01-20 14:30:00,128.28,128.31,125.97,125.97,126.16074074074074,129.6940535135135,121.86130005000048,123.67550059999998,126.26459999999996,127.25549850000002,126.06770261644712,127.41899223570944,128.05461461538488,129.91917387200073,126.19005535876906,121.86130005000048,123.67550059999998,126.26459999999996,127.25549850000002,126.75,115312000,52244214.4,43.23039242277752,1.5,2.75,1.1261282239887809,2.207172628094873,-0.17198861152063416,0.542734315985868,0.7147229275065021,13.05770132836656,-1.9230769230769225,2389103949.0,2006-01-20,2006,4,20,1,1.86,127.14,126.82001000000001,126.13,1520
2006-01-23 14:30:00,126.21001000000001,126.82001000000001,126.13,126.42,126.29925925925926,129.73639576576576,121.89720000000044,123.72280059999996,126.34839999999998,127.27499850000001,126.08151820011587,127.32385011802285,128.03307615384642,129.96498174040732,126.10117056728552,121.89720000000044,123.72280059999996,126.34839999999998,127.27499850000001,126.45667,67094816,53008895.2,46.11256549345364,1.5,2.75,1.1064054937038679,1.265727492468094,-0.2513105053757856,0.4005847957867701,0.6518953011625557,12.059355958008759,-1.8249592296342383,2456198765.0,2006-01-23,2006,0,23,1,0.55,126.48,127.14998999999999,126.42,1521
2006-01-24 14:30:00,126.63,127.14998999999999,126.42,126.55,126.43777777777778,129.778738018018,121.93995000000044,123.77780059999998,126.43159999999996,127.2679985,126.09989003540545,127.25015010678257,127.97538384615412,130.03216904379497,125.91859864851328,121.93995000000044,123.77780059999998,126.43159999999996,127.2679985,126.70666333333332,53013904,54047065.6,46.95048272602679,1.5,2.75,1.0795186727250203,0.9808840389662152,-0.2855007284895817,0.2950193905505785,0.5805201190401602,11.897224830338912,-1.8231110801482648,2509212669.0,2006-01-24,2006,1,24,1,0.58,126.78,127.17998999999999,125.84,1522
2006-01-25 14:30:00,127.03998999999999,127.17998999999999,125.84,126.66,126.57629629629628,129.8210802702703,121.98280000000044,123.81860059999997,126.49799999999998,127.262999,126.1218551320562,127.19394533470805,127.91999923076948,130.07439103859582,125.76560742294319,121.98280000000044,123.81860059999997,126.49799999999998,127.262999,126.55999666666666,87790624,57037732.0,47.69165406629977,1.5,2.75,1.098123767530376,1.539167511078456,-0.29023662610142176,0.21772433641338296,0.5079609625148047,11.885677085555336,-2.0493387982368003,2597003293.0,2006-01-25,2006,2,25,1,1.06,126.51,127.67,126.75998999999999,1523
2006-01-26 14:30:00,127.28,127.67,126.75998999999999,127.36,126.71481481481482,129.8634225225225,122.02610000000044,123.86730049999998,126.57000019999998,127.357499,126.17040983275987,127.20976006473585,127.83692230769256,129.98798919589206,125.68585541949305,122.02610000000044,123.86730049999998,126.57000019999998,127.357499,127.26333,71360816,58380737.6,52.26240690613845,1.5,2.75,1.091829212706778,1.2223349504237848,-0.2379489299030896,0.2105248001359428,0.4484737300390324,12.30710830830681,-1.1180124223602577,2668364109.0,2006-01-26,2006,3,26,1,0.72,127.21,128.66,127.45,1524
2006-01-27 14:30:00,127.66,128.66,127.45,128.53999,126.85333333333334,129.90576477477478,122.08229995000043,123.93000039999997,126.667,127.49699850000002,126.26333454520065,127.33644862999908,127.81922923076948,129.9429153641323,125.6955430974067,122.08229995000043,123.93000039999997,126.667,127.49699850000002,128.21666333333334,65790880,60132066.4,58.79819500277709,1.5,2.75,1.1066985546562935,1.0941064217277592,-0.12148678307196875,0.2966152511990714,0.41810203427104015,13.60466319822115,-0.10879702430814206,2734154989.0,2006-01-27,2006,4,27,1,0.95,128.06,128.81,128.35001,1525
2006-01-30 14:30:00,128.44,128.81,128.35001,128.44,126.99185185185185,129.94810702702702,122.14564995000043,123.97740039999996,126.77099979999996,127.6594985,126.34869397480064,127.44154876047537,127.78384538461565,129.84884122142455,125.71884954780676,122.14564995000043,123.97740039999996,126.77099979999996,127.6594985,128.53333666666666,33710192,60165896.0,58.072637362655314,1.5,2.75,1.0605050864665588,0.5602873760909336,-0.052314912411835945,0.3527083937562452,0.4050233061680811,13.601932720493533,0.08571651211718632,2700444797.0,2006-01-30,2006,0,30,1,0.36,128.58,128.53999,127.49001000000001,1526
2006-01-31 14:30:00,128.32001,128.53999,127.49001000000001,127.5,127.13037037037034,129.9904492792793,122.21240000000044,124.01330039999998,126.85119959999996,127.808999,126.3938432306908,127.44711554519199,127.64461461538488,129.5140520436846,125.77517718708515,122.21240000000044,124.01330039999998,126.85119959999996,127.808999,127.84333333333332,73131184,61590150.4,51.62337178870655,1.5,2.75,1.0597532945760897,1.1873844035945071,-0.06989801396776307,0.3176507887083773,0.3875488026761403,14.162966524461114,-0.25035986149586154,2627313613.0,2006-01-31,2006,1,31,1,0.82,128.01,128.42999,127.72,1527
2006-02-01 14:30:00,127.82001000000001,128.42999,127.72,128.39,127.26888888888891,130.03279153153153,122.28185000000043,124.06220039999997,126.92619959999996,127.89349900000002,126.47212388831078,127.53691406469751,127.61307615384642,129.41613690071458,125.81001540697828,122.28185000000043,124.06220039999997,126.92619959999996,127.89349900000002,128.17999666666665,63562896,61098854.4,56.54415005864372,1.5,2.75,1.050484487820655,1.0403287692412118,-0.023990079648289142,0.3575612031157789,0.381551282764068,14.604037599335625,0.062348998519198874,2690876509.0,2006-02-01,2006,2,32,2,0.56,128.07,128.14,126.8,1528
2006-02-02 14:30:00,128.10001,128.14,126.8,126.89998999999999,127.4074074074074,130.07513378378377,122.33929995000044,124.08520019999996,126.96159939999997,127.8734985,126.48890295151428,127.47625462996444,127.47615307692335,129.20307161455628,125.74923453929041,122.33929995000044,124.08520019999996,126.96159939999997,127.8734985,127.27999666666666,83628624,62668125.6,47.78139135928629,1.5,2.75,1.0890213101191788,1.3344682515923214,-0.0925257636626184,0.265894078185795,0.3584198418484134,15.935396762936607,0.7382630785107595,2607247885.0,2006-02-02,2006,3,33,2,1.06,127.47,128.39,126.14,1529
2006-02-03 14:30:00,126.58,128.39,126.14,126.27,127.54592592592593,130.11747603603607,122.40164995000043,124.10440009999996,126.97179959999998,127.81799850000002,126.48031852204313,127.36137323663448,127.31769153846182,129.0798252733187,125.55555780360494,122.40164995000043,124.10440009999996,126.97179959999998,127.81799850000002,126.93333333333332,86042496,64604725.6,44.63198614659815,1.5,2.75,1.171948359396379,1.3318297570479891,-0.17410438453349336,0.14078936118154672,0.3148937457150401,11.982500230803401,-0.11865211200759825,2521205389.0,2006-02-03,2006,4,34,2,1.78,127.26,126.8,126.17,1530
2006-02-06 14:30:00,126.44,126.8,126.17,126.60001000000001,127.68444444444445,130.15981828828828,122.45460005000044,124.13380019999997,126.97779979999996,127.725999,126.48501230549242,127.28886245219309,127.22384538461569,128.99887521054706,125.44881555868429,122.45460005000044,124.13380019999997,126.97779979999996,127.725999,126.52333666666668,45513392,63735764.8,46.61694408777074,1.5,2.75,1.1332377622966376,0.7140950162411795,-0.19791980305902868,0.06749399189125428,0.2654137949502829,11.897828815392387,0.039517977084156726,2566718781.0,2006-02-06,2006,0,37,2,0.5,126.48,126.66,125.39998999999999,1531
2006-02-07 14:30:00,126.38,126.66,125.39998999999999,125.48,127.82296296296295,130.20216054054058,122.50415000000044,124.15650009999996,126.94679979999997,127.561499,126.44560005821822,127.11658983769851,127.00615307692335,128.88601158351776,125.12629457032898,122.50415000000044,124.15650009999996,126.94679979999997,127.561499,125.84666333333332,71227632,65120511.2,41.216351755710456,1.5,2.75,1.1422929221325917,1.0937818313686702,-0.2763677114441342,-0.08004584435488482,0.19632186708924934,12.939750720289512,-0.9316279804200164,2495491149.0,2006-02-07,2006,1,38,2,1.0,126.03,128.10001,125.60001000000001,1532
2006-02-08 14:30:00,125.88,128.10001,125.60001000000001,126.62,127.96148148148147,130.2445027927928,122.55560000000042,124.19120019999997,126.93659979999997,127.4474995,126.45243927162142,127.06929556744151,127.05615307692335,128.85598828439268,125.25631786945408,122.55560000000042,124.19120019999997,126.93659979999997,127.4474995,126.77333999999999,59426304,65843756.8,47.840075126947205,1.5,2.75,1.2478441419802633,0.9025351360267464,-0.2400873807570604,-0.10378735885707613,0.13630002189998427,14.129577941223388,-0.5810301507537649,2554917453.0,2006-02-08,2006,2,39,2,1.99,126.85,127.60001000000001,126.37,1533
2006-02-09 14:30:00,126.92,127.60001000000001,126.37,126.41,128.1,130.28684504504508,122.61165000000042,124.22030019999997,126.94019979999996,127.30249950000001,126.45077498645979,127.00650551339949,127.05538384615411,128.85631415146037,125.2544535408479,122.61165000000042,124.22030019999997,126.94019979999996,127.30249950000001,126.79333666666666,62024304,66464776.8,46.794065795581595,1.5,2.75,1.2465702746959584,0.9331905858442604,-0.21940612580832514,-0.13795763536042216,0.08144849044790299,13.693836176057351,-1.6570640778795709,2492893149.0,2006-02-09,2006,3,40,2,0.97,126.99,127.13,125.45,1534
2006-02-10 14:30:00,126.42998999999999,127.13,125.45,126.64,128.23851851851853,130.3291872972973,122.6666000500004,124.25580019999997,126.95119979999998,127.19449949999998,126.45819557522607,126.97160022640905,127.06230692307722,128.8560906520567,125.26852319409772,122.6666000500004,124.25580019999997,126.95119979999998,127.19449949999998,126.40666666666664,64509696,67664796.8,48.13170474139441,1.5,2.75,1.2775295407891036,0.9533716060756722,-0.18100637186484386,-0.14480947438315184,0.036196897481692025,12.314027355045823,-1.401432575521642,2557402845.0,2006-02-10,2006,4,41,2,1.34,126.29,126.78998999999999,125.95,1535
2006-02-13 14:30:00,126.57001000000001,126.78998999999999,125.95,126.41,128.37703703703704,130.37152954954954,122.7276500500004,124.29940019999997,126.97119979999998,127.08099999999996,126.45630555266818,126.91811449056057,127.04307615384644,128.85892441799595,125.22722788969696,122.7276500500004,124.29940019999997,126.97119979999998,127.08099999999996,126.38333,52309200,68037312.0,46.8629060226332,1.5,2.75,1.2462767164470248,0.7688310790408651,-0.16245755979095194,-0.16687505225699795,-0.004417492466045975,12.306532608719465,-0.8549019607843164,2505093645.0,2006-02-13,2006,0,44,2,0.67,126.37,128.03,123.64,1536
2006-02-14 14:30:00,126.46001000000001,128.03,123.64,127.75,123.64,130.4138718018018,122.7876500500004,124.36780019999996,126.9923998,127.05199999999998,126.50703866824982,126.99734168193577,127.07307615384646,128.92147184781786,125.22468045987507,122.7876500500004,124.36780019999996,126.9923998,127.05199999999998,126.47333333333334,90992496,69977856.8,54.404231324645956,1.5,2.75,1.4708283795579518,1.3003041270620908,-0.056759287049351924,-0.07536660127773588,-0.018607314228383957,13.470880042583653,-0.4984811901238309,2596086141.0,2006-02-14,2006,1,45,2,3.55,125.84,128.32001,127.24001000000001,1537
2006-02-15 14:30:00,127.66,128.32001,127.24001000000001,128.2,123.616,130.45621405405404,122.8466501000004,124.43640019999997,127.0193996,127.07099949999996,126.57342930871063,127.11188056937044,127.04692307692336,128.819628173937,125.27421797990976,122.8466501000004,124.43640019999997,127.0193996,127.07099949999996,127.92000666666668,85473504,70498207.2,56.630251897950366,1.5,2.75,1.4429120667323836,1.2124209592666066,0.04135334625660286,0.03308436859236963,-0.008268977664233238,12.975979993953588,1.024436644951655,2681559645.0,2006-02-15,2006,2,46,2,0.85,127.78,129.21001,128.17999,1538
2006-02-16 14:30:00,128.34,129.21001,128.17999,129.16,123.59200000000001,130.4985563063063,122.90945005000042,124.51360019999996,127.07099959999998,127.11349949999996,126.67486345346708,127.30693956276372,127.102307692308,129.0789112103379,125.12570417427813,122.90945005000042,124.51360019999996,127.07099959999998,127.11349949999996,128.85,61035392,69647517.6,61.00412975973907,1.5,2.75,1.4134197762514995,0.8763469841170621,0.16202097726718698,0.19425724391975047,0.03223626665256352,11.298709666846554,2.2887463372139067,2742595037.0,2006-02-16,2006,3,47,2,0.8,128.7,129.16,128.58,1539
2006-02-17 14:30:00,129.09,129.16,128.58,128.81,123.568,130.54089855855855,122.96600005000042,124.58590019999995,127.11079939999998,127.25549949999996,126.75859429842914,127.45008817583386,127.20307692307723,129.37447639546312,125.03167745069136,122.96600005000042,124.58590019999995,127.11079939999998,127.25549949999996,128.85,40344400,65899137.6,58.68056112982566,1.5,2.75,1.3538897922335342,0.6122143850331662,0.20652962908293146,0.2903983030062278,0.08386867392329639,10.872173185220646,1.7456475714338449,2702250637.0,2006-02-17,2006,4,48,2,0.45,128.87,129.39999,128.28999,1540
2006-02-21 14:30:00,129.12,129.39999,128.28999,128.49001,123.544,130.58324081081082,123.02115005000044,124.65530029999996,127.1589996,127.35899999999997,126.8264929533927,127.54912834956396,127.21077000000031,129.39957451336028,125.02196548664034,123.02115005000044,124.65530029999996,127.1589996,127.35899999999997,128.72666333333333,46461808,64867487.2,56.55949204422059,1.5,2.75,1.3364690927882827,0.7162572500573138,0.20241453639855125,0.3368868444214854,0.1344723080229342,11.15518620168292,2.3987966209754608,2655788829.0,2006-02-21,2006,1,52,2,0.87,128.84,129.64999,128.64999,1541
2006-02-22 14:30:00,128.77,129.64999,128.64999,129.27,123.52,130.62558306306306,123.08205005000043,124.73130029999996,127.2243996,127.49499999999996,126.92231675914199,127.71302088770074,127.39307846153878,129.82884294428376,124.95731397879379,123.08205005000043,124.73130029999996,127.2243996,127.49499999999996,129.18999333333332,42338400,64333712.0,60.32413878714966,1.5,2.75,1.3238627290176903,0.6581059709410207,0.237775552791801,0.4316917490126855,0.19391619622088446,9.20220374696864,2.092876322855793,2698127229.0,2006-02-22,2006,2,53,2,0.78,129.15,129.64,128.28,1542
2006-02-23 14:30:00,129.27,129.64,128.28,129.08,123.49600000000001,130.6679253153153,123.13835000000044,124.79550029999996,127.2793996,127.61599999999996,127.00693178819526,127.84320937458637,127.60923230769262,130.10594335893487,125.11252125645036,123.13835000000044,124.79550029999996,127.2793996,127.61599999999996,129.0,43450192,62116690.4,58.98320615159098,1.5,2.75,1.326443962659283,0.6994930302983432,0.23358131235657864,0.4858928366666078,0.2523115243100291,8.62672368058422,2.1121746697255093,2654677037.0,2006-02-23,2006,3,54,2,1.06,128.96,129.48,128.75999,1543
2006-02-24 14:30:00,129.11,129.48,128.75999,129.41,123.47200000000001,130.71026756756757,123.20239995000044,124.85920039999998,127.33859960000001,127.71849999999996,127.10116975728563,127.99242752938768,127.82538538461573,130.41981351898178,125.23095725024966,123.20239995000044,124.85920039999998,127.33859960000001,127.71849999999996,129.21666333333334,36782704,60387784.8,60.62051599869403,1.5,2.75,1.283127251040763,0.6091083506676337,0.2374672783938889,0.5491456223023903,0.3116783439085013,8.320353272097362,2.187302590018948,2691459741.0,2006-02-24,2006,4,55,2,0.56,129.12,130.03999,129.28,1544
2006-02-27 14:30:00,129.39999,130.03999,129.28,129.46001,123.448,130.75260981981978,123.26349995000044,124.92780039999998,127.3815998,127.76450099999992,127.19367329621564,128.1321972884936,128.13154000000034,130.47370224685014,125.7893777531505,123.26349995000044,124.92780039999998,127.3815998,127.76450099999992,129.59333333333333,35880096,58892245.6,60.87540238837251,1.5,2.75,1.2457603045378505,0.6092499213512754,0.2278045088931968,0.5964339800249974,0.36862947113180056,8.393616662081397,2.412791709516664,2727339837.0,2006-02-27,2006,0,58,2,0.59,129.66,129.91,128.13,1545
2006-02-28 14:30:00,129.2,129.91,128.13,128.23,123.42399999999999,130.79495207207208,123.32489995000044,124.99790039999998,127.38999979999996,127.75400099999992,127.23431355910911,128.14151183244658,128.2553861538465,130.4289441629539,126.08182814473905,123.32489995000044,124.99790039999998,127.38999979999996,127.75400099999992,128.75666666666666,74397008,60926586.4,51.9662835079416,1.5,2.75,1.2839202827851468,1.2210926689961412,0.12794909418832673,0.528565838867209,0.4006167446788823,10.6186890552286,0.375733855185902,2652942829.0,2006-02-28,2006,1,59,2,1.39,129.02,129.49001,128.5,1546
2006-03-01 14:30:00,128.60001,129.49001,128.5,129.37,123.4,130.83729432432432,123.39314995000042,125.0953004,127.42859979999996,127.84750099999992,127.31806596855586,128.25851070554694,128.48307846153878,130.4455805222937,126.52057640078388,123.39314995000042,125.0953004,127.42859979999996,127.84750099999992,129.12000333333333,48646304,59702342.4,58.08847937279067,1.5,2.75,1.2822124054433524,0.8148139929598475,0.1277541421908518,0.5603094224174471,0.4325552802265952,10.120732172869179,0.9126365054602308,2701589133.0,2006-03-01,2006,2,60,3,0.77,129.0,129.42,128.61,1547
2006-03-02 14:30:00,128.89999,129.42,128.61,129.36,123.376,130.8796365765766,123.45594995000044,125.1969004,127.48859979999996,127.89600099999993,127.39814181292618,128.3634144478758,128.69230923076952,130.38573925721906,126.99887920431999,123.45594995000044,125.1969004,127.48859979999996,127.89600099999993,129.13,60644496,59556422.4,58.01862263903725,1.5,2.75,1.2484829479116826,1.0182696266188078,0.11635316625785165,0.5779967380489097,0.4616435717910581,10.037566914774748,0.1548467017652656,2640944637.0,2006-03-02,2006,3,61,3,0.63,129.01,130.07001,128.64999,1548
2006-03-03 14:30:00,128.66,130.07001,128.64999,128.75999,123.352,130.92197882882886,123.5118499000004,125.2884003,127.54959939999998,127.98900099999994,127.45154762418396,128.4011835480781,128.87307769230802,129.93874949368194,127.80740589093399,123.5118499000004,125.2884003,127.54959939999998,127.98900099999994,129.15999666666667,73429808,59046481.6,53.835235498249645,1.5,2.75,1.2607355944894192,1.2435932846505116,0.060607877385677626,0.5374034185231551,0.4767955411374775,9.53610019865073,-0.03882462541729256,2567514829.0,2006-03-03,2006,4,62,3,1.1,129.36,129.17999,127.85001000000001,1549
2006-03-06 14:30:00,129.14,129.17999,127.85001000000001,128.17,123.32799999999999,130.9643210810811,123.5587499500004,125.3841002,127.59639939999997,128.08400099999994,127.47972222715715,128.37916606730877,128.9053853846157,129.85168648639305,127.95908428283829,123.5587499500004,125.3841002,127.59639939999997,128.08400099999994,128.39999999999998,57479104,57618312.0,50.01629406739679,1.5,2.75,1.265681623454461,0.9975839625430192,-0.01950799220808247,0.4524105508773744,0.4719185430854568,9.76698270751719,-0.2490543817375567,2510035725.0,2006-03-06,2006,0,65,3,1.04,128.52,128.06,127.39998999999999,1550
2006-03-07 14:30:00,127.92,128.06,127.39998999999999,127.97,123.304,131.00666333333334,123.6021500000004,125.47950029999998,127.63519939999998,128.15250049999992,127.49894880648432,128.34019787042223,128.88769307692334,129.89285465071666,127.88253150313007,123.6021500000004,125.47950029999998,127.63519939999998,128.15250049999992,127.80999666666666,61784704,58431877.6,48.75372764288434,1.5,2.75,1.230276507493427,1.0573800900760375,-0.08576635001968974,0.3647106055608447,0.4504769555805344,9.712428775864794,-1.0056470952270529,2448251021.0,2006-03-07,2006,1,66,3,0.52,127.73,128.44,127.17998999999999,1551
2006-03-08 14:30:00,127.7,128.44,127.17998999999999,128.24001,127.17998999999999,131.04900558558558,123.6477500500004,125.58690039999998,127.6661996,128.29050099999992,127.52801002975944,128.33065616847722,128.8169246153849,129.86409998774405,127.76974924302573,123.6477500500004,125.58690039999998,127.6661996,128.29050099999992,127.95333333333332,66705120,58205752.0,50.567931342080605,1.5,2.75,1.2324003283867528,1.1460228191880415,-0.10967529627623136,0.31338283523524524,0.4230581315114766,8.991559206093331,-0.6507514719553766,2514956141.0,2006-03-08,2006,2,67,3,0.99,127.81,128.67999,127.38,1552
2006-03-09 14:30:00,128.33,128.67999,127.38,127.38,127.41598933333334,131.09134783783784,123.68575005000042,125.68640049999996,127.6785998,128.32850099999993,127.52220571486693,128.24011748576513,128.7069246153849,130.00441061607654,127.40943861469329,123.68575005000042,125.68640049999996,127.6785998,128.32850099999993,127.81333000000001,56523600,58060616.8,45.092296734528645,1.5,2.75,1.2372281620734142,0.9735273773391948,-0.17765236962608955,0.20099266947886466,0.3786450391049542,9.617956113569964,-1.5686577544239249,2458432541.0,2006-03-09,2006,3,68,3,1.02,128.03,128.84,127.44,1553
2006-03-10 14:30:00,127.72,128.84,127.44,128.59,127.65198866666668,131.13369009009008,123.73120005000042,125.78560049999996,127.7409998,128.43750099999994,127.56408000055842,128.27343962997796,128.71461615384644,130.0080466057082,127.4211857019847,123.73120005000042,125.78560049999996,127.7409998,128.43750099999994,128.29,60491104,57983956.8,52.831218892365634,1.5,2.75,1.253140436211028,1.043238635966975,-0.13717891281976452,0.20717139808024854,0.34435031090001306,11.30005356636342,-0.6720299187370739,2518923645.0,2006-03-10,2006,4,69,3,1.1,128.14,129.16,128.53,1554
2006-03-13 14:30:00,128.84,129.16,128.53,128.83,127.88798799999999,131.17603234234235,123.77830005000044,125.88280049999996,127.8025998,128.54700099999997,127.61372392210514,128.32644537950387,128.68077000000028,129.9367829216163,127.42475707838429,123.77830005000044,125.88280049999996,127.8025998,128.54700099999997,128.84,45713296,57044136.8,54.20979375371526,1.5,2.75,1.2086304050530974,0.8013671266562141,-0.09244292564485568,0.22879665384394346,0.3212395794887991,11.380334641222632,0.4679092256102494,2564636941.0,2006-03-13,2006,0,72,3,0.49,128.84,130.23,128.61,1555
2006-03-14 14:30:00,128.71001,130.23,128.61,130.17999,128.12398733333333,131.2183745945946,123.82895000000043,126.00640029999997,127.9023996,128.73550049999997,127.71436180751276,128.50297343859873,128.7653846153849,130.2457482170081,127.2850210137617,123.82895000000043,126.00640029999997,127.9023996,128.73550049999997,129.67333,69879184,57922636.0,61.09726540718499,1.5,2.75,1.238013947549303,1.2064227187450516,0.02366726340351688,0.3508236587431952,0.32715639533967833,11.334253030692869,0.6261034242869282,2634516125.0,2006-03-14,2006,1,73,3,1.26,129.42,130.86,129.85001,1556
2006-03-15 14:30:00,130.14999,130.86,129.85001,130.75999,128.35998666666666,131.26071684684686,123.88149995000043,126.11620019999997,128.0273996,128.88599999999997,127.83379820721815,128.71792739682743,128.8692300000003,130.67051413106933,127.06794586893122,123.88149995000043,126.11620019999997,128.0273996,128.88599999999997,130.49,53407504,56043386.4,63.62849000269231,1.5,2.75,1.221726522724354,0.9529671104956642,0.12923382602156686,0.4886986778666369,0.35946485184507004,10.54655301318486,1.0822433518861891,2687923629.0,2006-03-15,2006,2,74,3,0.78,130.36,131.47,130.84,1557
2006-03-16 14:30:00,130.98,131.47,130.84,131.03,128.595986,131.47,123.93924995000044,126.24980019999997,128.1139996,129.02749999999997,127.95913945399393,128.93812478760577,128.9899984615387,131.11496582059237,126.86503110248512,123.93924995000044,126.24980019999997,128.1139996,129.02749999999997,131.11333333333334,67083632,55123892.8,64.77745762481393,1.5,2.75,1.1851753425297582,1.2169610779012328,0.2025804865664938,0.6126904600531873,0.4101099734866935,10.532993656143619,1.7629777697249072,2755007261.0,2006-03-16,2006,3,75,3,0.48,131.16,130.89999,130.38,1558
2006-03-17 14:30:00,130.67999,130.89999,130.38,130.62,128.83198533333334,131.51613636363635,123.98984995000042,126.3747002,128.18039960000002,129.10049999999998,128.0634869263863,129.09830337926238,129.1738446153849,131.41439711912452,126.93329211164526,123.98984995000042,126.3747002,128.18039960000002,129.10049999999998,130.63333,47286800,54436463.2,61.595571455404226,1.5,2.75,1.1469485323490614,0.8686604018756309,0.2080290120705092,0.6701462385748299,0.4621172265043208,10.25364550888482,1.9115237575095712,2707720461.0,2006-03-17,2006,4,76,3,0.4,130.64,130.89999,130.21001,1559
2006-03-20 14:30:00,130.64,130.89999,130.21001,130.41,129.06798466666666,131.56227272727273,124.03810000000044,126.4792001,128.2409996,129.1805,128.15550704692018,129.2232268669517,129.25384461538488,131.58897094347878,126.91871828729096,124.03810000000044,126.4792001,128.2409996,129.1805,130.50666666666666,45541200,54696303.2,59.97069646607787,1.5,2.75,1.1143079228955564,0.8326193423616972,0.1829240737912169,0.6907723187433419,0.507848244952125,9.743451817575524,1.9066968820817358,2662179261.0,2006-03-20,2006,0,79,3,0.53,130.56,130.99001,129.45,1560
2006-03-21 14:30:00,130.34,130.99001,129.45,129.59,129.303984,131.60840909090908,124.08530005000044,126.5779001,128.2639996,129.2354995,128.21176167253114,129.2581576415277,129.27153692307718,131.61308873545062,126.92998511070374,124.08530005000044,126.5779001,128.2639996,129.2354995,130.01000333333334,87404128,56743419.2,53.98241735137079,1.5,2.75,1.1447152141173038,1.5403394654793732,0.10063916278536766,0.6336471984338345,0.5330080356484669,10.665254145273435,1.0527057819162609,2574775133.0,2006-03-21,2006,1,80,3,1.19,130.22,130.50999,129.45,1561
2006-03-22 14:30:00,129.50999,130.50999,129.45,130.38,129.53998333333334,131.65454545454546,124.13700010000042,126.68800009999997,128.2961996,129.2909995,128.29679062654952,129.364999770906,129.39615307692335,131.78744764846783,127.00485850537888,124.13700010000042,126.68800009999997,128.2961996,129.2909995,130.11333,51606896,57206844.0,58.302309154404966,1.5,2.75,1.1386634131089248,0.9021105236988776,0.08934552537623197,0.6446899423687569,0.5553444169925249,11.01759932886847,2.3551577955723038,2626382029.0,2006-03-22,2006,2,81,3,0.82,129.98,130.39348999999999,129.66,1562
2006-03-23 14:30:00,130.24001,130.39348999999999,129.66,130.11,129.77598266666666,131.7006818181818,124.1869001000004,126.80809999999998,128.3203998,129.3424995,128.36789687648877,129.43595217367687,129.54538384615412,131.8526339566248,127.23813373568345,124.1869001000004,126.80809999999998,128.3203998,129.3424995,130.05449666666667,46836400,57376154.4,56.3551388012527,1.5,2.75,1.1097224550297171,0.8163042729123722,0.055289513891023656,0.6244563093563045,0.5691667954652808,10.000690231415607,1.182051481452687,2579545629.0,2006-03-23,2006,3,82,3,0.57,130.03,130.57001,129.74001,1563
2006-03-24 14:30:00,129.99001,130.57001,129.74001,130.21001,130.01198200000002,131.74681818181818,124.23840015000042,126.9122001,128.33839999999998,129.38250000000002,128.4401366068225,129.50967196666002,129.71769230769257,131.85706539844142,127.57831921694368,124.23840015000042,126.9122001,128.33839999999998,129.38250000000002,130.17334333333335,43213696,57697704.0,56.92894866796858,1.5,2.75,1.0897422796704503,0.7489673419240391,0.03223891751541541,0.60946544235955,0.5772265248441346,8.84851827548316,1.0711868353644325,2622759325.0,2006-03-24,2006,4,83,3,0.64,130.16,130.28,129.74001,1564
2006-03-27 14:30:00,130.03,130.28,129.74001,130.02,130.24798133333334,131.79295454545453,124.28610015000042,127.0111001,128.3628,129.4104995,128.50209203400595,129.55827463650192,129.8546146153849,131.8188412644951,127.89038796627469,124.28610015000042,127.0111001,128.3628,129.4104995,130.01333666666667,32523200,57529859.2,55.43767410453815,1.5,2.75,1.0504742596939889,0.5653273005055434,-0.0012872254031540686,0.5756174930901921,0.5769047184933461,8.968881550442449,-0.12289907227677113,2590236125.0,2006-03-27,2006,0,86,3,0.42,130.01,130.53,129.05,1565
2006-03-28 14:30:00,129.92999,130.53,129.05,129.22,130.48398066666667,131.8390909090909,124.33120015000044,127.0984,128.3736002,129.4599995,128.53024528757436,129.52605800445411,129.99615307692335,131.41662894688056,128.57567720696613,124.33120015000044,127.0984,128.3736002,129.4599995,129.60000000000002,82081680,57914092.8,49.55214977020393,1.5,2.75,1.0811546697158458,1.4173006263511738,-0.07854694504373516,0.4787210371886772,0.5572679822324124,7.467755058343075,-1.177722635188324,2508154445.0,2006-03-28,2006,1,87,3,1.15,129.79,130.5,129.28999,1566
2006-03-29 14:30:00,129.41,130.5,129.28999,130.03,130.71998000000002,131.88522727272726,124.3784501500004,127.1812,128.40760020000002,129.49299950000002,128.58905919786557,129.57405248022042,130.10692230769257,131.27338500277156,128.94045961261364,124.3784501500004,127.1812,128.40760020000002,129.49299950000002,129.93999666666664,61532704,58558412.8,54.786124353767455,1.5,2.75,1.0953579075932858,1.0507918684571995,-0.07624247802168194,0.4619648847053099,0.5382073627269919,7.978861904964018,-0.7631840036632832,2569687149.0,2006-03-29,2006,2,88,3,0.94,129.89,130.98,129.55,1567
2006-03-30 14:30:00,130.11,130.98,129.55,129.8,130.95597933333335,131.93136363636364,124.4231501500004,127.2565,128.44719999999998,129.51499950000002,128.63654707245908,129.59557129162798,130.18153769230798,131.11194012994005,129.25113525467592,124.4231501500004,127.2565,128.44719999999998,129.51499950000002,130.11,70572320,59054804.0,53.10142420198541,1.5,2.75,1.1192609141937635,1.1950309749567538,-0.09038612252389733,0.4252247095721202,0.5156108320960175,7.819864467171314,-0.6277752258459601,2499114829.0,2006-03-30,2006,3,89,3,1.1,130.26,130.24001,129.37,1568
2006-03-31 14:30:00,130.02,130.24001,129.37,129.83,131.19197866666667,131.9775,124.4668501500004,127.3337,128.4776,129.56850000000003,128.6833491480489,129.61789783528246,130.15461538461562,131.10370597396914,129.20552479526214,124.4668501500004,127.3337,128.4776,129.56850000000003,129.8133366666667,62925696,58529598.4,53.303129781548975,1.5,2.75,1.1014572774656384,1.075108965722888,-0.09729909061153563,0.39398696883159795,0.4912860594431336,7.712871049582027,-0.4447511693888384,2562040525.0,2006-03-31,2006,4,90,3,0.67,129.81,130.87,129.49001,1569
2006-04-03 13:30:00,130.07001,130.87,129.49001,129.73,131.427978,132.02363636363637,124.5085002000004,127.4087,128.55279999999996,129.6465,128.724394279498,129.62857423192222,130.07538538461566,130.98002739105377,129.17074337817758,124.5085002000004,127.4087,128.55279999999996,129.6465,130.03000333333333,61627696,58737028.0,52.49269043351546,1.5,2.75,1.121352471932378,1.0492137259651613,-0.10739215358090064,0.35704586746700784,0.4644380210479085,7.68802920642834,0.10803302723974564,2500412829.0,2006-04-03,2006,0,93,4,1.07,130.18,130.73,129.36,1570
2006-04-04 13:30:00,129.72,130.73,129.36,130.56,131.66397733333335,132.06977272727272,124.5545002000004,127.492,128.63559999999998,129.776,128.79637881755693,129.71728144792962,130.03923153846182,130.81705804139878,129.26140503552486,124.5545002000004,127.492,128.63559999999998,129.776,130.21666666666667,54810192,58388302.4,58.17663180272304,1.5,2.75,1.1391130096514919,0.9387187115753516,-0.05935414758294881,0.3902453365692225,0.4495994841521713,7.641781870092582,0.13805798435343367,2555223021.0,2006-04-04,2006,1,94,4,1.06,130.05,131.28,130.38,1571
2006-04-05 13:30:00,130.61,131.28,130.38,131.00999,131.89997666666667,132.1159090909091,124.6025502000004,127.5781999,128.72479979999997,129.91449900000003,128.88318709922137,129.8403965481268,130.06923076923107,130.95669497139744,129.1817665670647,124.6025502000004,127.5781999,128.72479979999997,129.91449900000003,130.88999666666666,50610704,57583581.6,60.9074489367921,1.5,2.75,1.1220335089621003,0.8789085811223663,-0.001515015714606327,0.4477057145089134,0.4492207302235197,7.1005105537986255,0.6917147029436429,2605833725.0,2006-04-05,2006,2,95,4,0.69,130.83,131.21001,130.19,1572
2006-04-06 13:30:00,130.85001,131.21001,130.19,130.87,132.135976,132.16204545454545,124.64955020000038,127.6534999,128.80899979999995,130.088999,128.96110133062442,129.93845401973377,130.1046153846157,131.07629229786744,129.1329384713639,124.64955020000038,127.6534999,128.80899979999995,130.088999,130.75666999999999,57911008,57652952.0,59.60360686794827,1.5,2.75,1.1147461154648084,1.0044760240551085,0.02178755683086964,0.4764551762621068,0.4546676194312371,6.9911269654129535,0.5068657931905491,2547922717.0,2006-04-06,2006,3,96,4,0.78,130.7,131.39999,129.35001,1573
2006-04-07 13:30:00,131.06,131.39999,129.35001,129.53999,132.37197533333335,132.20818181818183,124.68940010000038,127.7112999,128.85259959999996,130.13649850000002,128.9838028470705,129.9005050654734,130.1007684615387,131.08092347650202,129.12061344657542,124.68940010000038,127.7112999,128.85259959999996,130.13649850000002,130.09666333333334,80183312,58637562.4,48.89442085074917,1.5,2.75,1.1815485357887512,1.3674393804610132,-0.053772230826851015,0.3874523308976734,0.4412245617245244,9.32802987052403,-0.36918166435934574,2467739405.0,2006-04-07,2006,4,97,4,1.58,130.38,130.08,129.25999,1574
2006-04-10 13:30:00,129.71001,130.08,129.25999,129.74001,132.60797466666668,132.25431818181818,124.7388001500004,127.77179999999998,128.87659999999997,130.18199900000002,129.0134580295383,129.88521982114258,130.05153846153874,131.03493246366926,129.06814445940822,124.7388001500004,127.77179999999998,128.87659999999997,130.18199900000002,129.69333333333336,41537008,58428748.0,50.33952125560221,1.5,2.75,1.1557243546609852,0.7109001890644653,-0.08957056369011951,0.329261357111875,0.4188319208019945,9.375738208854004,0.4024222256616727,2509276413.0,2006-04-10,2006,0,100,4,0.63,129.67,130.06,128.25,1575
2006-04-11 13:30:00,129.85001,130.06,128.25,128.64,132.843974,132.30045454545456,124.78710015000038,127.82579989999998,128.8806,130.10499950000002,128.99881261661523,129.76662745722425,129.9384615384618,131.17455429465986,128.70236878226376,124.78710015000038,127.82579989999998,128.8806,130.10499950000002,128.98333333333332,72805312,58575054.4,43.118462642646094,1.5,2.75,1.2024583293280575,1.2429405784725998,-0.18133130729292116,0.1921677866858431,0.37349909397876413,9.994716746146231,-1.0689840805967967,2436471101.0,2006-04-11,2006,1,101,4,1.41,129.16,129.13,128.61,1576
2006-04-12 13:30:00,128.77,129.13,128.61,128.88,133.07997333333333,132.3465909090909,124.8357502000004,127.87969979999998,128.9082,130.01100000000002,128.9941532983166,129.68218674701242,129.83615307692335,131.1808049581837,128.491501195663,124.8357502000004,127.87969979999998,128.9082,130.01100000000002,128.8733333333333,43051904,58057274.4,44.97312943381925,1.5,2.75,1.1537113058046238,0.741541941900049,-0.21742835754692968,0.1017136470451021,0.3191420045920318,9.206969543956244,-0.70878274268106,2479523005.0,2006-04-12,2006,2,102,4,0.4,128.87,129.25,128.31,1577
2006-04-13 13:30:00,128.59,129.25,128.31,128.71001,133.31597266666668,132.39272727272729,124.87855030000036,127.9203999,128.9146002,129.89500049999998,128.98301042387286,129.5895984853922,129.7353846153849,131.20074685229812,128.27002237847168,124.87855030000036,127.9203999,128.9146002,129.89500049999998,128.75666999999999,51076896,57256937.6,43.88175108163291,1.5,2.75,1.1384462125328647,0.8920647547870251,-0.2424132569535181,0.01612543340013417,0.2585386903536523,9.194828463917863,-0.8626588615882317,2428446109.0,2006-04-13,2006,3,103,4,0.73,128.78,129.31,128.02,1578
2006-04-17 13:30:00,128.78999,129.31,128.02,128.66,128.02,132.43886363636364,124.92270030000036,127.95569990000001,128.9498004,129.7970005,128.97034334842684,129.50106529630722,129.69230769230793,131.24600192712273,128.13861345749322,124.92270030000036,127.95569990000001,128.9498004,129.7970005,128.66333333333333,64169600,58101077.6,43.54694136983965,1.5,2.75,1.149271483066231,1.1044476737897886,-0.2509141736220095,-0.055104026673859614,0.1958101469481499,9.175237444906923,-0.8247899483542691,2364276509.0,2006-04-17,2006,0,107,4,1.01,128.67,130.94,128.84,1579
2006-04-18 13:30:00,128.95,130.94,128.84,130.7,128.05111148148148,132.485,124.98030035000036,128.0051,129.03840039999997,129.8115005,129.03817302103755,129.61524955380176,129.74384615384645,131.38112961623892,128.10656269145395,124.98030035000036,128.0051,129.03840039999997,129.8115005,130.16,92662192,60457127.2,57.718618826351786,1.5,2.75,1.2300378057043575,1.5326926086557418,-0.11468617744723313,0.052452425139108534,0.16713860258634164,13.238677638069037,0.10723039215685227,2456938701.0,2006-04-18,2006,1,108,4,1.63,129.89,131.07001,130.24001,1580
2006-04-19 13:30:00,130.72,131.07001,130.24001,130.95,128.08222296296302,132.53113636363636,125.03740035000037,128.0516,129.12540019999997,129.87950049999998,129.11314662805572,129.74236864391588,129.83230769230798,131.59186959317566,128.0727457914403,125.03740035000037,128.0516,129.12540019999997,129.87950049999998,130.75333999999998,87273312,60450586.4,59.07450202584693,1.5,2.75,1.2014636767254738,1.4437132408032356,-0.008858424469446236,0.15606557199953386,0.1649239964689801,12.784780400624962,-0.04579040117474943,2544212013.0,2006-04-19,2006,2,109,4,0.64,130.66,131.86,130.60001,1581
2006-04-20 13:30:00,131.0,131.86,130.60001,131.13,128.11333444444443,132.5772727272727,125.09060030000038,128.0926,129.23840019999997,129.91700049999997,129.19223891715154,129.87452401116198,129.932307692308,131.82286632115938,128.04174906345662,125.09060030000038,128.0926,129.23840019999997,129.91700049999997,131.19666999999998,86022496,62171366.4,60.067429573652745,1.5,2.75,1.2056441283879409,1.3836352806941044,0.06792033301390324,0.24982441273635916,0.1819040797224559,12.653554225439642,0.19867043631083586,2630234509.0,2006-04-20,2006,3,110,4,0.96,131.23,131.78999,130.62,1582
2006-04-21 13:30:00,131.73,131.78999,130.62,131.14999,128.14444592592594,132.6234090909091,125.14895025000038,128.1327999,129.32899999999998,129.96899999999997,129.26901346942012,129.99599696247992,130.041537692308,132.03405485271256,128.04902053190344,125.14895025000038,128.1327999,129.32899999999998,129.96899999999997,131.18666000000002,72359312,63447512.0,60.18296561152524,1.5,2.75,1.2030974049316587,1.140459408400443,0.11210060499044068,0.3220298359605067,0.20992923097006605,12.632007143209979,1.2428594444078729,2702593821.0,2006-04-21,2006,4,111,4,0.9,131.2,131.07001,130.38,1583
2006-04-24 13:30:00,130.92999,131.07001,130.38,130.91,128.1755574074074,132.66954545454544,125.20375025000038,128.1795999,129.41899999999998,130.00399949999996,129.33336588238404,130.08304487081514,130.06846076923108,132.09739801287046,128.0395235255917,125.20375025000038,128.1795999,129.41899999999998,130.00399949999996,130.78667,52547296,63914192.0,58.01286652554988,1.5,2.75,1.172161161722255,0.8221538027109847,0.11668595873377037,0.35578667938727904,0.23910072065350865,10.901095118610106,0.9017958299833524,2650046525.0,2006-04-24,2006,0,114,4,0.53,130.73,131.12,129.92,1584
2006-04-25 13:30:00,131.03999,131.12,129.92,130.37,128.2066688888889,132.71568181818182,125.24900020000037,128.22239990000003,129.49359999999996,130.02149949999998,129.3740182007219,130.11037393073752,130.0192307692311,131.98445516495806,128.05400637350408,125.24900020000037,128.22239990000003,129.49359999999996,130.02149949999998,130.47,84360368,66506050.4,53.35125659809182,1.5,2.75,1.1741496501706667,1.2684615533867276,0.07680172476437003,0.3351028766089712,0.2583011518446012,11.286481300961626,1.3448383084577258,2565686157.0,2006-04-25,2006,1,115,4,0.92,130.52,131.14,130.3,1585
2006-04-26 13:30:00,130.5,131.14,130.3,130.39999,128.23778037037042,132.76181818181817,125.29130015000038,128.27229979999998,129.57339979999998,130.08049899999997,129.41425238892893,130.13795641352442,129.9830761538465,131.90108985277115,128.0650624549218,125.29130015000038,128.27229979999998,129.57339979999998,130.08049899999997,130.61333,67266880,65765310.4,53.574375696602715,1.5,2.75,1.1502818180156174,1.0228322437903372,0.04733599571926922,0.3174711464936877,0.2701351507744185,9.749762858575577,1.1793839230291798,2632953037.0,2006-04-26,2006,2,116,4,0.64,130.72,131.63,129.59,1586
2006-04-27 13:30:00,129.89999,131.63,129.59,131.03,128.26889185185186,132.80795454545455,125.33515020000038,128.31569980000003,129.63899979999997,130.13049899999996,129.4776150403435,130.2229129455697,130.09769230769265,132.07331051821086,128.12207409717442,125.33515020000038,128.31569980000003,129.63899979999997,130.13049899999996,130.75,124605376,68918944.0,58.107416248721904,1.5,2.75,1.213833116728787,1.807998915363532,0.06412901226160844,0.35029641610142903,0.2861674038398206,9.950762464482086,1.802493838668795,2757558413.0,2006-04-27,2006,3,117,4,1.57,130.61,131.75,130.71001,1587
2006-04-28 13:30:00,130.78999,131.75,130.71001,131.47,128.30000333333334,132.8540909090909,125.3803502500004,128.3618997,129.70439979999998,130.21399899999994,129.55574778385943,130.34168314122974,130.2307684615388,132.32177779627665,128.13975912680093,125.3803502500004,128.3618997,129.70439979999998,130.21399899999994,131.31000333333336,55855104,68183083.2,60.973453865927326,1.5,2.75,1.2014157512481585,0.8191929930208847,0.09676363938814804,0.4071219530750057,0.3103583136868576,9.800214051382984,2.184050987097779,2813413517.0,2006-04-28,2006,4,118,4,0.8,131.23,131.8,130.32001,1588
2006-05-01 13:30:00,131.47,131.8,130.32001,130.39999,128.33111481481484,132.90022727272728,125.4178002000004,128.4000996,129.72919960000002,130.24249849999995,129.5888553217473,130.34723617539834,130.36615230769263,132.24476534263297,128.48753927275231,125.4178002000004,128.4000996,129.72919960000002,130.24249849999995,130.84,65006608,68287128.8,51.708802823081406,1.5,2.75,1.2213139118732912,0.9519598955520884,0.04103086559696656,0.36164689568306585,0.3206160300860993,11.410917909344196,-0.2295409334353375,2748406909.0,2006-05-01,2006,0,121,5,1.14,131.06,131.46001,130.74001,1589
2006-05-02 13:30:00,131.00999,131.46001,130.74001,131.38,128.36222629629628,132.94636363636363,125.4605002000004,128.44569950000002,129.78059959999996,130.32499849999994,129.65909628952193,130.4455946348842,130.55846000000034,132.29568384808488,128.8212361519158,125.4605002000004,128.44569950000002,129.78059959999996,130.32499849999994,131.19333999999998,49087696,67660128.8,58.00291868118797,1.5,2.75,1.209792918168057,0.7255040283044806,0.0635666905048885,0.4000743932172099,0.33650770271232144,8.120714925828409,0.32836960672012744,2797494605.0,2006-05-02,2006,1,122,5,0.55,131.1,131.32001,130.45,1590
2006-05-03 13:30:00,131.22,131.32001,130.45,130.89,128.39333777777782,132.9925,125.5032001500004,128.49379950000002,129.82859939999997,130.34149849999994,129.70736702326616,130.4879189553714,130.72615153846186,132.10018683772213,129.3521162392016,125.5032001500004,128.49379950000002,129.82859939999997,130.34149849999994,130.88666999999998,60824608,67960849.6,54.19918769356869,1.5,2.75,1.1898077097274815,0.8949948147793609,0.0400209062478466,0.3865338355221297,0.3465129292742831,8.407412207404379,-0.1830244795241433,2736669997.0,2006-05-03,2006,2,123,5,0.67,130.89,131.62,130.34,1591
2006-05-04 13:30:00,131.08,131.62,130.34,131.36,128.42444925925926,133.03863636363636,125.54490015000042,128.5473995,129.87039939999994,130.35899899999995,129.77217615960868,130.5709742929551,130.93384384615416,131.65876818669508,130.20891950561324,125.54490015000042,128.5473995,129.87039939999994,130.35899899999995,131.10666666666668,42930496,67576839.2,57.104909274908884,1.5,2.75,1.1962500161755187,0.635284167004958,0.05000011255784775,0.4090130699715928,0.35901295741374506,8.636021368449919,0.16012963477924105,2779600493.0,2006-05-04,2006,3,124,5,0.98,130.98,132.8,131.85001,1592
2006-05-05 13:30:00,132.05,132.8,131.85001,132.52,128.45556074074076,132.8,125.59030015000042,128.60929950000002,129.93919939999995,130.44149899999996,129.87993395727108,130.7565957888641,131.07384384615415,132.1713000830037,129.9763876093046,125.59030015000042,128.60929950000002,129.93919939999995,130.44149899999996,132.39000333333334,62589504,67810764.0,63.29443712492497,1.5,2.75,1.2136607293058386,0.9230024896932292,0.12438923464732846,0.5144995007229056,0.3901102660755772,9.947690317205588,1.229852570468271,2842189997.0,2006-05-05,2006,4,125,5,0.72,132.33,132.77,132.36,1593
2006-05-08 13:30:00,132.50999,132.77,132.36,132.36,128.48667222222224,132.83800000000002,125.63850015000044,128.66839950000002,129.99819939999998,130.58249949999995,129.9771914491428,130.9093009518295,131.18230538461572,132.4713435123565,129.8932672568749,125.63850015000044,128.66839950000002,129.99819939999998,130.58249949999995,132.49666666666667,30017296,65302463.2,61.966272286854476,1.5,2.75,1.1562563914982784,0.4596656010978771,0.15072681895143514,0.5785187897648711,0.42779197081343606,9.888258429973616,1.5264247909795268,2812172701.0,2006-05-08,2006,0,128,5,0.31,132.56,132.77,132.31,1594
2006-05-09 13:30:00,132.42,132.77,132.31,132.62,128.5177837037037,132.876,125.6839002000004,128.72149950000002,130.06139919999995,130.72649899999993,130.0808310001568,131.07222467070284,131.2969207692311,132.79499293949635,129.79884859896583,125.6839002000004,128.72149950000002,130.06139919999995,130.72649899999993,132.5666666666667,29865008,64718863.2,63.313469353993824,1.5,2.75,1.1065237921055449,0.461457549211093,0.1720258524887256,0.642824286424343,0.4707984339356174,9.310678402510426,1.7024617869986047,2842037709.0,2006-05-09,2006,1,129,5,0.35,132.54,132.75,131.89,1595
2006-05-10 13:30:00,132.41,132.75,131.89,132.55,128.54889518518522,132.91400000000002,125.7307002000004,128.76889950000003,130.14779919999998,130.92199899999997,130.17766115701338,131.21296517825496,131.40461384615415,133.0399508626422,129.7692768296661,125.7307002000004,128.76889950000003,130.14779919999998,130.92199899999997,132.39666666666668,64406896,64298942.4,62.669848281918966,1.5,2.75,1.0889149498122923,1.0016789327471116,0.16759837871042804,0.6802964073236524,0.5126980286132243,9.364667654104236,1.1600396855681985,2777630813.0,2006-05-10,2006,2,130,5,0.65,132.32,132.55,130.52,1596
2006-05-11 13:30:00,132.50999,132.55,130.52,130.95,128.5800066666667,132.95200000000003,125.7687502000004,128.80399950000003,130.17939919999998,131.02549899999994,130.20794895477758,131.187920875564,131.40769076923107,133.0394402859475,129.7759412525146,125.7687502000004,128.80399950000003,130.17939919999998,131.02549899999994,131.34,80654688,66179081.6,50.126623151801894,1.5,2.75,1.156135310539986,1.2187338665032184,0.04925510779573139,0.5742669133578886,0.5250118055621572,11.949811771910396,-0.3955274967673311,2696976125.0,2006-05-11,2006,3,131,5,1.56,131.54,130.72,129.19,1597
2006-05-12 13:30:00,130.48,130.72,129.19,129.24001,128.61111814814817,132.99,125.7960003000004,128.83279960000002,130.1769994,131.05199899999994,130.16999056439408,131.00240555408172,131.32076846153876,133.25644862612168,129.38508829695584,125.7960003000004,128.83279960000002,130.1769994,131.05199899999994,129.71667,91733376,68211905.6,40.741396652152424,1.5,2.75,1.1992685026442718,1.3448293988139222,-0.14141619523126014,0.34824156152308205,0.4896577567543422,13.823523092163999,-0.8895552829413486,2605242749.0,2006-05-12,2006,4,132,5,1.18,129.95,129.74001,128.61,1598
2006-05-15 13:30:00,128.78999,129.74001,128.61,129.5,128.64222962962964,133.02800000000002,125.8206502500004,128.8706995,130.1917996,131.09399899999994,130.14371642461396,130.85931931083584,131.2515384615388,133.36976311956843,129.13331380350914,125.8206502500004,128.8706995,130.1917996,131.09399899999994,129.28333666666666,84040368,69205444.0,42.50402798767753,1.5,2.75,1.1943214667411095,1.2143606505869682,-0.24138416530332885,0.18792755012518114,0.42931171542851,13.308625969323636,-1.4309636169888835,2689283117.0,2006-05-15,2006,0,135,5,0.88,129.18,130.0,129.00999,1599
2006-05-16 13:30:00,129.75999,130.0,129.00999,129.31,128.67334111111109,133.066,125.84850020000042,128.90549950000002,130.2145996,131.02449899999993,130.1110216628644,130.71176509075622,131.11923076923108,133.4775397532313,128.76092178523086,125.84850020000042,128.90549950000002,130.2145996,131.02449899999993,129.43999666666667,62136400,67679154.4,41.531790483791355,1.5,2.75,1.1797277905453167,0.9181024874034182,-0.3074277045159864,0.045027084783527016,0.3524547892995134,12.24701708840559,-1.2071204828481812,2627146717.0,2006-05-16,2006,1,136,5,0.77,129.5,129.10001,126.77,1600
2006-05-17 13:30:00,128.67,129.10001,126.77,126.85001000000001,128.70445259259262,133.10399999999998,125.8645003000004,128.9136996,130.1921998,130.81949949999995,129.98313885255598,130.3439788916366,130.7638469230772,134.02370091772258,127.50399292843184,125.8645003000004,128.9136996,130.1921998,130.81949949999995,127.57333999999996,144779632,70554470.4,31.48880412984656,1.5,2.75,1.2768900912206518,2.052026344740304,-0.4929107249987502,-0.2636836169489243,0.2292271080498259,15.90210606231764,-3.433305420219257,2482367085.0,2006-05-17,2006,2,137,5,1.84,127.94,127.75,126.11,1601
2006-05-18 13:30:00,127.38,127.75,126.11,126.21001000000001,128.7355640740741,133.14200000000002,125.8736003500004,128.9088997,130.1515998,130.57349999999994,129.83517301520084,129.9502675686236,130.44154076923107,134.50984938541947,126.37323215304268,125.8736003500004,128.9088997,130.1515998,130.57349999999994,126.69000333333332,87923872,70649539.2,29.49078403157641,1.5,2.75,1.3028265132763197,1.2445073668647508,-0.6262618187651008,-0.5536001654065501,0.07266165335855068,15.330351008100305,-4.761537881074566,2394443213.0,2006-05-18,2006,3,138,5,1.3,126.93,127.49001000000001,125.8,1602
2006-05-19 13:30:00,126.87,127.49001000000001,125.8,127.10001000000001,128.76667555555557,133.18,125.88550040000038,128.9122999,130.14600000000002,130.37100099999995,129.72791172048707,129.6788144668499,130.11231076923107,134.50346305483544,125.72115848362671,125.88550040000038,128.9122999,130.14600000000002,130.37100099999995,126.79667333333332,124320880,73247617.6,35.60949877607793,1.5,2.75,1.330482476613725,1.6972685811968309,-0.6208787431356763,-0.7034367755610447,-0.08255803242536841,14.817640191869481,-3.9740027198549535,2518764093.0,2006-05-19,2006,4,139,5,1.34,126.65,127.17,125.5,1603
2006-05-22 13:30:00,126.28,127.17,125.5,126.13,128.79778703703704,133.21800000000002,125.89755040000038,128.9188999,130.09679999999997,130.13200099999997,129.58681714321307,129.34083213667373,129.74615692307725,134.58759078570841,124.90472306044613,125.89755040000038,128.9188999,130.09679999999997,130.13200099999997,126.26666666666668,110877376,76164121.6,32.31775245039168,1.5,2.75,1.3547337282841734,1.4557691163604256,-0.6461083522071017,-0.8901934726842455,-0.24408512047714384,14.807468404900444,-4.893681194389993,2407886717.0,2006-05-22,2006,0,142,5,1.33,126.34,127.63,125.17,1604
2006-05-23 13:30:00,127.17998999999999,127.63,125.17,125.17,128.82889851851854,133.25600000000003,125.90900040000037,128.91309990000002,130.0236,129.87200099999998,129.41360862779294,128.94361002841907,129.27000307692342,134.5779839011971,123.96202225264969,125.90900040000037,128.91309990000002,130.0236,129.87200099999998,125.99,91990624,76545634.4,29.419261369734357,1.5,2.75,1.4336813191210176,1.2017749244756406,-0.6870913947414871,-1.1029493639040029,-0.4158579691625156,14.212654821258942,-5.567710298000761,2315896093.0,2006-05-23,2006,1,143,5,1.97,126.4,126.89,124.75998999999999,1605
2006-05-24 13:30:00,125.67998999999999,126.89,124.75998999999999,126.17,128.86001000000002,133.29399999999998,125.92660045000036,128.9228999,129.9434002,129.66050149999998,129.28640828944808,128.67945669237915,128.78154153846188,133.9706856714775,123.5923974054463,125.92660045000036,128.9228999,129.9434002,129.66050149999998,125.93999666666667,168394368,81602008.8,35.871296568128514,1.5,2.75,1.4834190820409447,2.0636056694721963,-0.6091513440093087,-1.1772971491741515,-0.5681458051648428,16.068417423019138,-3.6502481863306517,2484290461.0,2006-05-24,2006,2,144,5,1.71,125.82,127.73,126.42998999999999,1606
2006-05-25 13:30:00,126.92,127.73,126.42998999999999,127.73,128.8911214814815,133.33200000000002,125.94830045000036,128.9551,129.8828004,129.4955015,129.22537267025407,128.5890322454859,128.425387692308,133.20241080931842,123.64836457529762,125.94830045000036,128.9551,129.8828004,129.4955015,127.29666333333336,78992128,79321346.4,44.40871425518104,1.5,2.75,1.4888891476094488,0.9958495611214184,-0.4236320777204837,-1.0976859023154475,-0.6740538245949638,18.046446668919284,-1.1683765731680211,2563282589.0,2006-05-25,2006,3,145,5,1.03,127.08,128.38,127.50998999999999,1607
2006-05-26 13:30:00,128.0,128.38,127.50998999999999,128.38,128.92223296296302,133.37,125.97355045000036,128.97189999999998,129.82980039999998,129.34100149999998,129.19222080083236,128.56912441258248,128.0992338461542,132.22007141484366,123.97839627746471,125.97355045000036,128.97189999999998,129.82980039999998,129.34100149999998,128.08999666666668,62990704,79678126.4,47.54240331596221,1.5,2.75,1.4446834942087734,0.7905645733155693,-0.23751800064840145,-0.9709513254054656,-0.7334333247570641,17.117644503013512,-0.8648648648648684,2626273293.0,2006-05-26,2006,4,146,5,0.68,127.94,128.0,126.05,1608
2006-05-30 13:30:00,127.97,128.0,126.05,126.10001000000001,128.9533444444445,133.40800000000002,125.98495045000034,128.95990009999997,129.7394006,129.1260025,129.07095763217228,128.3339706590032,127.60308076923113,130.93943652482722,124.26672501363504,125.98495045000034,128.95990009999997,129.7394006,129.1260025,126.71667,72445504,80050071.2,39.19606601062355,1.5,2.75,1.5079203874795752,0.9050023680678501,-0.2472312804005081,-1.0424724252576991,-0.7952411448571912,19.609483239876106,-2.4823988863970343,2553827789.0,2006-05-30,2006,1,150,5,1.55,127.02,127.50998999999999,126.2,1609
2006-05-31 13:30:00,126.58,127.50998999999999,126.2,127.50998999999999,128.98445592592594,133.44600000000003,126.0072004000003,128.9612,129.6814004,128.932502,129.00974321522438,128.2554963105267,127.33846461538496,130.06006719499226,124.61686203577769,126.0072004000003,128.9612,129.6814004,128.932502,127.07332666666667,86932688,81942320.8,45.56094395449462,1.5,2.75,1.5009246455167489,1.0609009746279972,-0.1431274123735724,-0.9741504103241568,-0.8310229979505843,21.155101413861694,0.5202837587478351,2640760477.0,2006-05-31,2006,2,151,5,1.04,126.85,128.94,127.27,1610
2006-06-01 13:30:00,127.38,128.94,127.27,128.73,129.01556740740742,133.484,126.03175035000031,128.96409999999997,129.6642004,128.824502,128.99877289305869,128.30068713809558,127.29923307692344,129.92300777141816,124.67545838242869,126.03175035000031,128.96409999999997,129.6642004,128.824502,128.3133333333333,73728000,82587490.4,50.39913255735257,1.5,2.75,1.5130014565512668,0.8927260005469302,0.015060316820279971,-0.8121976019252344,-0.8272579187455144,18.58097410915165,1.9966641314741933,2714488477.0,2006-06-01,2006,3,152,6,1.31,128.1,129.42999,128.32001,1611
2006-06-02 13:30:00,129.25,129.42999,128.32001,129.0,129.04667888888892,133.52200000000002,126.0657003000003,128.96639999999996,129.6366004,128.706502,128.99882101489953,128.36728836303885,127.26077153846191,129.76637336464384,124.75516971227995,126.0657003000003,128.96639999999996,129.6366004,128.706502,128.91666666666666,91702688,85026100.0,51.42796248010476,1.5,2.75,1.4842142096547484,1.07852398263592,0.13819255594603252,-0.6545172238129737,-0.7927097797590063,18.10984621366127,1.4948779311661755,2806191165.0,2006-06-02,2006,4,153,6,0.87,128.88,128.86,126.77,1612
2006-06-05 13:30:00,128.78999,128.86,126.77,127.12,129.0777903703704,133.56000000000003,126.09030030000031,128.9486001,129.5768004,128.436502,128.92514175941326,128.2484989951304,127.09231000000037,129.30104651533753,124.88357348466316,126.09030030000031,128.9486001,129.5768004,128.436502,127.58333333333331,86119184,86202584.0,44.50569093940174,1.5,2.75,1.537484623250838,0.9990325116008124,0.0953749515969876,-0.6734910902627718,-0.7688660418597594,20.150938979648775,0.7849044636486238,2720071981.0,2006-06-05,2006,0,156,6,1.65,127.82,127.38,125.75998999999999,1613
2006-06-06 13:30:00,127.21001000000001,127.38,125.75998999999999,126.81,129.1089018518519,133.59799999999998,126.11340030000035,128.9236001,129.5088002,128.15900200000002,128.84219502375,128.1114990908323,127.08923230769264,129.29942176972742,124.87904284565786,126.11340030000035,128.9236001,129.5088002,128.15900200000002,126.64999666666668,130874816,91245460.0,43.46674030315784,1.5,2.75,1.543379293018635,1.4343159210332217,0.05076412330005842,-0.7054108877346863,-0.7561750110347447,19.640749488939377,1.3102181033794045,2589197165.0,2006-06-06,2006,1,157,6,1.29,126.57,127.64998999999999,125.78998999999999,1614
2006-06-07 13:30:00,126.91,127.64998999999999,125.78998999999999,125.86,129.14001333333334,133.63600000000002,126.1303503000003,128.8942001,129.42560020000002,127.82100200000001,128.72524619928922,127.89707060599109,127.06230846153879,129.32264222336846,124.80197469970913,126.1303503000003,128.8942001,129.42560020000002,127.82100200000001,126.43332666666667,108703120,95187365.6,40.35752707155917,1.5,2.75,1.5659950578030182,1.1419910543253864,-0.033591096240488616,-0.7981638813353555,-0.7645727850948669,19.62253671707321,-0.2457002457002475,2480494045.0,2006-06-07,2006,2,158,6,1.48,126.72,126.5,123.87,1615
2006-06-08 13:30:00,125.58,126.5,123.87,125.75,129.17112481481485,133.674,126.1467503000003,128.86490020000002,129.35620020000002,127.481002,128.6085698777485,127.69258769113479,126.95846153846186,129.32392724515304,124.5929958317707,126.1467503000003,128.86490020000002,129.35620020000002,127.481002,125.37333333333332,204960320,102215036.8,40.00073502091233,1.5,2.75,1.6419954108170882,2.0051875576881857,-0.08475189172709441,-0.8705126497537349,-0.7857607580266406,19.05015556377752,-1.5501448367650543,2275533725.0,2006-06-08,2006,3,159,6,2.12,125.18,126.96001000000001,125.28998999999999,1616
2006-06-09 13:30:00,126.36,126.96001000000001,125.28998999999999,125.35001000000001,129.20223629629632,133.71200000000002,126.16230030000031,128.8351003,129.2626004,127.20100249999999,128.48078321587602,127.46948505388387,126.89846230769264,129.38158131793648,124.41534329744879,126.16230030000031,128.8351003,129.2626004,127.20100249999999,125.86667,94976320,102931118.4,38.66223402012868,1.5,2.75,1.6439971671872955,0.9227172644808258,-0.13073844948660265,-0.949183819884894,-0.8184453703982912,17.291302757907538,-2.3601729241314837,2180557405.0,2006-06-09,2006,4,160,6,1.33,126.12,125.92998999999999,123.82001000000001,1617
2006-06-12 13:30:00,125.88,125.92998999999999,123.82001000000001,123.99001000000001,129.2333477777778,133.75000000000003,126.17650040000031,128.7968003,129.1464006,126.93850249999998,128.30467446231222,127.13810647732349,126.80769384615415,129.60348832863824,124.01189936367008,126.17650040000031,128.7968003,129.1464006,126.93850249999998,124.58000333333332,95878192,103138359.2,34.44219897232291,1.5,2.75,1.6772816552453464,0.929607497575936,-0.2320388200030173,-1.108493895402063,-0.8764550753990455,17.370871888892093,-1.6732750457355232,2084679213.0,2006-06-12,2006,0,163,6,1.7,124.88,124.84,122.55,1618
2006-06-13 13:30:00,123.78,124.84,122.55,122.55,129.26445925925927,133.78799999999998,126.18130040000031,128.7392003,129.00080060000002,126.59100250000002,128.07900095398622,126.70114395567364,126.52923230769258,130.12909511443277,122.92936950095243,126.18130040000031,128.7392003,129.00080060000002,126.59100250000002,123.31333333333336,185695872,108221134.4,30.62990763083332,1.5,2.75,1.7210472512992507,1.7158928616811835,-0.3672756718100726,-1.3355496651616363,-0.9682739933515636,15.772701970991507,-3.889883451484864,1898983341.0,2006-06-13,2006,1,164,6,1.87,123.7,123.63,122.34,1619
2006-06-14 13:30:00,122.84,123.63,122.34,123.5,122.34,133.82600000000002,126.19500045000031,128.7145003,128.8762006,126.30050250000002,127.89943228912405,126.39627310275236,126.203847692308,130.06588454585236,122.34181083876359,126.19500045000031,128.7145003,128.8762006,126.30050250000002,123.15666666666668,163652000,113296914.4,35.6873872955934,1.5,2.75,1.6902581619207324,1.4444524007266344,-0.363331963142044,-1.4224389472791188,-1.0591069841370748,14.761800452367735,-4.0627670317719184,2062635341.0,2006-06-14,2006,2,165,6,1.05,122.98,126.36,123.86,1620
2006-06-15 13:30:00,123.92,126.36,123.86,126.12,122.20146341463415,133.86400000000003,126.2171504500003,128.7115003,128.7874006,126.264002,127.82965063072704,126.3699613786807,126.03000153846183,129.68232713690688,122.3776759400168,126.2171504500003,128.7115003,128.7874006,126.264002,125.44666666666667,134446320,112780248.8,47.134513589039706,1.5,2.75,1.7738111503549658,1.1921087373944506,-0.16495570565482387,-1.2653016162056048,-1.1003459105507811,19.173409126219553,-2.23255813953488,2197081661.0,2006-06-15,2006,3,166,6,2.02,125.11,125.56,124.46001000000001,1621
2006-06-16 13:30:00,125.19,125.56,124.46001000000001,124.64998999999999,122.06292682926828,133.90200000000002,126.23515040000035,128.6925002,128.6602006,126.186001,127.70495805697304,126.20615458071111,125.91846153846184,129.6432687232005,122.19365435372316,126.23515040000035,128.6925002,128.6602006,126.186001,124.89,94263008,113097205.6,42.55751990384621,1.5,2.75,1.7656810681867543,0.8334689393952629,-0.11575102034143292,-1.245034685977572,-1.1292836656361391,19.711769959285316,-1.943053807426056,2102818653.0,2006-06-16,2006,4,167,6,0.88,125.01,125.48,123.55,1622
2006-06-19 13:30:00,125.39998999999999,125.48,123.55,123.67,121.92439024390244,133.94000000000003,126.2406004000003,128.6626002,128.51620060000002,126.0145005,127.54672440767996,125.9646160492148,125.623077692308,129.40479314602894,121.84136223858705,126.2406004000003,128.6626002,128.51620060000002,126.0145005,124.23333333333332,95817376,111672030.4,39.78397324661488,1.5,2.75,1.7774181347448441,0.8580248398528267,-0.13108782583070555,-1.2931434479245212,-1.1620556220938156,18.653179488911995,-2.476145414399496,2007001277.0,2006-06-19,2006,0,170,6,1.56,124.52,124.81,123.72,1623
2006-06-20 13:30:00,124.00998999999999,124.81,123.72,124.09,121.78585365853658,133.97799999999998,126.2486003500003,128.6299002,128.4072008,125.9125005,127.41116658777094,125.78608118738481,125.26615461538488,128.66392294042828,121.8683862903415,126.2486003500003,128.6299002,128.4072008,125.9125005,124.20666666666666,65518304,109404076.8,41.54235359257432,1.5,2.75,1.731888267977355,0.5988652883545926,-0.09643113985250797,-1.2825945469094506,-1.186163407056943,18.98508120182569,-1.4063244875258192,2072519581.0,2006-06-20,2006,1,171,6,0.88,124.26,125.7,123.96001000000001,1624
2006-06-21 13:30:00,124.0,125.7,123.96001000000001,125.00998999999999,121.64731707317074,134.01600000000002,126.26230030000029,128.59460020000003,128.31260039999998,125.9045,127.31700280001522,125.71216774096722,124.95923076923107,127.58572805111687,122.33273348734522,126.26230030000029,128.59460020000003,128.31260039999998,125.9045,124.89,75038688,108556480.0,45.309651102487145,1.5,2.75,1.73246696312183,0.6912409834954117,-0.00012828289788635594,-1.186323760679301,-1.1861954777814143,19.369894652048394,-0.5884771371769368,2147558269.0,2006-06-21,2006,2,172,6,1.4,124.83,125.06,124.03998999999999,1625
2006-06-22 13:30:00,124.95,125.06,124.03998999999999,124.46001000000001,121.50878048780487,134.05400000000003,126.26610035000029,128.5548003,128.22900059999998,125.8190005,127.2049638666813,125.59291462277986,124.75461615384644,127.07218190498779,122.43705040270508,126.26610035000029,128.5548003,128.22900059999998,125.8190005,124.52,74994128,103886468.0,43.504668861946705,1.5,2.75,1.6815771800416994,0.7218854336254843,0.03595508594609398,-1.1412516203487968,-1.1772067062948908,19.488587320681333,-0.7100119098514636,2072564141.0,2006-06-22,2006,3,173,6,0.82,124.55,125.3,124.03,1626
2006-06-23 13:30:00,124.33,125.3,124.03,124.44,121.37024390243904,134.092,126.26875035000029,128.52420030000002,128.14020059999996,125.65450049999998,127.09653391112516,125.48311323013417,124.57230846153877,126.56447945541395,122.58013746766358,126.26875035000029,128.52420030000002,128.14020059999996,125.65450049999998,124.59,54112496,102642486.4,43.436869499721716,1.5,2.75,1.6521788100387205,0.5271939320441091,0.06614199484755101,-1.094529212735452,-1.1606712075830028,19.443579776926533,0.3629244001190093,2018451645.0,2006-06-23,2006,4,174,6,1.02,124.66,125.06,124.25,1627
2006-06-26 13:30:00,124.53998999999999,125.06,124.25,124.99001000000001,121.23170731707316,134.13000000000002,126.27620040000029,128.49020040000002,128.06580060000002,125.48500099999998,127.01392513029673,125.43615101774044,124.50538615384646,126.37469499051144,122.63607731718149,126.27620040000029,128.49020040000002,128.06580060000002,125.48500099999998,124.76666999999999,37905200,101388211.2,45.93114869727385,1.5,2.75,1.5920231807502403,0.3738620057634472,0.12727726298826034,-1.0015746288476777,-1.128851891835938,18.47424724593253,1.991032231742147,2056356845.0,2006-06-26,2006,0,177,6,0.65,124.66,125.28998999999999,123.77,1628
2006-06-27 13:30:00,125.00998999999999,125.28998999999999,123.77,123.91,121.0931707317073,134.16800000000003,126.27275035000031,128.46030050000002,127.9708006,125.37550049999996,126.89220257616743,125.29080330176515,124.363847692308,126.10930471768148,122.61839066693452,126.27275035000031,128.46030050000002,127.9708006,125.37550049999996,124.32333,69780880,101254980.0,42.013360759451,1.5,2.75,1.5868779535537954,0.6891599800819673,0.100291392349654,-1.0034876513988706,-1.1037790437485246,17.80130044480969,0.33198380566801344,1986575965.0,2006-06-27,2006,1,178,6,1.23,124.53,124.77,123.64998999999999,1629
2006-06-28 13:30:00,124.19,124.77,123.64998999999999,124.75,120.95463414634146,134.20600000000002,126.2747503000003,128.44510050000002,127.8518006,125.23750099999998,126.80819463200399,125.23929822540657,124.31769307692338,125.98644848748958,122.64893766635714,126.2747503000003,128.44510050000002,127.8518006,125.23750099999998,124.38999666666666,62368096,100026750.4,45.87994968159553,1.5,2.75,1.5535302425856667,0.6235141674661461,0.14178951138175688,-0.9265421545213286,-1.0683316659030857,17.678418488676016,-1.0862670472565843,2048944061.0,2006-06-28,2006,2,179,6,0.91,124.21,127.35001000000001,125.17,1630
2006-06-29 13:30:00,125.2,127.35001000000001,125.17,127.27,120.81609756097559,134.24400000000003,126.29280030000031,128.45180040000002,127.7782006,125.16450099999996,126.82630464643522,125.4326983944155,124.5700000000003,126.84573121303468,122.29426878696593,126.29280030000031,128.45180040000002,127.7782006,125.16450099999996,126.59666999999999,110696624,101875181.6,55.47250414141672,1.5,2.75,1.6282787966866905,1.0865906912896242,0.3309271766482178,-0.6546726950928132,-0.9855998717410308,17.272946165250573,2.1018934698671004,2159640685.0,2006-06-29,2006,3,180,6,1.74,126.26,127.66,126.96001000000001,1631
2006-06-30 13:30:00,127.47,127.66,126.96001000000001,127.23,120.67756097560977,134.28200000000004,126.31290025000031,128.46930040000004,127.7002006,125.07600099999998,126.84213583677109,125.60386997589971,124.9300000000003,127.2926579426514,122.56734205734922,126.31290025000031,128.46930040000004,127.7002006,125.07600099999998,127.28333666666666,54229904,100001542.4,55.30493882460814,1.5,2.75,1.5619724540662123,0.5422906757086179,0.43856007094412985,-0.4373997830608687,-0.8759598540049985,15.359290124929855,2.8786286083933064,2105410781.0,2006-06-30,2006,4,181,6,0.55,127.31,128.00999,127.31,1632
2006-07-03 13:30:00,127.42998999999999,128.00999,127.31,127.8,120.53902439024392,128.00999,126.3361503000003,128.4811004,127.6332008,125.11000099999998,126.87969913728986,125.81302521629021,125.26076923076954,127.91590579733385,122.60563266420523,126.3361503000003,128.4811004,127.6332008,125.11000099999998,127.70666333333332,23936192,96892392.8,57.28503359847621,1.5,2.75,1.5061165644900534,0.24703891924113985,0.5273942674471033,-0.21671701969611945,-0.7441112871432227,14.01404669529301,2.989765492787488,2129346973.0,2006-07-03,2006,0,184,7,0.55,127.66,127.45,126.52,1633
2006-07-05 13:30:00,127.28998999999999,127.45,126.52,127.07001000000001,120.40048780487804,127.89023975,126.35400035000029,128.48770050000002,127.556401,125.1230015,126.88716230837656,125.932738052834,125.33384692307725,128.12820047242315,122.53949337373129,126.35400035000029,128.48770050000002,127.556401,125.1230015,127.01333666666665,69653504,93831327.2,53.986375161610816,1.5,2.75,1.4899653813121925,0.7423267482035573,0.5156246059898049,-0.09958052965596664,-0.6152051356457715,14.933421135809073,1.6478843010866526,2059693469.0,2006-07-05,2006,2,186,7,0.74,126.98,127.85001000000001,127.08,1634
2006-07-06 13:30:00,127.2,127.85001000000001,127.08,127.44,120.2619512195122,127.77048949999998,126.37575035000029,128.49570050000003,127.497801,125.20200149999998,126.90884221785194,126.07628680970694,125.54846307692341,128.52254483528645,122.57438131856031,126.37575035000029,128.49570050000003,127.497801,125.20200149999998,127.45667,51289504,90960646.4,55.38854406730571,1.5,2.75,1.4392535683613217,0.5638647704244986,0.5104383215546064,0.022842766297486602,-0.4875955552571198,14.601538044260455,2.394335337109487,2110982973.0,2006-07-06,2006,3,187,7,0.61,127.47,127.56,126.28998999999999,1635
2006-07-07 13:30:00,127.19,127.56,126.28998999999999,126.61,120.12341463414634,127.65073925,126.39855035000029,128.49770050000004,127.42200120000001,125.2450015,126.89712291519109,126.12711663735392,125.77461692307725,128.585591147446,122.96364269870844,126.39855035000029,128.49770050000004,127.42200120000001,125.2450015,126.81999666666668,81628368,84794048.8,51.59052922754076,1.5,2.75,1.4271647420497986,0.962666238435356,0.4319062933052498,0.05228731137444242,-0.3796189819308074,14.983803913082536,1.743812279009966,2029354605.0,2006-07-07,2006,4,188,7,1.01,126.92,127.42998999999999,126.41,1636
2006-07-10 13:30:00,126.94,127.42998999999999,126.41,126.85001000000001,119.98487804878047,127.530989,126.42825040000031,128.48870060000002,127.3384014,125.3200015,126.89527534988949,126.19596362427258,125.98692538461569,128.67093414925273,123.30291661997863,126.42825040000031,128.48870060000002,127.3384014,125.3200015,126.89666666666666,60956400,83093052.8,52.60263712692502,1.5,2.75,1.3980808319033848,0.7335920145661082,0.3788204891186551,0.0939066294675115,-0.28491385965114363,14.936235531387355,1.4881189304649225,2090311005.0,2006-07-10,2006,0,191,7,0.81,126.92,127.41,125.94,1637
2006-07-11 13:30:00,126.61,127.41,125.94,127.41,119.84634146341465,127.41123874999998,126.45860040000031,128.4808006,127.2572014,125.49100099999998,126.91546063028599,126.31158613624662,126.17154153846184,128.8912894288126,123.45179364811109,126.45860040000031,128.4808006,127.2572014,125.49100099999998,126.92,73640816,81981184.0,54.96828750750082,1.5,2.75,1.403217915338857,0.8982648506271879,0.3640236983210706,0.17011576325019462,-0.193907935070876,14.935914665863244,2.8246307804051334,2163951821.0,2006-07-11,2006,1,192,7,1.17,126.68,127.39998999999999,125.72,1638
2006-07-12 13:30:00,127.21001000000001,127.39998999999999,125.72,126.05,119.70780487804878,127.2914885,126.48165040000029,128.44970060000003,127.17020159999998,125.66600099999998,126.88152099772573,126.2866731708898,126.29384846153877,128.83164328029005,123.75605364278748,126.48165040000029,128.44970060000003,127.17020159999998,125.66600099999998,126.38999666666666,82561376,76824459.2,48.62131777532415,1.5,2.75,1.4237023499575103,1.07467565485967,0.2506424315622389,0.11939510438192258,-0.13124732718031626,15.503178426478124,1.0420841683366708,2081390445.0,2006-07-12,2006,2,193,7,1.34,126.56,125.67998999999999,124.0,1639
2006-07-13 13:30:00,125.5,125.67998999999999,124.0,124.0,119.56926829268292,127.17173825,126.49375040000028,128.40160060000002,127.02260159999999,125.691001,126.76852017428551,126.06889477366221,126.26000230769259,128.9052536466447,123.6147509687405,126.49375040000028,128.40160060000002,127.02260159999999,125.691001,124.55999666666668,102454192,73764568.8,40.946461770068495,1.5,2.75,1.4684378963891167,1.3889350085918215,0.03680850569127008,-0.08523669506622866,-0.12204520075749875,18.198836731017106,-2.56934077158796,1978936253.0,2006-07-13,2006,3,194,7,1.35,124.84,124.25998999999999,122.83,1640
2006-07-14 13:30:00,124.16,124.25998999999999,122.83,123.52,119.43073170731708,127.05198799999998,126.50360040000028,128.35190050000003,126.87520159999998,125.561001,126.64112722627432,125.82614289045628,126.14692461538492,129.10664962581086,123.18719960495899,126.50360040000028,128.35190050000003,126.87520159999998,125.561001,123.53666333333332,103243184,72204412.0,39.379057977655634,1.5,2.75,1.4656916180756083,1.4298736204651872,-0.12866783491815484,-0.2828799944051923,-0.15421215948703745,12.624605406725681,-2.9159789357855916,1875693069.0,2006-07-14,2006,4,195,7,1.16,123.54,124.10001000000001,123.14998999999999,1641
2006-07-17 13:30:00,123.5,124.10001000000001,123.14998999999999,123.34,119.29219512195122,126.93223774999998,126.5119504000003,128.29260050000002,126.71480160000002,125.49550149999999,126.51167125661651,125.58936737707948,126.10307846153873,129.2074134553697,122.99874346770778,126.5119504000003,128.29260050000002,126.71480160000002,125.49550149999999,123.53000000000002,81289632,71555743.2,38.779565955030044,1.5,2.75,1.4288579310702076,1.1360322507278493,-0.23572147554842265,-0.44886400392256576,-0.2131425283741431,12.552906861656318,-3.4898278560250344,1794403437.0,2006-07-17,2006,0,198,7,0.77,123.62,124.05,122.39,1642
2006-07-18 13:30:00,123.74001000000001,124.05,122.39,123.97,122.39,126.81248749999996,126.5185004000003,128.24150050000003,126.5438016,125.5105015,126.4119978740041,125.43514191259571,126.04307846153877,129.27714299636995,122.80901392670758,126.5185004000003,128.24150050000003,126.5438016,125.5105015,123.46999999999998,123697008,72949724.8,42.10184088331585,1.5,2.75,1.4453680788509071,1.695647356300925,-0.2483154063112969,-0.5235367862632643,-0.2752213799519673,12.694824829302574,-2.4396078980398266,1918100445.0,2006-07-18,2006,1,199,7,1.36,123.22,126.25998999999999,123.72399999999999,1643
2006-07-19 13:30:00,124.17998999999999,126.25998999999999,123.72399999999999,125.69,122.39217391304348,126.69273724999998,126.53175045000029,128.20430050000002,126.41040159999999,125.5905015,126.38368423188628,125.45941411139613,125.92154000000029,129.07990426843833,122.76317573156223,126.53175045000029,128.20430050000002,126.41040159999999,125.5905015,125.22466333333334,134399184,76393768.8,50.06866015425605,1.5,2.75,1.5232696446472704,1.7592951115143831,-0.1309164116556229,-0.438866894521496,-0.3079504828658731,15.745466195995936,-1.3731952291274323,2052499629.0,2006-07-19,2006,2,200,7,2.05,124.99,126.3,124.66,1644
2006-07-20 13:30:00,126.12,126.3,124.66,124.83,122.39434782608696,126.57298699999998,126.5429004000003,128.15800040000002,126.25460159999999,125.58150199999996,126.322755438479,125.39946991031078,125.73692461538492,128.847992987227,122.6258562435428,126.5429004000003,128.15800040000002,126.25460159999999,125.58150199999996,125.26333333333332,112337808,78258724.8,46.614844620857106,1.5,2.75,1.5316075271724654,1.4354668861151696,-0.10254580668728608,-0.4361327412249807,-0.3335869345376946,15.835494196860461,-1.4058921096279924,1940161821.0,2006-07-20,2006,3,201,7,1.32,125.48,125.19,123.82001000000001,1645
2006-07-21 13:30:00,125.14998999999999,125.19,123.82001000000001,123.95,122.39652173913043,126.45323674999996,126.5565504000003,128.11520040000002,126.08260159999999,125.55600149999998,126.22970620559748,125.26142515694784,125.44077076923107,128.44090169340916,122.44063984505294,126.5565504000003,128.11520040000002,126.08260159999999,125.55600149999998,124.32000333333332,101722192,79595128.0,43.321722832459535,1.5,2.75,1.520063418088718,1.2779952059377302,-0.13250633624113356,-0.4992198548391116,-0.36671351859797796,15.894027471641447,-2.2861724646296797,1838439629.0,2006-07-21,2006,4,202,7,1.11,124.51,126.32001000000001,124.44,1646
2006-07-24 13:30:00,124.44,126.32001000000001,124.44,126.21001000000001,122.39869565217391,126.33348649999998,126.5894504500003,128.08360050000002,125.98780179999999,125.64450199999996,126.22893380537796,125.35176657057188,125.37461692307724,128.264012350527,122.48522149562748,126.5894504500003,128.08360050000002,125.98780179999999,125.64450199999996,125.65667333333332,92889872,81533996.8,52.585839022352076,1.5,2.75,1.5807738882252378,1.139277793873586,0.0032330009226955725,-0.36267226744460856,-0.36590526836730414,19.646924636252752,-0.9418334510634956,1931329501.0,2006-07-24,2006,0,205,7,1.51,125.38,127.3,125.72,1647
2006-07-25 13:30:00,125.98,127.3,125.72,126.66,122.4008695652174,126.21373624999998,126.62675045000029,128.05660050000003,125.9362016,125.72800149999996,126.2458383620298,125.4763602305174,125.31461692307722,128.05870548929371,122.57052835686079,126.62675045000029,128.05660050000003,125.9362016,125.72800149999996,126.56,95483872,84412930.4,54.19134554128623,1.5,2.75,1.5807186104948634,1.1311522008244366,0.12019550752621988,-0.2156608839595293,-0.3358563914857492,19.57561293960345,0.483934946449821,2026813373.0,2006-07-25,2006,1,206,7,1.26,126.51,127.45,126.17998999999999,1648
2006-07-26 13:30:00,126.59,127.45,126.17998999999999,126.83,122.40304347826088,126.09398599999996,126.66285045000029,128.0373006,125.88280159999998,125.87400149999996,126.26874666155805,125.60527830380146,125.3315400000003,128.10987470705936,122.55320529294123,126.66285045000029,128.0373006,125.88280159999998,125.87400149999996,126.81999666666668,84528128,85150292.8,54.81384663318092,1.5,2.75,1.5585251383166587,0.9926933334044861,0.20111543506767535,-0.08446209765115498,-0.28557753271883035,18.48536142330955,2.282258064516128,2111341501.0,2006-07-26,2006,2,207,7,1.01,126.81,127.69,126.2,1649
2006-07-27 13:30:00,127.33,127.69,126.2,126.71001000000001,122.40521739130436,125.97423574999998,126.7034004500003,128.02270070000003,125.83080179999996,125.97200199999996,126.2860511062028,125.71049084629657,125.32077076923107,128.07647187376946,122.56506966469273,126.7034004500003,128.02270070000003,125.83080179999996,125.97200199999996,126.86667,87257184,86394747.2,54.25344330705342,1.5,2.75,1.5536304855797545,1.0099825143073051,0.2362377489097735,0.009719653418386542,-0.22651809549138696,15.107245004869347,2.582585816062177,2024084317.0,2006-07-27,2006,3,208,7,1.18,126.94,128.14,126.86,1650
2006-07-28 13:30:00,126.99001000000001,128.14,126.86,127.98,122.40739130434784,125.85448549999998,126.75115050000029,128.02280070000003,125.85340159999996,126.00750199999996,126.35248047458704,125.92663457522067,125.36461692307724,128.2661691279666,122.46306471818785,126.75115050000029,128.02280070000003,125.85340159999996,126.00750199999996,127.66,82137184,84966775.2,59.02804396255251,1.5,2.75,1.5447990223240566,0.9666976745517346,0.3289806787413804,0.18470775293533848,-0.14427292580604187,15.1715946278209,3.7619588130371335,2106221501.0,2006-07-28,2006,4,209,7,1.01,127.5,127.96001000000001,126.55,1651
2006-07-31 13:30:00,127.66,127.96001000000001,126.55,127.85001000000001,122.4095652173913,125.73473524999996,126.80290055000029,128.01890070000002,125.88620159999996,126.03850249999996,126.41120712264244,126.10981318710444,125.50307923076954,128.68088506008684,122.32527340145228,126.80290055000029,128.01890070000002,125.88620159999996,126.03850249999996,127.45333999999998,49589104,84734735.2,58.356671564884856,1.5,2.75,1.5365990921580532,0.5852275797281302,0.3628840902419195,0.30933218699635745,-0.053551903245562006,15.120386774528134,3.1297975316608846,2056632397.0,2006-07-31,2006,0,212,7,1.11,127.26,127.38,126.60001000000001,1652
2006-08-01 13:30:00,127.34,127.38,126.60001000000001,127.22,122.41173913043478,125.61498499999998,126.85185060000029,128.01730070000002,125.88860139999996,126.00950249999994,126.44292449038194,126.21554526452307,125.75077153846183,128.92329602036077,122.57824705656294,126.85185060000029,128.01730070000002,125.88860139999996,126.00950249999994,127.06667,65220896,86798970.4,55.08648639298151,1.5,2.75,1.5161277284324781,0.7514017240001731,0.32539356420219256,0.3531900520071787,0.027796487804986145,15.833219311818972,1.2172806110271313,1991411501.0,2006-08-01,2006,1,213,8,0.62,126.99,128.46001,127.55,1653
2006-08-02 13:30:00,127.58,128.46001,127.55,128.08,122.41391304347826,125.49523474999998,126.8989006000003,128.01220070000002,125.92760139999996,126.06000199999994,126.5071235299748,126.39311238218752,126.10154076923106,129.21777214894414,122.98530938951805,126.8989006000003,128.01220070000002,125.92760139999996,126.06000199999994,128.03000333333333,64787504,86555670.4,58.50482531742619,1.5,2.75,1.4964050335444448,0.7485067552547082,0.33946733607958063,0.4521306579044619,0.11266332182488133,14.472461028830175,2.603540815509104,2056199005.0,2006-08-02,2006,2,214,8,0.71,128.01,128.55,127.14998999999999,1654
2006-08-03 13:30:00,127.33,128.55,127.14998999999999,128.42,122.41608695652174,125.37548449999996,126.9454506000003,128.00810070000003,125.99260139999996,126.10900199999996,126.58213829350521,126.58614929816964,126.4923100000003,129.3918832646753,123.59273673532532,126.9454506000003,128.00810070000003,125.99260139999996,126.10900199999996,128.03999666666667,63704496,87176420.0,59.807245183095475,1.5,2.75,1.4895196740055563,0.7307537519893568,0.3511639406360484,0.5516182476199418,0.20045430698389344,13.357388488734633,3.6062928600241912,2119903501.0,2006-08-03,2006,3,215,8,1.1,127.85,129.42999,127.48,1655
2006-08-04 13:30:00,129.06,129.42999,127.48,128.2,122.41826086956522,125.25573424999996,126.9973505500003,127.98830080000003,126.03320139999997,126.18850199999993,126.64558385062269,126.73984936501064,126.81769461538494,129.44899947494736,124.18638975582253,126.9973505500003,127.98830080000003,126.03320139999997,126.18850199999993,128.36999666666665,96296624,87909832.8,58.527158725524856,1.5,2.75,1.5224104115765882,1.0954021971476209,0.32421916203881523,0.6057282595324125,0.2815090974935973,12.209924809807005,1.5767291358268585,2023606877.0,2006-08-04,2006,4,216,8,1.53,128.45,128.08,127.39998999999999,1656
2006-08-07 13:30:00,127.89998999999999,128.08,127.39998999999999,127.95,122.4204347826087,125.13598399999998,127.03820055000031,127.96020090000003,126.03760139999996,126.24350149999992,126.69673742510805,126.8551018064382,126.99154076923107,129.60038756065418,124.38269397780796,127.03820055000031,127.96020090000003,126.03760139999996,126.24350149999992,127.80999666666666,45434400,87133732.8,57.03327825047932,1.5,2.75,1.4708103821782594,0.5214329575927453,0.2718137119394212,0.6212762374178737,0.3494625254784526,8.120769757638971,1.0184746565608769,1978172477.0,2006-08-07,2006,0,219,8,0.53,127.74,128.46001,126.95,1657
2006-08-08 13:30:00,128.09,128.46001,126.95,127.41,122.42260869565216,125.01623374999996,127.08690055000031,127.92400090000002,126.01820139999997,126.24350149999992,126.72470850647636,126.90794925344409,127.19000230769264,129.48451643425085,124.89548818113444,127.08690055000031,127.92400090000002,126.01820139999997,126.24350149999992,127.60667,90898128,87996598.4,53.836769926176736,1.5,2.75,1.4736103548798132,1.0329732018368565,0.18707054554887895,0.5833007074145513,0.3962301618656723,8.56872461118232,0.4573050540093024,1887274349.0,2006-08-08,2006,1,220,8,1.19,127.71,128.60001,126.61,1658
2006-08-09 13:30:00,128.2,128.60001,126.61,126.98,122.42478260869564,124.89648349999996,127.1311505500003,127.8876009,126.03580119999997,126.2900014999999,126.73471993759493,126.91481122930657,127.42307923076956,128.77623473819284,126.06992372334629,127.1311505500003,127.8876009,126.03580119999997,126.2900014999999,127.39667,78916128,87814336.0,51.36789736675278,1.5,2.75,1.510496043816969,0.8986702125721249,0.09309467329250204,0.5125985034812999,0.4195038301887978,8.840765485045903,0.2130770883847354,1808358221.0,2006-08-09,2006,2,221,8,1.57,127.61,127.5,126.28,1659
2006-08-10 13:30:00,126.53,127.5,126.28,127.37,122.42695652173911,124.77673324999998,127.16820050000031,127.85720090000002,126.03300139999996,126.4585014999999,126.75963288121866,126.95816254080117,127.51230923076956,128.6730280368443,126.3515904246948,127.16820050000031,127.85720090000002,126.03300139999996,126.4585014999999,127.05,69324320,86157842.4,53.45283811840206,1.5,2.75,1.4897463264014712,0.8046199634172826,0.050376593117031084,0.4824745715850866,0.4320979784680556,8.962732666040207,-0.4766369745272694,1877682541.0,2006-08-10,2006,3,222,8,0.97,126.89,127.2,126.39,1660
2006-08-11 13:30:00,127.17,127.2,126.39,127.00998999999999,122.4291304347826,124.65698299999997,127.2046504500003,127.83140080000004,125.99860119999997,126.63300099999991,126.76945080744537,126.9630984892963,127.53923153846183,128.63398722224548,126.44447585467822,127.2046504500003,127.83140080000004,125.99860119999997,126.63300099999991,126.86666333333332,47489392,83370152.8,51.26784354799089,1.5,2.75,1.4533358745156522,0.5696210262913181,-0.0059534481452302454,0.42465616828651775,0.430609616431748,6.769387814437951,-0.6570355371892388,1830193149.0,2006-08-11,2006,4,223,8,0.64,126.8,128.16,126.92,1661
2006-08-14 13:30:00,127.63,128.16,126.92,127.11,122.43130434782609,124.53723274999996,127.2433504500003,127.79870080000003,125.96080119999996,126.8215009999999,126.78280567774164,126.9770891093633,127.5607700000003,128.60888803395224,126.51265196604835,127.2433504500003,127.79870080000003,125.96080119999996,126.8215009999999,127.39666666666666,58044496,82207896.0,51.85659225567858,1.5,2.75,1.4380975977645338,0.7060695970129195,-0.03849131824325347,0.3824954686276811,0.4209867868709346,6.823245715431218,-0.08646439239113303,1888237645.0,2006-08-14,2006,0,226,8,0.98,127.54,128.87,127.89998999999999,1662
2006-08-15 13:30:00,128.21001,128.87,127.89998999999999,128.63,122.43347826086956,124.41748249999998,127.29600040000031,127.78390080000004,125.99100119999996,127.05450099999992,126.85524467077136,127.13450919418587,127.70846153846183,128.7763402453392,126.64058283158444,127.29600040000031,127.78390080000004,125.99100119999996,127.05450099999992,128.46666333333334,68149808,79430536.0,59.804863643608286,1.5,2.75,1.4610906264956387,0.8579799587403011,0.036297146475038115,0.4663582199647322,0.4300610734896941,9.274800852495606,0.4294191130543277,1956387453.0,2006-08-15,2006,1,227,8,0.76,128.38,129.89,129.03999,1663
2006-08-16 13:30:00,129.32001,129.89,129.03999,129.78999,122.43565217391304,124.29773224999997,127.34595035000034,127.7797006,126.05060099999996,127.2595004999999,126.970332722898,127.38741212807292,127.84769153846183,129.3882417621822,126.30714131474147,127.34595035000034,127.7797006,126.05060099999996,127.2595004999999,129.57332666666665,71759184,76298536.0,64.60713717382991,1.5,2.75,1.4467270103173782,0.940505385319582,0.15137741800699767,0.6192828459984412,0.4679054279914435,9.843112787972302,1.0668042361002972,2028146637.0,2006-08-16,2006,2,228,8,0.66,129.46,130.37,129.49001,1664
2006-08-17 13:30:00,129.58,130.37,129.49001,130.03,122.43782608695652,124.17798199999996,127.3954503500003,127.77980060000002,126.13400099999996,127.51950049999992,127.0903196749412,127.63908716349457,128.01538307692334,129.94571646322822,126.08504969061848,127.3954503500003,127.77980060000002,126.13400099999996,127.51950049999992,129.96333666666666,70994816,74231386.4,65.52491694886412,1.5,2.75,1.4062457952947078,0.956398895979666,0.2266231213578036,0.7511843296886981,0.5245612083308944,9.814369563412026,1.4274570982839412,2099141453.0,2006-08-17,2006,3,229,8,0.68,129.93,130.69,129.59,1665
2006-08-18 13:30:00,130.19,130.69,129.59,130.69,122.44,124.05823174999996,127.44645030000031,127.79450060000003,126.23280099999994,127.85650049999992,127.23148360925722,127.92965029078077,128.28230615384646,130.61632388904093,125.948288418652,127.44645030000031,127.79450060000003,126.23280099999994,127.85650049999992,130.32333333333332,58288400,72059696.8,67.98355805470351,1.5,2.75,1.3843710956307995,0.8088904420702475,0.29924304568127114,0.8986150154324832,0.5993719697512121,9.836872014740836,2.1414615084017155,2157429853.0,2006-08-18,2006,4,230,8,0.85,130.14,130.28,129.8,1666
2006-08-21 13:30:00,130.17999,130.28,129.8,130.13,122.44217391304348,123.93848149999997,127.4883503000003,127.7955006,126.32840079999994,128.05249999999995,127.34515091869812,128.13920740594452,128.43999846153878,130.9670582672364,125.91293865584116,127.4883503000003,127.7955006,126.32840079999994,128.05249999999995,130.07000000000002,42133696,69521888.0,63.82440082481689,1.5,2.75,1.349058874514313,0.606049363906803,0.287870740859107,0.959210395825096,0.6713396549659889,10.25634656651687,2.134840279412918,2115296157.0,2006-08-21,2006,0,233,8,0.37,130.04,130.52,129.67999,1667
2006-08-22 13:30:00,129.94,130.52,129.67999,130.12,122.44434782608695,123.81873124999996,127.5276003000003,127.79870060000003,126.45100059999993,128.22549999999995,127.45396852972955,128.32785431966408,128.57076769230798,131.25142772231732,125.89010766229866,127.5276003000003,127.79870060000003,126.45100059999993,128.22549999999995,130.10666333333333,60840496,67789719.2,63.7493985913474,1.5,2.75,1.3126982406204342,0.8974885383505172,0.25889348846999505,0.9949565155534827,0.7360630270834877,9.639262161818532,2.472830366986928,2054455661.0,2006-08-22,2006,1,234,8,0.65,130.1,130.44,129.19,1668
2006-08-23 13:30:00,130.17999,130.44,129.19,129.75999,122.44652173913045,123.69898099999996,127.56585025000031,127.79800050000004,126.59520039999992,128.37199949999996,127.54440074424996,128.4642481939818,128.6907669230772,131.43324657332434,125.94828727283009,127.56585025000031,127.79800050000004,126.59520039999992,128.37199949999996,129.79666333333333,66610128,66893819.2,60.97151719292408,1.5,2.75,1.308219794861832,0.9957590820289118,0.1974739403215049,0.9829054524853688,0.7854315121638641,9.518130623543321,1.8764151684069896,1987845533.0,2006-08-23,2006,2,235,8,0.97,129.82,130.10001,129.39999,1669
2006-08-24 13:30:00,129.99001,130.10001,129.39999,129.64999,122.44869565217392,123.57923074999997,127.60295020000031,127.79720040000004,126.71820019999993,128.51899849999995,127.62697287192644,128.57717598503115,128.82153538461571,131.57236467239485,126.0707060968365,127.60295020000031,127.79720040000004,126.71820019999993,128.51899849999995,129.71666333333334,57982896,65430104.8,60.10964166257242,1.5,2.75,1.2647769523717007,0.8861806988883197,0.1344448749839019,0.9534876058937414,0.8190427309098395,9.646470744470555,2.078576653694721,1929862637.0,2006-08-24,2006,3,236,8,0.54,129.75,130.25,129.55,1670
2006-08-25 13:30:00,129.64,130.25,129.55,129.81,122.4508695652174,123.45948049999996,127.6408502000003,127.78970040000004,126.79200019999992,128.61049849999995,127.71258177890972,128.69458779598057,129.00615076923108,131.6741666834356,126.33813485502651,127.6408502000003,127.78970040000004,126.79200019999992,128.61049849999995,129.87,41757904,63411140.8,60.97383818265124,1.5,2.75,1.224435741488007,0.6585263011070129,0.09063606355114427,0.9323378103487698,0.8417017467976255,9.20972933704596,2.1241444418220463,1971620541.0,2006-08-25,2006,4,237,8,0.54,129.9,130.82001,129.64,1671
2006-08-28 13:30:00,129.64999,130.82001,129.64,130.42999,122.45304347826088,123.33973024999996,127.6810501500003,127.78390040000004,126.90760019999992,128.73949749999994,127.81914680718779,128.85986419636336,129.2715346153849,131.7609561475101,126.7821130832597,127.6810501500003,127.78390040000004,126.90760019999992,128.73949749999994,130.29666666666665,52679504,63565660.8,64.2093050007379,1.5,2.75,1.2212624742388642,0.8287415459385896,0.09031893627394504,0.9546004171400568,0.8642814808661118,9.272015136585964,1.399354738396959,2024300045.0,2006-08-28,2006,0,240,8,0.91,130.23,130.83,129.81,1672
2006-08-29 13:30:00,130.49001,130.83,129.81,130.58,122.45521739130434,123.21997999999996,127.71725015000031,127.78100040000002,127.04580019999992,128.90749749999995,127.92741555984706,129.02368665385256,129.51845769230798,131.83525842258024,127.2016569620357,127.71725015000031,127.78100040000002,127.04580019999992,128.90749749999995,130.40666666666667,61817008,63395466.4,64.96611970370645,1.5,2.75,1.2068865832218034,0.9751013993644191,0.08707929762097111,0.9731306028923256,0.8860513052713546,7.132897097594254,0.6086833044674891,2086117053.0,2006-08-29,2006,1,241,8,0.79,130.32,131.03999,130.55,1673
2006-08-30 13:30:00,130.87,131.03999,130.55,130.66,122.45739130434782,123.10022974999997,127.7517502000003,127.79220050000004,127.17720019999993,129.03649749999994,128.0345757339707,129.1795260201523,129.799227692308,131.67461349027778,127.92384189433821,127.7517502000003,127.79220050000004,127.17720019999993,129.03649749999994,130.74999666666668,50053104,62658746.4,65.38647805448687,1.5,2.75,1.1556796844202444,0.798820705420305,0.07751136669006409,0.9829405136339346,0.9054291469438706,5.313269185109734,0.4845035760978201,2136170157.0,2006-08-30,2006,2,242,8,0.38,130.79,130.99001,130.58,1674
2006-08-31 13:30:00,130.85001,130.99001,130.58,130.64,122.4595652173913,122.98047949999996,127.7865002000003,127.80120040000004,127.28980039999992,129.14749749999993,128.1367492345993,129.3186187801378,130.0707661538465,131.1727790491507,128.96875325854222,127.7865002000003,127.80120040000004,127.28980039999992,129.14749749999993,130.73667,38523008,61399672.0,65.17593380123499,1.5,2.75,1.1024175641045126,0.6274139054032731,0.057920121043005375,0.9778292982476272,0.9199091772046221,5.274764049943377,-0.03825847425205553,2097647149.0,2006-08-31,2006,3,243,8,0.31,130.79,131.58,130.84,1675
2006-09-01 13:30:00,131.14,131.58,130.84,131.42,122.46173913043478,122.86072924999996,127.8274001500003,127.82900040000004,127.42900019999992,129.30849749999996,128.2655041665758,129.51875032488658,130.28538153846188,131.26088981751295,129.3098732594108,127.8274001500003,127.82900040000004,127.42900019999992,129.30849749999996,131.28,48800000,59024840.8,69.32448622368247,1.5,2.75,1.0908163095256207,0.8267705484433937,0.08399558076778901,1.0249036531643585,0.9409080723965692,5.5739034895210375,0.9913163759317544,2146447149.0,2006-09-01,2006,4,244,9,0.57,131.21,131.85001,131.2,1676
2006-09-05 13:30:00,131.50999,131.85001,131.2,131.67,122.46391304347826,122.74097899999997,127.86830010000031,127.85690040000004,127.57360019999994,129.49449749999997,128.39901380710222,129.72363124632594,130.42999769230804,131.60573039352678,129.25426499108931,127.86830010000031,127.85690040000004,127.57360019999994,129.49449749999997,131.57333666666668,52348896,59370565.6,70.53602824399375,1.5,2.75,1.0593301445595056,0.8817314686319916,0.10331232327963402,1.0700484764961118,0.9667361532164778,4.662261459568925,1.1912081155856002,2198796045.0,2006-09-05,2006,1,248,9,0.5,131.53,131.16,130.33,1677
2006-09-06 13:30:00,131.11,131.16,130.33,130.50999,122.46608695652174,122.62122874999996,127.89765005000031,127.87490020000004,127.68399979999992,129.64949699999997,128.48179718721585,129.79852255619969,130.4669200000003,131.6200171374513,129.31382286254936,127.89765005000031,127.87490020000004,127.68399979999992,129.64949699999997,130.66666333333333,53795600,57515439.2,58.909760927272565,1.5,2.75,1.0793779913766821,0.9353245102229872,0.02716120337639372,1.00068765743697,0.973526454060576,7.418962822666602,0.5779901801780349,2145000445.0,2006-09-06,2006,2,249,9,0.64,130.74,130.57001,129.35001,1678
2006-09-07 13:30:00,130.06,130.57001,129.35001,129.91,122.4682608695652,122.50147849999996,127.92155005000029,127.88740020000004,127.80399979999993,129.79599699999997,128.53780514065835,129.80913945560923,130.4069200000003,131.5881712892669,129.22566871073374,127.92155005000029,127.88740020000004,127.80399979999993,129.79599699999997,129.94333999999998,86300624,57884664.0,53.95598989175552,1.5,2.75,1.0894224205640617,1.4909065378698578,-0.06915809341513801,0.8870788372916536,0.9562369307067916,7.76319795896087,0.2005476436982325,2058699821.0,2006-09-07,2006,3,250,9,0.94,129.96,130.46001,129.83,1679
2006-09-08 13:30:00,130.08,130.46001,129.83,130.28,122.47043478260868,122.38172824999997,127.9441501000003,127.88320020000003,127.91459979999992,129.94149699999997,128.60612650769136,129.85398331697976,130.4184584615388,131.59156685157714,129.24535007150038,127.9441501000003,127.88320020000003,127.91459979999992,129.94149699999997,130.19000333333335,45107696,56673832.8,56.39135275678726,1.5,2.75,1.0566072476666286,0.7959175120409362,-0.11100907504920587,0.8174755868952843,0.9284846619444902,7.883409583606576,0.3620676373160765,2103807517.0,2006-09-08,2006,4,251,9,0.49,130.15,130.69,129.48,1680
2006-09-11 13:30:00,129.86,130.69,129.48,130.41,122.47260869565216,122.26197799999996,127.9647001000003,127.87780020000004,127.97739979999993,130.11149749999998,128.67686664464463,129.90693728679122,130.44076615384648,131.60128600680358,129.28024630088942,127.9647001000003,127.87780020000004,127.97739979999993,130.11149749999998,130.1933333333333,68497184,57724222.4,57.24697815434062,1.5,2.75,1.0675638728332986,1.1866280939282086,-0.13158970153586635,0.7639975350246573,0.8955872365605236,7.876385168795773,-0.015326229803442488,2172304701.0,2006-09-11,2006,0,254,9,0.93,130.08,131.84,130.3681,1681
2006-09-12 13:30:00,130.56,131.84,130.3681,131.69,122.47478260869563,122.14222774999996,127.9880001000003,127.88340020000004,128.06659979999992,130.34049749999997,128.7950287370115,130.0767527832873,130.5892284615388,131.85264457081226,129.32581235226533,127.9880001000003,127.88340020000004,128.06659979999992,130.34049749999997,131.29936666666666,69888128,58316404.0,64.60981512614059,1.5,2.75,1.0964450247737776,1.198429999216001,-0.0640693781050975,0.8155005139291518,0.8795698920342493,9.27225463178276,0.8500536069842128,2242192829.0,2006-09-12,2006,1,255,9,1.13,131.1,132.45,131.52,1682
2006-09-13 13:30:00,131.64,132.45,131.52,132.22,122.47695652173913,122.02247749999997,128.0134501000003,127.89410030000003,128.15499979999993,130.51999749999996,128.92934133556008,130.28087156583138,130.78692153846183,132.19643750560357,129.37740557132014,128.0134501000003,127.89410030000003,128.15499979999993,130.51999749999996,132.06333333333336,62913008,58054564.0,67.1337551867298,1.5,2.75,1.084556094432792,1.0836875460816482,0.0074141662179768595,0.8888375998067204,0.8814234335887435,9.437615473431439,1.1939384662482797,2305105837.0,2006-09-13,2006,2,256,9,0.71,131.99,132.24001,131.75,1683
2006-09-14 13:30:00,131.96001,132.24001,131.75,132.23,122.4791304347826,121.90272724999996,128.0434501000003,127.90730030000003,128.2581995999999,130.64199799999997,129.05877893024402,130.46650284527598,130.9730753846157,132.45470619572558,129.49144457350582,128.0434501000003,127.90730030000003,128.2581995999999,130.64199799999997,132.07333666666668,57812192,57357214.4,67.1813134750011,1.5,2.75,1.042088516259022,1.0079323517496346,0.04443241153186928,0.93696394800358,0.8925315364717108,9.455810986151294,1.2170851194121275,2362918029.0,2006-09-14,2006,3,257,9,0.37,132.0,132.39,131.67999,1684
2006-09-15 13:30:00,132.31,132.39,131.67999,131.96001,122.48130434782608,121.78297699999996,128.07280015000032,127.92320040000004,128.3485997999999,130.73849849999993,129.1725526976854,130.60874162191638,131.09076923076955,132.62334085620026,129.55819760533885,128.07280015000032,127.92320040000004,128.3485997999999,130.73849849999993,132.01,76715680,57643257.6,64.46888286928714,1.5,2.75,1.018368622240519,1.3308699611036556,0.039938339395585,0.942454460716192,0.9025161213206071,9.614925852377716,0.41090397199819184,2286202349.0,2006-09-15,2006,4,258,9,0.54,132.03,132.39,131.64999,1685
2006-09-18 13:30:00,131.78999,132.39,131.64999,132.14,122.48347826086956,121.66322674999996,128.10645015000028,127.94060050000004,128.4591997999999,130.81099849999993,129.2889231801291,130.75457575316244,131.21076923076956,132.80752761122184,129.6140108503173,128.10645015000028,127.94060050000004,128.4591997999999,130.81099849999993,132.05999666666665,64155504,57936612.8,65.46979215750034,1.5,2.75,0.9984858635090522,1.1073395716361245,0.03828638240673443,0.9503740993290252,0.9120877169222906,9.098910797448694,0.3569529885319351,2350357853.0,2006-09-18,2006,0,261,9,0.56,132.02,132.13,131.07001,1686
2006-09-19 13:30:00,132.12,132.13,131.07001,131.81,122.48565217391304,121.54347649999997,128.1320501500003,127.94840050000002,128.55839959999992,130.89499849999993,129.3877889377711,130.85509234809936,131.2992307692311,132.89155092529202,129.70691061317015,128.1320501500003,127.94840050000002,128.55839959999992,130.89499849999993,131.67000333333334,92097808,60434818.4,62.02018860818135,1.5,2.75,1.0035933018298335,1.5239196615175068,0.005868773666039885,0.9194236840048404,0.9135549103388004,9.208817929881498,0.9960999920389348,2258260045.0,2006-09-19,2006,1,262,9,0.81,131.6,132.77,132.06,1687
2006-09-20 13:30:00,132.25,132.77,132.06,132.50999,122.48782608695652,121.42372624999996,128.16035005000032,127.95880040000004,128.6603993999999,131.01449799999997,129.5102281951134,131.01270164828034,131.4430761538465,133.10742491398872,129.77872739370423,128.16035005000032,127.95880040000004,128.6603993999999,131.01449799999997,132.44666333333336,75212816,61153434.4,66.10042274865515,1.5,2.75,1.0004794945562747,1.2299033854425678,0.021585414488005997,0.940536678448808,0.918951263960802,7.619681809320048,2.0013778769917567,2333472861.0,2006-09-20,2006,2,263,9,0.54,132.42,132.75,131.42,1688
2006-09-21 13:30:00,132.61,132.75,131.42,131.87,122.49,121.30397599999996,128.1868000500003,127.97350050000004,128.7767993999999,131.11999849999992,129.60276826589327,131.0943491103489,131.47769153846184,133.15732878167688,129.7980542952468,128.1868000500003,127.97350050000004,128.7767993999999,131.11999849999992,132.01333333333332,88947008,62270278.4,59.777260502665605,1.5,2.75,1.0240166735165417,1.4284022857363683,-0.018915812550229342,0.8953064982730154,0.9142223108232448,7.689114848491548,1.2204482652747954,2244525853.0,2006-09-21,2006,3,264,9,1.01,132.08,131.67999,131.0,1689
2006-09-22 13:30:00,131.67,131.67999,131.0,131.47,122.49217391304347,121.18422574999997,128.2100500000003,127.97440050000004,128.92619939999992,131.21099899999993,129.67599303977983,131.13012538555375,131.46230692307722,133.1382763386143,129.78633750754014,128.2100500000003,127.97440050000004,128.92619939999992,131.21099899999993,131.38332999999997,65969184,62669592.8,56.16118227720954,1.5,2.75,1.0130154825510749,1.0526505926172225,-0.07717145469302678,0.8177579924569613,0.8949294471499881,8.043984749087597,0.8128211026761769,2178556669.0,2006-09-22,2006,4,265,9,0.52,131.34,132.85001,131.05,1690
2006-09-25 13:30:00,131.73,132.85001,131.05,132.48,122.49434782608697,121.06447549999996,128.24205000000032,127.99030050000003,129.1053993999999,131.34449899999993,129.78595409704337,131.25868487264387,131.61384615384642,133.2741609240698,129.95353138362307,128.24205000000032,127.99030050000003,129.1053993999999,131.34449899999993,132.12667,92298320,65196613.6,62.35373569479054,1.5,2.75,1.0692293766545684,1.4156919340362797,-0.053342567900856334,0.8282512372739177,0.881593805174774,8.92666965093243,0.5998936897258653,2270854989.0,2006-09-25,2006,0,268,9,1.37,131.95,133.60001,132.39999,1691
2006-09-26 13:30:00,132.5,133.60001,132.39999,133.58,122.49652173913044,120.94472524999996,128.2799500000003,128.01250050000004,129.3101993999999,131.50199949999993,129.9347402108848,131.47976250382064,131.89615384615414,133.54965332327671,130.24265436903156,128.2799500000003,128.01250050000004,129.3101993999999,131.50199949999993,133.19333333333336,74016624,66263469.6,67.70442722433731,1.5,2.75,1.0785715640363849,1.1170049568306941,0.026551330011090668,0.9147829676886374,0.8882316376775468,8.453480812666163,1.0285887157767462,2344871613.0,2006-09-26,2006,1,269,9,0.91,133.0,133.97,133.27,1692
2006-09-27 13:30:00,133.49001,133.97,133.27,133.74001,122.49869565217392,120.82497499999997,128.3170000500003,128.02470060000005,129.5055995999999,131.6599999999999,130.08396647712465,131.69502417012345,132.16230846153874,133.8033823429407,130.52123458013682,128.3170000500003,128.02470060000005,129.5055995999999,131.6599999999999,133.66000333333332,82433872,67294312.8,68.40783400970446,1.5,2.75,1.051530738033785,1.2249753147044546,0.07734903892236589,0.984917936330504,0.9075688974081382,8.2908855751423,1.1419571957952224,2427305485.0,2006-09-27,2006,2,270,9,0.53,133.62,133.99001,133.28,1693
2006-09-28 13:30:00,133.74001,133.99001,133.28,133.69,122.5008695652174,120.70522474999996,128.35320005000028,128.03800060000003,129.6655995999999,131.81149999999994,130.22537955645308,131.88502186820693,132.41461615384642,133.90182713005962,130.92740517763332,128.35320005000028,128.03800060000003,129.6655995999999,131.81149999999994,133.65333666666666,58601600,67721737.6,67.90999187151245,1.5,2.75,1.0271363996028011,0.8653292440033318,0.09366764055371436,1.0246534481002811,0.9309858075465668,8.315982087109795,1.3109956569418162,2368703885.0,2006-09-28,2006,3,271,9,0.53,133.64,133.94,133.48,1694
2006-09-29 13:30:00,133.8,133.94,133.48,133.58,122.50304347826086,120.58547449999996,128.38455005000029,128.0476006,129.8405995999999,131.95849999999993,130.35693329933727,132.04644835694913,132.56000076923104,134.10388324788724,131.01611829057484,128.38455005000029,128.0476006,129.8405995999999,131.95849999999993,133.66666666666666,47991696,68195172.0,66.75914616684575,1.5,2.75,0.9866266567740304,0.7037403762248741,0.08347804849833795,1.0353333681694892,0.9518553196711512,8.175884522815398,1.0897532919630897,2320712189.0,2006-09-29,2006,4,272,9,0.34,133.71,133.83,132.34,1695
2006-10-02 13:30:00,133.53999,133.83,132.34,133.08,122.50521739130434,120.46572424999997,128.4109000500003,128.05290060000004,130.02319959999986,132.04149999999993,130.46372022877503,132.1448818467635,132.62615461538488,134.17976272060054,131.07254651016922,128.4109000500003,128.05290060000004,130.02319959999986,132.04149999999993,133.08333333333334,52444496,68377396.8,61.645324615991534,1.5,2.75,1.022581895575886,0.7669858528454537,0.03212863719491188,0.9920161161647912,0.9598874789698792,8.654487093340792,0.9635080798118582,2268267693.0,2006-10-02,2006,0,275,10,1.13,133.08,133.87,132.64999,1696
2006-10-03 13:30:00,132.89,133.87,132.64999,133.36,122.50739130434782,120.34597399999996,128.4405000500003,128.07700060000002,130.1661993999999,132.12599999999992,130.5772998276466,132.26060738516696,132.71307769230796,134.2944973526845,131.13165803193144,128.4405000500003,128.07700060000002,130.1661993999999,132.12599999999992,133.29333,73108688,69415386.4,63.338931552524784,1.5,2.75,1.0366839030347512,1.0532058062562335,0.00737741969107597,0.9691092535837242,0.9617318338926484,8.43064871078613,0.6414686168190232,2341376381.0,2006-10-03,2006,1,276,10,0.92,133.26,135.0,133.08,1697
2006-10-04 13:30:00,133.23,135.0,133.08,134.92,122.5095652173913,120.22622374999996,128.48330005000028,128.13380050000004,130.3313993999999,132.34650049999993,130.74760179518992,132.51388287229392,132.9407692307695,134.8427776355299,131.03876082600908,128.48330005000028,128.13380050000004,130.3313993999999,132.34650049999993,134.33333333333334,80893312,70770272.0,71.01751603608203,1.5,2.75,1.0997779099608396,1.1430408519554651,0.08226472954402864,1.064562745822684,0.9822980162786554,10.165344996104254,2.312883900811392,2422269693.0,2006-10-04,2006,2,277,10,1.44,134.04,135.41,134.75,1698
2006-10-05 13:30:00,134.92,135.41,134.75,135.17999,122.51173913043478,120.10647349999996,128.5306499500003,128.19060040000005,130.49839919999988,132.60999999999996,130.92142094047657,132.76779783683736,133.17461461538488,135.35277951483684,130.99644971593293,128.5306499500003,128.19060040000005,130.49839919999988,132.60999999999996,135.11333,60640000,69487240.8,72.0675464147168,1.5,2.75,1.0683652021064936,0.8726781967719174,0.13252672239858,1.1479564192768803,1.0154296968783003,9.2497116112118,2.8219289571765462,2482909693.0,2006-10-05,2006,3,278,10,0.49,135.08,135.10001,134.39999,1699
2006-10-06 13:30:00,134.95,135.10001,134.39999,135.00999,122.51391304347824,119.98672324999997,128.57654990000032,128.24760030000004,130.6643987999999,132.84649949999994,131.0817569820265,132.9813399476147,133.42076769230795,135.64911995966892,131.19241542494694,128.57654990000032,128.24760030000004,130.6643987999999,132.84649949999994,134.83666333333335,65001808,70481946.4,70.27470348748477,1.5,2.75,1.0477676876703157,0.9222476296426456,0.13697621443804975,1.1866499649258628,1.049673750487813,8.912384967246878,1.9097146739130424,2417907885.0,2006-10-06,2006,4,279,10,0.52,134.75,135.3,134.64,1700
2006-10-09 13:30:00,134.85001,135.3,134.64,135.09,122.51608695652172,119.86697299999994,128.62184990000029,128.33000020000006,130.8065987999999,133.08049949999997,131.23894298273134,133.1821647145086,133.6192300000003,135.94519287376946,131.2932671262311,128.62184990000029,128.33000020000006,130.8065987999999,133.08049949999997,135.01,41177904,69115982.4,70.64484425995884,1.5,2.75,1.020069995693866,0.5957797685879379,0.1281209264080414,1.2098249084978647,1.081703982089823,8.369971830750607,1.1304087438239188,2459085789.0,2006-10-09,2006,0,282,10,0.49,134.97,135.45,134.84,1701
2006-10-10 13:30:00,135.11,135.45,134.84,135.27,122.5182608695652,119.74722274999996,128.66474990000032,128.42060010000006,130.9549985999999,133.25949949999998,131.39702365007523,133.38100617026967,133.8807684615387,136.12431242478098,131.63722449829643,128.66474990000032,128.42060010000006,130.9549985999999,133.25949949999998,135.18666666666664,56428496,68443000.8,71.50451030684675,1.5,2.75,0.9907792817157316,0.8244597013636492,0.11747978351573662,1.2285537114844942,1.1110739279687576,7.339655487076442,1.144003204426258,2515514285.0,2006-10-10,2006,1,283,10,0.45,135.14,135.42999,134.3,1702
2006-10-11 13:30:00,134.84,135.42999,134.3,135.11,122.52043478260867,119.62747249999997,128.7064999500003,128.50070000000005,131.1127985999999,133.40399949999997,131.54263056575854,133.54567224929158,134.1607684615387,136.00374653009337,132.31779039298405,128.7064999500003,128.50070000000005,131.1127985999999,133.40399949999997,134.94666333333336,104076320,70501166.4,69.55464904997169,1.5,2.75,1.000722904450322,1.4762354343119066,0.08431136179922549,1.2164631302177895,1.1321517684185638,7.472399000604953,1.0621587254095417,2411437965.0,2006-10-11,2006,2,284,10,0.84,134.86,136.39,135.39999,1703
2006-10-12 13:30:00,135.45,136.39,135.39999,136.28,122.52260869565217,119.50772224999994,128.7605499500003,128.60220000000007,131.2767985999999,133.60649949999998,131.7284097592582,133.80608441602578,134.4530761538464,136.34184758892408,132.56430471876874,128.7605499500003,128.60220000000007,131.2767985999999,133.60649949999998,136.02333000000002,59172896,70569201.6,74.93681511421309,1.5,2.75,1.020671268418154,0.8385087921980968,0.12344735184572266,1.2864609582257174,1.1630136063799947,8.560037412413497,2.0212606677646265,2470610861.0,2006-10-12,2006,3,285,10,0.73,135.89,136.71001,136.03999,1704
2006-10-13 13:30:00,136.16,136.71001,136.03999,136.63,122.52478260869565,119.38797199999996,128.8149499500003,128.71680000000006,131.44099859999992,133.83999899999998,131.92062898438533,134.07502875735665,134.68769153846182,136.8256557407868,132.54972733613684,128.8149499500003,128.71680000000006,131.44099859999992,133.83999899999998,136.46,53945296,69430682.4,76.28728309437781,1.5,2.75,0.9956247492454304,0.7769662364718454,0.15323892733249211,1.3545622655456102,1.201323338213118,8.382333510896508,2.6675683799218386,2524556157.0,2006-10-13,2006,4,286,10,0.49,136.38,137.05,136.42,1705
2006-10-16 13:30:00,136.52,137.05,136.42,136.84,122.52695652173912,119.26822174999997,128.8731999500003,128.82350000000002,131.6137985999999,134.074999,132.1135454948016,134.3383593518941,134.92615230769258,137.26975249275478,132.58255212263037,128.8731999500003,128.82350000000002,131.6137985999999,134.074999,136.77,42275904,68336702.4,77.08509769044731,1.5,2.75,0.9695086957279012,0.6186412647268739,0.16632814574240662,1.409233520391126,1.2429053746487195,7.500672573461594,2.6094781043791158,2566832061.0,2006-10-16,2006,0,289,10,0.46,136.74,136.7,135.67,1706
2006-10-17 13:30:00,136.47,136.7,135.67,136.41,122.5291304347826,119.14847149999994,128.9327000000003,128.91030000000006,131.7829985999999,134.304999,132.28203390677015,134.53565846123752,135.13538307692335,137.48584127729495,132.78492487655174,128.9327000000003,128.91030000000006,131.7829985999999,134.304999,136.26,90785376,68271080.8,71.76103456131975,1.5,2.75,0.9838295031759096,1.3297779226017468,0.1270400915249028,1.401705489054848,1.2746653975299451,8.242193728653218,1.1043581381559509,2476046685.0,2006-10-17,2006,1,290,10,0.76,136.18,137.37,136.10001,1707
2006-10-18 13:30:00,137.03999,137.37,136.10001,136.59,122.53130434782608,119.02872124999996,128.9821500000003,128.99240000000006,131.9665985999999,134.50899950000002,132.4509737535635,134.73131003635774,135.3669215384618,137.65097244727386,133.0828706296498,128.9821500000003,128.99240000000006,131.9665985999999,134.50899950000002,136.68667000000002,87371184,68878999.2,72.61373085282327,1.5,2.75,1.0042695386633451,1.2684734826983377,0.09562174712601634,1.3941925814374656,1.2985708343114493,5.686993019839607,1.0430611808744767,2563417869.0,2006-10-18,2006,2,291,10,0.93,136.74,136.88,136.23,1708
2006-10-19 13:30:00,136.39,136.88,136.23,136.81,122.53347826086956,118.90897099999994,129.0297000000003,129.09949990000007,132.16319859999993,134.7559995,132.62191595930608,134.92928050908557,135.65384461538488,137.63352058318063,133.67416864758914,129.0297000000003,129.09949990000007,132.16319859999993,134.7559995,136.64,64081808,67635739.2,73.66058592396206,1.5,2.75,0.9789645716159636,0.9474548331690296,0.07311775115829189,1.389968023259314,1.3168502721010222,5.675777009091346,1.3332420808267704,2627499677.0,2006-10-19,2006,3,292,10,0.48,136.56,136.95,136.33,1709
2006-10-20 13:30:00,136.81,136.95,136.33,136.84,122.53565217391304,118.78922074999994,129.0770000000003,129.19280000000006,132.35259859999994,135.02449950000002,132.78733101972549,135.11125379393457,135.92153692307718,137.48563433229944,134.35743951385493,129.0770000000003,129.19280000000006,132.35259859999994,135.02449950000002,136.70666666666668,48099504,66742255.2,73.80761795055305,1.5,2.75,0.9533242450719648,0.7206754380094725,0.04508878647186454,1.3732112551908529,1.3281224687189883,5.502856338116389,1.2954326745132874,2675599181.0,2006-10-20,2006,4,293,10,0.45,136.64,137.8,136.39,1710
2006-10-23 13:30:00,136.56,137.8,136.39,137.47,122.53782608695651,118.66947049999996,129.12215000000032,129.28020000000006,132.56179879999993,135.2739995,132.9709650973833,135.33589628975028,136.11769076923102,137.76742470373068,134.46795683473135,129.12215000000032,129.28020000000006,132.56179879999993,135.2739995,137.22,66234000,65439039.2,76.74359342199995,1.5,2.75,0.9859439418525404,1.012148112345757,0.05325403489921365,1.3946900123430055,1.3414359774437918,5.773896946052152,1.6263768758778654,2741833181.0,2006-10-23,2006,0,296,10,1.03,137.1,137.92999,137.22,1711
2006-10-24 13:30:00,137.28,137.92999,137.22,137.88,122.54,118.54972024999994,129.16770000000034,129.36900000000006,132.77719879999995,135.48899950000003,133.16347627003495,135.57819188120266,136.32538384615407,138.12375485135667,134.52701284095147,129.16770000000034,129.36900000000006,132.77719879999995,135.48899950000003,137.67666333333332,53355392,64405977.6,78.43755451480939,1.5,2.75,0.9662329460059308,0.8284229816581496,0.06951581633526471,1.4283307478628728,1.358814931527608,5.807731005374719,2.05018133372806,2795188573.0,2006-10-24,2006,1,297,10,0.52,137.57,138.41,137.50999,1712
2006-10-25 13:30:00,137.74001,138.41,137.50999,138.35001,122.54217391304348,118.42996999999994,129.2149501000003,129.48130010000006,132.97159899999994,135.71949950000004,133.3668697496414,135.84217455918338,136.5823084615387,138.505580203098,134.6590367199794,129.2149501000003,129.48130010000006,132.97159899999994,135.71949950000004,138.09,80750816,64321824.8,80.21653469762794,1.5,2.75,0.9615027355769364,1.255418611817742,0.0936711357497384,1.475903851214781,1.382232715465043,5.502624844824048,1.5189389492221868,2875939389.0,2006-10-25,2006,2,298,10,0.65,137.96,139.0,137.98,1713
2006-10-26 13:30:00,138.66,139.0,137.98,138.78,122.54434782608696,118.31021974999994,129.26230010000032,129.60100010000005,133.15139919999993,135.97399950000005,133.5791493673025,136.12196745830877,136.86615461538486,138.91006770774996,134.82224152301978,129.26230010000032,129.60100010000005,133.15139919999993,135.97399950000005,138.58666666666667,66848368,64734163.2,81.70374137657821,1.5,2.75,0.965681111607156,1.0326597996403852,0.1187402317152484,1.5306580051091032,1.4119177733938548,3.8850734358033185,1.5735929151723675,2942787757.0,2006-10-26,2006,3,299,10,0.74,138.49,138.75,137.63,1714
2006-10-27 13:30:00,138.61,138.75,137.63,137.91,122.54652173913044,118.19046949999995,129.3078501000003,129.72150010000004,133.30899919999993,136.19049950000004,133.74898664701615,136.29225627180315,137.0692315384618,138.95708077654123,135.18138230038235,129.3078501000003,129.72150010000004,133.30899919999993,136.19049950000004,138.09666666666666,80239376,66346547.2,70.20426560473527,1.5,2.75,0.9788467464923596,1.2093979172438378,0.05983494389187016,1.4867114532586925,1.4268765093668223,6.001246505446037,0.7819351066939442,2862548381.0,2006-10-27,2006,4,300,10,0.81,138.19,138.2,137.39999,1715
2006-10-30 14:30:00,137.66,138.2,137.39999,137.81,122.5486956521739,118.07071924999994,129.35350015000031,129.84210010000004,133.45139919999997,136.42699950000002,133.90824207262338,136.4368032935362,137.2769238461541,138.8193792697828,135.73446842252537,129.35350015000031,129.84210010000004,133.45139919999997,136.42699950000002,137.80333000000002,49718096,66210227.2,69.0021012538479,1.5,2.75,0.9660726931714756,0.7509126324218383,0.00038727688695283646,1.4273606054755137,1.4269733285885606,6.057941650826407,1.0263177186423325,2812830285.0,2006-10-30,2006,0,303,10,0.58,137.8,138.25999,137.25,1716
2006-10-31 14:30:00,138.07001,138.25999,137.25,137.78999,122.55086956521738,117.95096899999994,129.4008001000003,129.96649990000003,133.60459899999995,136.64849900000002,134.0604674815401,136.5656782179613,137.3930769230772,138.84235134351428,135.94380250264007,129.4008001000003,129.96649990000003,133.60459899999995,136.64849900000002,137.76666,71297184,66119652.0,68.74841623894083,1.5,2.75,0.9692096436592266,1.0783054938038694,-0.05118010569792775,1.3629981964661508,1.4141783021640788,5.586938348778917,0.8785342997291057,2741533101.0,2006-10-31,2006,1,304,10,0.74,137.75,138.31,136.72,1717
2006-11-01 14:30:00,138.22,138.31,136.72,136.86,122.55304347826086,117.83121874999992,129.4460000500003,130.09519980000005,133.73939899999996,136.74549900000002,134.1702530704993,136.59370886386978,137.4107692307695,138.82760248280314,135.99393597873583,129.4460000500003,130.09519980000005,133.73939899999996,136.74549900000002,137.29666666666665,83006496,66225311.2,58.06390600251768,1.5,2.75,1.013551811969282,1.2533953332332548,-0.15306117917583914,1.2228518281942795,1.3759130073701191,7.13266074046499,0.03654703603538584,2658526605.0,2006-11-01,2006,2,305,11,1.16,137.51,137.00999,136.36,1718
2006-11-02 14:30:00,136.50999,137.00999,136.36,136.78,122.55521739130434,117.71146849999994,129.4883500500003,130.23749980000005,133.87979919999995,136.82549950000003,134.27259608734246,136.61145087683457,137.4061538461541,138.83076379470344,135.98154389760478,129.4883500500003,130.23749980000005,133.87979919999995,136.82549950000003,136.71666333333334,60703904,66228506.4,57.239793745258645,1.5,2.75,0.9875831111143316,0.9165827118819035,-0.2265438916883593,1.0927331427596698,1.3192770344480291,7.08483254897789,-0.043846828412746466,2597822701.0,2006-11-02,2006,3,306,11,0.48,136.68,137.39,135.62,1719
2006-11-03 14:30:00,137.27,137.39,135.62,136.53999,135.62,117.59171824999994,129.54120000000032,130.36789970000007,134.01759919999998,136.90199950000004,134.361513495682,136.6046450790408,137.41615307692337,138.81423268465758,136.01807346918906,129.54120000000032,130.36789970000007,134.01759919999998,136.90199950000004,136.51666333333333,71346368,66545734.4,54.73004655518209,1.5,2.75,1.0434700317490209,1.0721403654687145,-0.28807010153428303,0.9591894075301752,1.2472595090644585,7.150458123280551,-0.6765185131301448,2526476333.0,2006-11-03,2006,4,307,11,1.31,136.5,138.28,136.95,1720
2006-11-06 14:30:00,136.96001,138.28,136.95,138.08,135.7918181818182,117.47196799999992,129.59950000000032,130.48749970000006,134.18299919999995,137.05149950000003,134.50733649585132,136.74515507151312,137.53076846153868,138.88268144505741,136.17885547802,129.59950000000032,130.48749970000006,134.18299919999995,137.05149950000003,137.77,63312704,67652474.4,65.25654271371371,1.5,2.75,1.0932228866240916,0.9358520078018018,-0.22462361357667812,0.9664799920936104,1.1911036056702886,9.423494287394199,0.14505366985785978,2589789037.0,2006-11-06,2006,0,310,11,0.97,137.62,138.98,138.0,1721
2006-11-07 14:30:00,138.2,138.98,138.0,138.61,135.96363636363637,117.35221774999994,129.6598000000003,130.62709980000002,134.34659939999997,137.21849950000004,134.6682252607199,136.92275935041664,137.66923000000023,139.06548059388257,136.27297940611794,129.6598000000003,130.62709980000002,134.34659939999997,137.21849950000004,138.53,63363200,67999209.6,68.01319309473962,1.5,2.75,1.0851355375795129,0.9318225957732308,-0.15011714547883592,1.0034571738217437,1.1535743193005796,9.519448547040986,0.18792192353294096,2653152237.0,2006-11-07,2006,1,311,11,0.71,138.49,139.05,136.86,1722
2006-11-08 14:30:00,138.0,139.05,136.86,138.91,136.13545454545454,117.23246749999993,129.7210500000003,130.77949980000002,134.51319939999996,137.4084995,134.8345693681427,137.1120203646627,137.82846076923104,139.28111946710266,136.37580207135943,129.7210500000003,130.77949980000002,134.51319939999996,137.4084995,138.27333333333334,87519632,67171375.2,69.48888859430005,1.5,2.75,1.1640544277524048,1.30293047804089,-0.08692016360825372,1.0449241147902626,1.1318442783985163,9.40857277345444,0.09367343997693864,2740671869.0,2006-11-08,2006,2,312,11,1.6,137.96,139.14,137.89999,1723
2006-11-09 14:30:00,139.00999,139.14,137.89999,138.17999,136.30727272727273,117.11271724999992,129.7751499500003,130.92039970000005,134.66359919999996,137.503499,134.96576233409786,137.2137317585043,137.8830753846157,139.33109887005926,136.43505189917207,129.7751499500003,130.92039970000005,134.66359919999996,137.503499,138.40666000000002,95917680,69008614.4,61.993960287982226,1.5,2.75,1.1694798257700891,1.3899377756525422,-0.09965936209532522,1.0072700757793598,1.106929437874685,9.749386366665668,0.1957726053223168,2644754189.0,2006-11-09,2006,3,313,11,0.9,138.52,138.34,137.72,1724
2006-11-10 14:30:00,138.14,138.34,137.72,138.24001,136.47909090909093,116.99296699999994,129.8236500500003,131.05269990000005,134.81559939999997,137.5839995,135.09416420334892,137.31147254340866,137.91076846153874,139.37121434959892,136.45032257347856,129.8236500500003,131.05269990000005,134.81559939999997,137.5839995,138.10000333333335,48992000,68760949.6,62.35348501179182,1.5,2.75,1.1302312667865118,0.7124974318272068,-0.1086810646759333,0.9710781070297684,1.0797591717057018,9.008962772205043,0.3120310572527465,2693746189.0,2006-11-10,2006,4,314,11,0.45,138.03,139.03999,138.07001,1725
2006-11-13 14:30:00,138.17999,139.03999,138.07001,138.58,136.6509090909091,116.87321674999993,129.87435005000034,131.19389980000003,134.95879939999998,137.67099950000002,135.23086364635486,137.43228468213164,137.92846000000026,139.4150980212211,136.44182197877944,129.87435005000034,131.19389980000003,134.95879939999998,137.67099950000002,138.56333333333336,59403504,69617329.6,64.40743679480462,1.5,2.75,1.118784747730332,0.8532861622431436,-0.096785042815974,0.9587778681857344,1.0555629110017084,9.069017296059947,0.5733435353323008,2753149693.0,2006-11-13,2006,0,317,11,0.7,138.56,139.74001,138.12,1726
2006-11-14 14:30:00,138.97,139.74001,138.12,139.62,136.82272727272726,116.75346649999993,129.93495005000034,131.34569980000003,135.11779939999994,137.8314995,135.4029866406155,137.64063852192862,137.99307538461562,139.6814711864451,136.3046795827862,129.93495005000034,131.34569980000003,135.11779939999994,137.8314995,139.16000333333332,96704192,69913270.4,69.82987333409366,1.5,2.75,1.1545865514638802,1.383202236810252,-0.02750821010431004,1.0211776483713209,1.0486858584756311,9.870285564631065,2.0166593599298483,2849853885.0,2006-11-14,2006,1,318,11,1.17,138.93,140.45,139.53,1727
2006-11-15 14:30:00,139.57001,140.45,139.53,140.02,136.99454545454546,116.63371624999995,129.99310005000035,131.49599970000006,135.30799959999996,138.00299950000002,135.5840459880423,137.86724437698305,138.1553830769233,140.1572102340688,136.15355591977786,129.99310005000035,131.49599970000006,135.30799959999996,138.00299950000002,140.0,76518192,69370620.8,71.62067934552856,1.5,2.75,1.1378303692164593,1.1030345572458824,0.03332158908477112,1.0903378448315948,1.0570162557468237,8.426438882135951,2.368767363649663,2926372077.0,2006-11-15,2006,2,319,11,0.66,139.99,140.67999,139.49001,1728
2006-11-16 14:30:00,140.44,140.67999,139.49001,140.38,137.16636363636366,116.51396599999993,130.0605001000003,131.66069970000004,135.51739959999998,138.1814995,135.77212261596222,138.106554436318,138.35307538461564,140.66327521925072,136.04287554998055,130.0605001000003,131.66069970000004,135.51739959999998,138.1814995,140.18333333333334,76740128,70003536.8,73.16453847967296,1.5,2.75,1.1415553428438543,1.096232154944491,0.08303949952364187,1.160815630151376,1.077776130627734,8.226226495774599,2.812370207438866,3003112205.0,2006-11-16,2006,3,320,11,0.85,140.08,140.42999,139.73,1729
2006-11-17 14:30:00,139.92999,140.42999,139.73,140.42,137.33818181818182,116.39421574999993,130.1312501000003,131.81739970000004,135.72019959999997,138.3604995,135.95439231729702,138.3268825852401,138.55538384615411,141.08328139673338,136.02748629557485,130.1312501000003,131.81739970000004,135.72019959999997,138.3604995,140.19332999999997,56357296,70416426.4,73.33809424276744,1.5,2.75,1.1100149612121517,0.8003430290520962,0.10257548210857292,1.2059954832634503,1.1034200011548774,7.908951609958121,1.694669756662786,3059469501.0,2006-11-17,2006,4,321,11,0.5,140.08,140.74001,139.94099,1730
2006-11-20 14:30:00,140.3,140.74001,139.94099,140.5,137.51,116.27446549999992,130.2007500500003,131.94969970000002,135.9219996,138.5119995,136.1326514421089,138.53384614855057,138.83538384615412,141.3564562788344,136.31431141347383,130.2007500500003,131.94969970000002,135.9219996,138.5119995,140.3936666666667,69185504,70564001.6,73.7043866821009,1.5,2.75,1.0878010354112846,0.9804645772810028,0.10448882482706634,1.2340310321887102,1.1295422073616441,5.864775124992312,1.3635379842724091,3128655005.0,2006-11-20,2006,0,324,11,0.57,140.34,140.67,140.28999,1731
2006-11-21 14:30:00,140.49001,140.67,140.28999,140.64,137.6818181818182,116.15471524999992,130.27655005000034,132.08379970000004,136.1009996,138.64999949999998,136.30941020908506,138.734432229641,139.13230692307718,141.52088769357968,136.74372615257468,130.27655005000034,132.08379970000004,136.1009996,138.64999949999998,140.53332999999998,51371392,70464801.6,74.36804006589487,1.5,2.75,1.0372445328819069,0.7290362114636253,0.09884724635895248,1.2531012653103346,1.154254018951382,5.718659482887412,1.2454106975739614,3180026397.0,2006-11-21,2006,1,325,11,0.27,140.48,141.16,140.5,1732
2006-11-22 14:30:00,140.75,141.16,140.5,140.92,137.85363636363638,116.03496499999993,130.3480500500003,132.21499970000005,136.2749996,138.77849899999998,136.490217651866,138.94258154110378,139.46923076923105,141.5105194653633,137.4279420730988,130.3480500500003,132.21499970000005,136.2749996,138.77849899999998,140.86,45508704,68702696.0,75.68953630066827,1.5,2.75,1.0102984948189135,0.6624005555764507,0.0974753105850783,1.27609815718273,1.1786228465976518,5.711693118749339,1.9829282083462183,3225535101.0,2006-11-22,2006,2,326,11,0.47,140.83,140.84,140.2,1733
2006-11-24 14:30:00,140.24001,140.84,140.2,140.35001,138.02545454545455,115.91521474999992,130.41775010000032,132.34779970000002,136.4373998,138.85699949999997,136.64158205767518,139.07662234671292,139.6438469230772,141.56472196533517,137.72297188081922,130.41775010000032,132.34779970000002,136.4373998,138.85699949999997,140.46333666666666,30998192,66910187.2,68.00339128372758,1.5,2.75,0.989562888046134,0.4632806049001758,0.04438488125706175,1.234103948168979,1.189719066911917,5.2111422945573915,1.526330908106839,3194536909.0,2006-11-24,2006,4,328,11,0.46,140.52,140.35001,138.38,1734
2006-11-27 14:30:00,140.28,140.35001,138.38,138.42,138.19727272727272,115.79546449999992,130.4766501000003,132.45759970000006,136.56659960000002,138.88249950000002,136.71132393776634,139.0140868851212,139.62923153846182,141.58394244949622,137.67452062742746,130.4766501000003,132.45759970000006,136.56659960000002,138.88249950000002,139.0500033333333,84547376,67125587.2,49.6267675224249,1.5,2.75,1.0595948246142677,1.259540207046412,-0.12523307111161808,1.0331777280223946,1.158410799134013,10.289364395168072,-0.11545677586955187,3109989533.0,2006-11-27,2006,0,331,11,1.42,139.37,139.16,138.11,1735
2006-11-28 14:30:00,138.24001,139.16,138.11,139.02,138.36909090909091,115.67571424999993,130.53970010000032,132.58169970000006,136.7041996,138.94299949999998,136.80186025393238,139.01465003891917,139.63769307692334,141.5807949758273,137.69459117801938,130.53970010000032,132.58169970000006,136.7041996,138.94299949999998,138.76333333333332,106667680,69973066.4,53.80600500216014,1.5,2.75,1.0589094799989616,1.5244105409106383,-0.1972518049289722,0.9118460429727976,1.1090978479017697,10.497239881306074,-0.4297378599054536,3216657213.0,2006-11-28,2006,1,332,11,0.76,138.64,140.53,139.08279,1736
2006-11-29 14:30:00,139.47,140.53,139.08279,140.47,138.5409090909091,115.55596399999992,130.6033001000003,132.71789960000004,136.87739960000002,139.077,136.9457088714252,139.15325479711734,139.81384769230795,141.60573427344576,138.02196111117019,130.6033001000003,132.71789960000004,136.87739960000002,139.077,140.02759666666668,91542000,70985307.2,62.00910785496152,1.5,2.75,1.0911302314276066,1.2895908126745417,-0.14962730732899354,0.9220637137405276,1.0716910210695212,11.318477322459087,0.3213826596200461,3308199213.0,2006-11-29,2006,2,333,11,1.04,139.81,141.05,139.75999,1737
2006-11-30 14:30:00,140.44,141.05,139.75999,140.53,138.71272727272728,115.43621374999992,130.6649501000003,132.84909960000005,137.03779980000002,139.2605,137.0862693078399,139.28437338786807,139.99000076923105,141.56556486361376,138.4144366748483,130.6649501000003,132.84909960000005,137.03779980000002,139.2605,140.4466633333333,83997680,71034866.4,62.307382857892044,1.5,2.75,1.1053359291827791,1.1824852253118334,-0.11787482681780448,0.9243474875472656,1.0422223143650702,11.227170742469315,0.10685282803818613,3392196893.0,2006-11-30,2006,3,334,11,0.92,140.4,140.66,138.97,1738
2006-12-01 14:30:00,140.53,140.66,138.97,140.22,138.88454545454545,115.31646349999993,130.7202501000003,132.99079960000006,137.20479980000002,139.43249999999998,137.20916070753245,139.37348068426158,140.11615461538491,141.4664494401217,138.76585979064808,130.7202501000003,132.99079960000006,137.20479980000002,139.43249999999998,139.95000000000002,126156688,74307505.6,59.69941307790233,1.5,2.75,1.1470976485268662,1.69776507744865,-0.121079011661283,0.8908735497884663,1.011952561449749,11.218638309499323,-0.14242985329724306,3266040205.0,2006-12-01,2006,4,335,12,1.22,139.82,141.55,140.23,1739
2006-12-04 14:30:00,140.25,141.55,140.23,141.28999,139.05636363636364,115.19671324999992,130.7826500500003,133.16369950000004,137.4011996,139.67,137.3691932288057,139.55600538099858,140.24461538461566,141.69565260275033,138.793578166481,130.7826500500003,133.16369950000004,137.4011996,139.67,141.02333000000002,87814496,75130912.0,65.12535941123622,1.5,2.75,1.1601621022035196,1.1688197795336226,-0.05768168701069065,0.939850452686386,0.9975321396970768,12.065478751387205,0.562270462633444,3353854701.0,2006-12-04,2006,0,338,12,0.94,140.89,141.96001,141.25999,1740
2006-12-05 14:30:00,141.56,141.96001,141.25999,141.89999,139.22818181818184,115.07696299999992,130.8496999500003,133.34749940000003,137.58959940000003,139.86099950000002,137.5468715335584,139.7792420113797,140.38923000000023,142.07727331814752,138.70118668185302,130.8496999500003,133.34749940000003,137.58959940000003,139.86099950000002,141.70666333333338,73380688,75634311.2,67.7880230185608,1.5,2.75,1.1272948091889843,0.970203692421542,0.014912762040883319,1.0161730922481809,1.0012603302072975,12.248909866913472,0.8958973265074064,3427235389.0,2006-12-05,2006,1,339,12,0.5,141.61,142.07001,141.5,1741
2006-12-06 14:30:00,141.87,142.07001,141.5,141.78,139.4,114.95721274999993,130.9122499500003,133.53189940000004,137.75359939999998,140.01949950000002,137.71287657145808,139.9697903912483,140.49692230769259,142.3403497227181,138.65349489266708,130.9122499500003,133.53189940000004,137.75359939999998,140.01949950000002,141.78333666666666,53324000,75132351.2,66.70909734421798,1.5,2.75,1.0874887513897706,0.709734211006563,0.042846023901657926,1.0548178600843698,1.011971836182712,12.294075204468232,0.6102753335225757,3373911389.0,2006-12-06,2006,2,340,12,0.4,141.79,142.3,141.11,1742
2006-12-07 14:30:00,142.03,142.3,141.11,141.16,139.57181818181817,114.83746249999993,130.97264995000032,133.70379940000004,137.90199919999998,140.13199949999998,137.84805788238128,140.08314368731985,140.55384538461564,142.42967233823111,138.67801843100017,130.97264995000032,133.70379940000004,137.90199919999998,140.13199949999998,141.52333333333334,62850304,73898884.8,61.28159592207472,1.5,2.75,1.0948109834333584,0.8504905611241376,0.009315086277136286,1.0236156940291323,1.0143006077519958,12.608890850650608,0.5771214408891022,3311061085.0,2006-12-07,2006,3,341,12,0.84,141.71,141.89999,140.78,1743
2006-12-08 14:30:00,141.13,141.89999,140.78,141.42,139.74363636363637,114.71771224999992,131.0326999500003,133.86109940000003,138.05659920000002,140.29399999999998,137.98813404385652,140.21046333614652,140.6246146153849,142.55558318619273,138.69364604457706,131.0326999500003,133.86109940000003,138.05659920000002,140.29399999999998,141.36666333333332,79624624,73084232.0,62.65382723588468,1.5,2.75,1.09660948461669,1.0894911504303693,-0.004844360474127507,1.0082451571593367,1.0130895176334642,12.337938495969794,2.167316861725185,3390685709.0,2006-12-08,2006,4,342,12,0.8,141.34,142.09,141.34,1744
2006-12-11 14:30:00,141.42,142.09,141.34,141.83,139.91545454545457,114.59796199999992,131.09454990000032,134.03109940000004,138.22159919999999,140.47349949999997,138.13879545390137,140.36470492318017,140.71615307692335,142.75137109327983,138.6809350605669,131.09454990000032,134.03109940000004,138.22159919999999,140.47349949999997,141.75333333333333,39779296,72623596.8,64.77398687304729,1.5,2.75,1.0718516642869265,0.5477461562465604,0.003463820411954366,1.0174192931484072,1.0139554727364528,8.110981611718326,2.0212919004459806,3430465005.0,2006-12-11,2006,0,345,12,0.53,141.72,141.87,140.89,1745
2006-12-12 14:30:00,141.69,141.87,140.89,141.72,140.08727272727273,114.47821174999993,131.1619999000003,134.20879940000003,138.39439920000004,140.63049949999998,138.279234847866,140.49378064478205,140.77769153846182,142.8810799786557,138.6743030982679,131.1619999000003,134.20879940000003,138.39439920000004,140.63049949999998,141.49333333333334,77453504,73526096.8,63.7286632118274,1.5,2.75,1.0652908311235758,1.0534151460628058,-0.007774333472364336,1.0042375558959975,1.0120118893683618,8.203177224950517,0.8898697230725422,3353011501.0,2006-12-12,2006,1,346,12,0.7,141.38,142.34,141.56,1746
2006-12-13 14:30:00,142.23,142.34,141.56,141.87,140.2590909090909,114.35846149999992,131.2244999000003,134.36539930000004,138.56459920000003,140.74299949999997,138.42004916755755,140.6248491548028,140.8946138461541,143.0580367083307,138.7311909839775,131.2244999000003,134.36539930000004,138.56459920000003,140.74299949999997,141.92333333333332,55568400,71469307.2,64.56836410210991,1.5,2.75,1.0449129146147489,0.7775141830394012,-0.014064316847414604,0.9944314933090936,1.0084958101565082,6.190191454864963,0.9535330534405491,3408579901.0,2006-12-13,2006,2,347,12,0.55,141.95,143.24001,141.84,1747
2006-12-14 14:30:00,141.86,143.24001,141.84,143.12,140.4309090909091,143.24001,131.2932999000003,134.52999930000004,138.72859920000002,140.89799949999997,138.60436096490824,140.8624825686311,141.25615230769256,143.20477660655536,139.30752800882973,131.2932999000003,134.52999930000004,138.72859920000002,140.89799949999997,142.73333666666667,64779200,70882357.6,70.66337676674317,1.5,2.75,1.0702769921422677,0.9138973673189448,0.053308334135439006,1.075131227825807,1.021822893690368,7.5997523830907365,2.0681785765226115,3473359101.0,2006-12-14,2006,3,348,12,0.99,142.54,142.89,142.24001,1748
2006-12-15 14:30:00,142.64,142.89,142.24001,142.34,140.6027272727273,143.37244495652175,131.3611999500003,134.68509930000005,138.87179940000004,140.99599949999995,138.75085661334322,141.00319851447574,141.51153692307716,143.04748222385862,139.9755916222957,131.3611999500003,134.68509930000005,138.87179940000004,140.99599949999995,142.49000333333333,70858816,70588292.0,63.34121875903572,1.5,2.75,1.0566850641321053,1.0038324202546225,0.03364815353238715,1.063883085605852,1.0302349320734647,8.41612812115643,0.7431595118663499,3402500285.0,2006-12-15,2006,4,349,12,0.46,142.57,142.88,141.75,1749
2006-12-18 14:30:00,142.53999,142.88,141.75,141.95,140.77454545454546,143.50487991304345,131.43009995000034,134.83749920000002,139.01059960000003,141.07249949999996,138.87631321674152,141.09337008452567,141.6253830769233,143.05109469872082,140.19967145512587,131.43009995000034,134.83749920000002,139.01059960000003,141.07249949999996,142.19333333333333,48956800,70218267.2,59.993831227581616,1.5,2.75,1.061921845265526,0.6972088881167947,-0.014719702707801431,1.0118353036887129,1.0265550063965143,7.740319965989205,0.03524313144770914,3353543485.0,2006-12-18,2006,0,352,12,0.8,142.32,142.56,141.19,1750
2006-12-19 14:30:00,141.55,142.56,141.19,142.22,140.94636363636363,143.63731486956522,131.5013499500003,134.97989920000003,139.15319960000005,141.15849949999995,139.00743818863398,141.20066817171372,141.75538307692332,143.06100753615038,140.44975861769632,131.5013499500003,134.97989920000003,139.15319960000005,141.15849949999995,141.99,65077504,70012867.2,61.51034862405282,1.5,2.75,1.0839274277465605,0.9295077691090474,-0.036392243629399516,0.9810647018597648,1.0174569454891644,7.420507500383209,0.3103399633234573,3418620989.0,2006-12-19,2006,1,353,12,0.97,141.88,142.66,142.00999,1751
2006-12-20 14:30:00,142.28,142.66,142.00999,142.14,141.11818181818182,143.76974982608695,131.5708499000003,135.12279910000004,139.29059960000004,141.23349949999994,139.13028374986405,141.29012834583622,141.90307538461562,142.87135526255594,140.93479550667539,131.5708499000003,135.12279910000004,139.29059960000004,141.23349949999994,142.26999666666666,41473200,69517957.6,60.77522912113196,1.5,2.75,1.0529333257646638,0.5965825440188134,-0.062449804727798826,0.939394689579416,1.001844494307215,7.407345505501651,0.6942476622272526,3377147789.0,2006-12-20,2006,2,354,12,0.46,142.33,142.42999,141.32001,1752
2006-12-21 14:30:00,142.27,142.42999,141.32001,141.62,141.29000000000005,143.90218478260869,131.6420499000003,135.26679910000004,139.42079960000004,141.2684994999999,139.2279196812419,141.32154469385182,141.92846076923104,142.84715043816126,141.00977110030084,131.6420499000003,135.26679910000004,139.42079960000004,141.2684994999999,141.79,48698400,69677442.4,56.083400555305936,1.5,2.75,1.0570080882100454,0.6989119910635525,-0.11782726745270278,0.8545604099913362,0.9723876774440391,7.2532484601212195,0.14142271248763758,3328449389.0,2006-12-21,2006,3,355,12,0.79,141.88,141.64999,140.67,1753
2006-12-22 14:30:00,141.64,141.64999,140.67,140.75,141.4618181818182,144.03461973913045,131.7028499000003,135.39349910000004,139.51019960000005,141.28849899999994,139.28760910550696,141.2671118658659,141.84000000000026,142.95344234077916,140.72655765922136,131.7028499000003,135.39349910000004,139.51019960000005,141.28849899999994,141.02333000000002,62073200,71231192.8,49.23498738722885,1.5,2.75,1.0515067961950433,0.8714328310391568,-0.21074652855289103,0.7089545167529252,0.9197010453058162,8.049633795374254,-0.7614750052880296,3266376189.0,2006-12-22,2006,4,356,12,0.7,141.16,141.61,140.78,1754
2006-12-26 14:30:00,140.81,141.61,140.78,141.58,141.63363636363638,144.16705469565218,131.7665999000003,135.52509910000003,139.60919960000004,141.4464989999999,139.37750678764394,141.29691073578346,141.82461538461564,142.94644398487463,140.70278678435662,131.7665999000003,135.52509910000003,139.60919960000004,141.4464989999999,141.32333333333338,32697600,68638704.0,54.89391654473814,1.5,2.75,1.0378277393239697,0.4763726308119105,-0.2133549179023151,0.6530073979279223,0.8663623158302374,8.664025828964148,-0.09878633926050406,3299073789.0,2006-12-26,2006,1,360,12,0.59,141.2,142.60001,141.83,1755
2006-12-27 14:30:00,141.87,142.60001,141.83,142.50999,141.80545454545455,144.2994896521739,131.82824990000032,135.66819900000004,139.72259940000004,141.6209984999999,139.50034926655985,141.4124420942803,141.928460769231,143.03480020807788,140.8221213303841,131.82824990000032,135.66819900000004,139.72259940000004,141.6209984999999,142.3133333333334,39732496,65291944.8,60.24179357707471,1.5,2.75,1.036555043657971,0.6085359552653423,-0.1523540591505539,0.6759197418920451,0.8282738010425991,9.459242061529483,0.4511101712835576,3338806285.0,2006-12-27,2006,2,361,12,0.54,142.22,142.7,141.99001,1756
2006-12-28 14:30:00,142.41,142.7,141.99001,142.21001,141.97727272727275,144.43192460869562,131.8855000000003,135.81079910000003,139.83859960000004,141.70799899999994,139.6066104717928,141.48840094244406,141.989230769231,143.06350137089802,140.91496016756398,131.8855000000003,135.81079910000003,139.83859960000004,141.70799899999994,142.3000066666667,37291104,62579400.0,57.8588445347271,1.5,2.75,1.013228969110971,0.5959006318373139,-0.13282848806672987,0.6622381909591866,0.7950666790259164,9.571217963137718,-0.6358230855226338,3301515181.0,2006-12-28,2006,3,362,12,0.5,142.35,142.53999,141.42999,1757
2006-12-29 14:30:00,142.10001,142.53999,141.42999,141.62,142.1490909090909,144.5643595652174,131.9384500000003,135.95289910000002,139.93919960000002,141.7624989999999,139.68556692387935,141.50093418602086,141.97307692307717,143.0626457755005,140.88350807065385,131.9384500000003,135.95289910000002,139.93919960000002,141.7624989999999,141.86332666666667,45466704,60652851.2,53.385884105269014,1.5,2.75,1.0201411856030436,0.7496218743299573,-0.15852868052831592,0.5969058283655215,0.7554345088938375,8.123214759328848,-0.5058311086131789,3256048477.0,2006-12-29,2006,4,363,12,0.78,141.98,142.86,140.57001,1758
2007-01-03 14:30:00,142.25,142.86,140.57001,141.37,142.3209090909091,144.69679452173915,131.9922000000003,136.09679910000006,140.0303996,141.81999899999994,139.7516231229429,141.48846426354262,141.9461538461541,143.07596005046878,140.8163476418394,131.9922000000003,136.09679910000006,140.0303996,141.81999899999994,141.60000333333338,94808496,59085441.6,51.56676754317293,1.5,2.75,1.1108446723456846,1.6045999392175143,-0.18916829605049867,0.5189741388307141,0.7081424348812128,7.653135695531808,-0.4085945755547616,3161239981.0,2007-01-03,2007,2,3,1,1.63,141.72,142.05,140.61,1759
2007-01-04 14:30:00,141.23,142.05,140.61,141.67,142.49272727272728,144.82922947826088,132.0485000000003,136.23979910000006,140.1269996,141.83899949999994,139.82685358870984,141.5057533813005,141.93076923076947,143.0697142632844,140.79182419825452,132.0485000000003,136.23979910000006,140.1269996,141.83899949999994,141.44333333333338,69634624,58176448.0,53.609579211530296,1.5,2.75,1.1343557671781357,1.1969555789999418,-0.1857667990680756,0.4759339360461183,0.6617007351141939,7.682931547453174,-0.38672479257489206,3230874605.0,2007-01-04,2007,3,4,1,1.02,141.33,141.39999,140.38,1760
2007-01-05 14:30:00,141.33,141.39999,140.38,140.53999,142.66454545454545,144.96166443478262,132.1032499500003,136.37509910000006,140.1883994,141.77099949999996,139.85481972248593,141.41377591641475,141.73230692307718,142.87232697901976,140.5922868671345,132.1032499500003,136.37509910000006,140.1883994,141.77099949999996,140.77332666666666,76688880,58341857.6,45.777413911216,1.5,2.75,1.145473212379697,1.314474429761729,-0.25204380167029883,0.34664598302632044,0.5986897846966193,8.723894256641318,-1.1256578021668762,3154185725.0,2007-01-05,2007,4,5,1,0.73,140.89,141.41,140.25,1761
2007-01-08 14:30:00,140.82001,141.41,140.25,141.19,140.25,145.09409939130438,132.1572999500003,136.51589910000004,140.25459940000002,141.74149949999997,139.90717973336882,141.39246392437525,141.64384538461564,142.7597339604711,140.52795680876014,132.1572999500003,136.51589910000004,140.25459940000002,141.74149949999997,140.95,69655808,59158448.0,50.27744313504962,1.5,2.75,1.146510840066861,1.1774448173488257,-0.2443484111654145,0.2932542707398511,0.5376026819052656,9.342128056942784,-0.30362943087135064,3223841533.0,2007-01-08,2007,0,8,1,0.83,140.83,141.60001,140.39999,1762
2007-01-09 14:30:00,141.31,141.60001,140.39999,141.07001,140.3602380952381,145.2265343478261,132.21210000000028,136.64029920000004,140.3089994,141.73699999999997,139.95278092029554,141.36175402681567,141.57615384615409,142.7160475379305,140.43626015437766,132.21210000000028,136.64029920000004,140.3089994,141.73699999999997,141.02333666666667,75681120,59799988.8,49.46140352125406,1.5,2.75,1.150332922919228,1.2655708055918566,-0.2392746445146453,0.238509376261959,0.4777840207766043,9.150137420996789,0.2273605683836564,3148160413.0,2007-01-09,2007,1,9,1,0.85,141.0,141.57001,140.3,1763
2007-01-10 14:30:00,140.58,141.57001,140.3,141.53999,140.47047619047618,145.35896930434785,132.2687499000003,136.75779920000005,140.36419920000003,141.74299949999994,140.01502441361728,141.3787288814047,141.52384538461558,142.6014655503035,140.44622521892774,132.2687499000003,136.75779920000005,140.36419920000003,141.74299949999994,141.13666666666666,72447376,59441126.4,52.699730376647466,1.5,2.75,1.1588812855678536,1.218808935626092,-0.19791417370052575,0.2303913036509471,0.4283054773514728,8.562252077464283,-0.02825964119227549,3220607789.0,2007-01-10,2007,2,10,1,0.91,140.94,142.62,141.5,1764
2007-01-11 14:30:00,141.56,142.62,141.5,142.16,140.5807142857143,145.4914042608696,132.3294499000003,136.87909920000004,140.44919919999998,141.75949949999998,140.09914110327935,141.45313565460418,141.52538384615406,142.6065694326254,140.4441982596827,132.3294499000003,136.87909920000004,140.44919919999998,141.75949949999998,142.09333333333333,55532496,60228786.4,56.646365837727934,1.5,2.75,1.1561040508844358,0.9220258172095596,-0.12595243339376402,0.27086493560926783,0.39681736900303183,8.258361909515665,-0.2455898004062671,3276140285.0,2007-01-11,2007,3,11,1,0.79,142.06,143.24001,142.11,1765
2007-01-12 14:30:00,142.12,143.24001,142.11,143.24001,140.69095238095238,145.62383921739132,132.39954995000028,137.00459930000002,140.55779940000002,141.83549999999997,140.22231243256252,141.62331416368949,141.65000000000026,143.06728218793626,140.23271781206424,132.39954995000028,137.00459930000002,140.55779940000002,141.83549999999997,142.86334,57631200,59237671.2,62.51380416030693,1.5,2.75,1.154240190106976,0.972880919059492,-0.008939567122775327,0.38564291009956253,0.394582477222338,8.550988383511728,0.7242809419674473,3333771485.0,2007-01-12,2007,4,12,1,0.8,142.68,143.44,142.73,1766
2007-01-16 14:30:00,143.07001,143.44,142.73,142.96001,140.80119047619047,145.75627417391306,132.46420000000032,137.13289940000004,140.66119980000002,141.89000049999996,140.32967312148165,141.75061852905242,141.820000769231,143.29373609677668,140.34626544168532,132.46420000000032,137.13289940000004,140.66119980000002,141.89000049999996,143.04333666666662,44988304,58708666.4,60.2376282308292,1.5,2.75,1.122508747956478,0.7662974950492147,0.04340417842584393,0.4488377002546429,0.4054335218287989,8.534586386469822,0.9462011015393352,3288783181.0,2007-01-16,2007,1,16,1,0.5,143.08,143.46001,142.73,1767
2007-01-17 14:30:00,142.85001,143.46001,142.73,143.02,140.91142857142856,145.88870913043482,132.5303000000003,137.26189940000003,140.78439980000005,141.88500049999996,140.43517613632548,141.871512002476,141.93077000000022,143.5270687471647,140.33447125283578,132.5303000000003,137.26189940000003,140.78439980000005,141.88500049999996,143.07000333333337,51597008,58049556.8,60.568892343559945,1.5,2.75,1.0944731231024456,0.8888441332596014,0.07406906693813531,0.4980198555014681,0.4239507885633328,8.004519006415856,1.1671500318313686,3340380189.0,2007-01-17,2007,2,17,1,0.51,143.1,143.25999,142.31,1768
2007-01-18 14:30:00,143.17,143.25999,142.31,142.53999,141.02166666666668,146.02114408695653,132.5938499500003,137.38969940000004,140.89959960000004,141.8949999999999,140.5177178564696,141.93517657366874,141.9330776923079,143.5328022322903,140.33335315232554,132.5938499500003,137.38969940000004,140.89959960000004,141.8949999999999,142.7033266666666,68234368,57918334.4,56.51195285812731,1.5,2.75,1.0841529000236985,1.1781134369085031,0.054908206874437315,0.4925860471563794,0.4376778402819421,8.25292497543314,0.6140961389143795,3272145821.0,2007-01-18,2007,3,18,1,0.67,142.78,143.10001,142.46001,1769
2007-01-19 14:30:00,142.53999,143.10001,142.46001,142.82001,141.13190476190476,146.15357904347832,132.65930000000031,137.52139960000002,141.02520000000004,141.93850049999998,140.60800382288255,142.01944642379556,141.980000769231,143.64395988493308,140.31604165352888,132.65930000000031,137.52139960000002,141.02520000000004,141.93850049999998,142.79334333333338,56983904,58319689.6,58.26802085929802,1.5,2.75,1.0524276928791476,0.97709546108421,0.053900168955891885,0.505053051476807,0.4511528825209151,8.244401038796287,1.6223282782359725,3329129725.0,2007-01-19,2007,4,19,1,0.45,142.78,143.10001,141.92999,1770
2007-01-22 14:30:00,143.07001,143.10001,141.92999,142.38,141.24214285714285,146.28601400000005,132.71840000000032,137.64709960000002,141.11120000000003,141.94650049999996,140.67749386904399,142.05378485962456,142.03846230769253,143.70112355376662,140.3758010616184,132.71840000000032,137.64709960000002,141.11120000000003,141.94650049999996,142.47,60261696,58078899.2,54.54107329702729,1.5,2.75,1.0608271433877794,1.037583301854316,0.018249329426157868,0.4739645443036125,0.4557152148774546,6.651828310270193,0.8428358948934045,3268868029.0,2007-01-22,2007,0,22,1,0.82,142.51,143.08,142.06,1771
2007-01-23 14:30:00,142.25999,143.08,142.06,142.8,141.35238095238094,146.41844895652176,132.7773500500003,137.7707997,141.19500000000005,141.97950049999997,140.7607294035913,142.12485296823175,142.1484623076925,143.80888261244644,140.48804200293858,132.7773500500003,137.7707997,141.19500000000005,141.97950049999997,142.64666666666668,54077200,58709099.2,57.34559212433452,1.5,2.75,1.0579109188600817,0.9211042365984726,0.017596164054102914,0.4777104199450832,0.4601142558909803,6.412854225700419,1.2263343569622027,3322945229.0,2007-01-23,2007,1,23,1,0.72,142.57,143.98,142.91,1772
2007-01-24 14:30:00,142.97,143.98,142.91,143.95,141.46261904761906,146.5508839130435,132.84275005000032,137.9044997,141.29580000000004,142.09600049999997,140.8857988387446,142.29867649506681,142.32384692307713,144.21121143610114,140.43648241005312,132.84275005000032,137.9044997,141.29580000000004,142.09600049999997,143.61333333333332,56469392,59097648.8,63.91081520384384,1.5,2.75,1.0666315675129312,0.9555268804534912,0.08545989220425981,0.5669391211463051,0.4814792289420453,7.357186953924026,1.7027060691469598,3379414621.0,2007-01-24,2007,2,24,1,0.75,143.44,143.92,142.00999,1773
2007-01-25 14:30:00,143.84,143.92,142.00999,142.25999,141.57285714285715,146.68331886956526,132.9063500500003,138.02049960000002,141.37740000000005,142.17149999999995,140.9396886882056,142.29499206696522,142.45615461538483,144.04179533229347,140.8705138984762,132.9063500500003,138.02049960000002,141.37740000000005,142.17149999999995,142.72999333333334,73607312,59674354.4,51.3921395832613,1.5,2.75,1.1290157412620077,1.2334831727982634,0.011273569252288118,0.4955711905074054,0.4842976212551173,10.722168922076737,0.07033624085536799,3305807309.0,2007-01-25,2007,3,25,1,1.34,142.96,142.64999,141.58,1774
2007-01-26 14:30:00,142.57001,142.64999,141.58,142.16,141.68309523809523,146.81575382608696,132.96845000000027,138.13569960000004,141.45579980000005,142.20049999999995,140.98754403376614,142.2821356796352,142.53077000000022,143.95403998284124,141.1075000171592,132.96845000000027,138.13569960000004,141.45579980000005,142.20049999999995,142.12999666666667,74585632,61768756.0,50.758640503824395,1.5,2.75,1.1247996168861492,1.207497719397166,-0.04661233704883394,0.4260321999440748,0.4726445369929088,10.445661796934704,-0.7539862640333629,3231221677.0,2007-01-26,2007,4,26,1,0.76,142.11,142.8,141.74001,1775
2007-01-29 14:30:00,142.19,142.8,141.74001,142.05,141.79333333333332,146.94818878260872,133.0355000000003,138.2419996,141.52519980000002,142.17750049999995,141.02920897361847,142.2600275196699,142.60615384615406,143.79675308675772,141.4155546055504,133.0355000000003,138.2419996,141.52519980000002,142.17750049999995,142.19666999999998,66216000,63092931.2,50.028034013565225,1.5,2.75,1.1201703585371383,1.049499503995148,-0.09177955899447676,0.3579200882498128,0.4496996472442896,9.267288200835656,-0.6365486404204922,3165005677.0,2007-01-29,2007,0,29,1,0.75,142.27,142.86,142.06,1776
2007-01-30 14:30:00,142.35001,142.86,142.06,142.78999,141.90357142857144,147.0806237391305,133.10504995000028,138.35319950000002,141.5885996000001,142.20649949999995,141.09825920994712,142.31050013684418,142.7023076923079,143.72269364794974,141.68192173666606,133.10504995000028,138.35319950000002,141.5885996000001,142.20649949999995,142.56999666666667,70410624,64748907.2,54.746920514103444,1.5,2.75,1.098015332927343,1.0874411174618248,-0.07215365532989787,0.35950757808191725,0.4316612334118151,9.840103616421349,-0.1608236610264448,3235416301.0,2007-01-30,2007,1,30,1,0.56,142.46,144.13,142.39999,1777
2007-01-31 14:30:00,142.63,144.13,142.39999,143.75,142.01380952380953,147.2130586956522,133.1802499000003,138.4855996,141.66319960000004,142.31299950000002,141.2022490448512,142.44759536190668,142.82461538461558,143.93303791967674,141.71619284955443,133.1802499000003,138.4855996,141.66319960000004,142.31299950000002,143.42666333333332,91887872,67069965.6,60.02135342960933,1.5,2.75,1.143157809146818,1.3700301048014851,0.0012601170842466702,0.4332363797671235,0.4319762626828768,10.595159828821954,0.848891598771693,3327304173.0,2007-01-31,2007,2,31,1,1.21,143.26,144.66,143.91,1778
2007-02-01 14:30:00,144.14999,144.66,143.91,144.61,142.12404761904762,147.3454936521739,133.25999990000028,138.63259960000002,141.74779960000004,142.47499950000002,141.33588633720996,142.65353866077268,142.92999923076945,144.38323142680562,141.47676703473317,133.25999990000028,138.63259960000002,141.74779960000004,142.47499950000002,144.39333333333337,69316128,65795347.2,64.06231825915485,1.5,2.75,1.126503679922045,1.0535110908267993,0.098153335705834,0.5546679323151693,0.4565145966093353,10.699389379074713,1.2533187751492367,3396620301.0,2007-02-01,2007,3,32,2,0.52,144.28,144.95,144.38,1779
2007-02-02 14:30:00,144.73,144.95,144.38,144.81,142.23428571428568,147.47792860869566,133.3305499000003,138.7778996,141.83559960000005,142.63199949999995,141.4721260886919,142.85891593117532,143.07230615384634,144.83812331157503,141.30648899611762,133.3305499000003,138.7778996,141.83559960000005,142.63199949999995,144.71333333333334,49607696,64794000.8,64.94960925579375,1.5,2.75,1.0867534170704698,0.7656217456477854,0.1623403442830773,0.6594400269631819,0.4970996826801046,10.694247976001213,1.706700379266756,3446227997.0,2007-02-02,2007,4,33,2,0.39,144.66,144.94,144.34,1780
2007-02-05 14:30:00,144.7,144.94,144.34,144.85001,142.34452380952382,147.6103635652174,133.4000499500003,138.9222997,141.92259980000006,142.84750049999997,141.60459212442947,143.04854393773002,143.21307615384634,145.2156700706202,141.21048223707245,133.4000499500003,138.9222997,141.92259980000006,142.84750049999997,144.71000333333333,45735200,63246316.8,65.13505982890635,1.5,2.75,1.05198531585115,0.7231282755108991,0.192082750458596,0.7372031207533496,0.5451203702947536,10.34945091411867,1.4355812324929873,3491963197.0,2007-02-05,2007,0,36,2,0.42,144.64,145.03,144.33,1781
2007-02-06 14:30:00,144.97,145.03,144.33,144.89,142.4547619047619,147.74279852173916,133.46884995000028,139.0542997,142.00759980000004,143.03250049999997,141.7334316489616,143.22392070556532,143.39384615384634,145.53989512403243,141.24779718366025,133.46884995000028,139.0542997,142.00759980000004,143.03250049999997,144.75,57082192,62617636.0,65.33249541519041,1.5,2.75,1.0268435075760671,0.9115992817103477,0.19823772927692307,0.7929175318909074,0.5946798026139843,10.347160704690706,0.6530045154567543,3549045389.0,2007-02-06,2007,1,37,2,0.48,144.68,145.36,144.57001,1782
2007-02-07 14:30:00,145.12,145.36,144.57001,145.21001,142.565,147.8752334782609,133.53915005000027,139.18419980000002,142.09340000000003,143.23950049999996,141.86976805488467,143.41307206694003,143.5776923076925,145.89801927204027,141.25736534334473,133.53915005000027,139.18419980000002,142.09340000000003,143.23950049999996,145.0466733333334,55694192,61618289.6,66.9456003230402,1.5,2.75,1.0099253998920636,0.9038581298108606,0.2067043097697343,0.8530601898261523,0.646355880056418,9.502165856235699,2.0736821364882867,3604739581.0,2007-02-07,2007,2,38,2,0.55,144.97,145.12,144.27,1783
2007-02-08 14:30:00,144.78,145.12,144.27,145.02,142.6752380952381,148.00766843478263,133.6097000500003,139.31209980000003,142.18679980000005,143.41350099999994,141.99330656253628,143.56611282246956,143.7807692307694,146.10835579915397,141.45318266238485,133.6097000500003,139.31209980000003,142.18679980000005,143.41350099999994,144.8033333333333,70646000,61528220.8,65.01128889046873,1.5,2.75,1.0049314427569165,1.1481885723567031,0.183156519434886,0.8753015293500255,0.6921450099151395,5.4134942006499065,2.0118176702307355,3534093581.0,2007-02-08,2007,3,39,2,0.59,144.7,145.33,143.39,1784
2007-02-09 14:30:00,145.06,145.33,143.39,143.94,142.78547619047615,148.14010339130436,133.67755005000026,139.4318997,142.29719980000004,143.50250099999997,142.0696474816525,143.6017211250915,143.86846153846173,146.12649808727627,141.61042498964719,133.67755005000026,139.4318997,142.29719980000004,143.50250099999997,144.22,79084880,62705840.0,55.241182254643796,1.5,2.75,1.071722053988567,1.261204379049862,0.08356262238931822,0.7965982879017872,0.7130356655124691,7.572718424315264,1.3305174234424402,3455008701.0,2007-02-09,2007,4,40,2,1.35,144.36,144.03999,143.19,1785
2007-02-12 14:30:00,143.94,144.03999,143.19,143.45,142.89571428571432,148.2725383478261,133.7428001000003,139.54499970000003,142.38579980000003,143.51300049999998,142.1237789529603,143.5872714941304,143.83000000000018,146.09818125721006,141.5618187427903,133.7428001000003,139.54499970000003,142.38579980000003,143.51300049999998,143.55999666666662,65657056,63107132.8,51.46235376152258,1.5,2.75,1.0558840501322402,1.0404062597500865,-0.021012658897363142,0.6867698418907651,0.7077825007881282,7.969466997892164,0.4622242777662495,3389351645.0,2007-02-12,2007,0,43,2,0.59,143.61,144.89999,143.75999,1786
2007-02-13 14:30:00,143.77,144.89999,143.75999,144.66,143.00595238095238,148.40497330434783,133.8109501000003,139.67349970000004,142.46959980000003,143.59799999999996,142.22323860186378,143.68943611373703,144.0146161538464,146.12692354588816,141.90230876180456,133.8109501000003,139.67349970000004,142.46959980000003,143.59799999999996,144.43999333333332,64107072,64063071.2,58.9330436201388,1.5,2.75,1.0840344751227955,1.00068683563207,-0.014690245683357972,0.6894196936839307,0.7041099393672887,8.760267370012835,0.6330434782608672,3453458717.0,2007-02-13,2007,1,44,2,0.79,144.33,145.89999,144.78,1787
2007-02-14 14:30:00,144.8,145.89999,144.78,145.61,143.11619047619047,148.5374082608696,133.88165010000026,139.80449980000003,142.57119980000004,143.72749999999996,142.3560527743397,143.87234696004782,144.28000076923098,146.2560932460792,142.30390829238274,133.88165010000026,139.80449980000003,142.57119980000004,143.72749999999996,145.42999666666663,66062368,64786339.2,63.66200603252344,1.5,2.75,1.0951741554711678,1.0196959546681716,0.044250152099206685,0.7594226294912971,0.7151724773920904,8.725761588569245,0.6915151096051448,3519521085.0,2007-02-14,2007,2,45,2,0.77,145.34,145.95,145.42999,1788
2007-02-15 14:30:00,145.67,145.95,145.42999,145.8,143.22642857142856,148.66984321739133,133.95865015000024,139.94379980000002,142.68279980000003,143.89050049999997,142.49110952828715,144.05593296385274,144.5684623076925,146.22763942180202,142.90928519358297,133.95865015000024,139.94379980000002,142.68279980000003,143.89050049999997,145.72666333333333,38721696,63310705.6,64.54145162444361,1.5,2.75,1.0540910015089404,0.6116137173489344,0.08447845063448989,0.8207705406852028,0.7362920900507129,8.206985569911787,0.6836544437538906,3558242781.0,2007-02-15,2007,3,46,2,0.36,145.69,145.75999,145.23,1789
2007-02-16 14:30:00,145.44,145.75999,145.23,145.73,143.33666666666667,148.8022781739131,134.03040015000022,140.0863998,142.7716,144.03599999999997,142.61812484090333,144.2153679196763,144.79461692307711,146.20535949814155,143.38387434801268,134.03040015000022,140.0863998,142.7716,144.03599999999997,145.57332999999997,39842800,62453650.4,63.927597002368316,1.5,2.75,1.019513072829732,0.6379579054997879,0.09408439792202716,0.8538975874532468,0.7598131895312197,8.229771734404958,0.6075180802541831,3518399981.0,2007-02-16,2007,4,47,2,0.36,145.49,146.2,144.06,1790
2007-02-20 14:30:00,145.56,146.2,144.06,146.03999,143.44690476190476,148.93471313043483,134.10615010000026,140.22199970000003,142.8544,144.21899949999997,142.75231563145616,144.38914145113569,144.9707700000002,146.38764340434898,143.5538965956514,134.10615010000026,140.22199970000003,142.8544,144.21899949999997,145.43332999999996,56923904,62286760.8,65.49280061602168,1.5,2.75,1.0995478533418932,0.9139005347023922,0.1080289257709941,0.8948493467449623,0.7868204209739682,8.268611615755741,0.7936986679550021,3575323885.0,2007-02-20,2007,1,51,2,1.49,145.13,146.07001,145.35001,1791
2007-02-21 14:30:00,145.61,146.07001,145.35001,145.98,143.55714285714285,149.06714808695654,134.17925010000022,140.34599970000002,142.9384,144.37799949999996,142.87889148904608,144.54065178912282,145.07615461538484,146.5716336042301,143.5806756265396,134.17925010000022,140.34599970000002,142.9384,144.37799949999996,145.8000066666667,63973392,62781570.4,64.90585815967222,1.5,2.75,1.0724372923889005,1.0189836219834347,0.10010431763843076,0.9119508180220066,0.8118465003835759,8.294382476662793,0.5302595874760828,3511350493.0,2007-02-21,2007,2,52,2,0.5,145.71,146.42,145.17,1792
2007-02-22 14:30:00,146.05,146.42,145.17,145.87,143.66738095238094,146.42,134.24600010000023,140.46729960000002,143.0326,144.47399949999996,142.9961898620247,144.6672563806349,145.15769307692332,146.70105683742216,143.61432931642446,134.24600010000023,140.46729960000002,143.0326,144.47399949999996,145.82,79079680,63912084.8,63.77719108133919,1.5,2.75,1.0851203429325504,1.2373196751046995,0.07546830044487196,0.9061818759396658,0.8307135754947939,8.278121005496233,0.5861260515790886,3432270813.0,2007-02-22,2007,3,53,2,0.86,145.79,145.78999,144.75,1793
2007-02-23 14:30:00,145.74001,145.78999,144.75,145.3,143.77761904761903,146.49066644444446,134.31070010000022,140.5833996,143.1102,144.62599999999995,143.08653535763156,144.72751767771732,145.1923076923079,146.72667442911742,143.65794095549842,134.31070010000022,140.5833996,143.1102,144.62599999999995,145.27999666666668,71971376,63830288.0,58.135725870530216,1.5,2.75,1.0876117470087971,1.127542711384915,0.012121223657553415,0.8458651050667356,0.8337438814091822,8.608799502674707,0.9448381269973696,3360299437.0,2007-02-23,2007,4,54,2,0.72,145.27,145.95,144.75,1794
2007-02-26 14:30:00,145.83,145.95,144.75,145.17,143.88785714285714,146.56133288888887,134.37345010000024,140.69929960000002,143.17700000000005,144.7765,143.16823985341068,144.76965885126802,145.2138461538464,146.73846374451705,143.6892285631757,134.37345010000024,140.69929960000002,143.17700000000005,144.7765,145.29,70074752,63604744.0,56.89952694371206,1.5,2.75,1.0956394793653108,1.1017220979617497,-0.044116291524817115,0.7785985170031609,0.8227148085279781,7.176472863129301,1.1990240501917038,3290224685.0,2007-02-26,2007,0,57,2,0.83,145.35,144.2,139.0,1795
2007-02-27 14:30:00,143.88,144.2,139.0,139.5,143.99809523809523,146.6319993333333,134.40820010000022,140.76349960000005,143.1326,144.64899999999997,143.0243873101397,144.2677865797187,144.77461461538485,148.18024333943288,141.3689858913368,134.40820010000022,140.76349960000005,143.1326,144.64899999999997,140.9,274909952,74039441.6,28.467134460800608,1.5,2.75,1.4580938022677878,3.713020331584997,-0.44639891535204135,0.26471616433792633,0.7111150796899677,24.511346077834286,-3.5669846536706737,3015314733.0,2007-02-27,2007,1,58,2,3.74,141.6,141.98,139.8,1796
2007-02-28 14:30:00,140.39,141.98,139.8,140.92999,144.10833333333332,146.70266577777775,134.45810005000024,140.8391995,143.1137998,144.55599999999995,142.9422540822911,143.94990119117406,144.4599984615387,148.4263429905997,140.4936539324777,134.45810005000024,140.8391995,143.1137998,144.55599999999995,140.90332999999995,177549680,79396394.4,37.01532627262887,1.5,2.75,1.5310871021058023,2.23624361460928,-0.5903653810344449,-0.02684164660308852,0.5635237344313564,24.830773695935697,-3.214071835725574,3192864413.0,2007-02-28,2007,2,59,2,1.56,140.89,141.25,138.05,1797
2007-03-01 14:30:00,139.34,141.25,138.05,140.50999,144.21857142857144,146.7733322222222,134.51444995000023,140.89509940000005,143.0615996,144.3939995,142.8468711771032,143.62229060153842,144.19615153846178,148.6873672334717,139.70493584345186,134.51444995000023,140.89509940000005,143.0615996,144.3939995,139.9366633333333,212841120,85444056.8,35.667175909856844,1.5,2.75,1.6502951662411012,2.4909997016901944,-0.6815938009469162,-0.2884685167522889,0.3931252841946273,24.13899229692057,-3.628264746227725,2980023293.0,2007-03-01,2007,3,60,3,2.32,139.65,140.66,138.66,1798
2007-03-02 14:30:00,140.05,140.66,138.66,138.67,144.32880952380953,146.84399866666666,134.5602999500002,140.9299995,142.9881996,144.09699949999995,142.68307230741289,143.15064387758238,143.82845923076945,149.20017574024112,138.4567427212978,134.5602999500002,140.9299995,142.9881996,144.09699949999995,139.33,162600320,90108266.4,30.437070345079423,1.5,2.75,1.6752740829381654,1.8044994815259257,-0.824051645256727,-0.6369392723762815,0.1871123728804456,24.497555479687733,-4.844575584985934,2817422973.0,2007-03-02,2007,4,61,3,1.44,139.66,139.58,137.33,1799
2007-03-05 14:30:00,137.92999,139.58,137.33,137.35001,144.43904761904759,146.91466511111108,134.60050000000018,140.9533997,142.8961998,143.724,142.47393260908296,142.59820255590787,143.26615230769258,149.61373175522982,136.91857286015528,134.60050000000018,140.9533997,142.8961998,143.724,138.08667,144137008,94834732.0,27.33981401843945,1.5,2.75,1.7163259341568682,1.5198757349786152,-0.9560878591275211,-1.0079974510289558,-0.05190959190143474,24.437152186365903,-5.950411253794246,2673285965.0,2007-03-05,2007,0,64,3,1.64,138.46,140.12,137.717,1800
2007-03-06 14:30:00,138.78,140.12,137.717,139.7,144.54928571428567,146.98533155555555,134.6647499500002,140.9994997,142.84579979999995,143.4664995,142.36515093813853,142.322183264869,142.8115369230771,149.26814425064933,136.35492959550496,134.6647499500002,140.9994997,142.84579979999995,143.4664995,139.179,143379312,99716937.6,39.20151826512837,1.5,2.75,1.7915876531456636,1.4378631699977118,-0.8382817729438898,-1.0997618080812972,-0.2614800351374072,27.508066656081155,-4.301959172489383,2816665277.0,2007-03-06,2007,1,65,3,1.74,138.92,140.46001,139.39999,1801
2007-03-07 14:30:00,139.59,140.46001,139.39999,139.56,144.65952380952382,147.055998,134.73149990000022,141.0423997,142.7941998,143.19999950000002,142.25514501899585,142.05911819202439,142.33153692307715,148.7558096419968,135.9072642041575,134.73149990000022,141.0423997,142.7941998,143.19999950000002,139.80666666666667,115224496,102624052.8,38.79519172187595,1.5,2.75,1.739332820778117,1.1227825529806008,-0.7270496940407292,-1.1702921526883188,-0.4432424586475896,27.478516940173424,-4.325769520806198,2701440781.0,2007-03-07,2007,2,66,3,0.76,139.93,141.16,140.07001,1802
2007-03-08 14:30:00,140.53999,141.16,140.07001,140.74001,144.7697619047619,147.12666444444446,134.79969990000023,141.09869980000002,142.7766,142.97649950000002,142.19572795942742,141.93348884040302,141.94769153846175,148.10460589860222,135.7907771783213,134.79969990000023,141.09869980000002,142.7766,142.97649950000002,140.65667333333332,117892256,105733956.0,44.05838857548228,1.5,2.75,1.729380476436822,1.1149895498093347,-0.5398719971840018,-1.118082455127592,-0.5782104579435899,28.42152765249064,-3.1383275980729515,2819333037.0,2007-03-08,2007,3,67,3,0.78,140.62,141.42,140.08,1803
2007-03-09 14:30:00,141.31,141.42,140.08,140.78,144.88,147.19733088888887,134.8729499000002,141.1436998,142.7772,142.7644995,142.14020921592044,141.8236327603646,141.54307692307714,147.2456542060995,135.8404996400548,134.8729499000002,141.1436998,142.7772,142.7644995,140.76,107765632,107589937.6,44.233408934004295,1.5,2.75,1.7015675852627616,1.0016330002964888,-0.3864281580897291,-1.0612456555557517,-0.6748174974660224,28.505244012482656,-3.0240407797754267,2927098669.0,2007-03-09,2007,4,68,3,0.96,140.75,141.34,140.16,1804
2007-03-12 13:30:00,140.42,141.34,140.16,140.99001,144.99023809523808,147.2679973333333,134.95204995000023,141.1872999,142.76540020000004,142.61700000000005,142.09510336431572,141.74424011652036,141.15923153846174,146.25499816528264,136.06346491164092,134.95204995000023,141.1872999,142.76540020000004,142.61700000000005,140.83000333333334,80371808,107654284.0,45.20298909374762,1.5,2.75,1.6643127577439931,0.7465732436620915,-0.2504407999658502,-0.9878684974233352,-0.7374276974574849,28.607055335721807,1.0681075268817293,3007470477.0,2007-03-12,2007,0,71,3,0.84,140.75,140.77,138.03999,1805
2007-03-13 13:30:00,140.17999,140.77,138.03999,138.25,145.10047619047614,147.33866377777775,135.01244995000022,141.20139989999996,142.68020040000005,142.35700000000003,141.94431499708764,141.4114553435184,140.57307769230792,145.0862385584636,136.0599168261522,135.01244995000022,141.20139989999996,142.68020040000005,142.35700000000003,139.01999666666666,190080624,113875462.4,36.32832616504932,1.5,2.75,1.7561489893337097,1.6691973845280297,-0.3202160873205735,-1.1376978066082015,-0.8174817192876283,20.19362012802087,-1.9016463422725025,2817389853.0,2007-03-13,2007,1,72,3,1.98,139.4,139.36,136.75,1806
2007-03-14 13:30:00,138.42999,139.36,136.75,139.28,136.75,147.4093302222222,135.07019995000022,141.2300999,142.62160020000005,142.08800000000005,141.83983205602541,141.20845959651666,140.110000769231,143.73633821378618,136.48366332467577,135.07019995000022,141.2300999,142.62160020000005,142.08800000000005,138.46333333333334,231826880,122261452.8,41.016313061758616,1.5,2.75,1.8171383472384457,1.8961567582485,-0.27397861070983204,-1.1599549826749185,-0.8859763719650863,19.69320929518056,-0.8753754804195678,3049216733.0,2007-03-14,2007,2,73,3,1.91,138.06,139.99001,138.8,1807
2007-03-15 13:30:00,138.97,139.99001,138.8,139.47,136.67222222222222,147.4799966666666,135.12564995000022,141.25889990000002,142.57860019999998,141.781,141.746897465593,141.04289201589603,139.67153923076944,141.82312745279611,137.51995100874274,135.12564995000022,141.25889990000002,142.57860019999998,141.781,139.42000333333337,132413680,125579018.4,41.86660269765404,1.5,2.75,1.7723434652928425,1.0544251873209418,-0.21043281104682546,-1.149017385773618,-0.9385845747267928,19.705260205964052,0.5769092089132555,3181630413.0,2007-03-15,2007,3,74,3,0.86,139.4,139.63,138.12,1808
2007-03-16 13:30:00,139.31,139.63,138.12,138.53,136.59444444444443,147.55066311111108,135.18779990000021,141.27609990000005,142.52180020000003,141.41750000000005,141.62074462380502,140.8035689667631,139.59692384615406,141.83276048429394,137.36108720801417,135.18779990000021,141.27609990000005,142.52180020000003,141.41750000000005,138.76,122046192,129745243.2,38.88036585928586,1.5,2.75,1.753604646343353,0.940660243026158,-0.2110040068068061,-1.2023395832353003,-0.9913355764284942,18.535016030572837,0.8591116957326786,3059584221.0,2007-03-16,2007,4,75,3,1.09,138.88,140.33,138.5466,1809
2007-03-19 13:30:00,139.25999,140.33,138.5466,140.2,136.51666666666668,147.62132955555555,135.25124995000021,141.30969990000003,142.49240020000005,141.14100000000005,141.56502914836167,140.74608620802368,139.54077076923096,141.67418854559025,137.4073529928717,135.25124995000021,141.30969990000003,142.49240020000005,141.14100000000005,139.6922,96213120,132563759.2,46.2196462966911,1.5,2.75,1.7569186001759716,0.7257875046742036,-0.08468752674234814,-1.0971949848564293,-1.0125074581140812,18.633579826094447,0.3579098067287044,3155797341.0,2007-03-19,2007,0,78,3,1.29,139.44,141.05,139.96001,1810
2007-03-20 13:30:00,140.08,141.05,139.96001,140.97,136.43888888888893,147.691996,135.31244995000026,141.34469990000005,142.5010004,140.8875005,141.54169467195538,140.7674113310691,139.57615615384637,141.7865730810077,137.36573922668506,135.31244995000026,141.34469990000005,142.5010004,140.8875005,140.66000333333332,83351248,133885126.4,49.24588337054904,1.5,2.75,1.7092808430205448,0.6225579363534139,0.057295094261083035,-0.9408885902877272,-0.9981836845488103,16.294706693015694,1.010318142734305,3239148589.0,2007-03-20,2007,1,79,3,0.78,140.51,143.64999,140.82001,1811
2007-03-21 13:30:00,141.10001,143.64999,140.82001,143.28999,136.36111111111111,147.76266244444446,135.38389990000027,141.3987998,142.54300020000005,140.753,141.61025527305515,141.00765691858632,139.9315400000002,142.82497489086398,137.03810510913644,135.38389990000027,141.3987998,142.54300020000005,140.753,142.58666333333338,153296944,138351304.0,57.08196870048273,1.5,2.75,1.7893307828047924,1.1080267375000672,0.30044013892462884,-0.6226335108930243,-0.9230736498176532,18.439157581867896,1.8118373019868168,3392445533.0,2007-03-21,2007,2,80,3,2.01,142.24,143.67999,142.78999,1812
2007-03-22 13:30:00,143.48,143.67999,142.78999,143.17999,136.28333333333333,147.83332888888887,135.46419985000028,141.44709960000003,142.58519980000003,140.6184995,141.67181349764118,141.21454578348283,140.38000000000022,143.34037966383738,137.4196203361631,135.46419985000028,141.44709960000003,142.58519980000003,140.6184995,143.2166566666666,118950624,140344851.2,56.63548280307176,1.5,2.75,1.7250928697473085,0.8475595861403429,0.43848471712743775,-0.37496775340835603,-0.8134524705357937,18.13702846533527,1.7047805085949723,3273494909.0,2007-03-22,2007,3,81,3,0.62,143.23,143.81,143.14999,1813
2007-03-23 13:30:00,143.28,143.81,143.14999,143.39,136.20555555555555,147.9039953333333,135.54709985000028,141.4931996,142.62220000000005,140.5229995,141.73919336047882,141.4217318993416,140.66384615384635,143.9935637622464,137.3341285454463,135.54709985000028,141.4931996,142.62220000000005,140.5229995,143.44999666666666,74425744,140467569.6,57.32183420049633,1.5,2.75,1.649015521908215,0.529842896918749,0.5228407294214097,-0.15990155875903156,-0.6827422881804412,18.115543233085198,1.7022411729738682,3347920653.0,2007-03-23,2007,4,82,3,0.46,143.48,143.64999,142.09,1814
2007-03-26 13:30:00,143.5,143.64999,142.09,143.2,136.12777777777777,147.97466177777775,135.63379985000026,141.54609960000005,142.643,140.42449949999997,141.79647989536198,141.59109076607098,140.94384615384638,144.46202806600616,137.42566424168655,135.63379985000026,141.54609960000005,142.643,140.42449949999997,142.97999666666666,113811504,142654407.2,56.451303107251924,1.5,2.75,1.6426565560576285,0.797812743636006,0.5424043436821014,-0.0047368585778144725,-0.5471412022599159,18.20689543255272,3.5804701627486355,3234109149.0,2007-03-26,2007,0,85,3,1.1,142.87,143.16,142.39,1815
2007-03-27 13:30:00,143.12,143.16,142.39,142.86,136.05,148.0453282222222,135.7193498500003,141.59659960000005,142.63539980000002,140.59249949999997,141.83818656613212,141.7119392645404,141.1069223076925,144.76590869369326,137.4479359216918,135.7193498500003,141.59659960000005,142.63539980000002,140.59249949999997,142.8033333333333,100535184,133935668.8,54.84613602494768,1.5,2.75,1.583181087767798,0.7506229289086882,0.5095228823169411,0.08976240063626051,-0.4197604816806806,12.748696635663807,2.5703618609994345,3133573965.0,2007-03-27,2007,1,86,3,0.54,142.77,142.47,141.25999,1816
2007-03-28 13:30:00,142.14,142.47,141.25999,141.82001,135.97222222222223,148.1159946666666,135.80169985000032,141.63689980000004,142.61259980000003,140.63700049999997,141.83747375961713,141.72223171553657,141.18692307692328,144.85927314083537,137.51457301301122,135.80169985000032,141.63689980000004,142.61259980000003,140.63700049999997,141.85,152962064,132706288.0,50.148897710912145,1.5,2.75,1.5843831529272427,1.1526361433604413,0.39966053190786205,0.07981518320414692,-0.31984534870371506,13.756987240188913,1.684957338495732,2980611901.0,2007-03-28,2007,2,87,3,0.86,141.86,142.61,141.19,1817
2007-03-29 13:30:00,142.53999,142.61,141.19,141.97,135.89444444444445,148.18666111111108,135.89159980000028,141.68799980000003,142.5915998,140.71000099999998,141.84267086708314,141.7458286950093,141.26230692307718,144.95556743861903,137.5690464075353,135.89159980000028,141.68799980000003,142.5915998,140.71000099999998,141.92333333333332,139480064,129038235.2,50.803308246858656,1.5,2.75,1.5726414991467266,1.0809204247393491,0.3223380539555758,0.08307721874075469,-0.2392608352148211,13.761712662511131,2.4832166317765094,3120091965.0,2007-03-29,2007,3,88,3,1.01,141.9,142.84,140.56,1818
2007-03-30 13:30:00,142.24001,142.84,140.56,142.0,135.81666666666666,148.25732755555555,135.98884980000028,141.74019980000003,142.5808,140.87650099999996,141.8488406370014,141.77003548596076,141.5507684615387,144.819220474512,138.28231644856533,135.98884980000028,141.74019980000003,142.5808,140.87650099999996,141.79999999999995,128208496,127318644.0,50.94202495306948,1.5,2.75,1.623167106350532,1.0069891727718998,0.26107215461199723,0.08707935805017541,-0.17399279656182182,12.723545007952907,1.283880171184031,3248300461.0,2007-03-30,2007,4,89,3,1.62,141.7,142.46001,140.89,1819
2007-04-02 13:30:00,142.16,142.46001,140.89,142.16,135.73888888888888,148.32799399999996,136.08214980000028,141.7963999,142.56759979999995,141.11700049999996,141.8610429649621,141.8071749634883,141.77230692307714,144.77465334986144,138.76996049629284,136.08214980000028,141.7963999,142.56759979999995,141.11700049999996,141.83667,79428368,124083212.0,51.723848810097074,1.5,2.75,1.6193701701826384,0.6401217918182195,0.22078312739987696,0.10198611268802438,-0.11879701471185257,11.191305219975202,0.8441512378520236,3327728829.0,2007-04-02,2007,0,92,4,1.11,141.68,143.98,142.91,1820
2007-04-03 13:30:00,142.97,143.98,142.91,143.69,135.6611111111111,148.3986604444444,136.16999980000028,141.85249990000003,142.59379979999997,141.31650049999996,141.93276677025773,141.98649163363228,142.09692230769252,144.9417733034925,139.25207131189254,136.16999980000028,141.85249990000003,142.59379979999997,141.31650049999996,143.52666666666667,82499312,121039212.0,58.5298367764122,1.5,2.75,1.633700872312449,0.6815916151205611,0.28268100465418844,0.23455424110588294,-0.048126763548305466,12.24041862983494,0.27916116122278245,3410228141.0,2007-04-03,2007,1,93,4,0.75,143.44,143.95,143.16,1821
2007-04-04 13:30:00,143.69,143.95,143.16,143.85001,135.58333333333334,148.46932688888887,136.26599990000022,141.90490000000003,142.61479999999997,141.53100099999997,142.00795277926724,142.16396957328638,142.50615384615406,144.6166471674793,140.3956605248288,136.26599990000022,141.90490000000003,142.61479999999997,141.53100099999997,143.65333666666666,64006528,118478313.6,59.17801294093585,1.5,2.75,1.5734365242901307,0.5402383445133709,0.3173090164879754,0.3485095070616637,0.03120049057368837,8.111746880268521,0.4679564511772866,3474234669.0,2007-04-04,2007,2,94,4,0.55,143.56,144.44,143.61,1822
2007-04-05 13:30:00,143.67,144.44,143.61,144.24001,135.50555555555556,148.5399933333333,136.36884995000028,141.9582001,142.62060019999996,141.70600099999996,142.09548443498224,142.36168770916385,142.81692384615403,144.64898778400996,140.98485990829815,136.36884995000028,141.9582001,142.62060019999996,141.70600099999996,144.09667000000005,46843232,114925862.4,60.786775793674344,1.5,2.75,1.5203339154122637,0.40759521853281294,0.3469837604487168,0.4649301911345845,0.1179464306858676,8.174979393391371,0.5927958713996974,3521077901.0,2007-04-05,2007,3,95,4,0.58,144.02,144.8,144.14999,1823
2007-04-09 13:30:00,144.64999,144.8,144.14999,144.44,135.42777777777778,148.61065977777776,136.47059995000026,142.02080020000002,142.6642004,141.88900099999995,142.1874262218457,142.559622213053,143.08384692307718,144.76684011891697,141.40085372723738,136.47059995000026,142.02080020000002,142.6642004,141.88900099999995,144.46333,51137744,112094468.0,61.622010374189756,1.5,2.75,1.4581679214542451,0.4562022097290296,0.3590814524741018,0.5667982462784948,0.20771679380439306,8.172503164257884,0.8659217877095037,3572215645.0,2007-04-09,2007,0,99,4,0.45,144.47,144.85001,144.27,1824
2007-04-10 13:30:00,144.33,144.85001,144.27,144.61,135.35,148.6813262222222,136.56860000000032,142.08450009999999,142.71320039999995,142.07000049999996,142.28242911510662,142.75489628800034,143.18538615384637,145.05482706263066,141.3159452450621,136.56860000000032,142.08450009999999,142.71320039999995,142.07000049999996,144.57667,56632064,110907480.8,62.3560117397702,1.5,2.75,1.395442355636084,0.5106243834185079,0.35679569686124163,0.6537114148809451,0.29691571801970346,8.06795468226451,1.22497550048999,3628847709.0,2007-04-10,2007,1,100,4,0.4,144.56,144.86,143.53999,1825
2007-04-11 13:30:00,144.82001,144.86,143.53999,144.02,135.27222222222218,148.7519926666666,136.66639995000028,142.13890010000003,142.7526004,142.35850049999996,142.35056914980834,142.8753823558098,143.2500023076925,145.17157243496482,141.32843218042024,136.66639995000028,142.13890010000003,142.7526004,142.35850049999996,144.13999666666666,106552256,106731062.4,58.19599106566433,1.5,2.75,1.3900543302335084,0.998324701394521,0.2962998639417727,0.6672905479469193,0.3709906840051466,8.381353189418455,1.5512550027319938,3522295453.0,2007-04-11,2007,2,101,4,0.92,144.2,144.92,143.34,1826
2007-04-12 13:30:00,143.74001,144.92,143.34,144.66,135.19444444444446,148.82265911111108,136.76749995000029,142.18930010000003,142.79000059999996,142.62750049999994,142.44113506550212,143.04534594097078,143.3476946153848,145.41165854680426,141.2837306839654,136.76749995000029,142.18930010000003,142.79000059999996,142.62750049999994,144.30666666666662,116447120,100962074.4,61.21841486746031,1.5,2.75,1.4036218780739709,1.1533748755859556,0.28031077297984275,0.7213791502299499,0.4410683772501073,6.780559230563132,1.89476649996478,3638742573.0,2007-04-12,2007,3,102,4,1.1,144.13,145.32001,144.36,1827
2007-04-13 13:30:00,144.89999,145.32001,144.36,145.32001,135.11666666666667,148.89332555555552,136.8691499500003,142.24230020000005,142.82140080000002,142.92000099999996,142.5540321217569,143.26198061325928,143.51077230769252,145.82243611387912,141.19910850150592,136.8691499500003,142.24230020000005,142.82140080000002,142.92000099999996,145.00000666666668,85181568,98600468.8,64.10095614793829,1.5,2.75,1.3719353153544005,0.8639063184656989,0.29369392670734906,0.8081857856342936,0.5144918589269445,6.9012283896834425,2.338035211267603,3723924141.0,2007-04-13,2007,4,103,4,0.67,144.84,146.86,145.82001,1828
2007-04-16 13:30:00,145.83,146.86,145.82001,146.7,135.03888888888892,148.96399199999996,136.98309995000028,142.30550019999998,142.86320080000002,143.3285009999999,142.71661909737432,143.5894110310441,143.80615692307714,146.63353449578182,140.9787793503725,136.98309995000028,142.30550019999998,142.86320080000002,143.3285009999999,146.46000333333333,83206816,96658500.0,69.24775212563642,1.5,2.75,1.3839392214005155,0.8608328910545892,0.370063521066516,0.9770712602600896,0.6070077391935735,7.833755656753162,3.1935846933033147,3807130957.0,2007-04-16,2007,0,106,4,0.71,146.34,147.39999,146.64999,1829
2007-04-17 13:30:00,146.97,147.39999,146.64999,147.09,134.96111111111108,149.0346584444444,137.0947999500003,142.37220020000004,142.90880080000002,143.67300099999994,142.88812423081063,143.92280045665896,144.21154076923096,147.2841585325864,141.13892300587554,137.0947999500003,142.37220020000004,142.90880080000002,143.67300099999994,147.04666,108442368,97269962.4,70.53350045738476,1.5,2.75,1.3386578484433358,1.1148597709337655,0.41788607720890497,1.1293653357047049,0.7114792584957998,7.7303431979824735,2.3662050247059683,3915573325.0,2007-04-17,2007,1,107,4,0.51,147.02,147.7,146.57001,1830
2007-04-18 13:30:00,146.60001,147.7,146.57001,147.27,134.88333333333333,149.10532488888884,137.19479995000032,142.43990020000004,142.9572006,143.98800099999997,143.05996249626904,144.2415813655486,144.61923307692328,147.79859360064933,141.43987255319726,137.19479995000032,142.43990020000004,142.9572006,143.98800099999997,147.18000333333333,88348256,97519812.8,71.13338482794788,1.5,2.75,1.3237530021259545,0.9059518621225244,0.430954809127695,1.2501727699054186,0.8192179607777236,6.228331472988647,2.377469421100501,4003921581.0,2007-04-18,2007,2,108,4,0.77,147.14,147.39999,146.36,1831
2007-04-19 13:30:00,146.55,147.39999,146.36,147.23,134.80555555555554,149.17599133333331,137.29479995000028,142.50580020000004,143.00400059999996,144.18500149999994,143.22349337876832,144.52619266406774,145.02154076923097,148.09518737015924,141.9478941683027,137.29479995000028,142.50580020000004,143.00400059999996,144.18500149999994,146.99666333333334,103342944,95022112.8,70.7885001661728,1.5,2.75,1.303484216259814,1.0875673141210138,0.40653331357126254,1.3273846027418017,0.9208512891705392,6.3862651486532025,2.072926922287358,3900578637.0,2007-04-19,2007,3,109,4,0.71,146.88,148.62,147.0439,1832
2007-04-20 13:30:00,148.22,148.62,147.0439,148.62,134.72777777777782,149.24665777777776,137.3988999500003,142.58280020000004,143.0722004,144.4570019999999,143.43512108940484,144.91607907701368,145.51846384615402,148.6687559607463,142.36817173156174,137.3988999500003,142.58280020000004,143.0722004,144.4570019999999,148.09463333333332,124128320,95280997.6,75.27472494098564,1.5,2.75,1.3229567722412556,1.3027604992246642,0.4502265724958561,1.4836345047903592,1.0334079322945031,7.573865086863051,2.8939351980060963,4024706957.0,2007-04-20,2007,4,110,4,1.07,147.83,148.73,147.97,1833
2007-04-23 13:30:00,148.37,148.73,147.97,148.06,134.65,149.3173242222222,137.50384990000032,142.65990010000004,143.1330004,144.69050199999995,143.61648888982037,145.21550011729812,145.85461769230787,149.08434690223189,142.62488848238385,137.50384990000032,142.65990010000004,143.1330004,144.69050199999995,148.25333333333333,77569312,95438176.0,70.57232555053608,1.5,2.75,1.2827455742240226,0.8127702692054802,0.4088517652198945,1.5444726388193717,1.1356208735994768,8.494817124920688,2.385727128137742,3947137645.0,2007-04-23,2007,0,113,4,0.51,148.35,148.39999,147.32001,1834
2007-04-24 13:30:00,148.23,148.39999,147.32001,148.12,134.57222222222222,149.3879906666666,137.60724990000028,142.75690010000002,143.21660039999998,144.93650199999996,143.79309716865092,145.4921191537459,146.18307846153863,149.39901095224997,142.96714597082732,137.60724990000028,142.75690010000002,143.21660039999998,144.93650199999996,147.9466666666667,114473504,95471276.0,70.78292391470038,1.5,2.75,1.2682623189223072,1.1990360744733315,0.35496197354961057,1.5793233405364902,1.2243613669868796,8.54918162308557,2.8468268296069947,4061611149.0,2007-04-24,2007,1,114,4,0.73,147.86,149.66,148.0233,1835
2007-04-25 13:30:00,148.73,149.66,148.0233,149.48,134.49444444444444,149.45865711111108,137.72159990000029,142.86150010000003,143.33720039999997,145.26750199999995,144.01611296595868,145.87191732957962,146.5861546153848,150.0321905708114,143.1401186599582,137.72159990000029,142.86150010000003,143.33720039999997,145.26750199999995,149.05443333333338,109158944,95902464.0,75.12786982157412,1.5,2.75,1.2945792961421418,1.138228773767481,0.37820695686829453,1.6971200630722478,1.3189131062039532,8.24216749750808,3.3319507811419835,4170770093.0,2007-04-25,2007,2,115,4,1.11,148.84,149.8,149.10001,1836
2007-04-26 13:30:00,149.49001,149.8,149.10001,149.64999,134.41666666666666,149.52932355555552,137.8355998000003,142.95330000000004,143.43700019999997,145.6590009999999,144.23704932023486,146.2317337743816,146.98692307692326,150.55116386667288,143.4226822871736,137.8355998000003,142.95330000000004,143.43700019999997,145.6590009999999,149.51666666666668,88749440,92691832.8,75.615984642452,1.5,2.75,1.25210863213199,0.9574677435874372,0.3717743140873362,1.7836309988131234,1.4118566847257872,8.353979193263697,2.9796171910530465,4259519533.0,2007-04-26,2007,3,116,4,0.47,149.45,149.74001,148.84,1837
2007-04-27 13:30:00,149.09,149.74001,148.84,149.53,134.3388888888889,149.59998999999996,137.9461998000003,143.04330000000004,143.5154002,146.03700099999998,144.44461601355894,146.54585436729758,147.36538461538478,150.88424966308045,143.84651956768909,137.9461998000003,143.04330000000004,143.5154002,146.03700099999998,149.37000333333333,108191744,91127416.8,74.50451408742406,1.5,2.75,1.2269587298368485,1.1872578835132743,0.3277243249644501,1.8215120909313496,1.4937877659668997,8.641135226385552,1.9291070211315695,4151327789.0,2007-04-27,2007,4,117,4,0.6,149.29,149.74001,148.21001,1838
2007-04-30 13:30:00,149.64,149.74001,148.21001,148.28999,134.26111111111112,149.6706564444444,138.05739975000031,143.12399990000003,143.56519999999998,146.3515005,144.59541499341938,146.7119625227931,147.69384538461554,150.65532158460738,144.73236918462376,138.05739975000031,143.12399990000003,143.56519999999998,146.3515005,148.74667,101012752,89767629.6,64.03002519761579,1.5,2.75,1.248604534848502,1.1252692362503909,0.1901816752850096,1.7315148600731618,1.5413331847881522,9.638590736624408,0.8158202461078152,4050315037.0,2007-04-30,2007,0,120,4,1.03,148.98,149.47,147.67,1839
2007-05-01 13:30:00,148.42,149.47,147.67,148.67,134.18333333333334,149.74132288888885,138.1807497500003,143.19780000000003,143.624,146.6770005,144.75520264073626,146.89844228252707,148.0023069230771,150.42116478554527,145.58344906060887,138.1807497500003,143.19780000000003,143.624,146.6770005,148.60333333333332,134434624,92517942.4,65.62497773228189,1.5,2.75,1.2879899252164668,1.4530654326354753,0.1042022794273454,1.671586034072334,1.5673837546449885,9.633034627390877,0.9506348883003852,4184749661.0,2007-05-01,2007,1,121,5,1.22,148.57,149.95,148.75,1840
2007-05-02 13:30:00,148.89999,149.95,148.75,149.53999,134.10555555555555,149.81198933333332,138.31084970000032,143.27420000000004,143.694,146.96949999999995,144.94284136070738,147.15001825561973,148.3269207692309,150.31265659016347,146.34118494829838,138.31084970000032,143.27420000000004,143.694,146.96949999999995,149.41333,87181808,92752067.2,69.01261200745455,1.5,2.75,1.2874192162724334,0.9399446355412336,0.08608079496860155,1.6749847483557403,1.5889039533871387,10.015105567242196,1.568966922502207,4271931469.0,2007-05-02,2007,2,122,5,0.81,149.35,150.39999,149.05,1841
2007-05-03 13:30:00,149.97,150.39999,149.05,150.35001,134.02777777777777,149.8826557777777,138.4458997500003,143.35990010000003,143.78140019999998,147.2945,145.15488718969925,147.45477937413213,148.60769076923094,150.62579593366718,146.5895856047947,138.4458997500003,143.35990010000003,143.78140019999998,147.2945,149.93333333333334,87844064,93943944.0,71.79924882919275,1.5,2.75,1.2918885579672588,0.9350689385576572,0.10741795206496896,1.7231763934683502,1.615758441403381,10.169401449072641,1.16404925312878,4359775533.0,2007-05-03,2007,3,123,5,0.91,149.72,151.12,150.22,1842
2007-05-04 13:30:00,150.75,151.12,150.22,150.92,133.95,149.95332222222217,138.58064975000028,143.45750010000003,143.88240019999998,147.6284995,145.38097004500514,147.78480038611954,148.90230615384633,151.06146868824894,146.74314361944369,138.58064975000028,143.45750010000003,143.88240019999998,147.6284995,150.75333333333333,96412256,96422395.2,73.59845495910834,1.5,2.75,1.263896518112455,0.9998948460056508,0.13680551112682204,1.7867653303119084,1.6499598191850864,9.157300148015917,1.9316493313521448,4456187789.0,2007-05-04,2007,4,124,5,0.6,150.67,151.2,150.81,1843
2007-05-07 13:30:00,150.88,151.2,150.81,150.95,133.87222222222223,150.0239886666666,138.7069497500003,143.55280010000004,143.99540019999998,147.95399949999995,145.5993633765736,148.08624796839388,149.18538307692324,151.37896447539197,146.99180167845452,138.7069497500003,143.55280010000004,143.99540019999998,147.95399949999995,150.98666666666662,63688656,97049940.8,73.69358563967717,1.5,2.75,1.2014753382472787,0.6562462117442116,0.13492565405410814,1.8186168867527213,1.683691232698613,8.58122139149242,1.9106130164731192,4519876445.0,2007-05-07,2007,0,127,5,0.26,151.0,150.92,150.13,1844
2007-05-08 13:30:00,150.58,150.92,150.13,150.75,133.79444444444445,150.09465511111108,138.83654975000027,143.64200010000005,144.10700020000004,148.26099949999997,145.8013491265119,148.33993863807066,149.45615230769246,151.47983845994327,147.4324661554417,138.83654975000027,143.64200010000005,144.10700020000004,148.26099949999997,150.6,81533936,98295034.4,71.835257772073,1.5,2.75,1.174227099801044,0.8294817382962327,0.09856094597655017,1.806892415169301,1.7083314691927511,8.749421619179106,0.8496119882258565,4438342509.0,2007-05-08,2007,1,128,5,0.53,150.52,152.82001,150.37,1845
2007-05-09 13:30:00,150.64,152.82001,150.37,151.16,133.71666666666667,150.16532155555552,138.97259975000028,143.73640010000003,144.3402002,148.61799949999997,146.01149229802127,148.6085159106354,149.6515369230771,151.80112813237042,147.50194571378375,138.97259975000028,143.73640010000003,144.3402002,148.61799949999997,151.45000333333334,102947872,98114815.2,73.32053755899533,1.5,2.75,1.2653544498152545,1.0492591948539898,0.08119223405504307,1.8098217617615544,1.7286295277065116,7.449910041727411,1.009027798799047,4541290381.0,2007-05-09,2007,2,129,5,1.63,151.6,151.02,149.27,1846
2007-05-10 13:30:00,150.73,151.02,149.27,149.58,133.63888888888889,150.23598799999996,139.0894497000003,143.81350010000003,144.51320040000004,148.86399949999995,146.15143377653018,148.70103820486057,149.7684600000002,151.71480310912872,147.82211689087163,139.0894497000003,143.81350010000003,144.51320040000004,148.86399949999995,149.95666666666668,153698560,99977387.2,60.15516070924581,1.5,2.75,1.3099719891141641,1.5373332340895582,-0.05054186343215461,1.6654521984163182,1.7159940618484728,9.9939833954184,0.03343810606568004,4387591821.0,2007-05-10,2007,3,130,5,1.17,150.15,150.92999,149.72,1847
2007-05-11 13:30:00,149.75,150.92999,149.72,150.86,133.56111111111107,150.3066544444444,139.2104497000003,143.89090010000004,144.7202006,149.140999,146.33608343235255,148.90665361392146,149.9792292307694,151.75152447250997,148.20693398902887,139.2104497000003,143.89090010000004,144.7202006,149.140999,150.50333,113413120,101388964.8,65.55167498943769,1.5,2.75,1.3128304184631516,1.1185943186590264,-0.0644185362468046,1.6354708915399667,1.6998894277867715,11.103680728148289,1.7330974261985082,4501004941.0,2007-05-11,2007,4,131,5,0.81,150.32,151.3,149.78999,1848
2007-05-14 13:30:00,150.86,151.3,149.78999,150.53,133.48333333333332,150.37732088888885,139.3289497000003,143.97280010000003,144.9574006,149.332499,146.50055074873092,149.06125803164326,150.0599984615387,151.82962769700325,148.2903692260741,139.3289497000003,143.97280010000003,144.9574006,149.332499,150.53999666666667,108062320,102631740.0,63.176026337550276,1.5,2.75,1.3269146742872138,1.0529132605566272,-0.10629663630721753,1.5670186324027495,1.6733152687099673,9.715413736444383,1.251093024820081,4392942621.0,2007-05-14,2007,0,134,5,1.01,150.54,151.66499,150.19,1849
2007-05-15 13:30:00,150.7,151.66499,150.19,150.57001,133.40555555555557,150.44798733333332,139.44824970000028,144.05900019999999,145.2218006,149.50649950000002,146.66013738603556,149.20494869529625,150.13076923076943,151.90273503254184,148.35880342899705,139.44824970000028,144.05900019999999,145.2218006,149.50649950000002,150.8083333333333,180931808,106256212.0,63.34945391683118,1.5,2.75,1.3374914832666978,1.702788049700097,-0.13967472395710034,1.498721863763592,1.6383965877206923,9.713004082702527,0.6887923424362992,4573874429.0,2007-05-15,2007,1,135,5,0.98,150.93,151.63,150.38,1850
2007-05-16 13:30:00,150.8,151.63,150.38,151.60001,133.32777777777778,150.5186537777777,139.56634975000028,144.15280030000002,145.4598008,149.72299999999998,146.85385788070084,149.4330497719347,150.29000076923097,152.18515150413802,148.3948500343239,139.56634975000028,144.15280030000002,145.4598008,149.72299999999998,151.20333666666667,114667008,107572149.6,67.58221887681887,1.5,2.75,1.331242091604791,1.0659544168856137,-0.10247823803935074,1.510298790171504,1.612777028210855,9.896163072108989,0.8313933600669531,4688541437.0,2007-05-16,2007,2,136,5,0.83,151.0,151.96001,151.11,1851
2007-05-17 13:30:00,151.38,151.96001,151.11,151.3,133.25,150.58932022222217,139.68359970000031,144.24440030000005,145.69460080000005,149.9265,147.02821639518316,149.61085455555997,150.5215400000002,152.09005796489325,148.95302203510718,139.68359970000031,144.24440030000005,145.69460080000005,149.9265,151.45667,101566000,107483302.4,65.21954038929029,1.5,2.75,1.296868370775877,0.9449467752862792,-0.10764144034261358,1.4782252277825876,1.5858666681252012,9.700456384532568,0.25178902729924724,4586975437.0,2007-05-17,2007,3,137,5,0.56,151.54,152.62,151.81,1852
2007-05-18 13:30:00,152.00999,152.62,151.81,152.62,133.17222222222222,150.6599866666666,139.8105997000003,144.35440030000004,145.93220060000002,150.12650000000005,147.2475020267446,149.89743983598282,150.82538615384638,152.3716918915999,149.27908041609282,139.8105997000003,144.35440030000004,145.93220060000002,150.12650000000005,152.35,99182256,106235999.2,70.16221132592213,1.5,2.75,1.2985206300061711,0.9336030794352428,-0.03545362080534065,1.5415496421185253,1.577003262923866,10.643435897096033,1.1063265982113388,4686157693.0,2007-05-18,2007,4,138,5,0.53,152.22,153.23,152.4993,1853
2007-05-21 13:30:00,152.58,153.23,152.4993,152.53999,133.09444444444443,150.73065311111102,139.93289965000028,144.47230020000003,146.16740040000005,150.3504995,147.45505057471541,150.14911128017494,151.05615538461558,152.66059777968877,149.45171298954244,139.93289965000028,144.47230020000003,146.16740040000005,150.3504995,152.75643,174706432,111092855.2,69.51733781803135,1.5,2.75,1.257962013577158,1.5726162738861715,-0.007832445649602615,1.5672127058618628,1.5750451515114654,10.674310044566038,1.1873897180762778,4511451261.0,2007-05-21,2007,0,141,5,0.48,152.86,153.16,152.38,1854
2007-05-22 13:30:00,152.7,153.16,152.38,152.42,133.01666666666668,150.8013195555555,140.05289965000028,144.58070020000005,146.39600019999997,150.56549950000004,147.64975447374616,150.36538639634875,151.2153853846156,152.91589131567937,149.5148794535518,140.05289965000028,144.58070020000005,146.39600019999997,150.56549950000004,152.6533333333333,82254320,109481896.0,68.5005028022097,1.5,2.75,1.223821869750218,0.7513052203626434,-0.01212630590778585,1.5598872691267331,1.5720135750345192,10.63496678211477,0.8335538502249212,4429196941.0,2007-05-22,2007,1,142,5,0.51,152.77,153.5,152.36,1855
2007-05-23 13:30:00,152.95,153.5,152.36,152.44,132.93888888888893,150.87198599999996,140.17409965000027,144.68000030000005,146.6798002,150.7134995,147.8376072394816,150.56296864431553,151.3323084615387,153.14107316741809,149.52354375565926,140.17409965000027,144.68000030000005,146.6798002,150.7134995,152.76666666666668,133950624,110721480.0,68.58299100147721,1.5,2.75,1.2178345933394874,1.2097979904170355,-0.02723732775451793,1.5379669153413715,1.5652042430958897,10.594866874617438,1.9120203235726598,4563147565.0,2007-05-23,2007,2,143,5,0.75,152.93,153.21001,150.74001,1856
2007-05-24 13:30:00,152.53,153.21001,150.74001,151.06,132.86111111111111,150.9426524444444,140.28964965000026,144.76850019999998,146.9154002,150.78400000000005,147.9639755830313,150.61030496390453,151.3407700000002,153.14332016729426,149.53821983270618,140.28964965000026,144.76850019999998,146.9154002,150.78400000000005,151.67000666666667,187770320,115672524.0,57.4112904925946,1.5,2.75,1.3072749795295238,1.6232923213467705,-0.13761884215196973,1.3931806904059272,1.530799532557897,10.059567789923387,0.1325732467188046,4375377245.0,2007-05-24,2007,3,144,5,1.64,151.98,152.02,151.17999,1857
2007-05-25 13:30:00,151.49001,152.02,151.17999,151.69,132.78333333333333,151.01331888888885,140.41104965000022,144.86920020000005,147.15980019999995,150.892,148.1100941876183,150.71313306258028,151.41307769230787,153.1902700556027,149.63588532901306,140.41104965000022,144.86920020000005,147.15980019999995,150.892,151.62999666666667,83309120,114428392.8,60.56909846194788,1.5,2.75,1.282469623848844,0.7280458805849801,-0.17334050875033746,1.314123896619975,1.4874644053703123,9.135399954770207,0.7706105095329812,4458686365.0,2007-05-25,2007,4,145,5,0.56,151.6,152.5,151.45,1858
2007-05-29 13:30:00,151.94,152.5,151.45,152.24001,132.70555555555555,151.08398533333332,140.53734970000028,144.97790030000002,147.4340004,151.089501,148.27205167045682,150.85854991376308,151.49615538461555,153.31865453495374,149.6736562342773,140.53734970000028,144.97790030000002,147.4340004,151.089501,152.0633366666667,83960816,113575796.0,63.13875984468573,1.5,2.75,1.2658646507167846,0.7392491970736441,-0.16510393720567018,1.2810844838632252,1.4461884210688951,9.106481735570334,1.1091186086791227,4542647181.0,2007-05-29,2007,1,149,5,0.69,151.98,153.53999,151.34,1859
2007-05-30 13:30:00,151.46001,153.53999,151.34,153.48,132.62777777777777,151.1546517777777,140.66789970000028,145.09600030000001,147.6996004,151.330001,148.47628493828202,151.10821182673808,151.79615538461556,153.5404977334371,150.05181303579403,140.66789970000028,145.09600030000001,147.6996004,151.330001,152.78666333333334,131273376,113417733.6,68.17433376362867,1.5,2.75,1.3325878899512988,1.1574325445699083,-0.08533775134529731,1.3395162318872735,1.4248539832325708,9.909778321231098,1.2400988627903071,4673920557.0,2007-05-30,2007,2,150,5,1.45,152.44,153.89,153.12,1860
2007-05-31 13:30:00,153.66,153.89,153.12,153.32001,132.55,151.22531822222214,140.79944980000027,145.22380049999998,147.9466006,151.519002,148.6662349407024,151.31885927181062,151.9853869230771,153.81414082879778,150.15663301735637,140.79944980000027,145.22380049999998,147.9466006,151.519002,153.44333666666668,115777808,114847533.6,66.90436561406254,1.5,2.75,1.292403040669062,1.008100081654692,-0.05406861525500895,1.3572682141638095,1.4113368294188189,9.50607366233296,1.335102445472561,4558142749.0,2007-05-31,2007,3,151,5,0.5,153.5,154.39999,153.50999,1861
2007-06-01 13:30:00,153.88,154.39999,153.50999,154.08,132.47222222222223,154.39999,140.93429980000028,145.3527005,148.16240080000003,151.7055015,148.8785394528317,151.5818250554477,152.258463846154,154.1934802463417,150.3234474459663,140.93429980000028,145.3527005,148.16240080000003,151.7055015,153.99666000000005,107774432,115844052.0,69.78382608501968,1.5,2.75,1.2772299663355575,0.9303406617717412,0.003998537469825925,1.4163350012561011,1.4123364637862752,9.508043181758415,0.956624295636226,4665917181.0,2007-06-01,2007,4,152,6,0.58,153.95,154.39,153.48,1862
2007-06-04 13:30:00,153.53999,154.39,153.48,154.10001,132.39444444444445,154.5156420289855,141.06164985000024,145.4830005,148.38080119999998,151.86450200000002,149.08330300370105,151.8216521930241,152.53000230769248,154.43148534033546,150.62851927504948,141.06164985000024,145.4830005,148.38080119999998,151.86450200000002,153.99000333333333,78047568,114925817.6,69.8581851128658,1.5,2.75,1.2509992544544464,0.6791125756585438,0.028585283412564614,1.448068068051981,1.4194827846394165,8.459794119892809,1.0226957534217809,4743964749.0,2007-06-04,2007,0,155,6,0.59,153.94,153.89999,152.86,1863
2007-06-05 13:30:00,153.74001,153.89999,152.86,153.49001,132.31666666666666,154.63129405797105,141.1801499500003,145.6025007,148.5828014,151.9915025,149.2561150427716,151.9805434127361,152.67538692307704,154.5591454209888,150.79162842516527,141.1801499500003,145.6025007,148.5828014,151.9915025,153.41666666666666,127943056,118138537.6,64.63617943791212,1.5,2.75,1.250214307707699,1.0829917027853917,-0.009372636867319928,1.4077669885552666,1.4171396254225863,8.899564700747447,0.7020141713686031,4616021693.0,2007-06-05,2007,1,156,6,0.68,153.38,152.95,151.75,1864
2007-06-06 13:30:00,152.91,152.95,151.75,151.84,132.23888888888888,154.7469460869565,141.2891999500003,145.6993007,148.75560140000005,152.0460025,149.3574438646237,151.96715832580884,152.71692538461554,154.49858633042342,150.93526443880768,141.2891999500003,145.6993007,148.75560140000005,152.0460025,152.17999999999995,164138128,122268747.2,53.078293219583365,1.5,2.75,1.2851997143000071,1.3424373092783273,-0.1508921717520999,1.2285244107324615,1.3794165824845614,11.067544838777726,-0.393597480976118,4451883565.0,2007-06-06,2007,2,157,6,0.79,152.35,152.5,149.06,1865
2007-06-07 13:30:00,151.56,152.5,149.06,149.10001,132.1611111111111,154.86259811594203,141.38125000000028,145.75790070000005,148.88040160000003,151.94300300000003,149.34734841895218,151.69409658049372,152.4461569230771,155.07359242041045,149.81872142574366,141.38125000000028,145.75790070000005,148.88040160000003,151.94300300000003,150.22000333333332,232486192,128745663.2,40.2175642478691,1.5,2.75,1.4391140204214352,1.805778821759955,-0.4191194959070077,0.8555172126008017,1.2746367085078094,15.037854582771775,-1.2974910631537169,4219397373.0,2007-06-07,2007,3,158,6,2.31,150.78,151.19,149.09,1866
2007-06-08 13:30:00,149.5,151.19,149.09,151.03999,132.08333333333334,154.97825014492753,141.48579995000028,145.8387005,149.06480120000003,152.01600249999998,149.41372652016975,151.63180071568482,152.33077230769248,155.06131353594128,149.6002310794437,141.48579995000028,145.8387005,149.06480120000003,152.01600249999998,150.43999666666662,176982320,129909851.2,49.53998989133758,1.5,2.75,1.4863201618199038,1.3623471843373185,-0.4530838778346802,0.7082818612144592,1.1613657390491394,16.578966838987714,-0.4285120970400217,4396379693.0,2007-06-08,2007,4,159,6,1.41,150.14,151.95,150.7,1867
2007-06-11 13:30:00,150.92999,151.95,150.7,151.3,132.00555555555556,155.09390217391305,141.59169995000028,145.92150049999995,149.25140120000003,152.0380025,149.4876980291827,151.60020064752433,152.2446184615386,155.0286149087554,149.4606220143218,141.59169995000028,145.92150049999995,149.25140120000003,152.0380025,151.31666666666666,102527504,129365570.4,50.65073270783379,1.5,2.75,1.4694401502613392,0.7925408876796479,-0.44461540785428705,0.6055964792312807,1.0502118870855677,16.412754292748517,-0.6174526656954377,4498907197.0,2007-06-11,2007,0,162,6,0.83,151.32,151.53999,149.55,1868
2007-06-12 13:30:00,150.67,151.53999,149.55,149.64999,131.92777777777778,155.20955420289854,141.6911499500003,145.99260049999995,149.404401,151.994002,149.49406242019515,151.4144663001411,152.03000230769248,155.13259226306351,148.92741235232137,141.6911499500003,145.99260049999995,149.404401,151.994002,150.24666000000002,235736560,135749282.4,44.02748144280992,1.5,2.75,1.5066222823855278,1.7365584247095809,-0.5308744253428138,0.3866188554070504,0.9174932807498642,17.262103295759026,-2.495445660672392,4263170637.0,2007-06-12,2007,1,163,6,1.33,150.54,152.07001,149.722,1869
2007-06-13 13:30:00,150.5,152.07001,149.722,151.89,131.85,155.3252062318841,141.80235000000027,146.08330039999996,149.59900100000004,152.0600015,149.5880207566581,151.45975522393715,152.0938484615386,155.1477444983979,149.03995242467923,141.80235000000027,146.08330039999996,149.59900100000004,152.0600015,151.22733666666667,193250624,136365223.2,53.01070994206295,1.5,2.75,1.5718649765008468,1.4171547515202545,-0.42252299776324503,0.3893395335458081,0.8118625313090531,19.008455284453536,-0.9326962605859536,4456421261.0,2007-06-13,2007,2,164,6,1.57,150.9,153.12,152.03,1870
2007-06-14 13:30:00,152.06,153.12,152.03,152.86,131.77222222222218,155.44085826086956,141.91760000000028,146.1881004,149.78240100000005,152.123001,149.71633366816167,151.59311186927647,152.18384846153862,155.25375238701324,149.113944536064,141.91760000000028,146.1881004,149.78240100000005,152.123001,152.67,146645312,137964138.4,56.28273795357425,1.5,2.75,1.5474460496079303,1.062923406768436,-0.27795953016733943,0.4644131185998788,0.7423726487672182,19.4767683618502,-0.7917964693665621,4603066573.0,2007-06-14,2007,3,165,6,0.72,152.57,153.66,152.92999,1871
2007-06-15 13:30:00,153.14,153.66,152.92999,153.07001,131.69444444444446,155.5565102898551,142.03080010000028,146.29080050000005,149.96680100000003,152.2115015,149.8478503870573,151.73376883410728,152.24769461538475,155.3539237767262,149.1414654540433,142.03080010000028,146.29080050000005,149.96680100000003,152.2115015,153.22,154416368,140606656.8,56.98117868799698,1.5,2.75,1.4940570460645055,1.0982152019988856,-0.16614457361428306,0.5346919317493644,0.7008365053636474,19.231727473774463,-0.6683971013369832,4757482941.0,2007-06-15,2007,4,166,6,0.48,153.29,153.39,152.66,1872
2007-06-18 13:30:00,153.38,153.39,152.66,152.89,131.61666666666667,155.6721623188406,142.1423501000003,146.3802005,150.13980080000005,152.2250015,149.96715037187857,151.8438860880018,152.20231000000013,155.25191761320204,149.15270238679818,142.1423501000003,146.3802005,150.13980080000005,152.2250015,152.98,88635680,140079328.0,56.153062277304535,1.5,2.75,1.4394815427741832,0.6327534638087355,-0.105228762278063,0.5693005525160686,0.6745293147941316,19.226778159378814,-0.3909114345617841,4668847261.0,2007-06-18,2007,0,169,6,0.48,153.02,153.38,152.36,1873
2007-06-19 13:30:00,152.55,153.38,152.36,153.27,131.53888888888892,155.7878143478261,142.25540010000026,146.49030059999996,150.31640080000003,152.26150199999995,150.0966738867069,151.9797064605731,152.19846307692322,155.24254245997685,149.1543836938696,142.25540010000026,146.49030059999996,150.31640080000003,152.26150199999995,153.00333333333333,111117440,136899878.4,57.55540449800487,1.5,2.75,1.4095185754331685,0.8116693842147342,-0.043430489022958214,0.6202412035154339,0.6636716925383921,19.1929472533025,0.9417808219178126,4779964701.0,2007-06-19,2007,1,170,6,0.67,152.87,153.58,150.96001,1874
2007-06-20 13:30:00,153.58,153.58,150.96001,151.14,131.46111111111108,155.9034663768116,142.35790010000025,146.58010059999995,150.4470008000001,152.19750199999996,150.1375886362478,151.89973441670895,151.97230923076935,154.8562772919498,149.08834116958892,142.35790010000025,146.58010059999995,150.4470008000001,152.19750199999996,151.89333666666667,177234432,141648884.0,48.24177942842263,1.5,2.75,1.4959808200450853,1.2512236383027204,-0.14440202264681135,0.4831691642298779,0.6275711868766892,19.912585272764076,1.3682024568609947,4602730269.0,2007-06-20,2007,2,171,6,1.74,152.27,152.11,150.25,1875
2007-06-21 13:30:00,151.08,152.11,150.25,151.98,131.38333333333333,156.01911840579712,142.46070010000028,146.67940059999995,150.60620080000004,152.17450199999996,150.20984006227732,151.90737875797478,151.80923153846166,154.420353049604,149.1981100273194,142.46070010000028,146.67940059999995,150.60620080000004,152.17450199999996,151.4466666666667,205265680,145214636.8,51.570138934573315,1.5,2.75,1.521982190041866,1.4135329917376482,-0.152233840249536,0.4372788865647692,0.5895127268143052,16.556164660931273,0.6223583568828368,4807995949.0,2007-06-21,2007,3,172,6,1.24,151.18,151.77,149.85001,1876
2007-06-22 13:30:00,151.52,151.77,149.85001,150.55,131.30555555555554,156.1347704347826,142.55510010000026,146.7570007,150.72400080000006,152.14900199999997,150.22317966767818,151.77810459054862,151.58307692307704,154.07948089212226,149.08667295403185,142.55510010000026,146.7570007,150.72400080000006,152.14900199999997,150.72333666666663,205153120,146083776.8,46.13150362762526,1.5,2.75,1.565411319324589,1.4043525194510167,-0.2457960565965888,0.2822676560685693,0.5280637126651581,16.084286321424994,-0.49570389953734295,4602842829.0,2007-06-22,2007,4,173,6,1.28,150.81,151.25,149.02,1877
2007-06-25 13:30:00,150.24001,151.25,149.02,149.83,131.22777777777782,156.25042246376813,142.6517001500003,146.8178007,150.81420060000005,152.05600199999995,150.20776085718103,151.59257082002017,151.42846153846168,154.08585174644682,148.77107133047653,142.6517001500003,146.8178007,150.81420060000005,152.05600199999995,150.03333333333333,232036432,153520142.4,43.63622008558736,1.5,2.75,1.6128819393728322,1.5114396610929668,-0.3423169797746593,0.10016748794683394,0.4424844677214933,16.21477617958867,0.12028734515786467,4370806397.0,2007-06-25,2007,0,176,6,1.5,150.14,150.46001,148.28,1878
2007-06-26 13:30:00,150.21001,150.46001,148.28,148.28999,131.15,156.36607449275363,142.7436001000003,146.85460059999997,150.84600040000004,151.85850099999996,150.13255415689943,151.27803931335154,151.36615230769243,154.26593713470544,148.4663674806794,142.7436001000003,146.85460059999997,150.84600040000004,151.85850099999996,149.01,198318256,159238014.4,38.801745490985,1.5,2.75,1.6533910865604875,1.2454203021009285,-0.4871834896550761,-0.16649489434735187,0.3206885953077242,16.07571590977927,-2.3701428665481585,4172488141.0,2007-06-26,2007,1,177,6,1.47,149.37,150.57001,148.06,1879
2007-06-27 13:30:00,148.13,150.57001,148.06,150.39999,148.06,156.48172652173915,142.8442000500003,146.91050049999996,150.91220020000003,151.70450049999994,150.14304183702103,151.19441556922285,151.31692153846166,154.25861253312144,148.37523054380188,142.8442000500003,146.91050049999996,150.91220020000003,151.70450049999994,149.67666666666662,209169056,163132798.4,47.40036083645833,1.5,2.75,1.7145781518061671,1.2822011149904973,-0.4207124340112576,-0.20520194720634774,0.2155104868049098,15.818116271031174,-1.6093222556587798,4381657197.0,2007-06-27,2007,2,178,6,1.7,149.32,151.41,149.67,1880
2007-06-28 13:30:00,150.38,151.41,149.67,150.38,148.2149315068493,156.5973785507246,142.9440500500003,146.96580039999995,150.97440020000005,151.55749999999995,150.1523343140006,151.1168521816778,151.24615230769243,154.23002960666253,148.2622750087223,142.9440500500003,146.96580039999995,150.97440020000005,151.55749999999995,150.48666666666662,157701504,165228983.2,47.332508621246994,1.5,2.75,1.7163939981057272,0.9544421380909399,-0.3602357061774516,-0.23478414591690466,0.1254515602605469,15.139660597624404,-1.7573723291714691,4223955693.0,2007-06-28,2007,3,179,6,1.16,150.54,151.64999,149.14999,1881
2007-06-29 13:30:00,150.89999,151.64999,149.14999,150.42999,148.36986301369862,156.71303057971016,143.0377500000003,147.02120029999998,151.03840000000002,151.37499949999997,150.16322277227508,151.05143673580375,151.30615230769243,154.18888813110217,148.42341648428263,143.0377500000003,147.02120029999998,151.03840000000002,151.37499949999997,150.40999,199697632,169825143.2,47.53476815672707,1.5,2.75,1.7723658553838897,1.1759014492030766,-0.3013993867350703,-0.25129767315829105,0.05010171357677931,15.075796101664825,-1.609006475243628,4423653325.0,2007-06-29,2007,4,180,6,1.68,150.4,151.92,150.77,1882
2007-07-02 13:30:00,150.87,151.92,150.77,151.78999,148.52479452054794,156.82868260869566,143.1355999500003,147.08700009999995,151.10179980000004,151.25949849999995,150.2270175655192,151.12177514191768,151.29845923076934,154.17544966360924,148.42146879792944,143.1355999500003,147.08700009999995,151.10179980000004,151.25949849999995,151.49333000000001,103352000,171090364.8,52.84083739182603,1.5,2.75,1.7521975799993246,0.6040784360990502,-0.16238681263308738,-0.15288180221457992,0.009505010418507459,16.293700739313802,-0.9656227572258246,4527005325.0,2007-07-02,2007,0,183,7,0.76,151.34,152.5,151.99001,1883
2007-07-03 13:30:00,152.17999,152.5,151.99001,152.34,148.6797260273973,156.94433463768118,143.23614995000034,147.16020009999997,151.18739980000004,151.20199799999997,150.30987962177338,151.23779655697314,151.25845923076938,154.0609903910749,148.45592807046378,143.23614995000034,147.16020009999997,151.18739980000004,151.20199799999997,152.27667,54047488,167395586.4,54.83042769328353,1.5,2.75,1.6777556099993736,0.32287283770344377,-0.031730141346610966,-0.030157666264756244,0.0015724750818547175,16.387849553482766,0.7939658594680542,4581052813.0,2007-07-03,2007,1,184,7,0.34,152.25,152.56,151.63,1884
2007-07-05 13:30:00,152.39999,152.56,151.63,152.17999,148.8346575342466,157.05998666666667,143.33724985000038,147.24259999999995,151.26859960000004,151.21899749999997,150.38321728366458,151.32752926583285,151.1899961538463,153.85213278565826,148.52785952203433,143.33724985000038,147.24259999999995,151.26859960000004,151.21899749999997,152.12333,89254432,163651401.6,54.11514515831067,1.5,2.75,1.6243444949994188,0.5453936301636906,0.04160047507372399,0.0535730689240097,0.011972593850285715,14.039816283099912,0.13158968285301612,4491798381.0,2007-07-05,2007,3,186,7,0.61,152.1,153.17,151.92999,1885
2007-07-06 13:30:00,152.38,153.17,151.92999,152.98,148.98958904109585,157.17563869565217,143.44144985000034,147.33789999999996,151.33859960000004,151.41299699999996,150.48505189999145,151.48490743099163,151.19691923076937,153.8771106600037,148.5167278015351,143.44144985000034,147.33789999999996,151.33859960000004,151.41299699999996,152.69332999999997,81106368,156082410.4,57.126603447194434,1.5,2.75,1.5968920310708878,0.5196381052300817,0.13632753652898566,0.1823820145115178,0.046054477982532135,14.003044929472125,1.6140817004317358,4572904749.0,2007-07-06,2007,4,187,7,0.82,152.55,153.36,152.62,1886
2007-07-09 13:30:00,153.16,153.36,152.62,153.0,149.1445205479452,157.2912907246377,143.54739985000032,147.42129999999997,151.40559980000003,151.51099749999997,150.58367731567802,151.62920196137335,151.17615000000012,153.79524928784434,148.55705071215593,143.54739985000032,147.42129999999997,151.40559980000003,151.51099749999997,152.99333333333334,72343568,150850472.8,57.20222540913434,1.5,2.75,1.5356854574229681,0.4795713706241694,0.18941059213720265,0.28281771815403545,0.0934071260168328,12.471135833303613,2.115731161983573,4645248317.0,2007-07-09,2007,0,190,7,0.48,152.99,152.61,150.77,1887
2007-07-10 13:30:00,152.28999,152.61,150.77,150.92,149.29945205479453,157.40694275362318,143.6394499000003,147.47439999999997,151.43339980000005,151.49199749999997,150.59686644055338,151.56165891743302,151.15922692307706,153.7818824435355,148.53657140261862,143.6394499000003,147.47439999999997,151.43339980000005,151.49199749999997,151.4333333333333,180356128,154741904.0,47.76602467553287,1.5,2.75,1.5852793533213263,1.1655286857527616,0.07916049109795346,0.19235773988927465,0.11319724879132115,14.937255878874275,1.7735586872721476,4464892189.0,2007-07-10,2007,1,191,7,1.22,151.69,152.05,150.52,1888
2007-07-11 13:30:00,150.75,152.05,150.52,151.99001,149.45438356164385,157.52259478260868,143.7400499500003,147.53630009999995,151.50740020000003,151.60899849999996,150.65149952131603,151.6024542586299,151.15999692307707,153.7836215914216,148.53637225473258,143.7400499500003,147.53630009999995,151.50740020000003,151.60899849999996,151.52000333333334,175533632,151731757.6,52.13990584153541,1.5,2.75,1.5813308280840892,1.1568681123614692,0.07316168066784184,0.20464934962612347,0.13148766895828162,13.495468645574729,1.0571942192283454,4640425821.0,2007-07-11,2007,2,192,7,1.02,151.29,154.75,152.34,1889
2007-07-12 13:30:00,152.37,154.75,152.34,154.39,149.60931506849315,157.63824681159417,143.8546499500003,147.62290009999995,151.62180020000002,151.73399849999996,150.79810738322522,151.8679348054271,151.4553815384617,154.55861149393812,148.3521515829852,143.8546499500003,147.62290009999995,151.62180020000002,151.73399849999996,153.82666666666668,133863120,148762382.4,60.191717684708884,1.5,2.75,1.6655207689352245,0.8998452286147307,0.21752949331861726,0.4033995356065532,0.18587004228793594,14.000178930411293,2.6665780023939294,4774288941.0,2007-07-12,2007,3,193,7,1.58,153.55,155.46001,154.39,1890
2007-07-13 13:30:00,154.57001,155.46001,154.39,154.85001,149.76424657534247,157.75389884057972,143.96650000000034,147.71100029999997,151.72800060000006,151.833499,150.95700552505951,152.15194196681497,151.84153615384628,155.27175277513697,148.4113195325556,143.96650000000034,147.71100029999997,151.72800060000006,151.833499,154.90000666666666,111793872,147019810.4,61.527729831822136,1.5,2.75,1.622984285439853,0.7604000555832576,0.3242754077653063,0.5912143019945688,0.2669388942292625,13.890140793491987,2.9382571919335985,4886082813.0,2007-07-13,2007,4,194,7,0.69,154.93,155.53,154.58,1891
2007-07-16 13:30:00,154.99001,155.53,154.58,154.83,149.91917808219182,157.86955086956522,144.0727500000003,147.79950029999995,151.81760040000006,151.92149849999996,151.1088876613317,152.4069951128326,152.34461384615398,155.44637799245302,149.2428496998549,144.0727500000003,147.79950029999995,151.81760040000006,151.92149849999996,154.98000000000005,98370368,144217510.4,61.431149185568955,1.5,2.75,1.5749139793370055,0.6820972552303884,0.3704720038161726,0.7300288989994783,0.3595568951833057,13.924117158462082,2.002773700690028,4787712445.0,2007-07-16,2007,0,197,7,0.61,155.06,156.0,154.67999,1892
2007-07-17 13:30:00,154.92999,156.0,154.67999,154.75,150.0741095890411,156.0,144.1777999500003,147.88830029999997,151.89420040000005,152.0144985,151.25167638049516,152.63013843541995,152.67923000000016,155.8080928897065,149.55036711029382,144.1777999500003,147.88830029999997,151.89420040000005,152.0144985,155.14333,126120752,146091764.0,61.01875725778296,1.5,2.75,1.556706552241505,0.8632981664866474,0.3716229559426303,0.8240855901115935,0.4524626341689633,13.458679634728515,1.5819876591834032,4661591693.0,2007-07-17,2007,1,198,7,0.85,155.34,154.8,153.3,1893
2007-07-18 13:30:00,154.23,154.8,153.3,154.47,150.2290410958904,156.05161322580645,144.2816999500003,147.98000029999994,151.96460040000005,152.07449849999998,151.3778851498875,152.80536334633234,152.99384538461553,155.95255697377144,150.0351337954596,144.2816999500003,147.98000029999994,151.96460040000005,152.07449849999998,154.19000000000003,237719120,152421848.0,59.51289475547354,1.5,2.75,1.5526560842242545,1.5596131599191738,0.33086929967235224,0.8660492587594035,0.5351799590870513,13.569647605730704,1.5048036210279652,4423872573.0,2007-07-18,2007,2,199,7,0.98,154.05,155.53,154.75,1894
2007-07-19 13:30:00,155.2,155.53,154.75,155.07001,150.3839726027397,156.1032264516129,144.3891500000003,148.07900039999996,152.0510006000001,152.270999,151.52267435969583,153.02104398001498,153.35077000000013,156.09815387973336,150.60338612026692,144.3891500000003,148.07900039999996,152.0510006000001,152.270999,155.11667,145213120,150820782.4,61.69446230155215,1.5,2.75,1.5174663639225223,0.96281903388402,0.3213930849643544,0.9369213152924942,0.6155282303281399,13.540197871932046,1.3661981958425982,4569085693.0,2007-07-19,2007,3,200,7,0.5,155.14,155.2484,152.28999,1895
2007-07-20 13:30:00,154.89,155.2484,152.28999,153.5,150.53890410958903,156.15483967741937,144.4912500000003,148.21900039999994,152.09780060000006,152.34699899999995,151.60021654166852,153.06665883906118,153.48230923076937,156.07773041063845,150.88688805090018,144.4912500000003,148.21900039999994,152.09780060000006,152.34699899999995,153.6794633333334,245501872,152832592.0,53.56175162690696,1.5,2.75,1.6203909093566293,1.606345013110816,0.19279959682715894,0.8565277263620885,0.6637281295349295,14.9531720033814,0.32679738562091504,4323583821.0,2007-07-20,2007,4,201,7,1.94,153.77,154.72,153.3,1896
2007-07-23 13:30:00,154.17999,154.72,153.3,153.97,150.69383561643838,156.2064529032258,144.59430000000032,148.34940049999994,152.1856006000001,152.51799899999997,151.693149226309,153.15269133057916,153.60769384615398,156.1266240868967,151.08876360541123,144.59430000000032,148.34940049999994,152.1856006000001,152.51799899999997,153.99666666666667,121181808,148634026.4,55.454835386281,1.5,2.75,1.6060772729740118,0.8153032716336345,0.12603603561259558,0.8212731740506741,0.6952371384380784,15.032134503709559,2.020938245428049,4444765629.0,2007-07-23,2007,0,204,7,0.93,154.01,154.28,150.75999,1897
2007-07-24 13:30:00,153.12,154.28,150.75999,151.3,150.8487671232877,156.25806612903224,144.6762000000003,148.45730059999994,152.1944006000001,152.59149899999997,151.677731609591,152.9762445371907,153.54000230769242,156.24889511591587,150.83110949946897,144.6762000000003,148.45730059999994,152.1944006000001,152.59149899999997,152.11333,256825632,149873486.4,44.38526219333379,1.5,2.75,1.742786753475869,1.713616185017232,-0.0991485950582991,0.5713013946152046,0.6704499896735037,16.44684708695446,-0.4539837848553341,4187939997.0,2007-07-24,2007,1,205,7,2.33,152.52,152.39,150.25,1898
2007-07-25 13:30:00,152.02,152.39,150.25,151.61,151.003698630137,156.30967935483872,144.7583500500003,148.58670059999994,152.2160006000001,152.75749950000002,151.67507546803841,152.84612600983914,153.43461769230782,156.32309640827307,150.5461389763426,144.7583500500003,148.58670059999994,152.2160006000001,152.75749950000002,151.41666666666666,265201056,153217626.4,45.73954694074374,1.5,2.75,1.7711591282275916,1.7308782431314311,-0.2214213146180584,0.3936733464009308,0.6150946610189891,15.931473004339399,-1.8006347561370382,4453141053.0,2007-07-25,2007,2,206,7,1.42,151.32,150.8,146.39,1899
2007-07-26 13:30:00,150.19,150.8,146.39,148.02,151.15863013698632,156.36129258064517,144.8234001000003,148.69340049999994,152.16500040000008,152.6385,151.53173917517415,152.38649496128306,153.05154076923088,157.14044599564355,148.96263554281822,144.8234001000003,148.69340049999994,152.16500040000008,152.6385,148.40333333333334,467454208,166131884.0,35.084547882969034,1.5,2.75,2.017504904782766,2.813753728333088,-0.5211653289469519,-0.0363620001647007,0.4848033287822512,17.58579272995533,-4.410726224686706,3985686845.0,2007-07-26,2007,3,207,7,3.01,148.6,148.87,145.05,1900
2007-07-27 13:30:00,148.21001,148.87,145.05,145.11,151.3135616438356,156.41290580645162,144.87350010000034,148.74750049999994,152.0352002000001,152.375,151.2799062663438,151.69349544116088,152.6046176923078,158.42937136820774,146.77986401640788,144.87350010000034,148.74750049999994,152.0352002000001,152.375,146.34333333333333,422916864,179392652.0,29.15572330174025,1.5,2.75,2.146254554441139,2.357492680357945,-0.8718479835105672,-0.6050066506059579,0.2668413329046094,18.99151776873763,-6.277853129238517,3562769981.0,2007-07-27,2007,4,208,7,2.63,146.96,147.81,145.28999,1901
2007-07-30 13:30:00,145.92999,147.81,145.28999,147.38,151.46849315068494,156.4645190322581,144.9340501000003,148.8257004999999,151.95680020000006,152.2225005,151.12696876570288,151.2826863515265,152.25000153846167,158.70813435747118,145.79186871945214,144.9340501000003,148.8257004999999,151.95680020000006,152.2225005,146.82666333333333,282213376,183518439.2,37.96263445431214,1.5,2.75,2.1858078005524857,1.5377930263042474,-0.903512010213414,-0.862548679862158,0.04096333035125591,22.669341485177654,-4.762520193861069,3844983357.0,2007-07-30,2007,0,211,7,1.73,146.55,149.46001,145.03999,1902
2007-07-31 13:30:00,148.33,149.46001,145.03999,145.72,151.62342465753426,156.51613225806454,144.9871001000003,148.87550039999994,151.81880020000008,151.91900099999995,150.914930774891,150.75290669900014,151.5830784615386,158.7691421534971,144.3970147695801,144.9871001000003,148.87550039999994,151.81880020000008,151.91900099999995,146.74,316607488,194181213.6,34.57747568048386,1.5,2.75,2.34539438622731,1.6304743498626482,-0.982305592959354,-1.1869186608479367,-0.20461306788858266,22.747568604098987,-5.6645303295138225,3528375869.0,2007-07-31,2007,1,212,7,3.05,147.25,147.00999,143.95,1903
2007-08-01 13:30:00,145.17999,147.00999,143.95,146.42999,151.77835616438355,156.56774548387097,145.03785005000034,148.9320002999999,151.69660020000006,151.62350049999995,150.73905074450312,150.34120034671443,150.93538461538475,158.34133432081057,143.52943490995892,145.03785005000034,148.9320002999999,151.69660020000006,151.62350049999995,145.79665999999997,467658496,214861764.0,37.158534100413206,1.5,2.75,2.396436930068216,2.1765552292496304,-0.9330224803565368,-1.3708911683342535,-0.4378686879777168,23.506049726482072,-5.571689845122209,3996034365.0,2007-08-01,2007,2,213,8,2.13,145.48,147.75999,145.25999,1904
2007-08-02 13:30:00,146.75999,147.75999,145.25999,147.60001,151.93328767123288,156.6193587096774,145.09270010000034,148.9981002999999,151.60020040000006,151.3945015,150.61595110746381,150.08013459940832,150.37923153846168,157.6157204772476,143.14274259967576,145.09270010000034,148.9981002999999,151.60020040000006,151.3945015,146.87332999999995,294674176,225132751.2,41.27052719439102,1.5,2.75,2.4038342922062013,1.308890751920061,-0.7745622917163322,-1.4060715526231322,-0.6315092609067998,24.19682206647,-3.843641693811077,4290708541.0,2007-08-02,2007,3,214,8,1.72,146.51,147.58,143.2,1905
2007-08-03 13:30:00,147.28,147.58,143.2,143.8,152.08821917808217,156.67097193548386,145.1275001000003,149.0536002999999,151.4274004000001,150.9355015,150.34865890717109,149.48202654232182,149.536923846154,157.08474902421548,141.9890986680925,145.1275001000003,149.0536002999999,151.4274004000001,150.9355015,144.86,359378688,239046367.2,33.584223813848716,1.5,2.75,2.5464182713343297,1.5033848546182802,-0.8713890914219489,-1.720745625184236,-0.849356533762287,27.00806293063808,-6.605182827823594,3931329853.0,2007-08-03,2007,4,215,8,3.06,145.39,146.83,142.53,1906
2007-08-06 13:30:00,144.21001,146.83,142.53,146.21001,152.24315068493152,156.7225851612903,145.1765001500003,149.1229003999999,151.3304006000001,150.596002,150.18635895002708,149.17040591924354,148.90154000000013,156.0620355172352,141.74104448276506,145.1765001500003,149.1229003999999,151.3304006000001,150.596002,145.19000333333338,324726272,251665502.4,41.07911842129969,1.5,2.75,2.671674109096164,1.2903090368098062,-0.7248539681884291,-1.7554239939978231,-1.0305700258093942,29.74509320180039,-3.3641705221414417,4256056125.0,2007-08-06,2007,0,218,8,3.02,144.68,149.0,145.23,1907
2007-08-07 13:30:00,145.94,149.0,145.23,147.77,152.39808219178082,156.77419838709676,145.2324001500003,149.2059003999999,151.2520006000001,150.438502,150.09159977551624,149.0370339269346,148.3400007692309,154.56074474652146,142.11925679194042,145.2324001500003,149.2059003999999,151.2520006000001,150.438502,147.33333333333334,280677376,256681564.8,45.3761104877656,1.5,2.75,2.750125958446439,1.0934847472146936,-0.4860601214401885,-1.63814517760963,-1.1520850561694411,29.857311475867487,-2.5328144581492005,4536733501.0,2007-08-07,2007,1,219,8,2.6,147.12,150.59,147.34,1908
2007-08-08 13:30:00,148.41,150.59,147.34,149.83,152.5530136986301,156.82581161290327,145.2975001500003,149.3189003999999,151.20380040000006,150.3305015,150.08134096079013,149.1125545053218,148.05769307692324,153.61372423417387,142.50166191967259,145.2975001500003,149.3189003999999,151.20380040000006,150.3305015,149.25333333333333,274739968,261641881.6,50.50888989985299,1.5,2.75,2.785831247128836,1.0500611229360612,-0.16894096275399215,-1.3632612596119316,-1.1943202968579394,31.227211573297463,1.2228077286853145,4811473469.0,2007-08-08,2007,2,220,8,2.21,148.96,149.95,145.28999,1909
2007-08-09 13:30:00,147.42999,149.95,145.28999,145.39,152.70794520547946,156.8774248387097,145.34025015000032,149.3708003999999,151.0420004000001,149.88050149999995,149.89736680546503,148.75802550481498,147.39769307692322,151.93215022927674,142.86323592456966,145.34025015000032,149.3708003999999,151.0420004000001,149.88050149999995,146.8766633333333,357626368,272830044.0,41.46505444047668,1.5,2.75,2.9197011580482055,1.3108027354934562,-0.2337826904588831,-1.4865486599315432,-1.25276596947266,33.00267034568225,0.19295706705256196,4453847101.0,2007-08-09,2007,3,221,8,3.21,147.62,146.5,143.12,1910
2007-08-10 13:30:00,144.39,146.5,143.12,144.71001,152.86287671232878,156.92903806451613,145.3764502000003,149.40820049999994,150.8698004000001,149.37350149999997,149.69394104838796,148.37250021864213,146.8907707692309,151.02242190044484,142.759119638017,145.3764502000003,149.40820049999994,150.8698004000001,149.37350149999997,144.77667,411013376,287791019.2,40.27564449190311,1.5,2.75,2.9525796467590477,1.4281660947674215,-0.2941430992575209,-1.6204448435445613,-1.3263017442870404,31.060513675377766,-1.8116365856968275,4042833725.0,2007-08-10,2007,4,222,8,2.36,144.81,146.89,145.02,1911
2007-08-13 13:30:00,146.5,146.89,145.02,145.23,153.01780821917808,156.98065129032258,145.41320020000032,149.4276005999999,150.6928004000001,148.8935015,149.51888453668647,148.07321448353338,146.40000153846162,149.578544300892,143.2214587760313,145.41320020000032,149.4276005999999,150.6928004000001,148.8935015,145.71333333333334,181944192,291969710.4,41.65392657366601,1.5,2.75,2.8973946719905417,0.6231611893943915,-0.2712801799630564,-1.665401969240861,-1.3941217892778046,29.561872549639464,-0.33626132308537543,4224777917.0,2007-08-13,2007,0,225,8,1.29,145.95,146.06,142.72,1912
2007-08-14 13:30:00,145.7,146.06,142.72,143.00999,153.1727397260274,157.03226451612903,145.4365001000003,149.4259005999999,150.47100000000006,148.30650099999997,149.2636337705419,147.59100262795874,146.01461615384628,149.512843590074,142.51638871761855,145.4365001000003,149.4259005999999,150.47100000000006,148.30650099999997,143.92999666666663,264096560,298868500.8,37.65824112118245,1.5,2.75,2.9290093382769316,0.8836547153449634,-0.37169509938815937,-1.858740663513004,-1.4870455641248443,30.144689189730094,-2.3355871293851864,3960681357.0,2007-08-14,2007,1,226,8,2.34,144.39,144.46001,140.62,1913
2007-08-15 13:30:00,142.72,144.46001,140.62,141.03999,153.32767123287672,157.08387774193545,145.4478000500003,149.40240049999994,150.22199960000006,147.6350005,148.941137936403,146.96709666339126,145.7015384615386,150.08425030316505,141.3188266199122,145.4478000500003,149.40240049999994,150.22199960000006,147.6350005,142.04,323735040,303169296.8,34.495966107072576,1.5,2.75,2.9940808141142945,1.067835837655972,-0.5273120413812737,-2.1461856158514365,-1.6188735744701628,30.525911314746583,-4.444457693464932,3636946317.0,2007-08-15,2007,2,227,8,2.73,142.54,142.94,137.0,1914
2007-08-16 13:30:00,139.78999,142.94,137.0,142.10001,137.0,157.1354909677419,145.4687501000003,149.3914005999999,150.02719980000006,146.98650049999998,148.67285840948526,146.50356460021112,145.29538538461549,149.95076506739997,140.64000570183106,145.4687501000003,149.3914005999999,150.02719980000006,146.98650049999998,140.68000333333333,546451200,323231200.8,37.53548931455354,1.5,2.75,3.20450361310613,1.6905892706135068,-0.514800195907658,-2.262373819354736,-1.7475736234470771,30.461106016640315,-1.1821905424200374,4183397517.0,2007-08-16,2007,3,228,8,4.34,139.97,148.35001,141.386,1915
2007-08-17 13:30:00,145.5,148.35001,141.386,144.71001,136.684,157.18710419354838,145.5032501500003,149.4099006999999,149.93939980000005,146.547001,148.51745258950544,146.33274987638148,145.21769384615396,149.87584531387736,140.55954237843056,145.5032501500003,149.4099006999999,149.93939980000005,146.547001,144.81534,388157184,330363966.4,44.37911775592678,1.5,2.75,3.47303978359855,1.1749380183007756,-0.2974749389164264,-2.1194172970926104,-1.821942358176184,29.183312391670707,-1.0259215494205902,4571554701.0,2007-08-17,2007,4,229,8,4.93,144.87,145.47,143.28999,1916
2007-08-20 13:30:00,145.17,145.47,143.28999,144.64,136.368,157.23871741935483,145.5375002000003,149.4381005999999,149.81140000000005,146.080501,148.36539562521108,146.1715356024404,145.0800023076924,149.6922709235663,140.46773369181855,145.5375002000003,149.4381005999999,149.81140000000005,146.080501,144.46666333333334,187079936,333658872.8,44.23910626555871,1.5,2.75,3.3806805133415114,0.5606922256556877,-0.13352312421471013,-1.988846263444572,-1.8553231392298613,27.351794057537138,-2.118156594708008,4384474765.0,2007-08-20,2007,0,232,8,1.52,144.38,145.97,144.14,1917
2007-08-21 13:30:00,144.60001,145.97,144.14,144.92999,136.05200000000002,157.29033064516128,145.57785015000027,149.46770049999995,149.68399980000004,145.7620005,148.23067383598715,146.05329316411274,144.87461615384623,149.25151356519768,140.49771874249478,145.57785015000027,149.46770049999995,149.68399980000004,145.7620005,145.01333,157000816,328667632.0,45.01294963473556,1.5,2.75,3.269917619531405,0.47768870650457,0.011659311014529994,-1.8407490004616989,-1.8524083114762289,26.438252502869343,-3.2703797637322354,4541475581.0,2007-08-21,2007,1,233,8,1.27,145.06,146.8,145.33,1918
2007-08-22 13:30:00,146.00999,146.8,145.33,146.64999,135.736,157.34194387096775,145.6272001000003,149.51420039999994,149.62399980000004,145.51399999999995,148.1686862345759,146.11012143419725,145.09384615384627,149.51871815351,140.66897415418254,145.6272001000003,149.51420039999994,149.62399980000004,145.51399999999995,146.25999666666667,172226192,324018888.8,49.490367772529815,1.5,2.75,3.1699242181363054,0.5315313333671305,0.2287000831640771,-1.5665332075211325,-1.7952332906852095,26.01492710297193,0.8666276910379093,4713701773.0,2007-08-22,2007,2,234,8,1.01,146.06,147.64999,145.61,1919
2007-08-23 13:30:00,147.34,147.64999,145.61,146.52,135.42,157.3935570967742,145.67710015000029,149.5578003999999,149.51659980000005,145.439,148.10403187243566,146.14915748808326,145.11769153846166,149.56962459913456,140.66575847778878,145.67710015000029,149.5578003999999,149.51659980000005,145.439,146.59333,203853744,310838865.6,49.1645420187346,1.5,2.75,3.0892146311265685,0.6558180670441874,0.3608193392121555,-1.3442091166700152,-1.705028455882171,19.010141090048133,1.2507704200974066,4509848029.0,2007-08-23,2007,3,235,8,1.4,146.63,148.33,146.28,1920
2007-08-24 13:30:00,146.48,148.33,146.28,148.33,135.10399999999998,157.44517032258062,145.7283501500003,149.60420039999994,149.42599980000006,145.59999999999997,148.11289336763426,146.35685677493245,145.16076846153857,149.72396954189634,140.5975673811808,145.7283501500003,149.60420039999994,149.42599980000006,145.59999999999997,147.64666666666668,128886256,296137335.2,53.73223172703933,1.5,2.75,3.0149850146175288,0.4352246092609535,0.5557687738215455,-1.0103174886052386,-1.5660862624267842,19.705055519652785,2.134545204158936,4638734285.0,2007-08-24,2007,4,236,8,1.4,147.3,148.33,146.73,1921
2007-08-27 13:30:00,147.85001,148.33,146.73,146.95,134.78799999999998,157.4967835483871,145.77005015000032,149.63520029999995,149.30359960000004,145.57849999999996,148.06728970615842,146.41334660589123,144.93923000000012,148.79970860299056,141.0787513970097,145.77005015000032,149.63520029999995,149.30359960000004,145.57849999999996,147.33666666666667,112992128,287676272.8,50.0404481091291,1.5,2.75,2.913914656430564,0.3927752779199661,0.5750343185950708,-0.8472933641829457,-1.4223276827780165,20.801572019869546,2.7550592794251654,4525742157.0,2007-08-27,2007,0,239,8,1.09,147.53,146.25,143.46001,1922
2007-08-28 13:30:00,146.16,146.25,143.46001,143.72,134.472,157.54839677419355,145.7941001500003,149.6300001999999,149.12019960000003,145.47849999999997,147.89680775689732,146.15683740533018,144.81076846153857,148.7136079140501,140.90792900902701,145.7941001500003,149.6300001999999,149.12019960000003,145.47849999999997,144.47666999999998,219626128,282827204.8,42.65351299018982,1.5,2.75,2.9550628952569507,0.7765381981387103,0.3638013754979952,-0.9675759634055224,-1.3313773389035175,23.03384646580669,1.9001773894056644,4306116029.0,2007-08-28,2007,1,240,8,1.94,144.86,146.74001,143.96001,1923
2007-08-29 13:30:00,144.37,146.74001,143.96001,146.53999,134.156,157.60001,145.8359001500003,149.6510000999999,148.98559940000004,145.48399999999995,147.8435992174111,146.19332812863206,144.95153615384623,148.96025584679867,140.94281646089382,145.8359001500003,149.6510000999999,148.98559940000004,145.48399999999995,145.74667,207614496,269825004.8,49.64282152353587,1.5,2.75,2.959701974167169,0.7694412760369939,0.4044366766203973,-0.8258314931280211,-1.2302681697484183,23.358647020109743,3.1245458744161887,4513730525.0,2007-08-29,2007,2,241,8,1.93,145.35,147.19,145.31,1924
2007-08-30 13:30:00,145.45,147.19,145.31,146.14999,133.84,157.65162322580645,145.8754500500003,149.6663999999999,148.88579919999998,145.41149899999994,147.77718316966948,146.18920068780997,145.02230461538468,149.08036790317462,140.96424132759478,145.8754500500003,149.6663999999999,148.88579919999998,145.41149899999994,146.21666333333334,191681632,264675377.6,48.757761200783605,1.5,2.75,2.8825804045838,0.7242140683357621,0.3950320884161482,-0.736478059228233,-1.1315101476443812,23.502018668697325,0.9950797460382951,4322048893.0,2007-08-30,2007,3,242,8,1.29,146.25,148.5,146.83,1925
2007-08-31 13:30:00,147.64999,148.5,146.83,147.59,133.524,157.70323645161292,145.9205000500003,149.70209999999992,148.79799920000005,145.60099899999994,147.76984265321187,146.32261014611382,145.37461307692317,149.4677847098869,141.2814414439594,145.9205000500003,149.70209999999992,148.79799920000005,145.60099899999994,147.64,185474624,255980174.4,52.14998193899818,1.5,2.75,2.8445396613992417,0.7245663631362851,0.4706430759963982,-0.5432063026488834,-1.0138493786452816,21.9356451173968,2.0395464601770037,4507523517.0,2007-08-31,2007,4,243,8,1.14,147.67,149.98,147.39999,1926
2007-09-04 13:30:00,147.45,149.98,147.39999,149.08,133.208,157.75484967741934,145.9678000500003,149.7462999999999,148.76859920000004,145.7444984999999,147.82122137269374,146.58521870362674,145.99307538461545,149.6900249565723,142.29612581265866,145.9678000500003,149.7462999999999,148.76859920000004,145.7444984999999,148.81999666666667,120054688,245746595.2,55.4372381295569,1.5,2.75,2.8256446855850093,0.4885304225773461,0.5976940807855433,-0.26673177766335243,-0.8644258584488957,22.332107683079165,2.863458418785517,4627578205.0,2007-09-04,2007,1,247,9,1.75,148.69,148.36,147.0,1927
2007-09-05 13:30:00,148.2,148.36,147.0,147.78999,132.892,157.8064629032258,146.0066500000003,149.7709997999999,148.72779900000003,145.74549799999994,147.81999661298025,146.69995882709088,146.43076615384624,149.46906829966468,143.39246400802782,146.0066500000003,149.7709997999999,148.72779900000003,145.74549799999994,147.71666333333334,166256624,240025557.6,52.10004720012046,1.5,2.75,2.7723843509003667,0.6926621717386648,0.5715504588886681,-0.14998778483806066,-0.7215382437267287,23.329295670663576,0.7773611167651537,4461321581.0,2007-09-05,2007,2,248,9,0.93,147.68,148.61,147.12,1928
2007-09-06 13:30:00,147.95,148.61,147.12,148.13,132.576,157.85807612903224,146.0454000000003,149.7852997999999,148.72459920000003,145.6604979999999,147.83215360854965,146.8361532245108,146.69384230769242,149.6824532985497,143.70523131683515,146.0454000000003,149.7852997999999,148.72459920000003,145.6604979999999,147.95333333333338,127860432,232681580.8,52.904757942429704,1.5,2.75,2.6807854686931982,0.5495081800647625,0.5534792939857099,-0.02968912624459108,-0.5831684202303011,22.48636466833365,1.0988260988260887,4589182013.0,2007-09-06,2007,3,249,9,1.01,147.86,146.89,145.25999,1929
2007-09-07 13:30:00,146.48,146.89,145.25999,146.07001,132.26,157.90968935483872,146.0736500500003,149.7750998999999,148.63799960000003,145.69449849999995,147.76304993762614,146.76318720312887,146.8038430769232,149.5796690635394,144.02801709030703,146.0736500500003,149.7750998999999,148.63799960000003,145.69449849999995,146.07333333333338,235429056,226571715.2,47.67855897684343,1.5,2.75,2.694301506643685,1.0390928796746823,0.38699122463172575,-0.09942938944064393,-0.4864206140723697,24.08875143271376,-1.5236230027641178,4353752957.0,2007-09-07,2007,4,250,9,1.12,146.07,146.72,144.33,1930
2007-09-10 13:30:00,146.52,146.72,144.33,145.78999,131.944,157.96130258064517,146.10010000000034,149.76029979999987,148.54619940000003,145.7484974999999,147.68567503811138,146.6705017552118,146.86999692307703,149.50126526894525,144.2387285772089,146.10010000000034,149.76029979999987,148.54619940000003,145.7484974999999,145.61333,192354688,215638780.8,46.99890545087421,1.5,2.75,2.672565684740564,0.892022702439616,0.2489173903694201,-0.17527387611059453,-0.42419126648001465,22.716695755111715,-0.7893909493024838,4161398269.0,2007-09-10,2007,0,253,9,1.66,145.52,147.7,146.13,1931
2007-09-11 13:30:00,146.24001,147.7,146.13,147.49001,131.628,158.01291580645162,146.13435005000034,149.7628998999999,148.48739980000005,145.8614979999999,147.6780018993619,146.7485501594773,146.934613846154,149.58230347835942,144.28692421394862,146.13435005000034,149.7628998999999,148.48739980000005,145.8614979999999,147.10667,162048256,214643984.0,51.5174595341502,1.5,2.75,2.6180974215448094,0.7549629529798515,0.26168530071765245,-0.09708464058294908,-0.3587699413006015,23.31553776665737,2.623163094906773,4323446525.0,2007-09-11,2007,1,254,9,1.07,146.92,148.44,146.98,1932
2007-09-12 13:30:00,147.28999,148.44,146.98,147.87,131.312,158.06452903225806,146.16910005000034,149.75539989999987,148.40900000000005,146.1044984999999,147.68553123664185,146.85535490619378,147.03846000000016,149.7186549739829,144.3582650260174,146.16910005000034,149.75539989999987,148.40900000000005,146.1044984999999,147.76333333333332,149577680,208918040.0,52.49240541408372,1.5,2.75,2.535376177148752,0.7159634467181484,0.2834909148360744,-0.004406297755508604,-0.28789721259158296,18.347899176416174,0.907608905937564,4473024205.0,2007-09-12,2007,2,255,9,0.99,147.71,149.45,148.2,1933
2007-09-13 13:30:00,148.55,149.45,148.2,148.91,130.996,158.11614225806449,146.21190000000038,149.7638998999999,148.34040000000005,146.49799899999994,147.7335496195186,147.05103539131818,147.08307538461548,149.86515573777177,144.30099503145928,146.21190000000038,149.7638998999999,148.34040000000005,146.49799899999994,148.85333333333332,153905248,200426550.4,55.15066276962328,1.5,2.75,2.4671350216381254,0.7678885242142051,0.35129226342114234,0.15121811668484494,-0.20007414673629734,15.39286534613901,1.8884777207305958,4626929453.0,2007-09-13,2007,3,256,9,0.84,148.82,149.09,147.74001,1934
2007-09-14 13:30:00,147.96001,149.09,147.74001,148.89999,130.68,158.16775548387096,146.26429995000038,149.77169979999988,148.27480000000006,146.8379979999999,147.7792923795375,147.22712630643073,147.23307461538474,150.17590834700619,144.29024088376332,146.26429995000038,149.77169979999988,148.27480000000006,146.8379979999999,148.57666666666668,121903056,179199143.2,55.118694559049494,1.5,2.75,2.3873389486639733,0.6802658418067705,0.3765587372425775,0.2706242748169245,-0.10593446242565298,15.200691881206241,0.8875872349075135,4505026397.0,2007-09-14,2007,4,257,9,0.91,148.42,148.8905,147.63,1935
2007-09-17 13:30:00,148.31,148.8905,147.63,148.10001,130.364,158.2193687096774,146.3097000000004,149.75789989999987,148.1772002000001,147.00749799999994,147.7918695411243,147.31025808677066,147.56999846153857,149.72406671281868,145.41593021025847,146.3097000000004,149.75789989999987,148.1772002000001,147.00749799999994,148.20683666666662,109853056,165283936.8,52.499587691209214,1.5,2.75,2.30752830947369,0.6646323782384641,0.3225683718728207,0.2972760024153729,-0.0252923694574478,14.792383966688215,-0.6573584652535651,4395173341.0,2007-09-17,2007,0,260,9,0.85,148.26,152.5,148.13409,1936
2007-09-18 13:30:00,148.83,152.5,148.13409,152.46001,130.048,158.2709819354839,146.3696500500004,149.78600009999985,148.16640040000004,147.3984984999999,147.9749338728449,147.80071064993538,148.02538461538472,151.31805399673286,144.73271523403662,146.3696500500004,149.78600009999985,148.16640040000004,147.3984984999999,151.03136666666668,263372816,169098580.8,62.858343745807886,1.5,2.75,2.4569898587969976,1.557510505138432,0.5502942897031984,0.6625754926715501,0.1122812029683518,21.710540505972677,3.1599027782598963,4658546157.0,2007-09-18,2007,1,261,9,2.95,150.32,154.39,148.10001,1937
2007-09-19 13:30:00,153.41,154.39,148.10001,153.36,129.732,158.3225951612903,146.43380005000034,149.8243000999999,148.21520040000004,147.81999899999994,148.18611293665492,148.3301667785129,148.58000076923088,152.73757629058187,144.42242524787991,146.43380005000034,149.8243000999999,148.21520040000004,147.81999899999994,151.95000333333334,193766752,170936877.6,64.5756509161694,1.5,2.75,2.73077558316864,1.1335573383610231,0.7205927601950598,1.0130221532121766,0.2924293930171168,20.61097049276481,3.530682508607317,4852312909.0,2007-09-19,2007,2,262,9,4.25,151.25,153.42999,152.11,1938
2007-09-20 13:30:00,153.34,153.42999,152.11,152.28,129.416,158.37420838709676,146.49410005000038,149.8642001999999,148.22100020000005,148.10149949999996,148.3466575273743,148.7063413710355,148.94077000000013,153.48780779461617,144.3937322053841,146.49410005000038,149.8642001999999,148.22100020000005,148.10149949999996,152.60666333333333,175178752,171084505.6,60.93464205222355,1.5,2.75,2.630005184370879,1.0239311350004567,0.7179687791778513,1.189890366989431,0.4719215878115797,21.522213045085483,4.251379184543087,4677134157.0,2007-09-20,2007,3,263,9,0.87,152.77,153.11771000000002,151.74001,1939
2007-09-21 13:30:00,152.71001,153.11771000000002,151.74001,151.97,129.1,158.42582161290326,146.54750010000038,149.8972001999999,148.17260020000003,148.37399949999994,148.4887493890459,149.01716600236549,149.16307769230784,153.9896045997769,144.33655078483878,146.54750010000038,149.8972001999999,148.17260020000003,148.37399949999994,152.27590666666666,141459312,167964784.0,59.89079789552619,1.5,2.75,2.540554814058672,0.842196254662525,0.654601114101933,1.290172980438996,0.6355718663370629,19.072876411591317,4.238981016460738,4535674845.0,2007-09-21,2007,4,264,9,0.91,152.43,152.82001,151.36,1940
2007-09-24 13:30:00,152.42,152.82001,151.36,151.69,128.784,158.47743483870968,146.5964501500003,149.9187002999999,148.10940000000005,148.54199949999997,148.61428862869116,149.27172162118782,149.4630784615386,154.3946061387455,144.53155078433167,146.5964501500003,149.9187002999999,148.10940000000005,148.54199949999997,151.95667,139314944,168486218.4,58.90919571517573,1.5,2.75,2.4633730416259083,0.8268625488955719,0.5569048839353714,1.3317029712562771,0.7747980873209057,19.064519239032578,2.8476437149878726,4396359901.0,2007-09-24,2007,0,267,9,0.96,152.09,151.66,150.47,1941
2007-09-25 13:30:00,150.81,151.66,150.47,151.39,128.468,158.52904806451613,146.64450015000034,149.9291001999999,148.04060000000004,148.76399949999995,148.72314005501698,149.4734624191699,149.71384769230784,154.68014356439238,144.74755182022332,146.64450015000034,149.9291001999999,148.04060000000004,148.76399949999995,151.17333333333332,142289568,169951090.4,57.815818546834976,1.5,2.75,2.3745606815097715,0.8372383352475389,0.4402679198884222,1.3251329871814337,0.8848650672930113,18.665810120274013,2.3804693311692584,4254070333.0,2007-09-25,2007,1,268,9,0.79,151.06,152.77,151.39,1942
2007-09-26 13:30:00,152.25,152.77,151.39,152.19,128.15200000000002,158.58066129032258,146.69965015000034,149.9418001999999,147.98940000000005,149.18749949999997,148.8590953469771,149.73218028401087,150.18461615384632,154.82991109639084,145.5393212113018,146.69965015000034,149.9418001999999,147.98940000000005,149.18749949999997,152.11666666666662,135546944,165747131.2,59.950520275134295,1.5,2.75,2.303520632830504,0.8177936053471797,0.3870695437299747,1.3687019969554797,0.9816324532255051,18.727789457669694,2.202672755355585,4389617277.0,2007-09-26,2007,2,269,9,0.91,152.08,153.10001,152.19,1943
2007-09-27 13:30:00,152.91,153.10001,152.19,153.09,127.836,158.63227451612903,146.7580001500003,149.9632001999999,147.9618,149.51499999999996,149.02501317650743,150.0519726379146,150.74615538461555,154.86591119690644,146.62639957232466,146.7580001500003,149.9632001999999,147.9618,149.51499999999996,152.79333666666662,102704064,160501609.6,62.264075022133646,1.5,2.75,2.2039841590568967,0.6398942929977943,0.381921548830243,1.4590343892633086,1.0771128404330657,18.64896216648736,2.8139760116840846,4492321341.0,2007-09-27,2007,3,270,9,0.6,152.65,153.19,151.98,1944
2007-09-28 13:30:00,152.85001,153.19,151.98,152.58,127.52,158.68388774193545,146.81175015000034,149.9815001999999,147.91199980000005,149.83650049999997,149.16442442448752,150.2927371485894,151.13769307692326,154.89690089920768,147.3784852546388,146.81175015000034,149.9815001999999,147.91199980000005,149.83650049999997,152.58333333333334,133367008,157585878.4,60.1438286753805,1.5,2.75,2.132985290552833,0.8463131935050342,0.3163070859647017,1.4724966978889429,1.156189611924241,18.922581213341786,3.024976163067116,4358954333.0,2007-09-28,2007,4,271,9,0.8,152.58,154.75,152.5,1945
2007-10-01 13:30:00,152.60001,154.75,152.5,154.3,127.204,158.7355009677419,146.8746501500003,150.0129001999999,147.9279998,150.17200049999997,149.3658195450959,150.67438122967613,151.63230846153868,155.23016386222412,148.03445306085325,146.8746501500003,150.0129001999999,147.9279998,150.17200049999997,153.85,148120256,155718160.0,64.53060524187538,1.5,2.75,2.141343484084774,0.9512073350982312,0.3578254934566356,1.6034714787450357,1.2456459852884,18.80699663687132,1.2068672958895907,4507074589.0,2007-10-01,2007,0,274,10,1.48,153.62,154.64999,153.81,1946
2007-10-02 13:30:00,154.61,154.64999,153.81,154.09,126.88799999999999,158.78711419354838,146.9357501500003,150.0580001999999,147.9303998,150.42250049999996,149.55108152371955,150.99967825542126,152.03077000000022,155.47862707775937,148.58291292224106,146.9357501500003,150.0580001999999,147.9303998,150.42250049999996,154.18332999999996,112689008,155349876.0,63.610047177937574,1.5,2.75,2.0483896637930044,0.7253884644233639,0.3403325972050921,1.6710617317947651,1.3307291345896728,10.216095835829993,0.476004173187265,4394385581.0,2007-10-02,2007,1,275,10,0.55,154.23,154.41,153.00999,1947
2007-10-03 13:30:00,153.81,154.41,153.00999,153.78,126.572,158.83872741935485,146.98905015000034,150.0872001999999,147.9799998,150.722001,149.71692146396583,151.264470802524,152.4061553846156,155.44747203506194,149.36483873416927,146.98905015000034,150.0872001999999,147.9799998,150.722001,153.73333,119037872,152988938.4,62.19946249895279,1.5,2.75,2.002076830664933,0.7780815609607498,0.2796121123201725,1.6802442749898887,1.4006321626697162,9.851870243509172,0.9850275807722616,4275347709.0,2007-10-03,2007,2,276,10,0.91,153.71,154.25999,153.59,1948
2007-10-04 13:30:00,154.11,154.25999,153.59,154.02,126.256,158.89034064516127,147.04745015000034,150.1221001999999,148.0281998,151.016501,149.88566964184955,151.52690215466455,152.86153923076944,154.73663604473091,150.986442416808,147.04745015000034,150.1221001999999,148.0281998,151.016501,153.95666333333338,76764944,150434164.0,62.88566044343789,1.5,2.75,1.906927771331723,0.5102892983803865,0.2294429030269893,1.6874357914534528,1.4579928884264637,8.676321109281734,1.3489504507468657,4352112653.0,2007-10-04,2007,3,277,10,0.44,153.92,156.10001,154.63,1949
2007-10-05 13:30:00,155.03,156.10001,154.63,155.85001,125.94,158.94195387096775,147.1169502000003,150.1749001999999,148.18480000000002,151.505501,150.11956534216915,151.93862671136316,153.1223084615387,155.56000506181445,150.6846118612629,147.1169502000003,150.1749001999999,148.18480000000002,151.505501,155.52667333333332,134583008,145391861.6,67.70042591773162,1.5,2.75,1.9192907876651704,0.9256570933128488,0.2894647585735217,1.8198238366433657,1.530359078069844,10.30523957567649,2.7424418221372533,4486695661.0,2007-10-05,2007,4,278,10,0.95,155.37,155.49001,154.77,1950
2007-10-08 13:30:00,155.39,155.49001,154.77,155.02,125.624,158.9935670967742,147.1809502000003,150.20910009999992,148.38300000000004,151.96700149999998,150.3117392503194,152.23209083409046,153.250000769231,155.8896657829859,150.6103357554761,147.1809502000003,150.20910009999992,148.38300000000004,151.96700149999998,155.0933366666667,71270128,139337633.6,63.66622917535521,1.5,2.75,1.8593421599748,0.5114923094258722,0.2449897831110026,1.836596306958597,1.5916065238475947,11.015992169980365,2.3977805667481498,4415425533.0,2007-10-08,2007,0,281,10,0.47,155.13,156.5,155.03,1951
2007-10-09 13:30:00,155.60001,156.5,155.03,156.48,125.308,159.04518032258062,147.25265020000032,150.2609000999999,148.56500000000003,152.416501,150.55363182873825,152.63665361179616,153.57307769230792,156.65056530209344,150.4955900825224,147.25265020000032,150.2609000999999,148.56500000000003,152.416501,156.00333333333333,94001120,135935276.8,67.35160455236283,1.5,2.75,1.832246291405171,0.6915138013681522,0.2829343771642645,1.9452744953029253,1.6623401181386608,11.37066956620492,2.8188448649714117,4509426653.0,2007-10-09,2007,1,282,10,0.95,155.76,156.44,155.41,1952
2007-10-10 13:30:00,156.03999,156.44,155.41,156.22,124.992,159.0967935483871,147.3256502000003,150.2969000999999,148.775,152.834001,150.77584234525833,152.977924696387,153.90000076923099,157.12621259883258,150.6737889396294,147.3256502000003,150.2969000999999,148.775,152.834001,156.02333333333334,101668560,133539820.8,66.06644406369189,1.5,2.75,1.7778001277333726,0.7613351537461401,0.26013759589317065,1.987512113005124,1.7273745171119534,11.62520645999122,2.044548958129202,4407758093.0,2007-10-10,2007,2,283,10,0.66,155.93,157.52,154.53999,1953
2007-10-11 13:30:00,156.92999,157.52,154.53999,155.47,124.676,157.52,147.3992502000003,150.3262001999999,148.95580020000003,153.162001,150.95992695916976,153.215265201493,154.19077000000019,157.24460116217912,151.1369388378213,147.3992502000003,150.3262001999999,148.95580020000003,153.162001,155.84333,233513568,137520236.8,62.369408385823924,1.5,2.75,1.8636722614667047,1.6980305839612981,0.16860078079679466,1.9381254931079468,1.7695247123111522,12.13073597479832,1.8940883470965961,4174244525.0,2007-10-11,2007,3,284,10,1.93,156.03,156.35001,155.27,1954
2007-10-12 13:30:00,155.46001,156.35001,155.27,156.33,124.36,157.54491803278688,147.47300020000034,150.3653001999999,149.13040000000004,153.5335015,151.17051805881016,153.5119066108746,154.57077000000024,157.35334865425258,151.78819134574786,147.47300020000034,150.3653001999999,149.13040000000004,153.5335015,155.98333666666667,124539376,137652052.8,64.80170328371375,1.5,2.75,1.8076963856476536,0.9047404195340848,0.14113971878180154,1.945949360788404,1.8048096420066029,11.88975989521018,1.3156189241736882,4298783901.0,2007-10-12,2007,4,285,10,0.7,155.81,156.36,153.94,1955
2007-10-15 13:30:00,156.27,156.36,153.94,155.00999,124.044,157.56983606557378,147.53550020000034,150.3910000999999,149.35459980000005,153.87900050000005,151.32108558591563,153.65458121936277,154.78769230769254,157.21047186654957,152.3649127488355,147.53550020000034,150.3910000999999,149.35459980000005,153.87900050000005,155.10333,161094752,140214137.6,58.54652413442043,1.5,2.75,1.8514323581013936,1.1489194653078978,0.01583482042481177,1.8246031675376173,1.808768347112805,11.937105377201906,0.5970471802193421,4137689149.0,2007-10-15,2007,0,288,10,1.57,155.15,156.48,153.47,1956
2007-10-16 13:30:00,154.41,156.48,153.47,153.78,123.728,157.59475409836062,147.5933501500003,150.4182000999999,149.50599960000002,153.94500000000005,151.41751360215426,153.66652586513771,154.84076923076947,157.13951197132138,152.54202649021758,147.5933501500003,150.4182000999999,149.50599960000002,153.94500000000005,154.57666666666668,166428752,135366934.4,53.3762840580513,1.5,2.75,1.9341871896655791,1.2294638475612845,-0.15851923383478586,1.6106193048193234,1.7691385386541092,12.868714395736545,0.0,3971260397.0,2007-10-16,2007,1,289,10,1.96,154.98,155.09,152.47,1957
2007-10-17 13:30:00,154.98,155.09,152.47,154.25,123.412,157.61967213114755,147.65650015000034,150.4438000999999,149.6355996,153.98950000000005,151.528591500109,153.7220948303627,154.96923076923105,156.90648569535554,153.0319758431065,147.65650015000034,150.4438000999999,149.6355996,153.98950000000005,153.93666666666667,216672560,136512224.8,55.011198309610116,1.5,2.75,1.983173818975181,1.5872026136665818,-0.2456257334309082,1.462106371865474,1.7077321052963816,12.935638733687568,0.14933125568107372,4187932957.0,2007-10-17,2007,2,290,10,1.72,153.78,154.19,153.08,1958
2007-10-18 13:30:00,153.45,154.19,153.08,153.69,123.096,157.6445901639344,147.71810015000034,150.4582999999999,149.7127996,154.06,151.61335261775181,153.71903817985196,154.92230769230792,156.94958685186919,152.8950285327466,147.71810015000034,150.4582999999999,149.7127996,154.06,153.65333333333334,148428368,135174705.6,52.642553739299295,1.5,2.75,1.9250899747626675,1.0980483910889316,-0.3386532523852415,1.2844155398148305,1.6230687922000715,13.093641038956804,-1.3859543544463038,4039504589.0,2007-10-18,2007,3,291,10,0.73,153.64,156.48,149.66,1959
2007-10-19 13:30:00,153.09,156.48,149.66,149.67,122.78,157.6695081967213,147.7581001500003,150.4201999999999,149.79839959999995,153.94500000000005,151.53714271117332,153.33341549605655,154.58230769230792,158.0352104876144,151.1294048970014,147.7581001500003,150.4201999999999,149.79839959999995,153.94500000000005,151.9366666666666,297148672,142959173.6,39.495711690543494,1.5,2.75,2.2747264051367617,2.0785561675910533,-0.6505525528442255,0.8098781011447898,1.4604306539890153,17.814228911869495,-3.4511675912785598,3742355917.0,2007-10-19,2007,4,292,10,4.56,153.07,150.75999,148.66,1960
2007-10-22 13:30:00,148.86,150.75999,148.66,150.53999,122.464,157.6944262295082,147.80810015000034,150.3923997999999,149.91499919999998,153.88749950000005,151.49803868328414,153.0673749726226,154.3330761538464,158.39556381860345,150.27058848908936,147.80810015000034,150.3923997999999,149.91499919999998,153.88749950000005,149.98666,261945376,149090695.2,42.82363948201945,1.5,2.75,2.2622452333412784,1.7569532132680004,-0.769735690227157,0.498261041205069,1.2679967314322258,18.643103992850737,-3.7960186605316975,4004301293.0,2007-10-22,2007,0,295,10,1.41,149.71,151.95,150.25,1961
2007-10-23 13:30:00,151.46001,151.95,150.25,151.75999,122.148,157.7193442622951,147.86095010000034,150.3691996999999,150.045599,153.90599900000004,151.50831128393963,152.9428621180871,154.15922923076945,158.44757585416687,149.87088260737204,147.86095010000034,150.3691996999999,150.045599,153.90599900000004,151.3199966666666,179986432,150975538.4,47.20874434164978,1.5,2.75,2.222084859531186,1.192156251982606,-0.7377890892717283,0.3457603698425657,1.083549459114294,18.34177316817611,-2.854954551273852,4184287725.0,2007-10-23,2007,1,296,10,1.13,151.1,151.74001,148.0,1962
2007-10-24 13:30:00,151.21001,151.74001,148.0,151.48,121.83200000000001,157.74426229508197,147.9130000500003,150.3429995999999,150.2149992,153.87049900000005,151.50720103751067,152.80354191636454,153.82307461538485,158.2124940656463,149.43365516512335,147.9130000500003,150.3429995999999,150.2149992,153.87049900000005,150.40667,326582016,160527292.0,46.33053477870661,1.5,2.75,2.3319352267075293,2.0344329735531823,-0.7068362767827688,0.200004113135833,0.9068403899186018,18.336956874574078,-2.5664115263394924,3857705709.0,2007-10-24,2007,2,297,10,2.53,149.87,152.28999,149.88,1963
2007-10-25 13:30:00,151.64999,152.28999,149.88,151.84,121.516,157.7691803278689,147.9645001000003,150.3264994999999,150.4309994,153.80799900000005,151.52025197721613,152.7117760195679,153.57845923076945,158.02782695557474,149.12909150596417,147.9645001000003,150.3264994999999,150.4309994,153.80799900000005,151.33666333333338,237346064,167259392.0,47.67826362674654,1.5,2.75,2.3375105676569907,1.41902981448121,-0.6356752597097416,0.1122463152814248,0.7479215749911664,18.550630830736374,-2.8721294697115134,4095051773.0,2007-10-25,2007,3,298,10,1.61,151.08,153.62,151.89999,1964
2007-10-26 13:30:00,153.06,153.62,151.89999,153.62,121.2,157.79409836065574,148.0218001000003,150.3442994999999,150.66139919999998,153.85999900000004,151.6025950369331,152.7982735415138,153.35845923076945,157.48318484548494,149.23373361605397,148.0218001000003,150.3442994999999,150.66139919999998,153.85999900000004,153.04666333333333,176488496,169415466.4,53.84927027051742,1.5,2.75,2.29768838425292,1.0417496097038752,-0.4509729819469036,0.18420534755753687,0.6351783295044405,19.794156016291087,-0.8967099475330482,4271540269.0,2007-10-26,2007,4,299,10,1.13,152.76,154.44,153.55,1965
2007-10-29 13:30:00,153.92999,154.44,153.55,154.13,120.884,157.81901639344264,148.07625005000034,150.3945993999999,150.849799,153.85149900000005,151.70170895705343,152.92510463279822,153.19769000000022,157.01523155412127,149.38014844587914,148.07625005000034,150.3945993999999,150.849799,153.85149900000005,154.04,106819248,167350416.0,55.469822919408344,1.5,2.75,2.1971392139491392,0.6382968776127811,-0.2848082146499331,0.2791680611920242,0.5639762758419573,19.482096250923085,0.22759786708284194,4378359517.0,2007-10-29,2007,0,302,10,0.58,154.0,153.75,152.87,1966
2007-10-30 13:30:00,153.45,153.75,152.87,153.06,120.568,157.8439344262295,148.1267500000003,150.4147994999999,151.018199,153.79999899999999,151.7549752724631,152.93795181062697,153.01230538461564,156.5974484590481,149.42716231018315,148.1267500000003,150.4147994999999,151.018199,153.79999899999999,153.22666666666666,132970816,168364506.4,51.39243481721482,1.5,2.75,2.1302006986670565,0.7897793830968639,-0.2391558047576423,0.2650315198949045,0.5041873246525468,19.351481818510717,-0.7714748784440828,4245388701.0,2007-10-30,2007,1,303,10,0.58,153.31,155.27,152.84,1967
2007-10-31 13:30:00,153.98,155.27,152.84,154.64999,120.25200000000001,157.8688524590164,148.18489995000039,150.4482993999999,151.212599,153.8434985,151.86850526177827,153.10100306675773,152.8830738461541,156.0807108761151,149.68543681619312,148.18489995000039,150.4482993999999,151.212599,153.8434985,154.25333,220927568,173458991.2,56.50838287619649,1.5,2.75,2.1516149344765534,1.2736587851203878,-0.10113194850418827,0.37777238902231147,0.4789043375264998,20.26381071830749,0.6246274969093661,4466316269.0,2007-10-31,2007,2,304,10,1.59,154.06,153.41,150.59,1968
2007-11-01 13:30:00,153.28999,153.41,150.59,151.03,119.936,157.89377049180328,148.22735000000034,150.46209949999994,151.30019919999998,153.69399850000005,151.83562270249286,152.90376467944745,152.57692076923104,155.6614974158749,149.49234412258718,148.22735000000034,150.46209949999994,151.30019919999998,153.69399850000005,151.67666666666662,332966400,186269064.0,44.91709734819747,1.5,2.75,2.2879274391567987,1.7875560914398538,-0.2447051497915017,0.17302290028712264,0.4177280500786244,24.48849247045052,0.908665731275482,4133349869.0,2007-11-01,2007,3,305,11,1.87,152.0,152.0,149.21001,1969
2007-11-02 13:30:00,151.53,152.0,149.21001,151.2,119.62,157.91868852459018,148.2692499500003,150.45519949999994,151.3937992,153.461498,151.8106963220029,152.74150137664296,152.3784592307695,155.4598661491577,149.2970523123813,148.2692499500003,150.45519949999994,151.3937992,153.461498,150.80333666666667,331219456,196100886.4,45.482658574888326,1.5,2.75,2.323789050645598,1.6890257972847185,-0.3148255466214224,0.0241961168018463,0.3390216634232687,18.73728997802096,0.43842835382146617,4464569325.0,2007-11-02,2007,4,306,11,1.87,150.61,151.16,148.0,1970
2007-11-05 14:30:00,149.64,151.16,148.0,150.05,119.304,157.94360655737702,148.30759995000034,150.42709949999994,151.4281992,153.21299800000003,151.74164940741457,152.48516791220078,152.05538230769255,155.16472838787908,148.946036227506,148.30759995000034,150.42709949999994,151.4281992,153.21299800000003,149.73666666666662,226765936,203875676.8,42.317357991425006,1.5,2.75,2.3863755470280545,1.1122755767597283,-0.41875308670035,-0.1844196949521688,0.2343333917481812,19.065384519416085,-1.1267726098294923,4237803389.0,2007-11-05,2007,0,309,11,2.14,149.58,152.11,149.89999,1971
2007-11-06 14:30:00,150.86,152.11,149.89999,152.07001,118.988,157.96852459016398,148.35395000000034,150.4170994999999,151.5305994,152.9924985,151.7545262933983,152.44562906341974,151.93076769230794,154.89452164967423,148.96701373494162,148.35395000000034,150.4170994999999,151.5305994,152.9924985,151.36,177729632,208062102.4,49.027687067331094,1.5,2.75,2.373778007954623,0.8542143424962334,-0.33516518036322035,-0.18462308370584424,0.1505420966573761,20.1299642620792,0.38949696329548894,4415533021.0,2007-11-06,2007,1,310,11,1.47,151.0,152.10719,147.55,1972
2007-11-07 14:30:00,150.44,152.10719,147.55,147.91,118.67200000000001,157.99344262295082,148.3737500000003,150.36729949999994,151.6143994,152.5769985,151.60376055640228,152.0136643907131,151.79538307692332,155.2756437786198,148.31512237522682,148.3737500000003,150.36729949999994,151.6143994,152.5769985,149.18906333333334,306449152,218301132.0,38.97264126668435,1.5,2.75,2.529736007386435,1.4037909432370694,-0.532058570666505,-0.5145311166757551,0.01752745399074987,25.77152427462291,-2.5882507903055894,4109083869.0,2007-11-07,2007,2,311,11,3.09,149.83,149.3,145.07001,1973
2007-11-08 14:30:00,147.99001,149.3,145.07001,147.16,118.35600000000001,158.01836065573772,148.39825005000034,150.3061994999999,151.6267996,152.16149850000005,151.42949543654336,151.55141063921658,151.53538384615402,155.77427582711962,147.29649186518847,148.39825005000034,150.3061994999999,151.6267996,152.16149850000005,147.17666999999997,374404352,225345671.2,37.48020373258285,1.5,2.75,2.651182721144548,1.6614668034501832,-0.6755991861059198,-0.8269715286416499,-0.1513723425357301,25.622924133022384,-4.2051816169769625,3734679517.0,2007-11-08,2007,3,312,11,2.92,147.19,147.53999,144.89,1974
2007-11-09 14:30:00,145.69,147.53999,144.89,145.14,118.04,158.0432786885246,148.4131500500003,150.2461994999999,151.60659980000003,151.6019985,151.1828485566789,150.9408001021484,151.0261538461541,156.45757400589946,145.5947336864087,148.4131500500003,150.2461994999999,151.60659980000003,151.6019985,145.85666333333333,277731328,233005268.8,33.73332014393491,1.5,2.75,2.65109752677708,1.1919529950131325,-0.857683285468323,-1.223476449371134,-0.3657931639028109,24.387920132784423,-5.83273859728801,3456948189.0,2007-11-09,2007,4,313,11,1.83,146.21,146.61,143.7,1975
2007-11-12 14:30:00,145.21001,146.61,143.7,143.7,117.724,158.0681967213115,148.4214000500003,150.16339949999994,151.5287998,151.036499,150.88940351524053,150.25120009241994,150.42769230769252,157.0999443590528,143.75544025633224,148.4214000500003,150.16339949999994,151.5287998,151.036499,144.67,243016816,237101372.0,31.328905902390844,1.5,2.75,2.6695905605787194,1.0249490078868038,-1.0154114657606987,-1.635057496103684,-0.6196460303429855,23.781024947666225,-6.115248921991385,3213931373.0,2007-11-12,2007,0,316,11,2.03,145.16,148.31,145.22,1976
2007-11-13 14:30:00,145.37,148.31,145.22,148.08,117.40799999999999,158.09311475409837,148.44785010000038,150.13869949999994,151.50879980000002,150.751499,150.77923082836838,150.04441913123708,150.13846153846174,156.8664997170667,143.41042335985682,148.44785010000038,150.13869949999994,151.50879980000002,150.751499,147.20333333333338,191073376,238333603.2,44.32727790471804,1.5,2.75,2.8081912348230973,0.8017055649498946,-0.7758723244422462,-1.5894864358957932,-0.813614111453547,31.876859479213863,-4.248296427306585,3405004749.0,2007-11-13,2007,1,317,11,2.13,146.76,149.39999,146.78,1977
2007-11-14 14:30:00,149.22,149.39999,146.78,147.67,117.09200000000001,158.1180327868853,148.4674501000003,150.11709949999994,151.5064,150.422499,150.65730020764803,149.81828397588114,149.68076923076944,156.20563387913273,143.15590458240612,148.4674501000003,150.11709949999994,151.5064,150.422499,147.94999666666664,230524880,239026219.2,43.49729026017644,1.5,2.75,2.7947482894785907,0.9644334448812636,-0.6038089996090771,-1.5683753609648932,-0.9645663613558162,30.69264580254564,-2.2247235648546737,3174479869.0,2007-11-14,2007,2,318,11,1.78,148.09,147.49001,144.52,1978
2007-11-15 14:30:00,146.57001,147.49001,144.52,145.53999,116.77600000000001,158.14295081967214,148.47210005000034,150.08959949999996,151.45459979999995,150.01499850000002,150.45662137597557,149.41082740674963,149.0199992307694,155.3455133296871,142.69448513185168,148.47210005000034,150.08959949999996,151.45459979999995,150.01499850000002,145.85,263051680,244757384.8,39.37272218155033,1.5,2.75,2.820123411658689,1.0747446097078903,-0.5914488702289005,-1.7038774491419415,-1.1124285789130413,29.019413214416204,-3.7433928571428567,2911428189.0,2007-11-15,2007,3,319,11,2.06,146.01,146.47,144.57001,1979
2007-11-16 14:30:00,146.31,146.47,144.57001,145.78999,116.46,158.16786885245904,148.47700000000034,150.04349949999994,151.4489994,149.82099799999997,150.27361622397655,149.06598574896395,148.46076769230788,154.53935944569764,142.38217593891812,148.47700000000034,150.04349949999994,151.4489994,149.82099799999997,145.61,308757248,245337813.6,40.09076950001037,1.5,2.75,2.754399596540212,1.2584984086611262,-0.5266008385241308,-1.7706796270682048,-1.244078788544074,29.05727221924385,-2.8390603132289383,3220185437.0,2007-11-16,2007,4,320,11,1.31,145.52,145.36,143.19,1980
2007-11-19 14:30:00,145.28,145.36,143.19,143.75999,116.144,158.1927868852459,148.4715499000003,149.97729939999996,151.40839939999995,149.48199799999998,150.01817990146762,148.56065282049119,147.6230753846156,153.02260588975926,142.22354487947194,148.4715499000003,149.97729939999996,151.40839939999995,149.48199799999998,144.10333,267712624,245626176.0,36.328317303601374,1.5,2.75,2.743370339644481,1.0899189506577671,-0.5765578911530826,-1.9647761524854277,-1.3882182613323448,29.60296956600017,-5.464601468757718,2952472813.0,2007-11-19,2007,0,323,11,1.52,144.28,145.53,142.11,1981
2007-11-20 14:30:00,144.02,145.53,142.11,144.64,115.82799999999999,158.2177049180328,148.4702999000003,149.91939949999994,151.35139919999997,149.12599849999995,149.80727088572382,148.18725731377776,147.13153692307714,152.36175074700242,141.90132309915188,148.4702999000003,149.91939949999994,151.35139919999997,149.12599849999995,144.09333333333333,414724608,257363084.8,39.00087126773706,1.5,2.75,2.7917010296698748,1.61143781876211,-0.5088295833037901,-2.0242552404620824,-1.5154256571582922,28.284353813740516,-2.210803867216557,3367197421.0,2007-11-20,2007,1,324,11,2.41,143.82,143.91,141.67,1982
2007-11-21 14:30:00,143.08,143.91,141.67,141.67999,115.512,158.24262295081968,148.4526498000004,149.81829949999997,151.22759899999997,148.63599799999997,149.4885539882445,147.56751756960844,146.39922846153866,151.80861011999457,140.98984680308274,148.4526498000004,149.81829949999997,151.22759899999997,148.63599799999997,142.41999666666666,259160320,253992000.0,33.8536183956748,1.5,2.75,2.8044366704077404,1.0203483574285803,-0.6147901811312952,-2.2839133835724112,-1.669123202441116,26.443214014257123,-3.723844794781186,3108037101.0,2007-11-21,2007,2,325,11,1.58,142.79,144.34,142.7,1983
2007-11-23 14:30:00,143.07001,144.34,142.7,144.13,115.196,158.26754098360658,148.44819980000034,149.73619949999994,151.13199899999995,148.25049799999996,149.27841461615645,147.24013494393145,145.943843846154,151.03455848009557,140.8531292122125,148.44819980000034,149.73619949999994,151.13199899999995,148.25049799999996,143.72333333333333,77684624,246008928.0,40.816101104528215,1.5,2.75,2.79412047966433,0.3157796939792364,-0.4774049217051677,-2.265879354572576,-1.788474432867408,29.13578109745089,-0.6958798401543276,3185721725.0,2007-11-23,2007,4,327,11,1.15,143.52,144.88,140.66,1984
2007-11-26 14:30:00,144.42999,144.88,140.66,140.95,140.66,158.29245901639342,148.43324980000037,149.62389959999996,150.97299919999998,147.61699799999997,148.95181012140526,146.64107447308083,145.08845846153866,149.46045469308862,140.71646222998868,148.43324980000037,149.62389959999996,150.97299919999998,147.61699799999997,142.16333333333333,214165440,247892775.2,35.58105190876307,1.5,2.75,2.895969016831164,0.8639438556739352,-0.5529031387470542,-2.479603356301226,-1.926700217554172,30.74611345875605,-1.913709116214336,2971556285.0,2007-11-26,2007,0,330,11,3.0,142.77,143.23,140.95,1985
2007-11-27 14:30:00,141.74001,143.23,140.95,142.57001,140.71228571428568,158.31737704918038,148.42884985000038,149.51979969999994,150.86239919999997,147.03899849999996,148.70154344997758,146.25335404707315,144.67769000000018,148.91342179333253,140.44195820666783,148.42884985000038,149.51979969999994,150.86239919999997,147.03899849999996,142.25000333333332,293832192,257243422.4,39.81597691766755,1.5,2.75,2.851971229914652,1.1422340336582304,-0.450289250713114,-2.4895617809455644,-2.0392725302324504,31.396648427667664,-3.720954889249066,3265388477.0,2007-11-27,2007,1,331,11,1.62,142.09,147.47,144.14,1986
2007-11-28 14:30:00,144.19,147.47,144.14,147.13,140.76457142857143,158.34229508196722,148.44119985000034,149.46109969999995,150.755799,146.74249849999995,148.6399142950765,146.3368441378281,144.67538230769247,148.90573125131874,140.4450333640662,148.44119985000034,149.46109969999995,150.755799,146.74249849999995,146.24666666666667,259068752,263548319.2,49.81652313024141,1.5,2.75,2.9982582849207486,0.9830028618144948,-0.052768379837552,-2.1052330050293904,-2.0524646251918384,31.9257958128455,-0.3656802329518468,3524457229.0,2007-11-28,2007,2,332,11,2.31,145.8,147.72,146.10001,1987
2007-11-29 14:30:00,146.62,147.72,146.10001,147.17999,140.81685714285715,158.36721311475412,148.44904980000038,149.42369959999994,150.63219880000003,146.36899849999998,148.58266236193626,146.41714374374922,144.83230461538474,149.26638902367702,140.39822020709252,148.44904980000038,149.42369959999994,150.63219880000003,146.36899849999998,147.0,199180560,262460968.8,49.914778441285655,1.5,2.75,2.8998105502835516,0.7588959261663748,0.2210583796560457,-1.7761416506217813,-1.9972000302778268,31.89986502040955,1.1268380601098125,3723637789.0,2007-11-29,2007,3,333,11,1.11,146.91,149.87,147.33,1988
2007-11-30 14:30:00,149.03999,149.87,147.33,148.66,140.86914285714286,158.39213114754102,148.46334980000037,149.39039949999994,150.55979879999995,146.25049849999996,148.58569521048776,146.6307491014874,145.21384307692327,150.02969182233375,140.3979943315127,148.46334980000037,149.39039949999994,150.55979879999995,146.25049849999996,148.62,222886496,256956973.6,52.85765895503566,1.5,2.75,2.8848247966918703,0.8674078499498642,0.4937583141284359,-1.3800021376172822,-1.873760451745718,31.001185939805108,1.96859194516716,3946524285.0,2007-11-30,2007,4,334,11,1.72,148.6,148.45,147.28999,1989
2007-12-03 14:30:00,148.19,148.45,147.28999,147.67999,140.92142857142858,158.41704918032792,148.4730997500004,149.32329939999997,150.47399860000002,146.07449799999995,148.5501773590961,146.73067680610762,145.18307307692325,149.92989433010808,140.43625182373842,148.4730997500004,149.32329939999997,150.47399860000002,146.07449799999995,147.80666000000002,145927872,247692394.4,50.731990755262785,1.5,2.75,2.7766237397853084,0.5891495875498711,0.5933384909077923,-1.1320873381109775,-1.72542582901877,31.40591819166864,2.7267670232865315,3800596413.0,2007-12-03,2007,0,337,12,0.79,147.87,147.54089,146.31,1990
2007-12-04 14:30:00,146.66,147.54089,146.31,146.36,140.97371428571432,158.44196721311476,148.4746998000004,149.23839929999997,150.36739859999997,145.88999799999996,148.46428805089622,146.69537425314502,145.08230384615402,149.6665027209047,140.4981049714033,148.4746998000004,149.23839929999997,150.36739859999997,145.88999799999996,146.73696333333334,136528560,243180525.6,47.93576622123415,1.5,2.75,2.676149901229216,0.5614288383625403,0.5561413322514188,-1.0302491637044966,-1.5863904959559154,30.63199147255897,1.1891592920354173,3664067853.0,2007-12-04,2007,1,338,12,0.84,146.93,149.2,147.83,1991
2007-12-05 14:30:00,147.92999,149.2,147.83,148.81,141.026,158.46688524590166,148.4888498000004,149.17819929999996,150.3157986,145.72699749999995,148.47784538223362,146.89676718141692,145.33384307692324,150.3311366213756,140.33654953247083,148.4888498000004,149.17819929999996,150.3157986,145.72699749999995,148.61333333333332,171036688,242845878.4,53.10254148603632,1.5,2.75,2.687853479712841,0.7043013829465923,0.6744891219073375,-0.7432790935717435,-1.417768215479081,31.742039286538947,5.032474945826858,3835104541.0,2007-12-05,2007,2,339,12,0.93,148.51,151.21001,148.57001,1992
2007-12-06 14:30:00,148.63,151.21001,148.57001,150.94,141.07828571428567,158.49180327868854,148.51419980000037,149.14009929999997,150.29079860000002,145.87849749999995,148.57440046528328,147.2818369736629,145.72999769230788,151.55680019851346,139.90319518610227,148.51419980000037,149.14009929999997,150.29079860000002,145.87849749999995,150.2400066666667,154542560,235250548.8,57.08950127065786,1.5,2.75,2.6844353740190683,0.6569275216925657,0.8621665354991894,-0.3400600461050942,-1.2022265816042836,28.432573984736305,4.724901130923474,3989647101.0,2007-12-06,2007,3,340,12,1.78,149.89,151.5,150.55,1993
2007-12-07 14:30:00,151.42,151.5,150.55,150.91,141.13057142857141,158.51672131147544,148.54224980000038,149.10449929999996,150.24719859999996,146.06599749999995,148.66599260389958,147.62737630950457,146.2799984615386,152.58900964336857,139.9709872797087,148.54224980000038,149.10449929999996,150.24719859999996,146.06599749999995,150.98666666666668,148980064,223979334.4,57.01597958222618,1.5,2.75,2.560547133017705,0.6651509363535282,0.9436488483144482,-0.02266552121122345,-0.9663143695256716,27.754546027997677,7.066335579992911,3840667037.0,2007-12-07,2007,4,341,12,0.63,151.02,152.25,150.86,1994
2007-12-10 14:30:00,151.28,152.25,150.86,152.08,141.18285714285713,158.5416393442623,148.5767998000004,149.07459919999997,150.23719859999997,146.41299750000002,148.79987524688394,148.05143570859937,146.85230615384637,153.78171339816308,139.92289890952964,148.5767998000004,149.07459919999997,150.23719859999997,146.41299750000002,151.73000000000005,123914368,216288486.4,59.22163816677374,1.5,2.75,2.4769366235164396,0.5729124562406666,1.028729121798377,0.31959703272229945,-0.7091320890760775,21.833431138191422,6.670400037146674,3964581405.0,2007-12-10,2007,0,344,12,0.92,151.56,152.89,147.83,1995
2007-12-11 14:30:00,152.14,152.89,147.83,147.91,141.23514285714285,152.89,148.6188498000004,149.0186992,150.10939859999996,146.62349749999996,148.7649781783787,148.03796564111371,147.33153769230788,153.5933749764408,141.06970040817498,148.6188498000004,149.0186992,150.10939859999996,146.62349749999996,149.54333333333332,250346368,216654964.0,49.476929286742326,1.5,2.75,2.661441150408121,1.15550718699434,0.7684734722554019,0.2514597512431749,-0.517013721012227,29.54070002130889,0.5301434105892756,3714235037.0,2007-12-11,2007,1,345,12,3.42,150.36,151.77,147.2,1996
2007-12-12 14:30:00,151.06,151.77,147.2,149.37,141.28742857142856,152.7797619047619,148.66104985000038,148.9726992,150.01499859999996,146.68799750000002,148.78870452432463,148.16482605624574,147.7346146153848,153.79146914227562,141.67776008849398,148.66104985000038,148.9726992,150.01499859999996,146.68799750000002,149.4466666666667,322435584,223223074.4,52.42839499119154,1.5,2.75,2.7977667825218284,1.4444545433605944,0.6629529284328504,0.31167743952883603,-0.3512754889040144,24.230096155854174,1.487980804999376,4036670621.0,2007-12-12,2007,2,346,12,3.1,149.49,149.39,147.3,1997
2007-12-13 14:30:00,148.32001,149.39,147.3,149.06,141.33971428571428,152.66952380952378,148.7037999000004,148.9502992,149.92059859999995,146.75749749999997,148.79934356258642,148.2500807175557,148.3584607692309,152.99590338676617,143.72101815169566,148.7037999000004,148.9502992,149.92059859999995,146.75749749999997,148.58333333333334,237607056,223577183.2,51.73728816064226,1.5,2.75,2.747212012341696,1.062751809461029,0.5454806436475614,0.3305753156554374,-0.21490532799212406,24.31221603803012,0.26907036189964056,3799063565.0,2007-12-13,2007,3,347,12,1.42,148.34,149.10001,147.10001,1998
2007-12-14 14:30:00,147.92999,149.10001,147.10001,147.17,141.392,152.5592857142857,148.7462999000004,148.9058992,149.78359859999995,146.838998,148.73544773660262,148.14721588731229,148.71230615384633,152.04848001308133,145.37613229461132,148.7462999000004,148.9058992,149.78359859999995,146.838998,147.7900066666666,159152880,218382243.2,47.61614546260641,1.5,2.75,2.6938397257458604,0.7287812308725291,0.3246001608945647,0.1908448731260819,-0.13375528776848286,24.822430626183092,-0.34533453042623863,3639910685.0,2007-12-14,2007,4,348,12,1.36,148.1,146.87,144.86,1999
2007-12-17 14:30:00,146.61,146.87,144.86,145.07001,141.44428571428568,152.44904761904758,148.7848999000004,148.87639929999997,149.56799859999995,146.802999,148.59170508026526,147.85414865994917,148.55384538461553,152.34082237951264,144.76686838971844,148.7848999000004,148.87639929999997,149.56799859999995,146.802999,145.60000333333338,177269312,211807846.4,43.47262086900064,1.5,2.75,2.666422602478297,0.8369345848747556,0.036343442247109566,-0.08832598495959587,-0.12466942720670544,25.839420934744158,-0.8813815250068442,3462641373.0,2007-12-17,2007,0,351,12,1.39,145.86,146.48,143.96001,2000
2007-12-18 14:30:00,146.10001,146.48,143.96001,145.88,141.49657142857143,152.33880952380952,148.8157999000004,148.88409929999997,149.38519859999997,146.90899950000002,148.48536370456858,147.6661345018588,148.4538461538463,152.44386660849148,144.46382569920115,148.8157999000004,148.88409929999997,149.38519859999997,146.90899950000002,145.44000333333338,245569248,210700677.6,45.4445922361064,1.5,2.75,2.6559631308727027,1.1654886486231215,-0.09340721095153914,-0.24142844089612936,-0.14802122994459022,25.705635353025052,-1.9689536993481669,3708210621.0,2007-12-18,2007,1,352,12,1.75,145.22,146.89,144.94,2001
2007-12-19 14:30:00,145.94,146.89,144.94,145.88,141.54885714285714,152.22857142857143,148.8473999000004,148.86909929999996,149.17319859999995,146.9709995,148.38319257889924,147.4960264540627,148.24000000000015,152.45457353624343,144.02542646375687,148.8473999000004,148.86909929999996,149.17319859999995,146.9709995,145.90333333333334,198917120,199910303.2,45.4445922361064,1.5,2.75,2.605537192953224,0.9950318558668466,-0.1684863650437814,-0.3586291862493169,-0.19014282120553555,23.36981515390761,-3.3523254273221164,3708210621.0,2007-12-19,2007,2,353,12,1.35,145.92,146.86,145.17999,2002
2007-12-20 14:30:00,146.84,146.86,145.17999,146.8,141.60114285714286,152.1183333333333,148.8776998500004,148.87989929999995,148.98479859999995,147.22700000000003,148.321106595413,147.42973822034247,148.1723084615386,152.44850262577708,143.8961142973001,148.8776998500004,148.87989929999995,148.98479859999995,147.22700000000003,146.27999666666668,214813744,197692974.4,47.84146339485773,1.5,2.75,2.53942810774228,1.086602822644364,-0.14626644411965076,-0.372975876355099,-0.22670943223544826,21.749775523519183,-2.723477569412222,3923024365.0,2007-12-20,2007,3,354,12,1.16,146.02,148.42,147.09,2003
2007-12-21 14:30:00,147.37,148.42,147.09,148.13,141.65342857142858,152.00809523809522,148.9144498500004,148.89689939999994,148.83799859999996,147.42700000000005,148.31361221912232,147.4964298184051,148.30846230769242,152.45594734588934,144.16097726949556,148.9144498500004,148.89689939999994,148.83799859999996,147.42700000000005,147.88,146090320,201113259.2,51.18069809908391,1.5,2.75,2.4737546714749716,0.7264081969589005,-0.037727539965024925,-0.2738688571917294,-0.23614131722670445,22.76713222510246,-2.59731720147292,4069114685.0,2007-12-21,2007,4,355,12,0.9,147.76,149.48,148.48,2004
2007-12-24 14:30:00,148.82001,149.48,148.48,149.23,141.70571428571432,151.89785714285713,148.9556498000004,148.91319929999997,148.69599859999997,147.84100000000004,148.34954899484302,147.66153174046175,148.34077000000013,152.50986607957805,144.17167392042222,148.9556498000004,148.91319929999997,148.69599859999997,147.84100000000004,149.06333333333333,45601328,192685053.6,53.81432683818385,1.5,2.75,2.393486480655331,0.23666250779712786,0.1046325679110233,-0.10535060733792534,-0.20998317524894866,22.71797412309575,0.8924345886011718,4114716013.0,2007-12-24,2007,0,358,12,0.67,148.98,149.67999,148.5,2005
2007-12-26 14:30:00,148.64999,149.67999,148.5,149.55,141.75799999999995,151.78761904761905,149.0121498000004,148.97069929999995,148.58679879999997,148.18999950000006,148.39662550484914,147.84138586041774,148.2338469230771,152.19702530628226,144.27066853987188,149.0121498000004,148.97069929999995,148.58679879999997,148.18999950000006,149.24333000000001,67118064,181349347.2,54.58192458544268,1.5,2.75,2.306808160608522,0.3701036978422606,0.2107121423952646,0.0534070027451321,-0.15730513965013249,15.628955522100144,0.1205061257280624,4181834077.0,2007-12-26,2007,2,360,12,0.79,149.09,149.03,147.32001,2006
2007-12-27 14:30:00,149.02,149.03,147.32001,147.67,141.81028571428567,151.6773809523809,149.0540998000004,148.9852991999999,148.46459879999995,148.21699950000004,148.36813038701192,147.82506339752084,147.98461615384633,151.6387251069957,144.3305072006969,149.0540998000004,148.9852991999999,148.46459879999995,148.21699950000004,148.00667,122981680,174544993.6,49.38859765849492,1.5,2.75,2.3013211491364847,0.7045844023566425,0.14761179884351214,0.027209608904257717,-0.12040218993925444,16.3437910821302,-0.9325103984972594,4058852397.0,2007-12-27,2007,3,361,12,1.16,148.18,148.61,146.89999,2007
2007-12-28 14:30:00,148.53999,148.61,146.89999,147.3,141.8625714285714,151.56714285714284,149.0932498000004,148.98059919999992,148.32559880000002,148.22300000000004,148.32624292085458,147.7750573596617,147.616923846154,150.40892483716172,144.82492285514633,149.0932498000004,148.98059919999992,148.32559880000002,148.22300000000004,147.60333,116398064,170405868.8,48.41230254701242,1.5,2.75,2.25908463848388,0.6830637044350435,0.0778088197201658,-0.023141165289047198,-0.10094998500921301,16.354639469804276,0.0883332200856315,3942454333.0,2007-12-28,2007,4,362,12,1.16,147.75,147.6062,146.06,2008
2007-12-31 14:30:00,147.10001,147.6062,146.06,146.21001,141.91485714285713,151.45690476190475,149.13164985000037,148.9443992999999,148.175999,148.10050050000004,148.24325339454657,147.6260052301701,147.48615538461553,150.36877352397474,144.60353724525632,149.13164985000037,148.9443992999999,148.175999,148.10050050000004,146.62540333333334,108126752,164667881.6,45.55537319253066,1.5,2.75,2.2081643071636026,0.6566353495859876,-0.03866147582957268,-0.14927682979617884,-0.11061535396660616,15.223736541255827,0.7858274773676619,3834327581.0,2007-12-31,2007,0,365,12,1.06,146.83,146.99001,143.88,2009
2008-01-02 14:30:00,146.53,146.99001,143.88,144.92999,141.96714285714285,151.34666666666664,149.1552998000004,148.93979919999995,148.08119879999995,147.96300050000005,148.11332149672126,147.36924187491582,147.14461615384627,150.10458014453408,144.18465216315843,149.1552998000004,148.93979919999995,148.08119879999995,147.96300050000005,145.26666666666662,204935504,167618263.2,42.39161928815072,1.5,2.75,2.2725818566519176,1.222632308004967,-0.19031552919991712,-0.3485097654665026,-0.15819423626658544,13.642646510083717,-0.6512270359199286,3629392077.0,2008-01-02,2008,2,2,1,2.16,145.44,145.49001,144.07001,2010
2008-01-03 14:30:00,144.91,145.49001,144.07001,144.86,142.01942857142856,151.23642857142858,149.17474980000037,148.94129909999995,147.96759899999995,147.88800050000003,147.9857402615557,147.13026645825715,146.82153923076936,149.7915617533677,143.85151670817103,149.17474980000037,148.94129909999995,147.96759899999995,147.88800050000003,144.80667333333338,125133248,167048497.6,42.21896610071491,1.5,2.75,2.211683152605353,0.7490833488346201,-0.2784170689382076,-0.5062155724393449,-0.2277985035011373,13.157826789479824,-0.699204825884276,3504258829.0,2008-01-03,2008,3,3,1,0.99,144.78,143.44,140.91,2011
2008-01-04 14:30:00,143.34,143.44,140.91,141.31,142.07171428571428,151.12619047619046,149.1648498500004,148.9020990999999,147.7585992,147.51300050000003,147.7239465258084,146.57595536699458,146.37077000000014,150.53222284884208,142.20931715115816,149.1648498500004,148.9020990999999,147.7585992,147.51300050000003,141.88666666666668,232330816,170113204.0,34.5357864602408,1.5,2.75,2.335848641704972,1.3657424029236438,-0.5435182354987748,-0.9071962978746058,-0.363678062375831,19.043394396052523,-3.73978201634878,3271928013.0,2008-01-04,2008,4,4,1,1.8,142.18,142.23,140.10001,2012
2008-01-07 14:30:00,141.81,142.23,140.10001,141.19,142.124,151.01595238095237,149.15489990000037,148.88389919999997,147.55279919999995,147.02550050000005,147.46771332871788,146.06300723680462,146.07230769230785,151.04215079057425,141.10246459404144,149.15489990000037,148.88389919999997,147.55279919999995,147.02550050000005,141.17333666666667,234990944,174135623.2,34.308500449218826,1.5,2.75,2.321144453011758,1.3494708301592366,-0.6855289229932011,-1.2205892161173324,-0.5350602931241313,18.167237726171876,-4.6850739215553885,3036937069.0,2008-01-07,2008,0,7,1,1.52,141.17,142.89999,138.44,2013
2008-01-08 14:30:00,142.08,142.89999,138.44,138.91,142.17628571428568,150.90571428571425,149.13249990000037,148.86259929999994,147.29419919999995,146.42550050000006,147.1321167275917,145.38176845234702,145.536153846154,151.8069048327717,139.2654028595363,149.13249990000037,148.86259929999994,147.29419919999995,146.42550050000006,140.08333000000002,326366720,183004956.0,30.236786382894763,1.5,2.75,2.4739191349394907,1.7833764021123013,-0.8792281427302452,-1.6340954715369378,-0.7548673288066926,17.37168416960458,-6.91549956443074,2710570349.0,2008-01-08,2008,1,8,1,3.22,140.67,140.78999,137.7,2014
2008-01-09 14:30:00,139.09,140.78999,137.7,140.37,142.22857142857143,150.79547619047614,149.11834990000037,148.84529919999994,147.0291992,145.84000050000003,146.86693567945085,144.90445717117115,145.11230769230784,151.95185460419106,138.27276078042462,149.11834990000037,148.84529919999994,147.0291992,145.84000050000003,139.61999666666665,301910784,191904776.8,35.51443798408765,1.5,2.75,2.5179241967295267,1.5732322510900625,-0.8544886984673584,-1.8229782018908909,-0.9684895034235322,18.32206347002136,-6.138415245737216,3012481133.0,2008-01-09,2008,2,9,1,2.24,139.24,142.8,139.37,2015
2008-01-10 14:30:00,139.67999,142.8,139.37,141.28999,142.28085714285714,150.6852380952381,149.1104998500004,148.8110989999999,146.77239899999995,145.5090000000001,146.64823192731555,144.5602222024882,144.6884607692309,151.73685311840032,137.64006842006154,149.1104998500004,148.8110989999999,146.77239899999995,145.5090000000001,141.15333,335701248,196172520.8,38.663272070228096,1.5,2.75,2.583072468391705,1.7112552085837294,-0.7266476380668407,-1.876799051007083,-1.1501514129402424,19.196715940701505,-4.32045100562064,3348182381.0,2008-01-10,2008,3,10,1,2.46,141.08,141.8985,139.0,2016
2008-01-11 14:30:00,140.78,141.8985,139.0,140.14999,142.33314285714286,150.575,149.1021497500004,148.76619889999995,146.51419879999997,145.04799950000006,146.39339891055806,144.1402000879655,144.07461384615397,151.20665385773668,136.94257383457122,149.1021497500004,148.76619889999995,146.51419879999997,145.04799950000006,140.34949666666668,267076560,193404569.6,36.29802398258732,1.5,2.75,2.6056030063637263,1.3809216636006516,-0.6706936940498882,-1.9885185305026027,-1.3178248364527143,18.766136685333773,-4.854046164290568,3081105821.0,2008-01-11,2008,4,11,1,2.09,140.45,141.86,140.39999,2017
2008-01-14 14:30:00,141.16,141.86,140.39999,141.28,142.38542857142858,150.46476190476187,149.09869975000038,148.72969899999995,146.24679899999995,144.6589995000001,146.1928734630852,143.86780007958782,143.4630753846155,150.06574645825626,136.86040431097476,149.09869975000038,148.72969899999995,146.24679899999995,144.6589995000001,141.17999666666663,170365632,190042498.4,40.20301045239576,1.5,2.75,2.5416320773377463,0.8964607044968211,-0.5163350184632809,-1.9632436095318155,-1.4469085910685346,20.2377710938378,-3.371868998572676,3251471453.0,2008-01-14,2008,0,14,1,1.04,141.13,141.4903,137.89999,2018
2008-01-15 14:30:00,139.78999,141.4903,137.89999,138.17,142.43771428571432,150.35452380952378,149.07954975000038,148.64489909999998,145.98959899999997,144.20899950000006,145.87825097433677,143.32515245296042,142.5876907692309,148.73182445861804,136.44355707984377,149.07954975000038,148.64489909999998,145.98959899999997,144.20899950000006,139.18676333333335,240456496,194107679.2,34.021641351794884,1.5,2.75,2.616537643242192,1.2387788931948656,-0.5778006011977599,-2.1691593425657345,-1.5913587413679746,22.739108421310803,-4.6643141284975025,3011014957.0,2008-01-15,2008,1,15,1,2.6,139.7,139.12,136.28,2019
2008-01-16 14:30:00,137.36,139.12,136.28,136.98,142.49,150.24428571428567,149.05364975000037,148.5494990999999,145.70519899999996,143.8044990000001,145.52929995573533,142.72085221934515,141.76538307692317,147.82951699296243,135.70124916088395,149.05364975000037,148.5494990999999,145.70519899999996,143.8044990000001,137.46,378956032,204192015.2,31.99454981033818,1.5,2.75,2.6324992401534644,1.8558807582599344,-0.6474716814461048,-2.400698343175605,-1.7532266617295007,22.73203763787713,-5.439734916471092,2632058925.0,2008-01-16,2008,2,16,1,2.08,137.7,137.88,132.92999,2020
2008-01-17 14:30:00,137.81,137.88,132.92999,133.42999,142.54228571428567,150.13404761904758,149.0023497000004,148.40049899999994,145.37279879999997,143.1819985000001,145.05481721237317,141.83600819845518,140.69845923076937,147.34475697032184,134.0521614912169,149.0023497000004,148.40049899999994,145.37279879999997,143.1819985000001,134.74666000000002,398404864,211833796.0,26.854150900511318,1.5,2.75,2.798035722999645,1.8807426932008529,-0.8677681412708682,-2.837936838318086,-1.9701686970472176,25.257125250476278,-5.576399405562238,2233654061.0,2008-01-17,2008,3,17,1,3.72,135.4,135.02,131.10001,2021
2008-01-18 14:30:00,134.74001,135.02,131.10001,132.06,142.5945714285714,150.02380952380952,148.94339965000037,148.25159899999994,144.97259859999997,142.4909985000001,144.5452165373781,140.90495979860228,139.60999692307706,146.89342749264333,132.3265663535108,148.94339965000037,148.25159899999994,144.97259859999997,142.4909985000001,132.72666999999998,348561408,219316010.4,25.173284458985147,1.5,2.75,2.878175314213957,1.5893112744677211,-1.0298237638677703,-3.2574484018819305,-2.22762463801416,23.051672056210162,-6.466463630568733,1885092653.0,2008-01-18,2008,4,18,1,2.99,133.06,132.42661,126.0,2022
2008-01-22 14:30:00,127.21001000000001,132.42661,126.0,130.72,126.0,149.9135714285714,148.8757996000004,148.12159899999997,144.62879859999995,141.68699850000004,144.00305118297115,139.93496362730681,138.5169207692309,146.50930734914087,130.52453418932092,148.8757996000004,148.12159899999997,144.62879859999995,141.68699850000004,129.71553666666668,435925248,230371585.6,23.616227869447144,1.5,2.75,3.1316349346272467,1.8922700334967004,-1.1426188660743517,-3.6558982206070993,-2.5132793545327483,22.79663582323872,-5.89590382261896,1449167405.0,2008-01-22,2008,1,22,1,5.1,129.21,134.19,126.84,2023
2008-01-23 14:30:00,127.09,134.19,126.84,133.86,125.6142105263158,149.8033333333333,148.82289960000037,147.99479909999994,144.36279859999996,140.97349850000006,143.60528446991347,139.35639566280142,137.67076692307705,145.10765740549326,130.2338764406608,148.82289960000037,147.99479909999994,144.36279859999996,140.97349850000006,131.63,511912960,248662717.6,33.929195229787155,1.5,2.75,3.4329467250110137,2.0586639000039626,-0.9301181293654346,-3.675927016239541,-2.7458088868741064,28.199792298014852,-4.6377431075015965,1961080365.0,2008-01-23,2008,2,23,1,5.79,130.51,135.46001,133.31,2024
2008-01-24 14:30:00,134.48,135.46001,133.31,134.99001,125.22842105263157,149.6930952380952,148.77479965000038,147.88319929999994,144.15979879999998,140.26149900000004,143.26743056913256,138.94054940920128,137.18461384615395,144.43017084787908,129.93905684442882,148.77479965000038,147.88319929999994,144.15979879999998,140.26149900000004,134.58667333333335,259949248,259380113.6,37.21452556602128,1.5,2.75,3.341308387510228,1.0021942098494014,-0.6510208413475271,-3.5595849385585154,-2.9085640972109883,27.846489450144748,-4.458900450060176,2221029613.0,2008-01-24,2008,3,24,1,1.61,134.39,136.75999,132.60001,2025
2008-01-25 14:30:00,136.50999,136.75999,132.60001,133.03999,124.84263157894735,149.58285714285708,148.7198996000004,147.7376991999999,143.94659860000002,139.43599850000004,142.86635446838227,138.37859137022974,136.55769000000012,143.71835532859328,129.39702467140697,148.7198996000004,147.7376991999999,143.94659860000002,139.43599850000004,134.13333,269603840,269504402.4,34.066498838635056,1.5,2.75,3.3997849312594965,1.000368964659258,-0.5398893770859754,-3.583425818568457,-3.043536441482482,27.5818363140974,-5.0731362877728445,1951425773.0,2008-01-25,2008,4,25,1,3.14,134.68,135.52,132.06,2026
2008-01-28 14:30:00,133.25999,135.52,132.06,135.24001,124.45684210526316,149.47261904761905,148.6727996500004,147.5992992999999,143.68979879999995,138.81449900000004,142.56728213628884,138.0796788587793,136.2753830769232,143.33144474796524,129.21932140588112,148.6727996500004,147.5992992999999,143.68979879999995,138.81449900000004,134.27333666666667,217934560,274252046.4,40.211421212416745,1.5,2.75,3.4040860075981043,0.7946506247108901,-0.27378495746014986,-3.3857676383076694,-3.1119826808475195,30.342883709384388,-4.275191109852766,2169360333.0,2008-01-28,2008,0,28,1,2.62,133.79,136.45,134.88,2027
2008-01-29 14:30:00,136.10001,136.45,134.88,135.91,124.07105263157897,149.3623809523809,148.6257496000004,147.4804993999999,143.4545988,138.24499900000004,142.30621224859127,137.8730427769908,135.9323061538462,142.58057983288964,129.28403247480284,148.6257496000004,147.4804993999999,143.4545988,138.24499900000004,135.74666666666667,168968816,276880584.0,41.98470856378778,1.5,2.75,3.273079864198239,0.6102588110692514,-0.021515054002406053,-3.138876498350527,-3.1173614443481212,29.96125590444616,-1.635666208294124,2338329149.0,2008-01-29,2008,1,29,1,1.16,135.66,138.53999,134.60001,2028
2008-01-30 14:30:00,135.58,138.53999,134.60001,134.91,123.68526315789472,149.25214285714281,148.5667996000004,147.34829939999997,143.24199899999996,137.6799985,142.0161647094308,137.5908482268012,135.4415376923078,141.33436906772658,129.548706316889,148.5667996000004,147.34829939999997,143.24199899999996,137.6799985,136.01666666666665,334939136,288221203.2,40.07422888203764,1.5,2.75,3.320715588184078,1.162090548097469,0.10233341430603192,-2.989444676465581,-3.091778090771613,27.762223067993922,-1.5111695137976298,2003390013.0,2008-01-30,2008,2,30,1,2.93,136.57,138.53999,133.2,2029
2008-01-31 14:30:00,133.39999,138.53999,133.2,137.37,123.29947368421051,149.14190476190473,148.5181996000004,147.26129929999996,143.07359919999996,137.301999,141.83396217180606,137.56981506234393,135.22769230769242,140.60034974984185,129.855034865543,148.5181996000004,147.26129929999996,143.07359919999996,137.301999,136.36999666666665,343680768,295158466.4,46.52116025578824,1.5,2.75,3.4649494747423577,1.1643940700458932,0.3597733518988897,-2.642061400898001,-3.0018347527968907,29.71748140297057,2.9528668929676165,2347070781.0,2008-01-31,2008,3,31,1,4.01,135.87,139.61,137.52,2030
2008-02-01 14:30:00,137.94,139.61,137.52,139.58,122.91368421052631,149.0316666666666,148.4797496000004,147.19919939999997,142.9899994,137.037999,141.74557149840192,137.76126124688258,135.0969230769232,139.9295860511699,130.26426010267647,148.4797496000004,147.19919939999997,142.9899994,137.037999,138.90333333333334,206843680,299243988.0,51.562678944465894,1.5,2.75,3.3774530836893333,0.6912208374926483,0.6706759952163752,-2.163489758776421,-2.8341657539927967,25.507285807058945,5.694381341814334,2553914461.0,2008-02-01,2008,4,32,2,1.52,138.56,139.3,137.64,2031
2008-02-04 14:30:00,139.21001,139.3,137.64,137.82001,122.5278947368421,148.92142857142858,148.4326996500004,147.10249939999997,142.85359959999997,136.86349950000002,141.59162791022928,137.76685636622713,135.07000076923086,139.83734256042518,130.3026589780365,148.4326996500004,147.10249939999997,142.85359959999997,136.86349950000002,138.25333666666666,124694256,293862160.0,47.70565875459359,1.5,2.75,3.274777863425811,0.4243290663894936,0.7439059029959858,-1.9042833752478143,-2.6481892782438003,26.04042068461897,5.431464198286411,2429220205.0,2008-02-04,2008,0,35,2,1.21,138.47,136.25,133.67,2032
2008-02-05 14:30:00,135.94,136.25,133.67,134.13,122.1421052631579,148.81119047619043,148.3602496500004,146.96509939999996,142.7025998,136.51049949999998,141.2990150510046,137.4204890932531,134.85077000000007,139.5074517797508,130.19408822024928,148.3602496500004,146.96509939999996,142.7025998,136.51049949999998,134.6833333333333,286882560,296456740.8,40.812589845858284,1.5,2.75,3.3372944446096824,0.967704627750532,0.5394634323030081,-1.9738599878650405,-2.5133234201680485,30.8430244330753,0.20170327207528896,2142337645.0,2008-02-05,2008,1,36,2,1.93,134.96,135.25,132.41,2033
2008-02-06 14:30:00,134.58,135.25,132.41,133.05,121.75631578947369,148.70095238095234,148.2851996500004,146.80649939999995,142.48099979999995,136.2174995,140.97552426469068,137.0042520367528,134.82154000000008,139.51812719202158,130.1249528079786,148.2851996500004,146.80649939999995,142.48099979999995,136.2174995,133.57,250792880,292678048.8,39.03481896606368,1.5,2.75,3.301773412851848,0.8568899547754536,0.3370337007865252,-2.092031294184892,-2.4290649949714167,28.14878241527832,-1.4371507936031716,1891544765.0,2008-02-06,2008,2,37,2,2.14,133.83,134.78999,131.73,2034
2008-02-07 14:30:00,131.8,134.78999,131.73,133.92999,121.37052631578949,148.59071428571426,148.21424960000041,146.65679939999995,142.3405996,135.89549900000003,140.6992288033303,136.7114651761097,134.96538538461547,139.42332714390452,130.50744362532643,148.21424960000041,146.65679939999995,142.3405996,135.89549900000003,133.48332666666667,297541632,292459591.2,41.279278010107994,1.5,2.75,3.284503169076716,1.0173768990756902,0.27079103114493064,-2.0905762060402537,-2.3613672371851844,27.955301487079407,0.6689717881067301,2189086397.0,2008-02-07,2008,3,38,2,2.32,133.26,134.22,132.10001,2035
2008-02-08 14:30:00,133.09,134.22,132.10001,133.07001,120.98473684210528,148.48047619047614,148.1321996500004,146.50649939999994,142.1505996,135.48450000000003,140.4000437522193,136.3646599212421,135.14615538461547,139.0579672743427,131.23434349488826,148.1321996500004,146.50649939999994,142.1505996,135.48450000000003,133.13000666666667,221643504,286756704.0,39.739536178527594,1.5,2.75,3.201323656999808,0.7729322485168473,0.1817223156599708,-2.1342143426102207,-2.315936658270192,26.863167034972435,-1.6045547467794594,1967442893.0,2008-02-08,2008,4,39,2,1.6,133.16,134.23,132.03999,2036
2008-02-11 14:30:00,133.10001,134.23,132.03999,133.75,120.59894736842104,148.37023809523805,148.0526997000004,146.3193992999999,141.88299959999995,135.16450050000003,140.13925772272052,136.1156446906476,135.13769384615392,139.06105615073915,131.2143315415687,148.0526997000004,146.3193992999999,141.88299959999995,135.16450050000003,133.33999666666668,188576256,282831688.8,41.59463651955029,1.5,2.75,3.129086967214107,0.666743732995735,0.18087891193241834,-2.0898380183546688,-2.2707169302870875,25.068871942456365,-1.5892870281804108,2156019149.0,2008-02-11,2008,0,42,2,1.66,133.13,136.31,133.98,2037
2008-02-12 14:30:00,134.91,136.31,133.98,134.99001,120.21315789473684,148.25999999999996,147.9799997500004,146.1356993999999,141.6392,134.85000100000002,139.93732643947658,136.0084413867764,135.13769384615392,139.06105615073915,131.2143315415687,147.9799997500004,146.1356993999999,141.6392,134.85000100000002,135.09333666666666,256654368,287146125.6,44.924314191345864,1.5,2.75,3.088437898127385,0.8938110081189965,0.27070454548598466,-1.932336248429607,-2.203040793915592,25.56198260958647,0.05930620413610235,2412673517.0,2008-02-12,2008,1,43,2,1.74,135.14,137.10001,135.14,2038
2008-02-13 14:30:00,136.00999,137.10001,135.14,136.37,119.82736842105264,148.14976190476187,147.92039980000038,145.9765993999999,141.3934,134.76000100000002,139.79743128498728,136.0428755404168,135.3938484615385,139.16791901904008,131.6197779040369,147.92039980000038,145.9765993999999,141.3934,134.76000100000002,136.20333666666667,181967744,284221688.0,48.44673375003561,1.5,2.75,3.018549476832571,0.6402317334770034,0.4209671730796352,-1.6768318275660477,-2.0977990006456833,25.859666552296165,-0.7279609812914027,2594641261.0,2008-02-13,2008,2,44,2,1.45,136.12,137.0,134.78999,2039
2008-02-14 14:30:00,136.95,137.0,134.78999,135.17,119.44157894736843,148.03952380952376,147.8528998000004,145.8085993999999,141.14320020000005,134.66950100000003,139.61596339145837,135.95974453656754,135.38846307692313,139.16359599125857,131.61333016258772,147.8528998000004,145.8085993999999,141.14320020000005,134.66950100000003,135.65332999999998,215207120,276034242.4,45.709109014943245,1.5,2.75,2.9607966570588173,0.7796392147904039,0.4356251186295281,-1.5532676023587726,-1.9888927209883007,23.93256932638956,-3.1594784353059358,2379434141.0,2008-02-14,2008,3,45,2,1.64,135.89,136.10001,133.36,2040
2008-02-15 14:30:00,134.55,136.10001,133.36,135.14,119.0557894736842,147.92928571428567,147.7808998500004,145.6430993999999,140.91880020000005,134.7550015,139.44043541532275,135.881673628323,135.32923230769237,139.09392324971265,131.56454136567208,147.7808998500004,145.6430993999999,140.91880020000005,134.7550015,134.86667,154110256,263819512.0,45.63967430234541,1.5,2.75,2.9450261815546144,0.5841503338085168,0.4381940717501924,-1.44115013130056,-1.8793442030507528,21.241106394756862,-1.9445724898728491,2225323885.0,2008-02-15,2008,4,46,2,2.05,134.73,136.89,134.61,2041
2008-02-19 14:30:00,136.69,136.89,134.61,135.52,118.67,147.81904761904758,147.7067498000004,145.48439939999992,140.65300020000004,134.9280015,139.28669285001598,135.8472285208637,135.37615538461543,139.1339751963502,131.61833557288065,147.7067498000004,145.48439939999992,140.65300020000004,134.9280015,135.67333333333332,145190000,253650941.6,46.74323367784361,1.5,2.75,2.8975243114435685,0.5724007925385916,0.4582177190895236,-1.306572054188848,-1.7647897732783715,20.569283722322194,1.036308059345422,2370513885.0,2008-02-19,2008,1,50,2,1.69,135.75,137.60001,133.75999,2042
2008-02-20 14:30:00,133.99001,137.60001,133.75999,135.92,118.2842105263158,147.70880952380952,147.6317498000004,145.32169939999991,140.35260020000004,135.18800149999998,139.15466567942713,135.85415913792428,135.264616923077,138.86173335338785,131.66750049276615,147.6317498000004,145.32169939999991,140.35260020000004,135.18800149999998,135.76,220709376,242890148.0,47.94126546050762,1.5,2.75,2.964845432054743,0.9086798201465132,0.4883639403370738,-1.1543348478570294,-1.6426987881941033,12.70258069007979,2.1570838030815302,2591223261.0,2008-02-20,2008,2,51,2,2.87,135.68,137.00999,134.07001,2043
2008-02-21 14:30:00,136.66,137.00999,134.07001,134.78999,117.89842105263156,147.59857142857138,147.5509497500004,145.1386992999999,140.03020000000004,135.23450100000002,138.98350192729274,135.75280969621718,134.89615461538472,137.49143749428708,132.3008717364823,147.5509497500004,145.1386992999999,140.03020000000004,135.23450100000002,135.28999666666667,201051184,227347059.2,44.87040213969318,1.5,2.75,2.9630693297651183,0.8843359782504722,0.4245197360478359,-1.1120491181343084,-1.5365688541821445,12.774677771328307,0.6421265319290961,2390172077.0,2008-02-21,2008,3,52,2,2.19,135.54,135.85001,132.86,2044
2008-02-22 14:30:00,134.97,135.85001,132.86,135.62,117.51263157894738,147.48833333333332,147.4752997500004,144.9690992999999,139.70100000000005,135.26600050000002,138.8515998909283,135.74016115372032,134.72692307692316,136.7644980853498,132.68934806849649,147.4752997500004,144.9690992999999,139.70100000000005,135.26600050000002,134.77667,205491008,224624147.2,47.52901984053778,1.5,2.75,2.9649936633533227,0.9148215388305324,0.4292273037015959,-1.0000347245551495,-1.4292620282567454,12.708598653766048,1.9162770033608687,2595663085.0,2008-02-22,2008,4,53,2,2.25,134.36,137.64999,134.78,2045
2008-02-25 14:30:00,135.53999,137.64999,134.78,137.33,117.12684210526315,147.3780952380952,147.4061497500004,144.7993992999999,139.48940000000005,135.480501,138.79192930697036,135.89157437717554,134.973076923077,137.39890358463654,132.54725026151746,147.4061497500004,144.7993992999999,139.48940000000005,135.480501,136.58666333333335,190107008,220649305.6,52.60057981332716,1.5,2.75,2.9582076873995136,0.8615799061005519,0.5318356255994571,-0.7644674962574243,-1.2963031218568812,13.159132384134312,2.6766355140187015,2785770093.0,2008-02-25,2008,0,56,2,2.13,136.21,138.95,136.5,2046
2008-02-26 14:30:00,136.75,138.95,136.5,138.36,116.74105263157897,147.26785714285708,147.3500497500004,144.6420992999999,139.26920000000004,135.63650049999998,138.77499090277544,136.12666253173026,135.38153846153855,138.1399748096545,132.62310211342262,147.3500497500004,144.6420992999999,139.26920000000004,135.63650049999998,137.93666666666667,212420624,220373608.8,55.39705955033579,1.5,2.75,2.9219071382995487,0.9639113556141936,0.6458191734525607,-0.4890291550411803,-1.134848328493741,13.356268953395029,2.4964736279373567,2998190717.0,2008-02-26,2008,1,57,2,1.79,137.72,139.14,137.41,2047
2008-02-27 14:30:00,137.56,139.14,137.41,138.22,116.35526315789473,139.14,147.2868497500004,144.4864992999999,139.05240000000003,135.75200049999998,138.75322655364698,136.3260280048988,135.71153923076932,138.7122222504838,132.71085621105485,147.2868497500004,144.4864992999999,139.05240000000003,135.75200049999998,138.25666666666666,168395808,220344958.4,54.92274507656103,1.5,2.75,2.8367709141352937,0.7642371725805731,0.6848186674335655,-0.2788249942017842,-0.9636436616353496,13.007088582067285,1.3566033585099322,2829794909.0,2008-02-27,2008,2,58,2,1.26,138.27,137.96001,136.55,2048
2008-02-28 14:30:00,137.24001,137.96001,136.55,136.87,115.96947368421051,138.87557692307692,147.2185497500004,144.3149992999999,138.84640000000002,135.85000050000002,138.67937453193534,136.37783486157508,136.0038461538462,138.63600886174714,133.37168344594537,147.2185497500004,144.3149992999999,138.84640000000002,135.85000050000002,137.12667000000002,170831056,212139554.4,50.43809316333886,1.5,2.75,2.7534301345542005,0.8052767739762915,0.5959949777249599,-0.21864993947914968,-0.8146449172041097,13.656752916845436,1.257675519715926,2658963853.0,2008-02-28,2008,3,59,2,1.03,137.26,137.0249,132.78,2049
2008-02-29 14:30:00,135.60001,137.0249,132.78,133.82001,115.58368421052631,138.61115384615385,147.1347997500004,144.09469929999992,138.62140000000002,135.672501,138.4888112169575,136.13423249380602,136.00923153846162,138.62315005426785,133.39531302265542,147.1347997500004,144.09469929999992,138.62140000000002,135.672501,134.54163666666668,252715120,207591272.0,42.078484865295245,1.5,2.75,2.8599636963717576,1.2173687148080101,0.32186269398996803,-0.4123165497166497,-0.7341792437066177,18.44385297420461,-0.9767574367322704,2406248733.0,2008-02-29,2008,4,60,2,3.2,134.9,133.81,132.24001,2050
2008-03-03 14:30:00,133.14,133.81,132.24001,133.5,115.1978947368421,138.34673076923076,147.0442997000004,143.8794992999999,138.37380000000002,135.368501,138.29317156139052,135.88335320868165,135.89461538461546,138.7924927869933,132.99673798223762,147.0442997000004,143.8794992999999,138.37380000000002,135.368501,133.1833366666667,195613632,207029769.6,41.30495123411561,1.5,2.75,2.7685377180594886,0.9448575071012396,0.11944039652200687,-0.5848787480541091,-0.7043191445761159,18.452264752576095,-1.4905548996458162,2210635101.0,2008-03-03,2008,0,63,3,1.19,133.03,133.39999,130.99001,2051
2008-03-04 14:30:00,132.23,133.39999,130.99001,132.99001,114.81210526315789,138.0823076923077,146.9527497500004,143.6445993999999,138.11600020000003,135.127001,138.085204441336,135.6077967126167,135.63461615384622,138.89861326853006,132.37061903916245,146.9527497500004,143.6445993999999,138.11600020000003,135.127001,132.46000333333333,282513152,214920714.4,40.04163041411589,1.5,2.75,2.750070023912381,1.3144994087177666,-0.039820468082850224,-0.7540947296796787,-0.7142742615968285,18.314856243587567,-2.155672454384914,1928121949.0,2008-03-04,2008,1,64,3,1.84,132.2,134.77,132.34,2052
2008-03-05 14:30:00,133.41,134.77,132.34,133.83,114.42631578947369,137.8178846153846,146.85879975000043,143.4206993999999,137.85660020000003,135.11200100000002,137.91833367893068,135.43848273998654,135.53153923076928,138.92959745459362,132.133481006945,146.85879975000043,143.4206993999999,137.85660020000003,135.11200100000002,133.64666666666668,270681344,214110653.6,43.12705136270665,1.5,2.75,2.7272078793472114,1.264212403487801,-0.07743653635417247,-0.8110699320395441,-0.7336333956853716,18.73316211789095,-0.7122116412353591,2198803293.0,2008-03-05,2008,2,65,3,1.84,133.56,133.22,130.55,2053
2008-03-06 14:30:00,132.98,133.22,130.55,131.06,114.04052631578949,137.5534615384615,146.75139980000043,143.1765993999999,137.51520020000004,135.01250100000001,137.64937941701186,135.02148438379737,135.21769307692315,139.37194823800593,131.06343791584038,146.75139980000043,143.1765993999999,137.51520020000004,135.01250100000001,131.61,247912128,213966616.0,36.463402072599614,1.5,2.75,2.7666930308224105,1.1586486370378453,-0.2670407411535409,-1.0674343221272975,-0.8003935809737568,21.567989599372773,-3.3623359386521177,1950891165.0,2008-03-06,2008,3,66,3,2.05,131.88,131.74001,128.58,2054
2008-03-07 14:30:00,129.63,131.74001,128.58,129.71001,113.65473684210528,137.28903846153844,146.63784985000044,142.9103994999999,137.12480040000003,134.801502,137.33803159673687,134.51562968057857,134.77077076923086,139.84664238297822,129.69489915548348,146.63784985000044,142.9103994999999,137.12480040000003,134.801502,130.01000666666667,326434560,215411262.4,33.728190799631555,1.5,2.75,2.7947871000493807,1.515401545690027,-0.4507384390439405,-1.3638166297786825,-0.9130781907347422,21.13851558343215,-5.5486710842496185,1624456605.0,2008-03-07,2008,4,67,3,2.46,130.16,129.92999,127.59,2055
2008-03-10 13:30:00,129.81,129.92999,127.59,128.0,113.26894736842104,137.02461538461537,146.51564985000044,142.6402995999999,136.69380040000004,134.5480015,136.97183427921775,133.89509352052346,134.1615400000001,140.3242576165649,127.99882238343528,146.51564985000044,142.6402995999999,136.69380040000004,134.5480015,128.50666333333334,235683376,216113256.0,30.597289158909177,1.5,2.75,2.7623015929029973,1.0905549264409768,-0.6430526272123944,-1.716893974750235,-1.0738413475378406,18.590296010254875,-7.4877132119109655,1388773229.0,2008-03-10,2008,0,70,3,1.83,128.76,132.72,127.71518999999999,2056
2008-03-11 13:30:00,130.72,132.72,127.71518999999999,132.60001,112.88315789473684,136.7601923076923,146.42334990000043,142.42849969999992,136.39240060000003,134.49050200000002,136.80039018983672,133.77175223285457,133.99308000000008,140.19745909563036,127.78870090436979,146.42334990000043,142.42849969999992,136.39240060000003,134.49050200000002,131.01173333333335,341875712,223778228.8,45.30563336669263,1.5,2.75,2.9224807648384967,1.5277433994955276,-0.4265296549737254,-1.607003416254997,-1.1804737612812721,29.914892728354165,-4.065974533352628,1730648941.0,2008-03-11,2008,1,71,3,3.92,130.22,133.77,131.16,2057
2008-03-12 13:30:00,132.73,133.77,131.16,131.36,112.49736842105264,136.49576923076918,146.32169990000043,142.19959969999994,136.07360060000002,134.30900150000002,136.58704155494112,133.5420615440113,133.66538769230775,139.94102587000964,127.38974951460591,146.32169990000043,142.19959969999994,136.07360060000002,134.30900150000002,132.09666666666666,229161120,222403566.4,42.679836118409455,1.5,2.75,2.9001607102071767,1.0303841962131413,-0.33683024876255985,-1.6015115722344715,-1.264681323471912,29.969319858987927,-4.0257178344414335,1501487821.0,2008-03-12,2008,2,72,3,1.99,132.46,132.64,128.60001,2058
2008-03-13 13:30:00,129.61,132.64,128.60001,131.64999,112.11157894736843,136.23134615384615,146.21874980000044,141.9791995999999,135.78240020000004,134.07300100000003,136.3934316900415,133.36186425410546,133.22846384615391,139.20656554958043,127.25036214272741,146.21874980000044,141.9791995999999,135.78240020000004,134.07300100000003,130.96333333333334,351881472,230899252.8,43.50447825911984,1.5,2.75,2.9815770880495203,1.5239610684439595,-0.23291485793976685,-1.5558248958966203,-1.3229100379568537,30.069367202808586,-1.6215960527876168,1853369293.0,2008-03-13,2008,3,73,3,3.14,130.62,132.81,127.78,2059
2008-03-14 13:30:00,132.77,132.81,127.78,129.61,111.72578947368422,135.96692307692305,146.09939980000044,141.7785995999999,135.47600040000003,133.795001,136.12741476102025,133.00454384895255,132.55538692307698,138.01907739618972,127.09169644996427,146.09939980000044,141.7785995999999,135.47600040000003,133.795001,130.0666666666667,484687872,244373290.4,39.228908245439186,1.5,2.75,3.127893010331697,1.9833913567503365,-0.27369960013757466,-1.665034538128822,-1.3913349379912472,28.735121939589487,-2.9138576779026115,1368681421.0,2008-03-14,2008,4,74,3,3.94,130.3,129.25999,126.07001000000001,2060
2008-03-17 13:30:00,126.57001000000001,129.25999,126.07001000000001,128.3,126.07001000000001,135.7025,145.97429975000043,141.5561996999999,135.14480040000004,133.45300100000003,135.82045731941162,132.55649205381422,131.79231000000007,136.61116631600328,126.97345368399687,145.97429975000043,141.5561996999999,135.14480040000004,133.45300100000003,127.87666666666668,405310976,256933326.4,36.732376862342655,1.5,2.75,3.1573285095937207,1.5774947597455773,-0.3558315056629673,-1.836124320069956,-1.480292814406989,28.999372601327057,-3.526588200121197,963370445.0,2008-03-17,2008,0,77,3,2.53,127.66,133.69,129.98,2061
2008-03-18 13:30:00,130.62,133.69,129.98,133.63,126.07185236842103,135.43807692307692,145.87204975000043,141.3748997999999,134.99120040000003,133.35850100000005,135.73455703237587,132.65873090583193,131.54307923076928,135.5529184272043,127.5332400343343,145.87204975000043,141.3748997999999,134.99120040000003,133.35850100000005,132.4333333333333,334416384,266394645.6,50.5277404514577,1.5,2.75,3.31680504462274,1.2553419879997771,-0.03501322220225056,-1.5240593421598017,-1.4890461199575515,38.692550559924896,-0.14944332361953006,1297786829.0,2008-03-18,2008,1,78,3,2.85,131.83,134.64999,130.03999,2062
2008-03-19 13:30:00,134.14,134.64999,130.03999,130.32001,126.0736947368421,135.17365384615385,145.7531497500005,141.1632998999999,134.77380060000004,133.07850150000004,135.52222185463563,132.43599558146698,131.27384846153853,135.10189518828943,127.44580173478764,145.7531497500005,141.1632998999999,134.77380060000004,133.07850150000004,131.66999666666666,345971456,272657749.6,44.097208683392715,1.5,2.75,3.4091761128639737,1.2688854672480578,-0.029755566265656338,-1.526240577789622,-1.4964850115239656,41.07702729292439,-0.5646192583549564,951815373.0,2008-03-19,2008,2,79,3,3.55,132.34,132.91,129.25999,2063
2008-03-20 13:30:00,130.05,132.91,129.25999,132.08,126.07553710526315,134.90923076923076,145.6460997000005,140.9656998999999,134.63720060000006,132.94300200000004,135.38723276229695,132.40209124037492,131.16461769230776,134.80897402887723,127.52026135573827,145.6460997000005,140.9656998999999,134.63720060000006,132.94300200000004,131.41666333333333,245320624,274871221.6,47.89445814378933,1.5,2.75,3.4263785333736902,0.8924929375000092,0.1010612849087522,-1.3701584053880254,-1.4712196902967776,40.211043031583216,1.827145029130752,1197135997.0,2008-03-20,2008,3,80,3,2.82,131.08,135.81,133.24001,2064
2008-03-24 13:30:00,133.31,135.81,133.24001,134.72,126.0773794736842,134.6448076923077,145.56049970000046,140.7766998999999,134.52420060000006,132.89800200000002,135.36106677161862,132.62284445557728,131.29769384615392,135.30702137319642,127.28836631911145,145.56049970000046,140.7766998999999,134.52420060000006,132.89800200000002,134.59000333333336,209110368,275052189.6,53.046528156369455,1.5,2.75,3.4480657809898543,0.7602570563212123,0.3596484148944909,-1.0216591716786638,-1.3813075865731548,40.87213618319354,5.249999999999999,1406246365.0,2008-03-24,2008,0,84,3,1.93,134.53,135.55,133.77,2065
2008-03-25 13:30:00,134.86,135.55,133.77,134.85001,126.07922184210527,134.3803846153846,145.48924970000044,140.58389999999991,134.39540100000005,132.77400250000002,135.3410253295944,132.83495545980801,131.37615615384624,135.61404901645992,127.13826329123256,145.48924970000044,140.58389999999991,134.39540100000005,132.77400250000002,134.72333666666668,192947184,275194198.4,53.291463588011425,1.5,2.75,3.3289182252048652,0.7011310017500718,0.5237625061760673,-0.7266044538530707,-1.2503669600291378,39.49440420050952,1.6968324512192725,1599193549.0,2008-03-25,2008,1,85,3,1.33,134.66,135.08839,133.11,2066
2008-03-26 13:30:00,134.46001,135.08839,133.11,133.2,126.08106421052629,134.1159615384615,145.40004975000045,140.38529999999992,134.25640120000006,132.51600249999998,135.25706355196328,132.86972160649296,131.54077153846166,135.88175038809445,127.19979268882881,145.40004975000045,140.38529999999992,134.25640120000006,132.51600249999998,133.79946333333334,196934192,274419876.8,49.74475352086657,1.5,2.75,3.232451923404517,0.7176382202938151,0.5052691165475818,-0.6187805643446609,-1.1240496808922429,35.47657770539534,1.4007308160779346,1402259357.0,2008-03-26,2008,2,86,3,1.49,134.1,134.44,132.36,2067
2008-03-27 13:30:00,134.2,134.44,132.36,132.78,126.08290657894736,133.85153846153844,145.30744975000044,140.16660009999993,134.08640120000007,132.24400250000002,135.15992380482743,132.86117669158887,131.7769246153847,136.0268957735381,127.52695345723131,145.30744975000044,140.16660009999993,134.08640120000007,132.24400250000002,133.19333333333336,225153120,277257742.4,48.853480123646534,1.5,2.75,3.150133928875622,0.8120715333358353,0.4506351037729823,-0.5607558011760148,-1.011390904948997,35.0218756776245,0.8583441593880855,1177106237.0,2008-03-27,2008,3,87,3,1.57,133.4,133.36,131.06,2068
2008-03-28 13:30:00,132.99001,133.36,131.06,131.50999,126.08474894736841,133.58711538461537,145.21674975000045,139.97139999999993,133.95320100000004,131.97600200000005,135.01678914581458,132.73249224477087,132.04692384615393,135.70797574145553,128.3858719508523,145.21674975000045,139.97139999999993,133.95320100000004,131.97600200000005,131.97666333333333,180918688,277762124.0,46.16024482623578,1.5,2.75,3.089410076813078,0.6513439823782453,0.3209401128214274,-0.6102157639222128,-0.9311558767436402,35.53377687146127,1.4659285548954355,996187549.0,2008-03-28,2008,4,88,3,1.75,132.21,132.73,131.09,2069
2008-03-31 13:30:00,131.28999,132.73,131.09,131.97,126.08659131578945,133.3226923076923,145.11714975000044,139.77909999999991,133.85300100000006,131.88350150000002,134.89730721852774,132.65987393574508,131.99846153846158,135.64559779886298,128.35132527806022,145.11714975000044,139.77909999999991,133.85300100000006,131.88350150000002,131.92999999999998,166692128,273460974.4,47.293653468376206,1.5,2.75,2.9858807856121428,0.6095645946034485,0.2606715279790438,-0.6053164667698354,-0.8659879947488792,34.15022062931303,2.8604832424006137,1162879677.0,2008-03-31,2008,0,91,3,1.25,131.91,136.84,133.50999,2070
2008-04-01 13:30:00,133.71001,136.84,133.50999,136.61,126.08843368421051,133.05826923076918,145.03589975000043,139.64469999999992,133.91660120000006,132.03900150000004,134.9644716413306,133.03607641805507,132.40230769230777,136.7689177476357,128.03569763697988,145.03589975000043,139.64469999999992,133.91660120000006,132.03900150000004,135.65333,254547248,276407655.2,57.103104388808354,1.5,2.75,3.1204607294969904,0.9209124393310218,0.5132405217199462,-0.22443734259894652,-0.7376778643188927,37.848830730290686,2.230038165082705,1417426925.0,2008-04-01,2008,1,92,4,2.49,135.17,137.67,135.98,2071
2008-04-02 13:30:00,137.06,137.67,135.98,136.7,126.09027605263157,132.79384615384615,144.95404970000044,139.49099989999993,134.00940120000004,132.22450100000003,135.03253157696471,133.38502152109746,132.79077000000007,137.6869572039573,127.89458279604284,144.95404970000044,139.49099989999993,134.00940120000004,132.22450100000003,136.78333333333333,210910816,272827538.4,57.26922814238715,1.5,2.75,3.018284963104348,0.7730554519418704,0.6571098157061862,0.08370940531384008,-0.5734004103923461,30.869070254237062,4.895633448769679,1628337741.0,2008-04-02,2008,2,93,4,1.24,136.82,137.44,135.71001,2072
2008-04-03 13:30:00,135.94,137.44,135.71001,137.03999,126.09211842105265,132.52942307692305,144.87479965000043,139.38229979999994,134.13580100000004,132.38500050000002,135.11125543669158,133.73311375718342,133.36230769230775,138.37316246875605,128.35145291585943,144.87479965000043,139.38229979999994,134.13580100000004,132.38500050000002,136.73,175884752,268087708.8,57.932002997062156,1.5,2.75,2.926263894311179,0.6560716744056861,0.7397624692139806,0.3513026761251297,-0.3884597930888509,25.53604752091229,3.7552922471229375,1804222493.0,2008-04-03,2008,3,94,4,1.27,136.58,137.96001,136.12,2073
2008-04-04 13:30:00,137.12,137.96001,136.12,136.89,126.09396078947368,132.265,144.79289965000046,139.27959979999991,134.19640100000007,132.67650050000003,135.18101012544875,134.03376958983262,134.02307692307699,138.4169471050975,129.62920674105646,144.79289965000046,139.27959979999991,134.19640100000007,132.67650050000003,136.99000333333333,204473056,265915755.2,57.50822723781747,1.5,2.75,2.8486743304318094,0.7689392298181511,0.7467574825360958,0.5449870600812687,-0.201770422454827,25.147888906322226,1.6107482185273063,1599749437.0,2008-04-04,2008,4,95,4,1.35,137.04,138.57001,136.74001,2074
2008-04-07 13:30:00,137.87,138.57001,136.74001,136.96001,126.09580315789472,132.00057692307692,144.72199970000045,139.19779989999995,134.23580100000004,133.0390005,135.25077482641154,134.3124591527057,134.2792315384616,138.9322000970545,129.6262629798687,144.72199970000045,139.19779989999995,134.23580100000004,133.0390005,137.42334333333335,154381312,257313092.8,57.66389937108418,1.5,2.75,2.775911878258108,0.5999745691914515,0.7183029372485056,0.696108249105805,-0.022194688142700564,22.94180408107502,1.5647014041749152,1754130749.0,2008-04-07,2008,0,98,4,1.34,137.66,137.1554,135.95,2075
2008-04-08 13:30:00,136.19,137.1554,135.95,136.82001,126.0976455263158,131.73615384615385,144.64619975000045,139.12899999999993,134.31140140000005,133.48000100000002,135.3123134606699,134.55127351911472,134.7792315384616,138.99980380456566,130.55865927235754,144.64619975000045,139.12899999999993,134.31140140000005,133.48000100000002,136.6418033333333,148937248,252975786.4,57.212511710987464,1.5,2.75,2.6637324583825284,0.5887411207193701,0.6540814244092272,0.7954070923688334,0.14132566795960624,22.991666022487173,2.717725225225231,1605193501.0,2008-04-08,2008,1,99,4,0.89,136.55,136.8,134.89,2076
2008-04-09 13:30:00,136.61,136.8,134.89,135.83,126.09948789473684,131.47173076923076,144.57259975000045,139.00649999999993,134.32320120000003,133.64150049999998,135.33261489358483,134.67305699348472,135.06769307692315,139.01463078046757,131.12075537337873,144.57259975000045,139.00649999999993,134.32320120000003,133.64150049999998,135.84,195610560,245662528.8,53.99377399711114,1.5,2.75,2.611323711355205,0.7962572108799362,0.515072030758972,0.7851657064083213,0.2700936756493493,22.051467230351964,2.297032685645437,1409582941.0,2008-04-09,2008,2,100,4,1.42,135.84,136.67,134.89999,2077
2008-04-10 13:30:00,135.39,136.67,134.89999,136.02,126.10133026315788,131.2073076923077,144.50354975000045,138.88999999999993,134.32540120000004,133.87450049999998,135.35957117226778,134.8013372798195,135.16769307692314,139.14011837818973,131.19526777565656,144.50354975000045,138.88999999999993,134.32540120000004,133.87450049999998,135.86333,192967808,243852863.2,54.52257123683876,1.5,2.75,2.5512298748298328,0.7913288590002499,0.41060567255071856,0.7833507663377475,0.3727450937870289,21.819246075185017,3.4294048687860315,1602550749.0,2008-04-10,2008,3,101,4,1.31,135.78,135.9837,133.00999,2078
2008-04-11 13:30:00,134.45,135.9837,133.00999,133.38,126.10317263157894,130.9428846153846,144.42899980000047,138.76840009999992,134.29480120000005,133.961001,135.2819409302181,134.66597182459859,135.05461538461543,139.13889020688129,130.97034056234958,144.42899980000047,138.76840009999992,134.29480120000005,133.961001,134.12456333333333,222973312,237407455.2,46.52129324702908,1.5,2.75,2.58399988377056,0.9392009691193556,0.1517266768787202,0.5624034398854292,0.41067676300670897,24.423710377280266,1.0684246419640802,1379577437.0,2008-04-11,2008,4,102,4,2.24,134.5,133.53999,132.55,2079
2008-04-14 13:30:00,133.19,133.53999,132.55,132.92999,126.105015,130.6784615384615,144.34164980000043,138.63980009999997,134.20600100000004,134.12700049999998,135.1897075604056,134.5006402222559,135.03384538461543,139.15818418923837,130.9095065799925,144.34164980000043,138.63980009999997,134.20600100000004,134.12700049999998,133.00666,160521936,221199158.4,45.30091919129196,1.5,2.75,2.4701420349298044,0.7256896326419296,-0.050950073958964,0.34698917055800393,0.397939244516968,24.527439163927372,-2.6938071883463945,1219055501.0,2008-04-14,2008,0,105,4,0.75,133.04,133.69,132.33,2080
2008-04-15 13:30:00,133.58,133.69,132.33,133.24001,126.10685736842105,130.41403846153844,144.2559498500005,138.53460029999994,134.07920120000006,134.374001,135.11324883254656,134.38058020108866,135.0692307692308,139.12290158840992,131.0155599500517,144.2559498500005,138.53460029999994,134.07920120000006,134.374001,133.08667,172389120,209553065.6,46.34516391644017,1.5,2.75,2.39084617529196,0.8226513866853209,-0.15915623181053207,0.19899395475380288,0.3581501865643349,12.11941049698293,-2.5310826627651624,1391444621.0,2008-04-15,2008,1,106,4,1.03,133.01,136.92999,134.39999,2081
2008-04-16 13:30:00,134.53999,136.92999,134.39999,136.85001,126.1086997368421,130.14961538461537,144.18804995000045,138.45670039999993,134.05980120000007,134.5350015,135.18135711362316,134.61576399146117,135.48000153846158,139.06262021117158,131.89738286575158,144.18804995000045,138.45670039999993,134.05980120000007,134.5350015,136.05999666666665,189268816,202295687.2,56.70902922119956,1.5,2.75,2.4836414484853906,0.9356048001798428,0.008482056910153024,0.3687527577020262,0.3602707007918732,20.743842955012187,-0.13863106674189876,1580713437.0,2008-04-16,2008,2,107,4,1.88,135.66,137.25,135.66,2082
2008-04-17 13:30:00,136.02,137.25,135.66,137.05,126.11054210526315,129.8851923076923,144.11435000000043,138.41040049999992,134.11820120000004,134.87150100000002,135.25463722681442,134.8475959922744,135.8707707692308,138.90259862498849,132.8389429134731,144.11435000000043,138.41040049999992,134.11820120000004,134.87150100000002,136.65333333333334,179707504,193982489.6,57.202225549842304,1.5,2.75,2.41980991645072,0.9264109578682302,0.12258822052516445,0.5135059764483287,0.3909177559231643,20.709343041356398,0.11688216816423773,1760420941.0,2008-04-17,2008,3,108,4,1.17,136.45,139.56,138.25999,2083
2008-04-18 13:30:00,138.94,139.56,138.25999,138.48,126.1123844736842,129.62076923076918,144.04505000000043,138.35390049999992,134.22680120000004,135.19150100000002,135.38112204144917,135.1935392311054,136.01461692307694,139.3366441305333,132.69258971562064,144.04505000000043,138.35390049999992,134.22680120000004,135.19150100000002,138.76666333333333,218530560,192642986.4,60.65394979075982,1.5,2.75,2.4262520652756683,1.1343810853629914,0.2753768128860924,0.7351387720307798,0.4597619591446874,21.51508863468006,1.1098057016788905,1978951501.0,2008-04-18,2008,4,109,4,0.94,138.91,138.98,136.87,2084
2008-04-21 13:30:00,138.23,138.98,136.87,138.55,126.11422684210524,129.35634615384615,143.9769000500004,138.32990049999992,134.31920140000003,135.38300100000004,135.50539176531387,135.5132021614763,136.15692461538464,139.73298642206524,132.58086280870404,143.9769000500004,138.32990049999992,134.31920140000003,135.38300100000004,138.13333333333335,118587376,188116836.8,60.82052875730415,1.5,2.75,2.4036626320416907,0.6303921436127401,0.3569817094474488,0.9059890959539983,0.5490073865065497,21.515153767239507,1.2644276228309113,2097538877.0,2008-04-21,2008,0,112,4,1.54,137.93,138.37,136.64,2085
2008-04-22 13:30:00,138.19,138.37,136.64,137.94,126.11606921052629,129.09192307692305,143.90170005000041,138.28360039999993,134.41660120000003,135.53750050000002,135.60086659804665,135.74432576514522,136.22615615384618,139.90139357887713,132.55091872881522,143.90170005000041,138.28360039999993,134.41660120000003,135.53750050000002,137.65,162166064,186577780.8,58.49637707005029,1.5,2.75,2.368401015467287,0.8691606433771024,0.3454825360937173,0.9808605566236964,0.635378020529979,21.72701803948537,1.5534123536773798,1935372813.0,2008-04-22,2008,1,113,4,1.27,137.5,138.78,137.12,2086
2008-04-23 13:30:00,138.09,138.78,137.12,137.72,126.11791157894736,128.8275,143.82530005000044,138.18950039999993,134.49600120000005,135.76350050000002,135.6839698687115,135.9324852160838,136.29000230769236,140.03728199385588,132.54272262152884,143.82530005000044,138.18950039999993,134.49600120000005,135.76350050000002,137.8733333333333,193309008,186396521.6,57.640872463028316,1.5,2.75,2.3178009429339093,1.03708484654469,0.3003318054166739,1.0107927773008214,0.7104609718841475,21.194331707791807,1.2498162034994769,1742063805.0,2008-04-23,2008,2,114,4,1.21,137.95,139.74001,137.03999,2087
2008-04-24 13:30:00,138.08,139.74001,137.03999,138.32001,126.11975394736841,128.56307692307692,143.76230010000043,138.1009005999999,134.56260120000005,136.040501,135.78734399150713,136.1598685288377,136.39461769230772,140.28411381947754,132.5051215651379,143.76230010000043,138.1009005999999,134.56260120000005,136.040501,138.36667,229381376,186607934.4,59.385470197902094,1.5,2.75,2.3451023041529173,1.2292155568707692,0.28810241203025144,1.0705889869219618,0.7824865748917104,21.262450272485612,3.703711201079623,1971445181.0,2008-04-24,2008,3,115,4,1.97,138.39,139.89,137.91,2088
2008-04-25 13:30:00,139.41,139.89,137.91,139.60001,126.12159631578945,128.29865384615385,143.7003501000004,138.0103006999999,134.62720140000005,136.44500200000002,135.93686030556566,136.48750104990077,136.60846384615388,140.85710794927238,132.35981974303544,143.7003501000004,138.0103006999999,134.62720140000005,136.44500200000002,139.13333666666665,190788064,187101403.2,62.896240223746155,1.5,2.75,2.3190235681419944,1.0197040788414569,0.339887289619909,1.2073456869165966,0.8674583972966876,16.65180424057062,5.017693900375674,2162233245.0,2008-04-25,2008,4,116,4,1.44,138.9,140.25,139.38,2089
2008-04-28 13:30:00,139.88,140.25,139.38,139.63,126.12343868421051,128.03423076923076,143.62655010000043,137.9298007999999,134.71640140000005,136.82800200000003,136.08168931319057,136.78678666419594,136.90077153846158,141.40985910988613,132.39168396703704,143.62655010000043,137.9298007999999,134.71640140000005,136.82800200000003,139.75333333333333,105616496,184047621.6,62.97699046906245,1.5,2.75,2.2155218847032807,0.5738541747067054,0.34853303340729513,1.3031246890558066,0.9545916556485116,16.14618787164011,4.795849234775638,2267849741.0,2008-04-28,2008,0,119,4,0.62,139.82,139.73,138.61,2090
2008-04-29 13:30:00,139.39,139.73,138.61,139.08,126.12528105263156,127.76980769230768,143.54770005000043,137.8570007999999,134.79520140000002,136.95150200000003,136.19927012443796,137.00518793427253,137.1361561538462,141.75489994322047,132.51741236447194,143.54770005000043,137.8570007999999,134.79520140000002,136.95150200000003,139.14,125514064,177595962.4,60.38160716605258,1.5,2.75,2.137270321510188,0.7067394005124071,0.2918787955738158,1.3194401501157813,1.0275613545419655,16.896630271818324,1.6295139474231788,2142335677.0,2008-04-29,2008,1,120,4,0.81,139.17,140.59,138.25999,2091
2008-04-30 13:30:00,139.28999,140.59,138.25999,138.25999,126.12712342105264,127.5053846153846,143.4648500000004,137.7515006999999,134.85000120000004,137.02950150000004,136.28008266857762,137.12469289291323,137.51154000000002,141.61234686881724,133.4107331311828,143.4648500000004,137.7515006999999,134.85000120000004,137.02950150000004,139.03665999999998,208395808,177470212.0,56.63413012881673,1.5,2.75,2.1510374414023183,1.1742579537798714,0.17936904487167493,1.2517726606315591,1.0724036157598842,10.036638609230216,0.8828821597956776,1933939869.0,2008-04-30,2008,2,121,4,1.69,139.42,141.12,138.27,2092
2008-05-01 13:30:00,138.39,141.12,138.27,141.12,126.12896578947368,127.24096153846152,143.3967000000004,137.6533006999999,134.95400120000002,137.23350200000004,136.46988334824127,137.5051983316834,138.1415407692308,141.71600902399703,134.56707251446457,143.3967000000004,137.6533006999999,134.95400120000002,137.23350200000004,140.17,187279504,178039949.6,64.83221506110318,1.5,2.75,2.2016783384450105,1.051895961669043,0.2721895487162877,1.4126405516552438,1.140451002938956,15.018123156536426,1.9064124783362328,2121219373.0,2008-05-01,2008,3,122,5,2.06,139.7,142.37,140.56,2093
2008-05-02 13:30:00,142.33,142.37,140.56,141.50999,126.13080815789472,126.97653846153842,143.3318999500004,137.55930059999991,135.08840120000002,137.46450150000004,136.6675345894867,137.88660706199926,138.77769307692307,141.47156962118126,136.08381653266494,143.3318999500004,137.55930059999991,135.08840120000002,137.46450150000004,141.47999666666666,181585504,176895572.0,65.78213682765791,1.5,2.75,2.173701314270367,1.0265124329963442,0.33058999298987457,1.5536884941762992,1.2230985011864246,14.253300051890983,2.13640562973654,2302804877.0,2008-05-02,2008,4,123,5,1.29,141.46,141.61,140.41,2094
2008-05-05 13:30:00,141.05,141.61,140.41,140.83,126.1326505263158,126.71211538461536,143.2606999000004,137.4468005999999,135.19260119999998,137.65800100000007,136.8307685271539,138.16693019895172,139.08384615384614,141.7361409914391,136.43155131625326,143.2606999000004,137.4468005999999,135.19260119999998,137.65800100000007,140.95000000000005,118510368,175102024.8,62.606742462250345,1.5,2.75,2.104151220393913,0.6768075248436533,0.2953180575636023,1.5922460731409274,1.2969280155773248,14.795519458478685,2.0951138176018667,2184294509.0,2008-05-05,2008,0,126,5,0.85,141.01,142.2,139.69,2095
2008-05-06 13:30:00,140.00999,142.2,139.69,142.05,126.13449289473684,126.4476923076923,143.2034499000004,137.38820059999992,135.28700120000002,137.91950050000008,137.0354442711871,138.53674637048013,139.46846153846158,142.2751092640944,136.6618138128287,143.2034499000004,137.38820059999992,135.28700120000002,137.91950050000008,141.31333333333333,179339808,176622152.8,65.79679935985448,1.5,2.75,2.1331404189372045,1.0153868309094691,0.3237629359032073,1.7016316854563345,1.377868749553127,14.738301445446329,3.1440604124310285,2363634317.0,2008-05-06,2008,1,127,5,1.8,140.94,142.03999,139.13,2096
2008-05-07 13:30:00,141.89,142.03999,139.13,139.52,126.13633526315789,126.1832692307692,143.1311999000004,137.28970059999992,135.31020120000002,138.10400050000007,137.13287782917976,138.63038957329158,139.54846153846154,142.2965255972479,136.80039747967515,143.1311999000004,137.28970059999992,135.31020120000002,138.10400050000007,140.22999666666666,199267248,176804987.2,55.2670754079958,1.5,2.75,2.189344674727405,1.127045402710224,0.1505989906482934,1.5661174878634938,1.4155184972152004,18.95991045319394,0.8675462067997348,2164367069.0,2008-05-07,2008,2,128,5,2.09,140.58,140.32001,138.98,2097
2008-05-08 13:30:00,139.74001,140.32001,138.98,139.16,126.13817763157894,125.91884615384615,143.0704999000004,137.1907005999999,135.32900120000002,138.26100050000008,137.21237281627074,138.6808286615495,139.59538461538463,142.29403875730176,136.8967304734675,143.0704999000004,137.1907005999999,135.32900120000002,138.26100050000008,139.48667,178321184,176072656.0,53.94418604295458,1.5,2.75,2.128677912246877,1.0127704553965495,-0.0017108343519773859,1.4133799542752286,1.4150907886272062,18.96926878219868,-0.3151933871637981,1986045885.0,2008-05-08,2008,3,129,5,0.96,139.65,139.39,138.45,2098
2008-05-09 13:30:00,138.60001,139.39,138.45,138.89999,126.14002,125.65442307692308,143.0069498500004,137.10800049999992,135.36960100000002,138.53700000000006,137.27855388229938,138.70170116997335,139.66923,142.2317570395874,137.10670296041263,143.0069498500004,137.10800049999992,135.36960100000002,138.53700000000006,138.91333,152589632,172553472.0,52.958218446449564,1.5,2.75,2.0437723470863856,0.8843034581187679,-0.12658034053884706,1.256865362953647,1.3834457034924943,18.181183649981772,-0.522817446107565,1833456253.0,2008-05-09,2008,4,130,5,0.68,138.92,140.56,138.73,2099
2008-05-12 13:30:00,139.25,140.56,138.73,140.46001,126.14186236842104,125.39,142.9691499000004,137.06190049999992,135.50240100000002,138.91350100000002,137.4033168673072,138.8691591537854,139.88,142.20640985878043,137.55359014121956,142.9691499000004,137.06190049999992,135.50240100000002,138.91350100000002,139.91666999999998,150911440,172072947.2,57.92696288086894,1.5,2.75,2.0285028937230734,0.8770201385845736,-0.1112663557706779,1.2443627587791468,1.3556291145498247,19.383201203765946,0.9922418751797516,1984367693.0,2008-05-12,2008,0,133,5,1.32,139.64,140.89,139.73,2100
2008-05-13 13:30:00,140.8,140.89,139.73,140.48,126.1437047368421,125.12557692307692,142.9459999000004,137.00790049999992,135.642001,139.27550050000008,137.52397110780495,139.0225725677106,140.04615307692308,142.20572115454237,137.8865849993038,142.9459999000004,137.00790049999992,135.642001,139.27550050000008,140.36666666666667,159141872,171410584.8,57.98819813416094,1.5,2.75,1.9664669727428536,0.9284249988743986,-0.10691837734156916,1.2219811428728633,1.3288995202144325,19.174223901293797,1.6056778247994972,2143509565.0,2008-05-13,2008,1,134,5,0.83,140.31,142.2,140.46201000000002,2101
2008-05-14 13:30:00,141.07001,142.2,140.46201000000002,140.77,126.14554710526316,124.86115384615385,142.9129499000004,136.95680049999993,135.79760080000003,139.47150000000005,137.65126635847926,139.18899422792865,140.1361523076923,142.31130916775396,137.96099544763064,142.9129499000004,136.95680049999993,135.79760080000003,139.47150000000005,141.14400333333333,181910752,171042681.6,58.9222567238669,1.5,2.75,1.9501471889755069,1.063540107640595,-0.0921965114361436,1.213653880919253,1.3058503923553966,18.662433887099606,-0.24801587301586894,2325420317.0,2008-05-14,2008,2,135,5,1.24,141.33,142.63,140.83,2102
2008-05-15 13:30:00,141.03999,142.63,140.83,142.53,126.1473894736842,124.59673076923076,142.8969999000004,136.91410049999996,135.9716008,139.74550000000005,137.84258924638203,139.5071852538402,140.35922923076924,142.85255215888438,137.86590630265414,142.8969999000004,136.91410049999996,135.9716008,139.74550000000005,141.99666666666667,166927008,170403656.8,64.13402192676628,1.5,2.75,1.943708104048684,0.9795975692934776,0.02227786193728809,1.3336977197770068,1.3114198578397187,16.11927453501072,0.7208042343865713,2492347325.0,2008-05-15,2008,3,136,5,1.28,141.73,142.87,141.61,2103
2008-05-16 13:30:00,142.86,142.87,141.61,142.66,126.14923184210524,124.33230769230768,142.8781499500004,136.85940049999996,136.20360079999998,139.95450000000002,138.03150731515137,139.80745332490304,140.63461384615385,143.28764603083505,137.9815816614727,142.8781499500004,136.85940049999996,136.20360079999998,139.95450000000002,142.38,204236816,169688969.6,64.4923783694551,1.5,2.75,1.8948718109023484,1.2035951216006442,0.08920067087583837,1.422920696434517,1.3337200255586783,16.080146029656436,1.2994390399772662,2696584141.0,2008-05-16,2008,4,137,5,0.89,142.24,144.3,142.3,2104
2008-05-19 13:30:00,142.81,144.3,142.3,143.05,126.15107421052629,144.3,142.8553999000004,136.79760049999996,136.4704006,140.17950000000005,138.2283109498513,140.11626729395988,141.00307615384614,143.56346662798322,138.44268567970914,142.8553999000004,136.79760049999996,136.4704006,140.17950000000005,143.21666666666667,165704064,172044804.0,65.60273474788019,1.5,2.75,1.9023809672664664,0.9631448329006204,0.13920016244442054,1.5077202286142042,1.3685200661697834,15.693466168592213,0.7039774727208729,2862288205.0,2008-05-19,2008,0,140,5,1.41,143.3,142.34,141.0,2105
2008-05-20 13:30:00,142.27,142.34,141.0,141.89,126.15291657894736,144.39052631578951,142.8458499000004,136.72100049999997,136.74820060000002,140.37700000000004,138.37190659887673,140.28519421834466,141.0623069230769,143.66603519768702,138.45857864846678,142.8458499000004,136.72100049999997,136.74820060000002,140.37700000000004,141.74333333333334,178552000,172864100.8,59.629869300958134,1.5,2.75,1.9129251838902912,1.0329038775181016,0.07673674633152472,1.4644409990841891,1.3877042527526646,15.881071194860086,1.6986811926605332,2683736205.0,2008-05-20,2008,1,141,5,0.95,141.67,142.12,139.0,2106
2008-05-21 13:30:00,141.81,142.12,139.0,139.49001,126.1547589473684,144.48105263157896,142.8122499000004,136.63920059999995,136.88600060000002,140.46550050000005,138.41575379107763,140.20946238802608,140.90692384615386,143.62387234855453,138.18997534375322,142.8122499000004,136.63920059999995,136.88600060000002,140.46550050000005,140.20333666666667,252724816,175834891.2,49.57339831437273,1.5,2.75,1.9991448136124133,1.4372847975464842,-0.13224996958343405,1.222391790773372,1.3546417603568062,15.511025305730223,0.23714429433746456,2431011389.0,2008-05-21,2008,2,142,5,2.24,140.56,140.17,139.0,2107
2008-05-22 13:30:00,139.42999,140.17,139.0,139.50999,126.15660131578944,144.57157894736844,142.7709498500004,136.56130049999996,137.04900039999998,140.52499950000006,138.45866501495695,140.14284597011886,140.8053846153846,143.6230406995236,137.98772853124564,142.7709498500004,136.56130049999996,137.04900039999998,140.52499950000006,139.55999666666665,170820320,172906838.4,49.649528348723926,1.5,2.75,1.9399201840686688,0.987932701683128,-0.26738096586291826,1.0204155530281582,1.2877965188910765,15.425122232794509,0.4391648984279878,2601831709.0,2008-05-22,2008,3,143,5,0.84,139.58,139.6631,137.52,2108
2008-05-23 13:30:00,139.05,139.6631,137.52,137.64,126.15844368421051,144.6621052631579,142.70999985000037,136.47560039999996,137.16880060000003,140.42699900000005,138.42656050456648,139.90447968725042,140.46615384615387,143.64187610163842,137.2904315906693,142.70999985000037,136.47560039999996,137.16880060000003,140.42699900000005,138.27436666666665,181436192,172439244.8,43.09224529204803,1.5,2.75,1.9544330280637623,1.0521745917551129,-0.4691408925582254,0.7013704031932946,1.17051129575152,17.329901720012145,-2.0076959983129887,2420395517.0,2008-05-23,2008,4,144,5,1.56,138.59,139.0,137.53,2109
2008-05-27 13:30:00,137.8,139.0,137.53,138.66,126.16028605263156,144.75263157894742,142.67634985000038,136.41290049999995,137.3498006,140.37849900000003,138.4357149945835,139.78595781227415,140.40000000000003,143.68572815021446,137.11427184978558,142.67634985000038,136.41290049999995,137.3498006,140.37849900000003,138.39666666666665,168322816,175574560.8,47.18933971029235,1.5,2.75,1.919830668916351,0.9586970642731062,-0.5165842760234991,0.5247809507221461,1.0413652267456452,16.481874312974373,-1.2955580865603598,2588718333.0,2008-05-27,2008,1,148,5,1.07,138.26,140.0,138.0,2110
2008-05-28 13:30:00,139.17,140.0,138.0,139.3,126.16212842105264,144.8431578947369,142.6492998000004,136.35730049999992,137.5698006,140.38949900000006,138.4696085242077,139.7396761158671,140.41076923076923,143.6810514161171,137.14048704542137,142.6492998000004,136.35730049999992,137.5698006,140.38949900000006,139.1,181288064,178363260.8,49.639309253261345,1.5,2.75,1.92555704970804,1.0163980137326576,-0.4878912914340774,0.43150111245304856,0.919392403887126,16.818438085276426,-1.0442565887618092,2770006397.0,2008-05-28,2008,2,149,5,1.45,139.0,140.92999,139.08,2111
2008-05-29 13:30:00,139.13,140.92999,139.08,140.0,126.16397078947368,144.93368421052637,142.6231498000004,136.34420049999994,137.6972006,140.47649950000005,138.52962387619954,139.7644688667369,140.49538538461542,143.6601491730905,137.3306215961403,142.6231498000004,136.34420049999994,137.6972006,140.47649950000005,140.00333,173927184,176639829.6,52.24863117413252,1.5,2.75,1.9201594033003224,0.9846430694247,-0.4080405772471147,0.4093416823282325,0.8173822595753473,17.08734775617895,-1.7750648986178357,2943933581.0,2008-05-29,2008,3,150,5,1.33,140.0,140.74001,139.94,2112
2008-05-30 13:30:00,140.47,140.74001,139.94,140.35001,126.16581315789473,145.0242105263158,142.6098499000004,136.33580059999994,137.8978006,140.43800000000005,138.60101156732895,139.82023468895244,140.48692384615387,143.65260879015432,137.32123890215342,142.6098499000004,136.33580059999994,137.8978006,140.43800000000005,140.34333999999998,117361936,173143951.2,53.5447298601695,1.5,2.75,1.8401487316360143,0.6778286806244491,-0.3217166327689547,0.41523646861415386,0.7369531013831085,15.176620872058587,-1.6192275339969149,3061295517.0,2008-05-30,2008,4,151,5,0.57,140.34,139.86,138.0,2113
2008-06-02 13:30:00,139.83,139.86,138.0,138.89999,126.16765552631578,145.11473684210532,142.59914990000038,136.33570049999992,138.0342004,140.30750000000006,138.61273621174743,139.73259233762363,140.36538461538464,143.6421725209005,137.0885967098688,142.59914990000038,136.33570049999992,138.0342004,140.30750000000006,138.91999666666666,181069872,173118169.6,47.761048950856036,1.5,2.75,1.8765673936620133,1.0459322231650952,-0.3500010888837102,0.2994517402784709,0.6494528291621811,15.875253428219276,-2.9010905277874928,2880225645.0,2008-06-02,2008,0,154,6,1.35,138.93,139.62,137.23,2114
2008-06-03 13:30:00,139.3,139.62,137.23,138.09,126.16949789473685,145.20526315789473,142.5790998500004,136.31290049999993,138.1016004,140.17050000000006,138.5922367524632,139.5761549721357,140.15923076923082,143.63917422184014,136.67928731662144,142.5790998500004,136.31290049999993,138.1016004,140.17050000000006,138.31333333333336,272049920,180795147.2,44.84690867644407,1.5,2.75,1.9132411512575849,1.5047412732768306,-0.406994209576324,0.14071006719177606,0.5477042767681001,15.568408824522024,-2.6781309465078458,2608175725.0,2008-06-03,2008,1,155,6,1.74,138.43,139.16,137.46001,2115
2008-06-04 13:30:00,137.7,139.16,137.46001,138.02,126.17134026315789,145.29578947368427,142.5456498000004,136.28020059999994,138.16500019999998,139.96900000000005,138.56979609550388,139.4279497366942,139.8123076923077,143.17493758662368,136.44967779799168,142.5456498000004,136.28020059999994,138.16500019999998,139.96900000000005,138.21333666666666,246726368,184164475.2,44.59367994732935,1.5,2.75,1.8980089261677564,1.3397066276330367,-0.4308416363051824,0.009152231386622134,0.4399938676918045,15.356190658663035,-1.0538460782962178,2361449357.0,2008-06-04,2008,2,156,6,1.24,138.31,140.89,138.32001,2116
2008-06-05 13:30:00,138.58,140.89,138.32001,140.78,126.17318263157894,145.38631578947368,142.5263498000004,136.28650069999995,138.31660019999998,140.03200000000007,138.6564707584253,139.5567164284376,139.6676923076923,142.67045305637805,136.66493155900665,142.5263498000004,136.28650069999995,138.31660019999998,140.03200000000007,139.99667,237867008,186094463.2,55.308823151642905,1.5,2.75,1.967436860012915,1.2782057236402509,-0.2510778988377925,0.1261464941445638,0.3772243929823563,17.248282773931905,0.910336241870574,2599316365.0,2008-06-05,2008,3,157,6,1.86,139.61,139.8,136.22,2117
2008-06-06 13:30:00,139.55,139.8,136.22,136.28999,126.175025,145.4768421052632,142.4831498000004,136.23660059999992,138.38680000000002,139.88849950000008,138.5636675914282,139.24559962572928,139.14769153846157,141.96289840469132,136.33248467223186,142.4831498000004,136.23660059999992,138.38680000000002,139.88849950000008,137.4366633333333,384276224,196392215.2,41.31179952040603,1.5,2.75,2.152619941440564,1.9566774762872576,-0.4152245839548871,-0.14180633696125255,0.2734182469936345,25.771447391341557,-0.9808267945364704,2215040141.0,2008-06-06,2008,4,158,6,2.63,138.01,137.5,135.41,2118
2008-06-09 13:30:00,136.86,137.5,135.41,136.62,126.17686736842104,145.56736842105266,142.4329998500004,136.22110059999994,138.48900020000002,139.77450000000007,138.48744533294084,138.99554251851694,138.74230692307694,141.37290255122616,136.11171129492772,142.4329998500004,136.22110059999994,138.48900020000002,139.77450000000007,136.51,228263872,200175927.2,42.46430530671634,1.5,2.75,2.148147088480524,1.140316296734006,-0.4777740220499756,-0.323799280568835,0.1539747414811406,24.853921829779857,-1.4712245781047109,2443304013.0,2008-06-09,2008,0,161,6,1.54,136.45,137.10001,135.35001,2119
2008-06-10 13:30:00,135.67,137.10001,135.35001,135.94,126.1787097368421,145.6578947368421,142.3800998500004,136.21070059999994,138.56840019999999,139.54849950000008,138.38754551596278,138.70453846913438,138.46922923076926,141.44681442054141,135.49164404099707,142.3800998500004,136.21070059999994,138.56840019999999,139.54849950000008,136.13000666666667,260234816,205642096.0,40.69110303151243,1.5,2.75,2.119708010731915,1.2654744386577348,-0.536732864066884,-0.5169413386024644,0.019791525464419615,24.384448507266878,-2.4120603015075472,2183069197.0,2008-06-10,2008,1,162,6,1.29,136.23,136.2592,133.92999,2120
2008-06-11 13:30:00,135.97,136.2592,133.92999,133.94,126.18055210526316,145.74842105263158,142.30814985000038,136.21580069999993,138.51500019999997,139.22149950000008,138.21313196631715,138.25077290064542,138.0407684615385,141.79714791004162,134.28438901303537,142.30814985000038,136.21580069999993,138.51500019999997,139.22149950000008,134.70973,284064256,211888215.2,35.93783859032061,1.5,2.75,2.1346724385367777,1.340632633730354,-0.6733664635722274,-0.8219165540008646,-0.14855009042863726,25.00349749039368,-4.32857142857143,1899004941.0,2008-06-11,2008,2,163,6,1.74,135.09,135.87,133.52,2121
2008-06-12 13:30:00,134.60001,135.87,133.52,134.45,126.1823944736842,145.83894736842106,142.24564985000038,136.23970069999996,138.47000020000002,138.90549950000008,138.06555816371647,137.88879452915538,137.79538384615387,142.01289248679632,133.57787520551145,142.24564985000038,136.23970069999996,138.47000020000002,138.90549950000008,134.61333333333332,252791744,215432264.8,37.92899845846581,1.5,2.75,2.1500529786412934,1.173416360054903,-0.6898054626379732,-1.0108069187261035,-0.3210014560881306,24.854584350727034,-4.203783099124831,2151796685.0,2008-06-12,2008,3,164,6,1.76,134.7,136.52,134.418,2122
2008-06-13 13:30:00,135.17,136.52,134.418,136.14999,126.18423684210524,145.92947368421054,142.20779980000037,136.29400059999998,138.4522002,138.58649900000006,137.9904378435707,137.7231940978072,137.60230615384614,141.87328568704183,133.33132662065054,142.20779980000037,136.29400059999998,138.4522002,138.58649900000006,135.69599666666667,244727056,219322267.2,44.15939297763021,1.5,2.75,2.1466206230240585,1.1158331487465127,-0.5525324672603198,-1.0116670401635304,-0.4591345729032106,26.441019508042068,-1.9798417552081895,2396523741.0,2008-06-13,2008,4,165,6,1.56,135.47,136.92999,135.46001,2123
2008-06-16 13:30:00,135.55,136.92999,135.46001,136.23,126.1860792105263,146.02,142.1562498500004,136.31770059999997,138.43900019999998,138.26499900000005,137.92140106539148,137.58098513611128,137.36615230769232,141.57457545617183,133.15772915921283,142.1562498500004,136.31770059999997,138.43900019999998,138.26499900000005,136.20666666666668,185833376,218402095.2,44.44204728996024,1.5,2.75,2.0982891499509106,0.85087725843392,-0.428235854684919,-0.9944293912593594,-0.5661935365744404,26.073533564863762,-1.3469476428416352,2582357117.0,2008-06-16,2008,0,168,6,1.09,136.2,137.12,135.37,2124
2008-06-17 13:30:00,137.07001,137.12,135.37,135.57001,126.18792157894735,146.11052631578946,142.1033499500004,136.32350059999996,138.4112002,137.89099950000005,137.82918965106242,137.38946369457688,137.02538384615386,141.03842241045652,133.0123452818512,142.1033499500004,136.32350059999996,138.4112002,137.89099950000005,136.02000333333334,191743808,219704082.4,42.52966288496261,1.5,2.75,2.073411353525846,0.8727366642687382,-0.3648374563663124,-1.0222403570323308,-0.6574029006660185,26.025420713105305,-1.7750978119113272,2390613309.0,2008-06-17,2008,1,169,6,1.29,136.24,135.5235,133.71001,2125
2008-06-18 13:30:00,134.69,135.5235,133.71001,134.25,126.1897639473684,146.20105263157896,142.0366499500004,136.33560069999996,138.3598,137.50899950000004,137.68882927258937,137.09046715223622,136.55615230769232,140.32349597660834,132.78880863877626,142.0366499500004,136.33560069999996,138.3598,137.50899950000004,134.49450333333334,266970560,224125010.4,38.9221909229113,1.5,2.75,2.058167685416856,1.1911680875040798,-0.3842217238610225,-1.1376800554922966,-0.7534583316312741,26.39237274802066,-4.63844296064782,2123642749.0,2008-06-18,2008,2,170,6,1.36,134.62,135.24001,132.0,2126
2008-06-19 13:30:00,134.14999,135.24001,132.0,134.42,126.19160631578946,146.29157894736844,141.96334995000038,136.32740059999998,138.3316,137.25549900000004,137.56063988935054,136.83613694726137,136.2115376923077,139.87644638304158,132.5466290015738,141.96334995000038,136.32740059999998,138.3316,137.25549900000004,133.88666999999998,304310784,226704308.8,39.632375916042044,1.5,2.75,2.142584993601367,1.3423246589832791,-0.3585117308939669,-1.2015979952487328,-0.8430862643547659,22.45084940027374,-1.3720670168073248,2427953533.0,2008-06-19,2008,3,171,6,2.45,133.62,133.09,131.22,2127
2008-06-20 13:30:00,132.84,133.09,131.22,131.58,126.19344868421051,146.3821052631579,141.8823000000003,136.28410059999996,138.2428,136.85899950000004,137.32610499172895,136.3355524760936,135.7107684615385,139.94669789814208,131.47483902493488,141.8823000000003,136.28410059999996,138.2428,136.85899950000004,131.96333333333334,289275648,232627075.2,32.77595465324215,1.5,2.75,2.218114636915554,1.2435166790077925,-0.4971593367425735,-1.4645354352829827,-0.9673760985404092,17.884560909407295,-3.68906455862977,2138677885.0,2008-06-20,2008,4,172,6,1.43,132.16,132.23,131.32001,2128
2008-06-23 13:30:00,132.09,132.23,131.32001,131.45,126.19529105263157,146.47263157894741,141.79890000000034,136.24950059999998,138.2042,136.54949950000002,137.09566950185723,135.8702617640847,135.20538384615386,139.77337582328244,130.6373918690253,141.79890000000034,136.24950059999998,138.2042,136.54949950000002,131.66666999999998,165115680,231811049.6,32.498798588398664,1.5,2.75,2.124677162850157,0.7122856321340776,-0.5574759691508606,-1.6642210599789848,-1.1067450908281242,17.5757979828185,-3.302927762248057,1973562205.0,2008-06-23,2008,0,175,6,0.69,131.78,132.44,130.19,2129
2008-06-24 13:30:00,131.05,132.44,130.19,131.19,126.19713342105264,146.5631578947369,141.72449995000034,136.18770059999997,138.16940019999998,136.17599950000005,136.86407461943145,135.4245225484576,134.46769153846157,138.22120405644148,130.71417902048165,141.72449995000034,136.18770059999997,138.16940019999998,136.17599950000005,131.27333333333334,267300624,236759940.0,31.917482497694483,1.5,2.75,2.133628794075146,1.128994305371086,-0.5725600631873047,-1.8224451698122548,-1.2498851066249503,17.589691971390547,-2.0531581305061968,1706261581.0,2008-06-24,2008,1,176,6,1.73,131.32,133.39999,131.239,2130
2008-06-25 13:30:00,131.72,133.39999,131.239,131.81,126.19897578947369,146.65368421052636,141.6546000000003,136.11000059999998,138.14079999999998,135.80149950000003,136.66587561474788,135.08028230574735,134.12307692307695,137.9656507929833,130.28050305317058,141.6546000000003,136.11000059999998,138.14079999999998,135.80149950000003,132.14966333333334,287853824,242088228.0,34.907534782417606,1.5,2.75,2.139083165926922,1.1890451112724076,-0.5010380209769729,-1.8761826328461664,-1.3751446118691937,16.556581315418367,-1.9635552249906931,1994115405.0,2008-06-25,2008,2,177,6,1.65,132.32,131.42,128.08,2131
2008-06-26 13:30:00,130.57001,131.42,128.08,128.23,126.20081815789473,146.7442105263158,141.5582999500003,136.01410049999996,137.96839979999996,135.21299950000005,136.33505696318917,134.42787446710474,133.47769230769234,138.15386494284294,128.8015196725417,141.5582999500003,136.01410049999996,137.96839979999996,135.21299950000005,129.24333333333334,297775104,248280624.0,27.41935271955153,1.5,2.75,2.252720082646426,1.199348943153937,-0.6458744550788841,-2.182487680717798,-1.536613225638915,21.750627040295207,-5.817106560198803,1696340301.0,2008-06-26,2008,3,178,6,2.61,129.75,128.86,127.035,2132
2008-06-27 13:30:00,128.28,128.86,127.035,127.53,126.20266052631578,146.83473684210531,141.45659995000034,135.94810049999998,137.77799979999998,134.57199900000006,135.98976061169157,133.7709340416662,132.83076923076922,138.23555004061708,127.4259884209214,141.45659995000034,135.94810049999998,137.77799979999998,134.57199900000006,127.80833333333334,303423232,257583688.8,26.234329444692786,1.5,2.75,2.2221686481716834,1.1779598056598684,-0.7334606750416257,-2.4534390694409467,-1.719978394399321,18.76571740331475,-6.386258533362688,1392917069.0,2008-06-27,2008,4,179,6,1.44,127.95,128.91,127.3,2133
2008-06-30 13:30:00,127.89,128.91,127.3,127.98,126.20450289473685,146.92526315789473,141.35194995000032,135.89740049999997,137.56799979999997,134.02599950000007,135.67565235240951,133.21941651388846,132.37230769230771,138.30798908458678,126.43662630002865,141.35194995000032,135.89740049999997,137.56799979999997,134.02599950000007,128.06333333333333,258888192,261474604.8,28.37731592617816,1.5,2.75,2.17844231615942,0.9901083594639016,-0.7055101368905174,-2.601866065512468,-1.8963559286219505,19.241966278066066,-5.59859072076486,1651805261.0,2008-06-30,2008,0,182,6,1.26,128.1,128.47,125.92998999999999,2134
2008-07-01 13:30:00,126.52,128.47,125.92998999999999,128.38,126.20634526315789,147.01578947368426,141.2493500000003,135.84190059999997,137.36459979999995,133.54049950000007,135.38954833858952,132.75851970304194,131.90538461538463,138.06461812107554,125.7461511096937,141.2493500000003,135.84190059999997,137.36459979999995,133.54049950000007,127.59333000000001,388621824,267303200.0,30.315232830222318,1.5,2.75,2.2042685792908894,1.4538614726647492,-0.6081914933474257,-2.656595295306232,-2.0484038019588064,19.981360947671227,-4.372439478584734,2040427085.0,2008-07-01,2008,1,183,7,2.02,127.2,129.16,125.95,2135
2008-07-02 13:30:00,128.78999,129.16,125.95,126.17998999999999,126.20818763157894,147.10631578947368,141.13974990000034,135.77300039999997,137.12939959999997,132.94849900000006,135.0283891880566,132.131993064657,131.13846153846154,137.47297644384,124.8039466330831,141.13974990000034,135.77300039999997,137.12939959999997,132.94849900000006,127.09666333333332,291223296,269528046.4,26.127892282442176,1.5,2.75,2.2761065379129684,1.0804934769860746,-0.6370362419988901,-2.844699104457419,-2.207662862458529,21.011280309148127,-6.130047611962493,1749203789.0,2008-07-02,2008,2,184,7,2.55,127.56,127.11,124.99001000000001,2136
2008-07-03 13:30:00,127.11,127.11,124.99001000000001,126.31,126.21003,147.1968421052632,141.00899985000038,135.69860039999998,136.90119959999996,132.22499900000003,134.68649157283872,131.57751753468966,130.37538461538463,136.45764914501348,124.29312008575577,141.00899985000038,135.69860039999998,136.90119959999996,132.22499900000003,126.13667,239359632,269602677.6,26.771607332338675,1.5,2.75,2.264955356633471,0.8878236452648643,-0.5932973037956839,-2.949284492203134,-2.3559871884074504,20.98113165069498,-4.0051679586563385,1988563421.0,2008-07-03,2008,3,185,7,1.7,126.05,127.34,123.92,2137
2008-07-07 13:30:00,126.78998999999999,127.34,123.92,125.02,126.21187236842104,147.28736842105266,140.86729985000034,135.5989003,136.63519939999998,131.66149950000005,134.30741347194305,130.9529920551954,129.5638453846154,135.46989379332032,123.65779697591049,140.86729985000034,135.5989003,136.63519939999998,131.66149950000005,125.42666666666666,372427264,269010229.6,24.491159438596142,1.5,2.75,2.3474585454453663,1.3844353226038062,-0.5956266604981044,-3.1005205140300798,-2.5048938535319762,18.92397174646231,-4.891593761886644,1616136157.0,2008-07-07,2008,0,189,7,2.76,125.63,127.39,124.2,2138
2008-07-08 13:30:00,124.99001000000001,127.39,124.2,127.24001000000001,126.21371473684208,147.3778947368421,140.74209990000037,135.50760039999997,136.38799939999998,131.19250000000005,134.03026039461196,130.59937471660538,129.0246153846154,134.37466194881816,123.67456882041263,140.74209990000037,135.50760039999997,136.38799939999998,131.19250000000005,126.27667,376225280,276408300.0,34.78634445948901,1.5,2.75,2.4076400779135545,1.361121500331213,-0.4013504314099627,-3.006581892794429,-2.6052314613844665,22.970173240353752,-3.0108925985212287,1992361437.0,2008-07-08,2008,1,190,7,2.57,125.8,127.74001000000001,124.39,2139
2008-07-09 13:30:00,127.5,127.74001000000001,124.39,124.78998999999999,126.21555710526314,147.46842105263158,140.60619985000037,135.40380029999997,136.09119919999998,130.63499950000005,133.66789684972522,130.0460999816906,128.2838453846154,133.07848979333164,123.48920097589918,140.60619985000037,135.40380029999997,136.09119919999998,130.63499950000005,125.64,336789760,280236047.2,29.935452867326322,1.5,2.75,2.4749522152054437,1.2018074168725286,-0.3911455567268916,-3.0941634072930815,-2.703017850566189,24.729542593831077,-5.3258553979212495,1655571677.0,2008-07-09,2008,2,191,7,2.69,126.07,125.78998999999999,123.58,2140
2008-07-10 13:30:00,124.42998999999999,125.78998999999999,123.58,125.3,126.2173994736842,147.5589473684211,140.47424985000038,135.30540029999997,135.81559919999998,130.20299950000006,133.33974403208893,129.5940904596248,127.80076846153848,132.43236475467543,123.16917216840149,140.47424985000038,135.30540029999997,135.81559919999998,130.20299950000006,124.88999666666666,436475648,287856616.8,32.05936299505977,1.5,2.75,2.456026342690769,1.5162953447176066,-0.3070542980492017,-3.086835723127692,-2.7797814250784905,24.64083218462965,-2.284956718396625,2092047325.0,2008-07-10,2008,3,192,7,1.79,124.68,125.89998999999999,122.49001000000001,2141
2008-07-11 13:30:00,123.97,125.89998999999999,122.49001000000001,123.84,126.21924184210523,147.64947368421056,140.33649985000037,135.18860029999996,135.5271994,129.67249950000007,132.9672050504384,129.04608184442245,127.21538384615386,131.77723208107508,122.65353561123257,140.33649985000037,135.18860029999996,135.5271994,129.67249950000007,124.07666666666668,481124608,299273260.0,29.319359350119754,1.5,2.75,2.5241658896414285,1.6076431552889157,-0.30608228507641666,-3.16238428142401,-2.8563019963475935,20.73414103818585,-2.893436838390965,1610922717.0,2008-07-11,2008,4,193,7,2.78,124.2,125.5,122.39998999999999,2142
2008-07-14 13:30:00,125.25998999999999,125.5,122.39998999999999,122.72,126.2210842105263,147.74000000000004,140.18914985000038,135.05660029999996,135.1591994,129.00100000000006,132.56535387198983,128.44359785923936,126.56384538461538,131.08818517902435,122.03950559020642,140.18914985000038,135.05660029999996,135.1591994,129.00100000000006,123.53999666666668,322720768,303172945.6,27.38574166724513,1.5,2.75,2.5652976118098976,1.0644774630576403,-0.33486313041052185,-3.2748809093607463,-2.9400177789502244,20.962714737650884,-4.11001719018597,1288201949.0,2008-07-14,2008,0,196,7,2.53,123.95,123.49001000000001,120.02,2143
2008-07-15 13:30:00,121.8,123.49001000000001,120.02,120.99001000000001,120.02,147.8305263157895,140.02864990000037,134.91860049999997,134.74879980000003,128.23900050000006,132.1114188181863,127.73373234883562,125.73153846153845,130.06623974416783,121.39683717890912,140.02864990000037,134.91860049999997,134.74879980000003,128.23900050000006,121.50000666666666,502502400,319006396.8,24.67839821377736,1.5,2.75,2.6299199252520475,1.575211046050096,-0.4189486673943037,-3.4637036131931036,-3.0447549457988003,21.14912799403632,-5.756340551487769,785699549.0,2008-07-15,2008,1,197,7,2.89,121.76,124.57001000000001,121.10001000000001,2144
2008-07-16 13:30:00,121.45,124.57001000000001,121.10001000000001,123.96001000000001,119.947108313253,147.921052631579,139.88554995000038,134.80200059999996,134.4114,127.65850050000006,131.79175572727706,127.37433022037509,125.40307769230768,129.5747695926556,121.23138579195978,139.88554995000038,134.80200059999996,134.4114,127.65850050000006,123.21001000000001,371642880,328001350.4,36.31788576499756,1.5,2.75,2.6977827877340443,1.13305289611393,-0.2323929603567536,-3.3352461462447422,-3.1028531858879886,26.99504506729221,-1.7593756347579412,1157342429.0,2008-07-16,2008,2,198,7,2.87,122.84,126.25998999999999,124.09,2145
2008-07-17 13:30:00,125.14,126.25998999999999,124.09,125.2,119.87421662650604,148.01157894736846,139.74004995000038,134.68070059999997,134.0744,127.20600050000004,131.53325550267795,127.16725115176793,125.22384692307692,129.21073418455006,121.23695966160379,139.74004995000038,134.68070059999997,134.0744,127.20600050000004,125.18333,375490560,333427350.4,40.45507585920046,1.5,2.75,2.6693683028958985,1.1261540468996871,0.004140350793290892,-3.097677747396375,-3.1018180981896664,26.42770371841732,-0.878790277887736,1532832989.0,2008-07-17,2008,3,199,7,1.75,125.17,126.41588999999999,125.14998999999999,2146
2008-07-18 13:30:00,126.17,126.41588999999999,125.14998999999999,125.98,119.80132493975904,148.10210526315794,139.59949995000036,134.55690059999995,133.8036,126.78400050000003,131.31548077708274,127.05417961350432,125.07000076923076,128.76312631649722,121.37687522196435,139.59949995000036,134.55690059999995,133.8036,126.78400050000003,125.84862666666668,267030000,331563311.2,42.965165833826255,1.5,2.75,2.5691205669747634,0.8053665498560747,0.2302342650742601,-2.8140252668468406,-3.0442595319211008,26.72236211576844,0.7678771396576611,1799862989.0,2008-07-18,2008,4,200,7,1.01,125.78,126.8,125.19,2147
2008-07-21 13:30:00,126.50998999999999,126.8,125.19,126.05,119.72843325301204,148.19263157894738,139.46084995000038,134.43520059999994,133.54139999999998,126.50750050000006,131.1089913348442,126.95854345983723,124.89076999999999,128.12110786720544,121.66043213279457,139.46084995000038,134.43520059999994,133.54139999999998,126.50750050000006,126.01333333333334,222863008,328242679.2,43.19658913163206,1.5,2.75,2.500611955047994,0.6789580457458074,0.39209745928107065,-2.5541377078197627,-2.9462351671008333,25.952381979554573,-0.9352482760729119,2022725997.0,2008-07-21,2008,0,203,7,1.29,126.0,127.8,124.85001000000001,2148
2008-07-22 13:30:00,125.14998999999999,127.8,124.85001000000001,127.48,119.65554156626507,148.2831578947369,139.32814995000038,134.34130059999995,133.31300019999998,126.30900050000008,130.96667794916405,127.0082059874718,124.99077076923079,128.44713794512765,121.5344035933339,139.32814995000038,134.34130059999995,133.31300019999998,126.30900050000008,126.71000333333332,296904192,334832104.8,47.85169706949112,1.5,2.75,2.5327103868302805,0.8867255790102478,0.5911152997638363,-2.2073410423960382,-2.7984563421598745,24.682422522448977,2.155629630229156,2319630189.0,2008-07-22,2008,1,204,7,2.36,126.33,129.14999,127.55,2149
2008-07-23 13:30:00,127.89,129.14999,127.55,128.17,119.58264987951807,148.3736842105263,139.18974990000038,134.28480049999996,133.0672,126.15800050000007,130.85700430409878,127.11885303628401,125.13384769230773,128.93372827095868,121.33396711365671,139.18974990000038,134.28480049999996,133.0672,126.15800050000007,128.28999666666667,311698432,337051995.2,49.98170848452073,1.5,2.75,2.471087502056689,0.9247784805873772,0.7544157661041999,-1.8554366345296245,-2.6098524006338244,21.35269976155785,2.2905027932960818,2631328621.0,2008-07-23,2008,2,205,7,1.25,128.35,128.41,125.16,2150
2008-07-24 13:30:00,128.34,128.41,125.16,125.50998999999999,119.50975819277107,148.4642105263158,139.04219985000037,134.20490039999996,132.76779979999998,125.84300000000007,130.6473174686439,126.96562798520935,125.17153923076923,128.9758729377483,121.36720552379019,139.04219985000037,134.20490039999996,132.76779979999998,125.84300000000007,126.35999666666667,248634496,335091028.8,42.73494963391856,1.5,2.75,2.52672410905264,0.7419909058454626,0.671259515906443,-1.7707780057507705,-2.442037521657213,25.226409326617194,1.3485061369509033,2382694125.0,2008-07-24,2008,3,206,7,2.6,126.78,126.49001000000001,125.17,2151
2008-07-25 13:30:00,125.89,126.49001000000001,125.17,125.48,119.43686650602407,148.55473684210529,138.88719985000037,134.12980029999994,132.46199979999997,125.70550000000007,130.44467756791278,126.8241396056656,125.03615384615387,128.6572629279736,121.41504476433417,138.88719985000037,134.12980029999994,132.46199979999997,125.70550000000007,125.71333666666668,219131008,331158824.0,42.65985136432013,1.5,2.75,2.4405302441203083,0.6617097057936164,0.6042999544623404,-1.6866625785792877,-2.290962533041628,24.08397444673725,2.249022164276406,2163563117.0,2008-07-25,2008,4,207,7,1.05,125.83,126.06,123.42,2152
2008-07-28 13:30:00,125.50998999999999,126.06,123.42,123.64,119.36397481927709,148.64526315789473,138.72429985000036,134.02790029999994,132.0841998,125.51100000000004,130.17782746721036,126.52088821464982,124.94769307692309,128.64394151245546,121.25144464139076,138.72429985000036,134.02790029999994,132.0841998,125.51100000000004,124.37333333333332,205202880,326247806.4,38.22187703936858,1.5,2.75,2.4547780838260005,0.6289785738770871,0.4341143630832045,-1.7483195791876227,-2.182433942270827,25.17623565286221,2.1902552119799004,1958360237.0,2008-07-28,2008,0,210,7,2.14,124.74,126.38,123.64,2153
2008-07-29 13:30:00,123.98,126.38,123.64,126.28,119.29108313253012,148.73578947368426,138.57834985000034,133.98010029999998,131.75659979999998,125.42600000000007,130.02497148810406,126.49794647992128,125.02307769230772,128.78439355297135,121.2617618316441,138.57834985000034,133.98010029999998,131.75659979999998,125.42600000000007,125.43333333333332,261505568,326378675.2,46.777158329279395,1.5,2.75,2.4751510778384294,0.8012336217730931,0.4930638053371306,-1.5661041855994142,-2.059167990936545,25.659140632582396,1.8715632565696017,2219865805.0,2008-07-29,2008,1,211,7,2.22,125.01,128.60001,126.28,2154
2008-07-30 13:30:00,127.11,128.60001,126.28,128.53,119.21819144578312,148.82631578947368,138.4393498500003,133.96830019999996,131.46619979999997,125.43350000000008,129.96634515523724,126.69147538659544,125.38384692307696,129.50457086305082,121.26312298310312,138.4393498500003,133.96830019999996,131.46619979999997,125.43350000000008,127.80333666666668,354710016,324683084.8,52.77916558605074,1.5,2.75,2.464069572278541,1.0924807376968717,0.6665277393788878,-1.2260083167129352,-1.8925360560918232,24.012002857666985,2.6597444089456856,2574575821.0,2008-07-30,2008,2,212,7,1.84,127.44,128.57001,126.63,2155
2008-07-31 13:30:00,127.39998999999999,128.57001,126.63,126.83,119.14529975903612,148.91684210526319,138.29844990000035,133.95660019999997,131.16499979999998,125.46600050000006,129.84335122758088,126.70466820691969,125.7000007692308,129.57822696172394,121.82177457673764,138.29844990000035,133.95660019999997,131.16499979999998,125.46600050000006,127.34333666666666,277402112,323992025.6,48.34323021566942,1.5,2.75,2.4266367456872158,0.8562004311256727,0.6490749486783405,-1.0811923702438977,-1.730267318922238,25.433364999189507,0.6747102714716576,2297173709.0,2008-07-31,2008,3,213,7,1.53,127.6,127.28,125.46001000000001,2156
2008-08-01 13:30:00,127.12,127.28,125.46001000000001,126.16,119.07240807228916,149.00736842105266,138.16034990000034,133.89220009999997,130.89839959999995,125.45850050000006,129.69890608140125,126.65279504435591,126.09769230769234,128.8630605413216,123.33232407406307,138.16034990000034,133.89220009999997,130.89839959999995,125.45850050000006,126.30000333333332,248703568,324459222.4,46.678106577702074,1.5,2.75,2.383304835280987,0.7665171794481871,0.5771269783385893,-1.0088585959990013,-1.5859855743375906,25.47645208973348,0.08726695755652474,2048470141.0,2008-08-01,2008,4,214,8,1.45,126.37,126.14,124.75998999999999,2157
2008-08-04 13:30:00,126.03998999999999,126.14,124.75998999999999,124.99001000000001,118.99951638554217,149.0978947368421,138.01404995000036,133.82850019999995,130.60799999999998,125.45700100000006,129.51424348997378,126.49443456394106,126.17692307692309,128.74472767788984,123.60911847595636,138.01404995000036,133.82850019999995,130.60799999999998,125.45700100000006,125.29666666666664,188251744,315250446.4,43.83849777188578,1.5,2.75,2.3130694899037727,0.5971498094601906,0.4415705337850502,-1.0340224071062778,-1.4755929408913282,26.040230884126462,-1.95323972387826,1860218397.0,2008-08-04,2008,0,217,8,1.11,125.45,128.56,124.9736,2158
2008-08-05 13:30:00,126.02,128.56,124.9736,128.36,118.92662469879518,149.18842105263158,137.88739995000037,133.79560029999996,130.42239999999995,125.51300050000006,129.46897903938654,126.67210746261334,126.42000000000002,129.1640895702117,123.67591042978836,137.88739995000037,133.79560029999996,130.42239999999995,125.51300050000006,127.29786666666666,251624320,309020398.4,52.7539250745763,1.5,2.75,2.4040216691963603,0.8142644346548743,0.561976111527005,-0.7731228014825717,-1.3350989130095767,29.847561157755003,0.14824061792933305,2111842717.0,2008-08-05,2008,1,218,8,2.87,126.77,129.3,127.48,2159
2008-08-06 13:30:00,128.02,129.3,127.48,128.92999,118.85373301204821,149.2789473684211,137.7836999000004,133.78880019999994,130.22779979999996,125.72000050000004,129.44784221431254,126.8871438947454,126.64692230769234,129.68056043133498,123.61328418404966,137.7836999000004,133.78880019999994,130.22779979999996,125.72000050000004,128.5699966666667,209555376,302658679.2,54.081664620007714,1.5,2.75,2.362305835682335,0.6923818492630229,0.6565315507656486,-0.514434474552516,-1.1709660253181646,29.796952409092146,2.724882696588536,2321398093.0,2008-08-06,2008,2,219,8,1.43,128.39,129.0549,126.53998999999999,2160
2008-08-07 13:30:00,127.96001000000001,129.0549,126.53998999999999,127.00998999999999,118.78084132530121,149.36947368421056,137.66604990000036,133.77590009999997,129.98199959999994,125.80550000000004,129.35224016669244,126.89884352381728,126.72076769230772,129.73938846442056,123.70214692019488,137.66604990000036,133.77590009999997,129.98199959999994,125.80550000000004,127.53496,246312432,293150518.4,49.07837120143894,1.5,2.75,2.3732061331335967,0.8402251285256469,0.5695261586842657,-0.4590583269628326,-1.0285844856470985,28.383280930715962,1.219309850175325,2075085661.0,2008-08-07,2008,3,220,8,1.99,127.8,129.92999,126.38,2161
2008-08-08 13:30:00,126.58,129.92999,126.38,129.37,118.70794963855421,149.46000000000004,137.55409995000036,133.73330009999998,129.76939959999993,126.08200000000004,129.35293663074373,127.13419175964421,126.86615230769232,130.18423577392787,123.5480688414568,137.55409995000036,133.73330009999998,129.76939959999993,126.08200000000004,128.55999666666665,260811632,282134869.6,54.634005562466704,1.5,2.75,2.457262123624055,0.9244218283609136,0.6451250953690847,-0.2221781164357424,-0.8673032118048271,30.00732253528451,4.634422516984798,2335897293.0,2008-08-08,2008,4,221,8,2.81,128.15,131.50999,129.23,2162
2008-08-11 13:30:00,129.47,131.50999,129.23,130.71001,118.63505795180723,131.50999,137.45025000000035,133.7372001,129.57659959999992,126.48150050000008,129.40615519424398,127.4747458777733,127.06153769230772,130.91901376879358,123.20406161582187,137.45025000000035,133.7372001,129.57659959999992,126.48150050000008,130.48333333333332,249425808,278470121.6,57.471226194848526,1.5,2.75,2.4445998290794795,0.8957004312235699,0.7521138662911564,0.07283912105911837,-0.6792747452320379,27.941100864839964,3.50808520747546,2585323101.0,2008-08-11,2008,0,224,8,1.76,130.37,130.7028,128.73,2163
2008-08-12 13:30:00,130.28011,130.7028,128.73,129.35001,118.56216626506023,131.28947258620693,137.33780005000034,133.70990020000002,129.38559999999995,126.89950050000007,129.40395342192068,127.65334246084255,127.35692384615385,131.28143898466294,123.43240870764471,137.33780005000034,133.70990020000002,129.38559999999995,126.89950050000007,129.59427,213200816,264005042.4,53.794065621073386,1.5,2.75,2.4114148412880896,0.8075634240234496,0.6991460989060917,0.19465787840057655,-0.5044882205055151,27.377216029078628,0.6379911304753726,2372122285.0,2008-08-12,2008,1,225,8,1.53,129.72,129.64999,127.67,2164
2008-08-13 13:30:00,128.78999,129.64999,127.67,128.57001,118.48927457831324,131.06895517241378,137.21255010000036,133.6484003,129.19520019999993,127.13000050000008,129.37124975831594,127.74064413123848,127.59461692307691,131.40836423805288,123.78086960810094,137.21255010000036,133.6484003,129.19520019999993,127.13000050000008,128.63,256467184,258246257.6,51.7490125780925,1.5,2.75,2.380598781196084,0.9931109414071138,0.5841180797067584,0.2256593791279329,-0.3584587005788255,25.8858570688316,1.3719230465978065,2115655101.0,2008-08-13,2008,2,226,8,1.55,128.66,130.28,127.75,2165
2008-08-14 13:30:00,127.84,130.28,127.75,129.53999,118.41638289156626,130.84843775862066,137.08960005000034,133.59530009999997,129.02559999999994,127.34700000000008,129.37786702269568,127.91201040445387,128.0484623076923,131.22229624559327,124.87462836979131,137.08960005000034,133.59530009999997,129.02559999999994,127.34700000000008,129.18999666666664,239556064,251449532.8,54.08657265819551,1.5,2.75,2.391270296824935,0.9527003742358912,0.5465701678873556,0.3247540092803689,-0.2218161586069866,24.691647193124705,2.6791296766011348,2355211165.0,2008-08-14,2008,3,227,8,1.98,129.01,130.5,129.3,2166
2008-08-15 13:30:00,129.92999,130.5,129.3,130.17,118.34349120481927,130.62792034482754,136.97515005000034,133.5650001,128.81339999999994,127.55650000000007,129.40893106102138,128.12705703260113,128.34769307692306,131.53166382554258,125.16372232830355,136.97515005000034,133.5650001,128.81339999999994,127.55650000000007,129.99,181005376,247148301.6,55.59142122113369,1.5,2.75,2.3061795613374385,0.7323755608604191,0.5366117747766701,0.44894855986385096,-0.08766321491281909,24.261232293874105,4.144323214311279,2536216541.0,2008-08-15,2008,4,228,8,0.93,129.9,130.48,127.66,2167
2008-08-18 13:30:00,130.42999,130.48,127.66,128.39,118.27059951807227,130.40740293103448,136.84385010000034,133.52110009999996,128.65540019999997,127.67350000000006,129.368972980197,128.15209921997246,128.33692384615387,131.51930191127877,125.154545781029,136.84385010000034,133.52110009999996,128.65540019999997,127.67350000000006,128.84333333333333,172275056,244618904.0,50.550226916981494,1.5,2.75,2.3428810212419067,0.7042589643848621,0.3894437381597953,0.399141457786925,0.009697719627129729,25.21038934437839,0.0233717669055568,2363941485.0,2008-08-18,2008,0,231,8,2.21,129.07,128.1181,126.53,2168
2008-08-19 13:30:00,127.42,128.1181,126.53,126.99001000000001,118.1977078313253,130.18688551724136,136.72365015000034,133.47590029999995,128.46280039999996,127.64900050000006,129.27568031430692,128.04142405616557,128.34923230769232,131.50936185418058,125.18910276120405,136.72365015000034,133.47590029999995,128.46280039999996,127.64900050000006,127.21270333333332,194673632,239507376.0,46.94444479203887,1.5,2.75,2.308389519724627,0.8128085040687849,0.18735387622059305,0.24389006490287105,0.056536188682277985,21.051677222552076,-1.5046770731929828,2169267853.0,2008-08-19,2008,1,232,8,1.26,127.32,127.95,126.34,2169
2008-08-20 13:30:00,127.39,127.95,126.34,127.58,118.1248161445783,129.96636810344825,136.60555015000034,133.43200029999997,128.29560039999996,127.61950050000004,129.2091830470792,127.9974789079593,128.4584630769231,131.398883428519,125.51804272532715,136.60555015000034,133.43200029999997,128.29560039999996,127.61950050000004,127.29,225498128,235197360.8,48.608144983260495,1.5,2.75,2.2585045540300106,0.9587613025630516,0.08800281994463872,0.1665397136130764,0.07853689366843768,21.071505736626808,0.44879146908050016,2394765981.0,2008-08-20,2008,2,233,8,1.27,127.15,128.44,126.60001000000001,2170
2008-08-21 13:30:00,126.75,128.44,126.60001000000001,127.8,118.0519244578313,129.74585068965516,136.49430015000036,133.34390029999994,128.17280039999997,127.73400100000006,129.15392096680156,127.97867139291556,128.67461615384616,130.88617685479963,126.46305545289269,136.49430015000036,133.34390029999994,128.17280039999997,127.73400100000006,127.61333666666664,180609808,231796126.4,49.24724167117693,1.5,2.75,2.228610657313581,0.7791752640780972,0.034442129553068634,0.12158955560977347,0.08714742605670484,19.11977610978652,-1.2135734714385151,2575375789.0,2008-08-21,2008,3,234,8,1.45,127.52,129.64999,127.8,2171
2008-08-22 13:30:00,128.67,129.64999,127.8,129.64999,117.9790327710843,129.5253332758621,136.38220005000036,133.27340019999994,128.07680019999998,127.94250050000004,129.17337465437797,128.13784459359027,128.77384615384614,131.0352356173516,126.51245669034068,136.38220005000036,133.27340019999994,128.07680019999998,127.94250050000004,129.03332666666668,167715248,229225338.4,54.384337241371924,1.5,2.75,2.201566324648326,0.7316610335081525,0.11633334655223107,0.2325641092469937,0.1162307626947626,17.845749309692046,-0.8109707894598192,2743091037.0,2008-08-22,2008,4,235,8,1.45,128.72,129.64999,126.75,2172
2008-08-25 13:30:00,128.8,129.64999,126.75,127.02,117.90614108433736,129.30481586206895,136.27775005000035,133.17320029999996,127.8942004,128.11150050000006,129.0889285895004,128.03138320372454,128.62692384615386,131.0695638294271,126.18428386288058,136.27775005000035,133.17320029999996,127.8942004,128.11150050000006,127.80666333333332,171936880,227562038.4,47.08752373231655,1.5,2.75,2.251453730030589,0.7555604669781337,-0.007336682728015617,0.10705990928474307,0.11439659201275867,20.08110615266934,-1.8013218553288102,2571154157.0,2008-08-25,2008,0,238,8,2.29,128.2,127.87,126.58,2173
2008-08-26 13:30:00,127.02,127.87,126.58,127.39,117.83324939759035,129.08429844827586,136.17890005000035,133.07820029999996,127.7174004,128.16700050000003,129.02230393893174,127.97029908908414,128.65615538461537,131.0287871623931,126.28352360683763,136.17890005000035,133.07820029999996,127.7174004,128.16700050000003,127.27999999999996,159117184,222442619.2,48.14169228644628,1.5,2.75,2.182778463599833,0.7153178854495345,-0.0618964564428372,0.03702602145921219,0.0989224779020494,19.69345918828133,-0.9177956819012426,2730271341.0,2008-08-26,2008,1,239,8,1.02,127.22,128.83,127.3,2174
2008-08-27 13:30:00,127.55,128.83,127.3,128.63,117.76035771084335,128.8637810344827,136.09635005000035,132.99490019999993,127.57860020000001,128.17200050000002,129.00691947073835,128.03312774726658,128.5992323076923,130.93586215819371,126.26260245719091,136.09635005000035,132.99490019999993,127.57860020000001,128.17200050000002,128.25333333333333,171032752,213258756.0,51.62040708389257,1.5,2.75,2.1361514304855604,0.8019963878997775,-0.014616705297543525,0.08065159628011997,0.0952683015776635,20.42622104740695,-0.7024780533022995,2901304093.0,2008-08-27,2008,2,240,8,1.2,128.06,130.34,128.63,2175
2008-08-28 13:30:00,129.28,130.34,128.63,130.19,117.68746602409638,128.64326362068965,136.02880005000034,132.92860009999995,127.4974002,128.34000050000003,129.05331478561135,128.2385441522888,128.55923153846157,130.76403995670782,126.35442312021529,136.02880005000034,132.92860009999995,127.4974002,128.34000050000003,129.72,167537056,207765503.2,55.651025310931104,1.5,2.75,2.1057120425937352,0.8063757140603118,0.11447057123917664,0.2383565156266343,0.12388594438745765,21.183635315235925,0.01536452331567199,3068841149.0,2008-08-28,2008,3,241,8,1.33,129.49,130.14,128.50999,2176
2008-08-29 13:30:00,129.73,130.14,128.50999,128.78999,117.61457433734941,128.4227462068965,135.93235000000035,132.85819999999995,127.3848,128.47150000000005,129.0429883234305,128.29106280445177,128.51615307692308,130.67895963081648,126.35334652302969,135.93235000000035,132.85819999999995,127.3848,128.47150000000005,129.14666,189210000,204790824.8,51.503956247462355,1.5,2.75,2.075304753837041,0.9239183453886846,0.09890442680967547,0.247516477899552,0.14861205108987652,21.899540778263532,0.3115429550588072,2879631149.0,2008-08-29,2008,4,242,8,1.27,129.32,130.71001,127.52,2177
2008-09-02 13:30:00,130.03,130.71001,127.52,127.99001000000001,117.5416826506024,130.71001,135.83395005000037,132.77790009999993,127.3130002,128.62150000000003,129.001695055845,128.2623911087897,128.4715376923077,130.65191724023137,126.29115814438404,135.83395005000037,132.77790009999993,127.3130002,128.62150000000003,128.74000666666666,252469568,208001716.0,49.245720545463655,1.5,2.75,2.154926557134396,1.2137859862656133,0.031555413159305164,0.188056317539008,0.15650090437970282,20.69674013859829,0.7874635177995497,2627161581.0,2008-09-02,2008,1,246,9,2.5,129.12,128.5,126.92998999999999,2178
2008-09-03 13:30:00,127.88,128.5,126.92998999999999,127.88,117.4687909638554,130.656678,135.74565010000038,132.72290009999998,127.2416002,128.59750000000003,128.9577070144393,128.22597290795258,128.34384615384616,130.4522205544697,126.2354717532226,135.74565010000038,132.72290009999998,127.2416002,128.59750000000003,127.76999666666666,251949680,208017984.0,48.928015582317094,1.5,2.75,2.1131468030533678,1.2111918169536726,-0.02075920079860638,0.13055190338144484,0.15131110418005125,19.578635175318137,0.23514657469822636,2375211901.0,2008-09-03,2008,2,247,9,1.24,127.71,127.23,123.96001000000001,2179
2008-09-04 13:30:00,126.97,127.23,123.96001000000001,124.03,117.39589927710844,130.60334600000002,135.63685015000036,132.63390019999994,127.0984002,128.35250050000008,128.76446360210835,127.82635644052851,127.87153846153844,130.74430180724337,124.99877511583357,135.63685015000036,132.63390019999994,127.0984002,128.35250050000008,125.07333666666666,340438528,214562141.6,39.35819271644321,1.5,2.75,2.242207031406698,1.5866663403959984,-0.2995382358681796,-0.22311169065517333,0.0764265452130063,26.253941121568513,-2.9499217527386516,2034773373.0,2008-09-04,2008,3,248,9,2.64,125.6,124.95,122.0,2180
2008-09-05 13:30:00,123.28998999999999,124.95,122.0,124.42,117.32300759036144,130.55001399999998,135.54015020000034,132.54570009999995,126.9506002,128.22300100000007,128.59409248045705,127.50194154143057,127.56615384615385,130.9517994949715,124.1805081973362,135.54015020000034,132.54570009999995,126.9506002,128.22300100000007,123.79,289514752,216722257.6,40.625079767561736,1.5,2.75,2.292763672020506,1.335879181059251,-0.4343771222499949,-0.4665448575994873,-0.03216773534949241,26.355804071781296,-4.033930122169696,2324288125.0,2008-09-05,2008,4,249,9,2.42,123.48,128.24001,124.42,2181
2008-09-08 13:30:00,128.03999,128.24001,124.42,126.99001000000001,117.25011590361444,130.49668200000002,135.45190025000036,132.44710009999994,126.92580040000004,128.10400150000007,128.531187285145,127.45318615653242,127.56615384615385,130.9517994949715,124.1805081973362,135.45190025000036,132.44710009999994,126.92580040000004,128.10400150000007,126.55000666666666,364148736,221889112.8,48.29134579424104,1.5,2.75,2.401852695447613,1.6411293524267043,-0.3318154561573439,-0.44693705554617225,-0.11512159938882838,27.97054175721701,-0.02361045504644777,2688436861.0,2008-09-08,2008,0,252,9,3.07,126.33,127.36,122.8,2182
2008-09-09 13:30:00,127.10001000000001,127.36,122.8,123.22,117.17722421686749,130.44335,135.35960030000035,132.30880009999993,126.83960040000004,127.72950100000007,128.32290543082559,127.050025570196,127.23076923076924,131.33255207422405,123.1289863873145,135.35960030000035,132.30880009999993,126.83960040000004,127.72950100000007,124.45999999999998,377326848,228284164.8,40.10998229171382,1.5,2.75,2.5560060743442117,1.6528822677235473,-0.4896811654116847,-0.7272230561534343,-0.2375418907417496,30.70134553299128,-3.2734123557579102,2311110013.0,2008-09-09,2008,1,253,9,3.71,125.08,124.89998999999999,122.55,2183
2008-09-10 13:30:00,123.89,124.89998999999999,122.55,123.72,117.10433253012049,130.39001800000003,135.25755030000036,132.16120009999997,126.75440040000004,127.44800050000006,128.14239933549908,126.73288027779638,126.91692307692308,131.40283290569744,122.43101324814876,135.25755030000036,132.16120009999997,126.75440040000004,127.44800050000006,123.72333,298916608,232569954.4,41.52492658435805,1.5,2.75,2.5412906404624827,1.285276117334957,-0.5288839817706867,-0.8986468679551081,-0.3697628861844213,30.788833732770513,-3.8171499650159353,2610026621.0,2008-09-10,2008,2,254,9,1.92,123.72,125.74001000000001,121.60001000000001,2184
2008-09-11 13:30:00,122.12,125.74001000000001,121.60001000000001,125.50998999999999,117.03144084337349,130.336686,135.18035025000034,132.03079999999994,126.69700020000003,127.29499950000006,128.03916759685205,126.61641453705387,126.59846153846156,130.8444508797767,122.35247219714641,135.18035025000034,132.03079999999994,126.69700020000003,127.29499950000006,124.28333666666668,375369216,238515056.0,46.406525538387534,1.5,2.75,2.655484166143734,1.5737757703647857,-0.4081265376071857,-0.8799210581934034,-0.4717945205862178,31.59428115276471,-3.594753821338041,2985395837.0,2008-09-11,2008,3,255,9,3.4,123.67,126.21001000000001,123.83,2185
2008-09-12 13:30:00,124.28998999999999,126.21001000000001,123.83,126.09,116.95854915662649,130.28335400000003,135.09795020000035,131.91229999999993,126.69520040000003,127.12250000000007,127.96272965187748,126.5662798192392,126.52692307692308,130.7734308013295,122.28041535251666,135.09795020000035,131.91229999999993,126.69520040000003,127.12250000000007,125.37667,297851136,241429809.6,47.92358281848478,1.5,2.75,2.63580743999061,1.2336966031389356,-0.2697272997900406,-0.8089536453237685,-0.5392263455337278,30.61942833123231,-2.096428456901026,3283246973.0,2008-09-12,2008,4,256,9,1.92,125.02,125.65198999999998,119.89,2186
2008-09-15 13:30:00,121.63,125.65198999999998,119.89,120.09,116.88565746987952,130.23002200000002,134.96275020000036,131.73599999999996,126.57080040000004,126.61850000000008,127.6539951557254,125.94949126502596,125.9653846153846,131.37752301481922,120.55324621595,134.96275020000036,131.73599999999996,126.57080040000004,126.61850000000008,121.87733,483607040,256559892.8,36.43413853503494,1.5,2.75,2.890392622848424,1.8849674230920943,-0.5468317472498194,-1.222766029596002,-0.6759342823461827,40.26547973784989,-6.172364546264192,2799639933.0,2008-09-15,2008,0,259,9,4.81,122.77,122.32001000000001,117.0,2187
2008-09-16 13:30:00,117.2,122.32001000000001,117.0,122.10001000000001,116.81276578313252,130.17669000000004,134.83735030000034,131.57379999999995,126.51240060000003,126.3040005000001,127.43619181628522,125.58287400169014,125.46307769230768,131.00334770134063,119.92280768327473,134.83735030000034,131.57379999999995,126.51240060000003,126.3040005000001,120.47334000000002,581744128,277033346.4,41.49446301148789,1.5,2.75,3.0639367212163933,2.0999065114711404,-0.5574131164471119,-1.3727006779050726,-0.8152875614579607,42.488174094887064,-4.519854551141694,3381384061.0,2008-09-16,2008,1,260,9,4.55,119.66,121.8517,116.0,2188
2008-09-17 13:30:00,119.64,121.8517,116.0,116.61,116.73987409638552,130.12335800000002,134.67710030000038,131.34389989999997,126.29980040000002,125.78500000000014,127.0116352744701,124.72831457295773,124.41846230769228,131.01927196577384,117.81765264961071,134.67710030000038,131.34389989999997,126.29980040000002,125.78500000000014,118.15390000000002,624095488,298504439.2,33.62160423894953,1.5,2.75,3.2807990982723654,2.0907410612471717,-0.8777515884816154,-1.9124770470599801,-1.0347254585783645,48.45454962199079,-5.9824236071918095,2757288573.0,2008-09-17,2008,2,261,9,5.04,118.93,121.78998999999999,113.8,2189
2008-09-18 13:30:00,118.05,121.78998999999999,113.8,120.07001000000001,116.66698240963856,130.07002600000004,134.53905040000035,131.14829999999995,126.20540080000002,125.40950050000009,126.73941467547128,124.28466651839035,123.74769461538456,130.20594964783072,117.2894395829384,134.53905040000035,131.14829999999995,126.20540080000002,125.40950050000009,118.55333333333333,776114688,326035267.2,41.19430199328141,1.5,2.75,3.617169876967196,2.3804623796232067,-0.8022771986014958,-2.0375719568302344,-1.2352947582287386,50.902540850023186,-3.496214434978304,3533403261.0,2008-09-18,2008,3,262,9,7.02,117.79,128.0,116.52,2190
2008-09-19 13:30:00,126.7,128.0,116.52,124.12,116.59409072289156,130.01669400000003,134.4278504000003,130.9987,126.18180080000002,125.2255005000001,126.63669253133514,124.26898399282936,123.45000153846148,129.43829100786965,117.4617120690533,134.4278504000003,130.9987,126.18180080000002,125.2255005000001,122.88,501146880,342062120.8,48.5878205354763,1.5,2.75,4.178800600040968,1.4650756383897154,-0.4431917699569747,-1.7892844706749567,-1.3460927007179824,55.021573000631,-2.2600281707198806,4034550141.0,2008-09-19,2008,4,263,9,9.85,122.26,124.75,120.36,2191
2008-09-22 13:30:00,124.4505,124.75,120.36,121.31,116.52119903614458,129.96336200000005,134.29035040000034,130.82920009999995,126.13120080000004,124.80850100000008,126.42780262814553,123.98717599351228,122.94461692307686,128.44085558918135,117.44837825697238,134.29035040000034,130.82920009999995,126.13120080000004,124.80850100000008,122.14,249966432,346174680.0,44.41527429726183,1.5,2.75,4.193886271466614,0.7220817883041013,-0.3619467001242067,-1.7985260758732409,-1.4365793757490342,54.68075587116397,-1.5500730400908915,3784583709.0,2008-09-22,2008,0,266,9,3.65,122.56,122.02,118.28,2192
2008-09-23 13:30:00,120.85001000000001,122.02,118.28,118.55,116.44830734939758,129.91003000000003,134.12840040000034,130.60350009999993,126.04780080000002,124.3850010000001,126.11886919174766,123.46934970841585,122.5230784615384,128.44572467367053,116.60043224940628,134.12840040000034,130.60350009999993,126.04780080000002,124.3850010000001,119.61666666666667,328230144,353989343.2,40.71670460839489,1.5,2.75,4.161465823504711,0.9272317099516572,-0.4550897524094235,-2.0054415662608136,-1.5503518138513899,53.607324229916365,-4.178790817976076,3456353565.0,2008-09-23,2008,1,267,9,3.16,120.15,120.0,117.78998999999999,2193
2008-09-24 13:30:00,119.35001000000001,120.0,117.78998999999999,118.92998999999999,116.37541566265058,129.85669800000002,133.96850035000034,130.37770009999994,126.0066004,123.96200050000013,125.83695236069872,123.0370297361858,122.10076999999994,128.20237495136388,115.999165048636,133.96850035000034,130.37770009999994,126.0066004,123.96200050000013,118.90666,311871232,361627045.6,41.439727940467066,1.5,2.75,4.022076121825804,0.8624112488117509,-0.4512291206546952,-2.1143882146697592,-1.663159094015064,53.56375274498585,-5.242610568290218,3768224797.0,2008-09-24,2008,2,268,9,1.88,118.89,121.91,118.4369,2194
2008-09-25 13:30:00,119.39998999999999,121.91,118.4369,120.78998999999999,116.30252397590358,129.80336600000004,133.81205030000035,130.17729999999997,125.94320000000002,123.57000000000014,125.63903226812229,122.82302595178714,121.62384538461531,127.05460334191669,116.19308742731396,133.81205030000035,130.17729999999997,125.94320000000002,123.57000000000014,120.37896333333336,328252928,369488054.4,44.97716252991748,1.5,2.75,3.9828635416953886,0.8883992975985099,-0.2912916166463393,-2.0272736148229877,-1.7359819981766489,53.7116414800214,-4.2033547466095635,4096477725.0,2008-09-25,2008,3,269,9,2.93,120.17,121.5,118.50998999999999,2195
2008-09-26 13:30:00,118.83,121.5,118.50998999999999,120.85001000000001,116.22963228915664,129.75003400000003,133.6767503500003,129.96530009999995,125.85620020000002,123.10300050000014,125.451227473294,122.63511967066457,121.44153846153841,126.80442301921678,116.07865390386,133.6767503500003,129.96530009999995,125.85620020000002,123.10300050000014,120.28666666666666,285917440,375407073.6,45.092424312405306,1.5,2.75,3.9119454315742885,0.7616197458885601,-0.15611894706714136,-1.931130682010576,-1.7750117349434342,53.52702533567538,0.6328670164043585,4382395165.0,2008-09-26,2008,4,270,9,2.52,120.0,121.17998999999999,110.97,2196
2008-09-29 13:30:00,119.17998999999999,121.17998999999999,110.97,111.38,116.15674060240966,129.69670200000004,133.48680035000035,129.68390009999993,125.56420020000004,122.23250100000013,124.89941463120401,121.56320351155365,120.49230769230759,127.88880138490791,113.09581399970727,133.48680035000035,129.68390009999993,125.56420020000004,122.23250100000013,114.50999666666668,459562240,388924685.6,33.25537758749192,1.5,2.75,4.361805757890411,1.1816227074684815,-0.6513827946874351,-2.589240228302728,-1.9378574336152932,65.47436326789827,-8.77969625063913,3922832925.0,2008-09-29,2008,0,273,9,9.2,116.07,116.8,110.5321,2197
2008-09-30 13:30:00,113.50998999999999,116.8,110.5321,115.99001000000001,116.08384891566263,129.64337000000003,133.32145040000034,129.45220019999994,125.36300040000003,121.63250100000013,124.55002621429406,121.03242317711997,119.76000153846144,126.90516440791843,112.61483866900448,133.32145040000034,129.45220019999994,125.36300040000003,121.63250100000013,114.44070333333332,328510208,392726717.6,41.329505720228155,1.5,2.75,4.4979553466125255,0.8364855083136824,-0.6157908723701775,-2.7075960240780153,-2.0918051517078373,69.98151224067134,-0.5316782437183787,4251343133.0,2008-09-30,2008,1,274,9,5.67,113.67,116.69,113.95,2198
2008-10-01 13:30:00,115.27,116.69,113.95,116.06,116.01095722891566,129.59003800000005,133.16590040000037,129.22380029999994,125.13460040000004,121.04150100000014,124.21708400981194,120.55885906501331,118.98846307692301,125.35679809645569,112.6201280573903,133.16590040000037,129.22380029999994,125.13460040000004,121.04150100000014,115.56666666666668,333084928,396783480.0,41.44531937915983,1.5,2.75,4.3723871075687715,0.8394626913398713,-0.5376645833477545,-2.76388588089253,-2.2262212975447757,64.96460380165519,-3.3397265478698586,4584428061.0,2008-10-01,2008,2,275,10,2.4,115.32,115.11,111.06,2199
2008-10-02 13:30:00,114.95,115.11,111.06,111.85001000000001,115.93806554216869,129.53670600000004,132.99980040000034,128.93770029999993,124.80820060000003,120.43250150000013,123.73210071530953,119.72944486834535,118.35461769230764,125.72038559526959,110.98884978934566,132.99980040000034,128.93770029999993,124.80820060000003,120.43250150000013,112.67333666666669,365632512,398043179.2,36.7465286003744,1.5,2.75,4.417216599885289,0.9185749966495091,-0.7088869649127836,-3.112330003685756,-2.4034430387729717,64.99140515036467,-9.885586529165328,4218795549.0,2008-10-02,2008,3,276,10,3.65,113.08,115.45,109.67998999999999,2200
2008-10-03 13:30:00,112.86,115.45,109.67998999999999,110.34,115.8651738554217,129.48337400000003,132.82210040000035,128.63630029999993,124.50480080000007,119.72850150000014,123.2069202951013,118.83521202374105,117.45000153846145,125.60041602156977,109.29958705535317,132.82210040000035,128.63630029999993,124.50480080000007,119.72850150000014,111.82333,461832448,406659064.0,35.20484077075928,1.5,2.75,4.5138446998934825,1.1356747921890658,-0.8534983896017745,-3.4703160257751904,-2.616817636173416,59.73023963244502,-9.042947819635645,3756963101.0,2008-10-03,2008,4,277,10,5.26,112.56,107.62,100.64,2201
2008-10-06 13:30:00,107.14998999999999,107.62,100.64,104.72,115.79228216867467,129.43004200000004,132.61630040000034,128.27580029999993,124.08960080000007,118.61500100000013,122.48194302862673,117.49090611671811,116.53538615384608,127.15275425394822,105.91801805374394,132.61630040000034,128.27580029999993,124.08960080000007,118.61500100000013,104.32666666666668,610790912,418991172.8,30.137016397713452,1.5,2.75,4.884284364186805,1.4577655846977786,-1.2341944768586184,-4.159560732246689,-2.9253662553880706,63.952391764934006,-11.665963728384645,3146172189.0,2008-10-06,2008,0,280,10,6.94,104.13,107.33,99.64999,2202
2008-10-07 13:30:00,106.84,107.33,99.64999,100.03,115.7193904819277,129.37671000000006,132.38245040000035,127.85080029999992,123.61740080000007,117.45550100000014,121.60147467456294,115.82796267703064,114.99384692307686,128.52909307430141,101.45860077185232,132.38245040000035,127.85080029999992,123.61740080000007,117.45550100000014,102.33666333333332,540213504,427135505.6,26.68475549498622,1.5,2.75,5.083979052459177,1.2647356562905219,-1.680743732713506,-5.026295921279953,-3.345552188566447,66.32555754623452,-15.891693928503651,2605958685.0,2008-10-07,2008,1,281,10,7.71,103.49,102.17999,96.81,2203
2008-10-08 13:30:00,97.52,102.17999,96.81,97.50999,115.64649879518072,129.32337800000005,132.1293503500003,127.39930019999993,123.04200060000008,116.14500050000015,120.65671056967811,114.0833938506468,112.94692307692301,128.27251059106305,97.62133556278296,132.1293503500003,127.39930019999993,123.04200060000008,116.14500050000015,98.83332666666664,725787904,448479070.4,25.02590498143925,1.5,2.75,5.10440840585495,1.618331716913049,-2.002845181724135,-5.849108665721617,-3.8462634839974807,65.1674385395213,-19.2731202312377,1880170781.0,2008-10-08,2008,2,282,10,5.55,99.49,100.62,90.25,2204
2008-10-09 13:30:00,99.66,100.62,90.25,90.7,115.57360710843372,129.27004600000006,131.83670035000034,126.87580019999994,122.28540060000006,114.40450100000014,119.48193760616131,111.856403960109,110.59230769230764,129.1250152446754,92.05960013993986,131.83670035000034,126.87580019999994,122.28540060000006,114.40450100000014,93.85666666666668,534758400,456448529.6,21.191973707357434,1.5,2.75,5.480522091151025,1.171563419140873,-2.4992716782763367,-6.9703530818429025,-4.471081403566566,67.19693907116576,-24.948289205768372,1345412381.0,2008-10-09,2008,3,283,10,11.49,95.44,93.94,83.58,2205
2008-10-10 13:30:00,86.75999,93.94,83.58,88.5,83.58,129.21671400000002,131.53145035000034,126.34190019999994,121.51880060000006,112.52500100000013,118.26695966082168,109.63198453533673,108.28076923076915,129.55937908637904,87.00215937515928,131.53145035000034,126.34190019999994,121.51880060000006,112.52500100000013,88.67333333333332,871546880,485133316.8,20.11962670769266,1.5,2.75,5.8290562274973805,1.7965100516056745,-2.7790431024067908,-7.944885281575054,-5.165842179168262,64.719165232206,-20.542287663853468,473865501.0,2008-10-10,2008,4,284,10,12.4,88.76,101.35001,89.94791,2206
2008-10-13 13:30:00,93.87,101.35001,89.94791,101.35001,82.99225806451612,129.16338200000007,131.29985040000034,125.96050019999996,121.02260080000008,111.58800150000013,117.6035498702012,108.84322505578085,106.92846307692301,127.55248586509724,86.30444028874876,131.29985040000034,125.96050019999996,121.02260080000008,111.58800150000013,97.54931,456904704,483798200.0,39.40628488584408,1.5,2.75,6.330552925533283,0.944411748534823,-1.941562764090761,-7.592795634281714,-5.6512328701909516,108.09681456706332,-12.621776651282294,930770205.0,2008-10-13,2008,0,287,10,12.68,95.65,105.53,97.11,2207
2008-10-14 13:30:00,104.7,105.53,97.11,99.85001,82.40451612903227,129.11005000000006,131.0626004500003,125.56390039999997,120.51980080000007,110.47550150000014,116.90733262038941,107.9867283838017,105.3176953846153,124.58601655977505,86.04937420945565,131.0626004500003,125.56390039999997,120.51980080000007,110.47550150000014,100.83000333333332,546688512,482045419.2,38.245453376191676,1.5,2.75,6.479799145138048,1.134101663920552,-1.3590716687249245,-7.3500724560971085,-5.991000787372185,103.30206017122185,-13.966905049112532,384081693.0,2008-10-14,2008,1,288,10,8.67,101.32,97.8,89.71001,2208
2008-10-15 13:30:00,97.46001,97.8,89.71001,90.02,81.81677419354837,129.05671800000005,130.7816504000003,125.08770039999996,119.75300080000008,109.14600150000014,115.8529274195898,106.2756113948682,102.94615615384609,121.56189607404659,84.33041623364562,130.7816504000003,125.08770039999996,119.75300080000008,109.14600150000014,92.51000333333332,484627456,475072017.6,31.662807403178192,1.5,2.75,6.741242063342472,1.0201136628679432,-1.4954422151505369,-7.860303556310357,-6.364861341159818,114.2573605071524,-19.517217745443208,-100545763.0,2008-10-15,2008,2,289,10,9.02,93.76,94.77,86.53999,2209
2008-10-16 13:30:00,91.28999,94.77,86.53999,93.77,81.22903225806452,129.00338600000006,130.52585045000035,124.63880039999997,119.0498010000001,107.83100100000013,114.98693026588042,105.08460078583315,101.59154076923073,120.11795521197591,83.06512632648553,130.52585045000035,124.63880039999997,119.0498010000001,107.83100100000013,91.69333,708811264,471706846.4,36.175833339843386,1.5,2.75,6.847582630246582,1.502652059026803,-1.2051796144757567,-7.871335859254515,-6.666156244778758,119.94167951101677,-15.017219503353276,608265501.0,2008-10-16,2008,3,290,10,9.51,90.65,98.59,91.64999,2210
2008-10-17 13:30:00,91.99001,98.59,91.64999,93.21001,80.64129032258064,128.95005400000005,130.2676005000003,124.17790049999998,118.37380140000009,106.28550150000014,114.13293339270865,103.95368737765855,99.83923307692301,116.83251389344281,82.84595226040324,130.2676005000003,124.17790049999998,118.37380140000009,106.28550150000014,94.48333333333332,476770048,470488004.8,35.795665976882354,1.5,2.75,6.8541845852289685,1.0133521856793577,-0.9350343123729116,-7.834949135244898,-6.899914822871986,120.1141490365443,-10.991205118411004,131495453.0,2008-10-17,2008,4,291,10,7.57,95.12,99.10001,94.08949,2211
2008-10-20 13:30:00,95.35001,99.10001,94.08949,98.81,80.05354838709677,128.89672200000007,130.0551005000003,123.76600049999998,117.76260140000014,105.16050150000014,113.53203404397495,103.46381238931014,98.51230999999994,112.69316703205307,84.3314529679468,130.0551005000003,123.76600049999998,117.76260140000014,105.16050150000014,97.33316666666668,321294080,474054387.2,42.32319948891597,1.5,2.75,6.7853142577126135,0.6777578452500397,-0.2964129413088745,-7.270430999508079,-6.9740180581992055,124.85243486260413,-1.2196341097670689,452789533.0,2008-10-20,2008,0,294,10,5.33,96.59,98.64,95.22,2212
2008-10-21 13:30:00,96.97,98.64,95.22,95.86,79.4658064516129,128.84339000000006,129.82845050000034,123.32110039999998,117.06560120000013,104.02600150000013,112.839013101074,102.73963978080441,97.28230923076916,109.21851243430851,85.34610602722981,129.82845050000034,123.32110039999998,117.06560120000013,104.02600150000013,96.57333333333332,356502016,475467980.8,40.015232679052666,1.5,2.75,6.557077525018856,0.7497918480234285,-0.005280298743606693,-6.980618431628712,-6.975338132885107,123.34561360989473,-1.692124058263161,96287517.0,2008-10-21,2008,1,295,10,3.59,96.93,95.86,87.53,2213
2008-10-22 13:30:00,93.2,95.86,87.53,90.64,78.87806451612903,128.79005800000007,129.5871005000003,122.83850049999997,116.29140100000014,102.61150200000013,111.96846356769855,101.58729313501351,95.76692461538455,105.48290644148712,86.050942789282,129.5871005000003,122.83850049999997,116.29140100000014,102.61150200000013,91.34333333333332,516167936,485682816.0,36.24842553368424,1.5,2.75,6.683714844660367,1.062767549099369,-0.09206257542031704,-7.090416352160503,-6.998353776740186,126.46039604637957,-0.06615214994487571,-419880419.0,2008-10-22,2008,2,296,10,9.52,91.7,92.45,85.81,2214
2008-10-23 13:30:00,90.28999,92.45,85.81,91.69,78.29032258064517,128.73672600000006,129.34370050000035,122.37450049999998,115.55380080000009,101.15650250000013,111.1732297022986,100.64469378882174,94.76461692307687,103.1808040826824,86.34842976347133,129.34370050000035,122.37450049999998,115.55380080000009,101.15650250000013,89.98333333333332,634666496,501003494.4,37.5224435054047,1.5,2.75,6.680592355756055,1.2667905575390734,-0.010818750336491156,-7.0118772146608,-7.0010584643243075,119.65811842287657,3.6045197740112966,214786077.0,2008-10-23,2008,3,297,10,7.74,89.13,89.92,84.0,2215
2008-10-24 13:30:00,84.06,89.92,84.0,87.03999,77.70258064516129,128.68339400000008,129.07245050000034,121.86470039999996,114.7038008000001,99.46600150000009,110.2268281453457,99.34900771369585,93.7653853846153,102.5213986145657,85.00937215466496,129.07245050000034,121.86470039999996,114.7038008000001,99.46600150000009,86.98666333333334,545812480,513998246.4,34.257404552472245,1.5,2.75,6.7526929017734805,1.0618956072765309,-0.19225501925251987,-7.241377238389957,-7.049122219137439,122.80426657897776,-14.119406598973198,-331026403.0,2008-10-24,2008,4,298,10,7.05,86.96,89.50999,83.7,2216
2008-10-27 13:30:00,85.97,89.50999,83.7,83.95,77.11483870967741,128.63006200000007,128.79145055000035,121.29640039999997,113.77940080000008,98.09450150000008,109.19636429650862,97.88243555048672,92.7223092307692,102.6038517649393,82.84076669659909,128.79145055000035,121.29640039999997,113.77940080000008,98.09450150000008,85.71999666666666,400238592,511032064.0,32.24921687495555,1.5,2.75,6.6853569802182315,0.783196633235131,-0.4288278731158863,-7.585157060532295,-7.156329187416411,86.96980493649288,-15.923894248984046,-731264995.0,2008-10-27,2008,0,301,10,6.94,86.6,94.24001,84.53,2217
2008-10-28 13:30:00,87.34,94.24001,84.53,93.75999,76.52709677419354,128.57673000000008,128.5538505000003,120.87110039999996,113.08680060000007,96.98300050000007,108.59101628488085,97.4898216885356,92.95769307692301,102.7809409154568,83.13444523838925,128.5538505000003,120.87110039999996,113.08680060000007,96.98300050000007,90.84333333333336,639939328,526603520.0,43.560875364798974,1.5,2.75,6.942832195916928,1.2152203768026466,0.1366662420269158,-6.985496384882765,-7.122162626909682,114.41645846020157,4.154621195289942,-91325667.0,2008-10-28,2008,1,302,10,11.49,89.39,97.17,92.10001,2218
2008-10-29 13:30:00,93.77,97.17,92.10001,93.08,75.93935483870969,128.52339800000007,128.32840050000036,120.43570039999996,112.40860040000008,95.83400050000007,107.98274113645414,97.06983867057986,93.31000076923073,102.7910426788808,83.82895885958064,128.32840050000036,120.43570039999996,112.40860040000008,95.83400050000007,94.11667,531381504,536518348.8,43.02464926495883,1.5,2.75,6.809057753351433,0.990425593436852,0.5054787516686101,-6.490314187323919,-6.995792938992528,96.40476814669904,-0.7358430201556977,-622707171.0,2008-10-29,2008,2,303,10,5.5,94.64,96.53999,92.89999,2219
2008-10-30 13:30:00,95.78,96.53999,92.89999,96.3,75.3516129032258,128.4700660000001,128.12500050000034,120.03930039999996,111.78300040000008,95.0565000000001,107.52459442522064,96.9965207019532,92.9215384615384,101.41551124647295,84.42756567660382,128.12500050000034,120.03930039999996,111.78300040000008,95.0565000000001,95.24666,414582016,538965824.0,46.390035390059516,1.5,2.75,6.582696485254903,0.7692176341036422,0.9794174425382538,-5.771521135819711,-6.750938578357965,95.51424942591595,3.3150838627739665,-208125155.0,2008-10-30,2008,3,304,10,3.92,94.72,98.57001,94.48,2220
2008-10-31 13:30:00,95.08,98.57001,94.48,96.83,74.76387096774194,128.41673400000008,127.94200055000036,119.66820039999996,111.16360040000006,94.3810000000001,107.10519856540807,96.98066158748144,92.68922999999992,100.55444835567287,84.82401164432697,127.94200055000036,119.66820039999996,111.16360040000006,94.3810000000001,96.62667,411500032,536449203.2,46.94552329746908,1.5,2.75,6.4046474505938376,0.7670810759813614,1.320500731710232,-5.100312663720175,-6.420813395430407,95.36117770451773,-2.003845764598729,203374877.0,2008-10-31,2008,4,305,10,4.33,96.53,97.69,95.95,2221
2008-11-03 14:30:00,96.78,97.69,95.95,97.11,74.17612903225806,128.3634020000001,127.76725055000037,119.29480039999994,110.51280060000006,94.00050000000007,106.71322999421561,96.99297953153084,93.23461461538452,101.2653639044953,85.20386532627377,127.76725055000037,119.29480039999994,110.51280060000006,94.00050000000007,96.91666666666669,205566752,516187995.2,47.256455174408124,1.5,2.75,6.07145834697999,0.3982400867737189,1.5414685750713195,-4.493977676591257,-6.035446251662576,88.86134106382592,1.3039849780930524,408941629.0,2008-11-03,2008,0,308,11,1.81,96.82,100.86,96.7142,2222
2008-11-04 14:30:00,99.06,100.86,96.7142,100.41,73.58838709677421,100.86,127.61570055000034,118.93740049999997,109.98060060000006,94.0195000000001,106.46604450424637,97.31841005233744,93.74538384615377,102.64499569914463,84.84577199316294,127.61570055000034,118.93740049999997,109.98060060000006,94.0195000000001,99.32806666666666,346977536,506526196.8,50.908140041647215,1.5,2.75,5.933911322195705,0.6850139996549928,1.8647829105797191,-3.7044676134379273,-5.569250524017646,88.8882424062821,10.778905560458954,755919165.0,2008-11-04,2008,1,309,11,4.29,98.79,100.7114,95.0,2223
2008-11-05 14:30:00,99.2,100.7114,95.0,96.19,73.00064516129031,100.19666644444445,127.42735055000034,118.53700049999996,109.35660060000004,93.95350050000009,106.06306236682491,97.21094242830529,93.97461384615377,102.96035410609088,84.98887358621666,127.42735055000034,118.53700049999996,109.35660060000004,93.95350050000009,97.30046666666664,390404096,489757006.4,46.47672256253496,1.5,2.75,5.918017656324585,0.7971383582027709,1.7511383234972069,-3.3803276196461383,-5.131465943143344,85.90242132766701,4.907841640309741,365515069.0,2008-11-05,2008,2,310,11,6.01,97.86,95.44,90.06,2224
2008-11-06 14:30:00,94.46001,95.44,90.06,90.86,72.41290322580646,99.53333288888888,127.20670050000034,118.08990039999998,108.60120060000004,93.96150050000007,105.4668638426357,96.60609076846669,93.36307538461529,102.02554253090125,84.70060823832937,127.20670050000034,118.08990039999998,108.60120060000004,93.96150050000007,92.12,477982720,486918222.4,41.55640789366309,1.5,2.75,5.933159252301398,0.9816488642467368,1.2947449807836886,-3.513034717163734,-4.807779697947423,92.96675589113093,4.388798757904265,-112467651.0,2008-11-06,2008,3,311,11,5.97,92.75,94.0,90.5,2225
2008-11-07 14:30:00,91.64999,94.0,90.5,93.86,71.82516129032258,98.86999933333333,127.01080055000031,117.68600039999995,107.87460060000004,94.22950050000007,105.01169271155193,96.34455831432699,93.20922923076915,101.75915868936026,84.65929977217804,127.01080055000031,117.68600039999995,107.87460060000004,94.22950050000007,92.78666666666668,380518656,462366811.2,45.080617706079366,1.5,2.75,5.759362162851299,0.8229800383215741,1.176098405256731,-3.337656691376509,-4.51375509663324,88.51324468153835,11.804645622394276,268051005.0,2008-11-07,2008,4,312,11,3.87,92.25,95.53,90.92,2226
2008-11-10 14:30:00,95.21001,95.53,90.92,92.63,71.2374193548387,98.20666577777777,126.7977505000003,117.26810039999997,107.15140080000003,93.79350000000008,104.52613613462836,95.99079085581968,93.36230615384608,101.79318619299237,84.93142611469979,126.7977505000003,117.26810039999997,107.15140080000003,93.79350000000008,93.02666666666666,301903104,454616731.2,43.91146478380149,1.5,2.75,5.677264865504777,0.6640826948957659,1.0027353255888496,-3.2603359396471774,-4.263071265236027,85.29696357352633,-1.2051942411683347,-33852099.0,2008-11-10,2008,0,315,11,5.07,93.22,92.1377,88.64999,2227
2008-11-11 14:30:00,90.75999,92.1377,88.64999,89.77,70.64967741935484,97.54333222222222,126.5670505000003,116.85000039999996,106.38700060000002,93.28949950000008,103.94746412934879,95.39833458383684,93.21461384615377,101.82290386954234,84.60632382276512,126.5670505000003,116.85000039999996,106.38700060000002,93.28949950000008,90.18589666666666,418596608,448212136.0,41.23365977527791,1.5,2.75,5.556032375111578,0.9339251983127916,0.6978567516030507,-3.3907503257322134,-4.088607077335263,58.82864221666315,-3.556080790717665,-452448707.0,2008-11-11,2008,1,316,11,3.93,90.39,90.1516,85.12,2228
2008-11-12 14:30:00,88.23,90.1516,85.12,85.82001,70.06193548387097,96.87999866666668,126.32160055000031,116.39370049999997,105.54580080000004,93.07950000000008,103.23658357525669,94.4861131949,93.12076923076914,102.01801743989724,84.22352102164103,126.32160055000031,116.39370049999997,105.54580080000004,93.07950000000008,87.03053666666668,454330624,446697294.4,37.80470668086146,1.5,2.75,5.5185729197464655,1.017088372138571,0.25537788021018404,-3.7693847270725342,-4.024762607282718,63.315680493861386,-10.882647975077882,-906779331.0,2008-11-12,2008,2,317,11,5.91,87.64,91.73,82.09,2229
2008-11-13 14:30:00,86.13,91.73,82.09,91.17,69.47419354838709,96.21666511111113,126.0906005500003,115.99350049999997,104.88860080000003,92.94950000000007,102.76338421936428,94.1702928906238,93.67615384615378,100.97137776095056,86.38092993135695,126.0906005500003,115.99350049999997,104.88860080000003,92.94950000000007,88.33,753800960,448946779.2,44.53273859058424,1.5,2.75,5.812960568336004,1.6790430289827103,0.34277022106775323,-3.596299830948027,-3.9390700520157798,71.08350415941653,-5.8452958793762235,-152978371.0,2008-11-13,2008,3,318,11,11.74,86.91,92.06,86.52,2230
2008-11-14 14:30:00,89.41,92.06,86.52,86.62,68.88645161290323,95.55333155555556,125.82580055000031,115.54160049999996,104.13260080000003,92.61999950000008,102.1303103284088,93.45121737723109,93.12692384615377,101.33248913929627,84.92135855301126,125.82580055000031,115.54160049999996,104.13260080000003,92.61999950000008,88.39999999999998,540352256,452125889.6,40.51829975758535,1.5,2.75,5.793463384883433,1.1951367272465965,0.1251188452485743,-3.7826714954550624,-3.9077903407036367,75.1978634599704,-10.802183091339712,-693330627.0,2008-11-14,2008,4,319,11,6.4,89.29,88.56,85.16,2231
2008-11-17 14:30:00,86.38,88.56,85.16,85.47,68.29870967741935,94.889998,125.5640505000003,115.11400049999996,103.30220060000003,91.95299950000008,101.47696482533395,92.69110143654241,92.54153923076916,101.70666099000769,83.37641747153063,125.5640505000003,115.11400049999996,103.30220060000003,91.95299950000008,86.39666666666666,415543808,456838376.0,39.54792329903235,1.5,2.75,5.622501714534615,0.909607926633554,-0.05562349190966343,-3.9773197055907166,-3.9216962136810527,74.66613881413177,-14.878996115924707,-1108874435.0,2008-11-17,2008,0,322,11,3.99,86.86,87.22,82.91,2232
2008-11-18 14:30:00,85.14999,87.22,82.91,87.08,67.71096774193549,94.22666444444445,125.3288005000003,114.70950049999996,102.57940060000004,91.51399950000008,100.9123779694385,92.15671082353836,91.8323084615384,101.14997589040264,82.51464103267412,125.3288005000003,114.70950049999996,102.57940060000004,91.51399950000008,85.73666666666666,524140544,465220302.4,41.65464909992182,1.5,2.75,5.528751592067857,1.1266501941038247,-0.027493617379451333,-3.956063235405367,-3.9285696180259153,71.75698742308492,-9.47083896454933,-584733891.0,2008-11-18,2008,1,323,11,5.2,85.06,86.87,80.92,2233
2008-11-19 14:30:00,85.91,86.87,80.92,81.5,67.1232258064516,93.56333088888887,125.07105050000031,114.24470049999996,101.73500060000002,91.05699950000007,100.15110824514679,91.14178598320134,90.65307769230762,100.96906349869181,80.3370918859234,125.07105050000031,114.24470049999996,101.73500060000002,91.05699950000007,83.09666666666669,558809344,467352372.8,36.86011431924077,1.5,2.75,5.573840764063009,1.1956916804595712,-0.3287076409289877,-4.3394541691871495,-4.010746528258162,76.25615504658128,-10.301562843935724,-1143543235.0,2008-11-19,2008,2,324,11,7.35,83.9,82.50999,75.05,2234
2008-11-20 14:30:00,80.13,82.50999,75.05,75.45,66.53548387096774,92.89999733333332,124.77865055000035,113.71540049999996,100.73380080000004,90.24499950000008,99.18243733357241,89.64733017527745,88.9869238461538,101.38067430087251,76.59317339143504,124.77865055000035,113.71540049999996,100.73380080000004,90.24499950000008,77.66999666666669,814180352,476328065.6,32.49314092185303,1.5,2.75,5.708565709487081,1.7092848622606964,-0.8498030132861958,-5.073000294865906,-4.223197281579711,80.88363615046724,-19.61431919880673,-1957723587.0,2008-11-20,2008,3,325,11,9.94,78.78,80.89999,74.34,2235
2008-11-21 14:30:00,77.46001,80.89999,74.34,79.52,74.34,92.23666377777779,124.5109005000003,113.24880059999998,99.80240080000004,89.86900000000006,98.41136135970685,88.68282253953674,87.3800007692307,98.81252884015274,75.94747269830867,124.5109005000003,113.24880059999998,99.80240080000004,89.86900000000006,78.25333,718768640,484975873.6,37.829351777321314,1.5,2.75,5.769381730238004,1.4820709217234758,-0.8336274439786884,-5.265231586553071,-4.431604142574383,86.15042709801122,-14.153082154809455,-1238954947.0,2008-11-21,2008,4,326,11,8.82,77.62,86.985,80.3614,2236
2008-11-24 14:30:00,81.92,86.985,80.3614,85.03,74.03200000000002,91.5733302222222,124.2673005000003,112.8360006,99.10120080000004,89.92300000000006,97.88660209069872,88.33493467862846,86.52153923076916,96.79637413792729,76.24670432361101,124.2673005000003,112.8360006,99.10120080000004,89.92300000000006,84.12546666666667,523461888,491137038.4,44.25388473782542,1.5,2.75,5.890497320935289,1.0658163548514,-0.3877513657077456,-4.916293349709066,-4.528541984001318,98.6532678373792,-5.280160409936499,-715493059.0,2008-11-24,2008,0,329,11,8.24,83.67,87.50999,83.82001,2237
2008-11-25 14:30:00,87.3,87.50999,83.82001,85.66,73.72399999999999,90.90999666666666,124.0206504500003,112.44240059999998,98.37240060000002,89.51800050000006,97.40712749890659,88.08017899494956,86.12153923076917,96.08994722341257,76.15313123812578,124.0206504500003,112.44240059999998,98.37240060000002,89.51800050000006,85.66333333333334,454188288,481849486.4,44.95429617481216,1.5,2.75,5.733317512297053,0.9425936953743322,-0.006467329532724442,-4.536626145917225,-4.530158816384501,97.88097686443585,-0.18644835860541126,-261304771.0,2008-11-25,2008,1,330,11,4.4,85.66,89.19,84.24001,2238
2008-11-26 14:30:00,84.3,89.19,84.24001,88.97,73.416,90.24666311111109,123.78365045000034,112.05970049999998,97.81960060000004,89.31250050000007,97.07625975385143,88.16492385257341,85.74538538461533,94.84889822425049,76.64187254498019,123.78365045000034,112.05970049999998,97.81960060000004,89.31250050000007,87.46666999999998,370320384,473796430.4,48.60778736519349,1.5,2.75,5.677365547132978,0.7816023090071808,0.4853902061776356,-3.923421058662456,-4.408811264840091,96.94843750459272,-2.4130744762531564,109015613.0,2008-11-26,2008,2,331,11,5.88,86.72,90.13,88.48,2239
2008-11-28 14:30:00,88.63,90.13,88.48,90.09,73.108,89.58332955555555,123.55825045000034,111.7127006,97.22000040000003,89.00200050000008,96.80228878311216,88.3482644380426,85.55000076923072,94.14913856859214,76.9508629698693,123.55825045000034,111.7127006,97.22000040000003,89.00200050000008,89.56666666666668,119905312,459062595.2,49.82139399373511,1.5,2.75,5.3896965794806215,0.2611959964800896,0.8799020982292021,-3.3089336420535886,-4.188835740282792,90.3522879726067,4.006003232509811,228920925.0,2008-11-28,2008,4,333,11,1.86,89.3,87.55,81.86,2240
2008-12-01 14:30:00,87.50999,87.55,81.86,82.11,72.80000000000003,88.919996,123.29310045000037,111.2808006,96.37980040000002,88.26600050000008,96.22612059553913,87.75414401537188,84.96076999999994,93.37016967660077,76.55137032339913,123.29310045000037,111.2808006,96.37980040000002,88.26600050000008,83.83999999999997,370826752,457028931.2,42.17874626451828,1.5,2.75,5.592575395232006,0.8113857278714001,0.609972445844102,-3.426370182977664,-4.0363426288217665,101.23046899469395,-3.9312039312039295,-141905827.0,2008-12-01,2008,0,336,12,6.95,84.7,85.49001,82.03799000000001,2241
2008-12-02 14:30:00,83.47,85.49001,82.03799000000001,85.27,72.492,88.25666244444444,123.04185045000037,110.8951006,95.65900040000002,87.67400050000008,95.79646880747879,87.51755887105075,84.91846153846149,93.31566930205318,76.52125377486979,123.04185045000037,110.8951006,95.65900040000002,87.67400050000008,84.266,469785344,470239860.8,45.729040458509616,1.5,2.75,5.439678581286863,0.9990334362569204,0.6472723885335041,-3.2272521431548853,-3.874524531688389,103.95705159258287,-2.07854846118512,327879517.0,2008-12-02,2008,1,337,12,4.21,83.76,87.83,83.14,2242
2008-12-03 14:30:00,83.39999,87.83,83.14,87.32001,72.184,87.59332888888888,122.79885050000036,110.5411007,95.03440060000004,87.01950100000008,95.46405865816591,87.49874469285544,84.62230846153841,92.36257450195512,76.88204242112168,122.79885050000036,110.5411007,95.03440060000004,87.01950100000008,86.09666999999997,520103680,478896168.0,47.961359976677954,1.5,2.75,5.386130111194944,1.0860468609972256,0.8028703313940548,-2.870936617445821,-3.673806948839877,104.33542002248636,7.141116564417174,847983197.0,2008-12-03,2008,2,338,12,5.64,85.48,88.05,83.74001,2243
2008-12-04 14:30:00,86.06,88.05,83.74001,85.3,71.876,86.92999533333332,122.55140055000034,110.18420060000001,94.36180080000004,86.47500100000006,95.06546812255155,87.28934043639302,84.52076999999993,92.18783338914128,76.85370661085862,122.55140055000034,110.18420060000001,94.36180080000004,86.47500100000006,85.69667000000003,444341504,481593038.4,45.95546476279225,1.5,2.75,5.309262960395307,0.9226493503233332,0.7628893956902352,-2.7201952042270823,-3.483084599917317,97.0027928396968,13.055003313452609,403641693.0,2008-12-04,2008,3,339,12,5.15,85.9,88.42,82.24001,2244
2008-12-05 14:30:00,83.64999,88.42,82.24001,87.92999,71.56800000000001,86.26666177777777,122.31295050000037,109.8239004,93.70460080000002,86.32850050000008,94.78564545107893,87.35035468054606,84.70999999999995,92.58017325193742,76.83982674806249,122.31295050000037,109.8239004,93.70460080000002,86.32850050000008,86.19666666666667,472064256,481297115.2,48.949142549422724,1.5,2.75,5.371457748938498,0.9808167161023532,0.8974326321124391,-2.361293809776768,-3.2587264418892072,82.4326470569885,10.575943158953732,875705949.0,2008-12-05,2008,4,340,12,7.51,85.33,92.38,88.0815,2245
2008-12-08 14:30:00,90.34,92.38,88.0815,91.0,71.26,85.60332822222222,122.08130050000034,109.4819004,93.10760060000004,86.18550050000006,94.63718876672291,87.69793994906547,85.01153846153842,93.49806999969084,76.525006923386,122.08130050000034,109.4819004,93.10760060000004,86.18550050000006,90.48716666666668,413016832,482922024.0,52.27260928724949,1.5,2.75,5.3056400525857494,0.8552453842941733,1.1603468776852637,-1.808292844782628,-2.9686397224678918,80.05621333202187,7.021051393625776,1288722781.0,2008-12-08,2008,0,343,12,4.88,90.23,92.13,88.98,2246
2008-12-09 14:30:00,90.37,92.13,88.98,89.5,70.952,84.93999466666666,121.83700050000034,109.1171004,92.67000060000002,86.02900050000008,94.43573038371416,87.86956471582116,85.62692307692302,94.1657261766822,77.08811997716386,121.83700050000034,109.1171004,92.67000060000002,86.02900050000008,90.20333333333332,370862592,486369998.4,50.541314655566225,1.5,2.75,5.1516657631153375,0.7625112429220923,1.1956471585642077,-1.4740807742626316,-2.6697279328268397,73.7529271212371,4.482839131449921,917860189.0,2008-12-09,2008,1,344,12,3.54,90.56,91.36,89.0,2247
2008-12-10 14:30:00,90.32001,91.36,89.0,90.11,70.64399999999999,84.27666111111111,121.59645050000034,108.75770040000002,92.1524004,86.04600050000008,94.26609389807831,88.08293950479056,86.75461538461532,93.24620783775408,80.26302293147657,121.59645050000034,108.75770040000002,92.1524004,86.04600050000008,90.1566666666667,396381184,485259227.2,51.24845954259966,1.5,2.75,4.952261065749957,0.8168441974553761,1.2183630658600304,-1.1467741005018013,-2.365137166361832,73.74711374060873,1.2813307856580876,1314241373.0,2008-12-10,2008,2,345,12,2.65,90.18,91.0,87.37,2248
2008-12-11 14:30:00,89.53999,91.0,87.37,87.94,70.33600000000001,83.61332755555554,121.35180050000034,108.36230040000002,91.59000040000001,86.15200000000006,94.0180117844282,88.06932621862005,87.40230769230764,92.38132268818029,82.42329269643498,121.35180050000034,108.36230040000002,91.59000040000001,86.15200000000006,88.77,366329600,480859176.0,48.58711250688665,1.5,2.75,4.857813846767817,0.7618230415135095,1.0518105249073626,-1.0503740102276282,-2.1021845351349913,72.24636313613975,-2.3865023865023933,947911773.0,2008-12-11,2008,3,346,12,4.15,89.18,89.07001,85.2,2249
2008-12-12 14:30:00,85.55,89.07001,85.2,88.99001,70.028,82.94999399999998,121.12765050000034,107.9705005,91.13280040000001,86.04300050000008,93.82083524386238,88.15701038827528,87.7069238461538,92.55082851348507,82.86301917882251,121.12765050000034,107.9705005,91.13280040000001,86.04300050000008,87.75334000000001,415140864,463926171.2,49.94172464120437,1.5,2.75,4.787256429141544,0.8948425197185772,0.9784553734673259,-0.8791153183008333,-1.8575706917681596,72.20302822484167,8.379015954207768,1363052637.0,2008-12-12,2008,4,347,12,4.54,87.14,89.14999,86.28999,2250
2008-12-15 14:30:00,89.02,89.14999,86.28999,87.75,69.72,82.28666044444444,120.89890050000037,107.5929006,90.6810004,86.09950050000006,93.58276327351484,88.1182474941538,87.867693076923,92.56571364261572,83.16967251123032,120.89890050000037,107.5929006,90.6810004,86.09950050000006,87.72999333333333,256846128,449750864.8,48.322493895968705,1.5,2.75,4.649595255631434,0.5710853454705798,0.8189861142794366,-0.8338380489188637,-1.6528241631983005,44.605847501560746,2.9084085844963106,1106206509.0,2008-12-15,2008,0,350,12,3.31,87.72,92.02,88.17999,2251
2008-12-16 14:30:00,88.3,92.02,88.17999,91.88,69.41199999999999,81.62332688888887,120.69335045000034,107.2569006,90.4242004,86.42000050000006,93.51598824318093,88.47650963756773,88.09153923076916,93.23454568466259,82.94853277687571,120.69335045000034,107.2569006,90.4242004,86.42000050000006,90.69333,377699840,447858666.4,53.70615825008216,1.5,2.75,4.622481308800617,0.8433460561030243,0.9547367005989686,-0.4594032874495895,-1.414139988048558,46.891975702143135,5.2221592736876685,1483906349.0,2008-12-16,2008,1,351,12,4.35,90.1,92.42999,90.06,2252
2008-12-17 14:30:00,90.84,92.42999,90.06,90.99001,69.10400000000001,80.95999333333333,120.47915050000034,106.93040069999999,90.24340059999999,86.61550100000008,93.41693027286009,88.71589062446606,88.16077076923071,93.4321493154653,82.88939222299612,120.47915050000034,106.93040069999999,90.24340059999999,86.61550100000008,91.16,288101888,436056733.6,52.43837385154961,1.5,2.75,4.4615890724577145,0.6606981748028211,0.9458690244195828,-0.23180370752407956,-1.1776727319436624,46.572824243068574,6.67058616647128,1195804461.0,2008-12-17,2008,2,352,12,2.63,91.24,91.67,88.21001,2253
2008-12-18 14:30:00,91.39999,91.67,88.21001,89.28999,68.796,80.29665977777776,120.2703004500003,106.56050060000001,90.0790006,87.00500050000008,93.255089477846,88.7705667554693,88.71307769230765,92.67469757320113,84.75145781141414,120.2703004500003,106.56050060000001,90.0790006,87.00500050000008,89.72333333333334,374829312,426857732.0,50.00991355862516,1.5,2.75,4.390046281567878,0.8781129727784807,0.7929722322071399,-0.18645744168473755,-0.9794296738918774,45.656343203584264,1.546685038858755,820975149.0,2008-12-18,2008,3,353,12,3.92,89.94,90.62,88.09,2254
2008-12-19 14:30:00,89.10001,90.62,88.09,88.19,68.488,79.63332622222221,120.06270040000034,106.1571006,90.02880060000003,87.64200050000008,93.05645851793044,88.71527468351984,88.93769307692303,92.39155840840685,85.4838277454392,120.06270040000034,106.1571006,90.02880060000003,87.64200050000008,88.96666666666665,301523456,401224887.2,48.446535870191326,1.5,2.75,4.257185832884458,0.7515073606331367,0.5943010515721243,-0.23655335942672195,-0.8308544109988463,43.35865337231695,-3.0879120879120903,519451693.0,2008-12-19,2008,4,354,12,2.87,89.36,88.67,85.49001,2255
2008-12-22 14:30:00,88.58,88.67,85.49001,87.06,68.18,78.96999266666666,119.85800040000036,105.7594006,90.00000060000002,88.01900050000008,92.8213032819332,88.55762947556556,88.91769230769226,92.41157645749868,85.42380815788584,119.85800040000036,105.7594006,90.00000060000002,88.01900050000008,87.07333666666666,244192192,377496064.8,46.827043398586575,1.5,2.75,4.180243273392711,0.646873477023859,0.3740843422460843,-0.3632489831912409,-0.7373333254373252,37.94207874600414,-2.7262569832402206,275259501.0,2008-12-22,2008,0,357,12,3.72,87.08,87.92999,85.8,2256
2008-12-23 14:30:00,87.53,87.92999,85.8,86.16,67.87200000000001,78.3066591111111,119.62580035000036,105.3594006,89.69620040000002,88.07550050000008,92.5600757022495,88.32928381122599,88.98384615384613,92.22463252057,85.74305978712223,119.62580035000036,105.3594006,89.69620040000002,88.07550050000008,86.62999666666668,221772560,362411598.4,45.521820816184864,1.5,2.75,4.033796611007518,0.6119356029969708,0.16573288552911447,-0.5301672185259321,-0.6959001040550465,37.3750473509096,-4.383531239596054,53486941.0,2008-12-23,2008,1,358,12,2.48,86.86,86.87,86.0,2257
2008-12-24 14:30:00,86.45,86.87,86.0,86.66,67.56400000000001,77.64332555555555,119.40230035000036,104.9761005,89.43240020000002,88.12550050000006,92.32870018451428,88.17030440063304,88.88615461538458,92.31899796567093,85.45331126509824,119.40230035000036,104.9761005,89.43240020000002,88.12550050000006,86.50999999999998,62142416,342809304.8,46.41541410495335,1.5,2.75,3.807811138792696,0.18127400607242794,0.06470745749922258,-0.6150157821810183,-0.6797232396802408,37.27525072424227,-1.455537866727315,115629357.0,2008-12-24,2008,2,359,12,1.01,86.44,87.3,86.5,2258
2008-12-26 14:30:00,87.24001,87.3,86.5,87.16,67.256,76.97999199999998,119.17985040000036,104.56410049999998,89.3752002,88.03500050000008,92.12600605963137,88.0740849339061,88.59076999999996,91.90397594418013,85.27756405581982,119.17985040000036,104.56410049999998,89.3752002,88.03500050000008,86.98666666666668,74775808,328032076.0,47.345530373404245,1.5,2.75,3.592967486021789,0.22795273228097365,0.03610034348902058,-0.6345978103189651,-0.6706981538079857,35.17625376134235,-2.056421838810897,190405165.0,2008-12-26,2008,4,361,12,0.92,86.9,87.33,85.60001,2259
2008-12-29 14:30:00,87.24001,87.33,85.60001,86.91,66.94800000000001,76.31665844444444,118.96635040000034,104.14390059999998,89.23800019999999,87.87600050000009,91.9214568023909,87.96321970210552,88.3915392307692,91.77287329614627,85.01020516539214,118.96635040000034,104.14390059999998,89.23800019999999,87.87600050000009,86.61333666666668,128419184,328457769.6,46.907110001734466,1.5,2.75,3.459897665591661,0.3909762407398384,0.006437730069475123,-0.6626509912211418,-0.6690887212906169,34.22628733955861,-0.9572649572649612,61985981.0,2008-12-29,2008,0,364,12,2.02,86.47,89.05,86.8766,2260
2008-12-30 14:30:00,87.50999,89.05,86.8766,88.97,66.64000000000001,75.65332488888887,118.76970040000036,103.76350069999997,89.1532,88.21900050000009,91.80571339837557,88.05910354000022,88.30384692307692,91.5591458182905,85.04854802786329,118.76970040000036,103.76350069999997,89.1532,88.21900050000009,88.29886666666668,168555680,318344216.0,50.93858271751,1.5,2.75,3.3680049751922567,0.5294761818446232,0.12507264380894578,-0.5127479165294346,-0.6378205603383804,36.23994114324928,-3.1671745755333007,230541661.0,2008-12-30,2008,1,365,12,2.5,87.96,90.97,88.87,2261
2008-12-31 14:30:00,89.08,90.97,88.87,90.24001,66.33200000000001,74.98999133333331,118.55275045000036,103.37220079999996,88.9818002,88.4675010000001,91.74431326510593,88.26680891714305,88.48077076923073,91.88436939319763,85.07717214526386,118.55275045000036,103.37220079999996,88.9818002,88.4675010000001,90.02667000000002,194141808,304562039.2,53.29326064318586,1.5,2.75,3.2774331912499517,0.6374458501458576,0.2797381542638823,-0.2881478675085276,-0.5678860217724099,24.69256548468773,-0.8242663123127473,424683469.0,2008-12-31,2008,2,366,12,2.36,89.92,93.44,89.85001,2262
2009-01-02 14:30:00,90.44,93.44,89.85001,92.96001,66.024,74.32665777777777,118.36595045000034,102.99470079999996,88.9238004,88.7495010000001,91.79198764686649,88.71378044884372,88.78615538461538,92.94609082223197,84.6262199469988,118.36595045000034,102.99470079999996,88.9238004,88.7495010000001,92.08334,227638496,289938780.0,57.948281371710856,1.5,2.75,3.2997586775892414,0.7851260738560051,0.5407765176009212,0.10808462522874153,-0.4326918923721796,29.868406205317363,4.11022556951792,652321965.0,2009-01-02,2009,4,2,1,4.0,91.65,94.5533,91.89,2263
2009-01-05 14:30:00,92.63,94.5533,91.89,92.85001,65.71600000000001,94.5533,118.1698005000003,102.62970079999997,88.9680006,89.12700150000009,91.8334787195384,89.10770707276336,89.17846384615383,93.80886417852966,84.548063513778,118.1698005000003,102.62970079999997,88.9680006,89.12700150000009,93.09777,240697632,279756586.4,57.69783769464453,1.5,2.75,3.254297343475724,0.8603823598842713,0.6729667343128338,0.4085165255188628,-0.2644502087939711,26.90268692576014,5.284057149336659,411624333.0,2009-01-05,2009,0,5,1,2.9,93.22,94.45,92.67999,2264
2009-01-06 14:30:00,93.64,94.45,92.67999,93.47,65.40800000000002,94.39947804878048,117.96355050000031,102.27870069999996,89.00360060000001,89.40400200000009,91.89765602465457,89.52316354202401,89.30077153846153,94.28093184673,84.32061123019304,117.96355050000031,102.27870069999996,89.00360060000001,89.40400200000009,93.53333000000002,328481792,272577463.2,58.779179094847535,1.5,2.75,3.1482768189417434,1.2050951980537767,0.7625202284251007,0.6887000767374047,-0.0738201516876959,24.823727024315797,7.3627383413737615,740106125.0,2009-01-06,2009,1,6,1,1.91,93.56,92.25999,90.2,2265
2009-01-07 14:30:00,92.0,92.25999,90.2,90.67,65.10000000000001,94.24565609756095,117.74265045000031,101.89000079999997,89.07620080000002,89.38750200000011,91.84951265113868,89.63238606183123,89.27615538461541,94.22574345906,84.32656731017079,117.74265045000031,101.89000079999997,89.07620080000002,89.38750200000011,91.04333,281047552,265978999.2,52.279529233093385,1.5,2.75,3.156971331874476,1.0566531675257165,0.6006615987586522,0.6770068467606194,0.07634524800196718,30.924129215799688,5.234447539461472,459058573.0,2009-01-07,2009,2,7,1,2.28,91.23,91.09,89.67,2266
2009-01-08 14:30:00,90.16,91.09,89.67,91.04201,64.792,94.09183414634144,117.5318605000003,101.49872089999997,89.21804100000001,89.46460250000011,91.81784588050579,89.76663596070446,89.41092615384619,94.44929591123885,84.37255639645352,117.5318605000003,101.49872089999997,89.21804100000001,89.46460250000011,90.60067,263834368,260627588.0,53.02277942425943,1.5,2.75,3.0329019510263,1.012304069667406,0.4907688559171136,0.6898063178983591,0.1990374619812456,29.536137785972805,5.05655435033465,722892941.0,2009-01-08,2009,3,8,1,1.58,90.38,91.32001,85.36,2267
2009-01-09 14:30:00,91.16,91.32001,85.36,89.09,64.48400000000001,93.93801219512194,117.3134105000003,101.10572089999997,89.12464120000004,89.41360250000011,91.71087153225065,89.70219444063736,89.48015692307693,94.47405557336712,84.48625827278677,117.3134105000003,101.10572089999997,89.12464120000004,89.41360250000011,88.59000333333331,331160832,257366570.4,48.733629974529464,1.5,2.75,3.241981097381564,1.2867282315854336,0.26977599479928593,0.536257455480353,0.26648146068106704,33.385403571585485,2.2143184947223578,391732109.0,2009-01-09,2009,4,9,1,6.98,88.34,88.91,86.41,2268
2009-01-12 14:30:00,88.84,88.91,86.41,86.95,64.17600000000002,93.78419024390243,117.09061055000036,100.70532079999997,89.00204120000002,89.36410250000013,91.52417068784868,89.44008068438617,89.4716953846154,94.4823127540483,84.46107801518251,117.09061055000036,100.70532079999997,89.00204120000002,89.36410250000013,87.42333333333332,278008320,252950506.4,44.48509113729826,1.5,2.75,3.201839590425738,1.0990621207153275,-0.021879413817262442,0.239132193409489,0.26101160722675143,36.68761595773032,0.04602462317340497,113723789.0,2009-01-12,2009,0,12,1,2.89,87.66,87.88,86.2,2269
2009-01-13 14:30:00,86.73,87.88,86.2,87.11,63.86800000000001,93.63036829268292,116.86631055000036,100.30062079999998,88.81824120000002,89.27010200000011,91.35106595499188,89.21816823825417,89.54477230769231,94.38487041752589,84.70467419785875,116.86631055000036,100.30062079999998,88.81824120000002,89.27010200000011,87.06333333333332,356731648,250030045.6,44.87205775875629,1.5,2.75,3.0931367625381845,1.4267551211453284,-0.1957051853971187,0.016380125480353058,0.21208531087747176,36.663644823478215,-2.0905923344947728,470455437.0,2009-01-13,2009,1,13,1,1.95,87.04,85.75,83.16,2270
2009-01-14 14:30:00,85.53999,85.75,83.16,84.37,63.56000000000001,93.47654634146342,116.6051105500003,99.8663208,88.56904120000002,89.10110200000011,91.07729866263924,88.756437929849,89.36861846153845,94.75204749253237,83.98518943054457,116.6051105500003,99.8663208,88.56904120000002,89.10110200000011,84.42666666666666,435967232,258986100.8,39.76073253504672,1.5,2.75,3.154341279499743,1.6833615033907643,-0.4711905624087098,-0.3769028921334153,0.09428767027529432,37.60404794656761,-6.504886247242207,34488205.0,2009-01-14,2009,2,14,1,3.11,84.46,85.25,81.72,2271
2009-01-15 14:30:00,84.12,85.25,81.72,84.39999,63.25200000000001,93.32272439024388,116.34361050000034,99.4138208,88.31484100000002,88.72710150000009,90.81544342096713,88.34153812700623,89.15630999999999,95.06360799567108,83.24901200432893,116.34361050000034,99.4138208,88.31484100000002,88.72710150000009,83.78999666666667,533808896,266791553.6,39.84150532350669,1.5,2.75,3.1811740452497617,2.00084631165025,-0.6181045827480502,-0.6783430581597685,-0.060238475411718236,35.780779704537885,-9.2082821419662,568297101.0,2009-01-15,2009,3,15,1,4.32,83.48,85.98759,83.05,2272
2009-01-16 14:30:00,85.86,85.98759,83.05,85.06,62.94400000000001,93.16890243902438,116.08371055000036,98.99422079999998,88.00784100000004,88.4306010000001,90.58973975739978,88.02901068633898,89.01400230769232,95.21283914649106,82.81516546889355,116.08371055000036,98.99422079999998,88.00784100000004,88.4306010000001,84.69919666666667,399307008,272351809.6,41.694415144984454,1.5,2.75,3.163775184874779,1.4661441338923271,-0.6351159019240447,-0.854133352816774,-0.2190174508927294,29.257685550846762,-8.38988601078233,967604109.0,2009-01-16,2009,4,16,1,3.54,84.52,85.05901,80.05,2273
2009-01-20 14:30:00,84.23,85.05901,80.05,80.57001,62.63600000000001,93.01508048780487,115.80211060000036,98.5260209,87.69544120000003,87.9946020000001,90.19680917867822,87.31862966859242,88.36784923076921,96.02903049147058,80.70666797006784,115.80211060000036,98.5260209,87.69544120000003,87.9946020000001,81.89300666666666,420108544,274615771.2,34.018184772501456,1.5,2.75,3.295648385955152,1.5298048694153077,-0.8970283742330416,-1.3403029186840314,-0.4432745444509898,38.50087753669715,-13.801208944046223,547495565.0,2009-01-20,2009,1,20,1,6.26,82.55,84.24001,80.47,2274
2009-01-21 14:30:00,81.94,84.24001,80.47,84.05,62.32800000000001,92.86125853658535,115.53756055000036,98.0802209,87.55924120000005,87.78760200000008,89.9557578383379,87.00733160491694,87.8916946153846,95.79390372634457,79.98948550442464,115.53756055000036,98.0802209,87.55924120000005,87.78760200000008,82.92000333333334,364767232,277777960.0,42.806999345942074,1.5,2.75,3.3295313583869266,1.31316117376627,-0.7880402468252072,-1.4283248529824988,-0.6402846061572915,49.410820039855636,-7.301202161685238,912262797.0,2009-01-21,2009,2,21,1,4.68,82.36,84.03999,81.17,2275
2009-01-22 14:30:00,82.42,84.03999,81.17,82.75,62.02000000000001,92.70743658536585,115.26721050000036,97.60582089999998,87.33704120000006,87.5721020000001,89.67317909957956,86.6018714520677,87.1063092307692,94.86569786167213,79.34692059986631,115.26721050000036,97.60582089999998,87.33704120000006,87.5721020000001,82.65333000000001,427940352,286965368.0,40.629787763734015,1.5,2.75,3.2974219756450034,1.491261314849672,-0.7555438385317326,-1.5847144043219572,-0.8291705657902246,47.95244771792968,-9.1078942567283,484322445.0,2009-01-22,2009,3,22,1,3.54,82.6,83.99001,80.57001,2276
2009-01-23 14:30:00,80.89999,83.99001,80.57001,83.11,61.71200000000001,92.55361463414631,115.0036105000003,97.149021,87.14664120000003,87.41960200000008,89.41579952704703,86.2693122661565,86.35707769230767,93.61833907927576,79.09581630533954,115.0036105000003,97.149021,87.14664120000003,87.41960200000008,82.55667333333334,386800640,295216772.0,41.516862770755075,1.5,2.75,3.306177548813217,1.3102258295812543,-0.6650351141326469,-1.6604644584560333,-0.9954293443233864,47.97748259014747,-6.712313390952973,871123085.0,2009-01-23,2009,4,23,1,4.24,82.28,85.36,82.81,2277
2009-01-26 14:30:00,83.59,85.36,82.81,83.67999,61.40400000000001,92.3997926829268,114.74191045000036,96.7059208,87.02484100000004,87.27060150000008,89.19086582010401,86.02271014557016,85.60399999999997,91.69459114576,79.51340885423994,114.74191045000036,96.7059208,87.02484100000004,87.27060150000008,83.94999666666669,318269440,308023123.2,42.96979740153132,1.5,2.75,3.2521648667551304,1.0332647649746316,-0.5279931900025283,-1.6554208318265466,-1.1274276418240183,48.036138502899284,-3.7607935595169626,1189392525.0,2009-01-26,2009,0,26,1,3.08,84.08,85.14999,83.3,2278
2009-01-27 14:30:00,84.13,85.14999,83.3,84.53,61.09600000000001,92.2459707317073,114.49766045000031,96.27242080000002,86.99904080000002,87.13910150000005,89.00808676833523,85.88054727456348,85.13169230769228,90.48530725921734,79.77807735616722,114.49766045000031,96.27242080000002,86.99904080000002,87.13910150000005,84.32666333333334,274112000,317989932.8,45.157915941055506,1.5,2.75,3.1520095191297637,0.8620147109260938,-0.3498954963885428,-1.5647970123096968,-1.214901515921154,47.361879716301566,-2.9617724715876457,1463504525.0,2009-01-27,2009,1,27,1,2.22,84.22,87.95,86.07001,2279
2009-01-28 14:30:00,86.39999,87.95,86.07001,87.39,60.78800000000001,92.0921487804878,114.26996050000031,95.9060208,86.92344080000002,87.16310150000005,88.94463238526325,86.024304676986,84.85076846153844,89.22872158788564,80.4728153351912,114.26996050000031,95.9060208,86.92344080000002,87.16310150000005,87.13667,330317312,328084839.2,51.85172534252682,1.5,2.75,3.171151696334781,1.0068045594713966,-0.02633066852651078,-1.2478148515792924,-1.2214841830527816,51.717900132171316,3.5794713760815413,1793821837.0,2009-01-28,2009,2,28,1,2.18,87.01,87.4901,84.47,2280
2009-01-29 14:30:00,86.11,87.4901,84.47,84.55,60.48000000000001,91.93832682926828,114.0265104500003,95.5073208,86.88204080000004,86.94210150000006,88.77229386035096,85.88389470774925,84.50153769230769,88.13153701682846,80.8715383677869,114.0265104500003,95.5073208,86.88204080000004,86.94210150000006,85.5033666666667,294591488,334386629.6,45.865140879970504,1.5,2.75,3.160362289453725,0.8809906315703957,0.007747667132481428,-1.21179959913718,-1.2195472662696614,51.96658111886612,0.17773698788352302,1499230349.0,2009-01-29,2009,3,29,1,3.58,85.98,85.39999,82.21001,2281
2009-01-30 14:30:00,84.98,85.39999,82.21001,82.83,60.17200000000001,91.78450487804876,113.7564104000003,95.0657207,86.82924080000002,86.57160100000006,88.53926272857248,85.59304759272551,84.1846146153846,87.61830545625824,80.75092377451095,113.7564104000003,95.0657207,86.82924080000002,86.57160100000006,83.48,383464192,343852748.8,42.65323597997586,1.5,2.75,3.1624778402070315,1.1151988557260009,-0.06994683992790796,-1.3069808161795464,-1.2370339762516385,53.31001868920965,-2.6216788149541546,1115766157.0,2009-01-30,2009,4,30,1,3.88,83.8,83.17999,81.31,2282
2009-02-02 14:30:00,81.57001,83.17999,81.31,82.58,59.86400000000001,91.63068292682924,113.48406040000036,94.6593207,86.73924080000002,86.05260050000005,88.3055661509814,85.30609067913261,83.83615307692304,86.91244626170564,80.75985989214047,113.48406040000036,94.6593207,86.73924080000002,86.05260050000005,82.35666333333334,288488960,346895272.0,42.19075540896734,1.5,2.75,3.0701572801922437,0.8316312826540916,-0.11965413615185948,-1.3866016464414628,-1.2669475102896033,52.95335531344903,2.494712362577592,827277197.0,2009-02-02,2009,0,33,2,2.3,82.24,84.36,82.22,2283
2009-02-03 14:30:00,83.10001,84.36,82.22,83.74001,59.55600000000001,91.47686097560974,113.21036045000037,94.2595208,86.78404100000004,85.59710050000005,88.12652473329588,85.15694013826284,83.7876923076923,86.84863009108555,80.72675452429905,113.21036045000037,94.2595208,86.78404100000004,85.59710050000005,83.44000333333331,278480640,348784422.4,45.16194235754508,1.5,2.75,3.0037174744642257,0.7984319886873481,-0.058957592081066774,-1.3406445003909369,-1.28168690830987,42.1810401991761,-0.3688161808447342,1105757837.0,2009-02-03,2009,1,34,2,2.6,83.29,85.37,83.03999,2284
2009-02-04 14:30:00,84.3,85.37,83.03999,83.33,59.24800000000001,91.32303902439024,112.93426045000037,93.8377209,86.94164100000003,85.09010050000005,87.93842572414701,84.98294583938066,83.70538538461537,86.75355565896967,80.65721511026106,112.93426045000037,93.8377209,86.94164100000003,85.09010050000005,83.91332999999999,322993920,348510028.8,44.295362982155936,1.5,2.75,2.9555955120024957,0.9267851519571536,-0.03230450519656247,-1.3220675398055732,-1.2897630346090108,34.45358094849998,0.7009063444108741,782763917.0,2009-02-04,2009,2,35,2,2.81,84.2,85.28999,77.73,2285
2009-02-05 14:30:00,82.7,85.28999,77.73,84.57001,58.94000000000001,91.16921707317071,112.66741050000036,93.422521,87.04264120000003,84.78510100000005,87.80633098986674,84.9436186165825,83.66769384615381,86.65952827504285,80.67585941726479,112.66741050000036,93.422521,87.04264120000003,84.78510100000005,82.53000000000002,417679872,355341644.8,47.57190140917317,1.5,2.75,3.2844808325737453,1.1754318079860475,0.07698765355260173,-1.1935284676682585,-1.2705161212208602,34.109008098935625,1.7567200096257936,1200443789.0,2009-02-05,2009,3,36,2,9.73,81.51,87.34,84.67999,2286
2009-02-06 14:30:00,84.86,87.34,84.67999,86.979,58.63200000000001,91.01539512195122,112.41370550000036,93.091411,87.08162120000004,84.58195050000003,87.77388663732296,85.13746446262226,84.16069307692307,87.05899306436424,81.2623930894819,112.41370550000036,93.091411,87.08162120000004,84.58195050000003,86.33299666666666,366101504,360455001.6,53.316760674156534,1.5,2.75,3.2477314873899066,1.0156649300881833,0.3067732082174264,-0.8870496109490773,-1.1938228191665037,37.231617606303686,3.9424120390071695,1566545293.0,2009-02-06,2009,4,37,2,3.14,86.01,87.74001,86.32001,2287
2009-02-09 14:30:00,86.96001,87.74001,86.32001,87.10001,58.32400000000001,90.8615731707317,112.15760550000036,92.741411,87.11042140000004,84.48245100000005,87.74746010252596,85.32437356142016,84.3953092307692,87.68689353752268,81.10372492401574,112.15760550000036,92.741411,87.11042140000004,84.48245100000005,87.05334333333332,240075120,355900716.0,53.591854250937814,1.5,2.75,3.1171792382906283,0.6745564400606601,0.4533232139621455,-0.6271688017138217,-1.0804920156759672,37.240443356102865,3.0403525375606253,1806620413.0,2009-02-09,2009,0,40,2,1.65,87.03,87.03,82.45,2288
2009-02-10 14:30:00,86.27,87.03,82.45,83.11,58.01600000000001,90.70775121951219,111.87515545000036,92.406411,86.99322140000004,84.29045100000005,87.56559892203477,85.11348084128491,84.42300153846152,87.66442675589062,81.18157632103241,111.87515545000036,92.406411,86.99322140000004,84.29045100000005,84.19666666666667,536212736,368810936.8,44.318410384540385,1.5,2.75,3.226667149841297,1.4538959735100785,0.2766314891105668,-0.7347026542877586,-1.0113341433983254,46.90673417686094,-4.897585536102531,1270407677.0,2009-02-10,2009,1,41,2,5.55,84.74,84.05,82.39999,2289
2009-02-11 14:30:00,83.45,84.05,82.39999,83.60001,57.70800000000001,90.55392926829269,111.59500550000037,92.041711,86.86342160000004,84.11495150000005,87.41008563097456,84.96934076116253,84.46069461538461,87.6511657032597,81.27022352750951,111.59500550000037,92.041711,86.86342160000004,84.11495150000005,83.35000000000002,324674560,367208082.4,45.56419385704611,1.5,2.75,3.11404878199549,0.8841705168306503,0.19187449307606494,-0.7714910270532442,-0.9633655201293092,41.802611225764494,-1.1235836782968651,1595082237.0,2009-02-11,2009,2,42,2,2.0,83.22,83.82001,81.05,2290
2009-02-12 14:30:00,82.17,83.82001,81.05,83.66,57.40000000000001,90.40010731707315,111.31790550000035,91.637111,86.89442160000004,84.07945150000005,87.26302344936771,84.84464164105182,84.45915692307693,87.65115052054917,81.26716332560468,111.31790550000035,91.637111,86.89442160000004,84.07945150000005,82.84333666666666,469302272,368874834.4,45.72429521426894,1.5,2.75,3.0894745832815262,1.2722534264592815,0.14130331320206524,-0.7867363786267276,-0.9280396918287928,37.64192299909625,1.0020523964747052,2064384509.0,2009-02-12,2009,3,43,2,3.42,82.44,84.24001,82.74001,2291
2009-02-13 14:30:00,83.55,84.24001,82.74001,82.75999,57.09200000000001,90.24628536585364,111.04040550000036,91.2516109,86.84422140000002,83.99745150000005,87.0864339023337,84.64610338952306,84.32300230769229,87.63985111900696,81.00615349637766,111.04040550000036,91.2516109,86.84422140000002,83.99745150000005,83.24667,293998336,356884306.4,43.65010398392366,1.5,2.75,2.9759406844757033,0.8237917182900257,0.05322314932358796,-0.861510755174308,-0.914733904497896,36.18695112122261,0.2179583434245624,1770386173.0,2009-02-13,2009,4,44,2,1.81,83.49,82.95799,79.17,2292
2009-02-17 14:30:00,80.16,82.95799,79.17,79.22,56.784000000000006,90.09246341463414,110.73090550000036,90.8583109,86.68222120000001,83.70545150000007,86.77794629832061,84.12933163813993,83.69454076923077,87.50765403628921,79.88142750217231,110.73090550000036,90.8583109,86.68222120000001,83.70545150000007,80.44933,478910720,360864492.0,36.6145967652569,1.5,2.75,3.0339442070131524,1.3271206522585768,-0.22234827377163613,-1.1926692467124411,-0.9703209729408051,44.05397091541049,-5.397670719169962,1291475453.0,2009-02-17,2009,1,48,2,4.78,81.06,79.94,78.28,2293
2009-02-18 14:30:00,79.78999,79.94,78.28,79.03,56.476000000000006,89.93864146341463,110.41850555000036,90.459311,86.55682120000002,83.62845100000007,86.47410526701393,83.64368100593613,83.26992538461538,87.77416986931546,78.7656808999153,110.41850555000036,90.459311,86.55682120000002,83.62845100000007,79.08333333333333,362970112,358007570.4,36.276630524339936,1.5,2.75,2.935805335083641,1.0138615549231411,-0.38669436417090375,-1.4536889281544347,-1.0669945639835308,42.573408602674,-5.160206408256327,928505341.0,2009-02-18,2009,2,49,2,2.12,79.11,80.14999,78.02,2294
2009-02-19 14:30:00,79.84,80.14999,78.02,78.181,56.168000000000006,89.78481951219511,110.10526055000037,90.03322109999999,86.36184140000002,83.33500100000006,86.14888545262123,83.12342567203744,82.91230999999999,88.17400855673758,77.65061144326243,110.10526055000037,90.03322109999999,86.36184140000002,83.33500100000006,78.78366333333331,316869632,355612690.4,34.733827500584354,1.5,2.75,2.8782470968633818,0.8910526551894955,-0.5138857629810079,-1.7093517677097907,-1.1954660047287828,42.66278553798398,-7.5546993550077595,611635709.0,2009-02-19,2009,3,50,2,2.73,79.08,78.34,75.77,2295
2009-02-20 14:30:00,76.73,78.34,75.77,77.42,55.86000000000002,89.63099756097559,109.78211055000034,89.59892099999999,86.09024140000002,83.06850100000007,85.80657621918509,82.58024227470055,82.51538692307693,88.5405827170106,76.49019112914327,109.78211055000034,89.59892099999999,86.09024140000002,83.06850100000007,77.17666666666669,477176576,358074501.6,33.36412899738696,1.5,2.75,2.8562294470874265,1.3326181391520786,-0.6043345335913752,-1.9508841717180017,-1.3465496381266266,40.485503398014714,-10.990009082652133,134459133.0,2009-02-20,2009,4,51,2,3.39,77.06,78.27,74.59,2296
2009-02-23 14:30:00,78.27,78.27,74.59,74.64999,55.55200000000002,89.47717560975609,109.45776050000036,89.23162090000002,85.79324120000003,82.64550050000008,85.36906303411901,81.82498015330049,81.81615461538466,89.09084055774548,74.54146867302383,109.45776050000036,89.23162090000002,85.79324120000003,82.64550050000008,75.83666333333333,379644672,357716703.2,28.897196294339516,1.5,2.75,2.915070200866896,1.0612998179951918,-0.7938451867942078,-2.3388561216193864,-1.5450109348251786,35.60413155805275,-14.293936361201329,-245185539.0,2009-02-23,2009,0,54,2,4.93,76.43,77.95,74.7003,2297
2009-02-24 14:30:00,75.28999,77.95,74.7003,77.48,55.24400000000002,89.32335365853659,109.14936050000034,88.84652080000002,85.54064120000002,82.33550100000008,85.05968801317317,81.41117251965281,81.36615461538463,88.9286417839933,73.803667446776,109.14936050000034,88.84652080000002,85.54064120000002,82.33550100000008,76.71010000000003,426412288,363123845.6,38.026304019804826,1.5,2.75,2.9425659008049747,1.1742888636118805,-0.6763219197747445,-2.3904133345436094,-1.7140914147688648,46.09951680525285,-6.7741547346889615,181226749.0,2009-02-24,2009,1,55,2,4.35,76.33,78.42,75.63,2298
2009-02-25 14:30:00,77.14,78.42,75.63,76.87199,54.93600000000002,89.16953170731706,108.83922050000034,88.45464070000001,85.319281,81.9526005000001,84.73860181657814,80.97886942254303,80.77399923076928,88.44504051683515,73.1029579447034,108.83922050000034,88.45464070000001,85.319281,81.9526005000001,76.97399666666666,462039552,372520223.2,36.92927081312586,1.5,2.75,2.9316683364617626,1.240307299375633,-0.5903814337479685,-2.4520682069538253,-1.8616867732058568,40.286519087688475,-8.047869850733273,-280812803.0,2009-02-25,2009,2,56,2,3.69,77.03,79.6667,75.53,2299
2009-02-26 14:30:00,77.82001,79.6667,75.53,75.62,54.62800000000002,89.01570975609755,108.51502045000035,88.09234060000004,85.05188079999998,81.36410050000008,84.38100958847704,80.46850090611036,79.90023000000005,87.1194856759527,72.68097432404737,108.51502045000035,88.09234060000004,85.05188079999998,81.36410050000008,76.9389,363371264,374172920.8,34.70877593085429,1.5,2.75,3.0177420267144943,0.9711319120130192,-0.5684932657106092,-2.5723033553441184,-2.0038100896335087,39.54299233372765,-9.610327516136737,-644184067.0,2009-02-26,2009,3,57,2,5.48,77.6,75.68719,73.81,2300
2009-02-27 14:30:00,74.00999,75.68719,73.81,73.92999,54.32000000000002,88.86188780487804,108.18227040000036,87.72824050000004,84.7754806,80.8331000000001,83.97116568304656,79.8457855817189,78.8871515384616,85.44686637002566,72.32743670689753,108.18227040000036,87.72824050000004,84.7754806,80.8331000000001,74.47572666666666,470568960,382971794.4,31.91881039302004,1.5,2.75,2.9362740248063166,1.2287300706759308,-0.6145569655849115,-2.7720062966146486,-2.1574493310297367,39.487891155783366,-10.669406799106667,-1114753027.0,2009-02-27,2009,4,58,2,2.54,74.75,73.9169,70.37,2301
2009-03-02 14:30:00,72.52,73.9169,70.37,70.60001,54.01200000000002,88.70806585365852,107.83142045000034,87.38704060000003,84.3498808,80.2216005000001,83.44680663665257,78.96523552631709,77.92484461538467,85.33902762337539,70.51066160739396,107.83142045000034,87.38704060000003,84.3498808,80.2216005000001,71.62897,426453248,385121247.2,27.26780580825336,1.5,2.75,2.9808251658915794,1.1073220475382801,-0.8040551990501297,-3.1625183298423987,-2.358463130792269,43.910443351399685,-10.881078010603382,-1541206275.0,2009-03-02,2009,0,61,3,5.04,72.14,71.7,69.64,2302
2009-03-03 14:30:00,71.61,71.7,69.64,70.07001,53.70400000000002,88.55424390243903,107.4691205000003,87.08744070000004,83.93148079999997,79.59610100000009,82.92222637639169,78.11807119047737,76.88407538461544,84.61139302941741,69.15675773981349,107.4691205000003,87.08744070000004,83.93148079999997,79.59610100000009,70.47000333333334,443761152,392884856.8,26.603366084058024,1.5,2.75,2.915051939756467,1.129494161761238,-0.8930008220737511,-3.4747141583844576,-2.581713336310707,40.28956475379929,-11.337454131342534,-1984967427.0,2009-03-03,2009,1,62,3,2.96,70.67,72.87,70.07291,2303
2009-03-04 14:30:00,71.23,72.87,70.07291,71.73,53.39600000000002,88.4004219512195,107.11447050000034,86.82964080000002,83.58028099999997,78.9956005000001,82.48331553810182,77.50968345805096,75.96638307692314,83.06492990314206,68.8678362507042,107.11447050000034,86.82964080000002,83.58028099999997,78.9956005000001,71.55763666666667,462763264,402098988.0,32.17769069574804,1.5,2.75,2.9068332297738637,1.1508690093992475,-0.772463965272737,-3.547293292901628,-2.7748293276288907,45.03572684547238,-8.251365421266028,-1522204163.0,2009-03-04,2009,2,63,3,3.99,71.47,71.73,68.17,2304
2009-03-05 14:30:00,70.10001,71.73,68.17,68.8,53.08800000000002,88.24659999999999,106.7432205000003,86.6106408,83.19248099999999,78.26910050000009,81.9467149287645,76.68018979537943,74.89253769230777,81.77570609159831,68.0093692930172,106.7432205000003,86.6106408,83.19248099999999,78.26910050000009,69.56666666666666,485551104,410226847.2,28.1183722629751,1.5,2.75,2.9534879990757297,1.1836161073175124,-0.8181081267950859,-3.7974644861227485,-2.9793563593276633,48.651640329747785,-11.134073882717647,-2007755267.0,2009-03-05,2009,3,64,3,5.22,69.95,70.45,67.10001,2305
2009-03-06 14:30:00,69.39999,70.45,67.10001,68.92,67.10001,88.09277804878046,106.3783705000003,86.41484080000002,82.82968099999998,77.4866000000001,81.43586336293059,75.94112410058139,74.10023000000007,81.17699655136107,67.02346344863908,106.3783705000003,86.41484080000002,82.82968099999998,77.4866000000001,68.82333666666666,490495232,413867615.2,28.516117228337134,1.5,2.75,2.981809570570321,1.185150067281708,-0.7690100802197017,-3.94061895960229,-3.1716088793825876,49.35436758780435,-7.675808128038597,-1517260035.0,2009-03-06,2009,4,65,3,4.99,68.78,70.0,67.73,2306
2009-03-09 13:30:00,67.95,70.0,67.73,68.11,66.99658157142856,87.93895609756096,106.02147045000031,86.0824407,82.46868099999998,76.5431500000001,80.91328048595292,75.19530275766887,73.26023000000006,80.38914088613585,66.13131911386427,106.02147045000031,86.0824407,82.46868099999998,76.5431500000001,68.61333333333334,379907328,414557906.4,27.41346349246088,1.5,2.75,2.9309660298152984,0.916415589076798,-0.7207009516252589,-4.072485068914162,-3.351784117288904,46.7886582726784,-12.0934434692824,-1897167363.0,2009-03-09,2009,0,68,3,3.35,68.87,72.37,69.37,2307
2009-03-10 13:30:00,69.50999,72.37,69.37,72.17,66.89315314285714,87.78513414634146,105.68477050000031,85.80564059999999,82.17888099999998,75.7966495000001,80.57040674140575,74.90717868550995,72.79784538461544,79.34623764789848,66.24945312133241,105.68477050000031,85.80564059999999,82.17888099999998,75.7966495000001,71.30333333333334,406230784,422865689.6,39.94784852525321,1.5,2.75,3.0258970276856343,0.9606614913219008,-0.3629840998417517,-3.805514242091093,-3.442530142249341,55.04840986346456,-6.1166492502665735,-1490936579.0,2009-03-10,2009,1,69,3,4.32,70.87,73.75,71.83,2308
2009-03-11 13:30:00,73.0,73.75,71.83,72.64,66.78972471428571,87.63131219512194,105.35977050000031,85.63184059999998,81.888481,75.27314950000013,80.25941039860552,74.69125690593758,72.43015307692312,78.41134710888932,66.44895904495695,105.35977050000031,85.63184059999998,81.888481,75.27314950000013,72.74,356809984,413895552.0,41.213405686179534,1.5,2.75,2.946904382850946,0.8620773581060374,-0.0583666887743548,-3.515488503217284,-3.457121814442929,55.587667434043816,-3.940756413647189,-1134126595.0,2009-03-11,2009,2,70,3,2.67,72.79,75.75,71.97,2309
2009-03-12 13:30:00,72.62,75.75,71.97,75.5,66.68629628571428,87.47749024390242,105.0439705000003,85.44914059999998,81.66028100000001,74.8681490000001,80.07276685356217,74.76828005775305,72.49553846153853,78.58988445639629,66.40119246668078,105.0439705000003,85.44914059999998,81.66028100000001,74.8681490000001,74.40666666666667,409818624,418152755.2,48.346901796492226,1.5,2.75,3.0064112126473077,0.9800691706646444,0.3496577195290351,-3.0200496650316357,-3.3697073845606704,60.438617730815714,2.1236442748064706,-724307971.0,2009-03-12,2009,3,71,3,5.25,73.86,76.98,74.73,2310
2009-03-13 13:30:00,76.00999,76.98,74.73,76.09,66.58286785714286,87.32366829268291,104.72792050000031,85.27794049999999,81.402681,74.4896490000001,79.91657991812836,74.89415814749087,72.38861538461545,78.17015354666519,66.60707722256572,104.72792050000031,85.27794049999999,81.402681,74.4896490000001,75.93333333333334,337474560,411561369.6,49.7028350024081,1.5,2.75,2.9523818403153568,0.8199859970531111,0.6554432791245071,-2.5504032856550367,-3.205846564779544,58.80731287442686,7.776188700256567,-386833411.0,2009-03-13,2009,4,72,3,3.01,75.86,77.97,75.81,2311
2009-03-16 13:30:00,76.96001,77.97,75.81,75.86,66.47943942857142,87.16984634146341,104.40722050000035,85.0484405,81.1150808,74.1446495000001,79.75749835271156,74.98614308582506,72.31077000000006,77.87179317350383,66.74974682649629,104.40722050000035,85.0484405,81.1150808,74.1446495000001,76.54666666666667,360821248,414902515.2,49.161054195906495,1.5,2.75,2.8957831374356884,0.8696530745928821,0.8272933525786543,-2.1717298740562256,-2.9990232266348795,50.280532284044895,8.263149955308988,-747654659.0,2009-03-16,2009,0,75,3,2.85,76.89,78.36,75.45,2312
2009-03-17 13:30:00,76.07001,78.36,75.45,78.17999,66.37601099999999,87.0160243902439,104.09637040000034,84.87164039999998,80.81948040000002,74.0926490000001,79.6956352800562,75.29031898241315,72.50769230769238,78.67207641118013,66.3433082042046,104.09637040000034,84.87164039999998,80.81948040000002,74.0926490000001,77.32999666666667,357075200,408810739.2,54.54351930706064,1.5,2.75,2.8967986276188533,0.8734486787180761,1.0670354289253658,-1.6652289404781726,-2.7322643694035387,50.88530311064976,8.992039592917887,-390579459.0,2009-03-17,2009,1,76,3,3.86,76.9,80.89999,77.07001,2313
2009-03-18 13:30:00,77.81,80.89999,77.07001,79.92999,66.27258257142857,86.86220243902437,103.80152040000034,84.76454030000002,80.56108,74.1376485000001,79.70482566123047,75.73219241265951,72.96923076923082,80.28196241728159,65.65649912118008,103.80152040000034,84.76454030000002,80.56108,74.1376485000001,79.29999666666667,473552384,414339852.8,58.14337821883881,1.5,2.75,2.9634544399317924,1.1429081243328567,1.297955801820354,-1.1098196171280958,-2.40777541894845,50.77631349827686,16.17731104651164,82972925.0,2009-03-18,2009,2,77,3,4.97,78.98,81.0,78.69,2314
2009-03-19 13:30:00,80.92999,81.0,78.69,78.94,66.16915414285714,86.70838048780485,103.5057704000003,84.63704030000002,80.27047999999998,74.17559850000009,79.67483249804495,76.03769789716812,73.61076846153854,81.42561830454851,65.79591861852856,103.5057704000003,84.63704030000002,80.27047999999998,74.17559850000009,79.54333333333334,428597248,419926233.6,55.46726863173868,1.5,2.75,2.916779122793808,1.0206488990355853,1.3334236098660457,-0.7409959066158933,-2.074419516481939,41.686897181585394,14.53859547301218,-345624323.0,2009-03-19,2009,3,78,3,2.94,79.84,78.91,76.53,2315
2009-03-20 13:30:00,78.75999,78.91,76.53,76.71001,66.0657257142857,86.55455853658535,103.19922045000031,84.53374050000002,79.99128019999998,74.14009900000009,79.55856494910202,76.10172762124733,74.12153769230775,81.81089944759783,66.43217593701767,103.19922045000031,84.53374050000002,79.99128019999998,74.14009900000009,77.38333666666666,371165696,414625689.6,49.89632246891339,1.5,2.75,2.880580614022821,0.8951825834961481,1.1623532104394372,-0.6214780034326424,-1.7838312138720795,48.039292555117115,12.62664806929966,-716790019.0,2009-03-20,2009,4,79,3,3.11,77.72,82.28999,78.31,2316
2009-03-23 13:30:00,78.74001,82.28999,78.31,82.22,65.96229728571429,86.40073658536583,102.90642045000031,84.5164405,79.81483999999998,74.5185995000001,79.66293495109801,76.6844202287476,74.92846076923081,83.58536445802652,66.27155708043513,102.90642045000031,84.5164405,79.81483999999998,74.5185995000001,80.93999666666666,420247296,416655820.8,60.46280835584473,1.5,2.75,3.0733948558783344,1.0086197648531687,1.3620946604065376,-0.08121288836390761,-1.4433075487704452,56.01570165086371,13.925453789663294,-296542723.0,2009-03-23,2009,0,82,3,5.08,80.3,82.36,80.50999,2317
2009-03-24 13:30:00,81.24001,82.36,80.50999,80.60001,65.85886885714285,86.24691463414631,102.6279705500003,84.3848407,79.64504019999998,74.6746000000001,79.69968299223143,77.05733354029546,75.83615384615389,84.20200185030718,67.4703058420006,102.6279705500003,84.3848407,79.64504019999998,74.6746000000001,81.15666666666667,330843904,411877401.6,56.678181328800065,1.5,2.75,2.986010223315596,0.8032582091534686,1.3256598609687755,0.2137672774405246,-1.1118925835282512,53.91671808150405,10.958163546255506,-627386627.0,2009-03-24,2009,1,83,3,2.3,81.43,82.7,79.06,2318
2009-03-25 13:30:00,81.23,82.7,79.06,81.45,65.75544042857142,86.09309268292681,102.35212055000031,84.26854070000002,79.53504019999998,74.90350050000009,79.76832287488901,77.47568272693397,76.80000000000005,84.62627102482641,68.97372897517371,102.35212055000031,84.26854070000002,79.53504019999998,74.90350050000009,81.07,441995008,410875174.4,58.15808184881407,1.5,2.75,3.032723778793053,1.0757403599412991,1.2977112425903037,0.5102464697096281,-0.7874647728806753,53.84203795106911,7.8807947019867575,-185391619.0,2009-03-25,2009,2,84,3,4.6,80.88,83.3,81.32001,2319
2009-03-26 13:30:00,82.25,83.3,81.32001,83.11,65.652012,85.93927073170731,102.08797055000035,84.13664070000003,79.45504019999998,75.27800050000009,79.8993690366581,78.01228437198787,77.9538461538462,84.6576106919582,71.2500816157342,102.08797055000035,84.13664070000003,79.45504019999998,75.27800050000009,82.57667,422025216,413807872.0,60.96276524813199,1.5,2.75,2.9575285088792636,1.019857872592622,1.325281910300538,0.8691376149949974,-0.4561442953055407,51.4288024701036,9.225916677618605,236633597.0,2009-03-26,2009,3,85,3,2.43,82.31,82.53,81.31,2320
2009-03-27 13:30:00,82.05,82.53,81.31,81.61,65.54858357142857,85.78544878048778,101.82632055000036,83.98444070000005,79.39984019999999,75.66200100000009,79.96645260384797,78.35492395560806,78.68000000000005,84.73401796649608,72.62598203350402,101.82632055000036,83.98444070000005,79.39984019999999,75.66200100000009,81.81666666666666,322343680,406396608.0,57.22973226678018,1.5,2.75,2.8748479011021737,0.7931751241388314,1.1815212877697652,1.0207573144066655,-0.1607639733630994,53.86525515361378,7.57975217505932,-85710083.0,2009-03-27,2009,4,86,3,1.5,81.92,79.87,77.96001,2321
2009-03-30 13:30:00,79.8,79.87,77.96001,78.78999,65.44515514285713,85.63162682926827,101.54802050000036,83.80124060000001,79.2876402,76.0715000000001,79.92031681546177,78.39635881697873,79.1530761538462,84.10631186972198,74.19984043797045,101.54802050000036,83.80124060000001,79.2876402,76.0715000000001,78.87333333333333,324108544,401279372.8,50.91717227907653,1.5,2.75,2.93021519388059,0.8076880247755411,0.8509768207128756,0.9029570525279952,0.051980231815119515,58.95848196008125,0.7802508033065743,-409818627.0,2009-03-30,2009,0,89,3,2.45,78.92,81.08,79.05,2322
2009-03-31 13:30:00,79.56,81.08,79.05,79.52,65.34172671428571,85.47780487804876,101.26487055000034,83.59234060000003,79.1768402,76.54399950000007,79.90461811681621,78.50337226298076,79.46230692307698,83.94419622992163,74.98041761623233,101.26487055000034,83.59234060000003,79.1768402,76.54399950000007,79.88333333333333,364238336,397303232.0,52.38144790849558,1.5,2.75,2.8844862514605474,0.9167766750007208,0.6453019802700191,0.8586077071526432,0.21330572688262428,56.725652441863204,-0.5129363834525784,-45580291.0,2009-03-31,2009,1,90,3,2.57,80.06,81.42,78.33,2323
2009-04-01 13:30:00,78.53,81.42,78.33,81.06,65.23829828571428,85.32398292682925,100.98902055000036,83.44104060000002,79.18664,77.01049950000008,79.94992721027441,78.74686061888735,79.84461461538467,83.94204075570428,75.74718847506506,100.98902055000036,83.44104060000002,79.18664,77.01049950000008,80.27,377018368,393015987.2,55.40394763937636,1.5,2.75,2.899165804927651,0.9592952456871454,0.5788957134312107,0.9369253686716376,0.35802965524042696,56.361007328021536,2.685583987838871,331438077.0,2009-04-01,2009,2,91,4,3.94,79.88,84.61,81.12959000000001,2324
2009-04-02 13:30:00,83.08,84.61,81.12959000000001,83.42999,65.13486985714286,85.17016097560973,100.72832045000037,83.36674050000002,79.1742398,77.74199900000009,80.08640026085187,79.19287294089807,80.42692153846161,84.2351568899804,76.61868618694281,100.72832045000037,83.36674050000002,79.1742398,77.74199900000009,83.05652666666667,476230912,392549977.6,59.64875070457753,1.5,2.75,2.9456539617185333,1.213172689275425,0.6549100190481927,1.1766671790506678,0.5217571600024751,57.60634080635667,8.760238722430108,807668989.0,2009-04-02,2009,3,92,4,4.29,82.87,84.28,82.67,2325
2009-04-03 13:30:00,83.49001,84.28,82.67,84.25999,65.03144142857144,85.01633902439022,100.47837040000034,83.27074040000002,79.2044396,78.50899850000009,80.25007044670082,79.67545551795541,80.89461384615392,84.96831097104516,76.82091672126269,100.47837040000034,83.27074040000002,79.2044396,78.50899850000009,83.73666333333334,284646144,382257523.2,61.04710472385865,1.5,2.75,2.8502501073100666,0.7446449755053507,0.7164347483166844,1.4173005953983306,0.7008658470816462,53.33460446059583,2.481135976648021,1092315133.0,2009-04-03,2009,4,93,4,1.95,83.48,84.2747,82.28999,2326
2009-04-06 13:30:00,83.34,84.2747,82.28999,83.60001,64.92801299999999,84.86251707317072,100.22427045000036,83.18044050000002,79.21423979999999,79.28349900000009,80.38144062526158,80.04922261148347,81.17692307692312,85.44798367386569,76.90586247998057,100.22427045000036,83.18044050000002,79.21423979999999,79.28349900000009,83.38823333333333,264866560,376505484.8,59.28771430269145,1.5,2.75,2.788425813930776,0.7034865910139325,0.668932521420332,1.5370314988570613,0.8680989774367293,37.715052384226624,3.722083905448647,827448573.0,2009-04-06,2009,0,96,4,2.41,83.28,82.64999,81.50999,2327
2009-04-07 13:30:00,82.25,82.64999,81.50999,81.64999,64.82458457142856,84.7086951219512,99.97462040000036,83.09924040000001,79.17363979999998,79.75749850000008,80.43118765956505,80.20167664848505,81.38538384615389,85.45936909538568,77.31139859692209,99.97462040000036,83.09924040000001,79.17363979999998,79.75749850000008,81.93665666666669,259071936,369147542.4,54.3074799852369,1.5,2.75,2.738539684364291,0.7018113524897194,0.4717324842718209,1.4577645827765051,0.9860320985046844,38.53837504341678,0.24553713934929364,568376637.0,2009-04-07,2009,1,97,4,1.4,82.08,82.94,81.53999,2328
2009-04-08 13:30:00,82.06,82.94,81.53999,82.53,64.72115614285714,84.55487317073171,99.73002040000034,83.06634030000005,79.1336398,80.25199850000007,80.51349402585659,80.4234217295817,81.8330753846154,84.91088037903883,78.75527039019201,99.73002040000034,83.06634030000005,79.1336398,80.25199850000007,82.33666333333333,230402752,362827180.8,56.09967803138247,1.5,2.75,2.6429304211954125,0.6350206494783094,0.37057304097126775,1.4492483997187688,1.078675358747501,38.558592715355,-0.697870292383586,798779389.0,2009-04-08,2009,2,98,4,1.72,82.24,85.82001,84.33,2329
2009-04-09 13:30:00,84.67,85.82001,84.33,85.81,64.6177277142857,84.40105121951218,99.50312040000036,83.01274030000002,79.10203979999999,80.76749850000007,80.72120014248969,80.93642918390725,82.10922923076926,85.84931142146706,78.36914704007145,99.50312040000036,83.01274030000002,79.10203979999999,80.76749850000007,85.32000333333333,269653504,355818924.8,62.07115101837671,1.5,2.75,2.689150391110026,0.7578391288534408,0.4872300705211745,1.6877129468989691,1.2004828763777948,43.14662082612238,5.1464281338071345,1068432893.0,2009-04-09,2009,3,99,4,1.77,85.08,86.53999,84.58,2330
2009-04-13 13:30:00,84.92,86.53999,84.58,85.83,64.51429928571429,84.24722926829267,99.27322040000037,83.00484030000001,79.12763979999998,81.25449850000008,80.92154523494106,81.40248354734466,82.5115361538462,86.6224607858976,78.40061152179477,99.27322040000037,83.00484030000001,79.12763979999998,81.25449850000008,85.64999666666667,224847440,350187568.8,62.10499929187351,1.5,2.75,2.6370675060307387,0.6420771610211424,0.525138811259009,1.856906390451556,1.331767579192547,41.049991837392774,8.935157879827116,1293280333.0,2009-04-13,2009,0,103,4,2.32,85.56,85.75999,84.08,2331
2009-04-14 13:30:00,85.03,85.75999,84.08,84.35001,64.41087085714285,84.09340731707316,99.05382045000034,82.99364040000002,79.15803999999999,81.67899900000008,81.05599483357081,81.68320035235946,82.73461384615388,86.90521531033806,78.56401238196969,99.05382045000034,82.99364040000002,79.15803999999999,81.67899900000008,84.73,276598784,345976445.6,57.98146588239666,1.5,2.75,2.5737055413142573,0.7994728760228641,0.4147796562212396,1.8502421494690964,1.4354624932478568,35.598015688612854,6.073956237424549,1016681549.0,2009-04-14,2009,1,104,4,2.0,84.92,85.42,83.61,2332
2009-04-15 13:30:00,83.84,85.42,83.61,85.25,64.30744242857142,83.93958536585366,98.84242045000036,82.97534040000002,79.21144,82.03249950000007,81.22046562441119,82.02289555689664,82.89922923076928,87.27975272171373,78.51870573982481,98.84242045000036,82.97534040000002,79.21144,82.03249950000007,84.75999999999998,250726064,340658988.8,59.73237095884096,1.5,2.75,2.5191551455060965,0.7360030771041847,0.36821366259966704,1.8957295714974407,1.5275159088977737,35.64118428459771,5.169010609425113,1267407613.0,2009-04-15,2009,2,105,4,2.16,84.52,87.14999,84.77,2333
2009-04-16 13:30:00,85.92999,87.14999,84.77,86.5,64.204014,83.78576341463412,98.63502045000037,83.02534040000002,79.2666398,82.36100000000008,81.42750618815975,82.44928645623982,83.27538307692312,87.97655316018623,78.57421299366005,98.63502045000037,83.02534040000002,79.2666398,82.36100000000008,86.13999666666666,335202816,333741510.4,62.094895944544575,1.5,2.75,2.5092147779699467,1.0043785551226414,0.3855706401009418,2.009479209023951,1.623908568923009,35.15755950467719,3.6797439386004913,1602610429.0,2009-04-16,2009,3,106,4,2.81,85.96,87.64999,86.14,2334
2009-04-17 13:30:00,86.83,87.64999,86.14,87.08,64.10058557142857,83.63194146341462,98.42852045000036,83.14164040000001,79.3416398,82.76800000000007,81.64917261215348,82.89030679374079,83.9130761538462,88.24180406737766,79.58434824031472,98.42852045000036,83.14164040000001,79.3416398,82.76800000000007,86.95666333333332,262648944,325444095.2,63.17451729208592,1.5,2.75,2.4378415795435227,0.8070478090517834,0.3984467878270643,2.12196705370684,1.7235202658797752,32.1916374622929,3.3467960297645374,1865259373.0,2009-04-17,2009,4,107,4,1.75,86.89,87.0489,83.34,2335
2009-04-20 13:30:00,85.53999,87.0489,83.34,83.42999,63.99715714285714,83.47811951219511,98.21477045000036,83.18074030000002,79.3188394,83.10399900000007,81.71900858814747,82.9417051943369,84.21384461538467,87.75074372867157,80.67694550209777,98.21477045000036,83.18074030000002,79.3188394,83.10399900000007,84.60629666666667,293690112,321570316.0,52.95300559759029,1.5,2.75,2.530852895290413,0.913299820870282,0.13698195236527974,1.894747706336375,1.7577657539710951,41.63059812272845,-0.20337318141468386,1571569261.0,2009-04-20,2009,0,110,4,4.45,85.19,85.13,82.75,2336
2009-04-21 13:30:00,82.82001,85.13,82.75,85.06,63.89372871428571,83.3242975609756,98.00852045000036,83.18104029999999,79.2804594,83.24599900000007,81.85002785920051,83.14344755678101,84.52153692307698,87.56960585492676,81.47346799122721,98.00852045000036,83.18104029999999,79.2804594,83.24599900000007,84.31333333333333,300478464,315581874.4,56.349590086023376,1.5,2.75,2.520077688483955,0.9521410713821402,0.053918253966927836,1.8251635714297547,1.7712453174628269,42.8931688889224,4.176375281858577,1872047725.0,2009-04-21,2009,1,111,4,2.88,83.94,86.34,84.07001,2337
2009-04-22 13:30:00,84.28999,86.34,84.07001,84.53999,63.79030028571428,83.17047560975608,97.80612040000037,83.1698402,79.229259,83.44299800000006,81.95551657060442,83.27645159899235,84.60692153846159,87.5893801319424,81.62446294498078,97.80612040000037,83.1698402,79.229259,83.44299800000006,84.98333333333333,340395008,316059429.6,54.9857397337012,1.5,2.75,2.5022142821636733,1.0769968433810018,-0.050304875766720825,1.708364222754426,1.7586690985211468,40.2120209808788,2.4354658911910843,1531652717.0,2009-04-22,2009,2,112,4,2.7,85.21,85.42,83.63,2338
2009-04-23 13:30:00,84.71001,85.42,83.63,85.37,63.68687185714285,83.01665365853655,97.59677035000037,83.13384020000002,79.274459,83.63899800000004,82.0894178815611,83.47583716099307,84.69230692307698,87.69364463591965,81.69096921023433,97.59677035000037,83.13384020000002,79.274459,83.63899800000004,84.80666666666667,324903680,310204863.2,56.7836990606805,1.5,2.75,2.4513418334376964,1.0473842242457791,-0.07605700095920788,1.6635978473221371,1.739654848281345,40.15321201925348,-0.5127607504952776,1856556397.0,2009-04-23,2009,3,113,4,2.14,84.52,87.31,85.69,2339
2009-04-24 13:30:00,86.03,87.31,85.69,86.66,63.58344342857142,82.86283170731707,97.40612040000036,83.0995402,79.33565879999998,83.81649800000005,82.26865639600969,83.77909076470802,84.92769076923084,88.0277911387044,81.82759039975728,97.40612040000036,83.0995402,79.33565879999998,83.81649800000005,86.55333333333333,287703040,303488754.4,59.491793640467655,1.5,2.75,2.414817416763575,0.9479858341663812,-0.021746215315895826,1.7124720791364751,1.7342182944523707,34.32488541402733,0.9670278457415802,2144259437.0,2009-04-24,2009,4,114,4,1.89,86.5,87.00999,85.53999,2340
2009-04-27 13:30:00,85.67999,87.00999,85.53999,85.84,63.480015,82.70900975609754,97.20882040000036,83.13684020000002,79.3792588,84.02799800000005,82.40870908636225,83.9753678347358,85.2499992307693,87.72902091129295,82.77097755024563,97.20882040000036,83.13684020000002,79.3792588,84.02799800000005,86.12999333333335,289581568,301850648.8,57.044755246791155,1.5,2.75,2.34733045842332,0.9593538034495688,-0.054706315996539516,1.6658353994566966,1.7205417154532359,34.852772057720806,1.7664372535344168,1854677869.0,2009-04-27,2009,0,117,4,1.72,86.27,86.59,84.75999,2341
2009-04-28 13:30:00,84.97,86.59,84.75999,85.57001,63.37658657142857,82.55518780487803,97.01747045000036,83.13984029999999,79.43545920000001,84.36699900000005,82.5326816712108,84.12723851714193,85.4838461538462,87.40267165142963,83.56502065626277,97.01747045000036,83.13984029999999,79.43545920000001,84.36699900000005,85.63999999999999,247927872,298041615.2,56.224725560578186,1.5,2.75,2.3103789971073683,0.831856557459698,-0.1054132545288886,1.5887751472921252,1.6941884018210138,33.17204954089571,0.3753782991202304,1606749997.0,2009-04-28,2009,1,118,4,2.16,85.67,88.36,86.3,2342
2009-04-29 13:30:00,86.52,88.36,86.3,87.39,63.27315814285714,82.40136585365852,96.84082045000034,83.14054019999998,79.59885919999998,84.76049900000007,82.72316474292802,84.43797770598556,85.60538461538468,87.77518872406564,83.4355805067037,96.84082045000034,83.14054019999998,79.59885919999998,84.76049900000007,87.35000000000002,311505664,295404981.6,60.361286361110665,1.5,2.75,2.3446369258854136,1.054503760609567,-0.030967526550572888,1.6554789936327978,1.6864465201833707,34.72798430294275,1.028901734104047,1918255661.0,2009-04-29,2009,2,119,4,2.39,87.33,89.02,86.92,2343
2009-04-30 13:30:00,88.55,89.02,86.92,87.42,63.16972971428571,82.247543902439,96.67297040000031,83.1617402,79.76665919999998,85.07849900000006,82.90735436085241,84.72197982922503,85.72769230769238,88.10379576114849,83.35158885423625,96.67297040000031,83.1617402,79.76665919999998,85.07849900000006,87.78666666666668,301419776,291625052.0,60.427666648730096,1.5,2.75,2.3271628597507408,1.0335867029695378,0.00385650131031201,1.6912671468212608,1.6874106455109488,33.868687177628665,0.3904455672944458,2219675437.0,2009-04-30,2009,3,120,4,2.42,87.97,88.21001,86.72,2344
2009-05-01 13:30:00,87.44,88.21001,86.72,87.89,63.06630128571428,82.09372195121948,96.49262035000031,83.16134029999998,79.9608392,85.30149950000006,83.10275222905427,85.02369603596551,85.9999992307693,88.49076198083564,83.509236480703,96.49262035000031,83.16134029999998,79.9608392,85.30149950000006,87.60667,236110320,279619022.4,61.515023486918395,1.5,2.75,2.2673662269114017,0.8444000625330847,0.04009186438624024,1.7375254759937488,1.6974336116075088,33.797002702935146,5.345811500157193,2455785757.0,2009-05-01,2009,4,121,5,1.72,87.47,90.94,88.38,2345
2009-05-04 13:30:00,88.55,90.94,88.38,90.88,62.96287285714285,81.93989999999998,96.32102035000031,83.16014029999998,80.2300392,85.63250000000008,83.40774233771882,85.58143927063547,86.43307615384626,89.98386621047231,82.8822860972202,96.32102035000031,83.16014029999998,80.2300392,85.63250000000008,90.06666666666666,287119872,279742708.8,67.61209515041392,1.5,2.75,2.3232686392748727,1.0263712438892347,0.2360414427761377,1.992485415077681,1.7564439723015433,24.85174212023428,6.842229014813065,2742905629.0,2009-05-04,2009,0,124,5,2.9,89.66,90.92999,89.84,2346
2009-05-05 13:30:00,90.57001,90.92999,89.84,90.57001,62.85944442857142,81.78607804878047,96.1439704000003,83.17084039999997,80.5484396,85.98100000000005,83.6886155793769,86.05654124486067,86.74615384615394,90.92713168883029,82.56517600347756,96.1439704000003,83.17084039999997,80.5484396,85.98100000000005,90.44666666666667,243036256,278651193.6,66.43692493527095,1.5,2.75,2.2351773078980957,0.8721881031985645,0.3106891578397579,2.1448054196012407,1.8341162617614828,24.666751297618212,7.132742741038878,2499869373.0,2009-05-05,2009,1,125,5,1.21,90.38,92.2,90.61,2347
2009-05-06 13:30:00,91.67999,92.2,90.61,92.14101,62.756016,81.63225609756095,95.97442545000031,83.19115049999995,80.8416598,86.50555100000004,84.02008202724447,86.63601445963585,87.1354623076924,92.21436578542463,82.05655882996018,95.97442545000031,83.19115049999995,80.8416598,86.50555100000004,91.65033666666666,291941120,280294652.8,69.34490993774345,1.5,2.75,2.1919496430482326,1.0415508005010359,0.4247263224326594,2.3650241648023065,1.9402978423696475,23.99809928080101,7.931369333489504,2791810493.0,2009-05-06,2009,2,126,5,1.75,91.4,93.14999,90.28,2348
2009-05-07 13:30:00,93.00999,93.14999,90.28,90.86,62.65258757142857,81.47843414634144,95.7913254500003,83.22035049999997,81.12142,86.92205100000004,84.28831410460744,87.03829879681338,87.70700153846163,92.66000251039064,82.7540005665326,95.7913254500003,83.22035049999997,81.12142,86.92205100000004,91.42999666666668,317800448,284664537.6,64.44193147808588,1.5,2.75,2.2403810971162157,1.1164033661493913,0.3744973616978866,2.4084195444920056,2.033922182794119,27.22834597145223,4.846526655896612,2474010045.0,2009-05-07,2009,3,127,5,3.18,91.71,93.22,90.911,2349
2009-05-08 13:30:00,92.03,93.22,90.911,92.98,62.54915914285714,93.22,95.61537545000034,83.26025039999995,81.46862000000002,87.28055100000006,84.62916453187773,87.60417510187875,88.31623230769242,93.7427341835783,82.8897304318065,95.61537545000034,83.26025039999995,81.46862000000002,87.28055100000006,92.37033333333332,299081728,286135948.8,68.42124717495096,1.5,2.75,2.2489253044650583,1.0452434559666206,0.4401336186727312,2.584089206135033,2.143955587462302,28.53728047305671,8.317800559179869,2773091773.0,2009-05-08,2009,4,128,5,2.54,92.07,92.11,91.03999,2350
2009-05-11 13:30:00,91.7,92.11,91.03999,91.24001,62.44573071428571,93.20449651162792,95.44402555000036,83.29515049999995,81.81482040000002,87.55105150000006,84.88841337376488,87.95044509217604,88.83161846153854,93.99175772526304,83.67147919781407,95.44402555000036,83.29515049999995,81.81482040000002,87.55105150000006,91.46333333333332,247923568,287289755.2,62.26250018104662,1.5,2.75,2.2268599255746966,0.862973926193105,0.3276124906699005,2.5534712007996774,2.225858710129777,30.929684673455085,6.626153251588964,2525168205.0,2009-05-11,2009,0,131,5,1.18,91.57,91.83,89.85001,2351
2009-05-12 13:30:00,91.63,91.83,89.85001,90.97,62.34230228571428,93.1889930232558,95.27147555000036,83.28605049999996,82.22222020000002,87.88205100000008,85.12690696695056,88.23802175006401,89.2623876923078,94.12085964287053,84.40391574174508,95.27147555000036,83.28605049999996,82.22222020000002,87.88205100000008,90.88333666666664,282431232,287581377.6,61.339798101991384,1.5,2.75,2.2092263594622183,0.982091519127628,0.20238830303068853,2.4788440889181373,2.2764557858874492,30.909502116503845,4.0965785558988435,2242736973.0,2009-05-12,2009,1,132,5,2.2,90.84,90.00999,88.5,2352
2009-05-13 13:30:00,89.74001,90.00999,88.5,88.67999,62.23887385714285,93.17348953488373,95.09667550000036,83.26295029999997,82.5944198,88.05355050000006,85.26624355648192,88.28011396434364,89.41777153846165,94.05767631408762,84.77786676283566,95.09667550000036,83.26295029999997,82.5944198,88.05355050000006,89.06332666666668,269618944,288526021.6,54.02693435665473,1.5,2.75,2.22785304807206,0.934470112972299,-0.053606422243478224,2.209447758083101,2.26305418032658,34.05631620271283,1.4413063372226058,1973118029.0,2009-05-13,2009,2,133,5,1.71,89.25,90.12,88.5,2353
2009-05-14 13:30:00,88.72,90.12,88.5,89.44,62.13544542857142,93.15798604651162,94.91247550000037,83.26445039999999,82.9486198,88.20055050000008,85.42992027975714,88.3905793010728,89.69469461538473,93.85204028886022,85.53734894190924,94.91247550000037,83.26445039999999,82.9486198,88.20055050000008,89.35333333333334,260098624,284770812.0,55.90578959831318,1.5,2.75,2.18443497320977,0.9133612471491636,-0.18337858967390908,2.033830943234193,2.217209532908102,34.280617267142226,1.7635680964842384,2233216653.0,2009-05-14,2009,3,134,5,1.83,89.31,90.0,88.14999,2354
2009-05-15 13:30:00,89.37,90.0,88.14999,88.71001,62.032017,93.14248255813952,94.71337555000036,83.26965049999998,83.34682,88.28205100000008,85.55855124917844,88.42100127239921,89.9362330769232,93.41671048691049,86.4557556669359,94.71337555000036,83.26965049999998,83.34682,88.28205100000008,88.95333333333332,271502592,285213494.4,53.638290758832724,1.5,2.75,2.1605474751233578,0.9519275817266519,-0.3219043939189321,1.8148290405094367,2.1367334344283693,34.71427080921589,-2.387753080985914,1961714061.0,2009-05-15,2009,4,135,5,2.1,89.07,91.34,88.57021,2355
2009-05-18 13:30:00,89.55,91.34,88.57021,91.23,61.92858857142856,93.12697906976744,94.53537555000037,83.31135049999997,83.79301999999998,88.67205150000008,85.78096100411261,88.68852496074214,90.2316176923078,93.43862218012356,87.02461320449206,94.53537555000037,83.31135049999997,83.79301999999998,88.67205150000008,90.38006999999999,242217248,282639851.2,59.712955154386734,1.5,2.75,2.204064798328832,0.8569819399904921,-0.2505152402892046,1.823589384066864,2.0741046243560683,32.948140847578344,0.7287069969408281,2203931309.0,2009-05-18,2009,0,138,5,3.13,89.96,91.97,90.81,2356
2009-05-19 13:30:00,91.17999,91.97,90.81,91.12,61.82516014285714,93.11147558139535,94.36017555000036,83.3609505,84.25321999999998,88.97505150000009,85.9903350823827,88.92009401210005,90.51623307692316,93.30394263880942,87.72852351503694,94.36017555000036,83.3609505,84.25321999999998,88.97505150000009,91.3,206102192,277921037.6,59.34740820893056,1.5,2.75,2.129488741305344,0.7415854293716122,-0.2185666379475384,1.8008963269216451,2.0194629648691835,32.879347501214596,-1.1080950816579824,1997829117.0,2009-05-19,2009,1,139,5,1.28,91.39,92.8,90.41,2357
2009-05-20 13:30:00,91.95,92.8,90.41,90.50999,61.72173171428571,93.09597209302325,94.1877754500003,83.3994504,84.62001979999997,89.27355150000008,86.16757645170101,89.07151267761435,90.71777076923088,93.06013755505795,88.37540398340376,94.1877754500003,83.3994504,84.62001979999997,89.27355150000008,91.23999666666668,285898240,275196199.2,57.25420711954062,1.5,2.75,2.1480966883549617,1.0388887667457292,-0.2444247200962131,1.7139320647489171,1.9583567848451304,31.29331538632125,-0.385219018269863,1711930877.0,2009-05-20,2009,2,140,5,2.64,91.6,89.8,88.25999,2358
2009-05-21 13:30:00,89.46001,89.8,88.25999,89.21001,61.61830328571428,93.08046860465116,93.99202550000031,83.41995050000001,84.95141999999996,89.4655520000001,86.28688757124216,89.08470289879392,90.58931000000008,93.06156919924074,88.11705080075943,93.99202550000031,83.41995050000001,84.95141999999996,89.4655520000001,89.08999999999997,258988368,271900433.6,52.96677620637332,1.5,2.75,2.1553754963296075,0.9525117873883376,-0.34863456891227473,1.522563573704787,1.8711981426170612,31.36087679261519,-4.054624650462473,1452942509.0,2009-05-21,2009,3,141,5,1.74,89.03,90.0,88.67999,2359
2009-05-22 13:30:00,89.46001,90.0,88.67999,89.02,61.51487485714285,93.06496511627908,93.7924755500003,83.44105050000002,85.22181999999997,89.58355200000008,86.3940684508013,89.07854071795641,90.47007846153856,93.08022224425156,87.85993467882555,93.7924755500003,83.44105050000002,85.22181999999997,89.58355200000008,89.23333000000002,166811872,265855875.2,52.34971460889805,1.5,2.75,2.0957065323060635,0.6274522685440356,-0.4248606336641961,1.3401223505368165,1.7649829842010123,27.09448849512947,-2.433154051605213,1286130637.0,2009-05-22,2009,4,142,5,1.49,89.34,91.56,88.32001,2360
2009-05-26 13:30:00,88.36,91.56,88.32001,91.3,61.41144642857142,93.049461627907,93.6139256000003,83.46435050000002,85.52601999999997,89.8565520000001,86.58645792331887,89.29010826862722,90.40538538461549,92.88509469574863,87.92567607348231,93.6139256000003,83.46435050000002,85.52601999999997,89.8565520000001,90.39333666666666,236318432,263192718.4,58.58461792347782,1.5,2.75,2.1774410657127734,0.8978912237261956,-0.3209524972979469,1.3637923625785788,1.6847448598765258,30.106871073066436,0.3627569528415943,1522449069.0,2009-05-26,2009,1,146,5,3.67,89.94,91.75,89.53,2361
2009-05-27 13:30:00,91.44,91.75,89.53,89.67,61.30801799999999,93.03395813953487,93.4154256000003,83.45865040000002,85.80221999999998,90.06155150000009,86.70738114201225,89.32628843351986,90.31384692307701,92.80748811719204,87.82020572896201,93.4154256000003,83.45865040000002,85.80221999999998,90.06155150000009,90.31666666666666,246313504,263112000.0,53.22294228143645,1.5,2.75,2.1804809895904325,0.9361545805588496,-0.3583823195222933,1.236766960473659,1.5951492799959524,31.845289981102336,1.1163848800614409,1276135565.0,2009-05-27,2009,2,147,5,2.48,90.64,91.34,89.10001,2362
2009-05-28 13:30:00,90.46001,91.34,89.10001,90.92,61.20458957142856,93.01845465116277,93.21647555000031,83.43825030000002,86.05702019999998,90.2380515000001,86.8725818815412,89.47807048747035,90.15538538461549,92.1662726262265,88.14449814300447,93.21647555000031,83.43825030000002,86.05702019999998,90.2380515000001,90.45333666666666,289094912,261991462.4,56.51004296175521,1.5,2.75,2.1847316331911157,1.1034516520184132,-0.29782620529475823,1.222866523377505,1.5206927286722633,28.838601952407853,1.6547406082289848,1565230477.0,2009-05-28,2009,3,148,5,2.51,90.22,93.7,90.67999,2363
2009-05-29 13:30:00,91.42,93.7,90.67999,92.53,61.101161142857144,93.0029511627907,93.0323755000003,83.43505020000002,86.30902040000001,90.4935515000001,87.09444141559837,89.7687304410446,90.25461538461548,92.57352080794412,87.93570996128685,93.0323755000003,83.43505020000002,86.30902040000001,90.4935515000001,92.30333,258641376,259852542.4,60.37261073362283,1.5,2.75,2.2443943736774647,0.9953390242450058,-0.15537569083398095,1.3264731151297866,1.4818488059637676,29.969131823098124,4.306154401290232,1823871853.0,2009-05-29,2009,4,149,5,3.33,92.19,95.17,93.42999,2364
2009-06-01 13:30:00,93.67,95.17,93.42999,94.77,60.99773271428571,92.9874476744186,92.8633754500003,83.44805020000005,86.6256204,90.83755150000007,87.39544371302591,90.24504182761177,90.54692307692318,93.88631277352712,87.20753338031923,92.8633754500003,83.44805020000005,86.6256204,90.83755150000007,94.45666333333332,276246784,261859365.6,65.02666088214781,1.5,2.75,2.2726519184147893,1.0549433027420425,0.07149641661226025,1.5712193267290928,1.4997229101168326,31.067692456556223,3.8803025320618127,2100118637.0,2009-06-01,2009,0,152,6,1.86,94.3,95.37,87.53,2365
2009-06-02 13:30:00,94.39999,95.37,87.53,94.85001,87.53,92.97194418604653,92.68992555000031,83.48985030000003,86.98842040000002,91.03605200000008,87.68777964584841,90.68361022498208,91.02154000000007,94.8784089401532,87.164671059847,92.68992555000031,83.48985030000003,86.98842040000002,91.03605200000008,92.58333666666664,230874432,259047093.6,65.18394904587859,1.5,2.75,2.6703196385280186,0.8912450195503757,0.20138086179782502,1.751448987364114,1.5500681255662891,27.985474965458174,4.093514047410002,2330993069.0,2009-06-02,2009,1,153,6,8.96,91.45,94.13,92.75999,2366
2009-06-03 13:30:00,94.03999,94.13,92.75999,93.64999,87.87049983333334,92.95644069767442,92.5073255000003,83.51593010000005,87.21702020000002,91.19005100000008,87.92159181659945,90.9661225845076,91.34538538461544,95.32182632789828,87.36894444133264,92.5073255000003,83.51593010000005,87.21702020000002,91.19005100000008,93.51332666666669,235403936,258665477.6,60.769528474278204,1.5,2.75,2.6288696643474454,0.910070946398299,0.18151905006544267,1.7769669381480924,1.5954478880826497,29.491019813233446,3.4692303026439406,2095589133.0,2009-06-03,2009,2,154,6,1.48,93.44,94.67,93.3,2367
2009-06-04 13:30:00,94.0,94.67,93.3,94.53,88.21099966666668,92.9409372093023,92.3380255000003,83.57033010000005,87.49562,91.30950050000007,88.1807450786936,91.30553948122116,91.793076923077,95.79231819434295,87.79383565181101,92.3380255000003,83.57033010000005,87.49562,91.30950050000007,94.16666666666669,210102256,254573534.4,62.76117740184201,1.5,2.75,2.5389504026083425,0.8253106769137901,0.201169311193095,1.8469095270740183,1.6457402158809231,29.045256767171054,5.963445133567416,2305691389.0,2009-06-04,2009,3,155,6,1.47,93.98,95.67,93.8,2368
2009-06-05 13:30:00,95.49001,95.67,93.8,94.55,88.5514995,92.92543372093023,92.1758254500003,83.64633010000003,87.75761999999999,91.49400050000007,88.43051978148992,91.61453572110486,92.0484615384616,96.28805394381769,87.8088691331055,92.1758254500003,83.64633010000003,87.75761999999999,91.49400050000007,94.67333333333332,284257792,252896401.6,62.80739133915567,1.5,2.75,2.4911682309934613,1.1240088439439464,0.18921254034213209,1.8822558913085885,1.6930433509664564,26.69871333690195,6.212087171422153,2589949181.0,2009-06-05,2009,4,156,6,1.99,94.74,95.10001,93.03999,2369
2009-06-08 13:30:00,93.84,95.10001,93.03999,94.16,88.89199933333332,92.90993023255814,92.0087254500003,83.71683010000002,87.97861999999999,91.55300050000008,88.65520528025502,91.85696089052341,92.28230769230775,96.62535266347041,87.93926272114513,92.0087254500003,83.71683010000002,87.97861999999999,91.55300050000008,94.09999999999998,238565120,249870571.2,61.212122925671004,1.5,2.75,2.4603719287796424,0.9547547710572488,0.13147539204413095,1.85738759102162,1.7259121989774893,26.939640119093905,3.1325301204819267,2351384061.0,2009-06-08,2009,0,159,6,2.21,94.07,95.145,94.02,2370
2009-06-09 13:30:00,94.69,95.145,94.02,94.64,89.23249916666668,92.89442674418603,91.84292545000031,83.81953010000002,88.23922000000002,91.7230000000001,88.88990311240187,92.12201223428309,92.60000076923085,96.98203247928205,88.21796905917967,91.84292545000031,83.81953010000002,88.23922000000002,91.7230000000001,94.60166666666667,225125440,248730664.8,62.47540501192602,1.5,2.75,2.3649882195810963,0.90509724718108,0.10329237530367584,1.855027668107084,1.7517352928034082,23.866994933206982,5.542544886807182,2576509501.0,2009-06-09,2009,1,160,6,1.2,94.58,95.49001,93.19,2371
2009-06-10 13:30:00,95.48,95.49001,93.19,94.39999,89.572999,92.87892325581396,91.66667545000031,83.91953010000002,88.55142000000002,91.89449950000008,89.1059849511312,92.33896249768473,92.9992300000001,97.00242442802912,88.99603557197108,91.66667545000031,83.91953010000002,88.55142000000002,91.89449950000008,94.36,296100352,249414120.8,61.39860362979115,1.5,2.75,2.360346918182447,1.1871835926941632,0.04892593563000247,1.8128927123409115,1.7639667767109088,20.10486347732219,3.827529696436428,2280409149.0,2009-06-10,2009,2,161,6,2.47,94.34,96.11,94.56,2372
2009-06-11 13:30:00,94.58,96.11,94.56,94.82001,89.91349883333334,96.11,91.50567550000031,84.01713020000003,88.85742020000002,92.20150050000008,89.33006436481233,92.57525273600046,93.44538461538471,96.81841591482048,90.07235331594893,91.50567550000031,84.01713020000003,88.85742020000002,92.20150050000008,95.16333666666668,275414016,249703874.4,62.61303249612642,1.5,2.75,2.3138942811694148,1.102962525758871,0.023008272868531687,1.7927271177965736,1.769718844928042,19.32638746723462,2.474883821463304,2555823165.0,2009-06-11,2009,3,162,6,1.64,95.34,95.14,94.0,2373
2009-06-12 13:30:00,94.39999,95.14,94.0,95.08,90.25399866666667,96.23565217391304,91.3441255000003,84.16223010000002,89.13782020000002,92.48350050000008,89.5555520367805,92.81380009447659,93.73615384615393,96.9680401776035,90.50426751470437,91.3441255000003,84.16223010000002,89.13782020000002,92.48350050000008,94.74,184373008,245917593.6,63.38100703204781,1.5,2.75,2.230044689657314,0.7497349225850591,0.0060152177914072355,1.7772378671673008,1.7712226493758938,17.355091277186943,0.32710773451514435,2740196173.0,2009-06-12,2009,4,163,6,1.21,94.57,94.02,92.39999,2374
2009-06-15 13:30:00,93.96001,94.02,92.39999,92.89999,90.5944985,96.36130434782608,91.1654754500003,84.25073000000002,89.32722020000001,92.69299950000007,89.68670646671066,92.8220086569074,93.9846146153847,96.29243257714802,91.67679665362137,91.1654754500003,84.25073000000002,89.32722020000001,92.69299950000007,93.10666,224190432,243551985.6,53.464116885704215,1.5,2.75,2.2621850689675047,0.9205034048385932,-0.16022207167393998,1.5709450597834689,1.7311671314574089,17.35546443602905,-2.055898570806682,2516005741.0,2009-06-15,2009,0,166,6,1.75,93.21,93.28999,91.58,2375
2009-06-16 13:30:00,93.23,93.28999,91.58,91.64,90.93499833333334,96.48695652173912,90.97272545000031,84.33963000000001,89.47482040000004,92.71349950000008,89.76330621311415,92.7094364038686,94.0399992307693,96.0686444930717,92.01135396846688,90.97272545000031,84.33963000000001,89.47482040000004,92.71349950000008,92.16999666666668,227319008,242807073.6,48.719387149596564,1.5,2.75,2.2227425640412557,0.9362124613160364,-0.3522096169281874,1.2909051102971745,1.6431147272253617,18.445818888305574,-2.146278926457976,2288686733.0,2009-06-16,2009,1,167,6,1.87,92.43,92.33,90.83,2376
2009-06-17 13:30:00,91.60001,92.33,90.83,91.55,91.27549816666668,96.61260869565216,90.78652550000031,84.42403,89.63382020000005,92.73499950000007,89.8333726361293,92.59901388921443,93.96461461538469,96.26653199477808,91.6626972359913,90.78652550000031,84.42403,89.63382020000005,92.73499950000007,91.57,223445312,243674229.6,48.389050864691775,1.5,2.75,2.171118095181165,0.9169837629805724,-0.4748038338272598,1.0496099349412873,1.5244137687685468,17.490575971216654,-3.152438379350475,2065241421.0,2009-06-17,2009,2,168,6,1.65,91.58,92.67,91.25,2377
2009-06-18 13:30:00,91.69,92.67,91.25,92.21899,91.615998,96.73826086956522,90.6076704000003,84.50941999999998,89.84520020000004,92.82044950000008,89.92692625824188,92.5628211378607,93.76838307692316,96.19383452313178,91.34293163071452,90.6076704000003,84.50941999999998,89.84520020000004,92.82044950000008,92.04633,211725056,239965570.4,51.04612306345887,1.5,2.75,2.117466802668225,0.8823143072027969,-0.4979579228170965,0.9019663652471764,1.3999242880642728,17.022118373850574,-2.465372818614481,2276966477.0,2009-06-18,2009,3,169,6,1.56,91.96,92.7,91.52,2378
2009-06-19 13:30:00,92.58,92.7,91.52,92.03999,91.95649783333332,96.86391304347826,90.42847035000031,84.58451989999998,90.03540000000004,92.96194850000008,90.0097915030167,92.51302769615968,93.55222769230778,96.05325349459056,91.051201890025,90.42847035000031,84.58451989999998,90.03540000000004,92.96194850000008,92.08666333333332,215655568,237798930.4,50.29993716009981,1.5,2.75,2.050504888191924,0.906881993275778,-0.510552884411791,0.7617331825495341,1.2722860669613252,16.94260413180195,-2.2514974511469767,2061310909.0,2009-06-19,2009,4,170,6,1.29,92.11,91.19,89.25,2379
2009-06-22 13:30:00,91.14,91.19,89.25,89.28,92.29699766666668,96.9895652173913,90.25472035000031,84.60341989999998,90.10480000000004,92.97494850000008,89.9811722283886,92.20512029652542,93.2160746153847,96.59485724132955,89.8372919894398,90.25472035000031,84.60341989999998,90.10480000000004,92.97494850000008,89.90666666666668,251913568,242054015.2,40.4753547141687,1.5,2.75,2.103325253321072,1.0407328620095535,-0.6794184396594549,0.4230130173870066,1.1024314570464615,23.2851394121996,-5.663567202028741,1809397341.0,2009-06-22,2009,0,173,6,2.17,90.22,89.88,88.85001,2380
2009-06-23 13:30:00,89.47,89.88,88.85001,89.35001,92.6374975,97.11521739130434,90.0793704000003,84.65142,90.17520020000003,92.87744900000007,89.9564207684518,91.93320503018968,92.81761384615393,96.67102759752035,88.9642000947875,90.0793704000003,84.65142,90.17520020000003,92.87744900000007,89.36000666666666,188309680,239653577.6,40.79126928885253,1.5,2.75,2.026658449512424,0.7857578505016234,-0.7552266434409356,0.158398152745292,0.9136247961862276,22.706853792304287,-5.349555651435986,1997707021.0,2009-06-23,2009,1,174,6,1.16,89.37,91.08,89.60001,2381
2009-06-24 13:30:00,90.16,91.08,89.60001,90.118,92.97799733333332,97.2408695652174,89.8950103500003,84.7243,90.29056000000004,92.89984900000007,89.96275720890465,91.76032836064779,92.47669076923086,96.43937727278984,88.51400426567189,89.8950103500003,84.7243,90.29056000000004,92.89984900000007,90.26600333333332,211577632,237916784.0,44.28451347197387,1.5,2.75,2.0054678459758226,0.8892925855958107,-0.7224695435560541,0.010537866741159974,0.7330074102972141,24.126472497944736,-4.958879460147707,2209284653.0,2009-06-24,2009,2,175,6,1.65,90.34,92.17,89.57001,2382
2009-06-25 13:30:00,89.67,92.17,89.57001,92.08,93.31849716666667,97.36652173913043,89.73931035000031,84.8193,90.42716000000004,92.95784900000008,90.04578633796724,91.79077327868131,92.31669076923085,96.16078344632822,88.47259809213347,89.73931035000031,84.8193,90.42716000000004,92.95784900000008,91.27333666666664,279410944,237432585.6,52.065266525204706,1.5,2.75,2.0479337141204077,1.1768011677669237,-0.5455374128917998,0.051085644182464314,0.5966230570742641,28.13324419100153,-3.155237694572991,2488695597.0,2009-06-25,2009,3,176,6,2.9,90.87,92.24001,91.27,2383
2009-06-26 13:30:00,91.77,92.24001,91.27,91.84,93.658997,97.49217391304347,89.5799103500003,84.90029990000002,90.53396000000004,92.92334900000006,90.11614765804693,91.79546153785454,92.10130615384621,95.7069341922807,88.49567811541176,89.5799103500003,84.90029990000002,90.53396000000004,92.92334900000006,91.78333666666668,167579008,232879467.2,51.124734278156424,1.5,2.75,1.9709391631118067,0.7195954629013339,-0.42679734633707894,0.06312637415291532,0.4899237204899943,27.905863594194308,-1.1410011992466298,2321116589.0,2009-06-26,2009,4,177,6,1.06,91.76,92.82001,91.60001,2384
2009-06-29 13:30:00,92.11,92.82001,91.60001,92.7,93.99949683333334,97.61782608695653,89.4158604000003,84.99399990000002,90.64636000000004,92.81984900000006,90.21747520086865,91.88160805805886,91.97053769230776,95.34938505437263,88.59169033024288,89.4158604000003,84.99399990000002,90.64636000000004,92.81984900000006,92.37334,168481248,227491190.4,54.30981472851214,1.5,2.75,1.9173006514609632,0.7406055931386079,-0.2795833010120961,0.1404445942248742,0.4200278952369703,25.64715543580369,1.1567001309471872,2489597837.0,2009-06-29,2009,0,180,6,1.33,92.21,93.06,91.27,2385
2009-06-30 13:30:00,92.72,93.06,91.27,91.95,94.33999666666666,97.74347826086957,89.2451604000003,85.06779980000003,90.81676020000003,92.67484850000008,90.28541734985417,91.88812157633896,91.74976769230776,94.7033208650774,88.79621451953814,89.2451604000003,85.06779980000003,90.81676020000003,92.67484850000008,92.09333333333332,228888192,227391878.4,51.17755134829133,1.5,2.75,1.9082077477851804,1.0065803300035538,-0.2243487327916912,0.13959197924735633,0.3639407120390475,24.76999054487053,0.4369197160021908,2260709645.0,2009-06-30,2009,1,181,6,1.96,92.16,93.23,92.21001,2386
2009-07-01 13:30:00,92.34,93.23,92.21001,92.33,94.6804965,97.8691304347826,89.10636040000033,85.12130980000003,90.96216020000004,92.60884900000008,90.3655970616246,91.93020523573526,91.53822923076929,93.82637861116001,89.25007985037857,89.10636040000033,85.12130980000003,90.96216020000004,92.60884900000008,92.59000333333334,173041056,224273734.4,52.667084669153795,1.5,2.75,1.8633357658005247,0.7715618436681277,-0.15703530996168658,0.16764657458693932,0.3246818845486259,24.843457581210476,0.12037650813568135,2433750701.0,2009-07-01,2009,2,182,7,1.11,92.72,92.3624,89.75999,2387
2009-07-02 13:30:00,91.13,92.3624,89.75999,89.81,95.02099633333331,97.99478260869566,88.94491035000034,85.14840970000003,91.06756040000003,92.37284900000007,90.3438089415609,91.72828092757,91.30053769230776,93.61528699338311,88.98578839123242,88.94491035000034,85.14840970000003,91.06756040000003,92.37284900000007,90.64413,212309808,224384112.0,43.244622483708255,1.5,2.75,1.9161267825290584,0.9461891312518598,-0.2703930857584293,-0.013309472649410736,0.25708361310901856,29.230344554982626,-2.4228490246467875,2221440893.0,2009-07-02,2009,3,183,7,2.9,91.06,89.92999,88.66,2388
2009-07-06 13:30:00,88.94,89.92999,88.66,89.8,95.36149616666668,98.1204347826087,88.81086035000033,85.21530970000002,91.15616040000003,92.13534900000008,90.32248310071535,91.54463512494429,91.15899923076927,93.59524205059186,88.72275641094667,88.81086035000033,85.21530970000002,91.15616040000003,92.13534900000008,89.46333,174499568,218896200.8,43.211584809873116,1.5,2.75,1.8699741552055544,0.7971795187045566,-0.3302510500298703,-0.15573019942831934,0.17452085060155098,29.26527624482394,0.5824372759856586,2046941325.0,2009-07-06,2009,0,187,7,1.43,89.29,89.82001,88.0,2389
2009-07-07 13:30:00,89.71001,89.82001,88.0,88.06,95.701996,98.24608695652174,88.65081030000034,85.25990960000001,91.18416040000004,91.83034900000007,90.23375827323632,91.21276511304481,90.89053769230776,93.8154251122168,87.9656502723987,88.65081030000034,85.25990960000001,91.18416040000004,91.83034900000007,88.62666999999999,197088880,216822388.8,37.80023311081179,1.5,2.75,1.866405286976586,0.908987679228078,-0.4630903649617705,-0.4043421056006622,0.058748259361108335,25.94439434510993,-1.4437715228011674,1849852445.0,2009-07-07,2009,1,188,7,2.07,88.91,88.8,87.0,2390
2009-07-08 13:30:00,88.59,88.8,87.0,88.0,87.0,98.37173913043478,88.47021030000035,85.30330959999999,91.22736040000004,91.49834900000006,90.14615990958,90.90678748323104,90.56600000000005,93.75370919437107,87.378290805629,88.47021030000035,85.30330959999999,91.22736040000004,91.49834900000006,87.93333333333334,248050496,217968641.6,37.62525982021339,1.5,2.75,1.861662052192544,1.138010009968333,-0.5264401683796437,-0.5993019511134463,-0.07286178273380263,25.91344442290681,-2.350251891963864,1601801949.0,2009-07-08,2009,2,189,7,2.07,87.9,88.89999,87.91,2391
2009-07-09 13:30:00,88.61,88.89999,87.91,88.17,86.9788,98.49739130434784,88.30451030000033,85.3574097,91.27936020000004,91.18684950000005,90.06866344253766,90.64614105625664,90.26830846153852,93.57056635593388,86.96605056714311,88.30451030000033,85.3574097,91.27936020000004,91.18684950000005,88.32666333333331,163777568,211352502.4,38.49397477452558,1.5,2.75,1.79939976275022,0.7749024314367426,-0.5270364645306416,-0.7316573633971046,-0.20462089886646306,25.242017777283515,-4.246307558644654,1765579517.0,2009-07-09,2009,3,190,7,1.13,88.4,88.49001,87.35001,2392
2009-07-10 13:30:00,87.7,88.49001,87.35001,87.96001,86.9576,98.62304347826088,88.15156035000031,85.44480980000002,91.29076040000004,90.84384950000006,89.98597115067345,90.39031905089888,90.16677076923081,93.65999092074054,86.6735506177211,88.15156035000031,85.44480980000002,91.29076040000004,90.84384950000006,87.93334333333333,173520256,206257814.4,37.79377305258307,1.5,2.75,1.7522997796966329,0.8412784577630044,-0.5113176705975344,-0.8437679871133811,-0.3324503165158466,20.269881839853607,-4.224727787456453,1592059261.0,2009-07-10,2009,4,191,7,1.31,87.92,90.17,87.59,2393
2009-07-13 13:30:00,88.31,90.17,87.59,90.10200999999999,86.9364,98.74869565217392,88.00742045000031,85.55552990000002,91.34440060000004,90.59495000000008,89.99052169378429,90.36286104605136,90.224616923077,93.68658627515377,86.76264757100023,88.00742045000031,85.55552990000002,91.34440060000004,90.59495000000008,89.28733666666666,217413376,207909832.8,48.15364092873951,1.5,2.75,1.8114212240040164,1.045709926615842,-0.3349329959048642,-0.7511165613969268,-0.41618356549206265,26.131143623335976,-2.8025782092772342,1809472637.0,2009-07-13,2009,0,194,7,2.95,88.88,90.69,89.73,2394
2009-07-14 13:30:00,90.38,90.69,89.73,90.61,86.9152,98.87434782608696,87.8565205000003,85.67981990000003,91.39880060000002,90.48045050000007,90.0148149606947,90.38639808928455,90.26246307692314,93.72969588944908,86.7952302643972,87.8565205000003,85.67981990000003,91.39880060000002,90.48045050000007,90.34333333333336,181555376,205778080.0,50.26892445955435,1.5,2.75,1.7506054222894432,0.8822872484766113,-0.1706077566837504,-0.6294432613467507,-0.4588355046630002,25.632161851866986,-1.4573137574768933,1991028013.0,2009-07-14,2009,1,195,7,1.07,90.21,93.50999,90.6795,2395
2009-07-15 13:30:00,91.81,93.50999,90.6795,93.25999,86.89399999999999,99.0,87.7185704000003,85.83821980000002,91.4464004,90.56145000000005,90.14207672694198,90.6600735093527,90.35323153846159,94.05957359929548,86.64688947762775,87.7185704000003,85.83821980000002,91.4464004,90.56145000000005,92.48316,220877808,205456020.0,59.542081512636216,1.5,2.75,1.8327043206973403,1.0750612612859922,0.1146309469246492,-0.3155468210071888,-0.430177767931838,30.788022483202532,1.0072457489440092,2211905821.0,2009-07-15,2009,2,196,7,3.12,92.09,94.50999,92.82001,2396
2009-07-16 13:30:00,93.0,94.50999,92.82001,94.14999,86.8728,99.12565217391304,87.6324203500003,86.03321980000004,91.518,90.69144950000008,90.29924979647366,90.99244650846195,90.53092307692316,94.6981795425618,86.36366661128454,87.6324203500003,86.03321980000004,91.518,90.69144950000008,93.82666333333331,231174496,205842479.2,62.09825002424051,1.5,2.75,1.8225097263618164,1.1230650587694633,0.3481234660922157,0.004976564683431661,-0.3431469014087841,31.11298525019428,4.83241287161786,2443080317.0,2009-07-16,2009,3,197,7,1.82,93.66,94.32001,93.53999,2397
2009-07-17 13:30:00,94.06,94.32001,93.53999,94.13,86.8516,99.25130434782608,87.5231203000003,86.19971980000004,91.5577798,90.78700000000006,90.44947529465117,91.29126112670369,90.64092307692316,95.0968869617333,86.18495919211298,87.5231203000003,86.19971980000004,91.5577798,90.78700000000006,93.99666666666668,138561680,202184310.4,62.00349340102536,1.5,2.75,1.7480461744788292,0.6853236026369729,0.4780755359647949,0.2544475185472095,-0.22362801741758534,24.93731268006104,4.821826280623607,2304518637.0,2009-07-17,2009,4,198,7,0.83,93.93,95.28999,94.19,2398
2009-07-20 13:30:00,94.67999,95.28999,94.19,95.131,86.8304,99.37695652173912,87.41847530000031,86.38230990000002,91.6431998,90.94155050000008,90.63306449878249,91.6569505432081,90.88561538461546,95.91474554698586,85.85648522224507,87.41847530000031,86.38230990000002,91.6431998,90.94155050000008,94.87033,164179376,199610500.8,64.89242348715611,1.5,2.75,1.706042162016056,0.8224986929144561,0.6003857216227773,0.5268541346108861,-0.07353158701189105,24.937445042785143,8.029752441517145,2468698013.0,2009-07-20,2009,0,201,7,1.17,94.74,95.89999,94.42,2399
2009-07-21 13:30:00,95.87,95.89999,94.42,95.57001,86.8092,99.50260869565216,87.33707530000031,86.58181,91.69500000000002,91.25605100000007,90.82667020471258,92.02962287242636,91.13484692307699,96.71639017358619,85.55330367256785,87.33707530000031,86.58181,91.69500000000002,91.25605100000007,95.29666666666668,217718256,197900735.2,66.10944177294003,1.5,2.75,1.6898955790149093,1.100138692157825,0.6742611308687447,0.7692948265740398,0.09503369570529513,19.151821600283267,8.602284090909087,2686416269.0,2009-07-21,2009,1,202,7,1.57,95.16,96.13,94.89,2400
2009-07-22 13:30:00,94.96001,96.13,94.89,95.55,86.788,99.62826086956522,87.26312530000033,86.79801009999998,91.7811998,91.56605050000007,91.01189882413559,92.36489688457623,91.57638538461546,97.56234865752684,85.59042211170409,87.26312530000033,86.79801009999998,91.7811998,91.56605050000007,95.52333333333333,196067568,198288629.6,65.99714203553451,1.5,2.75,1.6577601805138438,0.9887988453776676,0.6830755280193684,0.9488781057295056,0.2658025777101373,19.07379206254809,8.370193943518197,2490348701.0,2009-07-22,2009,2,203,7,1.31,95.51,98.08,95.53,2401
2009-07-23 13:30:00,95.61,98.08,95.53,97.661,86.7668,99.75391304347826,87.2278303000003,87.06862,91.9150198,91.94320050000007,91.2726478898558,92.86928765747372,92.18107769230778,98.87359272473013,85.48856265988546,87.2278303000003,87.06862,91.9150198,91.94320050000007,97.09033333333332,258795504,200649523.2,71.49785118359497,1.5,2.75,1.7214915961914259,1.2897887813171742,0.7850880904379175,1.2471626907575342,0.4620746003196167,20.06369107401202,11.028864139510677,2749144205.0,2009-07-23,2009,3,204,7,2.67,96.8,98.14,96.69,2402
2009-07-24 13:30:00,97.2,98.14,96.69,98.06,86.7456,99.8795652173913,87.2179803000003,87.34851989999999,92.10262000000004,92.24220050000008,91.53881856084185,93.3636412139048,92.95030846153857,99.86635113177972,86.03426579129737,87.2179803000003,87.34851989999999,92.10262000000004,92.24220050000008,97.63,154003008,194379126.4,72.4064662384939,1.5,2.75,1.70209933932061,0.7922816140406319,0.8291225751871997,1.4984778193036163,0.6693552441164167,18.889016770590533,8.832200302745738,2903147213.0,2009-07-24,2009,4,205,7,1.5,97.42,98.39999,97.34,2403
2009-07-27 13:30:00,97.88,98.39999,97.34,98.35001,86.7244,100.00521739130434,87.22218040000033,87.61471999999998,92.28082020000004,92.56770100000007,91.80592410747549,93.83853347924723,93.74646307692316,100.58220319921092,86.91072295463543,87.22218040000033,87.61471999999998,92.28082020000004,92.56770100000007,98.03000000000002,159259376,193963144.8,73.07825131496162,1.5,2.75,1.6562343865119953,0.8210806035559802,0.8256639383787279,1.7014351670898265,0.8757712287110986,17.317726980337795,8.542114556892173,3062406589.0,2009-07-27,2009,0,208,7,1.09,97.87,98.37,97.06,2404
2009-07-28 13:30:00,97.66,98.37,97.06,97.89,86.7032,100.1308695652174,87.25813040000031,87.90562,92.46442000000003,92.82720100000007,92.04451531894705,94.22438743360462,94.49415538461548,100.83494527394606,88.15336549528489,87.25813040000031,87.90562,92.46442000000003,92.82720100000007,97.77333333333333,186685680,194873366.4,70.16045862394711,1.5,2.75,1.6315033589039956,0.9579845796721456,0.7428724611824149,1.8043618051891173,1.0614893440067024,18.93236592082033,4.964626309739041,2875720909.0,2009-07-28,2009,1,209,7,1.35,97.72,98.088,96.98,2405
2009-07-29 13:30:00,97.44,98.088,96.98,97.65199,86.682,100.25652173913043,87.3038903500003,88.19293990000001,92.59285980000006,93.11230050000007,92.26441628683145,94.55082577326132,95.23969230769241,100.52303006302971,89.9563545523551,87.3038903500003,88.19293990000001,92.59285980000006,93.11230050000007,97.57332999999998,194399312,193148922.4,68.63354203683039,1.5,2.75,1.5941102618394236,1.0064737073573236,0.6271711273654204,1.8454532532134775,1.2182821258480574,14.070510639012245,3.7195967838127175,2681321597.0,2009-07-29,2009,2,210,7,1.14,97.53,99.83,98.60001,2406
2009-07-30 13:30:00,98.83,99.83,98.60001,98.67,86.6608,100.38217391304347,87.2904903000003,88.49853990000001,92.74385980000008,93.4293005000001,92.5156156481322,94.94312808056976,95.89876846153857,100.55440727398563,91.24312964909149,87.2904903000003,88.49853990000001,92.74385980000008,93.4293005000001,99.03333666666668,225575376,195775638.4,71.49139800824078,1.5,2.75,1.6358173859937506,1.1522137169034,0.5756346003398378,1.9378253762728548,1.3621907759330172,14.189772244311511,4.823116965898234,2906896973.0,2009-07-30,2009,3,211,7,1.25,99.22,99.47,98.38,2407
2009-07-31 13:30:00,98.64999,99.47,98.38,98.81,86.6396,100.50782608695653,87.28529025000033,88.76493989999999,92.90986000000008,93.8793005000001,92.7624542501662,95.31140159670599,96.52953769230778,100.28250783842535,92.77656754619021,87.28529025000033,88.76493989999999,92.90986000000008,93.8793005000001,98.88666666666666,207357936,195528044.8,71.87096666355087,1.5,2.75,1.5968304298513405,1.0605022732779863,0.5096724263373733,1.9992813088547337,1.4896088825173603,14.013906743927972,3.867298777475273,3114254909.0,2009-07-31,2009,4,212,7,1.11,98.92,100.53,99.31,2408
2009-08-03 13:30:00,99.85001,100.53,99.31,100.44,86.6184,100.63347826086957,87.33739025000031,89.04293990000002,93.13445980000007,94.41130050000014,93.06353447564987,95.79983953987684,97.08184615384623,100.86080588262043,93.30288642507206,87.33739025000031,89.04293990000002,93.13445980000007,94.41130050000014,100.09333333333332,175776880,195591910.4,75.89503365423255,1.5,2.75,1.6056282562905302,0.8986919737146757,0.5320530549721174,2.1546752012325068,1.6226221462603898,15.216867132840164,5.095730344697047,3290031789.0,2009-08-03,2009,0,215,8,1.23,99.92,100.84,99.78,2409
2009-08-04 13:30:00,99.99001,100.84,99.78,100.7,86.5972,100.7591304347826,87.37204025000031,89.2949399,93.36805980000008,95.04330050000013,93.36300371189891,96.26652148846,97.58569307692316,101.41299573891014,93.7583904149362,87.37204025000031,89.2949399,93.36805980000008,95.04330050000013,100.43999999999998,176714496,194573191.2,76.47318814149776,1.5,2.75,1.5666548094126351,0.9082160543810828,0.519989155314335,2.2726085904033084,1.7526194350889734,15.300651877453403,5.38984824699111,3466746285.0,2009-08-04,2009,1,216,8,1.06,100.31,100.855,99.58,2410
2009-08-05 13:30:00,100.77,100.855,99.58,100.41,86.57600000000001,100.88478260869566,87.40804020000033,89.5381399,93.55025980000006,95.66380050000014,93.63935650751073,96.66113848955904,98.0687700000001,101.60356279309376,94.53397720690643,87.40804020000033,89.5381399,93.55025980000006,95.66380050000014,100.28166666666668,184726368,191406984.8,74.33167557474954,1.5,2.75,1.5458223230260189,0.9650973196877818,0.4506836266112717,2.3159739683530627,1.8652903417417916,15.718697905359125,2.8148390862268413,3282019917.0,2009-08-05,2009,2,217,8,1.28,100.22,101.02,99.42,2411
2009-08-06 13:30:00,100.87,101.02,99.42,99.89,86.5548,101.0104347826087,87.41344020000031,89.77843990000001,93.75465980000007,96.24980050000013,93.884479781726,96.96864910960105,98.43484692307705,101.64790663694679,95.22178720920724,87.41344020000031,89.77843990000001,93.75465980000007,96.24980050000013,100.11,193203744,192878293.6,70.51835236465129,1.5,2.75,1.5496921570955886,1.0016873355416291,0.33342800228678504,2.2820753446002726,1.948647342313488,12.404330555723284,1.8662043646746869,3088816173.0,2009-08-06,2009,3,218,8,1.61,100.22,102.03,100.39,2412
2009-08-07 13:30:00,100.94,102.03,100.39,101.20200000000001,86.53359999999998,101.13608695652174,87.4401502000003,90.00865999999998,93.96029980000007,96.91190000000013,94.17144135891321,97.37182538487714,98.86807692307706,101.93462571652964,95.80152812962444,87.4401502000003,90.00865999999998,93.96029980000007,96.91190000000013,101.20733333333334,220684368,195236499.2,74.1251568035197,1.5,2.75,1.5918570030173325,1.1303438081725243,0.3084189308085268,2.334171005824146,2.0257520750156197,13.864775074937205,2.8998370208604967,3309500541.0,2009-08-07,2009,4,219,8,1.63,101.21,101.22,100.27,2413
2009-08-10 13:30:00,100.74001,101.22,100.27,100.99001,86.5124,101.2617391304348,87.49190025000033,90.21926019999997,94.12950000000008,97.45630000000013,94.43883620758328,97.71641439584124,99.28653923076936,101.87519027600749,96.6978881855312,87.49190025000033,90.21926019999997,94.12950000000008,97.45630000000013,100.82667,130898624,190910761.6,72.58006454152263,1.5,2.75,1.5460100742303804,0.6856534587309508,0.24457879778247935,2.3314755722437184,2.086896774461239,14.189780258491073,3.1668301154356904,3178601917.0,2009-08-10,2009,0,222,8,0.95,100.74,100.61,99.46001,2414
2009-08-11 13:30:00,100.53999,100.61,99.46001,99.73,86.49119999999998,101.38739130434784,87.53210025000033,90.42716019999996,94.22870000000006,97.9123000000001,94.64633282689371,97.90818445338016,99.44569307692319,101.86380496692995,97.02758118691642,87.53210025000033,90.42716019999996,94.22870000000006,97.9123000000001,99.93333666666666,157301008,189698043.2,64.03614287773743,1.5,2.75,1.5448664974996391,0.8292178735557986,0.0923070803374446,2.202280624883045,2.1099735445456003,16.242391328422507,2.1279750673795856,3021300909.0,2009-08-11,2009,1,223,8,1.16,100.04,101.56,99.50999,2415
2009-08-12 13:30:00,99.56,101.56,99.50999,100.8,86.47,101.51304347826088,87.6009003000003,90.66806009999996,94.34769980000006,98.28930050000014,94.88765310819201,98.18359545782015,99.65646230769241,102.03198530190404,97.2809393134808,87.6009003000003,90.66806009999996,94.34769980000006,98.28930050000014,100.62333,219052368,189606771.2,67.53153667804169,1.5,2.75,1.5809481762496649,1.1552982344124216,0.04107590239254622,2.161318422536283,2.1202425201437367,16.7073289402987,2.158710854363024,3240353277.0,2009-08-12,2009,2,224,8,2.06,100.53,101.61,100.25999,2416
2009-08-13 13:30:00,101.25999,101.61,100.25999,101.57001,86.4488,101.63869565217392,87.6890003500003,90.86156019999994,94.50610020000008,98.6603015000001,95.14970631963544,98.50611112850395,99.90415461538471,102.35348003396307,97.45482919680641,87.6890003500003,90.86156019999994,94.50610020000008,98.6603015000001,101.14666666666666,176449504,186870521.6,69.80584820753934,1.5,2.75,1.5644525922318313,0.9442340209104442,0.036622318870147115,2.1660204187314207,2.1293980998612736,16.344150194641134,2.7932496710859165,3416802781.0,2009-08-13,2009,3,225,8,1.35,100.93,101.60001,99.7,2417
2009-08-14 13:30:00,101.52,101.60001,99.7,100.78999,86.4276,101.76434782608696,87.72415035000033,91.06345999999995,94.63130000000008,98.99330100000013,95.37089391494386,98.72362340197976,100.12723076923088,102.31660023718305,97.9378613012787,87.72415035000033,91.06345999999995,94.63130000000008,98.99330100000013,100.69666666666667,199691248,189927000.0,64.85027287479735,1.5,2.75,1.5884209785009857,1.0514105314147015,-0.03728127361331168,2.082796507844634,2.1200777814579457,17.44563662889142,0.3484567901234621,3217111533.0,2009-08-14,2009,4,226,8,1.91,100.65,98.95,98.11501,2418
2009-08-17 13:30:00,98.85001,98.95,98.11501,98.31,86.4064,101.89,87.75030035000033,91.23205999999992,94.70650000000008,99.15225100000009,95.48615297710293,98.6842306970293,100.177846923077,102.1562344200043,98.19945942614972,87.75030035000033,91.23205999999992,94.70650000000008,99.15225100000009,98.45833666666664,237892624,193612662.4,52.16945069447586,1.5,2.75,1.6660323371794874,1.2287038515513953,-0.25924378020174155,1.7960230562057689,2.0552668364075104,20.755256971656927,-2.373386295928501,2979218909.0,2009-08-17,2009,0,229,8,0.85,98.53,99.44,98.35001,2419
2009-08-18 13:30:00,98.53,99.44,98.35001,99.09,86.3852,102.01565217391304,87.76425035000031,91.39185999999992,94.8051000000001,99.32825050000014,95.62748031133421,98.72287539255032,100.21015461538471,102.10076256724993,98.31954666351947,87.76425035000031,91.39185999999992,94.8051000000001,99.32825050000014,98.96000333333332,173461440,191399821.6,55.14056115124467,1.5,2.75,1.6277443130952378,0.9062779607104922,-0.3537352895186916,1.6130977245091458,1.9668330140278372,21.410868540900143,-1.3146100985957507,3152680349.0,2009-08-18,2009,1,230,8,1.11,98.9,100.3,98.21001,2420
2009-08-19 13:30:00,98.31,100.3,98.21001,99.96001,86.36399999999999,102.1413043478261,87.7799004000003,91.57536009999993,94.91150020000008,99.5487510000001,95.79738343637993,98.84069773611697,100.29861692307699,102.0188317337255,98.57840211242849,87.7799004000003,91.57536009999993,94.91150020000008,99.5487510000001,99.49000666666666,192812752,191237080.8,58.25534978256794,1.5,2.75,1.660761862159864,1.0082393602402238,-0.356826584012921,1.5207997840116863,1.877626368024607,22.181675260988026,0.07008709580538228,3345493101.0,2009-08-19,2009,2,231,8,2.13,99.26,101.22,99.87,2421
2009-08-20 13:30:00,100.09,101.22,99.87,100.99001,86.3428,102.26695652173912,87.7993004500003,91.79736029999992,95.0433006000001,99.71520150000009,96.00101585063952,99.04539414220105,100.34092538461547,102.09959331308012,98.58225745615084,87.7993004500003,91.79736029999992,95.0433006000001,99.71520150000009,100.69333666666668,174131248,187003868.0,61.65030695500002,1.5,2.75,1.638564586291302,0.9311638837331428,-0.2914444758094188,1.5133207732628335,1.8047652490722523,22.735504792089053,-0.20947214481927248,3519624349.0,2009-08-20,2009,3,232,8,1.35,100.54,103.13,101.62,2422
2009-08-21 13:30:00,101.82001,103.13,101.62,102.97,86.3216,102.39260869565216,87.81210045000033,92.03186029999992,95.20630040000007,99.9607015000001,96.27430934669287,99.41916612865809,100.51554076923084,102.76455345512105,98.26652808334066,87.81210045000033,92.03186029999992,95.20630040000007,99.9607015000001,102.57333333333335,224604944,190533964.8,67.17653011978906,1.5,2.75,1.6743806872704945,1.1788184024604942,-0.1252816001324093,1.6481632489067408,1.77344484903915,24.20293133577596,1.9605800613347804,3744229293.0,2009-08-21,2009,4,233,8,1.49,102.38,103.95,102.59,2423
2009-08-24 13:30:00,103.39,103.95,102.59,102.96001,86.3004,102.51826086956522,87.84595050000033,92.25086039999992,95.3639006000001,100.19120150000008,96.53649368603828,99.75638935450016,100.71169538461548,103.30771502627917,98.11567574295178,87.84595050000033,92.25086039999992,95.3639006000001,100.19120150000008,103.16667000000002,191278880,192134940.0,67.123973024376,1.5,2.75,1.6519249238940303,0.9955444855579104,-0.031372156900339565,1.7342296529137258,1.7656018098140651,24.11443429935092,3.2387546375213003,3552950413.0,2009-08-24,2009,0,236,8,1.33,103.27,104.25999,102.94,2424
2009-08-25 13:30:00,103.37,104.25999,102.94,103.16,86.2792,102.64391304347826,87.90745050000031,92.44816049999993,95.56910080000007,100.45470150000007,96.79623903168384,100.08054274930969,100.96323384615393,103.81329537585798,98.11317231644988,87.90745050000031,92.44816049999993,95.56910080000007,100.45470150000007,103.45333,215310560,193566184.0,67.66929924704013,1.5,2.75,1.6282152864730286,1.1123356133321305,0.02579928300454481,1.7978509135697465,1.7720516305652017,22.298724114906975,2.341269841269841,3768260973.0,2009-08-25,2009,1,237,8,1.28,103.6,103.64,102.49001,2425
2009-08-26 13:30:00,102.84,103.64,102.49001,103.17,86.258,102.7695652173913,87.9540005000003,92.63726059999992,95.79970080000008,100.73060200000006,97.04619044220604,100.37477677318495,101.11461846153854,104.19877886385824,98.03045805921884,87.9540005000003,92.63726059999992,95.79970080000008,100.73060200000006,103.10000333333332,194620624,193577249.6,67.69815157310164,1.5,2.75,1.5940563374392411,1.005389963966096,0.04476351307288229,1.8280060219063048,1.7832425088334225,21.85611006388165,1.5752582873625838,3962881597.0,2009-08-26,2009,2,238,8,1.12,103.07,103.72,101.94,2426
2009-08-27 13:30:00,103.11,103.72,101.94,103.39999,86.2368,102.89521739130434,88.0078504500003,92.83526039999992,96.03670060000007,100.96710150000006,97.2953590523156,100.66289231859592,101.30000153846159,104.61313502161856,97.98686805530468,88.0078504500003,92.83526039999992,96.03670060000007,100.96710150000006,103.01999666666666,196230000,192109980.8,68.39669254881372,1.5,2.75,1.6073380276221525,1.0214461486219668,0.05272329069745374,1.8491466222052395,1.7964233315077858,21.597142795491447,2.589542870279081,4159111597.0,2009-08-27,2009,3,239,8,1.75,102.83,104.35001,102.67,2427
2009-08-28 13:30:00,104.23,104.35001,102.67,103.38,86.2156,103.0208695652174,88.0759004500003,93.05256049999993,96.25992080000007,101.19560150000008,97.53397242281301,100.92166447872962,101.58077076923084,104.93253057693951,98.22901096152219,88.0759004500003,93.05256049999993,96.25992080000007,101.19560150000008,103.46667,147024368,189093302.4,68.2585237673993,1.5,2.75,1.6125288827919986,0.7775228743374043,0.03729511938049357,1.843042230733403,1.805747111352909,20.806205003704907,5.157155935306676,4012087229.0,2009-08-28,2009,4,240,8,1.64,103.51,102.58,101.78999,2428
2009-08-31 13:30:00,102.37,102.58,101.78999,102.46001,86.1944,103.14652173913043,88.15910045000031,93.25186059999993,96.46832120000006,101.29660200000004,97.72715036701643,101.06817357599348,101.70846384615393,105.05799615444953,98.35893153785835,88.15910045000031,93.25186059999993,96.46832120000006,101.29660200000004,102.27666666666669,176051568,189107036.8,62.04631794656656,1.5,2.75,1.610920391163998,0.930962543642374,-0.049504295555864435,1.7438667419080789,1.793371037463943,14.021997894314401,3.4009587243919603,3836035661.0,2009-08-31,2009,0,243,8,0.78,102.18,103.24001,99.99001,2429
2009-09-01 13:30:00,101.95,103.24001,99.99001,100.2,86.1732,103.27217391304347,88.20425045000033,93.39576059999992,96.68672120000005,101.27160200000004,97.82412486242755,100.9854903782798,101.60307846153856,105.04824704738184,98.15790987569528,88.20425045000033,93.39576059999992,96.68672120000005,101.27160200000004,101.14334,321276672,196335145.6,50.00633418899432,1.5,2.75,1.7279975060808552,1.6363686237539328,-0.2618917701075827,1.4660063248294648,1.7278980949370475,20.32910762817432,0.24008601039556315,3514758989.0,2009-09-01,2009,1,244,9,3.25,101.62,100.44,99.57001,2430
2009-09-02 13:30:00,99.78,100.44,99.57001,99.82001,86.152,103.39782608695651,88.27025050000033,93.53566069999992,96.89612120000008,101.24210250000004,97.90239486782257,100.87449224701506,101.5284646153847,105.08117550901798,97.97575372175145,88.27025050000033,93.53566069999992,96.89612120000008,101.24210250000004,99.94334,171805008,195689077.6,48.3089355654046,1.5,2.75,1.6667112556465085,0.8779488876286675,-0.4212863163617167,1.2012901994849017,1.6225765158466183,19.877308141085557,-1.1585304328616284,3342953981.0,2009-09-02,2009,2,245,9,0.87,100.01,100.77,99.59,2431
2009-09-03 13:30:00,100.39999,100.77,99.59,100.64999,86.1308,103.52347826086957,88.34615045000034,93.69866049999992,97.10676100000006,101.28010200000004,98.01014369653542,100.85311108063269,101.70846384615393,104.79753687236315,98.61939081994473,88.34615045000034,93.69866049999992,97.10676100000006,101.28010200000004,100.33666333333332,143572256,193207503.2,52.13096186211829,1.5,2.75,1.6319461659574714,0.7430987597380225,-0.4609325408789922,1.0464108397478782,1.5073433806268703,19.53027995890873,-2.2530931339224978,3486526237.0,2009-09-03,2009,3,246,9,1.18,100.18,102.09,100.55,2432
2009-09-04 13:30:00,100.85001,102.09,100.55,102.06,86.1096,103.6491304347826,88.42105045000034,93.86676049999993,97.30636100000008,101.32300200000006,98.16896159078891,100.96805288247718,101.93692538461548,104.63172970225392,99.24212106697705,88.42105045000034,93.86676049999993,97.30636100000008,101.32300200000006,101.56666666666666,142687808,189307675.2,57.83485108926185,1.5,2.75,1.6253785826747953,0.7537349336166801,-0.3853777985987388,1.025621132378447,1.4109989309771858,17.66389776224947,-0.8741355017350859,3629214045.0,2009-09-04,2009,4,247,9,1.53,101.32,103.05,102.39,2433
2009-09-08 13:30:00,103.0,103.05,102.39,102.94,86.0884,103.77478260869566,88.52825045000033,94.03116049999993,97.52836100000006,101.42050150000004,98.35606113624814,101.1558573698603,102.16615538461548,104.64785856200184,99.68445220722911,88.52825045000033,94.03116049999993,97.52836100000006,101.42050150000004,102.79333333333334,132909008,189408194.4,60.961337026706374,1.5,2.75,1.5799943981980238,0.7017067472768221,-0.2745236726251048,1.0678443401958049,1.3423680128209097,18.487523404590767,-0.21326095385808344,3762123053.0,2009-09-08,2009,1,251,9,0.64,102.72,104.08,102.8,2434
2009-09-09 13:30:00,103.12,104.08,102.8,103.73,86.0672,103.9004347826087,88.6696504500003,94.19766049999993,97.74896100000004,101.62050150000003,98.56680383678746,101.401013810826,102.37692384615394,104.88850031617308,99.86534737613482,88.6696504500003,94.19766049999993,97.74896100000004,101.62050150000003,103.53666666666668,154612496,189273768.8,63.57265334317474,1.5,2.75,1.558566226898165,0.8168722849460162,-0.15247362803970388,1.1517759777712795,1.3042496058109836,18.990535764881674,0.5427934477076691,3916735549.0,2009-09-09,2009,2,252,9,1.25,103.44,104.86,103.22,2435
2009-09-10 13:30:00,103.8,104.86,103.22,104.78999,86.04599999999998,104.02608695652174,88.79600040000031,94.4112604999999,98.00576080000006,101.82000100000006,98.81085035299186,101.72377344789018,102.51692307692316,105.32993705999037,99.70390909385596,88.79600040000031,94.4112604999999,98.00576080000006,101.82000100000006,104.28999666666664,162902368,186466268.8,66.78321829090766,1.5,2.75,1.5643829249768677,0.8736291504536181,-0.012226614290059556,1.288966337948409,1.3011929522384686,19.763947233184886,1.3442941338775762,4079637917.0,2009-09-10,2009,3,253,9,1.59,104.04,105.3,104.28,2436
2009-09-11 13:30:00,104.99001000000001,105.3,104.28,104.77,86.0248,104.15173913043478,88.89470040000032,94.6083604999999,98.25456080000008,101.98000050000007,99.04454249601179,102.01389026237685,102.65615307692316,105.71181262381675,99.60049353002957,88.89470040000032,94.6083604999999,98.25456080000008,101.98000050000007,104.78333333333332,152383632,185262975.2,66.66389086058334,1.5,2.75,1.5254984303356625,0.8225260974865312,0.06317999334723745,1.3801679439225154,1.3169879505752782,19.782652207159753,1.3445540723544211,3927254285.0,2009-09-11,2009,4,254,9,0.98,104.79,105.46001000000001,103.14999,2437
2009-09-14 13:30:00,103.88,105.46001000000001,103.14999,105.28,86.00359999999998,104.27739130434784,88.9928004000003,94.81576059999992,98.56396080000006,102.20450100000008,99.28907024126623,102.32494833262665,102.81923000000008,106.17644576461805,99.4620142353821,88.9928004000003,94.81576059999992,98.56396080000006,102.20450100000008,104.63,149593744,182758100.0,68.22386049009516,1.5,2.75,1.5815356853116862,0.8185341388425466,0.12767167528677725,1.4765775446837497,1.3489058693969722,19.85357091445117,2.752283549455055,4076848029.0,2009-09-14,2009,0,257,9,2.24,104.3,106.11,104.75999,2438
2009-09-15 13:30:00,105.45,106.11,104.75999,105.72,85.9824,104.40304347826088,89.07655040000033,95.01926059999992,98.88236080000006,102.57500100000007,99.54126356513815,102.64828658666221,103.01538384615392,106.71243681743505,99.3183308748728,89.07655040000033,95.01926059999992,98.88236080000006,102.57500100000007,105.52999666666666,196795872,180703262.4,69.54785535811236,1.5,2.75,1.564998136360851,1.0890554458523156,0.17718310668094572,1.5703847527481545,1.3932016460672083,18.645272344384395,5.508982035928138,4273643901.0,2009-09-15,2009,1,258,9,1.29,105.43,107.34,105.72881000000001,2439
2009-09-16 13:30:00,106.10001000000001,107.34,105.72881000000001,107.32001000000001,85.96119999999998,104.52869565217392,89.1627004500003,95.2258606999999,99.26756100000006,102.98650150000007,99.84631244493666,103.09321262602772,103.31692384615393,107.67128483558756,98.96256285672028,89.1627004500003,95.2258606999999,99.26756100000006,102.98650150000007,106.79627333333332,206406256,182350503.2,73.819691889884,1.5,2.75,1.5689268409065047,1.1319204081033762,0.28833502826604684,1.7536204313997672,1.4652854031337204,10.59360895966254,7.513523591111642,4480050157.0,2009-09-16,2009,2,259,9,1.52,106.53,108.06,106.57001000000001,2440
2009-09-17 13:30:00,107.17,108.06,106.57001000000001,107.16,85.94,108.06,89.28795045000031,95.4390606999999,99.65076100000006,103.34650100000007,100.1331237216058,103.48052570926319,103.60769307692316,108.42074078613602,98.7946453677103,89.28795045000031,95.4390606999999,99.65076100000006,103.34650100000007,107.26333666666666,229170880,184168409.6,72.72102547813259,1.5,2.75,1.5632884951274693,1.2443549927902509,0.3193177090028025,1.864432539387224,1.5451148303844207,9.798488198813793,6.467968849276581,4250879277.0,2009-09-17,2009,3,260,9,1.4,107.32,107.16,106.36,2441
2009-09-18 13:30:00,107.14998999999999,107.16,106.36,106.72,85.9188,108.23573529411765,89.3952004500003,95.65056059999986,100.02176100000004,103.63300050000008,100.39143259526831,103.78904707028572,103.9353846153847,108.96639482370442,98.90437440706499,89.3952004500003,95.65056059999986,100.02176100000004,103.63300050000008,106.74666666666668,153799056,183151800.0,69.65120832097189,1.5,2.75,1.5087678883326496,0.8397354325756012,0.2798316020489662,1.8949043329456288,1.6150727308966626,11.651475198828678,4.565941602978636,4097080221.0,2009-09-18,2009,4,261,9,0.75,106.76,107.0,105.66,2442
2009-09-21 13:30:00,105.89,107.0,105.66,106.45,85.8976,108.41147058823529,89.49085040000033,95.84116059999992,100.39156080000005,103.80700050000007,100.62902347388523,104.04247115882995,104.41615384615395,109.11071179841248,99.72159589389544,89.49085040000033,95.84116059999992,100.39156080000005,103.80700050000007,106.37,151892000,179516152.8,67.76092199713791,1.5,2.75,1.4967130391660322,0.846118845746565,0.20845816117598104,1.8756454323666392,1.6671872711906581,11.308683505835653,3.4097532543229114,3945188221.0,2009-09-21,2009,0,264,9,1.27,106.33,107.37,106.60001000000001,2443
2009-09-22 13:30:00,107.08,107.37,106.60001000000001,107.07001000000001,85.8764,108.58720588235296,89.59970045000033,96.0376606999999,100.73092080000008,104.01250050000007,100.88161118079172,104.3308081913223,104.97384615384622,109.031184678738,100.91650762895449,89.59970045000033,96.0376606999999,100.73092080000008,104.01250050000007,107.01334,143126624,177108540.0,69.78855804975899,1.5,2.75,1.4555192506541723,0.8081294329454695,0.1771631115306702,1.888641160603996,1.7114780490733257,11.02503776533806,3.21990745203894,4088314845.0,2009-09-22,2009,1,265,9,0.72,106.99,108.03,105.99001000000001,2444
2009-09-23 13:30:00,107.32001000000001,108.03,105.99001000000001,106.17998999999999,85.8552,108.76294117647059,89.69095045000033,96.22056059999993,101.04232060000008,104.16350000000007,101.08939074232927,104.50692074452974,105.39923076923088,108.62928962597016,102.16917191249162,89.69095045000033,96.22056059999993,101.04232060000008,104.16350000000007,106.73333333333336,225947312,177640377.6,63.604403549560736,1.5,2.75,1.497267161321732,1.2719366793329765,0.0758585818122548,1.8063012763386441,1.7304426945263893,12.737278616864419,1.326462575289873,3862367533.0,2009-09-23,2009,2,266,9,1.92,107.01,106.64,104.55,2445
2009-09-24 13:30:00,106.41,106.64,104.55,105.00998999999999,85.834,108.93867647058822,89.76100040000033,96.36186049999992,101.27732060000008,104.25549950000007,101.2431397328262,104.55483210219357,105.6261530769232,108.24206817883258,103.01023797501377,89.76100040000033,96.36186049999992,101.27732060000008,104.25549950000007,105.39999666666668,228636688,179341180.8,56.5146965796478,1.5,2.75,1.5396052212273226,1.2748699823437315,-0.08205654942958107,1.6278720077394129,1.7099285571689935,13.749598445550564,0.22906366326238994,3633730845.0,2009-09-24,2009,3,267,9,2.0,105.6,105.36,104.09,2446
2009-09-25 13:30:00,104.78,105.36,104.09,104.45,85.8128,109.11441176470586,89.83575040000031,96.50066039999994,101.48332080000007,104.30800000000008,101.36889895898987,104.54484809246084,105.74230692307705,107.97715772286699,103.50745612328708,89.83575040000031,96.50066039999994,101.48332080000007,104.30800000000008,104.63333333333333,204058944,179732628.0,53.44411871824523,1.5,2.75,1.520347705425371,1.1353472447974222,-0.2280595002746968,1.4248541818256228,1.6529136821003196,14.11710561251518,-0.7883738601823692,3429671901.0,2009-09-25,2009,4,268,9,1.22,104.72,106.55,104.83,2447
2009-09-28 13:30:00,104.85001,106.55,104.83,106.32001000000001,85.7916,109.29014705882355,89.91680045000031,96.64245039999994,101.72712100000008,104.45500050000008,101.56306017628437,104.71391113127409,105.94153846153856,107.86312945554714,104.01994746753,89.91680045000031,96.64245039999994,101.72712100000008,104.45500050000008,105.90000333333334,118285744,178295696.8,61.053883213716134,1.5,2.75,1.5617514407521296,0.6634245588814457,-0.20334569447297807,1.398731564009097,1.602077258482075,17.3906174402195,0.567546348846006,3547957645.0,2009-09-28,2009,0,271,9,1.64,105.69,107.02,105.78,2448
2009-09-29 13:30:00,106.50998999999999,107.02,105.78,106.0,85.7704,109.4658823529412,90.00710045000031,96.79385039999994,101.94450100000007,104.63200000000008,101.7370578164301,104.83639578543848,106.03461615384626,107.83763864063141,104.2315936670611,90.00710045000031,96.79385039999994,101.94450100000007,104.63200000000008,106.26666666666668,133733808,176179808.8,59.26852610927636,1.5,2.75,1.5387691949841202,0.7590756790513671,-0.21222396561959636,1.3367973014575796,1.549021267077176,17.39749993784715,-1.2299756587797526,3414223837.0,2009-09-29,2009,1,272,9,1.17,106.4,106.46001000000001,104.62,2449
2009-09-30 13:30:00,106.36,106.46001000000001,104.62,105.59,85.7492,109.64161764705881,90.09010040000031,96.91995039999996,102.14490080000007,104.9015000000001,101.88815358833479,104.9081676153967,106.09769307692318,107.77212517043829,104.42326098340807,90.09010040000031,96.91995039999996,102.14490080000007,104.9015000000001,105.55667,254382944,172835122.4,56.96993094981253,1.5,2.75,1.5602863953423969,1.471824363402655,-0.2469509363874036,1.2403325965929213,1.487283532980325,14.711044632646436,-1.465098917506526,3159840893.0,2009-09-30,2009,2,273,9,1.76,105.54,105.73308999999999,102.95,2450
2009-10-01 13:30:00,105.34,105.73308999999999,102.95,103.0,85.728,109.8173529411765,90.16635040000031,97.03755029999996,102.29390080000006,105.06049950000009,101.93175540840012,104.7264373663113,105.92230846153856,108.25200324009433,103.59261368298279,90.16635040000031,97.03755029999996,102.29390080000006,105.06049950000009,103.89436333333332,281840640,178336904.0,45.07689039009059,1.5,2.75,1.647629509960797,1.5803831606272587,-0.4346185820994353,0.9440103053560308,1.3786288874554657,19.827745588150467,-3.4857571214392795,2878000253.0,2009-10-01,2009,3,274,10,2.7,104.34,103.10001,101.99001,2451
2009-10-02 13:30:00,102.02,103.10001,101.99001,102.49001,101.99001,109.99308823529414,90.21940045000031,97.15275039999996,102.39048100000008,105.15250050000013,101.95364774532558,104.51344428380548,105.6738476923078,108.63910917718515,102.7085862074304,90.21940045000031,97.15275039999996,102.39048100000008,105.15250050000013,102.52667666666666,224748752,182395728.8,43.1660007723896,1.5,2.75,1.609227402106454,1.2322040295496215,-0.5745766692386862,0.6604080509071082,1.2349847201457944,19.836141481901176,-3.720046970408647,2653251501.0,2009-10-02,2009,4,275,10,1.09,102.55,104.32001,102.60001,2452
2009-10-05 13:30:00,102.89999,104.32001,102.60001,104.02,102.23574786885244,110.16882352941177,90.2845504000003,97.30615049999994,102.50968100000007,105.25050050000013,102.03468116707754,104.4664495901097,105.42000076923088,108.34281213454656,102.4971894039152,90.2845504000003,97.30615049999994,102.50968100000007,105.25050050000013,103.64667333333334,149874944,182755085.6,50.012307560619824,1.5,2.75,1.6249968733845643,0.8200863111849841,-0.5457981608657789,0.5527370190635708,1.0985351799293497,22.61660417135998,-2.8486127908272363,2803126445.0,2009-10-05,2009,0,278,10,1.68,103.46,106.11,104.71001,2453
2009-10-06 13:30:00,104.77,106.11,104.71001,105.50998999999999,102.48148573770493,110.34455882352941,90.3656504000003,97.46685039999994,102.65288060000006,105.37900000000009,102.17096778797644,104.56583439105164,105.29307692307701,108.04067786399072,102.54547598216331,90.3656504000003,97.46685039999994,102.65288060000006,105.37900000000009,105.44333333333331,202491008,186234185.6,55.619205566961185,1.5,2.75,1.6582113824285245,1.087292364436876,-0.4140761625005609,0.5809399768036485,0.9950161393042094,24.179175084769287,-0.6310040149749512,3005617453.0,2009-10-06,2009,1,279,10,1.34,105.41,105.91,105.07001000000001,2454
2009-10-07 13:30:00,105.27,105.91,105.07001000000001,105.8,102.72722360655735,110.52029411764707,90.4537004000003,97.63775029999994,102.81108060000004,105.48250000000013,102.31328277668324,104.68337397285623,105.2223076923078,107.86462685839813,102.57998852621745,90.4537004000003,97.63775029999994,102.81108060000004,105.48250000000013,105.59333666666667,159200256,186463573.6,56.63868005889858,1.5,2.75,1.599766997969344,0.8537874337939858,-0.30037242066412995,0.6195506134740469,0.9199230341381768,23.860938653379513,0.7523188984209933,3164817709.0,2009-10-07,2009,2,280,10,0.8,105.49,107.17,105.84488999999999,2455
2009-10-08 13:30:00,106.55,107.17,105.84488999999999,106.61,102.97296147540985,110.69602941176471,90.5514504000003,97.79155029999994,102.99024080000004,105.57350050000014,102.48178149132313,104.86686216591757,105.23461538461548,107.9010740951132,102.56815667411772,90.5514504000003,97.79155029999994,102.99024080000004,105.57350050000014,106.54163,183305744,187483742.4,59.4410455224747,1.5,2.75,1.5833550695429626,0.9777154096322328,-0.17005355446757264,0.7073560910537111,0.8774096455212838,23.19239526379043,2.0679751077070336,3348123453.0,2009-10-08,2009,3,281,10,1.25,106.51,107.25998999999999,106.36,2456
2009-10-09 13:30:00,106.64,107.25998999999999,106.36,107.25998999999999,103.21869934426228,110.87176470588236,90.6569503500003,97.95295019999996,103.16204060000004,105.69800000000014,102.66916221715358,105.09477910249686,105.24922923076932,107.95751845961588,102.54094000192276,90.6569503500003,97.95295019999996,103.16204060000004,105.69800000000014,106.95999333333332,135008256,186614973.6,61.58646815163407,1.5,2.75,1.5345432788613225,0.7234588596807003,-0.045976058456802416,0.8199395724502807,0.8659156309070831,22.881437175364546,0.8841045067621849,3483131709.0,2009-10-09,2009,4,282,10,0.85,106.81,108.09,107.28,2457
2009-10-12 13:30:00,107.75998999999999,108.09,107.28,107.67998999999999,103.46443721311476,111.0475,90.76205030000031,98.12465019999996,103.33944040000002,105.81799950000013,102.86566526746128,105.3409896641638,105.36461384615394,108.33665819112952,102.39256950117836,90.76205030000031,98.12465019999996,103.33944040000002,105.81799950000013,107.68333,118031008,185036836.8,62.950231162870494,1.5,2.75,1.4842194732283711,0.6378784356737339,0.05311248450351447,0.9323062365364764,0.8791937520329618,20.83334966631507,1.584896226415098,3601162717.0,2009-10-12,2009,0,285,10,0.76,107.68,107.7132,106.75998999999999,2458
2009-10-13 13:30:00,107.39,107.7132,106.75998999999999,107.46001000000001,103.71017508196721,111.22323529411764,90.86355035000031,98.30715019999994,103.47984060000003,105.90500000000013,103.04583564912949,105.54280112471965,105.55307692307699,108.71586991098695,102.39028393516706,90.86355035000031,98.30715019999994,103.47984060000003,105.90500000000013,107.31106666666666,157692688,183081677.6,61.71439824994262,1.5,2.75,1.4462902251406302,0.8613242464629897,0.09038096806448216,0.9921699621135645,0.9017889940490824,20.767871077065397,1.7710105123591189,3443470029.0,2009-10-13,2009,1,286,10,0.89,107.24,109.42,107.4174,2459
2009-10-14 13:30:00,108.72,109.42,107.4174,109.31,103.95591295081968,111.3989705882353,90.9755503500003,98.51005019999994,103.65204060000003,106.00449950000014,103.2914891530852,105.90158196998443,105.92692307692316,109.58926336797369,102.26458278587265,90.9755503500003,98.51005019999994,103.65204060000003,106.00449950000014,108.71580000000002,191421504,182332440.0,67.49398770256167,1.5,2.75,1.4860266376305853,1.049848858491665,0.2188428136202352,1.1753425110743765,0.9564996974541412,22.25398287122571,6.126213592233013,3634891533.0,2009-10-14,2009,2,287,10,1.86,108.42,109.71001000000001,108.73,2460
2009-10-15 13:30:00,108.78,109.71001000000001,108.73,109.71001000000001,104.20165081967212,111.57470588235294,91.07925040000029,98.69415029999996,103.83804080000004,106.13200000000009,103.54319585296422,106.26428940141449,106.18769230769242,110.37061050032587,102.00477411505894,91.07925040000029,98.69415029999996,103.83804080000004,106.13200000000009,109.38334,173873568,179567574.4,68.59783071775638,1.5,2.75,1.4498825920855432,0.9682904532233856,0.3046955863262215,1.3373691803619179,1.0326735940356966,13.166891525618125,7.044589028725822,3808765101.0,2009-10-15,2009,3,288,10,0.9,109.22,109.27,108.23,2461
2009-10-16 13:30:00,108.8,109.27,108.23,108.89,104.44738868852457,111.75044117647059,91.17250035000029,98.88635029999996,104.01804080000004,106.24050000000014,103.7528744469656,106.51435707747022,106.4100000000001,110.82986370138443,101.99013629861577,91.17250035000029,98.88635029999996,104.01804080000004,106.24050000000014,108.79666666666664,192069376,181481090.4,63.81382818705023,1.5,2.75,1.4520345497937182,1.0583437402578004,0.2807879843490153,1.3836585744719656,1.1028705901229503,14.013559090121772,4.681791963084027,3616695725.0,2009-10-16,2009,4,289,10,0.96,108.75,110.13,108.73,2462
2009-10-19 13:30:00,109.07001000000001,110.13,108.73,109.78998999999999,104.69312655737706,111.92617647058823,91.25665025000029,99.07505019999994,104.18980060000004,106.40749950000013,103.98962407649636,106.8263221177112,106.73307615384627,111.46868268589785,101.99746962179468,91.25665025000029,99.07505019999994,104.18980060000004,106.40749950000013,109.54999666666669,159530368,181863008.8,66.56949774546672,1.5,2.75,1.4483177962370235,0.8772007515582244,0.2984643910857561,1.475951078980145,1.1774866878943893,12.981075287283813,4.05648792119116,3776226093.0,2009-10-19,2009,0,292,10,1.29,109.43,109.985,108.67998999999999,2463
2009-10-20 13:30:00,109.95,109.985,108.67998999999999,109.211,104.9388644262295,112.10191176470586,91.33845520000031,99.24186019999992,104.35422040000003,106.51454900000013,104.19438391663375,107.05343429697679,107.2108453846155,111.58282695648327,102.83886381274773,91.33845520000031,99.24186019999992,104.35422040000003,106.51454900000013,109.29199666666666,180921008,183752728.0,63.23332464306658,1.5,2.75,1.438081525077236,0.984589507699717,0.2462129132647968,1.4852528294753853,1.2390399162105885,12.956736231445833,3.2240075614366743,3595305085.0,2009-10-20,2009,1,293,10,1.2,109.33,110.31,108.14998999999999,2464
2009-10-21 13:30:00,109.03998999999999,110.31,108.14998999999999,108.23,105.18460229508196,110.31,91.41225520000029,99.37646019999993,104.52422040000003,106.61704950000014,104.35264337088341,107.1654881734552,107.6523830769232,111.08701178929009,104.2177543645563,91.41225520000029,99.37646019999993,104.52422040000003,106.61704950000014,108.89666333333334,225787440,183744734.4,57.9354653030021,1.5,2.75,1.489647844714576,1.2288103968654462,0.12665459287575076,1.397358157305277,1.270703564429526,14.812400161388284,1.5195572647969275,3369517645.0,2009-10-21,2009,2,294,10,2.0,109.23,109.67998999999999,107.5,2465
2009-10-22 13:30:00,108.19,109.67998999999999,107.5,109.33,105.43034016393442,110.40375,91.5055552000003,99.5212600999999,104.69482040000004,106.83305000000013,104.5478338269272,107.37163215693563,108.06084461538471,110.87785081276512,105.2438384180043,91.5055552000003,99.5212600999999,104.69482040000004,106.83305000000013,108.83666333333332,238443936,184235096.8,61.80023370739791,1.5,2.75,1.5389579986635349,1.2942373095113764,0.10369297919860276,1.4003197884277796,1.2966268092291768,15.203757609262686,1.929899490014866,3607961581.0,2009-10-22,2009,3,295,10,2.03,108.59,109.75998999999999,107.63,2466
2009-10-23 13:30:00,109.69,109.75998999999999,107.63,108.08,105.67607803278689,110.4975,91.5907451500003,99.6655601999999,104.8250202,107.01455000000013,104.68635014743988,107.43909576103701,108.25853769230778,110.66211753544506,105.85495784917049,91.5907451500003,99.6655601999999,104.8250202,107.01455000000013,108.48999666666668,240033184,186033808.8,55.55391595175373,1.5,2.75,1.5811745701875688,1.290266460426305,-0.0077278516155352426,1.2869669947097575,1.294694846325293,16.94056084020407,0.3714803465342025,3367928397.0,2009-10-23,2009,4,296,10,1.98,108.69,109.31,106.61,2467
2009-10-26 13:30:00,108.2,109.31,106.61,106.91,105.92181590163936,110.59125,91.6798451500003,99.7893601999999,104.9474204,107.04404950000013,104.77355210244222,107.3887056885573,108.34392230769241,110.4528962910138,106.23494832437099,91.6798451500003,99.7893601999999,104.9474204,107.04404950000013,107.61,242028192,192220931.2,50.41733245822797,1.5,2.75,1.6610906723170284,1.259114657748573,-0.16362931548340542,1.0901582019710359,1.2537875174544415,18.024604681596454,-0.5118276091729382,3125900205.0,2009-10-26,2009,0,299,10,2.53,107.96,107.39,106.16,2468
2009-10-27 13:30:00,107.03,107.39,106.16,106.42,106.16755377049179,110.685,91.77719515000031,99.90806019999992,105.10962040000001,107.06504950000013,104.8381186866602,107.2964480039328,108.32930692307706,110.48818627313351,106.17042757302058,91.77719515000031,99.90806019999992,105.10962040000001,107.06504950000013,106.65666666666668,253266320,198197556.8,48.399007762199886,1.5,2.75,1.6302984814372412,1.2778478407560268,-0.29546881036059197,0.8844515045037014,1.1799203148642934,18.151865843477136,-2.643856920684293,2872633885.0,2009-10-27,2009,1,300,10,1.16,106.78,106.4783,104.35001,2469
2009-10-28 13:30:00,106.14998999999999,106.4783,104.35001,104.41,106.41329163934427,110.77875,91.86369515000031,100.01056019999993,105.2160204,107.00604950000009,104.82132971855584,107.02154819403444,108.11007692307705,111.08381815251772,105.13633569363638,91.86369515000031,100.01056019999993,105.2160204,107.00604950000009,105.07943666666664,248821376,197919478.4,41.12602488385895,1.5,2.75,1.6658693041917243,1.2571848815058315,-0.5016449008731594,0.552864188772844,1.0545090896460034,16.808814429432513,-4.830926548999495,2623812509.0,2009-10-28,2009,2,301,10,2.04,105.41,106.86,104.94,2470
2009-10-29 13:30:00,105.19,106.86,104.94,106.64998999999999,106.65902950819671,110.8725,91.9750951000003,100.13066009999993,105.34982,107.18854900000014,104.89304188645563,106.98616169936449,108.03084615384628,111.09957008273555,104.96212222495701,91.9750951000003,100.13066009999993,105.34982,107.18854900000014,106.14999666666668,198110560,193732974.4,50.12150158597189,1.5,2.75,1.7218786396066017,1.022595975793783,-0.4712378547864542,0.4654617711629356,0.9366996259493898,22.12900409160627,-2.0571310496831647,2821923069.0,2009-10-29,2009,3,302,10,1.83,105.9,106.62,103.44,2471
2009-10-30 13:30:00,106.3,106.62,103.44,103.56,106.90476737704918,110.96625,92.07089515000031,100.22226019999992,105.4012198,107.2420485000001,104.8407657340456,106.6598605851393,107.73084538461549,111.61763055846838,103.84406021076263,92.07089515000031,100.22226019999992,105.4012198,107.2420485000001,104.54,325607936,198775933.6,40.84933036872066,1.5,2.75,1.8281723082061299,1.638065182756108,-0.6332118950596415,0.14518475712483792,0.7783966521844794,26.868935272311603,-5.674460850210479,2496315133.0,2009-10-30,2009,4,303,10,3.07,105.03,105.41,103.08,2472
2009-11-02 14:30:00,104.13,105.41,103.08,104.32001,103.08,111.06,92.16719520000031,100.31726019999992,105.42822,107.2570490000001,104.82034394055358,106.43701767226891,107.34700000000014,111.50994111271628,103.18405888728395,92.16719520000031,100.31726019999992,105.42822,107.2570490000001,104.27000333333336,254489744,204006673.6,43.612376139607754,1.5,2.75,1.864017143334264,1.2474579361015572,-0.6601345026892629,-0.0467714761770992,0.6133630265121637,26.7081837778614,-4.478477442748443,2750804877.0,2009-11-02,2009,0,306,11,2.26,104.24,104.8,103.53999,2473
2009-11-03 14:30:00,103.74001,104.8,103.53999,104.64999,103.13190428571428,111.15375,92.2875951000003,100.4129600999999,105.4620196,107.21404900000007,104.81366339386524,106.26682456062424,106.95776769230784,111.11036759039801,102.80516779421764,92.2875951000003,100.4129600999999,105.4620196,107.21404900000007,104.32999333333332,228362496,205300248.0,44.81763876218678,1.5,2.75,1.8208737759532443,1.1123342432591703,-0.6269370910478778,-0.17030833729768347,0.4566287537501942,27.123202499816237,-3.3077797283562798,2979167373.0,2009-11-03,2009,1,307,11,1.22,104.17,106.33,104.64999,2474
2009-11-04 14:30:00,105.50998999999999,106.33,104.64999,104.92,103.18380857142857,111.2475,92.3919451000003,100.53316019999993,105.4972196,107.17004900000008,104.81783345685093,106.13855555485053,106.6523830769232,110.77548414186418,102.52928201198222,92.3919451000003,100.53316019999993,105.4972196,107.17004900000008,105.29999666666669,247996688,209740069.6,45.837805272798796,1.5,2.75,1.8108120776708692,1.182400141627492,-0.5601961080724203,-0.24361638134033115,0.3165797267320891,27.19535783856793,-4.033659562791545,3227164061.0,2009-11-04,2009,2,308,11,1.61,105.49,106.88,105.44,2475
2009-11-05 14:30:00,105.66,106.88,105.44,106.8501,103.23571285714287,111.34125,92.5124456000003,100.68526119999993,105.5708216,107.18205400000008,104.89753018403324,106.20632169248378,106.42623769230782,110.13815405394142,102.71432133067421,92.5124456000003,100.68526119999993,105.5708216,107.18205400000008,106.39003333333332,180015184,209575541.6,52.585652022342614,1.5,2.75,1.8214683578372357,0.8589513004507965,-0.3687094712701669,-0.14430711235561944,0.2244023589145474,28.974946826987697,-1.1379533678756484,3407179245.0,2009-11-05,2009,3,309,11,1.37,106.16,107.39998999999999,106.05,2476
2009-11-06 14:30:00,106.25998999999999,107.39998999999999,106.05,107.13,103.28761714285713,111.435,92.6325456000003,100.84106119999993,105.6454218,107.17555450000008,104.9850780199535,106.29429105510437,106.2661607692309,109.6487774256875,102.88354411277427,92.6325456000003,100.84106119999993,105.6454218,107.17555450000008,106.85999666666667,170954064,211372832.0,53.49058743116661,1.5,2.75,1.787791332277433,0.8087797394889424,-0.21354426665666465,-0.04252797440628342,0.17101629225038126,28.46315340742513,0.20578056309044884,3578133309.0,2009-11-06,2009,4,310,11,1.27,106.72,109.63,107.87,2477
2009-11-09 14:30:00,107.95,109.63,107.87,109.57001000000001,103.33952142857143,111.52875,92.7619957000003,101.01457139999992,105.769222,107.27005550000008,105.16487927407296,106.6062642879516,106.36923846153856,110.05319286999577,102.68528405308138,92.7619957000003,101.01457139999992,105.769222,107.27005550000008,109.0233366666667,159495632,213446063.2,60.557719503371786,1.5,2.75,1.8386633799719019,0.7472409170205769,0.04906123586827449,0.23234283708572434,0.18328160121744985,30.54226234605337,2.9599793271941315,3737628941.0,2009-11-09,2009,0,313,11,1.63,108.75,109.92998999999999,108.97,2478
2009-11-10 14:30:00,109.31,109.92998999999999,108.97,109.59,103.39142571428572,111.6225,92.88729570000031,101.19007149999992,105.9118218,107.3765550000001,105.33841342018776,106.89042959386094,106.38923846153858,110.13949737656642,102.63897954651071,92.88729570000031,101.19007149999992,105.9118218,107.3765550000001,109.49666333333332,171899744,214156416.0,60.6105261275199,1.5,2.75,1.775900995688195,0.8026831379172875,0.2106901780096182,0.4466443237294726,0.2359541457198544,30.261157153251823,4.961210612010349,3909528685.0,2009-11-10,2009,1,314,11,0.88,109.45,110.82001000000001,109.62,2479
2009-11-11 14:30:00,110.31,110.82001000000001,109.62,110.14998999999999,103.44333,111.71625,93.00109565000031,101.39877139999993,106.11082160000002,107.4185545000001,105.52710269782746,107.20086391825515,106.54846846153858,110.72401667310032,102.37292024997684,93.00109565000031,101.39877139999993,106.11082160000002,107.4185545000001,110.19666666666667,169466192,213058650.4,62.13971939280602,1.5,2.75,1.7369087817104665,0.7953969091695702,0.3345374450450017,0.6541259520261065,0.3195885069811048,26.82192416028386,3.2817630831470312,4078994877.0,2009-11-11,2009,2,315,11,1.09,110.22,110.57001000000001,108.75,2480
2009-11-12 14:30:00,110.0,110.57001000000001,108.75,109.03,103.49523428571429,111.81,93.12349565000031,101.59557129999992,106.2950214,107.38455400000014,105.66447121948127,107.3750673546118,106.71154538461548,111.09142876782578,102.3316620014052,93.12349565000031,101.59557129999992,106.2950214,107.38455400000014,109.45000333333331,157144496,212222196.8,57.34466260079407,1.5,2.75,1.7428445830168615,0.7404715358219305,0.3202367343231009,0.719884424884981,0.39964769056188,26.073690451301676,5.281962147547314,3921850381.0,2009-11-12,2009,3,316,11,1.67,109.66,110.09,108.75,2481
2009-11-13 14:30:00,109.31,110.09,108.75,109.62,103.54713857142859,111.90375,93.2574456500003,101.79059129999992,106.4744216,107.42105400000014,105.81958999518791,107.58887046369641,106.95769923076931,111.59641248719952,102.31898597433913,93.2574456500003,101.79059129999992,106.4744216,107.42105400000014,109.48666666666668,150962944,210166875.2,59.13367204577125,1.5,2.75,1.7140699699442288,0.7183003689631867,0.3284948970576788,0.8102663118839786,0.4817714148262998,16.573712629187664,5.080511399490863,4072813325.0,2009-11-13,2009,4,317,11,1.23,109.42,111.69,110.32001000000001,2482
2009-11-16 14:30:00,110.38,111.69,110.32001000000001,111.21001000000001,103.59904285714286,111.9975,93.40059570000028,101.98189139999994,106.6574218,107.4920550000001,106.03097901498444,107.93374089572531,107.48077692307699,112.37871492451309,102.58283892164091,93.40059570000028,101.98189139999994,106.6574218,107.4920550000001,111.07333999999996,210922128,212736463.2,63.56824561943937,1.5,2.75,1.7394935435196406,0.9914714423060881,0.4135292137764949,0.9986829320469184,0.5851537182704235,17.309065551154855,6.268533804924392,4283735453.0,2009-11-16,2009,0,320,11,1.24,111.01,111.39,110.5,2483
2009-11-17 14:30:00,110.92,111.39,110.5,111.339,103.65094714285713,112.09125,93.53859065000029,102.17688139999993,106.8254018,107.5984550000001,106.23913670067135,108.2580512866086,107.84147000000007,113.11757649333731,102.56536350666286,93.53859065000029,102.17688139999993,106.8254018,107.5984550000001,111.07633333333332,147134064,211047116.0,63.910389919286594,1.5,2.75,1.6788154332682377,0.697162163542666,0.4480462970989685,1.1452115896441342,0.6971652925451657,17.482583970622784,6.117994662600073,4430869517.0,2009-11-17,2009,1,321,11,0.81,110.94,111.42998999999999,110.57001000000001,2484
2009-11-18 14:30:00,111.25998999999999,111.42998999999999,110.57001000000001,111.27,103.70285142857142,112.185,93.67829065000029,102.36258139999993,106.9762018,107.7504550000001,106.43642545750777,108.54490354502684,108.43454692307701,113.37488118901531,103.4942126571387,93.67829065000029,102.36258139999993,106.9762018,107.7504550000001,111.08999999999996,156486752,207582081.6,63.56648754860857,1.5,2.75,1.6203271880347927,0.7538548163397933,0.43543426726471296,1.2414581266260571,0.8060238593613439,17.81693226783757,4.136542689244089,4274382765.0,2009-11-18,2009,2,322,11,0.78,111.0,111.30588999999999,109.13,2485
2009-11-19 14:30:00,110.50998999999999,111.30588999999999,109.13,109.82001000000001,103.75475571428572,112.27875,93.80454065000029,102.54128149999993,107.07680220000002,107.77495550000009,106.5691150474094,108.66634225502428,108.85762384615394,113.22483046653858,104.49041722576929,93.80454065000029,102.54128149999993,107.07680220000002,107.77495550000009,110.0853,208734496,206096609.6,56.665899676713714,1.5,2.75,1.6600102460323083,1.0127992712015967,0.3048197674608237,1.1870485686873735,0.8822288012265498,18.909116971391388,2.5109773172780745,4065648269.0,2009-11-19,2009,3,323,11,1.99,110.22,109.75998999999999,109.00998999999999,2486
2009-11-20 14:30:00,109.25,109.75998999999999,109.00998999999999,109.42998999999999,103.80666,112.3725,93.91679560000028,102.71228139999992,107.170002,107.84245500000013,106.6813062220208,108.73907061168863,109.22531615384626,112.85644039643341,105.59419191125912,93.91679560000028,102.71228139999992,107.170002,107.84245500000013,109.39998999999999,134196000,200804750.4,54.93831337224266,1.5,2.75,1.5992966570300002,0.6682909629014434,0.17404069668573052,1.0997796720837127,0.9257389753979824,19.252053381400604,-0.12779044192840058,3931452269.0,2009-11-20,2009,4,324,11,0.69,109.38,111.74001000000001,110.60001000000001,2487
2009-11-23 14:30:00,110.72,111.74001000000001,110.60001000000001,110.82001000000001,103.85856428571428,112.46625,94.03539560000029,102.92238149999993,107.2808022,108.03795550000014,106.84360833096115,108.93725531533735,109.67916307692316,112.40685894906336,106.951467204783,94.03539560000029,102.92238149999993,107.2808022,108.03795550000014,111.05334333333332,148010128,196103847.2,59.65878890283857,1.5,2.75,1.6500626100992857,0.7547538210662906,0.16321545135578594,1.129758289592715,0.966542838236929,15.982709038020248,1.1223743042248315,4079462397.0,2009-11-23,2009,0,327,11,1.03,111.17,111.20218999999999,110.00998999999999,2488
2009-11-24 14:30:00,111.0,111.20218999999999,110.00998999999999,110.99001000000001,103.91046857142857,112.56,94.17479565000029,103.13428159999992,107.38620240000002,108.26645600000009,107.00621231798229,109.13275576149569,109.99761769230778,112.25609940294613,107.73913598166945,94.17479565000029,103.13428159999992,107.38620240000002,108.26645600000009,110.73406333333332,138420064,190361534.4,60.20780959056498,1.5,2.75,1.6173581379493365,0.7271430356783255,0.1499115899315855,1.153932325651411,1.0040207357198254,15.97208885067317,0.7626146856663315,4217882461.0,2009-11-24,2009,1,328,11,1.08,110.61,111.5,110.82001000000001,2489
2009-11-25 14:30:00,111.17,111.5,110.82001000000001,111.38,103.96237285714285,112.65375,94.3136956000003,103.36748159999992,107.4674022,108.61495600000013,107.17773340355164,109.34677902230564,110.32454076923084,111.97711269106124,108.67196884740044,94.3136956000003,103.36748159999992,107.4674022,108.61495600000013,111.23333666666667,109564752,183398703.2,61.50219895023493,1.5,2.75,1.5504032709529556,0.5974129047167658,0.14944915938352346,1.1908321849492296,1.0413830255657062,15.858652523964405,2.155370081628904,4327447213.0,2009-11-25,2009,2,329,11,0.61,111.16,110.32001000000001,108.28998999999999,2490
2009-11-27 14:30:00,108.39998999999999,110.32001000000001,108.28998999999999,109.57001000000001,104.01427714285713,112.7475,94.44324565000029,103.58318169999993,107.51560240000002,108.76095700000013,107.2715481720398,109.36803911541936,110.32454076923084,111.97711269106344,108.67196884739826,94.44324565000029,103.58318169999993,107.51560240000002,108.76095700000013,109.39333666666668,126001808,179793265.6,52.90135152796402,1.5,2.75,1.6603751801706008,0.7008149475427293,0.01632152139195675,1.0617849273056519,1.0454634059136954,17.747218809666165,-0.045602992154723763,4201445405.0,2009-11-27,2009,4,331,11,1.87,109.3,110.2,108.12,2491
2009-11-30 14:30:00,109.48,110.2,108.12,109.94,104.06618142857144,112.84125,94.57914570000031,103.80088169999992,107.5800024,109.07995700000014,107.37619334176372,109.42251158061754,110.35146384615395,111.96626354740818,108.7366641448997,94.57914570000031,103.80088169999992,107.5800024,109.07995700000014,109.42,160874816,171556609.6,54.30801157296475,1.5,2.75,1.6903483815869864,0.9377360416196988,-0.05389529698604889,0.9780942846811342,1.0319895816671831,17.580154041599187,-1.1419925238744242,4362320221.0,2009-11-30,2009,0,334,11,1.92,109.16,111.66,110.73,2492
2009-12-01 14:30:00,110.92,111.66,110.73,111.3,104.11808571428571,112.935,94.73954570000029,104.0342815999999,107.67700240000002,109.42895650000014,107.53006811267497,109.60132000151111,110.43992615384626,112.12534099255976,108.75451131513277,94.73954570000029,104.0342815999999,107.67700240000002,109.42895650000014,111.23,159613632,166812804.0,59.13887372950785,1.5,2.75,1.692466354330773,0.9568428092606128,-0.017696987128368757,1.009868347756722,1.0275653348850908,16.994918684164222,-0.03502815724948264,4521933853.0,2009-12-01,2009,1,335,12,0.84,111.2,112.00998999999999,110.92,2493
2009-12-02 14:30:00,111.28,112.00998999999999,110.92,111.25,104.16999,113.02875,94.90064570000031,104.2457614999999,107.7606022,109.75895700000015,107.67594779453086,109.75833714422434,110.61069538461548,112.13195453059164,109.08943623863934,94.90064570000031,104.2457614999999,107.7606022,109.75895700000015,111.39333,132315056,162010432.0,58.89234970497116,1.5,2.75,1.649432329021432,0.8167070130397529,-0.006639882683300513,1.0192654815309652,1.0259053642142657,16.982668333251162,-0.01797429675563586,4389618797.0,2009-12-02,2009,2,336,12,0.98,111.46,112.17998999999999,110.28998999999999,2494
2009-12-03 14:30:00,111.55,112.17998999999999,110.28998999999999,110.38,104.22189428571428,113.1225,95.06164070000031,104.44346149999987,107.84460240000004,110.03195700000015,107.78198905749042,109.81754313048869,110.66915692307705,112.08864304472166,109.2496708014324,95.06164070000031,104.44346149999987,107.84460240000004,110.03195700000015,110.94999333333335,167324816,157976838.4,54.625425173364036,1.5,2.75,1.6666157340913297,1.0591730895153804,-0.06423578110551342,0.945610637832374,1.0098464189378873,17.562398756838107,0.5099161801205437,4222293981.0,2009-12-03,2009,3,337,12,1.71,111.23,112.38,110.03998999999999,2495
2009-12-04 14:30:00,111.84,112.38,110.03998999999999,111.00998999999999,104.27379857142857,112.38,95.2295906500003,104.62096149999986,107.96460240000002,110.23995150000015,107.90857732974571,109.93110949901356,110.65377076923087,112.05367465142749,109.25386688703428,95.2295906500003,104.62096149999986,107.96460240000002,110.23995150000015,111.14332666666668,274907904,162721474.4,57.052023388770216,1.5,2.75,1.7147153245133768,1.6894383793759429,-0.06597051563868828,0.927383274389527,0.9933537900282152,15.98671401965357,1.4438455125509908,4497201885.0,2009-12-04,2009,4,338,12,2.13,111.21,111.53,110.49001000000001,2496
2009-12-07 14:30:00,110.91,111.53,110.49001000000001,110.84,104.32570285714287,112.44677419354838,95.41054070000031,104.78786159999987,108.09240240000004,110.42545150000015,108.02353508152036,110.01767049910751,110.61538615384626,111.9644728720104,109.26629943568213,95.41054070000031,104.78786159999987,108.09240240000004,110.42545150000015,110.95333666666666,127973808,160572461.6,56.178984496330706,1.5,2.75,1.6665206584767074,0.7969847801100161,-0.08350411175732053,0.8889736503315646,0.9724777620888851,15.81357120227387,0.018038258614132104,4369228077.0,2009-12-07,2009,0,341,12,0.94,111.01,110.77251000000001,109.27,2497
2009-12-08 14:30:00,110.03998999999999,110.77251000000001,109.27,109.61,104.37760714285713,112.51354838709679,95.5711907000003,104.94266159999991,108.15820220000002,110.42745100000015,108.08574939204901,109.97884473728777,110.48769384615395,111.87836899625871,109.09701869604916,95.5711907000003,104.94266159999991,108.15820220000002,110.42745100000015,109.88417,169863632,161090861.6,50.1937816022336,1.5,2.75,1.6596263257283717,1.0544585230525578,-0.1774780272229799,0.7506302280601602,0.92810825528314,15.458035106141924,-1.2433641550262031,4199364445.0,2009-12-08,2009,1,342,12,1.38,110.02,110.17998999999999,109.02,2498
2009-12-09 14:30:00,109.58,110.17998999999999,109.02,110.021,104.42951142857143,112.58032258064516,95.7369357500003,105.09156159999992,108.2386222,110.44900100000015,108.16164157275296,109.98285952421273,110.50315461538472,111.86802377566696,109.13828545510245,95.7369357500003,105.09156159999992,108.2386222,110.44900100000015,109.74033,155063376,160249043.2,52.032737526222135,1.5,2.75,1.6239380167477742,0.9676399490664792,-0.2093076913781073,0.6664736410605059,0.8757813324386132,15.646045667756812,-1.2201472436703131,4354427821.0,2009-12-09,2009,2,343,12,1.06,109.6,111.12,110.45,2499
2009-12-10 14:30:00,110.7,111.12,110.45,110.64,104.48141571428572,112.64709677419356,95.9120357500003,105.24226149999993,108.3396222,110.47350150000015,108.25883209931166,110.04544433143057,110.59623230769242,111.81262544497099,109.37983917041383,95.9120357500003,105.24226149999993,108.3396222,110.47350150000015,110.73666666666666,138014624,158676464.8,54.74297451823911,1.5,2.75,1.5864424441229334,0.8697863553612519,-0.18676685051364628,0.6423227692965554,0.8290896198102017,15.905404299241505,0.976535458927132,4492442445.0,2009-12-10,2009,3,344,12,0.61,110.78,111.36,110.61,2500
2009-12-11 14:30:00,111.11,111.36,110.61,111.11,104.53331999999999,112.71387096774193,96.0979358000003,105.39786149999992,108.5018222,110.57750150000015,108.37064260522101,110.14683058558005,110.61853923076931,111.86088835311523,109.37619010842344,96.0979358000003,105.39786149999992,108.5018222,110.57750150000015,111.02666666666666,124854000,157061940.0,56.741570348992546,1.5,2.75,1.5266965552570095,0.7949347881479116,-0.14041241103718438,0.6535741060137212,0.7939865170509056,12.492905006520564,1.0642168455521208,4617296445.0,2009-12-11,2009,4,345,12,0.68,110.98,112.0,105.476,2501
2009-12-14 14:30:00,111.87,112.0,105.476,111.87,105.476,112.78064516129032,96.3042857500003,105.53995149999993,108.689422,110.69000150000015,108.50787230697705,110.31094195838192,110.68623076923086,112.08785043764931,109.2846111008124,96.3042857500003,105.53995149999993,108.689422,110.69000150000015,109.78200000000001,107141504,154870868.0,59.830683592371614,1.5,2.75,1.8836468013100804,0.6918118648369685,-0.06273489481682915,0.7155678985298692,0.7783027933466984,12.842964355274653,0.5121293800539151,4724437949.0,2009-12-14,2009,0,348,12,6.19,108.74,111.92,111.0,2502
2009-12-15 14:30:00,111.46001000000001,111.92,111.0,111.35001000000001,105.55862068965516,112.84741935483869,96.5106857500003,105.67285159999994,108.8360222,110.69700150000016,108.61932868709559,110.40990081948841,110.68392384615393,112.08105997689778,109.28678771541011,96.5106857500003,105.67285159999994,108.8360222,110.69700150000016,111.42333666666669,120408752,150345199.2,56.83991649882147,1.5,2.75,1.814814886930789,0.8008819213430528,-0.051039650673250336,0.7145032300051355,0.7655428806783858,11.346361285859174,0.08989662921348089,4604029197.0,2009-12-15,2009,1,349,12,0.83,111.46,112.13,111.27,2503
2009-12-16 14:30:00,111.8,112.13,111.27,111.52,105.64124137931034,112.91419354838708,96.7096357500003,105.80455149999996,108.95622240000002,110.70605150000016,108.73308050328795,110.51562455096571,110.83392307692316,112.13595553827452,109.53189061557184,96.7096357500003,105.80455149999996,108.95622240000002,110.70605150000016,111.64,155358128,150756402.4,57.58632672497094,1.5,2.75,1.7466138235785895,1.030524246577537,-0.03716465903277466,0.7190870568874175,0.7562517159201921,11.371388837166787,1.0327957963399172,4759387325.0,2009-12-16,2009,2,350,12,0.77,111.7,110.92998999999999,110.08,2504
2009-12-17 14:30:00,110.72,110.92998999999999,110.08,110.17998999999999,105.72386206896552,112.98096774193549,96.91653570000031,105.92745139999997,109.04382220000001,110.6515510000002,108.7898220521786,110.48365935563564,110.85238384615394,112.10921592299393,109.59555176931394,96.91653570000031,105.92745139999997,109.04382220000001,110.6515510000002,110.39666000000001,183390064,152101568.0,50.21422354382236,1.5,2.75,1.7247128361801192,1.2057079122287548,-0.11893076046820206,0.6075882653349396,0.7265190258031416,12.658774287653776,-0.7476804565066606,4575997261.0,2009-12-17,2009,3,351,12,0.77,110.5,110.3,109.28,2505
2009-12-18 14:30:00,110.2,110.3,109.28,110.21001000000001,105.80648275862069,113.04774193548387,97.12298575000031,106.05303159999997,109.11582240000001,110.67105100000019,108.84551569719122,110.45759751224176,110.76853846153857,112.04008272335,109.49699419972711,97.12298575000031,106.05303159999997,109.11582240000001,110.67105100000019,109.93000333333332,174591120,150394399.2,50.36751761457521,1.5,2.75,1.674376205024396,1.1608884435106013,-0.16865335079797827,0.5157023373056688,0.6843556881036471,12.110327305729019,-0.5683778419343256,4750588381.0,2009-12-18,2009,4,352,12,0.93,109.79,111.7,110.75998999999999,2506
2009-12-21 14:30:00,110.75998999999999,111.7,110.75998999999999,111.33,105.88910344827585,113.11451612903222,97.33908575000031,106.17963159999996,109.1972226,110.76605150000016,108.94294645416413,110.54068346345684,110.77469230769242,112.05623250726566,109.49315210811916,97.33908575000031,106.17963159999996,109.1972226,110.76605150000016,111.26333000000001,118104256,149589812.0,55.831629572629204,1.5,2.75,1.6612057618083682,0.7895207194992664,-0.12574141467204936,0.5271789197635854,0.6529203344356348,13.576338529803046,1.5691998905209368,4868692637.0,2009-12-21,2009,0,355,12,0.85,111.23,111.97,111.425,2507
2009-12-22 14:30:00,111.57001000000001,111.97,111.425,111.73,105.97172413793105,113.18129032258064,97.53688575000031,106.30883159999996,109.2782228,110.81155100000015,109.05224267164787,110.65395170503237,110.87853846153857,112.23208203098042,109.52499489209671,97.53688575000031,106.30883159999996,109.2782228,110.81155100000015,111.70833333333331,91707440,146774677.6,57.62588695877054,1.5,2.75,1.5882624931077705,0.6248178602710145,-0.07267895624619325,0.5620716391278933,0.6347505953740865,11.440086136204474,1.5533398169440409,4960400077.0,2009-12-22,2009,1,356,12,0.49,111.7,112.11,111.5,2508
2009-12-23 14:30:00,112.0,112.11,111.5,111.95,106.0543448275862,113.24806451612902,97.73343575000034,106.42393159999996,109.3680226,110.85955050000015,109.16588021393619,110.7773848759817,110.95084692307701,112.42023091501221,109.48146293114183,97.73343575000034,106.42393159999996,109.3680226,110.85955050000015,111.85333333333334,111783056,145442827.2,58.62151098179915,1.5,2.75,1.51838660074293,0.7685704283394184,-0.027357498287722267,0.6005537225144337,0.627911220802156,11.38170230919572,1.1840202458423736,5072183133.0,2009-12-23,2009,2,357,12,0.55,111.8,112.60001000000001,111.9948,2509
2009-12-24 14:30:00,112.19,112.60001000000001,111.9948,112.48,106.13696551724138,113.31483870967743,97.91833575000034,106.54173159999996,109.4314226,110.91455050000015,109.29584569574259,110.93953869731676,111.07700076923086,112.75364302370028,109.40035851476144,97.91833575000034,106.54173159999996,109.4314226,110.91455050000015,112.35826999999999,39677472,141948463.2,60.99894758380718,1.5,2.75,1.456359700689863,0.279520264647712,0.030582053885466313,0.6661387881589889,0.6355567342735226,11.282440256710064,1.2330123301233054,5111860605.0,2009-12-24,2009,3,358,12,0.54,112.3,112.99001000000001,112.32001000000001,2510
2009-12-28 14:30:00,112.89998999999999,112.99001000000001,112.32001000000001,112.72,106.21958620689655,113.3816129032258,98.10148575000035,106.66483159999994,109.49162240000001,111.07205000000015,109.43012625669388,111.10910644042944,111.31623153846165,112.97473109982072,109.65773197710259,98.10148575000035,106.66483159999994,109.49162240000001,111.07205000000015,112.67667333333333,87508432,140023794.4,62.061938393324006,1.5,2.75,1.4001911506405873,0.6249540113876529,0.07481627079980524,0.7290770727732792,0.6542608019734739,11.169976496292133,0.7598104943237636,5199369037.0,2009-12-28,2009,0,362,12,0.6,112.66,113.03,112.55,2511
2009-12-29 14:30:00,113.00998999999999,113.03,112.55,112.56200000000001,106.30220689655172,113.4483870967742,98.28499575000036,106.79155159999996,109.5650624,111.20315000000014,109.55294483486273,111.24747725562663,111.51169307692318,113.1114203744702,109.91196577937616,98.28499575000036,106.79155159999996,109.5650624,111.20315000000014,112.71399999999998,80572496,136008678.4,60.88542452595049,1.5,2.75,1.3344632113091168,0.5924070209919781,0.08257146673178484,0.7574751353882049,0.6749036686564202,10.709416182774993,1.0884507329635624,5118796541.0,2009-12-29,2009,1,363,12,0.43,112.79,112.64998999999999,112.17,2512
2009-12-30 14:30:00,112.23,112.64998999999999,112.17,112.52,106.38482758620691,113.51516129032257,98.45669580000036,106.90473159999996,109.6196626,111.26415000000013,109.66929993937794,111.36866989794792,111.65630846153856,113.2545884258325,110.05802849724462,98.45669580000036,106.90473159999996,109.6196626,111.26415000000013,112.44666333333332,73138368,131684915.2,60.55679130996354,1.5,2.75,1.273429410501323,0.5554042988820636,0.07427043077015537,0.7677417071191144,0.6934712763489591,10.208813339613313,0.896700143472023,5045658173.0,2009-12-30,2009,2,364,12,0.43,112.41,112.8,111.39,2513
2009-12-31 14:30:00,112.77,112.8,111.39,111.44,106.46744827586208,113.58193548387095,98.6142458500003,107.00923149999996,109.66424259999998,111.27365000000013,109.73873915744154,111.37546324100047,111.68169307692318,113.25474310166572,110.10864305218064,98.6142458500003,107.00923149999996,109.66424259999998,111.27365000000013,111.87666666666664,90637872,129601056.0,52.682308110933754,1.5,2.75,1.2831844526083709,0.6993605978025365,-0.01007119863738848,0.6808822780522235,0.6909534766896119,11.886612923812732,1.1435924072964556,4955020301.0,2009-12-31,2009,3,365,12,1.27,112.1,113.39,111.50998999999999,2514
2010-01-04 14:30:00,112.37,113.39,111.50998999999999,113.33,106.55006896551724,113.64870967741936,98.78619585000037,107.14523149999997,109.76624259999998,111.42115000000014,109.87957291597324,111.56160959900043,111.79400076923086,113.59652615330812,109.99147538515359,98.78619585000037,107.14523149999997,109.76624259999998,111.42115000000014,112.74333,118944560,127182043.2,61.995817080428345,1.5,2.75,1.3308141345649165,0.9352307684894938,0.05190914455310092,0.7558399073809878,0.7039307628278871,12.73583657688187,2.830949747668112,5073964861.0,2010-01-04,2010,0,4,1,1.69,112.45,113.67998999999999,112.85001000000001,2515
2010-01-05 14:30:00,113.25998999999999,113.67998999999999,112.85001000000001,113.63,106.6326896551724,113.71548387096772,98.97079580000036,107.27353149999998,109.8522426,111.55215050000014,110.02664848789586,111.7585991610004,111.96938461538471,113.99487294606818,109.94389628470124,98.97079580000036,107.27353149999998,109.8522426,111.55215050000014,113.38666666666666,111579872,119015641.6,63.23288480130754,1.5,2.75,1.2950402678102797,0.9375227533117798,0.10076375652199132,0.8298854584803763,0.729121701958385,12.634901324306755,2.065930117668191,5185544733.0,2010-01-05,2010,1,5,1,0.74,113.26,113.99001000000001,113.42998999999999,2516
2010-01-06 14:30:00,113.52,113.99001000000001,113.42998999999999,113.71001000000001,106.7153103448276,113.78225806451613,99.12824585000037,107.39493149999998,109.9648428,111.69565100000014,110.17109403739012,111.94444781233368,112.137846923077,114.34220315117778,109.93349069497623,99.12824585000037,107.39493149999998,109.9648428,111.69565100000014,113.71000333333336,116074368,118420669.6,63.573440326118536,1.5,2.75,1.2425388201095449,0.9801867224030628,0.12456146611426022,0.8848235346012103,0.7602620684869501,11.843250037516295,1.7721381902801332,5301619101.0,2010-01-06,2010,2,6,1,0.49,113.71,114.33,113.17998999999999,2517
2010-01-07 14:30:00,113.5,114.33,113.17998999999999,114.19,106.79793103448276,113.84903225806451,99.29619580000036,107.5289316,110.1104428,111.92465100000014,110.3286981927866,112.15830992544477,112.44630923076932,114.58988979519472,110.30272866634394,99.29619580000036,107.5289316,110.1104428,111.92465100000014,113.89999666666668,131091056,116482040.8,65.63017512470263,1.5,2.75,1.2359296186731483,1.1254186061616462,0.15664836786536562,0.9560725283186572,0.7994241604532915,11.877008698812096,2.000893255917816,5432710157.0,2010-01-07,2010,3,7,1,1.02,113.75,114.62,113.66,2518
2010-01-08 14:30:00,113.89,114.62,113.66,114.57001000000001,106.88055172413792,113.91580645161291,99.46179585000034,107.6915317,110.273443,112.1521015000001,110.49502414601065,112.387995646831,112.78169384615393,114.78018105111342,110.78320664119448,99.46179585000034,107.6915317,110.273443,112.1521015000001,114.28333666666668,126402752,115049009.6,67.20875154407604,1.5,2.75,1.2162203601964958,1.0986861376684116,0.18551120291684264,1.0313131640993447,0.8458019611825021,11.893619768108492,1.858116998577518,5559112909.0,2010-01-08,2010,4,8,1,0.84,114.14,115.13,114.235,2519
2010-01-11 14:30:00,115.08,115.13,114.235,114.73,106.96317241379309,113.98258064516129,99.6198958500003,107.8479317,110.479843,112.3566015000001,110.66110163048084,112.61104368046612,113.0432323076924,115.1023278656152,110.98413674976959,99.6198958500003,107.8479317,110.479843,112.3566015000001,114.69833333333334,106375680,113467062.4,67.8776770146692,1.5,2.75,1.1932760487538887,0.9375027232572472,0.19637623796490988,1.0912722586386394,0.8948960206737295,11.800089346130461,1.7831795599716156,5665488589.0,2010-01-11,2010,0,11,1,0.78,114.68,114.21001000000001,113.22,2520
2010-01-12 14:30:00,113.97,114.21001000000001,113.22,113.66,107.04579310344828,114.04935483870966,99.78014585000034,107.98493159999998,110.62004319999998,112.4841015000001,110.77870548810905,112.71094428232651,113.19169384615395,115.12511526165498,111.25827243065291,99.78014585000034,107.98493159999998,110.62004319999998,112.4841015000001,113.69666999999998,163333440,115391034.4,59.182320496127176,1.5,2.75,1.2158991881286114,1.4154777348975736,0.1164483680670948,1.040456480757598,0.9240081126905032,13.46962486536855,0.9754624118263704,5502155149.0,2010-01-12,2010,1,12,1,0.87,113.72,114.94,113.37,2521
2010-01-13 14:30:00,113.95,114.94,113.37,114.62,107.12841379310345,114.11612903225807,99.9592959000003,108.1212315,110.84124319999997,112.62160150000008,110.92934448857534,112.89275911258112,113.39707846153857,115.32650744368496,111.46764947939218,99.9592959000003,108.1212315,110.84124319999997,112.62160150000008,114.31,161821936,118125056.0,63.678064224658826,1.5,2.75,1.2411921032622817,1.3699205018789578,0.11308766347859599,1.0653676920387485,0.9522800285601524,14.038117186671428,1.866334873800221,5663977085.0,2010-01-13,2010,2,13,1,1.38,114.16,115.14,114.42,2522
2010-01-14 14:30:00,114.49001000000001,115.14,114.42,114.92998999999999,107.21103448275862,115.14,100.13634585000031,108.2408314,111.05344279999996,112.80060050000007,111.08623254784688,113.08678110185909,113.58553923076934,115.59672491403477,111.57435354750393,100.13634585000031,108.2408314,111.05344279999996,112.80060050000007,114.82999666666667,115783744,117893805.6,65.01792578306326,1.5,2.75,1.2039640958864042,0.9821020146965213,0.11615407912283993,1.0974726274637019,0.9813185483408622,13.973893558001356,3.131721105527644,5779760829.0,2010-01-14,2010,3,14,1,0.63,114.78,114.84,113.2,2523
2010-01-15 14:30:00,114.73,114.84,113.2,113.64,107.29365517241379,115.24222222222221,100.2992458500003,108.3476313,111.23324299999996,112.90660050000008,111.18638029106859,113.13946861596777,113.65630846153856,115.60444529482537,111.7081716282518,100.2992458500003,108.3476313,111.23324299999996,112.90660050000008,113.89333333333332,212283120,120740055.2,55.794255485464774,1.5,2.75,1.2415373747516611,1.7581830623512915,0.02071641824302639,1.0072140711446451,0.9864976529016188,14.500532736682635,0.27353745698403104,5567477709.0,2010-01-15,2010,4,15,1,1.45,114.02,115.13,113.59,2524
2010-01-19 14:30:00,113.62,115.13,113.59,115.06,107.37627586206897,115.34444444444445,100.45739590000031,108.4666313,111.43604299999996,113.15060100000008,111.3382869463208,113.32237636682794,113.84846230769243,115.8195892217968,111.87733539358807,100.45739590000031,108.4666313,111.43604299999996,113.15060100000008,114.59333333333332,139172624,118529183.2,62.15823444385149,1.5,2.75,1.262856133697971,1.1741633599648391,0.04143932428713715,1.0382968082605402,0.996857483973403,12.99580719374604,1.2584704743465696,5706650333.0,2010-01-19,2010,1,19,1,1.36,114.36,114.45,112.98,2525
2010-01-20 14:30:00,114.28,114.45,112.98,113.89,107.45889655172415,115.44666666666667,100.6055459500003,108.57383129999998,111.576841,113.33460050000008,111.43835412489645,113.37643576046341,113.95384692307705,115.77000479627272,112.13768904988136,100.6055459500003,108.57383129999998,111.576841,113.33460050000008,113.77333333333333,216490128,120624133.6,55.117445762517654,1.5,2.75,1.3212235527195442,1.7947497033877142,-0.031499103592900424,0.9574836044822774,0.988982708075178,14.582708488521137,0.15828861504805394,5490160205.0,2010-01-20,2010,2,20,1,1.3,113.72,114.27,111.56,2526
2010-01-21 14:30:00,113.92,114.27,111.56,111.7,107.54151724137932,115.54888888888891,100.74604590000034,108.6568314,111.66824099999998,113.35310050000008,111.44861474744955,113.21677521184785,113.97384692307705,115.68130524253651,112.26638860361759,100.74604590000034,108.6568314,111.66824099999998,113.35310050000008,112.51,344859392,131961890.4,44.871805164614365,1.5,2.75,1.4204218703824334,2.613325642385614,-0.22434131240583555,0.7085560675678835,0.9328973799737191,18.402679846793088,-2.180576232594793,5145300813.0,2010-01-21,2010,3,21,1,2.43,112.92,111.74158999999999,109.09,2527
2010-01-22 14:30:00,111.2,111.74158999999999,109.09,109.21001000000001,107.62413793103448,115.65111111111109,100.8838460000003,108.7151315,111.66104099999997,113.22710100000006,111.36082632598092,112.83517852500519,113.65692461538477,116.717793363206,110.59605586756348,100.8838460000003,108.7151315,111.66104099999997,113.22710100000006,110.01386666666669,345942272,144673632.0,36.55221543383798,1.5,2.75,1.5083624510694025,2.39119089786866,-0.5008611226807448,0.3068209766227881,0.8076820993035329,21.371041144639808,-4.678362164758473,4799358541.0,2010-01-22,2010,4,22,1,2.43,110.42,110.41,109.41,2528
2010-01-25 14:30:00,110.21001000000001,110.41,109.41,109.77,107.70675862068966,115.75333333333332,101.0200460000003,108.7882314,111.66464099999996,113.11810100000008,111.29844097986404,112.54325676071898,113.36000153846165,117.05658277817574,109.66342029874758,101.0200460000003,108.7882314,111.66464099999996,113.11810100000008,109.86333333333334,186937440,148431351.2,39.278902713283784,1.5,2.75,1.4863358474215878,1.2594201864275694,-0.6195486449625822,0.033246293100305024,0.6527949380628872,21.63231381084847,-4.323193584938559,4986295981.0,2010-01-25,2010,0,25,1,0.91,109.91,110.47,109.03998999999999,2529
2010-01-26 14:30:00,109.34,110.47,109.03998999999999,109.31,107.78937931034484,115.85555555555555,101.1375460000003,108.8793314,111.6478412,112.95960100000006,111.2204629022223,112.2353275454124,113.02153923076936,117.28952689569414,108.75355156584456,101.1375460000003,108.8793314,111.6478412,112.95960100000006,109.60666333333334,211168752,157005915.2,37.840316565379595,1.5,2.75,1.4823125726057598,1.3449732242954373,-0.6967694530437749,-0.2181668782418313,0.4786025748019435,21.332143478827714,-3.827203941580146,4775127229.0,2010-01-26,2010,1,26,1,1.31,109.75,110.08,108.33,2530
2010-01-27 14:30:00,109.17,110.08,108.33,109.83,107.87200000000001,115.95777777777779,101.2575460000003,108.9794313,111.66384120000001,112.81510100000007,111.16593494527241,112.00624873156359,112.68615461538471,117.21161867047006,108.16069056029941,101.2575460000003,108.9794313,111.66384120000001,112.81510100000007,109.41333333333334,271863552,166223671.2,40.49352253151445,1.5,2.75,1.50143310313392,1.6355285022726656,-0.6798222965800194,-0.3711752959230808,0.3086470006569386,21.767636076081228,-4.179026347932303,5046990781.0,2010-01-27,2010,2,27,1,1.62,109.2,110.25,107.91,2531
2010-01-28 14:30:00,110.19,110.25,107.91,108.57001000000001,107.95462068965516,116.06,101.3786460000003,109.0586315,111.64284140000001,112.61550150000008,111.06413396702642,111.67898789998614,112.22461615384627,117.09790080150164,107.35133150619086,101.3786460000003,109.0586315,111.64284140000001,112.61550150000008,108.91000333333334,316103936,178000243.2,36.43532437264307,1.5,2.75,1.5613307386243545,1.7758623826419582,-0.7167862331127868,-0.5873357907340448,0.12945044237874193,20.788452224914824,-5.533786264142202,4730886845.0,2010-01-28,2010,3,28,1,2.17,109.08,109.8,107.22,2532
2010-01-29 14:30:00,109.03998999999999,109.8,107.22,107.39,108.03724137931034,116.16222222222223,101.48934600000034,109.1119315,111.5664412,112.35900150000006,110.920050282045,111.2705128618922,111.66000076923088,116.9263299184533,106.39367162000845,101.48934600000034,109.1119315,111.5664412,112.35900150000006,108.13666666666666,310677504,189877200.0,33.09063307247145,1.5,2.75,1.6340928287226149,1.6362022612509561,-0.7788650501029466,-0.8441308702499413,-0.06526582014699472,20.306546371128302,-5.49982400563182,4420209341.0,2010-01-29,2010,4,29,1,2.41,108.51,109.07001000000001,107.50079,2533
2010-02-01 14:30:00,108.14998999999999,109.07001000000001,107.50079,109.06,108.11986206896552,116.26444444444445,101.60214600000036,109.17313149999998,111.5208612,112.24000150000006,110.84710713372951,111.05998782742628,111.30615461538471,116.60545902750721,106.00685020326222,101.60214600000036,109.17313149999998,111.5208612,112.24000150000006,108.5436,187864880,194738550.4,41.30294072429045,1.5,2.75,1.6373726266709991,0.9647030832576228,-0.6697749423863308,-0.9024844981299084,-0.23270955574357746,23.644425799662088,-5.214670606640014,4608074221.0,2010-02-01,2010,0,32,2,1.46,108.29,110.59,108.88,2534
2010-02-02 14:30:00,109.25998999999999,110.59,108.88,110.38,108.20248275862068,116.36666666666667,101.7186460000003,109.23963149999996,111.50306119999999,112.09250150000008,110.82878920691658,110.99522708195713,110.98000076923088,115.9339995394812,106.02600199898052,101.7186460000003,109.23963149999996,111.50306119999999,112.09250150000008,109.95,216327872,199607716.0,46.85533279290306,1.5,2.75,1.6425602961944998,1.083765078500272,-0.4799277822269614,-0.8326192835272792,-0.3526915013003178,23.54639769889515,-3.081921151988765,4824402093.0,2010-02-02,2010,1,33,2,1.57,109.74,110.48151000000001,109.50998999999999,2535
2010-02-03 14:30:00,109.88,110.48151000000001,109.50998999999999,109.83,108.28510344827585,116.46888888888891,101.85064605000035,109.29003159999998,111.503261,111.90250150000006,110.78962100272379,110.88425307415169,110.58769384615394,115.00727137077044,106.16811632153744,101.85064605000035,109.29003159999998,111.503261,111.90250150000006,109.9405,172730624,202665253.6,44.947489654911,1.5,2.75,1.5946288464663212,0.8522952056740722,-0.3676609468075832,-0.8122676848097967,-0.4446067380022136,23.243388570108102,-1.6741271262309798,4651671469.0,2010-02-03,2010,2,34,2,0.89,110.0,109.03,106.42,2536
2010-02-04 14:30:00,108.98,109.03,106.42,106.44,108.36772413793105,116.57111111111112,101.9575460500003,109.30673159999998,111.4434612,111.53900100000007,110.61904763006794,110.46099087661342,110.03384769230776,114.58713093508959,105.48056444952594,101.9575460500003,109.30673159999998,111.4434612,111.53900100000007,107.29666666666668,356715520,214697311.2,35.38407170703072,1.5,2.75,1.7242982145758694,1.6614810777378757,-0.4903093605536532,-1.05749343869428,-0.5671840781406269,26.91849968483736,-2.5364066901925924,4294955949.0,2010-02-04,2010,3,35,2,2.45,107.72,106.88,104.58,2537
2010-02-05 14:30:00,106.56,106.88,104.58,106.66,104.58,116.67333333333332,102.0681461000003,109.32053159999998,111.36026100000001,111.16250100000006,110.46379086026137,110.09899174550738,109.38769384615395,113.23369920085771,105.5416884914502,102.0681461000003,109.32053159999998,111.36026100000001,111.16250100000006,106.04,493585664,232822041.6,36.330841666911006,1.5,2.75,1.7654197706775927,2.1200126096652183,-0.5222693883026527,-1.2200208135189428,-0.6977514252162901,24.60091436387807,-2.833196683975585,4788541613.0,2010-02-05,2010,4,36,2,2.2,105.73,107.33,105.80991000000002,2538
2010-02-08 14:30:00,106.74001000000001,107.33,105.80991000000002,105.89,104.55511111111109,116.77555555555556,102.1707461000003,109.32223159999998,111.2582608,110.72850050000008,110.28442651280012,109.6981353887924,108.77230923076931,112.05926412164614,105.48535433989252,102.1707461000003,109.32223159999998,111.2582608,110.72850050000008,106.34330333333332,224166816,237710244.8,34.429383165650165,1.5,2.75,1.7478962156291933,0.9430254728339752,-0.557701424767952,-1.3948782061762302,-0.8371767814082781,24.247152052732762,-3.1287164943738013,4564374797.0,2010-02-08,2010,0,39,2,1.44,106.57,108.14998999999999,106.27,2539
2010-02-09 14:30:00,107.13,108.14998999999999,106.27,107.22,104.5302222222222,116.87777777777778,102.2735461000003,109.32123149999998,111.1750608,110.35300050000004,110.16425292406286,109.4621224946217,108.42769384615394,111.33167780787548,105.5237098844324,102.2735461000003,109.32123149999998,111.1750608,110.35300050000004,107.21333,337820416,249282481.6,40.24665323403817,1.5,2.75,1.784474343084251,1.355171104811402,-0.4581640347569162,-1.4098818248544234,-0.9517177900975072,25.92334734359767,-2.3763998907402346,4902195213.0,2010-02-09,2010,1,40,2,1.77,107.21,107.60001000000001,106.11,2540
2010-02-10 14:30:00,107.05,107.60001000000001,106.11,107.00998999999999,104.50533333333333,116.98,102.37939605000031,109.31973139999998,111.12386039999996,110.02050000000006,110.0405563388055,109.22858606656249,108.25846153846165,111.21627780318356,105.30064527373972,102.37939605000031,109.31973139999998,111.12386039999996,110.02050000000006,106.90666666666668,240511504,253141384.8,39.6485036891616,1.5,2.75,1.7634411757210895,0.9501074041687078,-0.3764839294285229,-1.4223227018831608,-1.045838772454638,25.57556041690432,-1.436879300278221,4661683709.0,2010-02-10,2010,2,41,2,1.4,106.86,108.25,106.25,2541
2010-02-11 14:30:00,106.87,108.25,106.25,108.13,104.48044444444444,117.08222222222223,102.4921960000003,109.33383139999998,111.0876604,109.69600000000008,109.96563256081312,109.12395882212795,108.13230769230778,110.95845276833953,105.30616261627605,102.4921960000003,109.33383139999998,111.0876604,109.69600000000008,107.54333333333334,223591568,256229866.4,44.394872226927454,1.5,2.75,1.7803382345981549,0.8726210224492393,-0.22454137801659546,-1.326515494975382,-1.1019741169587869,25.86847280125393,0.6890771952695735,4885275277.0,2010-02-11,2010,3,42,2,1.88,107.25,108.1012,106.50998999999999,2542
2010-02-12 14:30:00,106.99001000000001,108.1012,106.50998999999999,108.03998999999999,104.45555555555555,117.18444444444445,102.59544595000034,109.34973129999996,111.02246019999998,109.35150000000007,109.89011716627144,109.020723696211,108.03461461538471,110.77774893555213,105.2914802952173,102.59544595000034,109.34973129999996,111.02246019999998,109.35150000000007,107.55039333333332,304622080,265671783.2,44.094739234845896,1.5,2.75,1.768886217841143,1.146610589693968,-0.11323364057957352,-1.2435161676832536,-1.1302825271036798,25.002278638899302,-0.935274161012286,4580653197.0,2010-02-12,2010,4,43,2,1.49,107.31,109.85001000000001,107.821,2543
2010-02-16 14:30:00,108.86,109.85001000000001,107.821,109.74001000000001,104.43066666666668,117.28666666666668,102.70704600000036,109.37643129999996,110.9922604,109.15650050000008,109.88423061073138,109.08922715371472,108.02769230769242,110.75306573137304,105.30231888401178,102.70704600000036,109.37643129999996,110.9922604,109.15650050000008,109.13700666666666,159317440,263023499.2,50.852876166868285,1.5,2.75,1.7874664879953472,0.6057156128048349,0.08126366229661741,-1.0287029492329085,-1.1099666115295257,25.04174449053946,-0.5798061242978777,4739970637.0,2010-02-16,2010,1,47,2,1.88,108.84,110.41,109.74001000000001,2544
2010-02-17 14:30:00,110.27,110.41,109.74001000000001,110.25998999999999,104.40577777777777,117.38888888888891,102.81889595000037,109.41723129999995,110.98986019999998,108.91650000000007,109.89896627305565,109.20072837717045,108.15769076923088,111.124649620302,105.19073191815973,102.81889595000037,109.41723129999995,110.98986019999998,108.91650000000007,110.13666666666668,168845056,264507120.8,52.734929440652344,1.5,2.75,1.7076467388528225,0.6383384140635959,0.24221409079632106,-0.8071989980341243,-1.0494130888304454,24.161585797648392,0.3915050532641388,4908815693.0,2010-02-17,2010,2,48,2,0.61,110.08,111.14,110.035,2545
2010-02-18 14:30:00,110.08,111.14,110.035,110.91,104.38088888888888,117.49111111111112,102.91904595000034,109.47623139999996,110.9878604,108.76750000000007,109.93861465450443,109.36351615077328,108.4284600000001,111.69328394248585,105.16363605751437,102.91904595000034,109.47623139999996,110.9878604,108.76750000000007,110.695,193708496,263368039.2,55.05211669791933,1.5,2.75,1.6646005432204782,0.7355049480886291,0.3814468568462962,-0.5726045177725752,-0.9540513746188714,24.162649002980913,4.199549041713642,5102524189.0,2010-02-18,2010,3,49,2,1.0,110.59,111.57001000000001,110.36,2546
2010-02-19 14:30:00,110.62,111.57001000000001,110.36,111.14,104.35600000000001,117.59333333333332,103.02189590000036,109.54313139999996,110.9938604,108.73950000000008,109.98572780530822,109.53270508879488,108.58846000000014,112.15163927915577,105.02528072084448,103.02189590000036,109.54313139999996,110.9938604,108.73950000000008,111.02333666666664,222684816,257259310.4,55.87641441920754,1.5,2.75,1.6321297901333012,0.865604497088009,0.4720951496206685,-0.3639324375930357,-0.8360275872137042,12.726586562048588,4.200262516407279,5325209005.0,2010-02-19,2010,4,50,2,1.1,110.97,111.58,110.83,2547
2010-02-22 14:30:00,111.55,111.58,110.83,111.16,104.33111111111113,117.69555555555556,103.11699085000036,109.59153129999996,111.02486040000001,108.83699950000008,110.0317776952961,109.68768555652868,108.64846000000013,112.35372460261827,104.943195397382,103.11699085000036,109.59153129999996,111.02486040000001,108.83699950000008,111.19,132346816,246579537.6,55.952060650053866,1.5,2.75,1.5691205194094942,0.5367307331668871,0.5130619927443811,-0.1947000962832277,-0.7077620890276088,12.893305227951133,4.9768627821323985,5457555821.0,2010-02-22,2010,0,53,2,0.68,111.2,111.2,109.52,2548
2010-02-23 14:30:00,110.86,111.2,109.52,109.81,104.30622222222222,117.79777777777778,103.21174085000037,109.62963129999994,111.0206404,108.83899950000007,110.02308053077469,109.699334551145,108.64692153846168,112.35023861293767,104.94360446398564,103.21174085000037,109.62963129999994,111.0206404,108.83899950000007,110.17666666666666,207496944,247607512.8,49.751751710344784,1.5,2.75,1.5770404823088169,0.8380074645295658,0.4321423446122124,-0.1675841582623434,-0.5997265028745558,14.685821089903119,2.4155941055773207,5250058877.0,2010-02-23,2010,1,54,2,1.53,110.36,111.0,109.86,2549
2010-02-24 14:30:00,110.14,111.0,109.86,110.82001000000001,104.28133333333334,117.9,103.30094090000036,109.68193139999994,111.0242406,108.91450000000007,110.05433266682272,109.80606554627406,108.98384538461549,112.61907439529315,105.34861637393783,103.30094090000036,109.68193139999994,111.0242406,108.91450000000007,110.56000333333334,176350624,245866606.4,53.87038967355032,1.5,2.75,1.5493947335724725,0.7172613905651565,0.4286939317326038,-0.06385908820880104,-0.4925530199414048,14.065071604877096,3.5604339370557785,5426409501.0,2010-02-24,2010,2,55,2,1.04,110.43,110.75,108.94,2550
2010-02-25 14:30:00,109.24001000000001,110.75,108.94,110.67,104.25644444444444,118.00222222222223,103.3980908500003,109.75863139999994,111.01544060000002,108.95650000000008,110.07847648381008,109.88834501805746,109.29230692307705,112.76325543526673,105.82135841088737,103.3980908500003,109.75863139999994,111.01544060000002,108.95650000000008,110.12,259634688,245255163.2,53.173273260126706,1.5,2.75,1.5730101097458669,1.0586308749319735,0.3989769131753923,0.006168121527835524,-0.3928087916475568,13.986365878179107,2.3490243225746843,5166774813.0,2010-02-25,2010,3,56,2,1.66,109.84,111.12,110.11,2551
2010-02-26 14:30:00,110.77,111.12,110.11,110.74001000000001,104.23155555555556,118.10444444444445,103.49694090000034,109.84113139999994,110.99284080000002,109.0650000000001,110.10441897464105,109.96945596871866,109.66538461538471,112.5934999387777,106.73726929199177,103.49694090000034,109.84113139999994,110.99284080000002,109.0650000000001,110.65666999999999,173589248,238129428.8,53.4758656783122,1.5,2.75,1.5327951019068768,0.7289701607850999,0.3674848700080388,0.06654729586249175,-0.30093757414554706,13.293349674715357,2.4990931598568222,5340364061.0,2010-02-26,2010,4,57,2,0.92,110.62,112.0,111.17,2552
2010-03-01 14:30:00,111.2,112.0,111.17,111.89,104.20666666666666,118.20666666666668,103.61299095000031,109.91983139999994,111.00364060000004,109.29000000000009,110.17444175994923,110.15236492407878,110.0246153846155,112.80678072163052,107.24245004760049,103.61299095000031,109.91983139999994,111.00364060000004,109.29000000000009,111.68666666666668,147709632,229981035.2,58.24846877187055,1.5,2.75,1.5133090231992432,0.6422687499929994,0.4046153689604556,0.2048316370550225,-0.19978373190543314,13.835824699497332,1.9591669437609882,5488073693.0,2010-03-01,2010,0,60,3,0.75,111.58,112.74001000000001,112.0,2553
2010-03-02 14:30:00,112.37,112.74001000000001,112.0,112.2,104.18177777777778,118.30888888888892,103.72679095000035,109.98673149999992,111.01724060000002,109.44700000000007,110.25387541642182,110.34737778845225,110.42384692307705,112.82440834564233,108.02328550051176,103.72679095000035,109.98673149999992,111.01724060000002,109.44700000000007,112.31333666666666,160992368,228637409.6,59.45588539750597,1.5,2.75,1.4659305215421539,0.704138348495355,0.4282823060623335,0.33556915067248383,-0.09271315538984973,11.492007057090724,1.7594868274520985,5649066061.0,2010-03-02,2010,1,61,3,0.66,112.37,112.97,112.02,2554
2010-03-03 14:30:00,112.49001000000001,112.97,112.02,112.3,104.15688888888887,118.41111111111113,103.84474090000036,110.05173149999992,111.05964080000004,109.54300000000008,110.33411559616998,110.53334180859966,110.74461615384628,112.93897032101756,108.55026198667495,103.84474090000036,110.05173149999992,111.05964080000004,109.54300000000008,112.43,150784944,225360263.2,59.85915385706027,1.5,2.75,1.4290783414320003,0.6690839896037183,0.4278920320683522,0.4421518846955905,0.014259852627238319,11.396093985184336,1.2532684158326577,5799851005.0,2010-03-03,2010,2,62,3,0.85,112.5,112.8,112.03,2555
2010-03-04 14:30:00,112.45,112.8,112.03,112.64101000000001,104.132,118.51333333333334,103.95179595000036,110.11204159999993,111.10826080000004,109.6835505000001,110.424582043379,110.73407211254258,111.09854076923088,112.87896949369708,109.31811204476465,103.95179595000036,110.11204159999993,111.10826080000004,109.6835505000001,112.49033666666666,135770368,223512250.4,61.27372237423246,1.5,2.75,1.382001317044,0.6074403875269648,0.4268490656947242,0.5478211847456436,0.12097211905091937,11.141304329299667,1.3505578549577053,5935621373.0,2010-03-04,2010,3,63,3,0.69,112.42,114.34,113.10001000000001,2556
2010-03-05 14:30:00,113.37,114.34,113.10001000000001,114.25,104.10711111111112,118.61555555555556,104.06744595000036,110.18194169999992,111.16666080000005,110.07405050000007,110.57459843383472,111.06892238753849,111.4454630769232,113.7206627627146,109.17026339113178,104.06744595000036,110.18194169999992,111.16666080000005,110.07405050000007,113.89667,176118752,214482412.0,67.15506850318128,1.5,2.75,1.4046433658265722,0.82113377203162,0.5053983244071439,0.7527200245598493,0.24732170015270535,13.301870175364712,2.7797768981648106,6111740125.0,2010-03-05,2010,4,64,3,1.1,113.72,114.52,114.07001000000001,2557
2010-03-08 14:30:00,114.25998999999999,114.52,114.07001000000001,114.27,104.0822222222222,118.71777777777778,104.18624600000037,110.24784179999992,111.21746080000008,110.4545505000001,110.7195161423118,111.37378692205864,111.7539253846155,114.3651119530018,109.14273881622921,104.18624600000037,110.24784179999992,111.21746080000008,110.4545505000001,114.28667,114631120,195534684.8,67.2217059985072,1.5,2.75,1.3364538396961028,0.5862444308397197,0.5271592312651177,0.9062707392341024,0.3791115079689849,13.302217179600838,4.061560877879969,6226371245.0,2010-03-08,2010,0,67,3,0.39,114.3,114.99001000000001,113.87,2558
2010-03-09 14:30:00,113.92998999999999,114.99001000000001,113.87,114.46001000000001,104.05733333333332,118.82,104.31249600000037,110.31784179999993,111.26766100000006,110.8830510000001,110.86620217594664,111.66771292948162,112.02700307692318,114.95173659855692,109.10226955528944,104.31249600000037,110.31784179999993,111.26766100000006,110.8830510000001,114.44000666666666,154556688,192054178.4,67.88827495959708,1.5,2.75,1.320993565432095,0.8047556647171598,0.5218336951624915,1.0314036269220992,0.5095699317596077,9.405769624114393,3.2846053704561124,6380927933.0,2010-03-09,2010,1,68,3,0.98,114.43,115.27498999999999,114.41,2559
2010-03-10 14:30:00,114.50998999999999,115.27498999999999,114.41,114.97,104.03244444444445,118.92222222222223,104.44224600000037,110.37444179999993,111.31746100000008,111.2705510000001,111.02713542394872,111.9822164600072,112.32161846153856,115.58195325173769,109.06128367133944,104.44224600000037,110.37444179999993,111.31746100000008,111.2705510000001,114.88499666666664,186088816,184467598.4,69.67100912172683,1.5,2.75,1.2884218821869458,1.0087886307083835,0.5190410862872734,1.1583712896186995,0.6393302033314261,8.862037216990315,3.885425137797052,6567016749.0,2010-03-10,2010,2,69,3,0.76,114.84,115.48,114.35001000000001,2560
2010-03-11 14:30:00,114.7,115.48,114.35001000000001,115.45,104.00755555555556,119.02444444444444,104.56299600000037,110.43184169999992,111.37206100000007,111.69255150000008,111.20058109359779,112.31248155905412,112.65161846153856,116.22797277923758,109.07526414383958,104.56299600000037,110.43184169999992,111.37206100000007,111.69255150000008,115.09333666666667,160875872,180485816.8,71.28674242797841,1.5,2.75,1.277105319173593,0.8913491090453374,0.5148855689343005,1.2829371644993015,0.7680515955650012,8.262718238707981,4.253196292830392,6727892621.0,2010-03-11,2010,3,70,3,0.99,114.92,115.97,115.14,2561
2010-03-12 14:30:00,115.95,115.97,115.14,115.46001000000001,103.98266666666666,119.12666666666668,104.69194605000037,110.49754179999992,111.43002120000007,112.05905200000008,111.36761752129983,112.61224617247755,113.08623461538471,116.54701221166492,109.62545701910449,104.69194605000037,110.49754179999992,111.43002120000007,112.05905200000008,115.52333666666668,162074752,177409976.0,71.32105493199222,1.5,2.75,1.2451692249469075,0.9135605316805859,0.4789264538577955,1.3667096628872455,0.8877832090294502,8.35481142924329,3.1906425954061994,6889967373.0,2010-03-12,2010,4,71,3,0.72,115.56,115.575,114.60001000000001,2562
2010-03-15 13:30:00,115.25998999999999,115.575,114.60001000000001,115.49001000000001,103.95777777777779,119.22888888888892,104.81479610000038,110.55454199999993,111.48942140000008,112.43155300000004,111.52927997144494,112.88631891795588,113.44546538461547,116.85991182045821,110.03101894877277,104.81479610000038,110.55454199999993,111.48942140000008,112.43155300000004,115.22167333333331,146816816,169519712.8,71.43124264188003,1.5,2.75,1.225870708879272,0.8660751813166121,0.4251026409326985,1.4191615101953232,0.9940588692626248,7.606265445388915,2.932272727272723,7036784189.0,2010-03-15,2010,0,74,3,0.85,115.09,116.52,115.49001000000001,2563
2010-03-16 13:30:00,115.81,116.52,115.49001000000001,116.41,103.93288888888887,119.33111111111113,104.9341961000004,110.62653199999994,111.58882140000007,112.76505250000004,111.7206807568785,113.22190759243628,113.88700384615395,117.23551768967957,110.53849000262836,104.9341961000004,110.62653199999994,111.58882140000007,112.76505250000004,116.14000333333333,168673008,169987491.2,74.64806864301056,1.5,2.75,1.2118792296736096,0.9922671768921312,0.4187313024189667,1.5174729972863332,1.0987416948673665,8.069616040055376,3.659839715048976,7205457197.0,2010-03-16,2010,1,75,3,0.89,116.01,117.48,116.4198,2564
2010-03-17 13:30:00,116.75998999999999,117.48,116.4198,117.10001000000001,103.90799999999999,119.43333333333334,105.0458461500004,110.71523209999994,111.66422160000008,113.10705350000003,111.931634844844,113.5912506788709,114.37623461538472,117.5987086628082,111.15376056796127,105.0458461500004,110.71523209999994,111.66422160000008,113.10705350000003,116.99993666666666,177468064,170418641.6,76.76155855342763,1.5,2.75,1.2017449989826379,1.0413653244376055,0.4268050919884596,1.632248059852941,1.2054429678644814,7.94743924817833,3.9585937661603032,7382925261.0,2010-03-17,2010,2,76,3,0.91,116.95,117.27,116.57001000000001,2565
2010-03-18 13:30:00,117.11,117.27,116.57001000000001,117.03751000000001,103.88311111111109,119.53555555555555,105.15678365000038,110.79230719999994,111.73237180000008,113.41342900000005,112.13186524308544,113.91946585231176,114.77219692307705,117.93991417333594,111.60447967281816,105.15678365000038,110.79230719999994,111.73237180000008,113.41342900000005,116.95917333333334,196509056,170558669.6,76.14236729060451,1.5,2.75,1.165905356198164,1.1521493246919652,0.3945133612634921,1.6985846694438465,1.3040713081803543,8.386974905533451,2.4398336980306325,7186416205.0,2010-03-18,2010,3,77,3,0.6,116.92,117.29299999999999,115.52,2566
2010-03-19 13:30:00,116.96001000000001,117.29299999999999,115.52,115.97,103.85822222222221,119.6377777777778,105.26838370000036,110.87120719999993,111.77757160000007,113.65492900000008,112.28238033159187,114.11475481875827,115.06219692307705,117.90890303998323,112.21549080617085,105.26838370000036,110.87120719999993,111.77757160000007,113.65492900000008,116.261,226641120,170756484.8,66.30450595285326,1.5,2.75,1.2092692593268672,1.3272767957565732,0.2735775242466276,1.6460432134886394,1.3724656892420113,8.539458316122637,1.487704559376917,6959775085.0,2010-03-19,2010,4,78,3,1.53,116.41,116.8,115.24001000000001,2567
2010-03-22 13:30:00,115.31,116.8,115.24001000000001,116.5925,103.83333333333331,119.74,105.37869620000038,110.96803219999994,111.82562160000008,113.92655400000008,112.45140463231377,114.3507305503051,115.39238923076937,117.85014845173288,112.93463000980582,105.37869620000038,110.96803219999994,111.82562160000008,113.92655400000008,116.21083666666668,184477680,173363028.0,68.83332030027188,1.5,2.75,1.2343207408035195,1.0641120089342233,0.2106498866528297,1.6357780475580483,1.4251281609052189,8.760385645420907,1.863087378727299,7144252765.0,2010-03-22,2010,0,81,3,1.35,116.02,117.50998999999999,116.38,2568
2010-03-23 13:30:00,116.75998999999999,117.50998999999999,116.38,117.41,103.80844444444445,119.84222222222223,105.49299620000038,111.07793219999995,111.88242140000007,114.30655400000008,112.6458593526152,114.64208954551414,115.75923461538473,117.86293610309784,113.65553312767165,105.49299620000038,111.07793219999995,111.88242140000007,114.30655400000008,117.09999666666666,182941568,172135259.2,71.82392307339113,1.5,2.75,1.22686854503184,1.0627780087021244,0.19934376614016736,1.6743078685804278,1.4749641024402604,9.20317162439294,2.122292772027484,7327194333.0,2010-03-23,2010,1,82,3,0.97,116.94,117.42641,115.58,2569
2010-03-24 13:30:00,116.97,117.42641,115.58,116.84,103.78355555555555,119.94444444444444,105.60639620000038,111.20223219999994,111.92462140000008,114.60755350000008,112.81033545643422,114.85141435070328,115.9584653846155,117.93971027963423,113.97722048959676,105.60639620000038,111.20223219999994,111.92462140000008,114.60755350000008,116.61547,196183312,173126893.6,66.9967413218376,1.5,2.75,1.2711215061009946,1.1331764113625846,0.13198434466560816,1.6399445332722706,1.5079601886066625,10.013105119778658,1.2039844088349942,7131011021.0,2010-03-24,2010,2,83,3,1.6,116.5,118.1666,116.50998999999999,2570
2010-03-25 13:30:00,117.63,118.1666,116.50998999999999,116.64998999999999,103.75866666666668,120.04666666666668,105.7164461500004,111.30223219999996,111.98442120000007,114.90655300000007,112.96091014441716,115.02270726968392,116.14154153846165,117.89116992615729,114.39191315076602,105.7164461500004,111.30223219999996,111.98442120000007,114.90655300000007,117.10886,223396256,171314972.0,65.41836520504215,1.5,2.75,1.2986563985223525,1.304008945581242,0.056972147315773373,1.579175372751379,1.522203225435606,10.024579013808172,1.030642557540057,6907614765.0,2010-03-25,2010,3,84,3,1.42,117.34,117.42,116.12,2571
2010-03-26 13:30:00,116.87,117.42,116.12,116.58200000000001,103.73377777777776,120.14888888888892,105.82735620000038,111.43245219999996,112.02366120000008,115.19865250000008,113.10291366816551,115.1712113392378,116.30477153846165,117.76911505349754,114.84042802342572,105.82735620000038,111.43245219999996,112.02366120000008,115.19865250000008,116.70733333333334,205808496,172925934.4,64.82981318038219,1.5,2.75,1.2987523700564698,1.1901540200669865,-0.011247218065900013,1.5081442028532308,1.5193914209191308,10.05498282569037,0.9455276694495011,6701806269.0,2010-03-26,2010,4,85,3,1.12,116.77,117.53,116.6886,2572
2010-03-29 13:30:00,117.16991000000002,117.53,116.6886,117.32001000000001,103.70888888888891,120.25111111111113,105.93985620000038,111.56245219999997,112.07146160000009,115.47015300000008,113.26828999490412,115.37585883073898,116.48554153846165,117.8206605523267,115.15042252459656,105.93985620000038,111.56245219999997,112.07146160000009,115.47015300000008,117.17953666666664,134513504,172266128.0,68.17663896133789,1.5,2.75,1.2736986293381511,0.7808470856209179,-0.020170124386410304,1.4941787654361178,1.514348889822528,10.488335369729864,0.7817283738510435,6836319773.0,2010-03-29,2010,0,88,3,0.72,117.11,117.83,116.91,2573
2010-03-30 13:30:00,117.46001000000001,117.83,116.91,117.39998999999999,103.684,120.35333333333334,106.05145615000038,111.68995219999996,112.1466614000001,115.73015250000007,113.43031744608436,115.56863322781145,116.63554076923084,117.90828906748432,115.36279247097737,106.05145615000038,111.68995219999996,112.1466614000001,115.73015250000007,117.37999666666668,145772368,171505128.0,68.52619078724247,1.5,2.75,1.248434441528283,0.8499592385365876,-0.0334073709654259,1.4725896761157458,1.5059970470811717,9.674706354936808,0.25617418820032983,6982092141.0,2010-03-30,2010,1,89,3,0.79,117.37,117.52,116.61,2574
2010-03-31 13:30:00,116.95,117.52,116.61,117.0,103.65911111111109,120.45555555555555,106.17195620000037,111.81075219999997,112.1854614000001,115.96515250000007,113.5703049972183,115.70495387278179,116.7540015384616,117.84001985411324,115.66798322280998,106.17195620000037,111.81075219999997,112.1854614000001,115.96515250000007,117.04333333333334,161078688,172019815.2,64.69870543446149,1.5,2.75,1.2242605528476915,0.9363961228113216,-0.07920926604313516,1.4069854645272528,1.4861947305703882,9.364502167662133,-0.03204955402759123,6821013453.0,2010-03-31,2010,2,90,3,0.78,117.06,118.25,117.10001000000001,2575
2010-04-01 13:30:00,117.8,118.25,117.10001000000001,117.8,103.63422222222222,120.5577777777778,106.30275620000036,111.92025119999997,112.26366140000007,116.22310200000008,113.73617538948423,115.90448207537399,116.93169307692317,117.87942539657244,115.98396075727388,106.30275620000036,111.92025119999997,112.26366140000007,116.22310200000008,117.71667,161215184,173292056.0,68.489558653467,1.5,2.75,1.226099084787142,0.9303091423879234,-0.0662599485494968,1.4033697948835169,1.4696297434330137,10.15018106643572,1.5779943088729829,6982228637.0,2010-04-01,2010,3,91,4,0.98,117.68,118.84,117.92,2576
2010-04-05 13:30:00,118.25,118.84,117.92,118.75998999999999,103.60933333333332,120.66,106.43880615000036,112.03655109999997,112.40486120000007,116.44860150000008,113.9331877271515,116.17643521105269,117.11246153846159,118.42099456112874,115.80392851579448,106.43880615000036,112.03655109999997,112.40486120000007,116.44860150000008,118.50666333333334,105847632,169778500.0,72.32950123019275,1.5,2.75,1.212806293016632,0.6234454421496244,-0.0068041259770521565,1.4611245859616986,1.4679287119387507,8.794088164708423,1.8590303836010045,7088076269.0,2010-04-05,2010,0,95,4,0.78,118.38,119.25,118.28998999999999,2577
2010-04-06 13:30:00,118.42,119.25,118.28998999999999,119.03998999999999,103.58444444444444,120.76222222222223,106.57291115000037,112.13125089999996,112.6014608000001,116.6871010000001,114.13345448294952,116.44915471476195,117.26169076923084,118.92491746529775,115.59846407316395,106.57291115000037,112.13125089999996,112.6014608000001,116.6871010000001,118.85999333333332,110384128,169566150.4,73.34961754940926,1.5,2.75,1.1947494149440152,0.6509797370501607,0.03530443529278071,1.5120592560547266,1.476754820761946,8.58924395165041,1.3882889021378133,7198460397.0,2010-04-06,2010,1,96,4,0.81,118.77,119.3567,117.81,2578
2010-04-07 13:30:00,118.8,119.3567,117.81,118.36,103.55955555555555,120.86444444444444,106.70451120000037,112.21895089999997,112.77326080000007,116.88210050000013,114.29920136597109,116.63113998002272,117.36342076923084,119.11859239174805,115.60824914671363,106.70451120000037,112.21895089999997,112.77326080000007,116.88210050000013,118.5089,184576320,171067132.0,66.899267979755,1.5,2.75,1.2198887424480145,1.0789700969558549,0.0029878838498755837,1.4804896755742902,1.4775017917244146,9.017565700553444,1.3009243409791134,7013884077.0,2010-04-07,2010,2,97,4,1.31,118.58,118.97,117.60001000000001,2579
2010-04-08 13:30:00,117.95,118.97,117.60001000000001,118.77251000000001,103.53466666666668,120.96666666666668,106.85197375000037,112.30517609999997,112.96251100000006,117.07222600000013,114.47462523397222,116.83507998192529,117.57899846153852,119.28435576777471,115.87364115530235,106.85197375000037,112.30517609999997,112.96251100000006,117.07222600000013,118.44750666666664,158704000,169697891.2,68.69763835910486,1.5,2.75,1.230610260844585,0.935214921515772,-0.004568811631026293,1.4717907771856318,1.4763595888166583,8.344940770523605,1.8195629506697724,7172588077.0,2010-04-08,2010,3,98,4,1.16,118.29,119.60001000000001,118.8,2580
2010-04-09 13:30:00,119.02,119.60001000000001,118.8,119.55,103.50977777777777,121.0688888888889,107.00297370000037,112.41037609999997,113.15691100000008,117.27722600000013,114.67365953852234,117.09364379317051,117.80649846153854,119.70310499477337,115.90989192830372,107.00297370000037,112.41037609999997,113.15691100000008,117.27722600000013,119.31667,133006496,168304422.4,71.80672022503214,1.5,2.75,1.2018166707842577,0.7902733279574239,0.02709220957694214,1.5102248507878355,1.4831326412108936,8.486549890940879,2.5458475579420528,7305594573.0,2010-04-09,2010,4,99,4,0.67,119.2,120.05,119.56,2581
2010-04-12 13:30:00,119.7,120.05,119.56,119.74001000000001,103.48488888888888,121.17111111111113,107.15108375000038,112.51157619999996,113.38031100000008,117.49122600000014,114.87233994877636,117.34567867001142,117.98573000000007,120.12361340141807,115.84784659858208,107.15108375000038,112.51157619999996,113.38031100000008,117.49122600000014,119.78333666666668,110278944,165714632.0,72.5249443087582,1.5,2.75,1.151686908585382,0.6654749955936299,0.04412106301758168,1.5382839699828708,1.494162906965289,8.291796590645518,2.062734225815359,7415873517.0,2010-04-12,2010,0,102,4,0.41,119.8,120.03998999999999,119.0,2582
2010-04-13 13:30:00,119.62,120.03998999999999,119.0,119.83,103.46,121.27333333333334,107.28983375000038,112.59777609999992,113.62911100000008,117.70822550000014,115.06675799000082,117.5822807014389,118.21573000000005,120.45215622012421,115.97930377987592,107.28983375000038,112.59777609999992,113.62911100000008,117.70822550000014,119.62333000000001,125125056,164630044.0,72.87735484333732,1.5,2.75,1.1437085579721409,0.7600377972321991,0.044602472975211686,1.5499159981843036,1.505313525209092,8.00897613465922,2.069855372219364,7540998573.0,2010-04-13,2010,1,103,4,0.87,119.52,121.19,120.08,2583
2010-04-14 13:30:00,120.27,121.19,120.08,121.19,103.43511111111113,121.37555555555555,107.43658375000037,112.69628609999994,113.87171100000003,117.94722550000013,115.30688512764785,117.92587301558758,118.56496153846163,121.1108138444108,116.01910923251242,107.43658375000037,112.69628609999994,113.87171100000003,117.94722550000013,120.81999999999998,161609008,164276844.0,77.5615278136716,1.5,2.75,1.1591579466884163,0.9837601214203994,0.11563444279648638,1.6498565787047,1.5342221359082135,9.485285086391151,3.5811965811965787,7702607581.0,2010-04-14,2010,2,104,4,0.92,120.64,121.5654,120.95,2584
2010-04-15 13:30:00,120.99001000000001,121.5654,120.95,121.28998999999999,103.41022222222222,121.4777777777778,107.57953370000037,112.79648599999993,114.08991080000006,118.15672450000015,115.54151669126949,118.24626510934117,118.9271146153847,121.57885212824205,116.27537710252732,107.57953370000037,112.79648599999993,114.08991080000006,118.15672450000015,121.26846333333334,144615248,162634203.2,77.8642178303747,1.5,2.75,1.1203180933535293,0.8892056231379502,0.14648807464354466,1.7173322292126445,1.5708441545690996,8.688109024194144,2.96264006791172,7847222829.0,2010-04-15,2010,3,105,4,0.51,121.26,121.285,118.75,2585
2010-04-16 13:30:00,120.86,121.285,118.75,119.36,103.38533333333334,121.58,107.71658370000036,112.89188589999996,114.28051080000004,118.27284900000015,115.69126113474913,118.35233509892772,119.084036923077,121.5732473659264,116.59482648022758,107.71658370000036,112.89188589999996,114.28051080000004,118.27284900000015,119.79833333333332,366879744,171152737.6,60.81211029704168,1.5,2.75,1.2217232295425633,2.1435809274487467,0.0206588471172966,1.5966677134657203,1.5760088663484235,13.90891412138912,0.5052290758865823,7480343085.0,2010-04-16,2010,4,106,4,2.13,120.02,119.92998999999999,118.47,2586
2010-04-19 13:30:00,119.00998999999999,119.92998999999999,118.47,119.81,103.36044444444444,121.68222222222224,107.85398370000036,112.99568599999995,114.54791080000008,118.46484900000016,115.85278030593544,118.49116032760126,119.26942230769235,121.58204823858142,116.9567963768033,107.85398370000036,112.99568599999995,114.54791080000008,118.46484900000016,119.40333000000001,217947744,170718068.8,62.854722325156146,1.5,2.75,1.2387422845752378,1.2766530545476742,-0.0449416691648763,1.5198317798923284,1.5647734490572047,13.344339137452787,0.6468498527259614,7698290829.0,2010-04-19,2010,0,109,4,1.23,119.2,120.98,119.87100000000001,2587
2010-04-20 13:30:00,120.56,120.98,119.87100000000001,120.88,103.33555555555556,121.78444444444445,108.00933370000037,113.09628589999993,114.83231080000007,118.67922400000015,116.04992617629091,118.71866886782972,119.56788384615393,121.61858188008928,117.51718581221857,108.00933370000037,113.09628589999993,114.83231080000007,118.67922400000015,120.57700000000001,157707936,169379581.6,67.22876275764435,1.5,2.75,1.2338321213912924,0.9310917792466668,-0.02968372587835555,1.5276687917092602,1.5573525175876155,14.111768235062273,2.1290976681311222,7855998765.0,2010-04-20,2010,1,110,4,0.93,120.43,121.23,119.99001000000001,2588
2010-04-21 13:30:00,120.95,121.23,119.99001000000001,120.66,103.31066666666666,121.88666666666668,108.16363370000036,113.19298579999992,115.12771080000006,118.84172400000016,116.23071338506382,118.90355754708405,119.78788384615393,121.63642025562643,117.93934743668143,108.16363370000036,113.19298579999992,115.12771080000006,118.84172400000016,120.62667,192910064,169878006.4,65.5204030078683,1.5,2.75,1.2342719698633433,1.1355799852381596,-0.04680224433158076,1.4988497121731397,1.5456519565047206,13.544106818989125,1.5891640245710053,7663088701.0,2010-04-21,2010,2,111,4,1.03,120.61,121.17,119.12,2589
2010-04-22 13:30:00,119.81,121.17,119.12,121.02,103.28577777777778,121.98888888888894,108.32843370000036,113.28938579999996,115.40371080000006,119.05072400000013,116.41852854643386,119.10512349498079,119.96173076923084,121.81597172599815,118.10748981246351,108.32843370000036,113.28938579999996,115.40371080000006,119.05072400000013,120.43666666666668,239188560,172028268.8,66.99823766610537,1.5,2.75,1.292538257730247,1.3904026452657063,-0.04619540394646182,1.487907701571643,1.5341031055181051,13.526179447423337,1.2296110414052688,7902277261.0,2010-04-22,2010,3,112,4,1.72,120.15,121.86,120.63,2590
2010-04-23 13:30:00,120.94,121.86,120.63,121.8125,103.26088888888887,122.09111111111113,108.49749620000036,113.41181069999996,115.69976100000008,119.30884950000015,116.63005683873057,119.36296887641122,120.17500076923085,122.18716595979271,118.16283557866898,108.49749620000036,113.41181069999996,115.69976100000008,119.30884950000015,121.43416666666668,177335440,169725228.0,70.04230029246222,1.5,2.75,1.2880712393209441,1.044838425552152,-0.006804035343377811,1.5255980613388829,1.532402096682261,13.526486322691506,1.7308249765471058,8079612701.0,2010-04-23,2010,4,113,4,1.02,121.24,122.12,121.23,2591
2010-04-26 13:30:00,121.85001000000001,122.12,121.23,121.35001000000001,103.236,122.12,108.66339625000036,113.52591079999996,115.96416120000008,119.54725000000015,116.81515304113329,119.55221088818158,120.40500153846163,122.20733701059784,118.6026660663254,108.66339625000036,113.52591079999996,115.96416120000008,119.54725000000015,121.56667,143457184,166607662.4,66.20442191549938,1.5,2.75,1.259637579369448,0.8610479370125296,-0.025243258609440652,1.5008480234204598,1.5260912820299004,13.91565204677474,1.2684720020028366,7936155517.0,2010-04-26,2010,0,116,4,0.73,121.68,121.33458999999999,118.25,2592
2010-04-27 13:30:00,120.64998999999999,121.33458999999999,118.25,118.48,103.21111111111112,122.22115942028988,108.81599620000036,113.59771079999994,116.17296140000006,119.60524950000016,116.88044115716728,119.45009556549759,120.38250076923084,122.27103812357042,118.49396341489128,108.81599620000036,113.59771079999994,116.17296140000006,119.60524950000016,119.35486333333334,355853824,177674678.4,48.459458430508654,1.5,2.75,1.3910927522716299,2.0028392745918717,-0.23254772944309646,1.23540662022603,1.4679543496691263,20.108833418134864,-2.236158098853036,7580301693.0,2010-04-27,2010,1,117,4,2.61,119.79,119.67998999999999,118.27,2593
2010-04-28 13:30:00,119.05,119.67998999999999,118.27,119.38,103.1862222222222,122.32231884057973,108.96238615000038,113.67901079999994,116.36576120000004,119.70425000000021,116.97846307257248,119.44341979735495,120.36942384615395,122.28302621103796,118.45582148126991,108.96238615000038,113.67901079999994,116.36576120000004,119.70425000000021,119.10999666666667,300677632,185419941.6,52.73753238519501,1.5,2.75,1.3924425556808,1.6216035309116936,-0.30623878152456285,1.0851558727634227,1.3913946542879856,19.37010230993248,-1.5747301158158291,7880979325.0,2010-04-28,2010,2,118,4,1.19,118.97,121.11,120.07001000000001,2594
2010-04-29 13:30:00,120.10001000000001,121.11,120.07001000000001,120.8575,103.16133333333332,122.42347826086956,109.11362365000038,113.78378579999996,116.57771140000006,119.89712500000022,117.13058216776571,119.57809410236878,120.45538461538472,122.34845593166088,118.56231329910852,109.11362365000038,113.78378579999996,116.57771140000006,119.89712500000022,120.67917,193774880,187054751.2,58.78561600299897,1.5,2.75,1.4165538017036003,1.035925998975641,-0.254767843551889,1.0729348498481244,1.3277026934000131,20.92790132793905,1.2546079088471869,8074754205.0,2010-04-29,2010,3,119,4,0.87,120.59,121.00998999999999,118.78,2595
2010-04-30 13:30:00,120.88,121.00998999999999,118.78,118.8125,103.13644444444445,122.52463768115942,109.24138620000038,113.86181089999997,116.73576140000006,119.94775000000018,117.19653972981413,119.50518037833366,120.37711538461548,122.44335773972088,118.31087302951008,109.24138620000038,113.86181089999997,116.73576140000006,119.94775000000018,119.53416333333332,270000896,192494036.8,49.36879296139449,1.5,2.75,1.4746563872962004,1.402645507821778,-0.35176303997221803,0.8879988934347409,1.239761933406959,21.2146575817275,-0.8325682330356416,7804753309.0,2010-04-30,2010,4,120,4,1.88,119.89,120.67998999999999,119.2,2596
2010-05-03 13:30:00,119.38,120.67998999999999,119.2,120.35001000000001,103.11155555555555,122.62579710144928,109.37238630000036,113.95691099999996,116.91996160000005,120.02725100000019,117.32020523060572,119.58564034230189,120.31250076923084,122.32485411415955,118.30014742430215,109.37238630000036,113.95691099999996,116.91996160000005,120.02725100000019,120.07666666666664,182747808,196339045.6,55.18175518477272,1.5,2.75,1.5027159310607578,0.930776695188336,-0.3073001267639188,0.8556367749520604,1.1629369017159792,22.47816273704901,-0.43844308405029614,7987501117.0,2010-05-03,2010,0,123,5,1.24,119.94,119.03,116.92,2597
2010-05-04 13:30:00,119.00998999999999,119.03,116.92,117.52,103.08666666666666,122.72695652173914,109.48933630000036,114.03601099999996,117.04716160000008,119.95125150000015,117.32804031960156,119.38891269065408,120.02250153846165,122.43467391402449,117.6103291628988,109.48933630000036,114.03601099999996,117.04716160000008,119.95125150000015,117.82333333333332,360353280,208837503.2,44.95166031363453,1.5,2.75,1.6403797931278459,1.7255199591947623,-0.4545293542488471,0.5947752089049203,1.0493045631537674,25.58950240379844,-2.6023537212000667,7627147837.0,2010-05-04,2010,1,124,5,1.8,117.98,117.8,115.97,2598
2010-05-05 13:30:00,116.56,117.8,115.97,116.82001000000001,103.06177777777779,122.828115942029,109.59778135000036,114.10400109999992,117.18736180000008,119.87425200000015,117.30811756197014,119.14425529154416,119.82711769230778,122.77440543377216,116.87982995084343,109.59778135000036,114.10400109999992,117.18736180000008,119.87425200000015,116.86333666666668,328973312,216057352.8,42.83629861068408,1.5,2.75,1.6539240936187143,1.5226203030661216,-0.5772206378117964,0.3277787658890219,0.9049994037008184,25.641057425595466,-3.4704924805817217,7298174525.0,2010-05-05,2010,2,125,5,1.58,116.88,117.0,105.0,2599
2010-05-06 13:30:00,116.25998999999999,117.0,105.0,112.94200000000001,103.03688888888887,122.92927536231883,109.68464130000037,114.12702109999992,117.22980160000006,119.58272650000019,117.13689726542229,118.55356431139714,119.29881000000007,124.00583508504249,114.5917849149577,109.68464130000037,114.12702109999992,117.22980160000006,119.58272650000019,111.64733333333336,647356416,240489973.6,33.44590790926709,1.5,2.75,2.3929295155030914,2.6918228910313293,-0.879598543053832,-0.19449877511647173,0.6850997679373603,30.56502413235005,-7.282093381221143,6650818109.0,2010-05-06,2010,3,126,5,11.43,111.0,113.77,109.41,2600
2010-05-07 13:30:00,112.64,113.77,109.41,111.25998999999999,103.012,123.0304347826087,109.76319125000036,114.12852099999992,117.24160140000004,119.16822600000015,116.90643031383709,117.85893818650213,118.55880923076931,124.81023189021269,112.30738657132594,109.76319125000036,114.12852099999992,117.24160140000004,119.16822600000015,111.47999666666666,637558784,265717588.0,30.339331342614326,1.5,2.75,2.5334345501100133,2.3993849590415515,-1.1366010194596934,-0.7356515063872564,0.4009495130724369,29.586157402903304,-8.314807720246579,6013259325.0,2010-05-07,2010,4,127,5,3.99,111.59,116.64998999999999,114.91,2601
2010-05-10 13:30:00,115.81,116.64998999999999,114.91,116.16,102.98711111111109,123.13159420289855,109.85568625000036,114.17142099999992,117.35000120000004,118.98922550000015,116.87715853682388,117.69713454969242,118.21265538461547,124.45870072761086,111.96661004162009,109.85568625000036,114.17142099999992,117.35000120000004,118.98922550000015,115.90666333333334,396159488,280011615.2,46.05809624292593,1.5,2.75,2.737474939387869,1.414796624479455,-0.9290508784142874,-0.7603640849454223,0.16868679346886506,42.1664077465568,-1.9581363943281629,6409418813.0,2010-05-10,2010,0,130,5,1.51,115.78,117.36,114.91,2602
2010-05-11 13:30:00,115.07001000000001,117.36,114.91,115.83,102.96222222222221,123.23275362318842,109.94453625000034,114.21622089999993,117.42880120000004,118.78922550000016,116.83609349616412,117.51931221162648,117.81342461538469,123.95324102674694,111.67360820402244,109.94453625000034,114.21622089999993,117.42880120000004,118.78922550000016,116.03333333333332,317849600,289647842.4,45.31646425429896,1.5,2.75,2.7169410151458786,1.0973656746976688,-0.7728578030475888,-0.7973854603406211,-0.02452765729303216,40.285487583394925,-2.973697436756573,6091569213.0,2010-05-11,2010,1,131,5,2.13,116.14,117.62,116.09,2603
2010-05-12 13:30:00,116.28998999999999,117.62,116.09,117.45,102.93733333333331,123.33391304347826,110.04003620000036,114.27552089999992,117.53380120000004,118.60222550000016,116.86016826102043,117.51271104861442,117.47784769230778,123.1670247932548,111.78867059136076,110.04003620000036,114.27552089999992,117.53380120000004,118.60222550000016,117.05333333333334,235607008,293347742.4,49.606334695184266,1.5,2.75,2.6507309426354597,0.8031662561041071,-0.5308362968934968,-0.6880730284099029,-0.15723673151640633,41.00499250307304,-2.8194361127774434,6327176221.0,2010-05-12,2010,2,132,5,1.32,116.86,117.67998999999999,115.89,2604
2010-05-13 13:30:00,117.13,117.67998999999999,115.89,115.99001000000001,102.91244444444445,123.43507246376812,110.13053625000038,114.3336210999999,117.60760140000004,118.33722650000013,116.82604440764707,117.36769190112732,117.06554000000007,122.33378866856873,111.79729133143145,110.13053625000038,114.3336210999999,117.60760140000004,118.33722650000013,116.52,234456064,297839783.2,46.09658690665547,1.5,2.75,2.5892494467329263,0.7871885396940486,-0.4430542434530589,-0.7110545358327299,-0.2680002923796711,40.38948348802924,-2.3755833771699124,6092720157.0,2010-05-13,2010,3,133,5,1.54,116.78,115.33,112.87,2605
2010-05-14 13:30:00,115.12,115.33,112.87,113.89,102.88755555555555,123.53623188405798,110.21172630000038,114.37042099999991,117.63258120000003,118.06372650000013,116.71090541126877,117.036483148639,116.71246307692316,122.16617535483076,111.2587507990156,110.21172630000038,114.37042099999991,117.63258120000003,118.06372650000013,114.03,345602048,296775898.4,41.543574852830346,1.5,2.75,2.627160914823431,1.1645219502770785,-0.4963829421081956,-0.8884789700149156,-0.39209602790672,40.53625071884992,-5.367685470071833,5747118109.0,2010-05-14,2010,4,134,5,2.18,114.1,114.52,111.77,2606
2010-05-17 13:30:00,114.2,114.52,111.77,113.95,102.86266666666668,123.63739130434784,110.2881263000004,114.39662099999993,117.62658120000003,117.77072650000014,116.60263461082684,116.74253237257817,116.29477076923088,121.69881646219034,110.8907250762714,110.2881263000004,114.39662099999993,117.62658120000003,117.77072650000014,113.41333333333336,325944064,302175714.4,41.720691340737524,1.5,2.75,2.6359351351931863,1.078657378695023,-0.4963833987464774,-1.0125752763398168,-0.5161918775933394,39.234025776163655,-3.0377808032675238,6073062173.0,2010-05-17,2010,0,137,5,2.46,113.14,115.22,112.03,2607
2010-05-18 13:30:00,114.88,115.22,112.03,112.39998999999999,102.83777777777777,123.73855072463768,110.35607625000038,114.40332089999993,117.58918100000002,117.34672600000009,116.4378250182454,116.3289569085231,115.64419307692316,120.72085487794321,110.56753127590314,110.35607625000038,114.40332089999993,117.58918100000002,117.34672600000009,113.21666333333332,360595968,312320116.0,38.47730062980703,1.5,2.75,2.6755111969651013,1.1545717023235225,-0.5645744412398841,-1.2219099291431943,-0.6573354879033104,37.91653901384836,-3.7836154953248107,5712466205.0,2010-05-18,2010,1,138,5,2.85,113.62,112.77,110.36,2608
2010-05-19 13:30:00,111.77,112.77,110.36,111.75998999999999,102.81288888888888,123.83971014492754,110.4126762000004,114.40142079999993,117.53518060000002,116.90172550000014,116.25438050772598,115.89381720294945,115.10169230769242,120.2152784818046,109.98810613358015,110.4126762000004,114.40142079999993,117.53518060000002,116.90172550000014,111.62999666666668,394759424,322412584.0,37.191648830425976,1.5,2.75,2.6565461114675943,1.2243921099556092,-0.612569843144297,-1.4230477918336817,-0.8104779486893847,37.912979473811305,-1.0465637229728455,5317706781.0,2010-05-19,2010,2,139,5,2.18,111.56,109.89,107.47,2609
2010-05-20 13:30:00,109.38,109.89,107.47,107.53998999999999,102.788,123.9408695652174,110.4468761500004,114.3520206999999,117.3865804,116.22772500000013,115.91263970350144,115.09821461219238,114.11630615384622,119.71837083977941,108.51424146791308,110.4468761500004,114.3520206999999,117.3865804,116.22772500000013,108.29999666666669,530423552,336974333.6,30.05953609054141,1.5,2.75,2.7732206749341946,1.574077011543647,-0.8724620763901929,-1.901055544177126,-1.028593467786933,39.31978247423055,-3.3435199841380525,4787283229.0,2010-05-20,2010,3,140,5,2.25,108.68,109.38,105.36121000000001,2610
2010-05-21 13:30:00,105.91,109.38,105.36121000000001,109.11501000000001,102.76311111111109,124.04202898550726,110.4904012000004,114.3159707999999,117.25988060000005,115.59285050000014,115.64606598963863,114.52838560150741,113.46976846153856,119.28721852424191,107.6523183988352,110.4904012000004,114.3159707999999,117.25988060000005,115.59285050000014,107.95207333333332,500909312,353153027.2,35.06463172755612,1.5,2.75,2.8621899124388945,1.4183916699553638,-0.8797300023491634,-2.1282559707233872,-1.2485259683742238,40.18552365298336,-6.064901859504131,5288192541.0,2010-05-21,2010,4,141,5,3.81,107.37,109.39,107.61,2611
2010-05-24 13:30:00,108.52,109.39,107.61,107.71001000000001,102.73822222222222,124.1431884057971,110.5295012500004,114.26745089999993,117.10488060000004,114.91085050000014,115.33484810769205,113.87901649660192,112.76899923076931,118.98450214330296,106.5534963182357,110.5295012500004,114.26745089999993,117.10488060000004,114.91085050000014,108.23666999999999,269822976,359471316.8,32.809079672006334,1.5,2.75,2.784890632978973,0.7506105866858971,-0.9164497418618456,-2.394088145701531,-1.4776384038396853,28.35173077142835,-7.010265043598379,5018369565.0,2010-05-24,2010,0,144,5,1.65,108.5,107.87,104.38,2612
2010-05-25 13:30:00,105.11,107.87,104.38,107.81799,104.38,124.24434782608697,110.56258120000038,114.2204307999999,116.95144020000002,114.37775000000009,115.04006935837076,113.30177587787794,112.37484461538472,119.1234845792772,105.62620465149223,110.56258120000038,114.2204307999999,116.95144020000002,114.37775000000009,106.68933,396505088,361503880.0,33.16490741737776,1.5,2.75,2.8352555877661905,1.096821112957349,-0.871060774768528,-2.5664643723003455,-1.6954035975318171,28.668842445053908,-8.200945083014055,5414874653.0,2010-05-25,2010,1,145,5,3.34,106.12,109.47,106.85001000000001,2613
2010-05-26 13:30:00,108.48,109.47,106.85001000000001,107.17,104.37733333333333,124.3455072463768,110.59348115000036,114.17773079999986,116.76664020000004,113.76725000000009,114.73143918745428,112.71779722284195,112.06023000000009,119.34729325680965,104.77316674319056,110.59348115000036,114.17773079999986,116.76664020000004,113.76725000000009,107.83000333333332,349719296,363955963.2,32.06741180660295,1.5,2.75,2.81987947435432,0.9608835446057064,-0.8228459413543572,-2.723961024224764,-1.9011150828704064,25.41764919783716,-7.604111767901387,5065155357.0,2010-05-26,2010,2,146,5,2.45,108.16,110.8,108.78011000000001,2614
2010-05-27 13:30:00,109.19,110.8,108.78011000000001,110.75998999999999,104.37466666666666,124.44666666666667,110.64863110000036,114.1520306999999,116.6398398,113.26237450000009,114.57569608206393,112.53133939209509,111.64484461538471,118.55567491677174,104.73401431399769,110.64863110000036,114.1520306999999,116.6398398,113.26237450000009,110.11336666666666,300870400,369310739.2,43.268449838880464,1.5,2.75,2.877745226186154,0.8146808854022082,-0.5030539956642643,-2.5299325774507366,-2.0268785817864723,34.838792953763274,-2.7482746509790137,5366025757.0,2010-05-27,2010,3,147,5,1.86,109.79,110.72399999999999,108.85001000000001,2615
2010-05-28 13:30:00,110.64,110.72399999999999,108.85001000000001,109.369,104.37200000000001,124.54782608695652,110.69147610000036,114.10942069999993,116.4864696,112.79019950000013,114.37151192198296,112.23016421189556,111.14784461538471,117.70343990836378,104.59224932240565,110.69147610000036,114.10942069999993,116.4864696,112.79019950000013,109.64767,297933312,370707360.0,40.48316256193397,1.5,2.75,2.8086191386014288,0.8036886885655575,-0.34653474485583396,-2.460047012856265,-2.113512268000431,34.1761083324225,-4.020184291355862,5068092445.0,2010-05-28,2010,4,148,5,1.72,109.79,109.95,107.37,2616
2010-06-01 13:30:00,108.35001000000001,109.95,107.37,107.53,104.36933333333332,124.64898550724638,110.72127605000036,114.04762059999992,116.3176696,112.14919900000014,114.10321733680716,111.78252952504835,110.38476769230778,116.08155114209299,104.68798424252256,110.72127605000036,114.04762059999992,116.3176696,112.14919900000014,108.28333333333336,277909248,375465432.0,37.08431759241924,1.5,2.75,2.7922892001298982,0.7401726612211801,-0.32835778263131754,-2.523959496289578,-2.1956017136582604,34.785157597335264,-4.332731702200331,4790183197.0,2010-06-01,2010,1,152,6,2.4,108.66,110.34,107.50908999999999,2617
2010-06-02 13:30:00,108.08,110.34,107.50908999999999,110.33,104.36666666666666,124.75014492753624,110.76897610000036,114.00902059999993,116.1924196,111.78969900000013,113.95524802948141,111.64419337980569,109.94938230769242,114.64285840119958,105.25590621418523,110.76897610000036,114.00902059999993,116.1924196,111.78969900000013,109.39303000000001,240243632,369459949.6,44.697445111034355,1.5,2.75,2.795047828692048,0.6502562246871479,-0.10104541689480806,-2.3219084847767704,-2.2208630678819623,38.637605441518886,-1.279518725798028,5030426829.0,2010-06-02,2010,2,153,6,2.63,108.92,111.06,109.58,2618
2010-06-03 13:30:00,110.64998999999999,111.06,109.58,110.71001000000001,104.364,124.85130434782609,110.83097615000037,113.97042059999993,116.05841979999998,111.48419900000009,113.82798379303115,111.5552235341099,109.70476769230775,113.85077773495584,105.55875764965971,110.83097615000037,113.97042059999993,116.05841979999998,111.48419900000009,110.45000333333331,226618256,364342196.8,45.65852022230465,1.5,2.75,2.7011158409283307,0.6219928901740649,0.09122507299157244,-2.106831726642497,-2.1980567996340694,38.660539902269335,2.947759247513408,5257045085.0,2010-06-03,2010,3,154,6,1.35,110.32,109.33,106.465,2619
2010-06-04 13:30:00,108.61,109.33,106.465,106.82001000000001,104.36133333333332,124.95246376811596,110.86962620000037,113.89132069999992,115.85802,111.1780995000001,113.55316129134366,111.10425081657564,109.156306923077,112.7620654557455,105.55054839040844,110.86962620000037,113.89132069999992,115.85802,111.1780995000001,107.53833666666668,398475520,351898152.0,38.317611495476854,1.5,2.75,2.8113939951477347,1.1323603654502852,-0.02125712589507112,-2.224628207002908,-2.203371081107837,37.715607324193584,-2.1032853316880984,4858569565.0,2010-06-04,2010,4,155,6,2.69,107.9,107.61,105.41,2620
2010-06-07 13:30:00,107.2,107.61,105.41,105.49001000000001,104.35866666666666,125.0536231884058,110.89727620000036,113.80962079999992,115.6348204,110.8896005000001,113.23695927991841,110.56956121499701,108.62477000000008,112.19827081114887,105.05126918885126,110.89727620000036,113.80962079999992,115.6348204,110.8896005000001,106.17000333333333,264609056,333250665.6,36.17602527554665,1.5,2.75,2.7677229954943257,0.7940240885148288,-0.15543423466728698,-2.397663874441946,-2.242229639774659,36.913188176146974,-2.0610897724361914,4593960509.0,2010-06-07,2010,0,158,6,2.09,106.51,106.83,104.64999,2621
2010-06-08 13:30:00,105.57001000000001,106.83,104.64999,106.62,104.35600000000001,125.15478260869564,110.92542615000036,113.72962079999992,115.4355804,110.4126005000001,112.97747068070593,110.19341252785442,108.22938615384622,111.44757630182613,105.01119600586632,110.92542615000036,113.72962079999992,115.4355804,110.4126005000001,106.03332999999998,357774336,331331408.0,39.281076979915035,1.5,2.75,2.7257434958161593,1.0798080935327448,-0.13883042601978926,-2.4157676722993955,-2.2769372462796063,37.15647774290215,-1.1111225501421331,4951734845.0,2010-06-08,2010,1,159,6,2.08,105.74,108.28,105.60001000000001,2622
2010-06-09 13:30:00,107.24001000000001,108.28,105.60001000000001,106.05,104.35333333333332,125.25594202898552,110.9408261500003,113.64082089999992,115.21018020000001,109.92360050000009,112.7058051638155,109.7988018109159,108.1147715384616,111.52349847261095,104.70604460431223,110.9408261500003,113.64082089999992,115.21018020000001,109.92360050000009,106.64333666666666,268023248,328840090.4,38.26967295163422,1.5,2.75,2.722475388972148,0.8150564843659343,-0.13676342622118964,-2.4478915290560934,-2.311128102834904,37.209187434808356,-1.0450685826257389,4683711597.0,2010-06-09,2010,2,160,6,2.54,106.94,109.28,106.0426,2623
2010-06-10 13:30:00,107.86,109.28,106.0426,109.14998999999999,104.35066666666664,125.35710144927536,110.97177605000036,113.59592079999993,115.0451802,109.50860000000013,112.56636143190114,109.73701020987629,108.11746230769235,111.5293969685676,104.70552764681713,110.97177605000036,113.59592079999993,115.0451802,109.50860000000013,108.15753,317890560,332954268.0,46.35893339053921,1.5,2.75,2.7592557183312807,0.9547574263261884,0.09060572741764528,-2.1978709435628474,-2.2884766709804927,40.89021907991457,-1.4535934862399311,5001602157.0,2010-06-10,2010,3,161,6,3.05,107.66,109.75,108.12,2624
2010-06-11 13:30:00,108.19,109.75,108.12,109.67998999999999,104.348,125.45826086956522,111.00437600000036,113.54212069999993,114.89878,109.19309900000013,112.45317039535604,109.73157971369758,108.2689992307693,111.76894075209142,104.76905770944715,111.00437600000036,113.54212069999993,114.89878,109.19309900000013,109.18332999999998,214128128,331937871.2,47.622662298236094,1.5,2.75,2.678594595593332,0.6450849588987785,0.2830535728968293,-1.934659704859456,-2.2177132777562854,35.95884896860022,0.28434931287659565,5215730285.0,2010-06-11,2010,4,162,6,1.51,108.94,111.12,109.39998999999999,2625
2010-06-14 13:30:00,110.52,111.12,109.39998999999999,109.509,104.34533333333331,125.55942028985508,111.03607100000036,113.49831069999992,114.73296,108.97404900000014,112.33771273279305,109.71038164572641,108.39907692307699,111.94765841753731,104.8504954286167,111.03607100000036,113.49831069999992,114.73296,108.97404900000014,110.00966333333332,207196000,325017568.8,47.23602002166461,1.5,2.75,2.6101242673366656,0.6374916924183207,0.3981443043866961,-1.7200328972729153,-2.1181772016596114,35.20047605215914,1.8404166279177896,5008534285.0,2010-06-14,2010,0,165,6,1.57,110.26,112.10001000000001,110.09,2626
2010-06-15 13:30:00,110.28,112.10001000000001,110.09,112.0,104.34266666666666,125.66057971014492,111.07907105000037,113.50131069999992,114.5977602,108.87654900000014,112.32446909621294,109.92844053660959,108.77061538461544,112.71589048189928,104.8253402873316,111.07907105000037,113.50131069999992,114.5977602,108.87654900000014,111.39667,238268624,320633796.8,53.19747966095994,1.5,2.75,2.6087589625269034,0.7431176200948758,0.6276903806612428,-1.333564225833058,-1.9612546064943008,35.472210115313594,1.5136408954953338,5246802909.0,2010-06-15,2010,1,166,6,1.83,111.1,112.42,111.2,2627
2010-06-16 13:30:00,111.42,112.42,111.2,111.96001000000001,104.34,125.7617391304348,111.12197110000034,113.52881069999992,114.4561606,108.85455000000013,112.31017658263596,110.1219233426468,108.8629246153847,113.03944283430815,104.68640639646118,111.12197110000034,113.52881069999992,114.4561606,108.85455000000013,111.86000333333334,216373936,313422695.2,53.09376957796791,1.5,2.75,2.5095618937749817,0.6903582264900389,0.7539891627609965,-1.0187681530430552,-1.7727573158040515,32.70825924630813,1.1290758622458799,5030428973.0,2010-06-16,2010,2,167,6,1.1,111.81,112.33,111.05,2628
2010-06-17 13:30:00,112.28,112.33,111.05,112.14,104.33733333333332,125.86289855072464,111.17037105000034,113.55251069999993,114.3317606,108.87355050000014,112.30350299116004,110.31412111953756,109.07607846153853,113.60235051839004,104.54980640468702,111.17037105000034,113.55251069999993,114.3317606,108.87355050000014,111.83999999999996,263185744,306844011.2,53.532863565547856,1.5,2.75,2.421736044219626,0.8577183663149819,0.8212738661163215,-0.7461649831586499,-1.5674388492749711,32.684793527178556,4.980330932378687,5293614717.0,2010-06-17,2010,3,168,6,1.15,111.69,112.13,111.37,2629
2010-06-18 13:30:00,111.83,112.13,111.37,111.729,104.33466666666666,125.9640579710145,111.2280160500003,113.5767006999999,114.19089040000001,109.08300100000014,112.28097346209495,110.44887148910541,109.39907846153855,114.03587304271434,104.76228388036272,111.2280160500003,113.5767006999999,114.19089040000001,109.08300100000014,111.743,174006560,289023161.6,52.32826749469832,1.5,2.75,2.303754898203938,0.602050572821635,0.8084550624676297,-0.5568700211904343,-1.365325083658064,23.206762341643387,5.914294633207449,5119608157.0,2010-06-18,2010,4,169,6,0.68,111.75,113.2,110.78998999999999,2630
2010-06-21 13:30:00,113.12,113.2,110.78998999999999,111.41,104.33200000000001,113.2,111.2859660000003,113.5925006999999,114.02809040000001,109.1977505000001,112.24681764005202,110.54040753776205,109.48215538461548,114.22028307088915,104.7440276983418,111.2859660000003,113.5925006999999,114.02809040000001,109.1977505000001,111.79999666666669,213140624,274634727.2,51.36222039343316,1.5,2.75,2.311344548332229,0.776087664415369,0.7501295078111867,-0.4276631988940807,-1.1777927067052674,21.192259460748847,4.492590508347393,4906467533.0,2010-06-21,2010,0,172,6,2.18,111.99,111.89998999999999,109.41,2631
2010-06-22 13:30:00,111.41,111.89998999999999,109.41,109.57001000000001,104.32933333333332,112.97128205128206,111.33056610000031,113.60250069999992,113.82469040000001,109.2907505000001,112.14184479142251,110.44798872464183,109.39446307692316,114.08035508307636,104.70857107076996,111.33056610000031,113.60250069999992,113.82469040000001,109.2907505000001,110.29333333333334,239355312,273111344.0,46.07817348793511,1.5,2.75,2.324104937737069,0.8764019410339836,0.5675629998149294,-0.4683389569366057,-1.035901956751535,24.30081443223667,3.3191984912776986,4667112221.0,2010-06-22,2010,1,173,6,2.28,110.65,110.03,108.48,2632
2010-06-23 13:30:00,109.64,110.03,108.48,109.23,104.32666666666668,112.74256410256409,111.36641610000031,113.62090069999992,113.6126904,109.3613510000001,112.02765479960205,110.3319897984855,109.57984692307699,114.02834239549082,105.1313514506632,111.36641610000031,113.62090069999992,113.6126904,109.3613510000001,109.24666666666668,254698752,266021027.2,45.15373615505334,1.5,2.75,2.268811727898707,0.957438420115987,0.41112673572898,-0.5219935370903102,-0.93312027281929,24.060223190462235,0.07330280103553052,4412413469.0,2010-06-23,2010,2,174,6,1.43,109.26,108.83,107.14,2633
2010-06-24 13:30:00,108.69,108.83,107.14,107.42,104.324,112.51384615384615,111.3888161000003,113.60450069999992,113.33729040000001,109.3738510000001,111.8469624545196,110.05465743672495,109.72830769230778,113.7270097421098,105.72960564250576,111.3888161000003,113.60450069999992,113.33729040000001,109.3738510000001,107.79666666666668,268691968,261969660.8,40.49608625283891,1.5,2.75,2.256039461620228,1.0256606325307729,0.18452068113268366,-0.7024694214034355,-0.8869901025361192,20.008585638022197,-2.060530822440813,4143721501.0,2010-06-24,2010,3,175,6,1.58,107.98,108.42,106.77,2634
2010-06-25 13:30:00,107.74001000000001,108.42,106.77,107.86748999999999,104.32133333333331,112.28512820512822,111.40950355000031,113.57937559999992,113.06884039999998,109.22922600000014,111.6909047112051,109.84635577608448,109.82426846153857,113.57199041345925,106.0765465096179,111.40950355000031,113.57937559999992,113.06884039999998,109.22922600000014,107.68583,238726496,258862465.6,42.08661507241744,1.5,2.75,2.2127509286473552,0.9222136374490284,0.06945980302467814,-0.8001653487552716,-0.8696251517799497,19.93160366178036,-1.4989726871763935,4382447997.0,2010-06-25,2010,4,176,6,1.55,107.6,108.32001000000001,107.14,2635
2010-06-28 13:30:00,108.03,108.32001000000001,107.14,107.53,104.31866666666666,112.05641025641027,111.4232036000003,113.55637559999994,112.8322404,109.13727600000013,111.52773197743237,109.62575046407645,109.9381146153847,113.2892424388573,106.58698679191211,111.4232036000003,113.55637559999994,112.8322404,109.13727600000013,107.66333666666668,169333248,252432462.4,41.19233272984572,1.5,2.75,2.1389837194582584,0.6708061490589017,-0.019908940775081763,-0.8945113277488019,-0.8746023869737202,19.948939641762085,-3.991071428571428,4213114749.0,2010-06-28,2010,0,179,6,1.1,107.73,107.5114,103.55,2636
2010-06-29 13:30:00,106.02,107.5114,103.55,104.21001,104.316,111.82769230769232,111.42040365000031,113.53407569999996,112.52024059999998,108.97127650000007,111.24076248812128,109.10996565797392,109.55811615384627,114.0921089523671,105.02412335532541,111.42040365000031,113.53407569999996,112.52024059999998,108.97127650000007,105.09047,373760512,257225025.6,33.623425752981056,1.5,2.75,2.270484882354097,1.4530487891999262,-0.27878030113796504,-1.2230777633961765,-0.9442974622582114,19.868372932395946,-6.922114422819363,3839354237.0,2010-06-29,2010,1,180,6,3.83,105.53,104.88,102.88,2637
2010-06-30 13:30:00,103.92,104.88,102.88,103.22,104.31333333333332,111.59897435897436,111.41010365000031,113.49967569999994,112.16704059999998,108.61577650000008,110.92622278270477,108.5490165476907,109.06119384615394,114.71144352810215,103.41094416420572,111.41010365000031,113.49967569999994,112.16704059999998,108.61577650000008,103.66,284101632,259417925.6,31.749953099729094,1.5,2.75,2.2511645336145194,1.0951503499340294,-0.4809928762367417,-1.5455385575541385,-1.0645456813173968,19.404297827455014,-7.954342785803464,3555252605.0,2010-06-30,2010,2,181,6,1.94,103.88,103.49001,101.13,2638
2010-07-01 13:30:00,103.14999,103.49001,101.13,102.75999,101.13,111.37025641025643,111.3953036000003,113.46837559999994,111.80904039999996,108.21827550000008,110.6059783598536,107.99768068600584,108.5420392307693,115.09966907090578,101.98440939063288,111.3953036000003,113.46837559999994,111.80904039999996,108.21827550000008,102.46,382924800,267233252.8,30.888725841266837,1.5,2.75,2.2589392097849115,1.432923470368355,-0.6021728631847745,-1.817261760298365,-1.2150888971135905,18.58730403577629,-8.027468249066937,3172327805.0,2010-07-01,2010,3,182,7,2.33,102.31,103.42,101.62,2639
2010-07-02 13:30:00,103.11,103.42,101.62,102.2,101.005,111.14153846153845,111.36970355000031,113.41817559999996,111.43264039999997,107.9872750000001,110.27633214966326,107.44552062067196,107.78819307692318,114.81855429438907,100.75783185945728,111.36970355000031,113.41817559999996,111.43264039999997,107.9872750000001,102.41333333333334,233385120,258978732.8,29.82801569242254,1.5,2.75,2.2261578376574174,0.901174847357968,-0.6712187548520191,-2.054112340678614,-1.3828935858265952,18.436851855060922,-8.266762409119464,2938942685.0,2010-07-02,2010,4,183,7,1.77,102.52,104.37,101.88,2640
2010-07-06 13:30:00,103.64,104.37,101.88,102.87,100.88,110.91282051282052,111.34825355000031,113.37677569999997,111.05379039999997,107.85627450000008,109.98588775163724,107.00975675203655,107.08896153846165,114.12869440667671,100.04922867024652,111.34825355000031,113.37677569999997,111.05379039999997,107.85627450000008,103.04,256936432,258595101.6,32.80130247327244,1.5,2.75,2.2450037063961736,0.9935858429268872,-0.6239435742334183,-2.1628230536183684,-1.5388794793849496,20.258996895975088,-6.114821017174308,3195879117.0,2010-07-06,2010,1,187,7,2.44,103.12,106.24001000000001,103.02,2641
2010-07-07 13:30:00,103.13,106.24001000000001,103.02,106.1075,100.755,110.68410256410256,111.34519105000028,113.35655069999996,110.74894019999996,107.83064950000008,109.83379411431814,106.92382753755686,106.62492307692317,113.03918462621219,100.21066152763416,111.34519105000028,113.35655069999996,110.74894019999996,107.83064950000008,105.12250333333333,253769680,253394868.8,44.94130125728598,1.5,2.75,2.3253612987964467,1.0014791586024412,-0.3409648966379304,-1.965085600182363,-1.6241207035444325,29.226285536345106,-2.858646891879522,3449648797.0,2010-07-07,2010,2,188,7,3.13,104.63,107.28,105.91,2642
2010-07-08 13:30:00,107.0,107.28,105.91,107.16,100.63,110.45538461538462,111.34874105000029,113.34775079999996,110.52254019999997,107.88614950000007,109.72893944316841,106.94632015302764,106.27346153846165,111.99367723588527,100.55324584103798,111.34874105000029,113.34775079999996,110.52254019999997,107.88614950000007,106.78333333333336,210842064,250535809.6,48.216560577672006,1.5,2.75,2.257121206025272,0.8415645824707687,-0.06375051082457239,-1.7038088420751478,-1.6400583312505754,30.174227390903248,-0.2420405883448195,3660490861.0,2010-07-08,2010,3,189,7,1.29,106.6,107.97,106.92998999999999,2643
2010-07-09 13:30:00,107.13,107.97,106.92998999999999,107.96001000000001,100.505,110.22666666666667,111.35319105000029,113.3299508,110.29414039999996,107.82665050000007,109.65956966108335,107.04286204321548,106.00807769230778,111.02765985427084,100.98849553034472,111.35319105000029,113.3299508,110.29414039999996,107.82665050000007,107.62,144999872,241891275.2,50.621032696803255,1.5,2.75,2.170184691309181,0.5994423398698921,0.17935087076549805,-1.4158697427937028,-1.5952206135592009,29.00363169825012,0.08577190402779676,3805490733.0,2010-07-09,2010,4,190,7,0.97,107.45,108.24001000000001,107.14998999999999,2644
2010-07-12 13:30:00,107.60001000000001,108.24001000000001,107.14998999999999,108.03,100.38,109.99794871794872,111.36244110000028,113.30765089999998,110.03759039999996,107.74415100000007,109.59566496849186,107.13687518195688,105.88961538461548,110.63241693993182,101.14681382929916,111.36244110000028,113.30765089999998,110.03759039999996,107.74415100000007,107.80666666666666,131283568,237749047.2,50.83611284518231,1.5,2.75,2.093030070501382,0.552193876468246,0.3413301582045916,-1.1685579158034614,-1.5098880740080531,28.91178233759189,0.4649865153910537,3936774301.0,2010-07-12,2010,0,193,7,1.02,107.7,110.09,108.92998999999999,2645
2010-07-13 13:30:00,109.14998999999999,110.09,108.92998999999999,109.66,100.255,109.76923076923076,111.38569115000028,113.29515090000001,109.85454039999996,107.75170100000008,109.59818791090395,107.37717278367526,105.92269230769242,110.76320878108686,101.08217583429794,111.38569115000028,113.29515090000001,109.85454039999996,107.75170100000008,109.55999666666668,213025872,238040540.8,55.67799301015507,1.5,2.75,2.090670779751284,0.8949142498335309,0.5427506999779721,-0.8314496990355877,-1.3742003990135598,30.003430179524837,5.229814295191028,4149800173.0,2010-07-13,2010,1,194,7,1.06,109.51,110.08,108.86,2646
2010-07-14 13:30:00,109.31,110.08,108.86,109.65100000000001,100.13,109.54051282051282,111.41169615000028,113.2802609,109.64056019999994,107.63425100000006,109.60025897322143,107.59372775665855,106.0943076923078,111.28082640379196,100.90778898082363,111.41169615000028,113.2802609,109.64056019999994,107.63425100000006,109.53033333333336,184426752,235348447.2,55.64540658407069,1.5,2.75,2.0284800097690487,0.783632754726754,0.6524992686030258,-0.5585763132597776,-1.2110755818628034,21.464150552847926,6.230381708971128,3965373421.0,2010-07-14,2010,2,195,7,1.12,109.47,110.06,108.17,2647
2010-07-15 13:30:00,109.61,110.06,108.17,109.67998999999999,100.005,109.31179487179487,111.42849605000029,113.2654608,109.48375999999992,107.52025000000008,109.60338568015392,107.79241939888156,106.23373076923086,111.69365922490131,100.77380231356041,111.42849605000029,113.2654608,109.48375999999992,107.52025000000008,109.30333,232337872,236146644.0,55.73527380902054,1.5,2.75,2.018588580499831,0.983871157618484,0.6999736743499647,-0.3361084889253476,-1.0360821632753123,19.68547953678425,6.734138452134924,4197711293.0,2010-07-15,2010,3,196,7,1.75,109.12,109.2059,106.45,2648
2010-07-16 13:30:00,109.09,109.2059,106.45,106.66,99.88,109.08307692307692,111.43179605000029,113.2339608,109.28055979999992,107.24625000000007,109.48795879073612,107.68456993232141,106.1668076923078,111.5826911523058,100.7509242323098,111.43179605000029,113.2339608,109.28055979999992,107.24625000000007,107.43863333333331,282693376,237122025.6,45.41281565368704,1.5,2.75,2.105117253321272,1.1921852273515667,0.5097529922382039,-0.3988909229775573,-0.9086439152157612,27.361197062054075,4.3639921722113435,3915017917.0,2010-07-16,2010,4,197,7,2.59,107.83,107.63,106.22,2649
2010-07-19 13:30:00,107.05,107.63,106.22,107.28998999999999,99.755,108.85435897435896,111.44029600000029,113.1986606,109.16751959999992,107.0242995000001,109.40176393619744,107.64699089114794,106.40372923076931,111.72512572352306,101.0823327380156,111.44029600000029,113.1986606,109.16751959999992,107.0242995000001,107.04666333333336,186709008,237757148.0,47.593298392746064,1.5,2.75,2.055466020941181,0.7852929326019674,0.4122926828562064,-0.3932780616455034,-0.8055707445017097,26.73606361970532,4.296675415573052,4101726925.0,2010-07-19,2010,0,200,7,1.33,106.92,108.56,105.82001000000001,2650
2010-07-20 13:30:00,105.87,108.56,105.82001000000001,108.48,99.63,108.62564102564104,111.46769600000029,113.1767606,109.11191979999992,106.87779950000014,109.36561633085638,107.726325091991,106.80834461538471,111.89460328652821,101.7220859442412,111.46769600000029,113.1767606,109.11191979999992,106.87779950000014,107.62000333333332,258162320,240008232.8,51.53171161840167,1.5,2.75,2.104360590873954,1.0756394353152372,0.4128812781662093,-0.2894691467939481,-0.7023504249601574,26.962047718186888,2.2359399665433664,4359889245.0,2010-07-20,2010,1,201,7,2.59,107.19,109.07001000000001,106.63,2651
2010-07-21 13:30:00,109.03998999999999,109.07001000000001,106.63,107.07001000000001,99.505,108.39692307692309,111.49059600000028,113.1400606,108.93011999999992,106.75279950000014,109.27559255317574,107.66381889275377,107.13988461538472,111.65747206812188,102.62229716264756,111.49059600000028,113.1400606,108.93011999999992,106.75279950000014,107.59000666666668,264526944,241266814.4,47.02259798992444,1.5,2.75,2.128335548668672,1.0964083256035229,0.3080272063992984,-0.3173164169610345,-0.6253436233603329,23.214246716074637,-0.08397723030981732,4095362301.0,2010-07-21,2010,2,202,7,2.29,107.85,109.94,108.33,2652
2010-07-22 13:30:00,108.34,109.94,108.33,109.461,99.38,108.16820512820513,111.51780100000029,113.1157706,108.80273999999994,106.7643495000001,109.28286343344335,107.83497899820576,107.69842307692316,111.34671064672254,104.05013550712377,111.51780100000029,113.1157706,108.80273999999994,106.7643495000001,109.24366666666668,274781440,242270948.8,54.32175103261896,1.5,2.75,2.1813108666209096,1.1341906297929187,0.3844479448844451,-0.1447836922547765,-0.5292316371392216,25.8433299144416,1.3903203602889642,4370143741.0,2010-07-22,2010,3,203,7,1.49,109.14,110.57001000000001,108.92998999999999,2653
2010-07-23 13:30:00,109.24001000000001,110.57001000000001,108.92998999999999,110.41,99.255,107.93948717948722,111.54230105000029,113.09787060000001,108.66193999999994,106.91384950000008,109.32706486742596,108.08021909361473,108.27842307692316,110.93423163836573,105.62261451548059,111.54230105000029,113.09787060000001,108.66193999999994,106.91384950000008,109.96999999999998,222020816,239937391.2,56.8622136242919,1.5,2.75,2.142647233290844,0.925328123680958,0.47758145348758707,0.06774517972026217,-0.4098362737673248,25.94185386932657,2.2030917337776503,4592164557.0,2010-07-23,2010,4,204,7,1.51,109.75,111.67,110.28998999999999,2654
2010-07-26 13:30:00,110.60001000000001,111.67,110.28998999999999,111.56,99.13,107.71076923076923,111.57110105000031,113.0904706,108.57333979999994,107.09847500000008,109.41463095105631,108.41162679898476,108.69784615384623,111.56367791084206,105.83201439685041,111.57110105000031,113.0904706,108.57333979999994,107.09847500000008,111.17333,182126496,237107391.2,59.781304706482324,1.5,2.75,2.088173145198641,0.7681181724376377,0.5880468358937827,0.32522227109990354,-0.2628245647938792,26.318426274820272,1.7326281232901748,4774291053.0,2010-07-26,2010,0,207,7,1.25,110.98,112.28998999999999,111.11,2655
2010-07-27 13:30:00,112.17,112.28998999999999,111.11,111.55,99.005,107.48205128205127,111.59580105000029,113.0795605,108.52653979999994,107.29947500000007,109.49837091375997,108.71051948479574,109.03553846153855,112.12296031014463,105.94811661293241,111.59580105000029,113.0795605,108.52653979999994,107.29947500000007,111.64999666666668,204855568,238883507.2,59.743445901427705,1.5,2.75,2.023302920541596,0.8575542547962056,0.6282159554272921,0.5224453794902361,-0.10577057593705612,25.25629986610798,1.731858350585039,4569435485.0,2010-07-27,2010,1,208,7,1.06,111.7,111.66,110.46001000000001,2656
2010-07-28 13:30:00,111.32001000000001,111.66,110.46001000000001,110.83,98.88,107.25333333333332,111.61365110000031,113.0453605,108.46413979999994,107.63047450000008,109.55059166224,108.91237477195807,109.25630692307699,112.41416851190523,106.09844533424877,111.61365110000031,113.0453605,108.46413979999994,107.63047450000008,110.98333666666667,163056192,228348291.2,56.9471035968644,1.5,2.75,1.9644948547886243,0.714067931680673,0.5754766350868509,0.6135752179215075,0.03809858283465661,25.6839733519121,1.0485139540949946,4406379293.0,2010-07-28,2010,2,209,7,1.09,111.06,111.82001000000001,109.41,2657
2010-07-29 13:30:00,111.52,111.82001000000001,109.41,110.28998999999999,98.755,107.0246153846154,111.6267011000003,113.00556039999998,108.42193979999996,107.98397400000009,109.57958767548548,109.04357622224778,109.43015230769235,112.54740332047544,106.31290129490928,111.6267011000003,113.00556039999998,108.42193979999996,107.98397400000009,110.50666666666666,220149008,225150660.0,54.87262117114154,1.5,2.75,1.9963173651608648,0.9777853105116371,0.477443700541079,0.6349032085110053,0.15745950796992636,25.911402810267035,3.40332833302082,4186230285.0,2010-07-29,2010,3,210,7,2.2,110.62,110.86,108.98,2658
2010-07-30 13:30:00,109.17,110.86,108.98,110.27,98.63,106.79589743589744,111.6407510500003,112.96366029999996,108.39213999999996,108.35947450000009,109.60666266860369,109.1603784867956,109.47707538461545,112.62496680132179,106.32918396790907,111.6407510500003,112.96366029999996,108.39213999999996,108.35947450000009,110.03666666666666,220070496,217007944.8,54.79304935589222,1.5,2.75,1.9880089819350888,1.0141126224794328,0.3882589252831668,0.6427831645738848,0.25452423929071805,18.64279023045539,2.777528453493185,3966159789.0,2010-07-30,2010,4,211,7,1.73,109.92,112.94,111.53998999999999,2659
2010-08-02 13:30:00,111.99001000000001,112.94,111.53998999999999,112.75998999999999,98.505,106.56717948717949,111.65800100000031,112.94156019999998,108.49653999999997,108.88747400000014,109.73032256395256,109.5031986309103,109.71622846153852,113.32001793214505,106.112438990932,111.65800100000031,112.94156019999998,108.49653999999997,108.88747400000014,112.41332666666663,188263184,214751848.0,62.15483907093796,1.5,2.75,2.0367226260825833,0.8766545468796152,0.4685913573410509,0.8402634359670316,0.3716720786259807,21.611922081572537,3.945418510324482,4154422973.0,2010-08-02,2010,0,214,8,1.26,112.24,112.77,111.85001000000001,2660
2010-08-03 13:30:00,112.48,112.77,111.85001000000001,112.22,98.38,106.33846153846156,111.6705509500003,112.90926019999998,108.55863979999997,109.35497400000013,109.82795697320931,109.76194161844265,109.91161384615391,113.75388873891102,106.06933895339678,111.6705509500003,112.90926019999998,108.55863979999997,109.35497400000013,112.28000333333334,146657248,209237888.8,59.877565900372936,1.5,2.75,1.9569560099338268,0.7009115263067021,0.4565284725150007,0.9423326692697316,0.4858041967547309,21.89508253411318,4.809927635198692,4007765725.0,2010-08-03,2010,1,215,8,0.82,112.31,113.11,112.16,2661
2010-08-04 13:30:00,112.53,113.11,112.16,112.97,98.255,106.1097435897436,111.6909509500003,112.88436009999997,108.66383959999996,109.6980990000001,109.95117434680895,110.06747098811479,110.3969984615385,114.06381239950417,106.73018452357285,111.6909509500003,112.88436009999997,108.66383959999996,109.6980990000001,112.74666666666666,158171632,204457986.4,61.96213613644808,1.5,2.75,1.8850305806528396,0.7736143487716555,0.468469976829474,1.0713916677915734,0.6029216909620994,19.236241067819517,3.2057079690483365,4165937357.0,2010-08-04,2010,2,216,8,0.85,112.64,112.91,112.08,2662
2010-08-05 13:30:00,112.25,112.91,112.08,112.85001000000001,98.13,105.88102564102564,111.7062510500003,112.85796009999996,108.76447999999996,109.98259950000009,110.06485417634586,110.33247470353243,110.82469230769236,114.22983467092556,107.41954994445915,111.7062510500003,112.85796009999996,108.76447999999996,109.98259950000009,112.61333666666668,140473744,200939570.4,61.412400605320514,1.5,2.75,1.8139569677490648,0.6990845243690239,0.4382425066426941,1.1507248242654669,0.7124823176227728,16.232481147865027,2.2099538085318366,4025463613.0,2010-08-05,2010,3,217,8,0.74,112.5,112.57001000000001,110.92,2663
2010-08-06 13:30:00,111.74001000000001,112.57001000000001,110.92,112.39200000000001,98.005,105.65230769230769,111.72215605000031,112.81778009999996,108.86891999999996,110.2041990000001,110.15611479688131,110.52861996986269,111.12561538461544,114.33451610593993,107.91671466329096,111.72215605000031,112.81778009999996,108.86891999999996,110.2041990000001,111.96067,239728256,205675989.6,59.25146843772481,1.5,2.75,1.822246470052703,1.1655626719785088,0.3605984240794209,1.1632303477220491,0.8026319236426279,16.269955900235242,0.7457870204374271,3785735357.0,2010-08-06,2010,4,218,8,1.49,111.75,113.17998999999999,112.32001000000001,2664
2010-08-09 13:30:00,112.92,113.17998999999999,112.32001000000001,112.992,97.88,113.17998999999999,111.74596605000029,112.77669999999996,108.91356019999998,110.45229900000014,110.26732598131734,110.7632275917805,111.58115307692312,113.92164344738069,109.24066270646557,111.74596605000029,112.77669999999996,108.91356019999998,110.45229900000014,112.83066666666667,120800368,205151829.6,61.178624783933394,1.5,2.75,1.753513150763225,0.5888339784028911,0.3240026083454104,1.2076351840743909,0.8836325757289807,15.53981082148999,1.2926938592559456,3906535725.0,2010-08-09,2010,0,221,8,0.77,112.75,112.98,111.3701,2665
2010-08-10 13:30:00,112.03,112.98,111.3701,112.375,97.755,113.17940147058823,111.76119105000029,112.73007489999996,108.97368019999998,110.58804900000014,110.34997986440294,110.91672972589666,111.805306923077,113.82712018967042,109.78349365648351,111.76119105000029,112.73007489999996,108.97368019999998,110.58804900000014,112.2417,242916192,206646345.6,58.13386668735559,1.5,2.75,1.7441122114229952,1.1755165149167777,0.23664889980589174,1.1794437004863454,0.9427948006804536,16.01192925277211,1.394026888026709,3663619533.0,2010-08-10,2010,1,222,8,1.45,112.18,110.69,109.12,2666
2010-08-11 13:30:00,110.64998999999999,110.69,109.12,109.3,97.63,113.17881294117649,111.76729105000028,112.66337489999997,109.0090802,110.57049900000014,110.30880418344594,110.76275546628746,111.71992230769236,114.04172686597552,109.3981177494092,111.76729105000028,112.66337489999997,109.0090802,110.57049900000014,109.70333333333332,273408256,211095420.8,45.878931518680936,1.5,2.75,1.852032767749924,1.2951880005916263,-0.03534283522914805,0.8986162566440186,0.9339590918731666,22.737173170158282,-0.897624526033601,3390211277.0,2010-08-11,2010,2,223,8,1.44,109.9,109.02,107.60001000000001,2667
2010-08-12 13:30:00,107.64998999999999,109.02,107.60001000000001,108.63,97.505,113.17822441176472,111.77589105000028,112.58374989999994,108.97508020000001,110.51799950000013,110.24296872527158,110.55963589806959,111.49453769230776,114.34365043529688,108.64542494931864,111.77589105000028,112.58374989999994,108.97508020000001,110.51799950000013,108.41667,239542560,211455655.2,43.71650381773536,1.5,2.75,1.8411725700535004,1.1328264537235229,-0.2552418170909305,0.6149068205095034,0.8701486376004339,22.819500737158197,-1.4872585472023219,3150668717.0,2010-08-12,2010,3,224,8,1.32,108.31,108.96001000000001,108.17998999999999,2668
2010-08-13 13:30:00,108.28998999999999,108.96001000000001,108.17998999999999,108.31,97.38,113.17763588235294,111.78534105000031,112.49274989999996,108.92708,110.60049950000014,110.16716603016293,110.34538486015819,111.245306923077,114.56018655547408,107.93042729067987,111.78534105000031,112.49274989999996,108.92708,110.60049950000014,108.48333333333332,158698496,205255911.2,42.681765491645216,1.5,2.75,1.7653759579068211,0.7731738154199381,-0.40804467240558095,0.36009279709345776,0.7681374694990387,22.815545348314185,-3.9464263875865897,2991970221.0,2010-08-13,2010,4,225,8,0.72,108.57,108.61,107.17998999999999,2669
2010-08-16 13:30:00,107.57001000000001,108.61,107.17998999999999,108.25998999999999,97.255,113.17704735294114,111.80459100000029,112.40694979999996,108.9558796,110.64899950000013,110.0923748132938,110.14677582585743,111.04761384615392,114.72473444970234,107.37049324260548,111.80459100000029,112.40694979999996,108.9558796,110.64899950000013,108.01666000000002,147895248,203315223.2,42.51241267450036,1.5,2.75,1.7414212466277623,0.7274184671086646,-0.4926226498966234,0.15235915712825945,0.6449818070248828,17.024504891063,-3.5287916592407744,2844074973.0,2010-08-16,2010,0,228,8,1.33,107.89,110.39,108.88,2670
2010-08-17 13:30:00,109.19,110.39,108.88,109.59,97.13,113.17645882352942,111.81929105000029,112.33634989999996,109.03787939999998,110.70449950000014,110.07267384022344,110.09374955672813,110.99376846153852,114.73365347761928,107.25388344545776,111.81929105000029,112.33634989999996,109.03787939999998,110.70449950000014,109.62,172270256,199020620.0,48.37868049747329,1.5,2.75,1.7691775861543506,0.8655899876103291,-0.4408124392767199,0.09396625792898304,0.5347786972057029,19.38695581638922,-2.991944764096659,3016345229.0,2010-08-17,2010,1,229,8,1.39,109.64,110.38,108.91,2671
2010-08-18 13:30:00,109.53998999999999,110.38,108.91,109.78998999999999,97.005,113.17587029411766,111.85044100000029,112.26842979999994,109.10127920000001,110.84049850000015,110.06158819943035,110.064820075135,110.9568446153847,114.7338773443937,107.17981188637566,111.85044100000029,112.26842979999994,109.10127920000001,110.84049850000015,109.69333,182922064,194940376.0,49.21782577150332,1.5,2.75,1.7478077585718967,0.9383487800392876,-0.3773432672311008,0.06309961316682687,0.4404428803979277,18.752142620744017,-2.711581505398178,3199267293.0,2010-08-18,2010,2,230,8,1.35,109.64,109.49001000000001,107.42998999999999,2672
2010-08-19 13:30:00,109.22,109.49001000000001,107.42998999999999,107.88,96.88,113.17528176470587,111.86824095000028,112.17402969999992,109.1378792,110.76144850000016,109.97603572102136,109.85674197274119,110.58146076923084,114.53302103987438,106.6299004985873,111.86824095000028,112.17402969999992,109.1378792,110.76144850000016,108.26666666666668,265847568,194493682.4,42.16771951656688,1.5,2.75,1.7915357758167614,1.3668699400387312,-0.4436875955792088,-0.1141666140760833,0.32952098150312553,20.47835128246643,-4.014520606448857,2933419725.0,2010-08-19,2010,3,231,8,1.92,108.46,107.93761,106.74989,2673
2010-08-20 13:30:00,107.56,107.93761,106.74989,107.53,96.755,113.17469323529413,111.88264100000029,112.07532979999996,109.10547939999998,110.6174485000002,109.88011275156951,109.63514749914678,110.2206915384616,114.3599143262968,106.08146875062641,111.88264100000029,112.07532979999996,109.10547939999998,110.6174485000002,107.40583333333332,209714128,193878348.0,41.008492025755366,1.5,2.75,1.7484060775441363,1.0816789505551183,-0.4873524605898546,-0.2796695942341927,0.2076828663556619,20.49007222386186,-4.833970546587372,2723705597.0,2010-08-20,2010,4,232,8,1.11,107.34,108.57001000000001,107.07001000000001,2674
2010-08-23 13:30:00,108.03998999999999,108.57001000000001,107.07001000000001,107.1236,96.63,113.17410470588236,111.89365900000028,111.97656579999996,109.0543516,110.39562850000021,109.77201421229229,109.39595249922804,109.77096846153853,113.88798026690166,105.65395665617537,111.89365900000028,111.97656579999996,109.0543516,110.39562850000021,107.58787333333336,163490256,192946536.0,39.64562293591228,1.5,2.75,1.7306627862909836,0.8473344968473546,-0.5170018343785336,-0.4385694266175051,0.0784324077610285,19.55217541210698,-4.6731034482758655,2560215341.0,2010-08-23,2010,0,235,8,1.4,107.82,106.39,104.97,2675
2010-08-24 13:30:00,105.95,106.39,104.97,105.53,96.505,113.17351617647059,111.88705850000028,111.85386579999997,108.97477159999998,110.09462850000018,109.60566071377104,109.02776654692062,109.2078907692308,113.48557481285812,104.9302067256035,111.88705850000028,111.85386579999997,108.97477159999998,110.09462850000018,105.63,280795648,196743540.0,34.766402876304376,1.5,2.75,1.7608725872701991,1.4272166089926002,-0.6108982793522619,-0.6851904414292989,-0.07429216207703697,20.322400423510448,-3.449222323879228,2279419693.0,2010-08-24,2010,1,236,8,1.35,105.68,106.34,104.28999,2676
2010-08-25 13:30:00,104.95,106.34,104.28999,105.94,104.28999,113.17292764705886,111.88110850000028,111.72566589999997,108.85357159999998,109.8501285000002,109.46190931323099,108.73369354245199,108.71158307692312,112.89244676321812,104.53071939062812,111.88110850000028,111.72566589999997,108.85357159999998,109.8501285000002,105.52333,272330752,202207268.0,36.91746769582357,1.5,2.75,1.781525259608042,1.3467901262579742,-0.6108839050944019,-0.8378970434450395,-0.2270131383506375,15.687338919282574,-2.476295682592284,2551750445.0,2010-08-25,2010,2,237,8,1.97,105.31,106.58,104.88,2677
2010-08-26 13:30:00,106.44,106.58,104.88,105.23,104.37314763157896,113.17233911764706,111.85940845000027,111.58756599999997,108.71897139999996,109.5971290000002,109.29595208526115,108.40000844317085,108.11450615384621,111.87559066970465,104.35342163798778,111.85940845000027,111.58756599999997,108.71897139999996,109.5971290000002,105.56333333333336,224492688,202424452.0,34.77874140960431,1.5,2.75,1.7757020267788963,1.109019615871308,-0.6220922577064055,-1.0046284604836444,-0.3825362027772389,15.73128488136111,-2.8436894100267733,2327257757.0,2010-08-26,2010,3,238,8,1.62,105.73,106.97,104.31,2678
2010-08-27 13:30:00,105.89,106.97,104.31,106.86,104.4563052631579,113.1717505882353,111.84575845000026,111.47256599999996,108.61337139999996,109.4266290000002,109.2004245525058,108.25334097239269,107.69027538461545,110.5755725736706,104.80497819556028,111.84575845000026,111.47256599999996,108.61337139999996,109.4266290000002,106.04666666666668,272704000,205056127.2,42.95006479349521,1.5,2.75,1.8388661677232605,1.329899299883003,-0.4889960303102666,-0.993781240665072,-0.5047852103548055,18.99510014471805,-1.2931739602045065,2599961757.0,2010-08-27,2010,4,239,8,2.55,105.64,106.91,105.3,2679
2010-08-30 13:30:00,106.58,106.91,105.3,105.311,104.53946289473684,113.17116205882354,111.82156350000028,111.33795089999997,108.48501139999996,109.05417950000022,109.04789809946637,107.97311802264099,107.38342923076927,110.36551849763869,104.40133996389984,111.82156350000028,111.33795089999997,108.48501139999996,109.05417950000022,105.84033333333332,167238560,204004896.0,38.06891416954044,1.5,2.75,1.822518584314456,0.8197771880925838,-0.4741914443900485,-1.0975245158423659,-0.6233330714523176,20.429089754342037,-3.904553335158314,2432723197.0,2010-08-30,2010,0,242,8,1.53,106.1,105.98,104.49001,2680
2010-08-31 13:30:00,104.92,105.98,104.49001,105.31,104.6226205263158,113.17057352941177,111.80296350000029,111.19555089999996,108.36301139999996,108.70867950000022,108.90131386027159,107.71948773477041,107.12804461538464,110.2064596148904,104.04962961587893,111.80296350000029,111.19555089999996,108.36301139999996,108.70867950000022,105.26000333333332,273933056,210368686.4,38.06590651585344,1.5,2.75,1.7987665425777095,1.3021569925057062,-0.43443532670380935,-1.1663772298320794,-0.73194190312827,18.24392049154223,-4.080508614674253,2158790141.0,2010-08-31,2010,1,243,8,1.43,105.24,108.61,106.66,2681
2010-09-01 13:30:00,106.73,108.61,106.66,108.46001000000001,104.70577815789473,113.16998500000001,111.79716355000029,111.08275089999998,108.34081139999996,108.4831800000002,108.88400782653544,107.79001366479228,107.13958384615391,110.23670204560408,104.0424656467037,111.79716355000029,111.08275089999998,108.34081139999996,108.4831800000002,107.91000333333334,267834944,215851852.0,51.156533159367434,1.5,2.75,1.9059975038221588,1.2408276395052658,-0.17904389082821404,-0.9557467666635376,-0.7767028758353235,26.480106169187337,0.5376436781609211,2426625085.0,2010-09-01,2010,2,244,9,1.83,107.64,109.49001000000001,108.49001000000001,2682
2010-09-02 13:30:00,108.72,109.49001000000001,108.49001000000001,109.47,104.78893578947368,113.16939647058823,111.78846350000029,110.97915089999996,108.34561139999997,108.3141795000002,108.90698791176935,107.95001236338351,107.23266153846157,110.52542111395545,103.93990196296774,111.78846350000029,110.97915089999996,108.34561139999997,108.3141795000002,109.15000666666668,156112128,216633771.2,54.47879762251942,1.5,2.75,1.8434262535491477,0.7206269231950665,0.061952544176185786,-0.6992621956150913,-0.7612147397912771,24.854457060126737,1.804147679717286,2582737213.0,2010-09-02,2010,3,245,9,0.92,108.99,110.99001000000001,109.95,2683
2010-09-03 13:30:00,110.53998999999999,110.99001000000001,109.95,110.89,104.87209342105265,113.1688079411765,111.78621850000029,110.87615089999996,108.41501139999997,108.23907950000022,108.98475309169996,108.23001118591841,107.3326615384616,110.96696152487192,103.69836155205128,111.78621850000029,110.87615089999996,108.41501139999997,108.23907950000022,110.61000333333334,212197248,215257220.8,58.72916907104188,1.5,2.75,1.8203250925813512,0.9857845753623146,0.30731771812335684,-0.37706759213708096,-0.6843853102604378,25.4514466707652,3.51593859803069,2794934461.0,2010-09-03,2010,4,246,9,0.95,110.47,110.50998999999999,109.55,2684
2010-09-07 13:30:00,110.37,110.50998999999999,109.55,109.64,104.95525105263157,113.16821941176471,111.77806850000029,110.75965099999996,108.45046159999998,108.07147950000015,109.0104490488882,108.36429583487856,107.32112384615392,110.92497052355701,103.71727716875084,111.77806850000029,110.75965099999996,108.45046159999998,108.07147950000015,109.89999666666668,141973680,216315886.4,53.95345038934585,1.5,2.75,1.7860161573969688,0.6563257205135166,0.3714650835015385,-0.22005395588351465,-0.5915190393850531,26.53918165597606,3.8946271202501648,2652960781.0,2010-09-07,2010,1,250,9,0.88,110.03,110.85001000000001,109.81,2685
2010-09-08 13:30:00,109.86,110.85001000000001,109.81,110.41,105.03840868421055,113.16763088235294,111.78101845000029,110.67015099999996,108.50806159999998,107.97322950000016,109.06533339991219,108.55912480298537,107.51573923076931,111.47501254236141,103.55646591917723,111.78101845000029,110.67015099999996,108.50806159999998,107.97322950000016,110.35667,150268944,211683524.0,56.31028695683443,1.5,2.75,1.7448728604400423,0.7098754837433641,0.44673096319612976,-0.03310533538989091,-0.4798362985860207,24.192976928566488,4.219369454408154,2803229725.0,2010-09-08,2010,2,251,9,0.95,110.33,111.67998999999999,110.62,2686
2010-09-09 13:30:00,111.64998999999999,111.67998999999999,110.62,110.92,105.1215663157895,113.1670423529412,111.78846850000029,110.58125099999997,108.64226140000001,108.05422950000015,109.13806542344506,108.78397005984391,107.77650846153857,112.13192161264341,103.4210953104337,111.78846850000029,110.58125099999997,108.64226140000001,108.05422950000015,111.07333,147017872,205364004.8,57.84915983250739,1.5,2.75,1.710952656122897,0.7158891946189783,0.5074093676561903,0.15442541098421714,-0.35298395667197313,24.1895139989013,5.4072032690297425,2950247597.0,2010-09-09,2010,3,252,9,0.96,111.15,111.61,110.87,2687
2010-09-10 13:30:00,111.12,111.61,110.87,111.48199,105.20472394736844,113.16645382352941,111.79177840000028,110.48727089999996,108.8075012,108.19682900000015,109.22998403429031,109.04092433985876,108.11176923076935,112.86715108450882,103.35638737702986,111.79177840000028,110.48727089999996,108.8075012,108.19682900000015,111.32066333333334,127818944,199777824.0,59.540336260446175,1.5,2.75,1.6415988949712612,0.6398054670972889,0.5579251547720981,0.3444224867931496,-0.2135026679789486,23.09523862677193,4.325276062137373,3078066541.0,2010-09-10,2010,4,253,9,0.67,111.24,112.95,112.13,2688
2010-09-13 13:30:00,112.58,112.95,112.13,112.72,105.28788157894738,113.16586529411764,111.80042835000029,110.40787089999996,109.0067014,108.41732900000015,109.36684740549464,109.39131249796743,108.66484615384627,113.75142031463552,103.578271993057,111.80042835000029,110.40787089999996,109.0067014,108.41732900000015,112.59999999999998,178503440,200768071.2,63.056735656862,1.5,2.75,1.6291996881876003,0.8891027290000683,0.641293481994971,0.5881141845147653,-0.053179297480205806,22.56582828401969,7.035352432319503,3256569981.0,2010-09-13,2010,0,256,9,0.73,112.54,113.28998999999999,112.08,2689
2010-09-14 13:30:00,112.5,113.28998999999999,112.08,112.64998999999999,105.37103921052632,113.16527676470587,111.80677830000029,110.32417079999996,109.21570120000001,108.63682900000015,109.49559809547523,109.70166273625628,109.18099923076932,114.41641772644213,103.94558073509656,111.80677830000029,110.32417079999996,109.21570120000001,108.63682900000015,112.67332666666668,209823568,203864487.2,62.72473771599201,1.5,2.75,1.5992561390313436,1.0292305976477103,0.6559464212321869,0.7667537290600279,0.11080730782784096,19.23321793234149,6.9698888994397485,3046746413.0,2010-09-14,2010,1,257,9,1.08,112.68,113.21001000000001,111.98,2690
2010-09-15 13:30:00,112.32001000000001,113.21001000000001,111.98,113.08,105.45419684210528,113.16468823529414,111.82432825000029,110.23684579999995,109.41990120000001,108.81132900000013,109.63616287604485,110.0234091423271,109.78484538461548,114.86672395761944,104.7029668116115,111.82432825000029,110.23684579999995,109.41990120000001,108.81132900000013,112.75667,168608320,203681390.4,63.97920785000839,1.5,2.75,1.5728814148148185,0.8278042469607965,0.6571768289144188,0.9322783439708644,0.27510151505644564,18.865284674072644,4.25962527571222,3215354733.0,2010-09-15,2010,2,258,9,1.1,112.6,113.12,112.35001000000001,2691
2010-09-16 13:30:00,112.73,113.12,112.35001000000001,113.05,105.53735447368422,113.16409970588236,111.83987825000031,110.15384569999996,109.55875120000002,108.97432950000014,109.77003884169014,110.3116558906769,110.26099923076931,115.31735741491396,105.20464104662467,111.83987825000031,110.15384569999996,109.55875120000002,108.97432950000014,112.84000333333334,199962880,204533431.2,63.817842931950814,1.5,2.75,1.515532028042332,0.9776537694929158,0.6190751513927262,1.0489454542973533,0.4298703029046272,12.693399806423828,3.2703023659450063,3015391853.0,2010-09-16,2010,3,259,9,0.69,112.74,113.14998999999999,112.17998999999999,2692
2010-09-17 13:30:00,113.03998999999999,113.14998999999999,112.17998999999999,112.49001000000001,105.62051210526316,113.16351117647058,111.8458283000003,110.09394579999994,109.66535140000002,109.20483000000013,109.87670437731012,110.51911818680293,110.81323076923088,115.09533969137213,106.5311218470896,111.8458283000003,110.09394579999994,109.66535140000002,109.20483000000013,112.60666333333334,195836816,201032893.6,60.73836524058075,1.5,2.75,1.4765654546107367,0.9741530975008559,0.5230845166072795,1.0837259486637263,0.560641432056447,13.207540481032964,1.4428803318603998,2819555037.0,2010-09-17,2010,4,260,9,0.86,112.66,114.46001000000001,112.52161000000001,2693
2010-09-20 13:30:00,112.88,114.46001000000001,112.52161000000001,114.21001000000001,105.70366973684212,113.1629226470588,111.86062835000031,110.04224589999995,109.79035140000002,109.53883050000009,110.04663793114109,110.87063169282169,111.497846923077,114.76789534879694,108.2277984973571,111.86062835000031,110.04224589999995,109.79035140000002,109.53883050000009,113.73054333333332,214786688,201286521.6,66.14246262539459,1.5,2.75,1.5118107792813984,1.0670694008356296,0.540153612501998,1.2358334476839443,0.6956798351819465,13.89694404200272,4.168195913900033,3034341725.0,2010-09-20,2010,0,263,9,1.72,113.49,114.84,113.50998999999999,2694
2010-09-21 13:30:00,114.3,114.84,113.50998999999999,113.98,105.78682736842106,113.16233411764706,111.87862835000028,109.97347089999997,109.90935140000002,109.88165050000013,110.20088742403752,111.16676200779104,111.92246153846165,114.9271612721636,108.9177618047597,111.87862835000028,109.97347089999997,109.90935140000002,109.88165050000013,114.10999666666667,268632320,206543624.8,64.85683994063135,1.5,2.75,1.4988250093327269,1.3006081415493778,0.5015153650781274,1.322574041529606,0.8210586764514785,11.156065171200924,3.233402771488097,2765709405.0,2010-09-21,2010,1,264,9,1.17,114.17,114.44,113.10001000000001,2695
2010-09-22 13:30:00,113.8,114.44,113.10001000000001,113.42,105.869985,113.1617455882353,111.89067840000028,109.91954589999996,109.98455140000002,110.27615050000013,110.3271271328988,111.38135610228714,112.2263076923078,114.96461588027954,109.48799950433607,111.89067840000028,109.91954589999996,109.98455140000002,110.27615050000013,113.65333666666668,191322368,202069960.8,61.71179167889692,1.5,2.75,1.487479651523247,0.946812516034298,0.4077840690230404,1.330788762730279,0.9230046937072386,12.001512887550815,2.253876667868734,2574387037.0,2010-09-22,2010,2,265,9,1.18,113.77,113.67,112.17998999999999,2696
2010-09-23 13:30:00,112.49001000000001,113.67,112.17998999999999,112.49799999999999,105.95314263157896,113.1611570588235,111.89896840000029,109.84102579999997,110.0414914,110.60405050000013,110.41225940219691,111.48770314016457,112.35000000000014,114.97876276021248,109.72123723978773,111.89896840000029,109.84102579999997,110.0414914,110.60405050000013,112.78266333333336,202354256,198571136.0,56.8258834708002,1.5,2.75,1.487660390700157,1.0190517115236728,0.26040365015692496,1.2485092564033948,0.9881056062464698,13.406121810238625,0.9113669391800492,2372032781.0,2010-09-23,2010,3,266,9,1.33,112.92,114.89998999999999,113.64998999999999,2697
2010-09-24 13:30:00,113.75,114.89998999999999,113.64998999999999,114.82001000000001,106.0363002631579,113.16056852941178,111.92501845000028,109.81402589999996,110.14429180000003,111.0835510000001,110.58511236681663,111.80506569824414,112.7484623076924,115.17597068666534,110.32095392871945,111.92501845000028,109.81402589999996,110.14429180000003,111.0835510000001,114.45666333333332,209671680,197830085.6,64.45788232670878,1.5,2.75,1.5529696485072886,1.0598573991619402,0.2935545525688277,1.3550487969575045,1.0614942443886768,17.270365934181722,1.8630322924059597,2581704461.0,2010-09-24,2010,4,267,9,1.1,114.27,114.99001000000001,114.16,2698
2010-09-27 13:30:00,114.86,114.99001000000001,114.16,114.27,106.11945789473684,113.15998,111.94626345000029,109.78852579999996,110.29649180000004,111.45405100000008,110.72961776419638,112.03982134603041,113.04538538461546,115.18311516031338,110.90765560891754,111.94626345000029,109.78852579999996,110.29649180000004,111.45405100000008,114.47333666666668,128799440,190634857.6,61.6767141645471,1.5,2.75,1.501329673613911,0.6756342550440262,0.2541664875583076,1.3792023538365612,1.1250358662782536,16.944781117534777,1.4380915613041718,2452905021.0,2010-09-27,2010,0,270,9,0.73,114.58,115.03998999999999,113.17998999999999,2699
2010-09-28 13:30:00,114.42,115.03998999999999,113.17998999999999,114.67,106.20261552631581,113.15939147058823,111.96641345000029,109.80580579999996,110.44409200000004,111.9220010000001,110.8841425577573,112.29031455117037,113.33384692307699,115.2467598670406,111.42093397911341,111.96641345000029,109.80580579999996,110.44409200000004,111.9220010000001,114.29666,209207440,192733301.6,62.929435584106514,1.5,2.75,1.5269489826414888,1.0854763461386168,0.23142531249997056,1.4143175069032168,1.1828921944032462,16.932811905805618,1.4060841881853583,2662112461.0,2010-09-28,2010,1,271,9,1.64,114.11,114.91,114.02,2700
2010-09-29 13:30:00,114.38,114.91,114.02,114.47,106.28577315789472,113.15880294117649,111.98321345000029,109.83790589999997,110.56389200000004,112.38000100000008,111.0247644182374,112.49790364153507,113.56369384615392,115.23399567262184,111.89339201968602,111.98321345000029,109.83790589999997,110.56389200000004,112.38000100000008,114.46666666666664,179665744,188019936.0,61.84095018833587,1.5,2.75,1.4814526267385253,0.9555675202442362,0.1814921521440553,1.4097573845833151,1.22826523243926,16.988688327086166,1.2560813799203907,2482446717.0,2010-09-29,2010,2,272,9,0.78,114.46,115.78998999999999,113.59,2701
2010-09-30 13:30:00,115.05,115.78998999999999,113.59,114.13,106.36893078947371,113.1582144117647,111.99451345000028,109.81760589999996,110.70509180000003,112.6635005000001,111.14653836262026,112.6533413899603,113.67215538461544,115.29157163337645,112.05273913585444,111.99451345000028,109.81760589999996,110.70509180000003,112.6635005000001,114.50333,287106560,188983516.8,59.94276260067308,1.5,2.75,1.5327767248286306,1.5192148228664988,0.10778503071512313,1.3629965208331642,1.2552114901180411,17.145492107551696,1.4578983502623897,2195340157.0,2010-09-30,2010,3,273,9,1.94,114.69,115.12,113.92998999999999,2702
2010-10-01 13:30:00,114.99001000000001,115.12,113.92998999999999,114.61,106.45208842105265,113.15762588235296,112.0108134000003,109.80540589999997,110.80807180000004,112.92050050000013,111.28236038761554,112.83968982901173,113.82292538461546,115.39795885906635,112.24789191016458,112.0108134000003,109.80540589999997,110.80807180000004,112.92050050000013,114.55333,174638624,189909841.6,61.728766642325326,1.5,2.75,1.5082933873408713,0.9195870131250744,0.07512552060714084,1.349118390876967,1.2739928702698262,16.792036927746068,0.3502232422534614,2369978781.0,2010-10-01,2010,4,274,10,1.04,114.52,114.85001000000001,113.17998999999999,2703
2010-10-04 13:30:00,114.37,114.85001000000001,113.17998999999999,113.75,106.53524605263159,113.1570373529412,112.02196340000029,109.76840589999996,110.87487180000004,113.06350050000013,111.37913056849337,112.92638603577251,113.87446384615393,115.39167010095609,112.35725759135175,112.02196340000029,109.76840589999996,110.87487180000004,113.06350050000013,113.92666666666666,166153184,187607638.4,56.838983045997885,1.5,2.75,1.519845288245094,0.8856418929262531,-0.015780972235566848,1.2542666549753676,1.2700476272109344,15.190827738838458,-0.20178978768205294,2203825597.0,2010-10-04,2010,0,277,10,1.48,114.02,116.32001000000001,114.67,2704
2010-10-05 13:30:00,114.8,116.32001000000001,114.67,116.03998999999999,106.6184036842105,113.15644882352942,112.05126340000031,109.76890569999996,110.96447160000004,113.38350000000014,111.56190936972892,113.2229197466513,114.10446307692317,115.92767163101887,112.28125452282744,112.05126340000031,109.76890569999996,110.96447160000004,113.38350000000014,115.67666666666666,229634064,191990657.6,64.82838345091108,1.5,2.75,1.5948570533704445,1.1960689487215963,0.06263089402273847,1.3483362447393574,1.2857053507166192,19.056969809704626,2.309989419855406,2433459661.0,2010-10-05,2010,1,278,10,1.44,115.5,116.33,115.56,2705
2010-10-06 13:30:00,116.02,116.33,115.56,116.03,106.70156131578949,113.15586029411764,112.08036335000031,109.79030569999996,111.05407160000004,113.66450000000015,111.7371286101317,113.49026072316073,114.37677000000008,116.21152511449272,112.54201488550743,112.08036335000031,109.79030569999996,111.05407160000004,113.66450000000015,115.97333333333331,148626496,191908535.2,64.77205513319245,1.5,2.75,1.5359386924154124,0.7744652724544375,0.0961356490213514,1.4058749119933085,1.3097392629719569,18.631541424885175,3.139611370868812,2284833165.0,2010-10-06,2010,2,279,10,0.67,115.94,116.53,115.19,2706
2010-10-07 13:30:00,116.5,116.53,115.19,115.89,106.78471894736843,113.15527176470587,112.10316335000029,109.80970569999994,111.15527160000003,113.91300000000015,111.89998631169516,113.71880732095494,114.50600000000007,116.50488519704271,112.50711480295746,112.10316335000029,109.80970569999994,111.15527160000003,113.91300000000015,115.87,164860000,192800641.6,63.933679744353135,1.5,2.75,1.521943071528597,0.8550801420154609,0.09122107499341814,1.4237656067137294,1.3325445317203113,17.607734985520874,0.9318846079180836,2119973165.0,2010-10-07,2010,3,280,10,1.16,115.86,116.86,115.61,2707
2010-10-08 13:30:00,116.05,116.86,115.61,116.53751000000001,106.86787657894736,113.15468323529413,112.12720090000029,109.85108089999994,111.28022200000004,114.16577600000014,112.08184998574636,113.98725519514971,114.70273153846163,116.94448398507893,112.46097909184431,112.12720090000029,109.85108089999994,111.28022200000004,114.16577600000014,116.33583666666668,177760064,195297697.6,66.11803164135188,1.5,2.75,1.5025185664194116,0.9102005102184062,0.11253277708022268,1.4732105030705895,1.3606777259903668,13.898781844551374,1.9843440973133817,2297733229.0,2010-10-08,2010,4,281,10,1.08,116.24,116.97,116.25,2708
2010-10-11 13:30:00,116.72,116.97,116.25,116.64998999999999,106.95103421052632,113.15409470588236,112.15070085000029,109.89998089999992,111.40782180000002,114.36227550000015,112.26099273140335,114.24084898608784,114.95119230769235,117.28334978489866,112.61903483048607,112.15070085000029,109.89998089999992,111.40782180000002,114.36227550000015,116.62333,103098320,191527441.6,66.49761745557407,1.5,2.75,1.4466243831037393,0.5382952914669957,0.11476455667467778,1.504133421833714,1.3893688651590363,13.328037406891385,1.7266852707770133,2400831549.0,2010-10-11,2010,0,284,10,0.62,116.61,117.35001000000001,115.64998999999999,2709
2010-10-12 13:30:00,116.27,117.35001000000001,115.64998999999999,117.00998999999999,107.03419184210527,113.15350617647059,112.17335080000029,109.99468089999996,111.49282180000002,114.58027550000016,112.44722791840714,114.50457670169851,115.29826846153853,117.39816636557998,113.19837055749709,112.17335080000029,109.99468089999996,111.49282180000002,114.58027550000016,116.66999666666668,182210000,190146763.2,67.74320548343987,1.5,2.75,1.4647240700249005,0.9582598038145306,0.12045499342526035,1.5399376069406117,1.419482613515351,13.31392537817239,2.2189132523805397,2583041549.0,2010-10-12,2010,1,285,10,1.47,116.5,118.55,117.38,2710
2010-10-13 13:30:00,117.66,118.55,117.38,117.92,107.1173494736842,113.15291764705884,112.19935080000026,110.08273079999996,111.60682180000002,114.82227550000015,112.6618464314108,114.82985511106057,115.5367292307693,118.03205566402922,113.04140279750938,112.19935080000026,110.08273079999996,111.60682180000002,114.82227550000015,117.95,194347120,191433703.2,70.70788535403854,1.5,2.75,1.4701016364516932,1.0152189335070023,0.1628407593593164,1.6230335627144967,1.4601928033551803,13.44496393967196,3.3207745553316452,2777388669.0,2010-10-13,2010,2,286,10,1.0,117.96,118.00998999999999,116.72,2711
2010-10-14 13:30:00,117.80991000000002,118.00998999999999,116.72,117.46001000000001,107.20050710526316,113.15232911764707,112.22384085000027,110.18023079999996,111.69662199999999,115.04277600000015,112.85000970861036,115.0803460528643,115.7821146153847,118.35703804487517,113.20719118589422,112.22384085000027,110.18023079999996,111.69662199999999,115.04277600000015,117.39666666666666,217764256,192323772.0,67.33882316063409,1.5,2.75,1.4572365195622865,1.1322794563326264,0.1382031683694127,1.632946763816946,1.4947435954475334,13.605354821589756,2.486702731000783,2559624413.0,2010-10-14,2010,3,287,10,1.11,117.36,118.35001000000001,116.75998999999999,2712
2010-10-15 13:30:00,118.28,118.35001000000001,116.75998999999999,117.7,107.28366473684211,113.1517405882353,112.24974085000022,110.27905089999996,111.79362179999998,115.30327550000014,113.04020540631191,115.32983690497248,116.0151915384616,118.69178593168623,113.33859714523695,112.24974085000022,110.27905089999996,111.79362179999998,115.30327550000014,117.60333333333334,243704944,194717178.4,68.19040951900861,1.5,2.75,1.4667210538792657,1.2515842002361308,0.11720427429189414,1.6412489383124012,1.5240446640205068,13.585050354852918,3.4725274725274753,2803329357.0,2010-10-15,2010,4,288,10,1.36,117.56,118.67,117.31,2713
2010-10-18 13:30:00,117.74001000000001,118.67,117.31,118.28,107.36682236842108,113.15115205882351,112.28394085000023,110.39015089999997,111.9113818,115.50677500000015,113.24568754724086,115.61080481878464,116.30826846153852,119.07669647558208,113.53984044749498,112.28394085000023,110.39015089999997,111.9113818,115.50677500000015,118.08666666666666,141502192,191052953.6,70.21184551701404,1.5,2.75,1.4590981214593182,0.7406438337313409,0.12101835329790522,1.6753176056428885,1.5542992523449832,11.951426442759384,1.930377622404137,2944831549.0,2010-10-18,2010,0,291,10,1.16,117.99,117.85001000000001,116.02,2714
2010-10-19 13:30:00,117.19,117.85001000000001,116.02,116.73,107.44998,113.15056352941177,112.30094085000023,110.44985099999997,111.98614179999998,115.64427500000015,113.38232725127064,115.71739483604324,116.50826846153852,118.9778765540269,114.03866036905012,112.30094085000023,110.44985099999997,111.98614179999998,115.64427500000015,116.86667,280604672,191651571.2,59.356184329583655,1.5,2.75,1.5163053984979389,1.464139689766342,0.0039773335632555815,1.5592709192990526,1.555293585735797,10.757467177322376,0.6032922520037945,2664226877.0,2010-10-19,2010,1,292,10,1.58,116.94,118.44,116.87,2715
2010-10-20 13:30:00,116.94,118.44,116.87,117.87,107.53313763157897,113.149975,112.32214085000022,110.53486099999996,112.09604179999998,115.86677500000015,113.55831441788747,115.92240485165816,116.75903769230776,119.06321552748908,114.45485985712645,112.32214085000022,110.53486099999996,112.09604179999998,115.86677500000015,117.72666666666667,200051744,192088040.0,63.7904968125105,1.5,2.75,1.5301407271766572,1.0414586144978104,-0.011017386532296669,1.5415218525704262,1.5525392391027228,11.934978169673665,1.7085166968677228,2864278621.0,2010-10-20,2010,2,293,10,1.34,117.66,119.09,117.21001000000001,2716
2010-10-21 13:30:00,118.39998999999999,119.09,117.21001000000001,118.13,107.61629526315792,113.14938647058823,112.34424080000024,110.64086099999994,112.2726418,116.14837500000013,113.7375962054213,116.13265200864309,117.0959607692308,118.72308868731994,115.46883285114166,112.34424080000024,110.64086099999994,112.2726418,116.14837500000013,118.14333666666666,221546128,193047633.6,64.73547766089122,1.5,2.75,1.5551299609497538,1.1476241581860034,-0.017399848281463903,1.5307894287508932,1.5481892770323569,11.804311402447702,1.3665042268364906,3085824749.0,2010-10-21,2010,3,294,10,1.6,118.15,118.53,118.0,2717
2010-10-22 13:30:00,118.31,118.53,118.0,118.34700000000001,107.69945289473684,113.1487979411765,112.36502580000023,110.72103099999997,112.46698179999996,116.32472450000016,113.91835713854204,116.34354229353424,117.27342307692312,118.90438689521429,115.64245925863196,112.36502580000023,110.72103099999997,112.46698179999996,116.32472450000016,118.29233333333332,108212320,187974665.6,65.54371691075946,1.5,2.75,1.4819063923104856,0.5756750233048427,-0.02075423592518177,1.5222464821258797,1.5430007180510614,11.573775402514364,1.4547879515463238,3194037069.0,2010-10-22,2010,4,295,10,0.45,118.26,119.75998999999999,118.61,2718
2010-10-25 13:30:00,119.14,119.75998999999999,118.61,118.7,107.7826105263158,113.14820941176471,112.38567575000026,110.80093089999997,112.67478179999996,116.54622450000015,114.10587254487372,116.56796683700718,117.47880769230775,119.10416289798367,115.85345248663185,112.38567575000026,110.80093089999997,112.67478179999996,116.54622450000015,119.02333,151145680,189091977.6,66.87378361123814,1.5,2.75,1.4769837928597371,0.7993235985914191,-0.013308337458954655,1.5263652962273682,1.5396736336863228,11.594715876456812,1.4443296679198083,3345182749.0,2010-10-25,2010,0,298,10,0.97,119.18,118.84,117.87,2719
2010-10-26 13:30:00,118.10001000000001,118.84,117.87,118.72,107.86576815789476,113.14762088235297,112.40562575000028,110.91993079999996,112.88398199999996,116.74872450000014,114.28681871958456,116.77292237633982,117.69650000000004,119.16262652941806,116.23037347058201,112.40562575000028,110.91993079999996,112.88398199999996,116.74872450000014,118.47666666666667,158982880,186580749.6,66.95162222872838,1.5,2.75,1.4407706647983272,0.8520861897105381,-0.02070430485491892,1.5137932526176743,1.534497557472593,11.592106964212318,0.6784260515603775,3504165629.0,2010-10-26,2010,1,299,10,0.82,118.36,118.50998999999999,117.25998999999999,2720
2010-10-27 13:30:00,117.89,118.50998999999999,117.25998999999999,118.38,107.94892578947369,113.1470323529412,112.42922575000028,111.04883069999994,113.05978199999998,116.94422450000015,114.44733563254202,116.92597738811699,117.83823000000004,119.1797264173877,116.4967335826124,112.42922575000028,111.04883069999994,113.05978199999998,116.94422450000015,118.04999333333336,190023936,187098659.2,64.19024391413043,1.5,2.75,1.442144903027018,1.015634942615345,-0.059942327081957465,1.4595696486201462,1.5195119757021036,11.07260278730206,0.7832367799049214,3314141693.0,2010-10-27,2010,2,300,10,1.07,117.88,119.11,117.83,2721
2010-10-28 13:30:00,119.06,119.11,117.83,118.39998999999999,108.03208342105265,113.14644382352941,112.44812570000029,111.16663059999992,113.23198199999996,117.15772400000013,114.60234168616782,117.06635954162964,117.97284538461544,119.15173980149332,116.79395096773754,112.44812570000029,111.16663059999992,113.23198199999996,117.15772400000013,118.44666333333336,168576000,181172131.2,64.28351608063882,1.5,2.75,1.4305631242393742,0.9304742339974196,-0.09397106894488294,1.4020481395209998,1.4960192084658828,10.736453641129524,0.5947238742565842,3482717693.0,2010-10-28,2010,3,301,10,1.09,118.47,118.72,118.07001000000001,2722
2010-10-29 13:30:00,118.28,118.72,118.07001000000001,118.49001000000001,108.11524105263159,113.14585529411764,112.46592580000029,111.29103069999994,113.44418219999996,117.35172450000013,114.75479926710241,117.20194529956969,118.08669307692313,119.15204907175692,117.0213370820893,112.46592580000029,111.29103069999994,113.44418219999996,117.35172450000013,118.42667333333333,144305504,179655475.2,64.72904795714659,1.5,2.75,1.374807901079419,0.8032346569975286,-0.11826756184617683,1.3481847561581617,1.4664523180043385,10.707342262313563,0.17755326344267575,3627023197.0,2010-10-29,2010,4,302,10,0.55,118.4,119.75,117.85001000000001,2723
2010-11-01 13:30:00,119.07001000000001,119.75,117.85001000000001,118.53,108.19839868421057,113.14526676470591,112.49037580000031,111.38483079999996,113.66418219999996,117.59072450000015,114.90284635466702,117.32842669961069,118.1336161538462,119.21901681087112,117.04821549682127,112.49037580000031,111.38483079999996,113.66418219999996,117.59072450000015,118.71000333333332,174074688,180051550.4,64.93828583528901,1.5,2.75,1.4123209081451749,0.9668047157232366,-0.13811364936163573,1.2938102563022935,1.4319239056639297,10.360483283807216,1.5420200462605989,3801097885.0,2010-11-01,2010,0,305,11,1.61,118.8,119.75,119.10001000000001,2724
2010-11-02 13:30:00,119.42,119.75,119.10001000000001,119.47501000000001,108.28155631578949,113.14467823529414,112.51245085000029,111.48278099999996,113.9112104,117.76247550000014,115.08214688977812,117.53286320440964,118.28861615384619,119.51173632598193,117.06549598171043,112.51245085000029,111.48278099999996,113.9112104,117.76247550000014,119.44167333333333,158345872,176487140.8,69.53726738036006,1.5,2.75,1.3985837004205195,0.8972091183654101,-0.0960588932456008,1.3118502891069284,1.4079091823525292,6.8766278470313775,1.3616781199626646,3959443757.0,2010-11-02,2010,1,306,11,0.55,119.43,120.02,118.45,2725
2010-11-03 13:30:00,119.675,120.02,118.45,119.95,108.36471394736843,113.14408970588237,112.54275085000029,111.58719099999996,114.19961039999998,117.95847550000013,115.27304309017894,117.76306670875161,118.46169307692313,119.91733238517365,117.0060537686726,112.54275085000029,111.58719099999996,114.19961039999998,117.95847550000013,119.47333333333334,226702752,180390953.6,71.55675159025266,1.5,2.75,1.4108277218190537,1.2567301601093148,-0.04718710806690996,1.3489252972688917,1.3961124053358016,5.206681277914125,1.5406755269618282,4186146509.0,2010-11-03,2010,2,307,11,1.33,119.24,122.32001000000001,119.9724,2726
2010-11-04 13:30:00,121.28,122.32001000000001,119.9724,122.25998999999999,108.44787157894741,113.14350117647058,112.59555080000028,111.68979089999996,114.5260102,118.27697500000014,115.54704100821115,118.19134511744193,118.76784615384621,121.25237921897836,116.28331308871405,112.59555080000028,111.68979089999996,114.5260102,118.27697500000014,121.51746666666666,215039312,182899919.2,78.88716506989148,1.5,2.75,1.4793407416891209,1.1757211973661714,0.12060848119425405,1.5468730068286192,1.4262645256343651,11.234273139663763,3.306370250196463,4401185821.0,2010-11-04,2010,3,308,11,1.96,121.15,122.92,122.17998999999999,2727
2010-11-05 13:30:00,122.34,122.92,122.17998999999999,122.72501000000001,108.53102921052631,113.14291264705885,112.66312580000029,111.79744089999994,114.87591040000001,118.58635000000014,115.8285299882813,118.62312272530458,119.22900076923081,122.20602261721108,116.25197892125051,112.66312580000029,111.79744089999994,114.87591040000001,118.58635000000014,122.60833333333336,180654128,183044622.4,80.00436449809031,1.5,2.75,1.4265314029970406,0.9869403735075256,0.2361305185203271,1.7214276737847742,1.4852971552644467,11.188390127591063,3.3909098567817986,4581839949.0,2010-11-05,2010,4,309,11,0.61,122.55,122.69,121.94,2728
2010-11-08 14:30:00,122.34,122.69,121.94,122.49001000000001,108.61418684210527,113.14232411764705,112.72672585000029,111.90094099999996,115.1885106,118.87835100000014,116.0897644985448,118.99139770384701,119.58438615384621,122.91023161501262,116.25854069267977,112.72672585000029,111.90094099999996,115.1885106,118.87835100000014,122.37333666666665,155901632,185684788.0,77.76487743385044,1.5,2.75,1.3807084456401093,0.839603683636163,0.2676208198710817,1.8198231801032991,1.5522023602322172,11.635676494188779,3.175547506738544,4425938317.0,2010-11-08,2010,0,312,11,0.62,122.32,122.95,121.12,2729
2010-11-09 14:30:00,122.82001000000001,122.95,121.12,121.61,108.69734447368424,122.95,112.78822585000029,111.99975099999996,115.5144906,119.10835150000014,116.30624432213129,119.24078839871872,119.85207846153853,123.22643238219723,116.4777245408798,112.78822585000029,111.99975099999996,115.5144906,119.10835150000014,121.89333333333332,186621568,185905366.4,69.87678123377363,1.5,2.75,1.4128006995229587,1.003852506325498,0.20301789012405425,1.805974722887285,1.6029568327632309,13.011409842446492,2.7285014360533912,4239316749.0,2010-11-09,2010,1,313,11,1.51,122.04,122.16,120.66,2730
2010-11-10 14:30:00,121.58,122.16,120.66,122.10001000000001,108.78050210526315,123.10030784615385,112.84957590000026,112.10665109999997,115.85029080000001,119.31735200000013,116.5334508193026,119.51309521788835,120.14077153846159,123.59196202481732,116.68958105210586,112.84957590000026,112.10665109999997,115.85029080000001,119.31735200000013,121.64000333333333,221387376,187257379.2,71.60400204444899,1.5,2.75,1.4190292209856046,1.1822624931834995,0.16854093403440704,1.81363300030624,1.645092066271833,12.584458217677007,3.1250171558291475,4460704125.0,2010-11-10,2010,2,314,11,1.24,121.41,121.82001000000001,120.67998999999999,2731
2010-11-11 14:30:00,121.05,121.82001000000001,120.67998999999999,121.63498999999999,108.86365973684212,123.25061569230768,112.91490080000023,112.22730089999996,116.11379040000001,119.52610100000015,116.73351117932995,119.71518043523231,120.36654000000006,123.79511064949844,116.93796935050165,112.91490080000023,112.22730089999996,116.11379040000001,119.52610100000015,121.37833,158017568,184270044.8,67.64027945700118,1.5,2.75,1.4190999909152038,0.8575325857846646,0.09342177124800323,1.7618692803318368,1.6684475090838335,13.11842688155495,2.6542153216123485,4302686557.0,2010-11-11,2010,3,315,11,0.94,121.25,121.35001000000001,119.64998999999999,2732
2010-11-12 14:30:00,120.82001000000001,121.35001000000001,119.64998999999999,120.198,108.94681736842108,123.40092353846156,112.97894080000027,112.3369809,116.32835039999999,119.65100100000015,116.86937348602291,119.7611632509245,120.48023230769238,123.7784061053994,117.18205850998535,112.97894080000027,112.3369809,116.32835039999999,119.65100100000015,120.39933333333332,239068816,184038238.4,57.11808361891614,1.5,2.75,1.4595214201355464,1.299017085136368,-0.06547505049854885,1.5866036959606475,1.6520787464591964,15.571748744646492,1.4072386737534734,4063617741.0,2010-11-12,2010,4,316,11,1.42,120.5,121.05,119.98,2733
2010-11-15 14:30:00,120.58,121.05,119.98,120.03,109.029975,123.5512313846154,113.03379080000023,112.46308089999998,116.5111504,119.73850100000016,116.99331962382591,119.78676675083643,120.60715538461544,123.69238815764758,117.52192261158329,113.03379080000023,112.46308089999998,116.5111504,119.73850100000016,120.35333333333335,163940688,185160163.2,56.02087033175224,1.5,2.75,1.4316984615544353,0.8853993492267564,-0.18741924378555289,1.417804691727255,1.6052239355128082,15.647863755988446,0.4645239201068103,3899677053.0,2010-11-15,2010,0,319,11,0.89,120.52,119.49001000000001,117.59,2734
2010-11-16 14:30:00,119.28998999999999,119.49001000000001,117.59,118.16,117.59,123.70153923076923,113.07269080000023,112.56600599999996,116.68155039999998,119.81000100000013,117.03907179544058,119.63183658409012,120.5886946153847,123.72891553601521,117.44847369475416,113.07269080000023,112.56600599999996,116.68155039999998,119.81000100000013,118.41333666666668,300332032,186146531.2,45.53548480429945,1.5,2.75,1.5037200000148323,1.6134172904748707,-0.3880002267802276,1.1202236520375235,1.508223878817751,17.695540524298465,-1.4922884535223062,3599345021.0,2010-11-16,2010,1,320,11,1.62,118.54,118.71001000000001,117.86,2735
2010-11-17 14:30:00,118.21001000000001,118.71001000000001,117.86,118.21799999999999,117.81931051724138,123.85184707692308,113.11463080000023,112.67288599999998,116.83771039999998,119.82740100000015,117.08530427405077,119.49718548084343,120.56777076923085,123.76672413161856,117.36881740684315,113.11463080000023,112.67288599999998,116.83771039999998,119.82740100000015,118.26267,172308816,184759384.8,45.87387096311409,1.5,2.75,1.4570264285852017,0.9326119817216452,-0.5034296527012709,0.8789368129411628,1.3823664656424337,17.441999203109095,-3.3060611243302067,3771653837.0,2010-11-17,2010,2,321,11,0.72,118.29,120.39,119.35001000000001,2736
2010-11-18 14:30:00,119.36,120.39,119.35001000000001,119.9575,118.04862103448276,124.00215492307692,113.18221830000023,112.83036089999996,117.01846039999998,119.91877600000014,117.19793940055857,119.54102495885834,120.67757846153853,123.68123795883076,117.6739189642463,113.18221830000023,112.83036089999996,117.01846039999998,119.91877600000014,119.89916999999998,197723680,183568262.4,54.9200208221954,1.5,2.75,1.5080959694005438,1.0771125542886872,-0.4509799113422557,0.8186415764646142,1.2696214878068701,15.61490815425585,-2.2550497245834418,3969377517.0,2010-11-18,2010,3,322,11,0.87,119.87,120.34,119.25,2737
2010-11-19 14:30:00,119.89998999999999,120.34,119.25,120.28998999999999,118.27793155172415,124.15246276923077,113.25036825000024,113.00106079999998,117.1946204,120.01592550000014,117.31919628681118,119.61235496277658,120.74026923076931,123.67412287446976,117.80641558706887,113.25036825000024,113.00106079999998,117.1946204,120.01592550000014,119.95999666666668,156852816,186000287.2,56.419324496317174,1.5,2.75,1.4782319715862198,0.8432934075598568,-0.3848204791294254,0.7885958888950881,1.1734163680245135,15.488556179848125,-1.7960811661293807,4126230333.0,2010-11-19,2010,4,323,11,0.91,119.8,120.24001000000001,118.77,2738
2010-11-22 14:30:00,119.69,120.24001000000001,118.77,120.19,118.50724206896551,124.30277061538462,113.32186825000024,113.17536089999996,117.34402039999998,120.09042550000015,117.43177682458328,119.66736877584549,120.75873076923084,123.67543100744189,117.84203053101984,113.32186825000024,113.17536089999996,117.34402039999998,120.09042550000015,119.73333666666667,181592192,187522612.8,55.81809048863597,1.5,2.75,1.4812146879014902,0.9683749031039524,-0.3402590445849072,0.7480925622933796,1.0883516068782868,15.503270120031114,-1.1676671326371202,3944638141.0,2010-11-22,2010,0,326,11,1.24,119.51,119.015,117.99001000000001,2739
2010-11-23 14:30:00,118.77,119.015,117.99001000000001,118.44748999999999,118.73655258620691,124.45307846153848,113.37800570000023,113.33783579999998,117.45997039999996,120.07680000000015,117.47160871381531,119.55118984481258,120.46546153846162,123.48428309059116,117.44663998633209,113.37800570000023,113.33783579999998,117.45997039999996,120.07680000000015,118.48416666666668,222308944,190688916.0,46.515270799883254,1.5,2.75,1.5325557816228124,1.1658199577787731,-0.4156170705730995,0.5688302686619124,0.984447339235012,16.94095653061148,-2.9914166264196007,3722329197.0,2010-11-23,2010,1,327,11,0.87,118.5,120.23,119.17998999999999,2740
2010-11-24 14:30:00,119.2,120.23,119.17998999999999,120.2,118.96586310344827,124.6033863076923,113.44395575000023,113.51113579999998,117.60237039999996,120.16780000000013,117.57860445052843,119.61298128816375,120.27123000000007,122.99393485324705,117.54852514675311,113.44395575000023,113.51113579999998,117.60237039999996,120.16780000000013,119.86999666666668,140159056,188195672.0,54.693671844504394,1.5,2.75,1.5504096543640402,0.7447517496576648,-0.3381966121811111,0.5617015740086231,0.8998981861897342,19.39572166203693,-1.1797509910593975,3862488253.0,2010-11-24,2010,2,328,11,0.88,119.7,119.81,118.8,2741
2010-11-26 14:30:00,119.16,119.81,118.8,118.8,119.19517362068966,124.75369415384615,113.49730575000022,113.63806079999996,117.71737039999996,120.18780050000015,117.62650231521359,119.53555449881485,119.98738307692317,122.48579984470794,117.48896630913835,113.49730575000022,113.63806079999996,117.71737039999996,120.18780050000015,119.13666666666668,76007680,183567256.0,48.33517950927286,1.5,2.75,1.539666107623752,0.4140590302226885,-0.3694910728233737,0.4380343451605171,0.8075254179838908,20.239948914764863,-1.163080916487792,3786480573.0,2010-11-26,2010,4,330,11,0.85,119.3,119.48,117.74001000000001,2742
2010-11-29 14:30:00,118.5,119.48,117.74001000000001,119.162,119.42448413793105,124.904002,113.5529158000002,113.75808079999996,117.85081019999996,120.22140000000016,117.68671791069542,119.49997787988009,119.79907538461546,122.14422913957544,117.4539216296555,113.5529158000002,113.75808079999996,117.85081019999996,120.22140000000016,118.79400333333336,223642256,187534093.6,49.95527494081149,1.5,2.75,1.5539749570791987,1.192541855759928,-0.35399656267778257,0.36502971463666256,0.7190262773144451,19.46915790086359,-0.7231525451970299,4010122829.0,2010-11-29,2010,0,333,11,1.48,118.61,119.17,117.81,2743
2010-11-30 14:30:00,117.98,119.17,117.81,118.49248999999999,119.65379465517242,125.05430984615386,113.59667820000023,113.86340559999996,117.93645979999997,120.21952450000015,117.71831681615835,119.40402665322485,119.52157384615394,121.54345019098524,117.49969750132263,113.59667820000023,113.86340559999996,117.93645979999997,120.21952450000015,118.49083,233930624,190526890.4,47.01864665150123,1.5,2.75,1.5401196030021131,1.2278089644400136,-0.3750096085527307,0.2502642666235317,0.6252738751762624,19.661886663031897,0.28138964116452864,3776192205.0,2010-11-30,2010,1,334,11,1.15,118.49,121.24001000000001,120.19,2744
2010-12-01 14:30:00,120.2,121.24001000000001,120.19,121.00998999999999,119.88310517241379,125.20461769230768,113.6504282000002,113.99320549999996,118.07705959999996,120.29627350000014,117.84740203905409,119.5569755433939,119.47349692307701,121.31362690013987,117.63336694601415,113.6504282000002,113.99320549999996,118.07705959999996,120.29627350000014,120.81333333333332,221037120,193661452.8,57.20573913198037,1.5,2.75,1.6263624885019616,1.1413583694854943,-0.21356108916720615,0.3583225137172548,0.5718836028844609,21.053652041280387,2.361730024192592,3997229325.0,2010-12-01,2010,2,335,12,0.87,120.72,122.64998999999999,121.13,2745
2010-12-02 14:30:00,121.2,122.64998999999999,121.13,122.56,120.1124156896552,125.35492553846156,113.70867820000024,114.12220549999996,118.25985959999996,120.42677350000015,118.03220980222844,119.84297787259449,119.65518923076931,122.10952253427521,117.20085592726345,113.70867820000024,114.12220549999996,118.25985959999996,120.42677350000015,122.11333,191213568,191886993.6,62.04467256446272,1.5,2.75,1.627336596466107,0.9964905094015709,-0.0074687963573344405,0.5625476074377929,0.5700164037951273,21.806871137813097,2.1695183710897656,4188442893.0,2010-12-02,2010,3,336,12,1.25,121.89,123.03,122.11,2746
2010-12-03 14:30:00,122.14,123.03,122.11,122.89,120.34172620689655,125.50523338461541,113.76742820000023,114.25459549999997,118.46769959999996,120.45827400000016,118.22271137861163,120.13317045615692,119.87518923076935,122.87629218110793,116.87408628043077,113.76742820000023,114.25459549999997,118.46769959999996,120.45827400000016,122.67666666666668,151288816,188699468.8,63.003819472517684,1.5,2.75,1.5768125538613853,0.801744790073304,0.13796048506431655,0.7424670101255231,0.6045065250612065,20.651800775915813,2.161451671913845,4339731709.0,2010-12-03,2010,4,337,12,0.75,122.57,123.03998999999999,122.5,2747
2010-12-06 14:30:00,122.63,123.03998999999999,122.5,122.75998999999999,120.57103672413794,125.65554123076923,113.8254281500002,114.38539549999996,118.62649919999996,120.46002300000013,118.40064387356806,120.38334374604672,120.2290346153847,123.41670449672294,117.04136473404648,113.8254281500002,114.38539549999996,118.62649919999996,120.46002300000013,122.76666000000002,103050432,184819284.0,62.3354829127358,1.5,2.75,1.5027538000141438,0.5575740245806817,0.2080725195582923,0.8645971745090719,0.6565246549507796,20.744189582057246,2.1382727348365123,4236681277.0,2010-12-06,2010,0,340,12,0.44,122.77,124.00998999999999,122.75998999999999,2748
2010-12-07 14:30:00,123.94,124.00998999999999,122.75998999999999,122.83,120.80034724137931,125.80584907692308,113.89052815000021,114.54709549999995,118.79769919999997,120.47702250000013,118.57434411382029,120.61635862737562,120.58380384615393,123.8233951143288,117.34421257797906,113.89052815000021,114.54709549999995,118.79769919999997,120.47702250000013,123.19999333333334,206580944,187353249.6,62.56576771317923,1.5,2.75,1.484699957155991,1.1026280272215785,0.23959234386871295,0.9560150847866709,0.7164227409179579,20.689032629458648,3.6999602102163553,4443262221.0,2010-12-07,2010,1,341,12,1.02,123.38,123.38,122.41,2749
2010-12-08 14:30:00,122.98,123.38,122.41,123.28,121.02965775862069,125.95615692307692,113.9528281000002,114.70699559999996,118.96989919999994,120.56052250000013,118.75887963876852,120.87003875810177,120.83938076923086,124.35360047761502,117.32516106084671,113.9528281000002,114.70699559999996,118.96989919999994,120.56052250000013,123.02333333333333,138019184,184923130.4,64.08574417278844,1.5,2.75,1.4479356745019911,0.7463597641974592,0.26897499187489715,1.0526414807615794,0.7836664888866822,17.718210979927253,2.5623960066555727,4581281405.0,2010-12-08,2010,2,342,12,0.79,122.9,124.02,123.14998999999999,2750
2010-12-09 14:30:00,123.97,124.02,123.14998999999999,123.75998999999999,121.25896827586209,126.10646476923077,114.0182780500002,114.85979549999998,119.15569899999993,120.64352150000013,118.95500161371878,121.14527220971114,121.10630384615392,124.92683786040848,117.28576983189942,114.0182780500002,114.85979549999998,119.15569899999993,120.64352150000013,123.64332666666668,123705056,180039014.4,65.68619089364236,1.5,2.75,1.4066552691804202,0.6871013841764287,0.29677865553993443,1.1546398083116003,0.8578611527716659,16.370175653338215,4.175075757575762,4704986461.0,2010-12-09,2010,3,343,12,0.71,123.58,124.60001000000001,123.73,2751
2010-12-10 14:30:00,124.14,124.60001000000001,123.73,124.48,121.48827879310345,126.25677261538462,114.08697800000022,115.03389539999998,119.36269899999992,120.78577200000014,119.17166821710235,121.46286533259577,121.43630384615393,125.60819046976029,117.26441722254759,114.08697800000022,115.03389539999998,119.36269899999992,120.78577200000014,124.27000333333336,117571632,178016717.6,67.99051744948852,1.5,2.75,1.368323464238961,0.6604527573875455,0.33677622549863273,1.2788314346449567,0.9420552091463241,13.477605004595196,4.462832110907837,4822558093.0,2010-12-10,2010,4,344,12,0.7,124.17,125.2,124.52,2752
2010-12-13 14:30:00,125.05,125.2,124.52,124.56,121.71758931034485,126.40708046153848,114.15032800000023,115.18488539999998,119.56169899999992,121.00387200000013,119.38297534584343,121.75783053901522,121.90649692307699,126.00210369021104,117.81089015594296,114.15032800000023,115.18488539999998,119.56169899999992,121.00387200000013,124.76,133812624,172753908.0,68.24567832052779,1.5,2.75,1.3220146453647494,0.7745852209606743,0.3407084368162097,1.367940755166586,1.0272323183503764,13.652476432321752,5.120586123221816,4956370717.0,2010-12-13,2010,0,347,12,0.55,124.86,125.23,124.28998999999999,2753
2010-12-14 14:30:00,124.75,125.23,124.28998999999999,124.67,121.94689982758621,126.55738830769229,114.21267800000021,115.3274854,119.78009899999994,121.23587200000013,119.59030964600643,122.03518001148994,122.25034307692316,126.46399518445294,118.03669096939336,114.21267800000021,115.3274854,119.78009899999994,121.23587200000013,124.72999666666668,147249568,171919352.0,68.61612808805253,1.5,2.75,1.2947285992672677,0.8565037401955773,0.32296743349349605,1.4309416102172463,1.1079741767237503,12.34746639594259,3.0245519398852934,5103620285.0,2010-12-14,2010,1,348,12,0.76,124.76,124.92998999999999,123.89,2754
2010-12-15 14:30:00,124.44,124.92998999999999,123.89,124.09801000000002,122.1762103448276,126.70769615384614,114.27166805000023,115.4528655,119.94125939999992,121.53277250000015,119.76708220890814,122.23164001039568,122.65788230769242,126.46286556089899,118.8528990544858,114.27166805000023,115.4528655,119.94125939999992,121.53277250000015,124.30599999999998,160823008,164943900.8,64.40838395101872,1.5,2.75,1.2765329850338916,0.9750163978176026,0.24831297516644255,1.4183653956818034,1.1700524205153608,8.363403422013421,1.2549037206266318,4942797277.0,2010-12-15,2010,2,349,12,0.84,124.41,124.91,123.75,2755
2010-12-16 14:30:00,124.17998999999999,124.91,123.75,124.82001000000001,122.40552086206895,126.858004,114.33256305000023,115.5855656,120.11705959999992,121.86287300000015,119.96523623993133,122.47815143797705,123.09311384615393,126.469239332001,119.71698836030683,114.33256305000023,115.5855656,120.11705959999992,121.86287300000015,124.49333666666666,185035184,165580219.2,67.14700259194812,1.5,2.75,1.2682092003886134,1.1174957062745574,0.22391323921013995,1.4499439695280358,1.2260307303178961,5.838915824908306,1.5705183497436697,5127832461.0,2010-12-16,2010,3,350,12,0.94,124.33,124.46001000000001,123.82001000000001,2756
2010-12-17 14:30:00,124.08,124.46001000000001,123.82001000000001,124.3,122.63483137931036,127.00831184615384,114.38281305000021,115.7202656,120.28525959999992,122.07999800000016,120.13522697562031,122.65166082483637,123.53984538461545,125.66953747143896,121.41015329779194,114.38281305000021,115.7202656,120.28525959999992,122.07999800000016,124.19334,141075248,162747797.6,63.36524118425967,1.5,2.75,1.2490514003608553,0.8668335306554097,0.15251874391422482,1.4166791602106767,1.264160416296452,6.726891287356142,1.2544885349045691,4986757213.0,2010-12-17,2010,4,351,12,0.52,124.14,124.89998999999999,123.98,2757
2010-12-20 14:30:00,124.64,124.89998999999999,123.98,124.60001000000001,122.86414189655173,127.1586196923077,114.43446310000022,115.86336580000001,120.44650959999994,122.29549900000015,120.31031650598814,122.83721788913765,123.81600076923084,125.43064906539259,122.2013524730691,114.43446310000022,115.86336580000001,120.44650959999994,122.29549900000015,124.49333333333334,119085440,160859428.8,64.60384469260407,1.5,2.75,1.2255470146207939,0.7403074901382467,0.10739560093623757,1.398404917466749,1.2910093165305114,6.6056659367403245,1.4410241797606442,5105842653.0,2010-12-20,2010,0,354,12,0.74,124.44,125.47,124.87,2758
2010-12-21 14:30:00,124.99001000000001,125.47,124.87,125.39,123.09345241379309,127.30892753846157,114.48911305000021,116.0145658,120.62130979999996,122.55549900000014,120.50951978026312,123.08033999493408,124.03369307692316,125.6751657793155,122.39222037453078,114.48911305000021,116.0145658,120.62130979999996,122.55549900000014,125.24333333333334,94965440,156528091.2,67.7005809981902,1.5,2.75,1.2001500850050228,0.6066990229802279,0.11212886496677577,1.4311703977389811,1.3190415327722054,7.116483206769082,1.7115509409474363,5200808093.0,2010-12-21,2010,1,355,12,0.48,125.17,125.82001000000001,125.41,2759
2010-12-22 14:30:00,125.48,125.82001000000001,125.41,125.78,123.32276293103449,127.45923538461538,114.5431630500002,116.14476589999998,120.79670999999996,122.92212450000015,120.7162052790763,123.33745047160706,124.25600076923084,125.99744056619082,122.51456097227086,114.5431630500002,116.14476589999998,120.79670999999996,122.92212450000015,125.67000333333333,78878064,149356547.2,69.13615586818841,1.5,2.75,1.145140078933235,0.5281192252949993,0.12208104179428435,1.4716428350150608,1.3495617932207764,7.078312149830606,1.6321995501130848,5279686157.0,2010-12-22,2010,2,356,12,0.33,125.62,125.78,125.28998999999999,2760
2010-12-23 14:30:00,125.64,125.78,125.28998999999999,125.60001000000001,123.55207344827585,127.60954323076923,114.59391310000021,116.278566,120.95031019999996,123.19212500000015,120.90772703283804,123.55293233145396,124.47446384615391,126.12033176533372,122.82859592697409,114.59391310000021,116.278566,120.95031019999996,123.19212500000015,125.55666666666669,70079248,145852556.8,67.64193225458746,1.5,2.75,1.098345073295147,0.4804800789066455,0.09812894491318168,1.4722229743622537,1.3740940294490718,7.218091844638387,0.8997509640102775,5209606909.0,2010-12-23,2010,3,357,12,0.39,125.53,125.77,125.03998999999999,2761
2010-12-27 14:30:00,125.13,125.77,125.03998999999999,125.64998999999999,123.78138396551724,127.75985107692308,114.64486300000021,116.4053659,121.11410979999997,123.53462450000015,121.09369812958948,123.75265210941072,124.69138615384621,126.14526643487615,123.23750587281627,114.64486300000021,116.4053659,121.11410979999997,123.53462450000015,125.48665999999996,58125968,144958471.2,67.84972368623313,1.5,2.75,1.0720354252026358,0.40098358873972456,0.06863440703716339,1.459887038245526,1.3912526312083626,6.680682398863909,0.8750722543352603,5267732877.0,2010-12-27,2010,0,361,12,0.58,125.4,125.95,125.5,2762
2010-12-28 14:30:00,125.89998999999999,125.95,125.5,125.83,124.01069448275862,127.91015892307692,114.69656295000021,116.5351658,121.27670979999996,123.86802450000015,121.27943545784088,123.95049476565731,124.88754000000004,126.20884284076818,123.56623715923192,114.69656295000021,116.5351658,121.27670979999996,123.86802450000015,125.76,55309008,136541808.8,68.63104587490214,1.5,2.75,1.0276043234024477,0.4050701282345983,0.04535390606259648,1.447945013786608,1.4025911077240116,6.683357854614473,0.9304564049089568,5323041885.0,2010-12-28,2010,1,362,12,0.36,125.72,126.2,125.89998999999999,2763
2010-12-29 14:30:00,125.98,126.2,125.89998999999999,125.92,124.24000500000001,128.06046676923077,114.74411295000021,116.67044579999998,121.42950979999996,124.23940000000015,121.4614183810628,124.13806669273758,125.0536946153847,126.30757387697624,123.7998153537931,114.74411295000021,116.67044579999998,121.42950979999996,124.23940000000015,126.00666333333334,58033040,127746929.6,69.03620920644697,1.5,2.75,0.9806325860165588,0.45428129021740504,0.021341046715948053,1.4292674161189467,1.4079263694029986,6.685255370295006,1.4681863149940917,5381074925.0,2010-12-29,2010,2,363,12,0.24,126.05,126.13,125.53,2764
2010-12-30 14:30:00,125.8,126.13,125.53,125.72,124.46931551724138,128.21077461538462,114.78721290000021,116.7977258,121.60930979999998,124.47490050000015,121.62842158180544,124.28872700771495,125.14907923076927,126.40253639942648,123.8956220621121,114.78721290000021,116.7977258,121.60930979999998,124.47490050000015,125.79333333333336,76616880,120525917.6,66.96626637960219,1.5,2.75,0.9534445441582328,0.6356880040878444,-0.020427809973305955,1.3823916069363662,1.4028194169096722,5.947632170309262,0.7210302258427976,5304458045.0,2010-12-30,2010,3,364,12,0.48,125.83,125.87,125.33,2765
2010-12-31 14:30:00,125.53,125.87,125.33,125.75,124.69862603448277,128.36108246153847,114.83077535000021,116.9314758,121.76690979999998,124.63440050000015,121.79005210800915,124.42789586412306,125.24061769230777,126.48237996373508,123.99885542088042,114.83077535000021,116.9314758,121.76690979999998,124.63440050000015,125.65,91270256,115528752.0,67.12549333853325,1.5,2.75,0.9239127910040736,0.7900220024881771,-0.05641156752953401,1.3323049574977546,1.3887165250272886,5.220665849901517,1.1665325824617885,5395728301.0,2010-12-31,2010,4,365,12,0.43,125.6,127.60001000000001,125.6969,2766
2011-01-03 14:30:00,126.71001000000001,127.60001000000001,125.6969,127.05,124.92793655172414,128.51139030769232,114.88617535000022,117.1089758,121.94530979999998,124.84240050000015,121.99632457436172,124.6776200675399,125.42369461538466,126.94522731516376,123.90216191560556,114.88617535000022,117.1089758,121.94530979999998,124.84240050000015,126.78230333333336,138725184,114900570.4,73.16234250888792,1.5,2.75,0.9938554487894968,1.2073498287872728,-0.005706002572023916,1.3815840218122588,1.3872900243842827,6.635985727270013,1.9662839513415769,5534453485.0,2011-01-03,2011,0,3,1,1.51,126.65,127.37,126.19,2767
2011-01-04 14:30:00,127.33,127.37,126.19,126.98,125.15724706896552,128.66169815384615,114.93811285000021,117.2924758,122.11796979999997,125.05340100000015,122.19176282634756,124.89689434682181,125.6453861538462,127.16951865993799,124.1212536477544,114.93811285000021,117.2924758,122.11796979999997,125.05340100000015,126.84666666666666,137409680,116618532.8,72.39147827263406,1.5,2.75,1.0071514881616759,1.1782833885901882,0.009259486487657842,1.3988643824938551,1.389604896006197,6.8144779869643894,1.2680437036446317,5397043805.0,2011-01-04,2011,1,4,1,0.94,126.78,127.72501000000001,126.46001000000001,2768
2011-01-05 14:30:00,126.58,127.72501000000001,126.46001000000001,127.64,125.38655758620692,128.812006,114.98926285000022,117.48577579999998,122.29676979999998,125.29390100000015,122.40541918609863,125.15814250426737,125.86230846153852,127.63693340773169,124.0876835153454,114.98926285000022,117.48577579999998,122.29676979999998,125.29390100000015,127.27500666666668,133975248,112988248.0,75.05970350122618,1.5,2.75,1.0255692390072706,1.1857449811948584,0.04760506305328294,1.4491112248228006,1.4015061617695177,6.571828969871138,1.4787724598505323,5531019053.0,2011-01-05,2011,2,5,1,1.0,127.09,127.83,127.00998999999999,2769
2011-01-06 14:30:00,127.69,127.83,127.00998999999999,127.39,125.61586810344828,128.96231384615385,115.0420128500002,117.67707589999998,122.47016979999998,125.49940100000015,122.60089294350651,125.3707003610038,126.10000076923085,127.80011560704894,124.39988593141277,115.0420128500002,117.67707589999998,122.47016979999998,125.49940100000015,127.40999666666664,122519008,112213239.2,72.21279036616178,1.5,2.75,1.0108864362210368,1.0918409349331035,0.0404121113911633,1.4520213010084717,1.4116091896173084,6.834642102517496,1.4251511604179037,5408500045.0,2011-01-06,2011,3,6,1,0.65,127.42,127.77,126.14998999999999,2770
2011-01-07 14:30:00,127.56,127.77,126.14998999999999,127.14,125.84517862068968,129.1126216923077,115.09446290000021,117.85257589999998,122.64536979999998,125.66840150000013,122.7788971418004,125.53920508852724,126.29538461538469,127.83752319815723,124.75324603261215,115.09446290000021,117.85257589999998,122.64536979999998,125.66840150000013,127.01999666666664,156034560,113829714.4,69.37892244356102,1.5,2.75,1.054395262205248,1.3707717780235418,0.004961451499309932,1.4178110039914458,1.4128495524921358,6.917824890568245,1.1858417179340786,5252465485.0,2011-01-07,2011,4,7,1,1.28,126.96,127.16,126.2,2771
2011-01-10 14:30:00,126.58,127.16,126.2,126.98,126.07448913793104,129.26292953846158,115.14645290000021,118.02447599999998,122.81696999999998,125.79340150000013,122.9436462734945,125.67642365152464,126.41769230769238,127.9044160955842,124.93096851980057,115.14645290000021,118.02447599999998,122.81696999999998,125.79340150000013,126.78,122401632,114071214.4,67.55180241955459,1.5,2.75,1.0476527434763012,1.0730282187650664,-0.04060992870515934,1.3620871416106866,1.402697070315846,7.053457388158691,0.9139314948740408,5130063853.0,2011-01-10,2011,0,10,1,0.76,126.68,127.74001000000001,126.95,2772
2011-01-11 14:30:00,127.44,127.74001000000001,126.95,127.42998999999999,126.30379965517241,129.4132373846154,115.1970028000002,118.21997590000001,122.99576959999996,125.93690100000015,123.11958132159278,125.84342997042705,126.54461461538472,128.07304310644116,125.01618612432823,115.1970028000002,118.21997590000001,122.99576959999996,125.93690100000015,127.37333333333332,110286944,112894930.4,69.94880671402169,1.5,2.75,1.0292496903708508,0.9768989945716818,-0.051115158282988515,1.3388031224621102,1.3899182807450987,7.196544234491117,1.1991661372299889,5240350797.0,2011-01-11,2011,1,11,1,0.62,127.35,128.72,127.4621,2773
2011-01-12 14:30:00,128.21001,128.72,127.4621,128.58,126.53311017241379,129.56354523076922,115.25290285000021,118.43047589999998,123.19676959999997,126.13240100000013,123.33371538741264,126.10405568752924,126.77384461538469,128.54191327457482,125.00577595619455,115.25290285000021,118.43047589999998,123.19676959999997,126.13240100000013,128.25403333333335,107929120,110928908.0,75.02625340639588,1.5,2.75,1.0478754267729324,0.9729575630547088,0.005699240312169175,1.3970423311353102,1.3913430908231408,8.422680857427144,2.274896595609301,5348279917.0,2011-01-12,2011,2,12,1,0.99,128.09,128.69,128.05,2774
2011-01-13 14:30:00,128.63,128.69,128.05,128.36749,126.76242068965516,129.71385307692307,115.30974030000021,118.6429148,123.37461919999996,126.34587500000013,123.53111831339645,126.31962086014549,126.98288307692316,128.81156999068324,125.15419616316306,115.30974030000021,118.6429148,123.37461919999996,126.34587500000013,128.36916333333332,129229120,109349213.6,72.5856519264311,1.5,2.75,1.018741467717722,1.1818020061188623,0.014764139966178647,1.4097982657808643,1.3950341258146857,8.433048218374108,2.081502982107359,5219050797.0,2011-01-13,2011,3,13,1,0.5,128.37,129.33,128.10001,2775
2011-01-14 14:30:00,128.19,129.33,128.10001,129.3,126.99173120689656,129.86416092307692,115.3672403000002,118.88061479999996,123.56161919999997,126.56987450000015,123.75734896777307,126.6034664925126,127.24980615384622,129.32396806519264,125.17564424249984,115.3672403000002,118.88061479999996,123.56161919999997,126.56987450000015,128.91000333333335,117677872,105981348.0,76.23838819672534,1.5,2.75,1.0338306485950286,1.1103639859345815,0.06646423268953461,1.4781144166766043,1.4116501839870694,8.819368713918065,1.770956316410873,5336728669.0,2011-01-14,2011,4,14,1,0.96,128.72,129.64,129.03,2776
2011-01-18 14:30:00,129.17999,129.64,129.03,129.52,127.22104172413792,130.01446876923077,115.42104035000023,119.11641479999996,123.7068194,126.83087450000014,123.98333528276235,126.88123158846378,127.52672923076929,129.77106928641123,125.28238917512738,115.42104035000023,119.11641479999996,123.7068194,126.83087450000014,129.39666666666665,114401248,104647648.0,77.01644527853232,1.5,2.75,1.0035570308382398,1.0932041970021151,0.0965548250795405,1.532343715336495,1.4357888902569544,7.415091168922633,2.0003150102378378,5451129917.0,2011-01-18,2011,1,18,1,0.47,129.33,129.53571000000002,127.91,2777
2011-01-19 14:30:00,129.41,129.53571000000002,127.91,128.25,127.45035224137929,130.16477661538462,115.46709040000022,119.34661479999995,123.8173192,127.01337400000013,124.15065546775206,127.01159048480056,127.72134461538471,129.73184976405372,125.71083946671568,115.46709040000022,119.34661479999995,123.8173192,127.01337400000013,128.56523666666666,151958320,106291292.0,63.990312067567814,1.5,2.75,1.0479965286355082,1.429640350970614,0.016215215665059457,1.4560579098382789,1.4398426941732194,10.011516918406695,0.4779066123472262,5299171597.0,2011-01-19,2011,2,19,1,1.27,128.72,128.39999,127.13,2778
2011-01-20 14:30:00,127.96001000000001,128.39999,127.13,128.08,127.6796627586207,130.31508446153848,115.51569040000021,119.55881479999996,123.92911899999996,127.14787400000013,124.30474741019316,127.11334377196242,127.90057538461544,129.56113617929682,126.24001458993406,115.51569040000021,119.55881479999996,123.92911899999996,127.14787400000013,127.86999666666668,175745632,110330301.6,62.46726124753026,1.5,2.75,1.0638532051615441,1.5929044827336898,-0.05896589732861667,1.3661353225124486,1.4251012198410653,9.708018347973725,0.5416437710966417,5123425965.0,2011-01-20,2011,3,20,1,1.0,127.76,129.17,128.23,2779
2011-01-21 14:30:00,128.88,129.17,128.23,128.37,127.90897327586208,130.4653923076923,115.5636778500002,119.78940479999996,124.06431899999998,127.27737400000014,124.46416908038168,127.23302531748979,128.00211384615392,129.60255630536335,126.40167138694449,115.5636778500002,119.78940479999996,124.06431899999998,127.27737400000014,128.59,151462880,113959542.4,64.039642743146,1.5,2.75,1.0657208333642891,1.3290934379883923,-0.0974821259646641,1.3032485623852352,1.4007306883498991,9.643561805326492,0.9674374705049584,5274888845.0,2011-01-21,2011,4,21,1,0.73,128.7,129.25,128.25999,2780
2011-01-24 14:30:00,128.285,129.25,128.25999,129.10001,128.13828379310345,130.61570015384615,115.61142790000021,120.02730489999998,124.20431899999998,127.45237400000013,124.64596676350395,127.4108333824908,128.16519153846158,129.74774401650728,126.58263906041587,115.61142790000021,120.02730489999998,124.20431899999998,127.45237400000013,128.87,113715440,116141352.0,67.70713905375533,1.5,2.75,1.060312916695412,0.979112418116159,-0.08269583931195568,1.2973608892099548,1.3800567285219103,9.845192139788256,1.6695621357694073,5388604285.0,2011-01-24,2011,0,24,1,0.77,128.75,129.28,128.11,2781
2011-01-25 14:30:00,128.75999,129.28,128.11,129.17,128.36759431034486,130.766008,115.65857785000021,120.23440479999998,124.3550192,127.62837450000013,124.82337983160186,127.5783730603488,128.2828838461539,129.91838233851996,126.64738535378784,115.65857785000021,120.23440479999998,124.3550192,127.62837450000013,128.85333333333332,167552128,121612660.0,68.04364657163539,1.5,2.75,1.0681477083600244,1.3777523491386503,-0.07720814422459865,1.283546548241162,1.3607546924657608,9.712168280460489,1.365463498820006,5556156413.0,2011-01-25,2011,1,25,1,0.91,128.7,130.05,129.23,2782
2011-01-26 14:30:00,129.49001,130.05,129.23,129.67,128.5969048275862,130.91631584615385,115.70777785000018,120.43640479999998,124.54445919999998,127.82037450000013,125.01344336761744,127.77757562602986,128.45826846153852,130.16077814963324,126.75575877344379,115.70777785000018,120.43640479999998,124.54445919999998,127.82037450000013,129.64999999999998,141281440,125911281.6,70.41541571165689,1.5,2.75,1.05470858633431,1.1220713362987484,-0.050218093634680105,1.2979820754224107,1.3482001690570908,9.736315901146076,0.8477212630268898,5697437853.0,2011-01-26,2011,2,26,1,0.63,129.64,130.21001,129.47,2783
2011-01-27 14:30:00,129.7,130.21001,129.47,129.99001,128.8262153448276,131.0666236923077,115.7517779000002,120.6274049,124.7436594,128.02387500000015,125.20860284339714,127.98828366164608,128.67750000000004,130.37852601171994,126.97647398828009,115.7517779000002,120.6274049,124.7436594,128.02387500000015,129.89000666666666,123302624,129174760.8,71.85518159405005,1.5,2.75,1.0322301158818599,0.9545411443873948,-0.022537730353539898,1.320028006115166,1.3425657364687058,8.619401422660161,1.2639648870598066,5820740477.0,2011-01-27,2011,3,27,1,0.57,129.84,130.35001,127.50998999999999,2784
2011-01-28 14:30:00,130.14,130.35001,127.50998999999999,127.72,129.05552586206898,131.21693153846158,115.7839279500002,120.80820489999998,124.9348594,128.12387500000014,125.3070890064012,127.96273283672741,128.73442307692312,130.24306666269288,127.22577949115336,115.7839279500002,120.80820489999998,124.9348594,128.12387500000014,128.52666666666667,295637248,140125779.2,52.38133078042878,1.5,2.75,1.1613579647474412,2.1097991368029447,-0.16111340042860345,1.1411739859329515,1.302287386361555,13.783598268771614,-1.2219644238205818,5525103229.0,2011-01-28,2011,4,28,1,2.23,128.93,128.78,127.75,2785
2011-01-31 14:30:00,128.07001,128.78,127.75,128.67999,129.28483637931035,131.3672393846154,115.8305279000002,120.9909048,125.14409920000001,128.27037450000014,125.43935963360113,128.03104304275334,128.83057692307696,130.14068470182647,127.52046914432744,115.8305279000002,120.9909048,125.14409920000001,128.27037450000014,128.40332999999998,149249120,143024722.4,57.61310478541512,1.5,2.75,1.1541181101226243,1.0435197320823466,-0.19013250152541936,1.0646217594547809,1.2547542609802,13.835539503833747,-0.6485562075355208,5674352349.0,2011-01-31,2011,0,31,1,0.81,128.26,130.97,129.3801,2786
2011-02-01 14:30:00,129.46001,130.97,129.3801,130.74001,129.51414689655172,131.51754723076922,115.88517795000021,121.1891049,125.3597494,128.45487500000013,125.6472282754207,128.28903989582452,128.99673153846157,130.64247130889498,127.35099176802817,115.88517795000021,121.1891049,125.3597494,128.45487500000013,130.36337,167194192,144448172.8,66.19592773815317,1.5,2.75,1.2352532451138651,1.1574683760901128,-0.07832774325865488,1.156844581906881,1.2351723251655362,16.735290623127373,1.9415282651072219,5841546541.0,2011-02-01,2011,1,32,2,1.23,130.18,130.84,130.33,2787
2011-02-02 14:30:00,130.39999,130.84,130.33,130.485,129.7434574137931,131.66785507692308,115.93320295000021,121.379135,125.5636496,128.63012500000013,125.8369448136395,128.49817895336503,129.15961692307698,130.93782515636525,127.3814086897887,115.93320295000021,121.379135,125.5636496,128.63012500000013,130.55166666666668,118323632,143493870.4,64.45599553548139,1.5,2.75,1.1834494418914456,0.8245901491831249,-0.031679589828127463,1.195572837880377,1.2272524277085044,15.438071705595254,1.8777326670830736,5723222909.0,2011-02-02,2011,2,33,2,0.39,130.58,130.98,129.57001,2788
2011-02-03 14:30:00,130.25999,130.98,129.57001,130.78,129.9727679310345,131.81816292307693,115.98380295000021,121.559735,125.7754496,128.78712500000015,126.0307901150654,128.7154952435207,129.27346307692312,131.2513423835847,127.29558377026156,115.98380295000021,121.559735,125.7754496,128.78712500000015,130.44333666666668,145886624,144089439.2,65.58299476439174,1.5,2.75,1.1996309103277707,1.0124727031347902,0.006856850168687423,1.2358234904193637,1.2289666402506765,15.315457960595689,1.8773856820129289,5869109533.0,2011-02-03,2011,3,34,2,1.09,130.28,131.2,130.23,2789
2011-02-04 14:30:00,130.83,131.2,130.23,131.14999,130.20207844827587,131.96847076923078,116.0344529000002,121.744735,126.02949960000001,128.97512450000016,126.2315430517295,128.94735188699494,129.39884692307695,131.61558185509978,127.18211199105421,116.0344529000002,121.744735,126.02949960000001,128.97512450000016,130.85999666666666,134634688,144695223.2,66.99641415894575,1.5,2.75,1.1832287024472157,0.9304708546867912,0.043058939933336315,1.2827903151673468,1.2397313752340104,15.3212184765131,1.5879007290549436,6003744221.0,2011-02-04,2011,4,35,2,0.74,130.71,132.39999,131.42999,2790
2011-02-07 14:30:00,131.44,132.39999,131.42999,131.97,130.43138896551724,132.11877861538463,116.08524040000022,121.93363500000001,126.2648996,129.21662450000014,126.45658057911264,129.23522313585258,129.6850007692308,132.17786481876914,127.19213671969248,116.08524040000022,121.93363500000001,126.2648996,129.21662450000014,131.93332666666666,112439008,142515445.6,69.94261907261031,1.5,2.75,1.1879980808438428,0.7889601546458626,0.10452121586695684,1.3703828950677064,1.2658616792007495,15.371790722631246,2.167685995200133,6116183229.0,2011-02-07,2011,0,38,2,0.74,131.91,132.64,131.73,2791
2011-02-08 14:30:00,132.09,132.64,131.73,132.57001,130.66069948275862,132.26908646153842,116.1413404000002,122.1288351,126.5402998,129.49612500000015,126.69632290934355,129.55282188481897,130.0303861538462,132.77001966456962,127.29075264312277,116.1413404000002,122.1288351,126.5402998,129.49612500000015,132.3133366666667,99072688,141348998.4,71.91801284638414,1.5,2.75,1.1681410750692824,0.7009083129095592,0.16431602202081064,1.4712567067267628,1.306940684705952,15.385128104232715,2.236454075730708,6215255917.0,2011-02-08,2011,1,39,2,0.69,132.18,132.63,131.61,2792
2011-02-09 14:30:00,132.21001,132.63,131.61,132.269,130.89001000000002,132.4193943076923,116.21028540000022,122.326625,126.80243980000002,129.73807550000012,126.91485926583988,129.8115055148362,130.33030923076927,133.1302148862076,127.53040357533095,116.21028540000022,122.326625,126.80243980000002,129.73807550000012,132.16966666666667,146436624,143156482.4,69.45200501345667,1.5,2.75,1.1575595697071894,1.022912979873554,0.16205564697126906,1.5095102434200385,1.3474545964487694,15.60143218618136,1.7532039577502865,6068819293.0,2011-02-09,2011,2,40,2,0.78,132.12,132.47,131.3,2793
2011-02-10 14:30:00,131.60001,132.47,131.3,132.321,131.1193205172414,132.56970215384615,116.2749904000002,122.50773490000002,127.07901,129.92512550000012,127.12686478482655,130.0505049896137,130.57807769230774,133.4672850237077,127.6888703609078,116.2749904000002,122.50773490000002,127.07901,129.92512550000012,132.03033333333335,162708496,145895451.2,69.64564049924,1.5,2.75,1.1584481718709607,1.1152403632992776,0.14317769505158884,1.5264267152632556,1.3832490202116667,15.623323136113804,3.6024115252113997,6231527789.0,2011-02-10,2011,3,41,2,0.89,131.88,133.28,131.77,2794
2011-02-11 14:30:00,131.8,133.28,131.77,133.11,131.34863103448276,132.72001,116.3362529000002,122.69903490000002,127.32101020000002,130.16225100000014,127.36149753836277,130.34188546679334,130.8811546153847,133.93771182747594,127.8245974032934,116.3362529000002,122.69903490000002,127.32101020000002,130.16225100000014,132.72,137716432,146319816.8,72.49455405820643,1.5,2.75,1.1835590167373202,0.9412015064797428,0.1615810686243644,1.5852253559921223,1.4236442873677582,9.636903898006377,3.4426564689661614,6369244221.0,2011-02-11,2011,4,42,2,1.15,132.52,133.53999,132.88,2795
2011-02-14 14:30:00,133.03,133.53999,132.88,133.42999,131.57794155172414,132.87031784615385,116.4093403500002,122.8991348,127.53841000000001,130.36875050000015,127.59947763489755,130.63599066043207,131.17038461538465,134.41930992304393,127.92145930772536,116.4093403500002,122.8991348,127.53841000000001,130.36875050000015,133.28332666666665,101691120,145520479.2,73.57766628587031,1.5,2.75,1.146161229827511,0.6988096834139618,0.17208752105668124,1.6387536886886096,1.4666661676319284,9.429375669780233,2.057503284572176,6470935341.0,2011-02-14,2011,0,45,2,0.5,133.21,133.22,132.3167,2796
2011-02-15 14:30:00,133.02,133.22,132.3167,133.00999,131.80725206896548,133.0206256923077,116.47264025000023,123.1042547,127.7408098,130.54325000000009,127.81165459039177,130.86208583562902,131.40269076923082,134.71210529695028,128.09327624151138,116.47264025000023,123.1042547,127.7408098,130.54325000000009,132.84889666666666,119575376,145779185.6,69.69818378771348,1.5,2.75,1.143813284839832,0.8202499932198826,0.12947691539070516,1.6285123118703098,1.4990353964796046,6.133266337994112,1.9350806606123108,6351359965.0,2011-02-15,2011,1,46,2,0.68,132.77,134.00999,133.19,2797
2011-02-16 14:30:00,133.46001,134.00999,133.19,133.85001,132.0365625862069,133.17093353846158,116.5542903000002,123.29455470000002,127.9626102,130.82325050000014,128.04845284174894,131.14665004175959,131.87423000000007,134.6550074006251,129.09345259937504,116.5542903000002,123.29455470000002,127.9626102,130.82325050000014,133.6833333333333,130183440,144690441.6,72.78851514061617,1.5,2.75,1.1335409073512728,0.8997376644954549,0.1359237137997249,1.6689400387292608,1.533016324929536,6.151811760747012,2.347461385532953,6481543405.0,2011-02-16,2011,2,47,2,0.62,133.6,134.42999,133.34,2798
2011-02-17 14:30:00,133.46001,134.42999,133.34,134.25,132.26587310344829,133.32124138461538,116.64144025000022,123.49435470000002,128.1910102,131.13175050000012,128.2916507695235,131.44220718063966,132.30269230769235,134.66820894797786,129.93717566740685,116.64144025000022,123.49435470000002,128.1910102,131.13175050000012,134.00666333333334,109810432,141393681.6,74.14088131216494,1.5,2.75,1.1304301282547533,0.7766289890566086,0.1443893066096833,1.71350295819164,1.5691136515819566,6.1534746129289095,2.3637134856052957,6591353837.0,2011-02-17,2011,3,48,2,0.82,133.88,134.69,134.06,2799
2011-02-18 14:30:00,134.37,134.69,134.06,134.53,132.49518362068966,134.69,116.74938025000021,123.69295470000004,128.4160102,131.43975050000014,128.53629191581672,131.73628268724536,132.59423000000004,135.0499876172853,130.1384723827148,116.74938025000021,123.69295470000004,128.4160102,131.43975050000014,134.42666666666668,130002320,140320653.6,75.07472792196019,1.5,2.75,1.0946851190936993,0.9264660380686824,0.1456898863575713,1.7512260095289207,1.6055361231713494,6.159073815436895,1.9398348109418824,6721356157.0,2011-02-18,2011,4,49,2,0.47,134.38,134.56149,131.47,2800
2011-02-22 14:30:00,133.12,134.56149,131.47,131.83,132.72449413793103,134.85771428571428,116.85223030000023,123.86655470000004,128.57741040000002,131.57625000000013,128.66545693872584,131.74520814560296,132.69769153846158,134.88829829135958,130.5070847855636,116.85223030000023,123.86655470000004,128.57741040000002,131.57625000000013,132.62049666666667,233116368,146290700.0,54.59908292201112,1.5,2.75,1.2373140391584343,1.593514611660208,-0.04807729870964428,1.5454394997842942,1.5935167984939382,14.048972450404511,-0.5582031712903875,6488239789.0,2011-02-22,2011,1,53,2,2.35,133.02,132.07001,130.21001,2801
2011-02-23 14:30:00,131.75,132.07001,130.21001,131.02,132.9538046551724,135.02542857142856,116.92653030000022,124.03545470000005,128.7082104,131.66875000000013,128.7577919607366,131.67614070316458,132.71615307692312,134.8449765596032,130.58732959424304,116.92653030000022,124.03545470000005,128.7082104,131.66875000000013,131.10000666666667,227610128,149293600.0,50.17767769797372,1.5,2.75,1.2817916077899738,1.5245806116270222,-0.2332266211418765,1.3019835220665923,1.5352101432084688,14.096806222568176,-0.9442877771813464,6260629661.0,2011-02-23,2011,2,54,2,1.43,131.14,131.44,129.7,2802
2011-02-24 14:30:00,130.88,131.44,129.7,130.92999,133.18311517241378,135.19314285714285,117.00203025000023,124.19865460000004,128.83561020000002,131.73174950000015,128.84297619757047,131.60507873143465,132.69923000000003,134.88043850717474,130.5180214928253,117.00203025000023,124.19865460000004,128.83561020000002,131.73174950000015,130.68999666666664,260467056,155252880.8,49.69607656352042,1.5,2.75,1.3145207786621191,1.677695477583692,-0.35678895038501723,1.0892239552271974,1.4460129056122146,14.081053748457023,-1.0512390323531369,6000162605.0,2011-02-24,2011,3,55,2,1.34,130.57,132.41,131.39999,2803
2011-02-25 14:30:00,131.48,132.41,131.39999,132.33,133.41242568965518,135.36085714285713,117.07643025000023,124.38445460000004,128.98881020000002,131.84874900000014,128.9797222290383,131.67411885225036,132.72692230769232,134.8793459478963,130.57449866748829,117.07643025000023,124.38445460000004,128.98881020000002,131.84874900000014,132.04666333333333,141693808,156172440.0,56.66327377230174,1.5,2.75,1.3263414373291105,0.9072907358046016,-0.3393696143290814,1.0218008877008629,1.3611705020299445,15.597730354986945,-0.5859815190444002,6141856413.0,2011-02-25,2011,4,56,2,0.77,131.9,133.32001,132.38,2804
2011-02-28 14:30:00,132.82001,133.32001,132.38,133.14999,133.64173620689655,135.52857142857144,117.16223015000023,124.55555460000004,129.16984979999998,132.12024850000014,129.14326214162503,131.81467800917892,132.7715361538462,134.93312418289858,130.60994812479382,117.16223015000023,124.55555460000004,129.16984979999998,132.12024850000014,132.95000000000002,141600752,148470615.2,60.145048223722455,1.5,2.75,1.3023177632341727,0.953729138989922,-0.2707408814816019,1.0227444001779418,1.2934852816595437,15.630554489781675,-0.2098478760284709,6283457165.0,2011-02-28,2011,0,59,2,0.71,132.85,133.69,130.89,2805
2011-03-01 14:30:00,133.57001,133.69,130.89,130.92999,133.87104672413793,135.69628571428572,117.24743010000023,124.70455450000004,129.2920494,132.23274850000013,129.21332990077698,131.7304220083047,132.66853538461544,135.03407872533677,130.3029920438941,117.24743010000023,124.70455450000004,129.2920494,132.23274850000013,131.83666333333335,258582256,153937272.0,48.73016405355072,1.5,2.75,1.4092950658603038,1.679789778267605,-0.3670007089904641,0.8347343954214637,1.2017351044119278,18.230155665696348,-1.5637923136450012,6024874909.0,2011-03-01,2011,1,60,3,2.14,132.29,131.82001,130.35001,2806
2011-03-02 14:30:00,130.75,131.82001,130.35001,131.21001,134.1003572413793,135.864,117.33373015000024,124.85775460000006,129.4302496,132.25624850000014,129.29163108113866,131.68085895989478,132.5830746153847,135.06983364974386,130.0963155810255,117.33373015000024,124.85775460000006,129.4302496,132.25624850000014,131.12667666666667,200277808,155591452.8,50.01870983678444,1.5,2.75,1.4136311325845683,1.2872031489894282,-0.4011814877387141,0.700258244738535,1.1014397324772491,18.348253890005495,-1.9723569688190437,6225152717.0,2011-03-02,2011,2,61,3,1.13,131.09,133.62,132.39,2807
2011-03-03 14:30:00,132.39999,133.62,132.39,133.47,134.3296677586207,136.03171428571432,117.4390802000002,125.02707950000006,129.6076494,132.40549850000014,129.45548868579988,131.8512533446667,132.610766923077,135.12820891873434,130.09332492741964,117.4390802000002,125.02707950000006,129.6076494,132.40549850000014,133.16,176485184,158499530.4,58.979410557011484,1.5,2.75,1.4847996231142413,1.1134744914045498,-0.2673890749015324,0.7672033888503336,1.034592463751866,20.85958887663229,-0.5810055865921796,6401637901.0,2011-03-03,2011,3,62,3,0.93,133.0,133.63,131.60001,2808
2011-03-04 14:30:00,133.37,133.63,131.60001,132.47,134.55897827586207,136.19942857142857,117.54263025000023,125.18527960000004,129.7492494,132.48999850000013,129.5737048157685,131.91018159755555,132.5369215384616,135.00983443941314,130.06400863751006,117.54263025000023,125.18527960000004,129.7492494,132.48999850000013,132.56667000000002,277371392,165073768.8,54.33734676309887,1.5,2.75,1.5237417928917951,1.6802875103436783,-0.2427634512024971,0.7311381497487446,0.9739016009512416,21.12602098669189,-1.5312569687058666,6124266509.0,2011-03-04,2011,4,63,3,1.54,132.62,133.15939,130.735,2809
2011-03-07 14:30:00,132.86,133.15939,130.735,131.42999,134.78828879310345,136.36714285714285,117.66208025000023,125.32947960000006,129.86224919999998,132.50399850000014,129.64650031318936,131.86444906445502,132.41538307692315,134.93815274495063,129.89261340889567,117.66208025000023,125.32947960000006,129.86224919999998,132.50399850000014,131.77479333333335,216888944,169186481.6,49.93543146202855,1.5,2.75,1.5880738076852376,1.281951973638064,-0.2898524096273756,0.6115860889170222,0.9014384985443976,21.30879916918556,-0.3034286581203132,5907377565.0,2011-03-07,2011,0,66,3,1.85,131.95,133.0,131.07001,2810
2011-03-08 14:30:00,131.64,133.0,131.07001,132.58,135.01759931034482,136.53485714285713,117.77940520000023,125.47607960000003,130.001849,132.53449850000013,129.7615395165937,131.93259677260215,132.31769000000006,134.70541922260628,129.92996077739383,117.77940520000023,125.47607960000003,130.001849,132.53449850000013,132.21667000000002,174706432,172299852.8,54.340227299249136,1.5,2.75,1.6124963928505782,1.0139673897620416,-0.23899960538713305,0.6026889918104814,0.8416885971976145,18.719037667674336,1.1906579148221659,6082083997.0,2011-03-08,2011,1,67,3,1.47,132.04,132.8,131.60001,2811
2011-03-09 14:30:00,132.32001,132.8,131.60001,132.39,135.24690982758622,136.70257142857142,117.90280515000023,125.62537950000004,130.13664920000002,132.52549800000014,129.8646163982959,131.9761589847353,132.17461307692312,134.2893488454472,130.05987730839905,117.90280515000023,125.62537950000004,130.13664920000002,132.52549800000014,132.26333666666667,153903440,175041390.4,53.502683479244176,1.5,2.75,1.583031650504109,0.8792402736764366,-0.21439616903114497,0.5736933859086832,0.7880895549398282,18.28971370765975,1.1151073944174157,5928180557.0,2011-03-09,2011,2,68,3,0.91,132.2,131.17999,129.81,2812
2011-03-10 14:30:00,131.0,131.17999,129.81,129.9375,135.4762203448276,136.8702857142857,118.01340270000023,125.74775450000004,130.2187992,132.40892300000013,129.8674745787549,131.78200098618908,131.8213438461539,133.7721848777203,129.8705028145875,118.01340270000023,125.74775450000004,130.2187992,132.40892300000013,130.30916333333334,301665792,182802848.8,44.06223352884431,1.5,2.75,1.6542436754681005,1.6502247857747827,-0.35143389286967985,0.3487971888527284,0.7002310817224082,21.535885541228385,-1.8079800498753211,5626514765.0,2011-03-10,2011,3,69,3,1.06,130.49,131.31,129.49001,2813
2011-03-11 14:30:00,129.52,131.31,129.49001,130.84,135.70553086206897,137.03799999999998,118.13175270000023,125.87335450000002,130.3171992,132.33487300000016,129.90561283056843,131.69228660655202,131.74519000000006,133.76481341361102,129.7255665863891,118.13175270000023,125.87335450000002,130.3171992,132.33487300000016,130.54667000000003,225758496,185955348.8,47.71810821497594,1.5,2.75,1.6660826986489496,1.2140467991744048,-0.3676921694428424,0.2406158699188552,0.6083080393616976,20.914672151524663,-1.7348780874861494,5852273261.0,2011-03-11,2011,4,70,3,1.41,130.4,130.48,129.06,2814
2011-03-14 13:30:00,129.99001,130.48,129.06,130.05,135.93484137931034,137.2057142857143,118.22820275000024,126.00655450000002,130.40379919999998,132.18187300000017,129.91127507250692,131.53587835830893,131.67057461538468,133.8566668478354,129.48448238293395,118.22820275000024,126.00655450000002,130.40379919999998,132.18187300000017,129.86333333333332,235607744,190849914.4,44.948814708391254,1.5,2.75,1.6742196487454533,1.2345184682985637,-0.4145692938140845,0.09009642209409208,0.5046657159081765,20.525762788598932,-0.6721072842058511,5616665517.0,2011-03-14,2011,0,73,3,1.1,129.77,129.33,126.5,2815
2011-03-15 13:30:00,126.59,129.33,126.5,128.56,136.16415189655174,137.37342857142858,118.32415775000028,126.11345449999999,130.4599992,131.93837350000015,129.85828389319292,131.25246137180335,131.48826769230774,134.2185475223919,128.7579878622236,118.32415775000028,126.11345449999999,130.4599992,131.93837350000015,128.13,359794688,203755092.8,40.209082612468634,1.5,2.75,1.8082039595493504,1.7658193621357177,-0.5219078198722188,-0.1477190589320969,0.3741887609401219,19.356308284698613,-2.0196706028755043,5256870829.0,2011-03-15,2011,1,74,3,2.24,127.92,128.57001,125.28,2816
2011-03-16 13:30:00,128.14999,128.57001,125.28,126.175,125.28,137.54114285714286,118.41738275000029,126.19390449999999,130.4424992,131.59662400000016,129.7138413875775,130.76889362210778,131.0148061538462,134.89116588004268,127.13844642764973,118.41738275000029,126.19390449999999,130.4424992,131.59662400000016,126.67500333333334,469160704,221234359.2,34.02445534406908,1.5,2.75,1.914047248152968,2.1206502719402187,-0.7174427938954353,-0.5226147314291723,0.19482806246626305,21.3842317309036,-5.465647711096128,4787710125.0,2011-03-16,2011,2,75,3,2.63,126.93,128.39,127.10001000000001,2817
2011-03-17 13:30:00,128.0,128.39,127.10001000000001,127.85001000000001,125.37378048780486,137.70885714285714,118.50498280000023,126.28893459999999,130.45989939999998,131.29662400000015,129.64074996061368,130.49090470571656,130.60711538461544,134.61215863138892,126.60207213784193,118.50498280000023,126.28893459999999,130.45989939999998,131.29662400000015,127.78000666666668,254521632,227451268.8,40.899765215721615,1.5,2.75,1.9355438732848982,1.119016101087584,-0.6972717758821136,-0.6767616573863791,0.020510118495734614,20.066251319893663,-3.487574545180042,5042231757.0,2011-03-17,2011,3,76,3,1.01,127.75,128.88,127.50998999999999,2818
2011-03-18 13:30:00,128.84,128.88,127.50998999999999,127.75998999999999,125.46756097560976,137.87657142857142,118.59023270000027,126.37953449999999,130.46229920000002,130.97212350000015,129.5669946680406,130.2308175908864,130.36326923076928,134.63698459181524,126.08955386972332,118.59023270000027,126.37953449999999,130.46229920000002,130.97212350000015,128.04999333333333,230654368,233493465.6,40.654562726592616,1.5,2.75,1.8951485966216903,0.98784078349814,-0.6540086868223616,-0.7970007400322174,-0.1429920532098558,20.047476875762488,-2.792361165058296,4811577389.0,2011-03-18,2011,4,77,3,1.07,128.19,130.00999,129.2,2819
2011-03-21 13:30:00,129.35001,130.00999,129.2,129.74001,125.56134146341465,138.0442857142857,118.70483270000028,126.48973459999999,130.5092994,130.73262400000016,129.57377958301942,130.184074010802,130.25019230769234,134.50606060995057,125.9943240054342,118.70483270000028,126.48973459999999,130.5092994,130.73262400000016,129.64999999999998,154065312,234696615.2,48.0342284666161,1.5,2.75,1.9204951254344256,0.6564445416850648,-0.4649441227170739,-0.7241722066061982,-0.2592280838891243,22.522868674206578,-2.1420953386634483,4965642701.0,2011-03-21,2011,0,80,3,0.63,129.6,129.89,129.17,2820
2011-03-22 13:30:00,129.72,129.89,129.17,129.28999,125.65512195121953,138.21200000000002,118.82383260000027,126.5988345,130.55229920000002,130.60562350000015,129.56265057976373,130.09892315263036,129.92865307692313,133.77477553852393,126.0825306153223,118.82383260000027,126.5988345,130.55229920000002,130.60562350000015,129.44999666666664,129743440,229527968.8,46.615413314912,1.5,2.75,1.8347454736176807,0.5652620056645575,-0.3484248696412827,-0.6947591709407277,-0.34633430129944504,21.611333457585026,-2.3415741370194105,4835899261.0,2011-03-22,2011,1,81,3,0.56,129.53,130.0,128.32001,2821
2011-03-23 13:30:00,128.92999,130.0,128.32001,129.66,125.7489024390244,138.37971428571427,118.93903260000026,126.71143460000002,130.6058992,130.53762350000014,129.5664682040867,130.05712094761796,129.71249923076928,133.26788415858022,126.15711430295835,118.93903260000026,126.71143460000002,130.6058992,130.53762350000014,129.32667,148648752,225579900.0,47.97605755794038,1.5,2.75,1.8236915112164185,0.6589627533304164,-0.2303572142503225,-0.6342808191123481,-0.4039236048620256,21.82843401578332,-0.21356421356421615,4984548013.0,2011-03-23,2011,2,82,3,1.31,129.16,131.09,129.67,2822
2011-03-24 13:30:00,130.39999,131.09,129.67,130.89999,125.84268292682928,138.54742857142855,119.06328255000028,126.8355344,130.6752992,130.53612350000014,129.61876317647543,130.13739419070197,129.67173000000003,133.15890335578356,126.18455664421654,119.06328255000028,126.8355344,130.6752992,130.53612350000014,130.55333000000002,159238320,220518463.2,52.35838277439625,1.5,2.75,1.7955706889866752,0.722108787124905,-0.0614632300230401,-0.4807526423908257,-0.4192894123677856,19.894427447499154,0.04584989299908216,5143786333.0,2011-03-24,2011,3,83,3,1.1,130.38,131.87,130.89211,2823
2011-03-25 13:30:00,131.24001,131.87,130.89211,131.3,125.93646341463415,138.71514285714287,119.17403260000027,126.9632344,130.72969920000003,130.48462350000014,129.68469403229994,130.24811855349225,129.57326846153853,132.78806246493514,126.35847445814191,119.17403260000027,126.9632344,130.72969920000003,130.48462350000014,131.35403666666667,155770000,221222272.8,53.7129428239684,1.5,2.75,1.737164925487627,0.70413344022022,0.07696853659235525,-0.3230787416273415,-0.4000472782196968,19.57646237839509,0.9611687812379852,5299556333.0,2011-03-25,2011,4,84,3,0.75,131.38,131.92,130.94,2824
2011-03-28 13:30:00,131.58,131.92,130.94,130.98,126.03024390243904,138.88285714285715,119.28053265000023,127.0782843,130.7819494,130.37612400000015,129.73549034475874,130.31782154839777,129.464806923077,132.37264317210511,126.55697067404888,119.28053265000023,127.0782843,130.7819494,130.37612400000015,131.28,109839056,219634188.0,52.428707152575406,1.5,2.75,1.683081716524224,0.5000999935401678,0.14292557041683968,-0.2213903151986472,-0.3643158856154868,19.251496883115035,1.8823895457373887,5189717277.0,2011-03-28,2011,0,87,3,0.75,131.43,131.89999,130.44,2825
2011-03-29 13:30:00,130.87,131.89999,130.44,131.86,126.12402439024392,139.05057142857143,119.39228765000028,127.19738429999998,130.8331494,130.42262450000015,129.81880444888588,130.46469568664557,129.61269153846158,132.78515070709022,126.44023236983296,119.39228765000028,127.19738429999998,130.8331494,130.42262450000015,131.39999666666668,129844560,213197303.2,55.57440098786188,1.5,2.75,1.6671465939153511,0.6090347206605754,0.2362547093902924,-0.06899749887762141,-0.30525220826791377,17.802413623633853,4.505646918961772,5319561837.0,2011-03-29,2011,1,88,3,1.12,131.17,133.16,132.36,2826
2011-03-30 13:30:00,132.55,133.16,132.36,132.77,126.21780487804878,139.21828571428568,119.49613765000029,127.3024844,130.8981494,130.50062400000016,129.9345376077531,130.68424847839358,129.76115307692314,133.30799981153757,126.21430634230872,119.49613765000029,127.3024844,130.8981494,130.50062400000016,132.76333333333332,135895872,209978206.4,58.62152010895943,1.5,2.75,1.6409218372071106,0.6471903647996872,0.34322374354367,0.1237774711616737,-0.21944627238199627,11.614730062235315,3.8482515566483038,5455457709.0,2011-03-30,2011,2,89,3,0.6,132.76,132.96001,132.45,2827
2011-03-31 13:30:00,132.60001,132.96001,132.45,132.59,126.31158536585366,139.386,119.59928760000028,127.40113429999998,130.9849494,130.4566240000002,130.03867338784121,130.86574862330852,129.95653769230776,133.81192597615257,126.101149408463,119.59928760000028,127.40113429999998,130.9849494,130.4566240000002,132.66666999999998,132756496,207791772.0,57.77735079551928,1.5,2.75,1.5601424202637466,0.6388919769161986,0.38279097631905945,0.2590424480168281,-0.1237485283022314,10.884192116650134,3.7805341093091833,5322701213.0,2011-03-31,2011,3,90,3,0.39,132.71,133.77,132.83,2828
2011-04-01 13:30:00,133.41,133.77,132.83,133.14999,126.40536585365854,139.55371428571428,119.70433755000029,127.50773410000001,131.0863492,130.49062350000014,130.16068580400432,131.08329542108865,130.30961384615392,134.42095894749332,126.19826874481457,119.70433755000029,127.50773410000001,131.0863492,130.49062350000014,133.24999666666668,154038944,201625149.6,59.72068293621818,1.5,2.75,1.5329893902449083,0.7639867561442345,0.4243898610395278,0.4067387979971784,-0.017651063042349438,10.52676585102272,2.6283179722276806,5476740157.0,2011-04-01,2011,4,91,4,0.71,133.3,133.67,132.88,2829
2011-04-04 13:30:00,133.42999,133.67,132.88,133.25999,126.49914634146342,139.72142857142856,119.81199250000029,127.624234,131.184149,130.58212350000016,130.28222714502377,131.29059966669925,130.85461307692316,134.4786201644877,127.23060598935862,119.81199250000029,127.624234,131.184149,130.58212350000016,133.26999666666666,100773312,195819368.0,60.10907713546357,1.5,2.75,1.4799187195131294,0.5146238241357208,0.4353968826837321,0.5265950403123156,0.09119815762858358,7.8040665037356325,3.0706166811521913,5577513469.0,2011-04-04,2011,0,94,4,0.59,133.27,133.83,132.94,2830
2011-04-05 13:30:00,133.0,133.83,132.94,133.24001,126.59292682926831,139.88914285714284,119.92114255000031,127.735634,131.266949,130.61512400000018,130.39821862953264,131.47625779368028,131.26922846153857,134.64841092354558,127.89004599953152,119.92114255000031,127.735634,131.266949,130.61512400000018,133.33667,121083808,193138236.8,59.9959153470888,1.5,2.75,1.4377816681193352,0.6269282044103242,0.4173651334413754,0.6129045744303028,0.1955394409889274,7.043038336374513,2.7610751195434333,5456429661.0,2011-04-05,2011,1,95,4,0.67,133.38,134.0,133.12,2831
2011-04-06 13:30:00,133.88,134.0,133.12,133.66,126.68670731707316,140.05685714285713,120.04159250000029,127.85588409999998,131.356749,130.67862400000018,130.52613162445292,131.6842332419012,131.72307538461547,134.64959463224932,128.79655613698162,120.04159250000029,127.85588409999998,131.356749,130.67862400000018,133.59333333333333,120453632,191465746.4,61.63110158051596,1.5,2.75,1.3979401203965252,0.6291132187600528,0.4092042972595976,0.7070448125634243,0.2978405153038268,7.0427170963928925,2.108487556034186,5576883293.0,2011-04-06,2011,2,96,4,0.66,133.56,133.97749,132.66,2832
2011-04-07 13:30:00,133.42,133.97749,132.66,133.32001,126.78048780487805,140.22457142857144,120.16204255000031,127.98710419999998,131.4297492,130.84774950000016,130.63569548231752,131.8400215045773,131.99846000000008,134.7977153059229,129.19920469407725,120.16204255000031,127.98710419999998,131.4297492,130.84774950000016,133.31916666666666,170973184,184931116.0,59.51045624625522,1.5,2.75,1.392193683225344,0.9245236155931704,0.3582253551554845,0.7456222092481823,0.38739685409269786,6.352059253588175,1.5384691546077567,5405910109.0,2011-04-07,2011,3,97,4,0.99,133.32,133.99001,132.31,2833
2011-04-08 13:30:00,133.91,133.99001,132.31,132.86,126.87426829268291,140.39228571428572,120.28924255000031,128.11540419999997,131.487149,130.94874950000016,130.72292311046192,131.93716231366517,132.27307615384623,134.61943224102296,129.9267200666695,120.28924255000031,128.11540419999997,131.487149,130.94874950000016,133.0533366666667,148014816,181043932.0,56.669258548182974,1.5,2.75,1.4127519915663918,0.817562976924297,0.27460539011029955,0.7306535917305723,0.4560482016202728,6.961879063307944,1.4353336387234876,5257895293.0,2011-04-08,2011,4,98,4,1.27,133.15,133.45,132.14,2834
2011-04-11 13:30:00,133.0,133.45,132.14,132.46001,126.9680487804878,140.56,120.4122051500003,128.2584043,131.58194919999997,131.06925000000015,130.7910441649536,131.9869573314113,132.48846153846162,134.28557062138398,130.69135245553923,120.4122051500003,128.2584043,131.58194919999997,131.06925000000015,132.68333666666666,121518496,175339469.6,54.24416900428565,1.5,2.75,1.4054125635973642,0.6930470148975516,0.1781146159417778,0.678691471547495,0.5005768556057172,7.077883161443438,0.45503564386470297,5136376797.0,2011-04-11,2011,0,101,4,0.99,132.79,131.98,130.99001,2835
2011-04-12 13:30:00,131.72,131.98,130.99001,131.47,127.0618292682927,140.72771428571428,120.5319051500003,128.39092429999997,131.6377494,131.21475000000015,130.81766988397504,131.93772329984836,132.53230846153858,134.19504321756244,130.86957370551465,120.5319051500003,128.39092429999997,131.6377494,131.21475000000015,131.48000333333334,161480688,165423769.6,48.69027477030038,1.5,2.75,1.410025951911838,0.9761637544015924,0.04055521654476979,0.5512708762866794,0.5107156597419096,7.652532122722517,-0.9791368532047988,4974896109.0,2011-04-12,2011,1,102,4,0.76,131.49,132.17999,130.96001,2836
2011-04-13 13:30:00,132.08,132.17999,130.96001,131.46001,127.15560975609756,140.89542857142857,120.6681551500003,128.50594939999996,131.65214939999998,131.47900050000013,130.84285969244658,131.8922267951009,132.54461692307706,134.17268824009633,130.91654560605772,120.6681551500003,128.50594939999996,131.65214939999998,131.47900050000013,131.53333666666666,162172944,150074381.6,48.63616017500504,1.5,2.75,1.396451241060992,1.080617106470889,-0.05308395713881653,0.4443607133183889,0.4974446704572054,6.166860732043915,-0.8522437589561749,4812723165.0,2011-04-13,2011,2,103,4,0.93,131.57,131.75999,130.27,2837
2011-04-14 13:30:00,130.7,131.75999,130.27,131.56,127.24939024390244,141.06314285714285,120.8098551500003,128.61864949999998,131.6736494,131.66450000000015,130.87098284176244,131.86058614794842,132.58923230769238,134.0683245593883,131.11014005599648,120.8098551500003,128.61864949999998,131.6736494,131.66450000000015,131.19666333333333,161271248,145411862.4,49.24420222060033,1.5,2.75,1.403132580985205,1.1090652807703807,-0.10714640826274102,0.3635116601287791,0.4706580683915201,6.240045168146508,-1.19413452453132,4973994413.0,2011-04-14,2011,3,104,4,1.14,131.01,132.37,131.41,2838
2011-04-15 13:30:00,131.8,132.37,131.41,132.03999,127.3431707317073,141.23085714285713,120.9562551500003,128.73714939999996,131.6988492,131.8785000000001,130.91682625973257,131.8776722290962,132.60307769230778,134.05777464330674,131.1483807413088,120.9562551500003,128.73714939999996,131.6988492,131.8785000000001,131.93999666666664,170146624,142386475.2,52.17122238562229,1.5,2.75,1.371480253771977,1.1949633823086592,-0.1090739728043032,0.3343156023861411,0.4433895751904443,6.0792809251310205,-0.9155035956403712,5144141037.0,2011-04-15,2011,4,105,4,0.73,131.89,132.03011,129.50999,2839
2011-04-18 13:30:00,130.59,132.03011,129.50999,130.56,129.50999,141.39857142857142,121.0980551500003,128.85827449999996,131.6870494,131.9194995000001,130.90283307307638,131.75217963584893,132.4330776923078,134.24314091793732,130.62301446667826,121.0980551500003,128.85827449999996,131.6870494,131.9194995000001,130.70003333333332,210908192,145228619.2,43.78645341492693,1.5,2.75,1.4542316642168358,1.4522495163955949,-0.20305609742010225,0.1895694534153165,0.3926255508354187,8.387453550173216,-2.0114153398817742,4933232845.0,2011-04-18,2011,0,108,4,1.95,130.77,131.35001,130.44,2840
2011-04-19 13:30:00,130.75999,131.35001,130.44,131.31,129.69390260869565,141.56628571428567,121.24025515000034,128.96937449999993,131.67384940000002,132.02050000000008,130.91880040354394,131.7100672895776,132.3346161538462,134.2367378021118,130.4324945055807,121.24025515000034,128.96937449999993,131.67384940000002,132.02050000000008,131.03333666666666,124321872,144957540.8,48.319344341648,1.5,2.75,1.4153586882013478,0.8576433575920598,-0.2070339805700086,0.133833075122908,0.3408670556929166,9.478348404146873,-1.758192428550048,5057554717.0,2011-04-19,2011,1,109,4,0.7,130.9,133.39,132.78999,2841
2011-04-20 13:30:00,132.88,133.39,132.78999,133.10001,129.8778152173913,141.73399999999995,121.3752177000003,129.11237459999995,131.6844494,132.1925005000001,131.0043380347775,131.84244278580832,132.33077153846165,134.22647664879221,130.43506642813105,121.3752177000003,129.11237459999995,131.6844494,132.1925005000001,133.09333333333333,156473008,145348753.6,57.19173720458532,1.5,2.75,1.4628330676155359,1.076534914297332,-0.08754754076576765,0.231432629735707,0.31898017050147465,12.659622799277345,-0.16501648927268972,5214027725.0,2011-04-20,2011,2,110,4,0.45,133.09,133.84,133.1046,2842
2011-04-21 13:30:00,133.78999,133.84,133.1046,133.78,130.06172782608695,141.90171428571432,121.5083177000003,129.25855459999994,131.71466940000002,132.33650100000008,131.11318752360978,132.02697204430277,132.37077230769242,134.36272020992018,130.3788244054646,121.5083177000003,129.25855459999994,131.71466940000002,132.33650100000008,133.57486666666668,136214496,144197562.4,60.00100765997318,1.5,2.75,1.4112014199287124,0.9446379934089648,0.032420923511768784,0.3595063248911856,0.32708540137941683,12.94553803743706,0.6924582267047925,5350242221.0,2011-04-21,2011,3,111,4,0.55,133.47,133.86,133.2,2843
2011-04-25 13:30:00,133.67999,133.86,133.2,133.64,130.2456404347826,142.06942857142857,121.63671765000035,129.41002969999994,131.7410494,132.4535010000001,131.21227820895842,132.18059375436917,132.40154076923088,134.45757063575152,130.34551090271023,121.63671765000035,129.41002969999994,131.7410494,132.4535010000001,133.56666666666666,65231072,139670616.0,59.1404875162679,1.5,2.75,1.357544175648092,0.4670350419303657,0.0939988262582946,0.4445839342022849,0.35058510794399045,12.759659715335404,0.8908273523457949,5285011149.0,2011-04-25,2011,0,115,4,0.5,133.53,135.06,133.91,2844
2011-04-26 13:30:00,134.05,135.06,133.91,134.791,130.42955304347825,142.23714285714286,121.77052265000034,129.54783979999993,131.77466940000002,132.6440510000001,131.3526202399797,132.4292038730007,132.4885407692309,134.82658662777175,130.15049491069,121.77052265000034,129.54783979999993,131.77466940000002,132.6440510000001,134.58700000000002,146658432,141511584.8,63.744235443151425,1.5,2.75,1.3620053059589436,1.0363705007422122,0.197925002485256,0.5979913610505605,0.4000663585653045,13.284486758751905,2.5260515707005387,5431669581.0,2011-04-26,2011,1,116,4,0.86,134.49,135.87,134.5,2845
2011-04-27 13:30:00,135.05,135.87,134.5,135.67,130.61346565217391,142.40485714285714,121.90057265000034,129.67893979999994,131.81946960000002,132.8345510000001,131.52192925017656,132.7378511231911,132.6693092307693,135.53939513661186,129.7992233249268,121.90057265000034,129.67893979999994,131.81946960000002,132.8345510000001,135.34666666666666,143104816,142174597.6,66.8189623858625,1.5,2.75,1.3625763555333048,1.0065427890474297,0.30513675854447786,0.7814873067459018,0.47635054820142403,12.09830291563868,3.2024872050443136,5574774397.0,2011-04-27,2011,2,117,4,1.02,135.18,136.28999,135.41,2846
2011-04-28 13:30:00,135.42999,136.28999,135.41,136.11,130.79737826086955,142.57257142857142,122.03286765000034,129.81113979999995,131.88146980000002,133.00155100000012,131.70185359330688,133.05900815907765,132.9193092307693,136.32794160246618,129.51067685907248,122.03286765000034,129.81113979999995,131.88146980000002,133.00155100000012,135.9366633333333,124865744,141623091.2,68.26958269716746,1.5,2.75,1.3281059015666397,0.8816764479717839,0.38007621216718224,0.9514458134104018,0.5713696012432196,11.92414479925946,3.4584980237154235,5699640141.0,2011-04-28,2011,3,118,4,0.65,135.85,136.57001,135.98,2847
2011-04-29 13:30:00,136.16,136.57001,135.98,136.42999,130.9812908695652,142.74028571428568,122.1666176500003,129.94783979999994,131.93306940000002,133.1935505000001,131.88727070729485,133.3800540486893,133.2246923076924,137.09420138288658,129.35518323249823,122.1666176500003,129.94783979999994,131.93306940000002,133.1935505000001,136.32666666666668,115094368,140739984.8,69.32006008701114,1.5,2.75,1.2753847657404516,0.8177801650579686,0.4223345334467921,1.0992877680517097,0.6769532346049176,11.82647577484325,3.3247503275333594,5814734509.0,2011-04-29,2011,4,119,4,0.43,136.28,137.17999,135.95,2848
2011-05-02 13:30:00,137.07001,137.17999,135.95,136.22,131.16520347826085,137.17999,122.31441765000034,130.08173979999995,131.97246940000002,133.3470510000001,132.05718165994995,133.65052509167126,133.59007692307702,137.62148907205912,129.55866477409492,122.31441765000034,130.08173979999995,131.97246940000002,133.3470510000001,136.4499966666667,126310064,139353540.8,67.73526666155396,1.5,2.75,1.2721422824732775,0.9064001049049771,0.4071090317811285,1.1858395243313282,0.7787304925501998,12.19266448384157,4.335171568627448,5688424445.0,2011-05-02,2011,0,122,5,0.9,136.56,136.19,135.045,2849
2011-05-03 13:30:00,135.96001,136.19,135.045,135.73,131.3491160869565,137.230806122449,122.45661770000034,130.20623979999993,131.99646940000002,133.47055150000008,132.2012137517166,133.8485703210359,133.9185376923078,137.89769431736664,129.93938106724895,122.45661770000034,130.20623979999993,131.99646940000002,133.47055150000008,135.655,138445808,141237165.6,64.05524338298935,1.5,2.75,1.2652035480109014,0.9802363805012524,0.3378544616176522,1.2010485695722648,0.8631941079546128,9.350528230512877,3.3660802680679214,5549978637.0,2011-05-03,2011,1,123,5,0.85,135.62,135.73,134.23,2850
2011-05-04 13:30:00,135.67,135.73,134.23,134.83,131.53302869565215,137.28162224489796,122.58836770000036,130.31693989999994,132.05646940000003,133.55005100000008,132.30430340851203,133.94203981427054,134.17007615384622,137.92834977245408,130.41180253523845,122.58836770000036,130.31693989999994,132.05646940000003,133.55005100000008,134.92999999999998,182821184,144324034.4,57.83952213186427,1.5,2.75,1.28197472315298,1.2667410855028038,0.21143067621827605,1.127482453227458,0.9160517770091818,11.005269286736684,1.2997669947583137,5367157453.0,2011-05-04,2011,2,124,5,1.12,134.98,134.95,133.02,2851
2011-05-05 13:30:00,134.08,134.95,133.02,133.61,131.7169413043478,137.33243836734695,122.72106765000036,130.40823989999993,132.1082694,133.54755100000008,132.35550719641353,133.91041697481623,134.29084615384627,137.86390022748122,130.7177920802113,122.72106765000036,130.40823989999993,132.1082694,133.54755100000008,133.86,227065680,149654636.8,50.66277241467419,1.5,2.75,1.3282622429277655,1.5172645823426967,0.03489813229603411,0.9596744423792244,0.9247763100831904,10.457867258989145,-0.12707430109133466,5140091773.0,2011-05-05,2011,3,125,5,1.45,133.99,135.63,133.22,2852
2011-05-06 13:30:00,134.94,135.63,133.22,134.2,131.90085391304345,137.38325448979592,122.84476265000036,130.50463989999994,132.1736696,133.5915505000001,132.42784024753456,133.93799631054802,134.57084615384628,137.42966059841936,131.7120317092732,122.84476265000036,130.50463989999994,132.1736696,133.5915505000001,134.35,222951248,152253540.0,53.657513631647355,1.5,2.75,1.405529225575782,1.464341965382217,-0.04835705143446034,0.8643299957901149,0.9126870472245752,10.351328404527726,0.4190362167015881,5363043021.0,2011-05-06,2011,4,126,5,1.81,134.43,135.11,133.98,2853
2011-05-09 13:30:00,134.19,135.11,133.98,134.72,132.0847665217391,137.4340706122449,122.96631265000036,130.60513989999993,132.2214696,133.68455050000009,132.51772886527831,134.01247285240058,134.83315384615398,136.98552821254557,132.6807794797624,122.96631265000036,130.60513989999993,132.2214696,133.68455050000009,134.60333333333335,114134432,150559520.8,56.18200052138678,1.5,2.75,1.385848566606085,0.7580685126622693,-0.07314043954110816,0.82126149779819,0.8944019373392982,10.497753770561518,-0.05267413996483293,5477177453.0,2011-05-09,2011,0,129,5,0.84,134.55,136.11,135.0,2854
2011-05-10 13:30:00,135.17,136.11,135.0,135.87,132.26867913043475,137.48488673469387,123.08786265000036,130.72285979999995,132.27586979999998,133.85505000000006,132.64919047840465,134.189380199791,135.04623000000012,137.01032060049127,133.08213939950895,123.08786265000036,130.72285979999995,132.27586979999998,133.85505000000006,135.66,114887008,150227946.4,61.2140756340849,1.5,2.75,1.386145097562794,0.7647512380559307,-0.01960382271886529,0.8698971589407165,0.8895009816595818,10.4773387616091,0.14741652539250907,5592064461.0,2011-05-10,2011,1,130,5,0.82,135.56,135.69,133.82001,2855
2011-05-11 13:30:00,135.67,135.69,133.82001,134.44,132.4525917391304,137.53570285714287,123.20231265000037,130.81905969999997,132.34607000000003,134.00355000000008,132.71941830278092,134.21324875219187,135.09699923076937,136.95901115671856,133.23498730482018,123.20231265000037,130.81905969999997,132.34607000000003,134.00355000000008,134.65000333333333,193745632,151841193.6,53.054954251913074,1.5,2.75,1.4335625905940237,1.2759754280540638,-0.08438911360888267,0.7840145896484785,0.8684037032573612,11.597714909137974,-1.2269487914187172,5398318829.0,2011-05-11,2011,2,131,5,1.4,134.76,135.36,133.39,2856
2011-05-12 13:30:00,134.08,135.36,133.39,135.08,132.63650434782608,137.58651897959186,123.32356265000037,130.92685969999997,132.42346980000002,134.1845495000001,132.8119901340444,134.29579649007835,135.2077684615386,136.87057164276658,133.54496528031058,123.32356265000037,130.92685969999997,132.42346980000002,134.1845495000001,134.61,171648128,152314952.8,55.88875943362562,1.5,2.75,1.471879548408738,1.1269289379972154,-0.08764522801292618,0.7588471682412035,0.8464923962541296,11.825151517121485,-0.9895111771246125,5569966957.0,2011-05-12,2011,3,132,5,1.48,134.38,135.34,133.56,2857
2011-05-13 13:30:00,135.14999,135.34,133.56,134.03999,132.8204169565217,137.6373351020408,123.44231265000036,131.02125949999996,132.4348696,134.30854900000008,132.86014699153287,134.27143396721377,135.1499984615386,136.9157056940347,133.3842912290425,123.44231265000036,131.02125949999996,132.4348696,134.30854900000008,134.31332999999998,157499056,152126343.2,50.54885181902825,1.5,2.75,1.4938881520938283,1.035317438695917,-0.1591799079031333,0.6475175113752131,0.8066974192783463,12.260960824185307,-1.600359712230223,5412467901.0,2011-05-13,2011,4,133,5,1.33,134.45,134.61,132.97,2858
2011-05-16 13:30:00,133.56,134.61,132.97,133.19,133.00432956521738,137.68815122448981,123.55691265000034,131.09925949999996,132.4492696,134.3660495000001,132.87308240362958,134.16844025605056,134.95922923076938,136.97689591646463,132.94156254507408,123.55691265000034,131.09925949999996,132.4492696,134.3660495000001,133.59,141770624,150707543.2,46.62769505117755,1.5,2.75,1.5043247126585562,0.9407002528855504,-0.2572708680516109,0.4851088342138326,0.7423797022654435,12.53665821213279,-1.8713622633168732,5270697277.0,2011-05-16,2011,0,136,5,1.23,133.79,133.35001,132.12,2859
2011-05-17 13:30:00,132.69,133.35001,132.12,133.17,133.188242173913,137.73896734693878,123.65896270000034,131.17315949999997,132.4840698,134.4965495000001,132.88472623093824,134.07335070785527,134.73307538461552,136.84114463224387,132.62500613698714,123.65896270000034,131.17315949999997,132.4840698,134.4965495000001,132.88000333333332,192852320,149804749.6,46.536221636331504,1.5,2.75,1.484730804611516,1.2873578475645342,-0.3133103048258745,0.3507418212331004,0.6640521260589749,12.55674042705173,-1.2311800044500667,5077844957.0,2011-05-17,2011,1,137,5,0.93,132.74,134.5,132.95,2860
2011-05-18 13:30:00,133.24001,134.5,132.95,134.36,133.37215478260867,137.78978346938777,123.76966270000034,131.26075939999998,132.51966979999997,134.6490495000001,132.9425801042348,134.10065064044048,134.5738453846155,136.44450288889692,132.7031878803341,123.76966270000034,131.26075939999998,132.51966979999997,134.6490495000001,133.93666666666667,135228128,150350062.4,52.506404614883394,1.5,2.75,1.4893928899964084,0.8994218282412897,-0.2621215107658588,0.3364002376016515,0.5985217483675103,13.534855724794431,0.561335229398997,5213073085.0,2011-05-18,2011,2,138,5,1.17,133.72,135.03,133.94,2861
2011-05-19 13:30:00,134.8,135.03,133.94,134.67999,133.5560673913043,137.84059959183674,123.87821265000035,131.35105939999997,132.5654696,134.72804850000009,133.01071382563734,134.1558258175414,134.4553830769232,136.0718299775016,132.8389361763448,123.87821265000035,131.35105939999997,132.5654696,134.72804850000009,134.54999666666666,119584880,148505656.0,53.994105434766254,1.5,2.75,1.4608648264252366,0.8052547170324609,-0.20133211789827232,0.34685660099466986,0.5481887188929422,12.378359217202005,0.35766766020865504,5332657965.0,2011-05-19,2011,3,139,5,0.81,134.49,134.6781,133.36,2862
2011-05-20 13:30:00,134.33,134.6781,133.36,133.61,133.73997999999997,137.89141571428573,123.98201260000036,131.4288594,132.63891959999998,134.71954850000014,133.0342152442398,134.10384240634698,134.29230615384628,135.784462885352,132.80014942234055,123.98201260000036,131.4288594,132.63891959999998,134.71954850000014,133.8827,182638320,150826847.2,48.52094928095026,1.5,2.75,1.4508023388234332,1.210913861759752,-0.22595833584772226,0.2657407990832894,0.4916991349310117,13.075695146733535,-0.8239311163895378,5150019645.0,2011-05-20,2011,4,140,5,0.99,134.02,133.64751,131.59,2863
2011-05-23 13:30:00,131.98,133.64751,131.59,132.06,133.92389260869564,137.9422318367347,124.08035260000037,131.4902594,132.6633196,134.6405485000001,132.99601072485785,133.90919074859966,134.07922923076936,135.94718418635392,132.2112742751848,124.08035260000037,131.4902594,132.6633196,134.6405485000001,132.43250333333336,168800000,156005293.6,41.895760868396785,1.5,2.75,1.4941386003360455,1.082014565690353,-0.3329485688991901,0.07551342380702407,0.4084619927062141,14.191755607296805,-2.8041510267167156,4981219645.0,2011-05-23,2011,0,143,5,1.56,132.62,132.73,131.7,2864
2011-05-24 13:30:00,132.44,132.73,131.7,131.95,134.10780521739127,137.99304795918368,124.17514260000036,131.55255939999998,132.70131959999998,134.4984985000001,132.95499069643202,133.72260115349494,133.9515369230771,136.13127246756315,131.771801378591,124.17514260000036,131.55255939999998,132.70131959999998,134.4984985000001,132.12666666666664,147200320,156032388.0,41.463071636747046,1.5,2.75,1.4609858431691851,0.9433959313626604,-0.39329807311640297,-0.0831605986892896,0.31013747442711337,12.590528253762288,-1.8521273430526697,4834019325.0,2011-05-24,2011,1,144,5,0.78,132.21,132.94,131.38,2865
2011-05-25 13:30:00,131.42,132.94,131.38,132.39,134.29171782608694,138.04386408163262,124.27521760000036,131.6189594,132.7779196,134.33449850000008,132.9328341985327,133.595686757924,133.8123061538463,136.1371690190839,131.48744328860866,124.27521760000036,131.6189594,132.7779196,134.33449850000008,132.23666666666665,151102192,156432256.8,43.95638475787607,1.5,2.75,1.4680582829428148,0.96592732912615,-0.3852543303830811,-0.171430438551738,0.2138238918313431,12.015406236496235,-1.991412496298509,4985121517.0,2011-05-25,2011,2,145,5,1.19,132.16,133.24001,131.78,2866
2011-05-26 13:30:00,132.03,133.24001,131.78,133.0,134.47563043478257,138.09468020408164,124.39371760000036,131.67845939999998,132.91441959999997,134.1789985000001,132.93546815153144,133.53895468574075,133.6799984615386,135.97879900499478,131.38119791808242,124.39371760000036,131.67845939999998,132.91441959999997,134.1789985000001,132.67333666666667,164984624,158438200.8,47.30726912761671,1.5,2.75,1.4674834055897574,1.0413184646565359,-0.323037616347418,-0.18997312860292934,0.1330644877444886,11.986630660661032,-0.7758803921128231,5150106141.0,2011-05-26,2011,3,146,5,1.11,132.51,133.87,132.9588,2867
2011-05-27 13:30:00,133.37,133.87,132.9588,133.50999,134.65954304347824,138.14549632653058,124.51811755000037,131.7437593,133.02761919999998,134.03299850000008,132.95799842009885,133.5361961442416,133.49845923076936,135.4183097489103,131.57860871262838,124.51811755000037,131.7437593,133.02761919999998,134.03299850000008,133.44626333333335,120921872,158729576.0,49.99898154572853,1.5,2.75,1.4277488766190611,0.7618105903590393,-0.2357739728492541,-0.16165297831707906,0.07412099453217506,11.637784471979014,0.2402507695772881,5271028013.0,2011-05-27,2011,4,147,5,0.69,133.41,134.92,133.84,2868
2011-05-31 13:30:00,134.77,134.92,133.84,134.89999,134.84345565217387,138.1963124489796,124.65106750000037,131.8163592,133.17041919999997,133.96699800000007,133.034154952644,133.6660812733615,133.5338430769232,135.5369520298083,131.53073412403808,124.65106750000037,131.8163592,133.17041919999997,133.96699800000007,134.55333000000002,164731184,160650632.0,56.518562308584244,1.5,2.75,1.426481814003414,1.025400161513215,-0.08068834467970486,-0.026739436317456008,0.05394890836224885,12.428004605170205,1.2990838777502554,5435759197.0,2011-05-31,2011,1,151,5,0.81,134.38,134.9234,131.75999,2869
2011-06-01 13:30:00,134.50999,134.9234,131.75999,131.87,135.02736826086954,138.2471285714286,124.76911755000036,131.86115920000003,133.21301899999997,133.77399800000006,132.9885018172462,133.49502591399371,133.28692000000012,135.2579093866582,131.31593061334206,124.76911755000036,131.86115920000003,133.21301899999997,133.77399800000006,132.85112999999998,233094256,165383054.4,43.27303497454934,1.5,2.75,1.5505481130031702,1.4094204321334631,-0.17311258618212064,-0.16244182436540197,0.010670761816718673,18.580605194569312,-1.8532301280142969,5202664941.0,2011-06-01,2011,2,152,6,2.4,133.34,132.24001,130.96001,2870
2011-06-02 13:30:00,131.96001,132.24001,130.96001,131.73,135.2112808695652,138.29794469387755,124.87981755000037,131.90705920000002,133.26181919999996,133.6189980000001,132.93914880480517,133.32692820789907,133.10922846153858,135.1900579604923,131.02839896258484,124.87981755000037,131.90705920000002,133.26181919999996,133.6189980000001,131.64334,200466752,166265332.8,42.77422875633851,1.5,2.75,1.531223247788658,1.205703850730812,-0.2309992186111624,-0.27807826144723435,-0.047079042836071935,17.493202426830372,-2.1903699280049054,5002198189.0,2011-06-02,2011,3,153,6,0.98,131.6,131.42,130.08,2871
2011-06-03 13:30:00,130.14999,131.42,130.08,130.42,135.39519347826084,138.34876081632657,124.98296760000035,131.94145920000003,133.27701919999996,133.45949800000008,132.84035865559713,133.05007790238488,132.89615153846165,135.420325106923,130.3719779700003,124.98296760000035,131.94145920000003,133.27701919999996,133.45949800000008,130.64,234690128,166646555.2,38.32279768485303,1.5,2.75,1.5397073015180378,1.4083107071630607,-0.3383440065737565,-0.4700090510532675,-0.13166504447951105,17.803430900503372,-2.387545842377087,4767508061.0,2011-06-03,2011,4,154,6,1.03,130.75,130.36,128.87,2872
2011-06-06 13:30:00,130.09,130.36,128.87,129.045,135.5791060869565,138.3995769387755,125.0887926000003,131.95760930000003,133.23991939999996,133.2017480000001,132.69152106125998,132.66864191168156,132.57884384615394,135.8206240135054,129.33706367880254,125.0887926000003,131.95760930000003,133.23991939999996,133.2017480000001,129.42499999999998,179951120,164496548.8,34.28921392165293,1.5,2.75,1.5404424942667485,1.0939507321748745,-0.4744380108144303,-0.7247125579975489,-0.2502745471831186,18.120098961069164,-2.283053157655622,4587556941.0,2011-06-06,2011,0,157,6,1.16,129.62,130.07001,128.85001,2873
2011-06-07 13:30:00,129.7,130.07001,128.85001,128.96001,135.76301869565214,138.4503930612245,125.1959426500003,131.96140940000004,133.19311959999996,132.91374850000008,132.54518729415173,132.3154388724738,132.1634600000001,135.75126297760514,128.57565702239506,125.1959426500003,131.96140940000004,133.19311959999996,132.91374850000008,129.29334333333335,161805936,166880124.0,34.050647638305364,1.5,2.75,1.5175537446762664,0.9695938145395911,-0.5380104295693449,-0.9227875841447996,-0.3847771545754548,17.387187958914318,-2.266002273588464,4425751005.0,2011-06-07,2011,1,158,6,0.95,129.46,129.19,128.17999,2874
2011-06-08 13:30:00,128.75999,129.19,128.17999,128.42,135.9469313043478,138.50120918367347,125.3024246500003,131.96193449999998,133.14191959999997,132.5412485000001,132.38341524340072,131.94444469414296,131.68192230769242,135.46452302319858,127.89932159218624,125.3024246500003,131.96193449999998,133.14191959999997,132.5412485000001,128.59666333333334,198696320,171070589.6,32.50326683338656,1.5,2.75,1.4813006200565326,1.1614873162277335,-0.5806072310718076,-1.1105361934152145,-0.5299289623434067,17.385155486778032,-2.9987159150993272,4227054685.0,2011-06-08,2011,2,159,6,0.79,128.68,129.92999,128.46001,2875
2011-06-09 13:30:00,128.77,129.92999,128.46001,129.39999,136.13084391304344,138.55202530612246,125.4217746000003,131.96293440000002,133.09271939999996,132.2892480000001,132.26641817503204,131.70211567565315,131.35807538461546,135.14581082525135,127.57033994397956,125.4217746000003,131.96293440000002,133.09271939999996,132.2892480000001,129.26333,160964368,169431526.4,38.00888166310713,1.5,2.75,1.4833498614810672,0.9500260749583852,-0.5094977569958005,-1.1668011585881573,-0.6573034015923568,18.085496947196415,-2.706774436090224,4388019053.0,2011-06-09,2011,3,160,6,1.14,129.2,128.92999,127.25998999999999,2876
2011-06-10 13:30:00,128.85001,128.92999,127.25998999999999,127.60001000000001,136.3147565217391,138.60284142857142,125.5300746500003,131.94373450000003,132.98931959999996,131.9152485000001,132.0834217760112,131.31143894463855,131.01499923076932,135.26589217952235,126.76410628201627,125.5300746500003,131.94373450000003,132.98931959999996,131.9152485000001,127.92999666666668,238629312,172780585.6,32.7283473803234,1.5,2.75,1.530253442803848,1.3811118371391835,-0.5470970108119115,-1.3411746651072465,-0.7940776542953347,18.636859189111,-4.426620060416447,4149389741.0,2011-06-10,2011,4,161,6,1.31,128.09,128.24001,127.05,2877
2011-06-13 13:30:00,127.89,128.24001,127.05,127.7,136.49866913043473,138.65365755102042,125.64242465000034,131.93823450000002,132.89151959999995,131.59824900000007,131.91152288283428,130.9674923784825,130.68807615384623,135.24382875350938,126.13232355418316,125.64242465000034,131.93823450000002,132.89151959999995,131.59824900000007,127.66333666666668,207599744,175285620.0,33.28285029238616,1.5,2.75,1.5059503397464316,1.1843512548262658,-0.528363182740305,-1.4545316327207156,-0.9261684499804109,18.239025595092386,-5.337279861918448,4356989485.0,2011-06-13,2011,0,164,6,0.94,127.65,129.77,128.82001,2878
2011-06-14 13:30:00,128.87,129.77,128.82001,129.32001,136.6825817391304,138.7044736734694,125.75472470000034,131.95063460000003,132.81491999999997,131.40474950000007,131.80989492664472,130.8105892948175,130.45192307692318,134.94819292660958,125.95565322723677,125.75472470000034,131.95063460000003,132.81491999999997,131.40474950000007,129.30334000000002,160570368,176225607.2,41.67160627505415,1.5,2.75,1.5462396011931154,0.9111636529517942,-0.37709455659183794,-1.3975366457202083,-1.0204420891283703,18.937562725749114,-1.9337150223705224,4517559853.0,2011-06-14,2011,1,165,6,0.74,129.3,129.2991,126.67998999999999,2879
2011-06-15 13:30:00,128.24001,129.2991,126.67998999999999,127.02,136.86649434782606,138.75528979591834,125.8632697000003,131.93713460000004,132.6901202,131.09724950000006,131.6220559099135,130.44958079054916,129.99192307692317,134.57409717709504,125.4097489767513,125.8632697000003,131.93713460000004,132.6901202,131.09724950000006,127.66636333333332,300957952,181630888.8,34.952194732434265,1.5,2.75,1.6243667725364637,1.6569756057924436,-0.3999924817224234,-1.5204326912813997,-1.1204402095589765,17.369375963280532,-3.5754953313595945,4216601901.0,2011-06-15,2011,2,166,6,2.07,127.99,127.97,126.32001000000001,2880
2011-06-16 13:30:00,127.06,127.97,126.32001000000001,127.3,137.0504069565217,138.80610591836736,125.9732197000003,131.91913449999998,132.57132,130.74424950000008,131.45256352128945,130.14962071525878,129.51423153846164,133.81597478523798,125.21248829168532,125.9732197000003,131.91913449999998,132.57132,130.74424950000008,127.19667,308038400,190271402.4,36.29883429771113,1.5,2.75,1.6261970030695736,1.6189421852918449,-0.3652924053533315,-1.577055716250641,-1.2117633108973092,17.6520032653333,-2.3922711240607195,4524640301.0,2011-06-16,2011,3,167,6,1.31,127.15,127.94,126.62,2881
2011-06-17 13:30:00,127.92998999999999,127.94,126.62,127.05,137.23431956521736,138.8569220408163,126.0661696500003,131.89793450000002,132.43911999999997,130.36275000000006,131.27991397143495,129.854418742377,128.91038615384622,132.0710626277988,125.74970967989373,126.0661696500003,131.89793450000002,132.43911999999997,130.36275000000006,127.20333333333332,234996064,196041961.6,35.59037013332233,1.5,2.75,1.6043257885646036,1.1987028801491038,-0.3293008393858841,-1.6233893601296645,-1.2940885207437802,17.153450816812455,-1.5459723352318886,4289644237.0,2011-06-17,2011,4,168,6,1.04,127.28,127.97,126.58,2882
2011-06-20 13:30:00,126.62,127.97,126.58,127.7,137.418232173913,138.9077381632653,126.1573196500003,131.87823450000002,132.32671979999998,130.06725000000006,131.13952518824144,129.64923600500777,128.58961692307702,131.29773628716595,125.88149755898809,126.1573196500003,131.87823450000002,132.32671979999998,130.06725000000006,127.41666666666669,159478944,194883992.8,38.927906802813,1.5,2.75,1.589016803667132,0.8183275686662758,-0.23620008946019544,-1.5893386325690244,-1.353138543108829,16.8449456482522,-0.9770548249802464,4449123181.0,2011-06-20,2011,0,171,6,1.1,127.28,129.7,127.75348999999999,2883
2011-06-21 13:30:00,128.36,129.7,127.75348999999999,129.45,137.60214478260866,138.95855428571429,126.2501196500003,131.87283440000002,132.2585198,129.93675000000005,131.07326929850652,129.63026114738798,128.4142323076924,130.51284616077828,126.3156184546065,126.2501196500003,131.87283440000002,132.2585198,129.93675000000005,128.96783,193157248,196101855.2,46.904897434603406,1.5,2.75,1.6183727462623358,0.984984297078695,-0.041447126589353456,-1.404947451345521,-1.3635003247561674,18.83334137776828,0.8020557545553662,4642280429.0,2011-06-21,2011,1,172,6,1.52,128.73,129.81,128.59,2884
2011-06-22 13:30:00,129.05,129.81,128.59,128.67,137.7860573913043,139.00937040816328,126.3452696500003,131.88233440000005,132.18271959999998,129.77275000000006,130.9790234436631,129.5388077047796,128.279616923077,130.044254300776,126.51497954537805,126.3452696500003,131.88233440000005,132.18271959999998,129.77275000000006,129.0233333333333,176886432,197586160.8,44.13765763250128,1.5,2.75,1.5899175501007403,0.8952369502186308,0.04544597882389256,-1.306692851226302,-1.3521388300501944,19.02595119235163,-0.5641345103658933,4465393997.0,2011-06-22,2011,2,173,6,0.95,129.2,128.63609,126.19,2885
2011-06-23 13:30:00,127.16,128.63609,126.19,128.30098999999998,126.19,139.06018653061224,126.43472460000031,131.87854440000004,132.11933939999997,129.56829950000008,130.87400252430376,129.4209203043244,128.22238538461548,129.93140095460944,126.51336981462153,126.43472460000031,131.87854440000004,132.11933939999997,129.56829950000008,127.70902666666666,334286848,206745393.6,42.84969127698452,1.5,2.75,1.653494867950687,1.6169010693740555,0.08630437607951125,-1.2442583599508057,-1.3305627360303167,18.476628197524253,0.5493573237180902,4131107149.0,2011-06-23,2011,3,174,6,1.94,127.41,128.37,126.62,2886
2011-06-24 13:30:00,128.27,128.37,126.62,126.81,126.11782630434784,139.11100265306123,126.5141746000003,131.83924430000002,132.0263392,129.25879950000007,130.71462987629184,129.17226122772206,128.05700000000007,129.8619119629711,126.25208803702904,126.5141746000003,131.83924430000002,132.0263392,129.25879950000007,127.26666666666668,226129376,209802631.2,38.021881801166145,1.5,2.75,1.6603880916684952,1.077819542617824,0.024368397822150056,-1.300102238752629,-1.3244706365747791,17.913253736309308,-0.6969459671104155,3904977773.0,2011-06-24,2011,4,175,6,1.38,127.5,128.42999,126.64,2887
2011-06-27 13:30:00,126.89,128.42999,126.64,127.94,126.04565260869565,139.1618187755102,126.5964646500003,131.81379430000004,131.95393919999998,128.98030000000008,130.6058208615353,129.05490301555807,128.020076923077,129.81337601467925,126.22677783147476,126.5964646500003,131.81379430000004,131.95393919999998,128.98030000000008,127.66999666666666,168908192,212201947.2,43.24131283357232,1.5,2.75,1.6696453708350312,0.7959785205967234,0.06845960095745829,-1.2388961353779564,-1.307355736335415,18.726095286891997,-1.0671279719201991,4073885965.0,2011-06-27,2011,0,178,6,1.41,127.53,129.63,128.27,2888
2011-06-28 13:30:00,128.45,129.63,128.27,129.61,125.97347891304348,139.2126348979592,126.6809146500003,131.80209430000002,131.90533939999997,128.71580050000009,130.56676906304372,129.10776939502873,128.03623153846164,129.88197908047007,126.19048399645315,126.6809146500003,131.80209430000002,131.90533939999997,128.71580050000009,129.17,165556256,212243200.8,49.949646252134244,1.5,2.75,1.671099272918243,0.7800309049994312,0.21100075875925015,-1.0436047878863521,-1.254605546645602,18.814726165248796,2.039048968666365,4239442221.0,2011-06-28,2011,1,179,6,1.06,128.95,130.92999,129.6321,2889
2011-06-29 13:30:00,130.2,130.92999,129.6321,130.72,125.9013052173913,139.26345102040818,126.7712647000003,131.79779440000002,131.90853939999997,128.65830050000008,130.57277811939494,129.26131516693076,128.27623076923086,130.58578128748852,125.96668025097321,126.7712647000003,131.79779440000002,131.90853939999997,128.65830050000008,130.42736333333335,244295376,212803256.8,53.853655130212346,1.5,2.75,1.6460200391383677,1.1479870170859152,0.3715573926751481,-0.7901588058016671,-1.1617161984768152,15.26707788988574,2.6865671641791056,4483737597.0,2011-06-29,2011,2,180,6,1.0,130.28,132.17999,130.705,2890
2011-06-30 13:30:00,131.14,132.17999,130.705,131.97,125.82913152173911,139.31426714285715,126.86571470000031,131.79779440000002,131.92173939999995,128.67030050000008,130.62757113432062,129.5192851510326,128.6046923076924,131.60443256053995,125.60495205484487,126.86571470000031,131.79779440000002,131.92173939999995,128.67030050000008,131.61833,223496496,213954744.0,57.841686719009154,1.5,2.75,1.633803607771341,1.044597057403878,0.5430767524227273,-0.4828702579484059,-1.0259470103711332,15.719010710014606,3.8724911452184188,4707234093.0,2011-06-30,2011,3,181,6,1.13,131.44,134.10001,131.78,2891
2011-07-01 13:30:00,132.09,134.10001,131.78,133.92,125.75695782608696,139.36508326530614,126.97006470000031,131.8112943,131.93813919999994,128.84530050000006,130.75668599179824,129.93840085093424,128.9585376923078,133.0856736477185,124.83140173689716,126.97006470000031,131.8112943,131.93813919999994,128.84530050000006,133.26666999999998,202385632,212339519.2,63.18655518979392,1.5,2.75,1.6828183500733878,0.9531227760263292,0.755910590978527,-0.08105877164797448,-0.8369693626265015,16.442622291049695,4.870790916209853,4909619725.0,2011-07-01,2011,4,182,7,1.76,132.94,134.08,133.39,2892
2011-07-05 13:30:00,133.78,134.08,133.39,133.81,125.68478413043478,139.41589938775508,127.07666465000031,131.82670430000002,131.93873919999996,129.08355050000006,130.87642379604142,130.3071245794167,129.4808453846155,134.17422387218542,124.78746689704556,127.07666465000031,131.82670430000002,131.93873919999996,129.08355050000006,133.76000000000002,165935936,211638760.0,62.7036196525614,1.5,2.75,1.6119027536395762,0.7840526754173007,0.8502951823422423,0.22589961530130154,-0.6243955670409408,16.81061377838784,3.368095789880273,4743683789.0,2011-07-05,2011,1,186,7,0.52,133.74,134.14,133.11,2893
2011-07-06 13:30:00,133.49001,134.14,133.11,133.97,125.6126104347826,139.4667155102041,127.17546460000031,131.84319430000002,131.94533919999995,129.33405000000008,130.99774050992218,130.6559698575675,129.99392230769243,135.0646392887627,124.92320532662218,127.17546460000031,131.84319430000002,131.94533919999995,129.33405000000008,133.74,143332688,210715097.6,63.144859310940674,1.5,2.75,1.5703382712367475,0.6802203052013298,0.8807830585799981,0.4765832561840568,-0.4041998023959413,15.881845443672798,4.119064272946306,4887016477.0,2011-07-06,2011,2,187,7,0.77,133.62,135.7,134.88,2894
2011-07-07 13:30:00,135.16,135.7,134.88,135.36,125.54043673913044,135.7,127.28236460000035,131.8656943,131.95671919999995,129.68105000000008,131.16880950953308,131.10397272827535,130.6331530769232,136.13505927347154,125.13124688037487,127.28236460000035,131.8656943,131.95671919999995,129.68105000000008,135.31333333333333,170464192,209303491.2,66.8176371823719,1.5,2.75,1.5817426804341217,0.8144354927988894,0.9461117305518238,0.7784398607938385,-0.16767186975798531,15.066844382972107,5.501913897936407,5057480669.0,2011-07-07,2011,3,188,7,0.61,135.29,135.3558,133.39,2895
2011-07-08 13:30:00,133.83,135.3558,133.39,134.39999,125.46826304347826,135.6678263043478,127.38726455000034,131.8753943,131.93131899999997,129.93105000000008,131.29552246994353,131.41787913510626,131.14853692307705,136.70975607974657,125.58731776640751,127.38726455000034,131.8753943,131.93131899999997,129.93105000000008,134.38192999999998,194171504,210963848.0,62.206796992233784,1.5,2.75,1.6094753461174007,0.9204017932020276,0.8777247732152575,0.9294840967610868,0.0517593235458291,16.048085447846773,5.9853245012223,4863309165.0,2011-07-08,2011,4,189,7,1.47,134.37,133.17999,131.66,2896
2011-07-11 13:30:00,132.75,133.17999,131.66,131.97,125.39608934782608,135.63565260869564,127.48462455000036,131.8649944,131.84851899999995,130.14954950000006,131.32197256916143,131.47046207461997,131.3423830769232,136.82843663264345,125.85632952120295,127.48462455000036,131.8649944,131.84851899999995,130.14954950000006,132.26999666666666,195918560,208828310.4,52.357957397720384,1.5,2.75,1.6902263928233014,0.938180075415675,0.6333012054757843,0.8433858303905595,0.2100846249147752,18.70400105961898,3.1499140221979065,4667390605.0,2011-07-11,2011,0,192,7,1.15,132.42,132.78,131.36,2897
2011-07-12 13:30:00,131.69,132.78,131.36,131.39999,125.32391565217392,135.60347891304346,127.56752445000036,131.8404942,131.74791899999997,130.33454900000007,131.32503207625314,131.4637504484657,131.55238230769243,136.81773898932204,126.28702562606286,127.56752445000036,131.8404942,131.74791899999997,130.33454900000007,131.84666333333334,214675632,209182104.8,50.34441314587981,1.5,2.75,1.670924507621636,1.026261936723757,0.4086105448400041,0.7208478059647803,0.3122372611247762,18.974327804328045,1.3810585602962646,4452714973.0,2011-07-12,2011,1,193,7,1.08,132.07,133.22,131.519,2898
2011-07-13 13:30:00,132.09,133.22,131.519,131.84,125.25174195652174,135.57130521739128,127.65537445000037,131.8163942,131.66031899999996,130.46054850000007,131.34522689679224,131.499583739088,131.82461384615394,136.74398466464882,126.90524302765913,127.65537445000037,131.8163942,131.66031899999996,130.46054850000007,132.19299999999998,204062560,211356714.4,51.88272457419332,1.5,2.75,1.6815734713629475,0.9654888919866744,0.2715925545251156,0.6517279542811707,0.3801353997560551,17.834967372082343,0.8567931456548382,4656777533.0,2011-07-13,2011,2,194,7,1.29,132.37,132.78,130.67999,2899
2011-07-14 13:30:00,132.17,132.78,130.67999,130.92999,125.17956826086956,135.5391315217391,127.73667440000037,131.7803941,131.56431879999997,130.65604800000008,131.32894309691804,131.4453367163177,132.1415361538463,136.17977503593414,128.10329727175844,127.73667440000037,131.7803941,131.56431879999997,130.65604800000008,131.4633266666667,226111744,207614404.0,48.53391989407701,1.5,2.75,1.7114617948370223,1.0890946853571877,0.10993466805287112,0.517553734822144,0.4076190667692728,17.876831986547785,-0.7880654694248657,4430665789.0,2011-07-14,2011,3,195,7,1.61,131.73,131.87,130.77,2900
2011-07-15 13:30:00,131.66,131.87,130.77,131.69,125.1073945652174,135.50695782608693,127.82277440000036,131.77899409999998,131.50151879999996,130.87554800000007,131.34310219115656,131.4686379814303,132.42999769230784,135.68662224025792,129.17337314435778,127.82277440000036,131.77899409999998,131.50151879999996,130.87554800000007,131.44333333333333,220124624,203218715.2,51.35774975420207,1.5,2.75,1.6677859523486636,1.0831907080180183,0.04763355714197698,0.4671610131967441,0.4195274560547671,17.28232684539708,-1.6651732377538755,4650790413.0,2011-07-15,2011,4,196,7,0.84,131.32,131.28,129.63,2901
2011-07-18 13:30:00,131.08,131.28,129.63,130.61,125.03522086956522,135.47478413043476,127.90517440000036,131.77489409999998,131.44151879999995,131.05354800000006,131.314353085621,131.38686293557979,132.5069207692309,135.53251887864545,129.48132265981636,127.90517440000036,131.77489409999998,131.44151879999995,131.05354800000006,130.50666666666666,196872064,201312515.2,47.37945778426215,1.5,2.75,1.6958012414666164,0.9779424980330284,-0.06666043063917282,0.3362019177558011,0.4028623483949739,14.906517430830275,-2.391450564232859,4453918349.0,2011-07-18,2011,0,199,7,1.27,130.45,132.89,131.31,2902
2011-07-19 13:30:00,131.34,132.89,131.31,132.73,124.96304717391304,135.4426104347826,127.99577440000036,131.79289419999998,131.41211879999994,131.30504800000008,131.36986865089077,131.51478075123887,132.6615361538463,135.50608258645292,129.81698972123968,127.99577440000036,131.79289419999998,131.41211879999994,131.30504800000008,132.30999999999997,166554880,201666312.0,54.78372723953064,1.5,2.75,1.737529724218999,0.8258934194224765,-0.0031826098498967115,0.3988840860826031,0.4020666959324998,18.358868130638555,-0.9255803538105614,4620473229.0,2011-07-19,2011,1,200,7,1.2,132.1,133.14999,132.42,2903
2011-07-20 13:30:00,133.07001,133.14999,132.42,132.64999,124.89087347826089,135.41043673913043,128.09027435000036,131.79609409999998,131.37071859999998,131.46504750000008,131.42006948811073,131.62289591778756,132.7138430769232,135.53047156888346,129.89721458496297,128.09027435000036,131.79609409999998,131.37071859999998,131.46504750000008,132.73999333333333,137145312,198865715.2,54.47220080018721,1.5,2.75,1.6655626010605002,0.6896377883038937,0.027999279517340547,0.43706579532917533,0.4090665158118349,18.316054386431233,-2.0020759456264856,4483327917.0,2011-07-20,2011,2,201,7,0.55,132.78,134.82001,132.6693,2904
2011-07-21 13:30:00,133.39999,134.82001,132.6693,134.49001,124.8186997826087,135.37826304347826,128.18252445000036,131.80949429999998,131.34311879999996,131.75604800000008,131.54045931210638,131.89595440180778,132.75769000000014,135.66436658128228,129.85101341871797,128.18252445000036,131.80949429999998,131.34311879999996,131.75604800000008,133.99310666666668,245270320,202284909.6,60.09251562755487,1.5,2.75,1.7015952724133212,1.2124993430552964,0.15977211161726526,0.6087816553334164,0.4490095437161512,19.18120887319269,0.06697917165024325,4728598237.0,2011-07-21,2011,3,202,7,1.62,133.74,134.72,133.75999,2905
2011-07-22 13:30:00,134.52,134.72,133.75999,134.58,124.74652608695652,135.34608934782608,128.27527445000038,131.84599440000002,131.34591879999996,132.06999850000003,131.6596569861414,132.1515777921118,132.8169207692309,135.83615898895695,129.79768254950486,128.27527445000038,131.84599440000002,131.34591879999996,132.06999850000003,134.35333,126019312,191871532.8,60.35031397597885,1.5,2.75,1.6486248958123704,0.6567900415501345,0.2356386690769172,0.7435578800622977,0.5079192109853805,18.736156175081163,1.9777222095931,4854617549.0,2011-07-22,2011,4,203,7,0.72,134.24,134.49001,133.16,2906
2011-07-25 13:30:00,133.3,134.49001,133.16,133.83,124.67435239130435,135.3139156521739,128.3649744500004,131.87219429999996,131.32091879999996,132.42099850000002,131.74476847688098,132.31142752619638,132.80615153846168,135.80981997567721,129.80248310124614,128.3649744500004,131.87219429999996,131.32091879999996,132.42099850000002,133.82667,136653680,187397748.0,57.04296829149441,1.5,2.75,1.632294546111488,0.7292173009464341,0.2183439387491581,0.7808491344218282,0.5625051956726701,15.292081097636846,1.8493228195831752,4717963869.0,2011-07-25,2011,0,206,7,1.0,133.83,133.96001,133.03,2907
2011-07-26 13:30:00,133.74001,133.96001,133.03,133.33,124.60217869565216,135.28174195652173,128.4489369000004,131.87079429999997,131.30671899999996,132.69049850000005,131.8069344189641,132.4084344284634,132.6499976923078,135.29614794101485,130.00384744360076,128.4489369000004,131.87079429999997,131.30671899999996,132.69049850000005,133.44000333333335,131278128,185516244.8,54.88355526566282,1.5,2.75,1.5821313642463823,0.7076368333216714,0.15902090236383004,0.7612813236274576,0.6022604212636276,15.215518359414173,1.1301577669902982,4586685741.0,2011-07-26,2011,1,207,7,0.7,133.5,132.63,130.42999,2908
2011-07-27 13:30:00,132.59,132.63,130.42999,130.60001,124.530005,135.24956826086955,128.5186870000004,131.85209440000003,131.25491919999996,132.73999900000007,131.75960404959295,132.2362035305145,132.3576915384617,135.0055400191318,129.70984305779155,128.5186870000004,131.85209440000003,131.25491919999996,132.73999900000007,131.22,249020000,189689432.0,44.891149489405976,1.5,2.75,1.6762655525144985,1.3127774034348945,-0.06621004338065127,0.5194978670378134,0.5857079104184647,19.701543029431733,-0.25202782036415505,4337665741.0,2011-07-27,2011,2,208,7,1.69,131.53,131.77,130.00999,2909
2011-07-28 13:30:00,130.60001,131.77,130.00999,130.22,124.45783130434783,135.21739456521738,128.5847370500004,131.83999450000002,131.19591919999996,132.71499900000006,131.69922742019716,132.04418414665597,132.22307615384628,135.1037771147746,129.34237519291796,128.5847370500004,131.83999450000002,131.19591919999996,132.71499900000006,130.66666333333333,207939872,187871656.8,43.69849951697192,1.5,2.75,1.6822472987634645,1.1068187481912917,-0.23350073448867856,0.2938319923076165,0.5273327267962951,19.388653426933192,-1.1162578783506711,4129725869.0,2011-07-28,2011,3,209,7,1.35,130.89,130.55,127.96671,2910
2011-07-29 13:30:00,128.91,130.55,127.96671,129.33,124.38565760869564,135.1852208695652,128.64178705000043,131.80749449999996,131.09531919999998,132.58299900000006,131.60631654097375,131.78569041840302,132.0638461538463,135.31406450831082,128.81362779938178,128.64178705000043,131.80749449999996,131.09531919999998,132.58299900000006,129.28223666666668,307042560,192048960.0,40.9542066403,1.5,2.75,1.7466074917089318,1.5987723130601696,-0.3877201169813415,0.04268258056961827,0.4304026975509597,19.235453205648067,-0.9800168440395076,3822683309.0,2011-07-29,2011,4,210,7,2.02,129.26,130.96001,127.53,2911
2011-08-01 13:30:00,130.84,130.96001,127.53,128.78,124.31348391304348,135.15304717391302,128.69838700000042,131.7713945,130.97731939999997,132.32599900000008,131.49548059819045,131.49943418807894,131.82846153846168,135.52236501608434,128.13455806083905,128.69838700000042,131.7713945,130.97731939999997,132.32599900000008,129.09000333333333,325790720,198219214.4,39.3112062378281,1.5,2.75,1.8668505280154373,1.6435879891167604,-0.5030805233291628,-0.19844795661049372,0.304632566718669,18.882499659735966,-2.9759662472688837,3496892589.0,2011-08-01,2011,0,213,8,2.69,129.25,128.5,125.49001000000001,2912
2011-08-02 13:30:00,127.81,128.5,125.49001000000001,125.49001000000001,124.2413102173913,135.12087347826085,128.73733705000043,131.72691959999997,130.8149196,131.90999950000008,131.25997194728106,130.92710807492858,131.41000153846167,136.41579209926928,126.40421097765403,128.73733705000043,131.72691959999997,130.8149196,131.90999950000008,126.49334,346653696,207255102.4,31.23810491024446,1.5,2.75,1.9685033474429063,1.6725942666104416,-0.7617506315364742,-0.6475557227019237,0.11419490883455045,19.970232421042386,-5.397648352630863,3150238893.0,2011-08-02,2011,1,214,8,2.4,127.0,126.31,123.53,2913
2011-08-03 13:30:00,125.66,126.31,123.53,126.17,124.16913652173912,135.08869978260867,128.77678705000042,131.6802196,130.69711959999998,131.5199995000001,131.06036520425042,130.4740501630306,130.9853861538463,136.7091192622356,125.261653045457,128.77678705000042,131.6802196,130.69711959999998,131.5199995000001,125.33666666666666,371029504,218639943.2,34.243855930275046,1.5,2.75,2.026467394054128,1.6969886589322898,-0.8415935372162737,-0.9377970126857916,-0.096203475469518,20.799431512153863,-6.186340531910147,3521268397.0,2011-08-03,2011,2,215,8,2.25,124.92,124.62,120.06,2914
2011-08-04 13:30:00,124.42,124.62,120.06,120.25998999999999,124.09696282608697,135.0565260869565,128.7944370000004,131.58231949999998,130.46331940000002,130.76499900000007,130.6368210785935,129.50128252845624,130.18923153846166,138.2872206891259,122.09124238779741,128.7944370000004,131.58231949999998,130.46331940000002,130.76499900000007,121.64666333333334,520721920,236152829.6,24.301186225302768,1.5,2.75,2.3181482944788323,2.205020879411051,-1.2238057624107943,-1.6259606784830112,-0.4021549160722167,28.956207734605638,-10.64051865061674,3000546477.0,2011-08-04,2011,3,216,8,3.8,122.34,122.07001000000001,116.86,2915
2011-08-05 13:30:00,121.75998999999999,122.07001000000001,116.86,120.08,124.02478913043478,135.02435239130432,128.80548700000043,131.4975195,130.21711939999997,130.0489995000001,130.22282809511924,128.60401752574612,129.21615461538474,138.76857318581287,119.6637360449566,128.80548700000043,131.4975195,130.21711939999997,130.0489995000001,119.67000333333333,655561472,259222328.0,24.071953545010427,1.5,2.75,2.5247098448732013,2.5289544965432142,-1.4070352318780266,-2.16094895591975,-0.7539137240417233,28.657591274819733,-10.274228498841824,2344985005.0,2011-08-05,2011,4,217,8,4.46,119.47,120.1218,112.02,2916
2011-08-08 13:30:00,116.91,120.1218,112.02,112.25998999999999,123.95261543478262,134.99217869565214,128.77613695000042,131.35836940000002,129.80231919999997,129.0634990000001,129.51840307178122,127.04744347567505,127.6476930769232,140.54131271570608,114.75407343814034,128.77613695000042,131.35836940000002,129.80231919999997,129.0634990000001,114.80059666666666,702263808,284539590.4,16.700864870800544,1.5,2.75,2.9230734273822585,2.4680706365422536,-1.940302283443009,-3.1792915783454845,-1.2389892949024754,42.567080933876795,-15.80290257256432,1642721197.0,2011-08-08,2011,0,220,8,7.23,116.07,117.64,110.27,2917
2011-08-09 13:30:00,114.07001000000001,117.64,110.27,117.48,110.27,134.96000499999997,128.7718019500004,131.25466930000002,129.48171939999997,128.3674995000001,129.04630883367216,126.13625838275362,126.3392307692309,139.6359089398051,113.04255259865671,128.7718019500004,131.25466930000002,129.48171939999997,128.3674995000001,115.13,717828608,309697239.2,31.729005157847308,1.5,2.75,3.2407110397120973,2.317839867911874,-1.8284054161645305,-3.5244960651081385,-1.696090648943608,55.710549118904,-10.045948694797183,2360549805.0,2011-08-09,2011,1,221,8,6.68,113.96,116.28,111.95,2918
2011-08-10 13:30:00,115.25998999999999,116.28,111.95,112.28998999999999,109.7725,134.92783130434782,128.7397519000004,131.0999693,129.02951939999997,127.38999900000009,128.3891982911752,124.81756615582472,124.62461461538473,138.93821698053702,110.31101225023248,128.7397519000004,131.0999693,129.02951939999997,127.38999900000009,113.50666333333334,662607360,332624479.2,26.592125981472353,1.5,2.75,3.404231679732661,1.9920583163140808,-1.9781739730439785,-4.168808115248581,-2.1906341422046025,58.68901129278054,-13.769013976347717,1697942445.0,2011-08-10,2011,2,222,8,3.87,114.12,118.92,112.31700000000001,2919
2011-08-11 13:30:00,113.25998999999999,118.92,112.31700000000001,117.33,109.275,134.89565760869564,128.73280190000042,130.9758692,128.73871939999998,126.7099995000001,127.95550424054086,124.10446461717474,123.35538384615398,137.0934546522177,109.61731304009028,128.73280190000042,130.9758692,128.73871939999998,126.7099995000001,116.189,487979776,345717880.8,37.2213750036351,1.5,2.75,3.6346444168946137,1.4114970705906282,-1.6267335974155333,-4.224051138974018,-2.597317541558486,67.68445936221707,-9.278589654372547,2185922221.0,2011-08-11,2011,3,223,8,5.88,115.62,119.215,117.28,2920
2011-08-12 13:30:00,118.39998999999999,119.215,117.28,118.12,108.7775,134.86348391304347,128.7315019000004,130.8641693,128.46651939999998,126.03149950000008,127.56979819189225,123.53451560601525,122.185383846154,134.877089100863,109.493678591445,128.7315019000004,130.8641693,128.46651939999998,126.03149950000008,118.205,313731584,350398228.8,38.719212335254284,1.5,2.75,3.5132412442592846,0.8953572199106961,-1.2470863126186909,-4.15617543233185,-2.9090891197131588,68.38845962295186,-8.277682870010867,2499653805.0,2011-08-12,2011,4,224,8,1.65,118.25,120.74001000000001,119.0,2921
2011-08-15 13:30:00,119.19,120.74001000000001,119.0,120.62,108.28,134.8313102173913,128.7426019500004,130.77376930000003,128.27051939999998,125.53199950000008,127.29725708632783,123.25694269115664,121.4176907692309,133.15180803572642,109.68357350273537,128.7426019500004,130.77376930000003,128.27051939999998,125.53199950000008,120.12000333333332,258810560,353495153.6,43.32733555343464,1.5,2.75,3.4494390125264784,0.7321474067303875,-0.7576906545259017,-3.856202437870536,-3.0985117833446343,70.52729180829304,-3.880794973241291,2758464365.0,2011-08-15,2011,0,227,8,1.46,119.87,120.69,118.31,2922
2011-08-16 13:30:00,119.47,120.69,118.31,119.59,107.7825,134.79913652173911,128.7481019000004,130.66066940000002,128.08141940000002,124.87499950000007,126.99501171039341,122.90771005390364,120.5999984615386,131.19257405594792,110.00742286712929,128.7481019000004,130.66066940000002,128.08141940000002,124.87499950000007,119.53000000000002,294095104,359872164.8,41.92842423238242,1.5,2.75,3.373050511631729,0.8172210378189272,-0.4487111943253464,-3.6594007762513168,-3.210689581925971,69.48557761107129,-5.215185860347148,2464369261.0,2011-08-16,2011,1,228,8,2.01,119.5,121.2,118.72,2923
2011-08-17 13:30:00,120.25,121.2,118.72,119.67,107.285,134.76696282608694,128.75380190000038,130.54436940000002,127.89561919999998,124.22600000000007,126.7077563492015,122.59935671543666,119.85692153846169,129.1741097046025,110.53973337232088,128.75380190000038,130.54436940000002,127.89561919999998,124.22600000000007,119.86333333333334,238201056,364924952.0,42.084831874619134,1.5,2.75,3.3092611893723207,0.6527398433418168,-0.19715001517470654,-3.4571271008943536,-3.2599770857196475,69.28408250851483,-0.4905954174784151,2702570317.0,2011-08-17,2011,2,229,8,2.09,119.96,119.714,113.39,2924
2011-08-18 13:30:00,116.5,119.714,113.39,114.50998999999999,106.7875,134.73478913043476,128.7289768000004,130.37966930000005,127.61741899999996,123.22699900000008,126.22941257080144,121.82894083777599,118.7592284615386,126.9009867532518,110.6174701698254,128.7289768000004,130.37966930000005,127.61741899999996,123.22699900000008,115.87133,512956160,378309244.0,35.452239943807285,1.5,2.75,3.5245996758457263,1.3559175942314536,-0.3287206067227033,-3.6708778441230265,-3.342157237400323,68.43832263616738,-4.638582611592268,2189614157.0,2011-08-18,2011,3,230,8,5.58,116.55,115.88,112.5,2925
2011-08-19 13:30:00,112.96001000000001,115.88,112.5,112.64,106.29,134.7026154347826,128.69242680000036,130.18746930000003,127.2822192,122.12999900000008,125.69649443077006,120.9538036151307,117.7707661538463,125.51428011605879,110.02725219163378,128.69242680000036,130.18746930000003,127.2822192,122.12999900000008,113.67333333333332,428281344,393422345.6,33.39799823273424,1.5,2.75,3.5142711275710314,1.088604520790087,-0.482823010760244,-3.945686000850628,-3.462862990090384,68.70392208674336,0.3385088489674715,1761332813.0,2011-08-19,2011,4,231,8,3.0,114.19,115.23,112.41,2926
2011-08-22 13:30:00,115.17,115.23,112.41,112.73,105.7925,134.6704417391304,128.64477685000037,129.98706930000003,126.98481899999996,121.07499900000008,125.18800445309276,120.17058422321348,116.73692000000014,123.202065116521,110.2717748834793,128.64477685000037,129.98706930000003,126.98481899999996,121.07499900000008,113.45666666666666,275090688,400344196.0,33.597423738098804,1.5,2.75,3.464680332744529,0.6871354468193664,-0.5167871814781521,-4.108846966938073,-3.5920597854599223,56.69178459560187,-4.043241402791963,2036423501.0,2011-08-22,2011,0,234,8,2.51,113.82,116.5665,112.58,2927
2011-08-23 13:30:00,113.14998999999999,116.5665,112.58,116.44,105.295,134.63826804347823,128.61335180000037,129.82556929999998,126.75961899999996,120.2304990000001,124.84494545493229,119.81529048766932,116.44307461538477,122.57991124243506,110.30623798833449,128.61335180000037,129.82556929999998,126.75961899999996,120.2304990000001,115.1955,331136512,410337115.2,41.38841897613865,1.5,2.75,3.5019531661199212,0.8069864989877962,-0.2414727715216496,-3.893900749861984,-3.652427978340335,53.29550678721797,3.695796927223873,2367560013.0,2011-08-23,2011,1,235,8,3.54,114.57,118.24001000000001,115.92,2928
2011-08-24 13:30:00,116.19,118.24001000000001,115.92,118.08,104.7975,134.60609434782606,128.59130175000038,129.67486940000003,126.53481879999997,119.60449850000008,124.57965347630748,119.65002472693891,116.2892284615386,122.14761071295284,110.4308462101244,128.59130175000038,129.67486940000003,126.53481879999997,119.60449850000008,117.41333666666668,246869680,410229599.2,44.48899051781353,1.5,2.75,3.4175286542542116,0.6017841727691696,0.0817068259630167,-3.550294445886564,-3.632001271849581,45.57706445820999,0.6392227051904884,2614429693.0,2011-08-24,2011,2,236,8,2.0,117.08,119.39998999999999,115.87,2929
2011-08-25 13:30:00,118.73,119.39998999999999,115.87,116.28,104.3,134.57392065217388,128.56465175000037,129.50506950000002,126.32001879999994,118.90749850000013,124.25417686939345,119.32906999103994,116.59846000000013,121.97831693746343,111.21860306253684,128.56465175000037,129.50506950000002,126.32001879999994,118.90749850000013,117.18332999999998,312365312,415450871.2,41.870903978440936,1.5,2.75,3.425561607521768,0.7518706389945825,0.1982267972417211,-3.3842177752974294,-3.5824445725391505,39.35858297631813,-1.5577378936674595,2302064381.0,2011-08-25,2011,3,237,8,3.05,117.63,118.50998999999999,113.85001000000001,2930
2011-08-26 13:30:00,115.69,118.50998999999999,113.85001000000001,117.97,103.8025,134.5417469565217,128.5440017000004,129.3523694,126.13341879999994,118.33949850000009,124.00773856078979,119.19963475379808,116.63615230769246,122.04696305708885,111.22534155829605,128.5440017000004,129.3523694,126.13341879999994,118.33949850000009,116.77666666666669,314495744,415823530.4,45.13544542600582,1.5,2.75,3.5137343498416422,0.7563202200161013,0.40138019679782655,-3.0807193265418675,-3.482099523339694,40.144072035215714,-2.196982258331956,2616560125.0,2011-08-26,2011,4,238,8,4.09,116.18,121.42998999999999,118.0569,2931
2011-08-29 13:30:00,119.56,121.42998999999999,118.0569,121.36,103.305,134.50957326086953,128.5426267500004,129.22936940000002,126.01961879999992,117.9684985000001,123.90390567605291,119.40538382486493,117.33384538461551,122.66149067684843,112.00620009238258,128.5426267500004,129.22936940000002,126.01961879999992,117.9684985000001,120.2822966666667,190977184,409082853.6,51.0713819028646,1.5,2.75,3.5098954677100966,0.466842309129722,0.7557593157606409,-2.537400378638893,-3.2931596943995336,41.75041111622658,1.4800568609415468,2807537309.0,2011-08-29,2011,0,241,8,2.86,119.74,122.42998999999999,119.25998999999999,2932
2011-08-30 13:30:00,120.83,122.42998999999999,119.25998999999999,121.67998999999999,102.8075,134.47739956521735,128.5500367000004,129.11296920000004,125.89921859999993,117.77799750000014,123.81669329659988,119.6220129844016,117.66846000000015,123.47775632093945,111.85916367906088,128.5500367000004,129.11296920000004,125.89921859999993,117.77799750000014,121.12332333333332,241315680,403815952.8,51.60365115297481,1.5,2.75,3.4856172200165187,0.5975882783400527,0.9887032524669276,-2.0572806288158745,-3.0459838812828015,41.34238495821864,1.6796105958051324,3048852989.0,2011-08-30,2011,1,242,8,2.66,120.84,123.50998999999999,121.3,2933
2011-08-31 13:30:00,122.46001000000001,123.50998999999999,121.3,122.22,102.31,123.50998999999999,128.5609867000004,129.00656920000003,125.75461859999994,117.58049750000008,123.7540778732038,119.86944031922049,117.98384461538477,124.28159276596584,111.6860964648037,128.5609867000004,129.00656920000003,125.75461859999994,117.58049750000008,122.34332999999998,301828352,400355895.2,52.54192290990942,1.5,2.75,3.3945009900153384,0.7539001064271078,1.145110371128164,-1.6145959173725968,-2.7597062885007606,41.363221044080476,6.7330457368828664,3350681341.0,2011-08-31,2011,2,243,8,1.82,122.4,123.39998999999999,120.78,2934
2011-09-01 13:30:00,122.28998999999999,123.39998999999999,120.78,120.94,101.8125,123.19742564102563,128.5748867000004,128.89136910000002,125.60001859999993,117.6144980000001,123.64372187817621,119.97139838405664,118.00846000000016,124.34958258369299,111.66733741630732,128.5748867000004,128.89136910000002,125.60001859999993,117.6144980000001,121.70666333333334,254585872,387049092.8,50.064290019199895,1.5,2.75,3.339178776442815,0.657761190339625,1.126587850900008,-1.3514714748757513,-2.4780593257757597,30.815232575052104,7.368607954545452,3096095469.0,2011-09-01,2011,3,244,9,2.17,122.09,120.8726,117.42998999999999,2935
2011-09-02 13:30:00,118.42,120.8726,117.42998999999999,117.85001000000001,101.315,122.88486128205128,128.5730467500004,128.75516920000004,125.39099899999994,117.50299850000009,123.41651749079675,119.76936139509884,117.87461461538479,124.149666898825,111.59956233194458,128.5730467500004,128.75516920000004,125.39099899999994,117.50299850000009,118.71753333333334,255517184,367046878.4,44.59704132005041,1.5,2.75,3.3513810066968994,0.696143187796145,0.8813167481528006,-1.3764133905847586,-2.2577301387375592,33.60725286291038,4.541834471746644,2840578285.0,2011-09-02,2011,4,245,9,2.93,119.15,117.16,114.38,2936
2011-09-06 13:30:00,114.39,117.16,114.38,116.99001000000001,100.8175,122.57229692307692,128.5582093000004,128.6104692,125.19459919999994,117.73949950000014,123.16449758919687,119.5046612622323,117.6684615384617,123.8696907523756,111.46723232454781,128.5582093000004,128.6104692,125.19459919999994,117.73949950000014,116.17667,285142784,346190827.2,43.18357513436499,1.5,2.75,3.3598545062185496,0.8236578256744753,0.6470855962256241,-1.4488731434555289,-2.095958739681153,34.251973934617055,0.4723548608725527,2555435501.0,2011-09-06,2011,1,249,9,2.43,115.77,120.34,118.36,2937
2011-09-07 13:30:00,118.75998999999999,120.34,118.36,120.28998999999999,100.32,122.25973256410255,128.5582093000004,128.49776910000003,125.04159899999996,117.87999900000014,123.05177180138523,119.57945447535305,118.11307692307709,124.17192002980094,112.0542338163532,128.5582093000004,128.49776910000003,125.04159899999996,117.87999900000014,119.66332999999996,209803120,320789552.8,49.763169864193046,1.5,2.75,3.3591498986315114,0.6540210495283935,0.6960582217881566,-1.2258859624459577,-1.921944184234114,32.93207661318751,1.8716039972899767,2765238621.0,2011-09-07,2011,2,250,9,1.67,119.35,120.94,118.77,2938
2011-09-08 13:30:00,119.57001000000001,120.94,118.77,119.03998999999999,99.8225,121.94716820512821,128.55245925000042,128.36776910000003,124.83019879999996,118.21749900000013,122.89444702486031,119.5280769062718,118.605383846154,123.78106579409656,113.42970189821145,128.55245925000042,128.36776910000003,124.83019879999996,118.21749900000013,119.58333,250568192,300187594.4,47.51840683210882,1.5,2.75,3.274210620157832,0.8347053531669862,0.62801471105426,-1.136925795416289,-1.764940506470549,33.00272135375921,2.37357241142071,2514670429.0,2011-09-08,2011,3,251,9,1.83,119.85,119.05701,115.28,2939
2011-09-09 13:30:00,117.67998999999999,119.05701,115.28,115.92,99.325,121.63460384615385,128.5398218000004,128.22136910000003,124.53419879999996,118.14699900000014,122.6209392983952,119.18445053424593,118.85076846153862,123.11035839932433,114.59117852375292,128.5398218000004,128.22136910000003,124.53419879999996,118.14699900000014,116.7523366666667,380195072,294798359.2,42.3797593709602,1.5,2.75,3.3101248615751295,1.2896783856997804,0.36942494061509934,-1.3031593307016751,-1.6725842713167742,35.532528310592205,-1.7377299313384735,2134475357.0,2011-09-09,2011,4,252,9,3.28,117.17,116.75998999999999,114.05,2940
2011-09-12 13:30:00,114.47,116.75998999999999,114.05,116.67,98.8275,121.32203948717951,128.5221718000004,128.07496910000003,124.22819879999996,118.07449900000013,122.38756912983071,118.94497905479393,118.86846076923092,123.08958796833231,114.6473335701295,128.5221718000004,128.07496910000003,124.22819879999996,118.07449900000013,115.82666333333334,305793536,294401456.8,43.948906922229824,1.5,2.75,3.267258085748335,1.0386957297148809,0.2510918957839936,-1.3587194015867825,-1.609811297370776,34.60659121393022,-3.8645352669742894,2440268893.0,2011-09-12,2011,0,255,9,2.38,115.4,118.17998999999999,116.22,2941
2011-09-13 13:30:00,117.05,118.17998999999999,116.22,117.74001000000001,98.33,121.00947512820515,128.5168718500004,127.92136910000004,123.90459899999996,117.93049950000014,122.20531190905302,118.8302200971945,118.84230769230786,123.08679958615606,114.59781579845965,128.5168718500004,127.92136910000004,123.90459899999996,117.93049950000014,117.38,272514560,295086656.8,46.19994425615602,1.5,2.75,3.1738817939091684,0.9235068876214941,0.2467222644629432,-1.3014084667920969,-1.54813073125504,30.101209214399532,-3.237985144476101,2712783453.0,2011-09-13,2011,1,256,9,1.69,117.2,120.8,116.72,2942
2011-09-14 13:30:00,118.34,120.8,116.72,119.37,97.8325,120.69691076923077,128.5179118500004,127.77726910000004,123.61579899999997,117.91949950000013,122.09412320673721,118.8816277069855,119.08000000000015,123.06186780296377,115.09813219703652,128.5179118500004,127.77726910000004,123.61579899999997,117.91949950000013,118.96333333333332,319389440,296351373.6,49.52541517147195,1.5,2.75,3.2386045229156566,1.0777390235116493,0.34918604162325906,-1.1116481792259665,-1.460834220849225,31.505757440649468,-2.331860579283255,3032172893.0,2011-09-14,2011,2,257,9,3.5,118.76,121.47,119.4034,2943
2011-09-15 13:30:00,120.64998999999999,121.47,119.4034,121.42998999999999,97.335,120.3843464102564,128.5325993500004,127.65516900000004,123.36499879999994,118.00749900000014,122.0680787672573,119.12432887774878,119.34615307692324,123.4561445579671,115.23616159587937,128.5325993500004,127.65516900000004,123.36499879999994,118.00749900000014,120.76779666666668,326777088,300780175.2,53.442183529742344,1.5,2.75,3.1572756284216807,1.0864316033552202,0.539885338820173,-0.7859775473240092,-1.325862886144182,33.22925768726057,0.4051513147015098,3358949981.0,2011-09-15,2011,3,258,9,1.73,120.44,121.97,120.32001000000001,2944
2011-09-16 13:30:00,121.28998999999999,121.97,120.32001000000001,121.521,96.8375,120.07178205128206,128.5351544000004,127.52246900000006,123.08821879999994,118.35804950000013,122.04662469795313,119.35258327034414,119.35853769230785,123.49362147724676,115.22345390736898,128.5351544000004,127.52246900000006,123.08821879999994,118.35804950000013,121.27033666666668,284528128,289358773.6,53.613443534392786,1.5,2.75,3.0496123692487034,0.9833056881604091,0.6490059666967818,-0.5146054277732048,-1.1636113944699866,32.62863404443247,3.1149679155733665,3643478109.0,2011-09-16,2011,4,259,9,1.37,121.15,120.92998999999999,118.72,2945
2011-09-19 13:30:00,119.53,120.92998999999999,118.72,120.31,96.34,119.7592176923077,128.52390440000042,127.36886900000003,122.80641899999996,118.74154950000013,121.97852176862163,119.44376581602563,119.253153846154,123.2123009218678,115.29400677044019,128.52390440000042,127.36886900000003,122.80641899999996,118.74154950000013,119.98666333333334,241516944,280020553.6,50.928918176255046,1.5,2.75,3.031854342873796,0.8624972020625273,0.6167039291125702,-0.39273148307927386,-1.009435412191844,29.01719699245204,2.8378405985263218,3401961165.0,2011-09-19,2011,0,262,9,1.86,119.82,121.99001000000001,120.00998999999999,2946
2011-09-20 13:30:00,120.82001000000001,121.99001000000001,120.00998999999999,120.17,95.8425,119.44665333333334,128.5103044000004,127.20946900000004,122.57041899999994,119.11354950000013,121.90759934632273,119.51293097640415,119.09546153846169,122.71839743384271,115.47252564308069,128.5103044000004,127.20946900000004,122.57041899999994,119.11354950000013,120.72333333333334,218932128,277212625.6,50.61339746313077,1.5,2.75,2.9567233183828106,0.7897624703281191,0.5643973557644664,-0.3039387174862611,-0.8683360732507275,28.499790509959425,-0.09975061100262904,3183029037.0,2011-09-20,2011,1,263,9,1.65,121.0,120.60001000000001,116.44,2947
2011-09-21 13:30:00,120.23,120.60001000000001,116.44,116.63,95.345,119.13408897435896,128.47965445000042,127.01146910000004,122.27501919999996,119.12304950000014,121.70063466607479,119.23836612150852,118.76392307692322,122.43944113874132,115.08840501510514,128.47965445000042,127.01146910000004,122.27501919999996,119.12304950000014,117.89000333333333,316251136,276468356.8,43.30731467489757,1.5,2.75,3.0426723670697524,1.1438963202171424,0.2840278912395405,-0.5133012092013018,-0.7973291004408424,29.112652204700645,-2.024521339425522,2866777901.0,2011-09-21,2011,2,264,9,3.57,118.52,114.21001000000001,111.3,2948
2011-09-22 13:30:00,113.25,114.21001000000001,111.3,112.86,94.8475,118.82152461538462,128.4298044500004,126.77786910000003,121.89541919999995,118.86204950000015,121.35394311054243,118.63090268136484,118.3800761538463,123.21620072835087,113.54395157934174,128.4298044500004,126.77786910000003,121.89541919999995,118.86204950000015,112.79000333333332,513920000,289820872.8,37.155965002386814,1.5,2.75,3.2060529122790555,1.7732332217308815,-0.13991496423874872,-0.9722228057392784,-0.8323078415005296,33.65875216634094,-2.6397515527950333,2352857901.0,2011-09-22,2011,3,265,9,2.61,112.76,114.16,112.02,2949
2011-09-23 13:30:00,112.11,114.16,112.02,113.53998999999999,94.35,118.50896025641028,128.38110440000042,126.55596900000003,121.54761919999996,118.72504900000015,121.0475135767957,118.1460538545682,118.11469000000014,123.56629217667809,112.6630878233222,128.38110440000042,126.55596900000003,121.54761919999996,118.72504900000015,113.23999666666668,307242496,289564732.0,38.84329148227914,1.5,2.75,3.1299062756876945,1.0610494374708588,-0.34731619435393113,-1.2664530844429436,-0.9191368900890124,31.25129156904428,-2.6827890631696225,2660100397.0,2011-09-23,2011,4,266,9,1.91,113.09,116.39998999999999,112.98,2950
2011-09-26 13:30:00,114.61,116.39998999999999,112.98,116.24001000000001,93.8525,118.19639589743592,128.34350450000045,126.37006910000004,121.23861939999998,118.63854950000015,120.85898402476448,117.96452586841885,117.80315307692322,123.18433587959265,112.4219702742538,128.34350450000045,126.37006910000004,121.23861939999998,118.63854950000015,115.20666666666666,260673632,286873626.4,45.141644298911494,1.5,2.75,3.1506265417100017,0.9086706061871709,-0.2784158142996445,-1.2671566579635678,-0.9887408436639236,34.32606124977347,-1.2739934368954104,2920774029.0,2011-09-26,2011,0,269,9,3.03,114.69,119.56,116.84,2951
2011-09-27 13:30:00,118.53,119.56,116.84,117.53998999999999,93.355,117.88383153846156,128.30880445000045,126.20936900000002,120.97721919999998,118.44754900000015,120.72882739634234,117.92409388095038,117.6877684615386,123.02204310659435,112.35349381648285,128.30880445000045,126.20936900000002,120.97721919999998,118.44754900000015,117.97999666666668,311753728,292912453.6,47.92255427181152,1.5,2.75,3.1627239315878586,1.0643239103303186,-0.12865952571051698,-1.1495652508020695,-1.0209057250915528,34.545550868623856,-1.5330568819636436,3232527757.0,2011-09-27,2011,1,270,9,2.33,118.2,118.49001000000001,114.97,2952
2011-09-28 13:30:00,117.78,118.49001000000001,114.97,115.145,92.8575,117.57126717948721,128.26172945000044,126.01881900000002,120.6255192,118.12079950000015,120.50985377295635,117.65941827324082,117.6281530769232,123.05661209204304,112.1996940618034,128.26172945000044,126.01881900000002,120.6255192,118.12079950000015,116.20167,286696704,295181504.8,43.543143894601286,1.5,2.75,3.1882443650458687,0.971255648941322,-0.17158590439150825,-1.235388105580938,-1.0638022011894301,35.09689199800556,-5.175813651965225,2945831053.0,2011-09-28,2011,2,271,9,3.06,116.73,117.63,113.92998999999999,2953
2011-09-29 13:30:00,117.05,117.63,113.92998999999999,116.05,92.36,117.25870282051281,128.21862945000044,125.83211900000002,120.2935194,117.8122995000002,120.33495754656592,117.50614034245598,117.5804607692309,123.05247303419856,112.10844850426322,128.21862945000044,125.83211900000002,120.2935194,117.8122995000002,115.86999666666668,298108928,294995533.6,45.56739489790471,1.5,2.75,3.2247990532568775,1.0105540391137635,-0.12204304292486268,-1.2163560048455082,-1.0943129619206455,33.462673584424216,-4.5021025172603935,3243939981.0,2011-09-29,2011,3,272,9,3.25,115.78,115.45,113.07001000000001,2954
2011-09-30 13:30:00,114.45,115.45,113.07001000000001,113.14998999999999,91.8625,116.94613846153848,128.16388935000043,125.60491890000002,119.866719,117.42279900000015,120.05319411336723,117.0912688812697,117.22738230769244,123.18356751741815,111.27119709796676,128.16388935000043,125.60491890000002,119.866719,117.42279900000015,113.89,288685568,296700518.4,40.55004269165347,1.5,2.75,3.2073126923099577,0.9729863956988624,-0.2596880600455884,-1.4189230369776311,-1.1592349769320427,35.24667189131131,-5.95130080625052,2955254413.0,2011-09-30,2011,4,273,9,2.1,114.26,113.95,109.81,2955
2011-10-03 13:30:00,112.49001000000001,113.95,109.81,109.92998999999999,91.365,116.63357410256413,128.08943925000045,125.3598188,119.3737188,117.02679800000016,119.65620571676462,116.40924232114878,116.50122769230784,123.45389578906564,109.54855959555007,128.08943925000045,125.3598188,119.3737188,117.02679800000016,111.22999666666664,365136640,302181491.2,35.832281928728655,1.5,2.75,3.2739332142878186,1.2083355553975108,-0.5272723664146368,-1.8183254349503384,-1.2910530685357018,37.39960828631033,-8.52126986768744,2590117773.0,2011-10-03,2011,0,276,10,3.77,111.88,112.58,107.42998999999999,2956
2011-10-04 13:30:00,108.35001000000001,112.58,107.42998999999999,112.34,107.42998999999999,116.32100974358977,128.02963925000046,125.1324188,118.9439188,116.79429750000016,119.3692956886562,116.02169543342032,115.80199769230784,122.45310063660429,109.15089474801138,128.02963925000046,125.1324188,118.9439188,116.79429750000016,110.78333000000002,459177472,310883225.6,41.3337730057615,1.5,2.75,3.4079386989815457,1.4770094819808766,-0.5017770445908478,-1.9182743742742616,-1.4164973296834138,41.247349847228186,-3.678298893938088,3049295245.0,2011-10-04,2011,1,277,10,4.79,110.0,114.72,111.58,2957
2011-10-05 13:30:00,112.62,114.72,111.58,114.42,107.35716923076923,116.0084453846154,127.97873920000046,124.93621890000004,118.56571880000001,116.50079800000016,119.17520566165008,115.86915301118981,115.25576692307709,121.04952880062477,109.46200504552937,127.97873920000046,124.93621890000004,118.56571880000001,116.50079800000016,113.57333333333334,284108032,314598471.2,45.66372289680107,1.5,2.75,3.388800220482864,0.9030814133212482,-0.31383841246351585,-1.8087953452628085,-1.4949569327992926,40.62266917128596,1.3822434875066474,3333403277.0,2011-10-05,2011,2,278,10,2.81,113.15,116.66,113.50998999999999,2958
2011-10-06 13:30:00,114.36,116.66,113.50998999999999,116.49001000000001,107.28434846153849,115.69588102564104,127.93423925000046,124.76921899999999,118.28351880000001,116.37329900000016,119.06990387099712,115.92828224821936,114.96192153846171,120.04433607066834,109.87950700625505,127.93423925000046,124.76921899999999,118.28351880000001,116.37329900000016,115.55333333333333,257800752,314960099.2,49.646773366254465,1.5,2.75,3.371743776162659,0.8185187668368629,-0.033857751374345664,-1.5372791220172246,-1.503421370642879,36.7455455523834,2.5982211201533443,3591204029.0,2011-10-06,2011,3,279,10,2.78,115.08,117.245,115.06,2959
2011-10-07 13:30:00,117.17,117.245,115.06,115.71001000000001,107.2115276923077,115.38331666666667,127.88388930000046,124.59461910000002,117.993319,116.36279950000014,118.93814332703646,115.9074944150556,114.61884538461551,118.7645005957145,110.47319017351658,127.88388930000046,124.59461910000002,117.993319,116.36279950000014,116.00500333333332,312657920,311583241.6,48.212626705107915,1.5,2.75,3.286976363579612,1.0034490892208496,0.1073322100244094,-1.3692561081123669,-1.4765883181367765,37.10844724745238,-0.45595316105014205,3278546109.0,2011-10-07,2011,4,280,10,1.9,116.15,119.63,117.67,2960
2011-10-10 13:30:00,117.67998999999999,119.63,117.67,119.58,107.13870692307691,115.07075230769232,127.85378925000047,124.4468191,117.798319,116.50829950000013,118.9633141769566,116.25725685171696,114.8457684615386,119.67372789110873,110.0178090319685,127.85378925000047,124.4468191,117.798319,116.50829950000013,118.96,230666192,307826874.4,55.13714227055438,1.5,2.75,3.3321916233239253,0.7493374074294276,0.4506363053557945,-0.9132929364420336,-1.3639292417978277,39.424167189385095,1.7355880326346762,3509212301.0,2011-10-10,2011,0,283,10,1.67,118.65,120.03998999999999,118.75,2961
2011-10-11 13:30:00,118.87,120.03998999999999,118.75,119.7,107.06588615384615,114.75818794871796,127.82403930000048,124.2970192,117.616719,116.60629900000013,118.99220381707596,116.58513715155344,115.37192230769249,120.68594642282193,110.05789819256302,127.82403930000048,124.2970192,117.616719,116.60629900000013,119.49666333333334,209087936,304655543.2,55.3365645719526,1.5,2.75,3.186320078800788,0.6863093111775028,0.6622823638404336,-0.5360762869972859,-1.1983586508377195,39.072674358869314,3.955881714360161,3718300237.0,2011-10-11,2011,1,284,10,1.09,119.39,122.14,120.33,2962
2011-10-12 13:30:00,120.60001000000001,122.14,120.33,120.75,106.9930653846154,114.44562358974359,127.79863930000047,124.1684192,117.52191879999998,116.67529900000014,119.06113700072002,116.98179075616741,115.92653846153864,121.83208280905883,110.02099411401841,127.79863930000047,124.1684192,117.52191879999998,116.67529900000014,121.07333333333334,281544704,302763306.4,57.13217046062115,1.5,2.75,3.1330115017435887,0.9299168626069676,0.8381538312325695,-0.15066636179700765,-0.9888201930295772,36.4619522759342,4.049978457561399,3999844941.0,2011-10-12,2011,2,285,10,1.5,121.24,120.87,119.12,2963
2011-10-13 13:30:00,120.03998999999999,120.87,119.12,120.50998999999999,106.92024461538462,114.13305923076923,127.77158925000047,124.0529191,117.40871859999996,116.62929900000013,119.11795476539768,117.31780973177051,116.25499846153863,122.6485642561103,109.86143266696695,127.77158925000047,124.0529191,117.40871859999996,116.62929900000013,120.16666333333332,212538816,297051392.8,56.5723001294425,1.5,2.75,3.034224965904761,0.715495100011529,0.8981472584385033,0.1338638800185521,-0.7642833784199512,36.593659849447626,6.504640433463582,3787306125.0,2011-10-13,2011,3,286,10,1.47,120.0,122.60001000000001,121.23,2964
2011-10-14 13:30:00,121.91,122.60001000000001,121.23,122.57001000000001,106.84742384615384,113.82049487179488,127.75583930000046,123.9591192,117.454919,116.68174950000014,119.25332948048012,117.8180192811257,116.64192307692323,123.855892442494,109.42795371135249,127.75583930000046,123.9591192,117.454919,116.68174950000014,122.13334000000002,211397568,293394864.8,60.17927164859096,1.5,2.75,2.9667817540544212,0.7205223859119159,1.027101102429905,0.51959299961743,-0.5075081028124749,32.07325457702092,11.498245383266196,3998703693.0,2011-10-14,2011,4,287,10,1.13,121.92,122.54919,119.92998999999999,2965
2011-10-17 13:30:00,121.99001000000001,122.54919,119.92998999999999,120.23,106.77460307692309,113.50793051282051,127.72823930000044,123.8375192,117.457919,116.67774950000013,119.29163028516716,118.0477317305423,117.03307692307709,124.42910289390974,109.63705095224444,127.72823930000044,123.8375192,117.457919,116.67774950000013,120.90306000000001,202311568,291434596.0,54.62881604076971,1.5,2.75,2.943441628764819,0.6941920100659567,0.9093774195877318,0.6292136716721899,-0.28016374791554194,28.296807296686648,7.023322058038097,3796392125.0,2011-10-17,2011,0,290,10,2.18,121.24,123.5,119.2,2966
2011-10-18 13:30:00,120.14,123.5,119.2,122.58,106.70178230769231,113.19536615384615,127.70588930000048,123.7333192,117.66431920000001,116.79824950000014,119.42058596025865,118.47937632763349,117.53538461538477,125.46392598240652,109.60684324836302,127.70588930000048,123.7333192,117.66431920000001,116.79824950000014,121.76,318857984,296430888.8,58.744124099796714,1.5,2.75,3.0403386552816163,1.0756570790945184,0.9404451382419702,0.8953926748869208,-0.045052463355049394,27.943661302854988,7.131620346093338,4115250109.0,2011-10-18,2011,1,291,10,3.61,121.35,123.08,120.71001000000001,2967
2011-10-19 13:30:00,122.38,123.08,120.71001000000001,121.13,106.62896153846155,112.88280179487178,127.67663930000047,123.6095193,117.7373192,117.02324950000009,119.48762180495441,118.7318166773827,118.14923153846169,125.8572057495072,110.44125732741621,127.67663930000047,123.6095193,117.7373192,117.02324950000009,121.64000333333333,226601248,291948394.4,55.404829867643826,1.5,2.75,2.9924566084757878,0.7761688447223741,0.8184932164272033,0.9780640571789548,0.15957084075175146,29.47708255406234,3.9831655950583214,3888648861.0,2011-10-19,2011,2,292,10,1.96,121.9,122.10001000000001,119.82001000000001,2968
2011-10-20 13:30:00,121.42998999999999,122.10001000000001,119.82001000000001,121.66,106.55614076923078,112.57023743589744,127.64673930000048,123.4771194,117.92471940000001,117.46324950000009,119.5728131067209,119.01069127953673,119.05154000000016,125.30951441718548,112.79356558281485,127.64673930000048,123.4771194,117.92471940000001,117.46324950000009,121.19333999999999,262075632,279356176.0,56.38085269880861,1.5,2.75,2.941566850727517,0.9381415358434746,0.7315179324616365,1.073968256328797,0.34245032386716057,28.429398987720674,5.142156672529888,4150724493.0,2011-10-20,2011,3,293,10,1.9,120.96,124.12,122.72,2969
2011-10-21 13:30:00,123.09,124.12,122.72,123.97,106.48331999999999,112.25767307692308,127.62963930000048,123.39811939999998,118.05751940000002,117.98475000000008,119.74525180841812,119.48300639577131,119.94615538461555,125.38163413493747,114.51067663429363,127.62963930000048,123.39811939999998,118.05751940000002,117.98475000000008,123.60333333333334,278999296,277944016.0,60.4443626865681,1.5,2.75,2.9071692185326947,1.0037967358145965,0.7829528798516844,1.3211414236817658,0.5381885438300816,28.568879768650497,3.6711824719852815,4429723789.0,2011-10-21,2011,4,294,10,1.14,123.42,125.8,124.06,2970
2011-10-24 13:30:00,124.17,125.8,124.06,125.49001000000001,106.41049923076923,111.94510871794873,127.6213893500005,123.33571949999998,118.2049196,118.44725000000008,119.97053644338213,120.05510197712644,120.79769461538477,125.96530908982677,115.63008014094277,127.6213893500005,123.33571949999998,118.2049196,118.44725000000008,125.11667,203215568,275071112.8,62.893924127075955,1.5,2.75,2.8302285600660735,0.7387746606011476,0.8662445496416635,1.620994230882161,0.7547496812404975,23.74744862840922,4.837101086048451,4632939357.0,2011-10-24,2011,0,297,10,1.4,124.93,124.95,122.78,2971
2011-10-25 13:30:00,124.89,124.95,122.78,123.04899999999999,106.33767846153849,111.63254435897436,127.6017343500005,123.2620095,118.2534996,118.72270050000006,120.09126050442595,120.340235122162,121.30223230769245,125.94291360446715,116.66155101091779,127.6017343500005,123.2620095,118.2534996,118.72270050000006,123.59299999999999,268596736,272913263.2,56.809636228225486,1.5,2.75,2.8216415200613545,0.9841835198869148,0.7103797196143657,1.6427243307584547,0.9323446111440891,27.59645687142805,1.9039337474120137,4364342621.0,2011-10-25,2011,1,298,10,1.77,123.86,124.77,122.21001000000001,2972
2011-10-26 13:30:00,124.35001000000001,124.77,122.21001000000001,124.3,106.2648576923077,111.31998000000002,127.58608440000047,123.21455949999998,118.3476996,119.18045050000008,120.25630911209555,120.717355586718,121.96300076923092,125.55912756346657,118.36687397499529,127.58608440000047,123.21455949999998,118.3476996,119.18045050000008,123.76000333333332,289053696,273031112.8,58.99876082460492,1.5,2.75,2.8029521257712573,1.0586840929434178,0.6467832745928033,1.7408237043850932,1.09404042979229,27.71673327814796,3.1449757816758552,4653396317.0,2011-10-26,2011,2,299,10,2.09,123.49,129.42,124.3187,2973
2011-10-27 13:30:00,127.63,129.42,124.3187,128.63,106.19203692307691,129.42,127.58633440000048,123.21125939999996,118.52689960000002,119.80945050000008,120.58468914691532,121.47094076893535,122.65915461538476,127.44694066259031,117.87136856817921,127.58633440000048,123.21125939999996,118.52689960000002,119.80945050000008,127.45623333333332,390025728,277626952.8,65.51414320631446,1.5,2.75,2.968455545359024,1.4048554150323116,0.8393731334743141,2.1432568466351825,1.3038837131608685,32.71373943827913,4.94410500578404,5043422045.0,2011-10-27,2011,3,300,10,4.1,126.87,128.85001,127.8,2974
2011-10-28 13:30:00,128.0,128.85001,127.8,128.60001,106.11921615384615,129.56775025,127.58749700000048,123.21305949999996,118.80870000000004,120.58195150000007,120.89901545487943,122.14989974332245,123.34377076923091,128.74871111780135,117.93883042066051,127.58749700000048,123.21305949999996,118.80870000000004,120.58195150000007,128.41667333333334,225906496,274487999.2,65.43658338587252,1.5,2.75,2.8314237206905224,0.8230104655154629,0.9022822486192948,2.431736523934987,1.529454275315692,32.192591323333716,6.9616651418115225,4817515549.0,2011-10-28,2011,4,301,10,0.82,128.33,128.6239,125.32001000000001,2975
2011-10-31 13:30:00,127.16,128.6239,125.32001000000001,125.5,106.04639538461541,129.7155005,127.56849700000048,123.17405959999996,119.0659,121.36045200000008,121.07944622135473,122.46895691062508,123.70915538461556,129.0044242839241,118.41388648530695,127.56849700000048,123.17405959999996,119.0659,121.36045200000008,126.48130333333332,228146624,267638498.4,57.81704078798575,1.5,2.75,2.86517131206977,0.8524432223462213,0.682634198124408,2.3827470229712016,1.700112824846794,33.690960958285125,2.382117800620005,4589368925.0,2011-10-31,2011,0,304,10,2.64,126.97,123.50998999999999,121.52,2976
2011-11-01 13:30:00,122.03,123.50998999999999,121.52,122.00200000000001,105.97357461538462,129.86325075,127.53090700000048,123.11807949999996,119.25134000000004,121.84355200000007,121.11562480090946,122.42448482389887,123.82392538461552,128.89687229599386,118.75097847323723,127.53090700000048,123.11807949999996,119.25134000000004,121.84355200000007,122.34399666666668,416565760,265507912.8,50.650155366575966,1.5,2.75,2.9448019326362163,1.568939153665781,0.2704444505635055,2.0381683880511763,1.7677239374876703,36.82853832447264,0.7198877239329645,4172803165.0,2011-11-01,2011,1,305,11,1.64,122.51,124.39998999999999,122.7905,2977
2011-11-02 13:30:00,123.83,124.39998999999999,122.7905,123.99001000000001,105.90075384615385,130.011001,127.50960705000048,123.08097959999996,119.40234020000004,122.32205250000008,121.22834578910907,122.57358245971805,123.93315615384633,128.95428815320693,118.91202415448568,127.50960705000048,123.08097959999996,119.40234020000004,122.32205250000008,123.72683333333332,245529376,263578980.0,54.13020057376051,1.5,2.75,2.9057439374479155,0.9315210795640836,0.10866890938480324,1.9035600742186745,1.7948911648338712,37.16120734517603,1.9151816537892499,4418332541.0,2011-11-02,2011,2,306,11,1.31,123.6,126.5,123.595,2978
2011-11-03 13:30:00,125.27,126.5,123.595,126.25,105.82793307692309,130.15875125,127.50045705000048,123.05027949999996,119.56574020000004,122.81005200000007,121.42527340522246,122.9237174635544,124.39623307692324,129.06379439486923,119.72867175897724,127.50045705000048,123.05027949999996,119.56574020000004,122.81005200000007,125.44833333333335,291174912,265247688.0,57.77552349265407,1.5,2.75,2.9056907990587786,1.097747219572372,0.12943813240626656,1.9566888303417045,1.8272506979354382,38.247956875172456,1.8391546341856908,4709507453.0,2011-11-03,2011,3,307,11,2.35,125.05,125.7,124.00998999999999,2979
2011-11-04 13:30:00,125.23,125.7,124.00998999999999,125.48100000000001,105.75511230769231,130.3065015,127.48601205000048,123.03488949999996,119.74976020000004,123.29860150000007,121.58432150697844,123.16726818131113,124.61938692307709,129.19475796358577,120.04401588256842,127.48601205000048,123.03488949999996,119.74976020000004,123.29860150000007,125.06366333333334,249401504,262084867.2,56.14062455931278,1.5,2.75,2.85814217055458,0.951605892642702,0.0699360389448791,1.9146707466165367,1.8447347076716576,37.310860071123116,-0.007179854396380648,4460105949.0,2011-11-04,2011,4,308,11,1.36,124.85,126.39,124.2,2980
2011-11-07 14:30:00,125.39,126.39,124.2,126.25998999999999,105.68229153846156,130.45425175,127.47181195000047,123.02448939999996,119.91556000000004,123.6326010000001,121.76768105572437,123.46181311642435,125.0140015384617,129.1844821911056,120.8435208858178,127.47181195000047,123.02448939999996,119.91556000000004,123.6326010000001,125.61666333333334,196617184,260382416.8,57.45402080586295,1.5,2.75,2.810417729800681,0.7551092981482764,0.06187034452140482,1.9220726383234137,1.8602022938020089,36.82206882280567,2.609521410169928,4656723133.0,2011-11-07,2011,0,311,11,1.76,125.3,128.02,125.71001000000001,2981
2011-11-08 14:30:00,126.92,128.02,125.71001000000001,127.88,105.60947076923078,130.60200199999997,127.4653619500005,123.03278939999996,120.04596000000004,124.0416010000001,122.00737983785284,123.88259281962203,125.49246307692324,129.43495521859163,121.54997093525485,127.4653619500005,123.03278939999996,120.04596000000004,124.0416010000001,127.20333666666666,224426192,261149329.6,60.12807974858541,1.5,2.75,2.7746728919577763,0.8593787789681541,0.1399977221495381,2.035199446488932,1.8952017243393933,34.951207057275035,2.8801287208366837,4881149325.0,2011-11-08,2011,1,312,11,1.84,126.87,125.8,122.86,2982
2011-11-09 14:30:00,124.89,125.8,122.86,123.161,105.53665,130.74975224999997,127.4328169500005,122.98739939999996,120.07558020000006,124.16215100000014,122.05261984421156,123.81386969394373,125.43023230769245,129.4906614437572,121.36980317162771,127.4328169500005,122.98739939999996,120.07558020000006,124.16215100000014,123.94033333333334,337981952,263971192.0,50.22539832673524,1.5,2.75,2.9350533996750783,1.2803743826712728,-0.13680621097652734,1.7241939606187344,1.8610001715952615,41.848480868496935,-4.251729767550334,4543167373.0,2011-11-09,2011,2,313,11,2.39,124.33,124.94,123.02,2983
2011-11-10 14:30:00,124.78998999999999,124.94,123.02,124.32001000000001,105.46382923076924,130.89750249999997,127.4044669500005,122.93609949999994,120.11758040000008,124.35265200000009,122.14153710522288,123.86207353261575,125.34023230769245,129.44301731674912,121.23744729863579,127.4044669500005,122.93609949999994,120.11758040000008,124.35265200000009,124.09333666666664,231866496,264937576.0,52.30311983362297,1.5,2.75,2.8625495854125727,0.8751740674188097,-0.24613101882515356,1.55333639806382,1.7994674168889735,36.2773415634269,-3.3281490413569963,4775033869.0,2011-11-10,2011,3,314,11,1.56,123.98,126.99001000000001,125.78998999999999,2984
2011-11-11 14:30:00,125.83,126.99001000000001,125.78998999999999,126.66,105.39100846153849,131.04525274999997,127.39916695000048,122.91599949999994,120.23198040000008,124.55715150000009,122.31873172854746,124.12854271998569,125.6180015384617,129.54799516855124,121.68800790837213,127.39916695000048,122.91599949999994,120.23198040000008,124.55715150000009,126.48000000000002,189924320,263863913.6,56.271854822397565,1.5,2.75,2.848796043597389,0.7197813350404275,-0.16882380148714482,1.5884376650300425,1.7572614665171873,38.43054698019584,0.9243027888446188,4964958189.0,2011-11-11,2011,4,315,11,0.95,126.39,127.45,124.92,2985
2011-11-14 14:30:00,126.19,127.45,124.92,125.46001000000001,105.3181876923077,131.19300299999998,127.38306705000048,122.88758969999996,120.38418040000006,124.81865200000007,122.4419191117417,124.25534912760608,125.70723307692323,129.5654943862013,121.84897176764522,127.38306705000048,122.88758969999996,120.38418040000006,124.81865200000007,125.94333666666668,159258256,261711248.0,53.799620409938036,1.5,2.75,2.826024897626147,0.6085266002781814,-0.20412028847042185,1.50211110592916,1.7062313943995815,36.07055976875769,2.8343879608531024,4805699933.0,2011-11-14,2011,0,318,11,2.03,126.18,126.75,124.72,2986
2011-11-15 14:30:00,125.17,126.75,124.72,126.08299,105.24536692307692,131.34075324999998,127.35978195000048,122.88031959999996,120.56604000000004,124.99380150000007,122.58470620539889,124.42941016307219,125.5113092307694,128.9966496449117,122.02596881662708,127.35978195000048,122.88031959999996,120.56604000000004,124.99380150000007,125.85099666666666,184709376,255003817.6,54.907229463986766,1.5,2.75,2.769165976367137,0.7243396500429492,-0.1913413776172785,1.4670546723779836,1.658396049995262,31.286715477924187,1.6880230915377756,4990409309.0,2011-11-15,2011,1,319,11,1.63,125.74,126.34,123.89998999999999,2987
2011-11-16 14:30:00,124.81,126.34,123.89998999999999,124.08,105.17254615384616,131.48850349999998,127.32775695000048,122.84171959999996,120.64184020000003,125.14130150000008,122.6433451777362,124.39613300468436,125.1636161538463,128.22286142756872,122.1043708801239,127.32775695000048,122.84171959999996,120.64184020000003,125.14130150000008,124.77333,235782432,255462876.8,50.69872894734642,1.5,2.75,2.745654835198056,0.922961625397307,-0.3162467953498558,1.2630875558079424,1.5793343511577982,31.884097261639923,-1.71881188118812,4754626877.0,2011-11-16,2011,2,320,11,1.97,125.12,124.16,121.23,2988
2011-11-17 14:30:00,123.85001000000001,124.16,121.23,122.105,105.0997253846154,131.63625374999998,127.28438195000048,122.76666959999994,120.70314040000002,125.16355150000008,122.62223360213869,124.17792986138107,124.90246230769245,128.35642554844623,121.44849906693865,127.28438195000048,122.76666959999994,120.70314040000002,125.16355150000008,122.49833333333332,331219712,258920080.8,46.88292903818054,1.5,2.75,2.7588223469696227,1.2792353183909555,-0.5183952876303017,0.9313402416199209,1.4497355292502228,30.835326503590746,-2.6904471593308874,4423407165.0,2011-11-17,2011,3,321,11,2.42,122.7,122.75,121.47,2989
2011-11-18 14:30:00,122.5,122.75,121.47,121.979,105.02690461538462,131.78400399999998,127.23852700000047,122.67925959999997,120.82432040000003,125.06400150000007,122.59700875499597,123.96850796982098,124.90069307692323,128.36061576598237,121.44077038786413,127.23852700000047,122.67925959999997,120.82432040000003,125.06400150000007,122.06633333333332,215580368,255749134.4,46.64174340973196,1.5,2.75,2.6531921793289355,0.8429368431911298,-0.6391808964704779,0.6507594086621253,1.2899403051326033,30.806064030115053,-3.390614873326065,4207826797.0,2011-11-18,2011,4,322,11,1.05,122.11,120.35001000000001,118.64998999999999,2990
2011-11-21 14:30:00,120.2,120.35001000000001,118.64998999999999,119.661,104.95408384615385,131.93175424999998,127.17698200000046,122.55616959999996,120.88414040000004,124.77255100000008,122.48187115676085,123.55826911555229,124.5676923076925,129.00839348275406,120.12699113263086,127.17698200000046,122.55616959999996,120.88414040000004,124.77255100000008,119.55366666666669,229611632,257068937.6,42.32766016650655,1.5,2.75,2.70146488080544,0.8931908854630907,-0.841069541559375,0.2386033781833845,1.0796729197427597,31.51918051129729,-6.427119174225832,3978215165.0,2011-11-21,2011,0,325,11,1.43,119.5,120.10001000000001,118.52,2991
2011-11-22 14:30:00,119.39998999999999,120.10001000000001,118.52,119.19,104.88126307692309,132.07950449999998,127.11008195000046,122.40886959999996,120.91314020000002,124.5796010000001,122.3527781702212,123.1422434854997,124.02461538461556,129.1789930555578,118.87023771367329,127.11008195000046,122.40886959999996,120.91314020000002,124.5796010000001,119.27000333333332,216494816,254463841.6,41.487952901401755,1.5,2.75,2.6213609607479085,0.8507881302063941,-0.9634204694740309,-0.1246026670997793,0.8388178023742517,29.39767633697628,-3.2242349445035385,3761720349.0,2011-11-22,2011,1,326,11,1.33,119.31,119.19,116.56,2992
2011-11-23 14:30:00,118.07001000000001,119.19,116.56,116.56,104.80844230769232,132.22725475,127.03153695000046,122.23636959999996,120.85694020000004,124.19260100000008,122.12561039884,122.51536315354737,123.33838461538478,129.75524442296287,116.92152480780668,127.03153695000046,122.23636959999996,120.85694020000004,124.19260100000008,117.43666666666668,224531632,251237738.4,37.06613842675253,1.5,2.75,2.6219780349802004,0.8937018516004919,-1.1650913654013726,-0.6175464043774639,0.5475449610239087,24.49338954657141,-6.241963783625818,3537188717.0,2011-11-23,2011,2,327,11,2.26,117.88,117.7,116.2,2993
2011-11-25 14:30:00,116.38,117.7,116.2,116.34,116.2,132.37500500000002,126.95163195000046,122.06006959999996,120.75514040000004,123.57810100000007,121.89872371653252,121.92723332939998,122.57530846153864,129.73704854240037,115.41356838067686,126.95163195000046,122.06006959999996,120.75514040000004,123.57810100000007,116.74666666666668,99557008,236714302.4,36.71363968777916,1.5,2.75,2.5418367467673284,0.4205787609392883,-1.2494505102899942,-1.0142681768385842,0.2351823334514101,22.78858928221598,-8.147797252486969,3437631709.0,2011-11-25,2011,4,329,11,1.29,116.95,120.17998999999999,118.82001000000001,2994
2011-11-28 14:30:00,119.53998999999999,120.17998999999999,118.82001000000001,119.71001000000001,116.4370272972973,132.52275525,126.88463200000044,121.90356969999998,120.71892060000003,123.13360100000007,121.81289180608029,121.71606920279045,121.94684769230784,128.54824283527876,115.34545254933693,126.88463200000044,121.90356969999998,120.71892060000003,123.13360100000007,119.57000333333332,210686000,235953277.6,45.295756698434865,1.5,2.75,2.6345619791410906,0.8929140639324605,-1.0239048748290471,-1.0446987600848985,-0.02079388525585163,27.10025792554008,-4.583133701328415,3648317709.0,2011-11-28,2011,0,332,11,1.14,119.5,121.0,119.61,2995
2011-11-29 14:30:00,120.05,121.0,119.61,120.05,116.6740545945946,132.6705055,126.81773205000044,121.76006979999997,120.71372060000004,122.86110100000008,121.74375879407712,121.55739594538186,121.70754000000014,128.34100381428541,115.07407618571483,126.81773205000044,121.76006979999997,120.71372060000004,122.86110100000008,120.22,199241504,234508021.6,46.09003554194935,1.5,2.75,2.5456646949167268,0.8496148773104485,-0.8069755132020222,-1.0295132767583794,-0.2225377635563572,27.379063716298667,-4.784935699890998,3847559213.0,2011-11-29,2011,1,333,11,1.16,120.3,125.22,119.9971,2996
2011-11-30 14:30:00,123.49001000000001,125.22,119.9971,124.99001000000001,116.9110818918919,132.81825575,126.77763215000046,121.69026989999996,120.81012080000004,123.01050150000007,121.87106276293684,121.8843115696312,121.7590784615386,128.48272939516048,115.03542752791672,126.77763215000046,121.69026989999996,120.81012080000004,123.01050150000007,123.40237,324439552,229901711.2,56.07057220039277,1.5,2.75,2.7368957881369598,1.41120981791109,-0.3114166703409321,-0.6118086014825224,-0.30039193114159024,37.44797982393826,0.7334058671824627,4171998765.0,2011-11-30,2011,2,334,11,4.35,122.61,125.64,124.42998999999999,2997
2011-12-01 14:30:00,124.85001000000001,125.64,124.42998999999999,124.97,117.1481091891892,132.966006,126.73323210000048,121.62596999999997,120.97692080000004,123.05950100000008,121.99258971340991,122.17818665823776,121.6290784615386,128.02608740925731,115.23206951381992,126.73323210000048,121.62596999999997,120.97692080000004,123.05950100000008,125.01333000000001,176954752,226472980.0,56.02532692957176,1.5,2.75,2.6278325175557486,0.7813503933228589,0.016976612688597736,-0.2791711652808431,-0.2961477779694408,36.18924377345635,2.3463412636665124,3995044013.0,2011-12-01,2011,3,335,12,0.97,125.03,126.5,124.78,2998
2011-12-02 14:30:00,126.12,126.5,124.78,124.86,117.38513648648649,133.11375624999997,126.68628210000048,121.55616999999997,121.21692080000004,122.99000100000008,122.10503717562914,122.43359745269129,121.582923846154,127.87652806253496,115.289319629773,126.68628210000048,121.55616999999997,121.21692080000004,122.99000100000008,125.38,221109680,222969718.4,55.75895826390419,1.5,2.75,2.562987337730338,0.9916578878363064,0.21759719810890168,-0.02415128033331371,-0.2417484784422154,34.63625408737853,2.3618819632887633,3773934333.0,2011-12-02,2011,4,336,12,1.38,125.64,127.17998999999999,125.44,2999
2011-12-05 14:30:00,126.84,127.17998999999999,125.44,126.22,117.6221637837838,133.26150649999997,126.6447321000005,121.50907009999996,121.47052100000003,123.02695100000004,122.26640826678093,122.79420721910164,121.59346307692324,127.91756012996667,115.26936602387977,126.6447321000005,121.50907009999996,121.47052100000003,123.02695100000004,126.27999666666666,225263872,221762836.8,58.39284823851715,1.5,2.75,2.545630385035314,1.0157872944381454,0.4209314872208072,0.2844158805837935,-0.13651560663701362,34.894872818872216,5.481318056843915,3999198205.0,2011-12-05,2011,0,339,12,1.39,126.31,127.11,125.75998999999999,3000
2011-12-06 14:30:00,126.21001000000001,127.11,125.75998999999999,126.25998999999999,117.85919108108108,133.40925674999997,126.61688205000047,121.45476999999997,121.67092060000004,123.02695100000004,122.42301931514244,123.12428176966341,121.76115461538477,128.4454462646405,115.07686296612906,126.61688205000047,121.45476999999997,121.67092060000004,123.02695100000004,126.37666000000002,178842064,220874080.8,58.47114061338002,1.5,2.75,2.4602289289613632,0.8097014523036783,0.5301082113831811,0.5261196575919627,-0.003988553791218347,31.949755336686703,5.931697290041115,4178040269.0,2011-12-06,2011,1,340,12,1.07,126.43,127.25998999999999,124.97,3001
2011-12-07 14:30:00,125.84,127.25998999999999,124.97,126.73,118.09621837837837,127.25998999999999,126.59543205000048,121.41596999999994,121.8547208,122.96945100000003,122.59192051847022,123.46768350588593,122.11692384615401,129.30954753318204,114.92430015912592,126.59543205000048,121.41596999999994,121.8547208,122.96945100000003,126.31999666666668,237802496,221542896.0,59.4372346740621,1.5,2.75,2.448069005464123,1.0733925587033943,0.6007802216350466,0.74698672325259,0.1462065016175433,31.432342731407665,8.725120109814691,4415842765.0,2011-12-07,2011,2,341,12,1.83,126.11,126.17998999999999,123.64998999999999,3002
2011-12-08 14:30:00,125.89998999999999,126.17998999999999,123.64998999999999,123.95,118.33324567567568,127.18284678571429,126.56053210000047,121.32816999999996,122.03082079999999,123.00890100000004,122.64517853735373,123.51361841008728,122.2685392307694,129.5259445026453,115.01113395889351,126.56053210000047,121.32816999999996,122.03082079999999,123.00890100000004,124.59332666666668,240862752,216686936.0,51.76644412973161,1.5,2.75,2.4932076479309715,1.111570251747895,0.4348361343762108,0.6897516695878068,0.254915535211596,31.38876186112447,6.54117242564896,4174980013.0,2011-12-08,2011,3,342,12,2.05,124.91,126.37,124.39998999999999,3003
2011-12-09 14:30:00,124.50998999999999,126.37,124.39998999999999,126.05,118.57027297297294,127.10570357142859,126.52913210000048,121.26217009999996,122.23082079999999,123.09540050000004,122.77870094765358,123.7551785615075,122.76000076923091,130.10925533322606,115.41074620523577,126.52913210000048,121.26217009999996,122.23082079999999,123.09540050000004,125.60666333333334,209111312,215549176.8,56.349259169300225,1.5,2.75,2.4879785302216164,0.9701327330701268,0.4397238443985873,0.8045703407098301,0.3648464963112428,31.46991550970757,5.296123523838983,4384091325.0,2011-12-09,2011,4,343,12,1.58,125.38,124.97,123.16,3004
2011-12-12 14:30:00,124.95,124.97,123.16,124.21001000000001,118.80730027027029,127.02856035714287,126.48443220000044,121.15937009999996,122.4520212,122.97290100000004,122.83483071441226,123.79849584136394,123.14615538461551,130.22715129125575,116.06515947797529,126.48443220000044,121.15937009999996,122.4520212,122.97290100000004,124.11333666666668,215826064,216844264.0,51.71303988720603,1.5,2.75,2.5166943494915013,0.9953044642213824,0.29898621670569264,0.7385792671933586,0.439593050487666,30.927344185756322,3.4652311536859637,4168265261.0,2011-12-12,2011,0,346,12,1.47,124.06,125.57001000000001,122.45,3005
2011-12-13 14:30:00,124.86,125.57001000000001,122.45,123.05,119.04432756756756,126.95141714285715,126.44503225000044,121.04407009999996,122.71442140000002,122.85240050000007,122.84326872561178,123.72721052313881,123.6453861538463,129.6286559124176,117.662116395275,126.44503225000044,121.04407009999996,122.71442140000002,122.85240050000007,123.69000333333334,245159680,221139335.2,48.977140408518466,1.5,2.75,2.5597883245278217,1.1086208601390424,0.11706443254221875,0.5859235911654395,0.4688591586232207,31.830264677862054,-1.5521320463931485,3923105581.0,2011-12-13,2011,1,347,12,2.55,124.01,123.03,121.47,3006
2011-12-14 14:30:00,122.56,123.03,121.47,121.74001000000001,119.28135486486488,126.87427392857144,126.39768225000046,120.92317019999994,122.9024216,122.63525150000008,122.80000367754856,123.53795333045893,124.06077153846171,128.51108307336426,119.61046000355913,126.39768225000046,120.92317019999994,122.9024216,122.63525150000008,122.08000333333332,238618816,223834807.2,46.01637881255638,1.5,2.75,2.489803444204406,1.0660487481144534,-0.0909723292308195,0.3551437470846963,0.4461160763155158,21.4088053795718,-2.584612306953669,3684486765.0,2011-12-14,2011,2,348,12,1.28,122.25,123.2,121.99001000000001,3007
2011-12-15 14:30:00,123.03,123.2,121.99001000000001,122.185,119.51838216216215,126.79713071428571,126.34125725000044,120.81172019999994,123.05772160000002,122.54050150000008,122.77588588627216,123.40910063232,124.25115538461552,128.11361101033063,120.38869975890042,126.34125725000044,120.81172019999994,123.05772160000002,122.54050150000008,122.45833666666664,199109120,222001141.6,47.18436965035716,1.5,2.75,2.4162453410469493,0.8968833158468767,-0.19226575423489026,0.20578388352190305,0.3980496377567933,21.6790724725522,-2.142399487425915,3883595885.0,2011-12-15,2011,3,349,12,0.99,122.6,122.95,121.3,3008
2011-12-16 14:30:00,122.23,122.95,121.3,121.59,119.75540945945946,126.7199875,126.28685725000044,120.72162009999994,123.15972140000002,122.51475150000007,122.72938055739874,123.23585295305142,124.36961692307707,127.77707218349596,120.96216166265819,126.28685725000044,120.72162009999994,123.15972140000002,122.51475150000007,121.94666666666667,220481312,216464221.6,45.75875222974846,1.5,2.75,2.361513530972167,1.0185577568907582,-0.28727607464457616,0.03895454445107305,0.3262306190956492,21.707836577248173,-3.668198383774359,3663114573.0,2011-12-16,2011,4,350,12,1.36,122.12,122.32001000000001,120.03,3009
2011-12-19 14:30:00,122.06,122.32001000000001,120.03,120.28998999999999,119.99243675675676,126.64284428571429,126.23115725000044,120.62231999999996,123.25132100000002,122.4303010000001,122.63371818259878,122.95529457657034,124.00807692307708,128.01937500279024,119.99677884336391,126.23115725000044,120.62231999999996,123.25132100000002,122.4303010000001,120.87999999999998,183902944,214880350.4,42.72159872157951,1.5,2.75,2.356406135902726,0.8558388128912879,-0.4177049997094592,-0.1959006305411748,0.2218043691682844,20.291732995891657,-4.728338723929884,3479211629.0,2011-12-19,2011,0,353,12,1.91,121.18,124.14,120.37019,3010
2011-12-20 14:30:00,122.17998999999999,124.14,120.37019,123.92998999999999,120.22946405405406,126.56570107142859,126.18790720000044,120.56831989999996,123.33832080000002,122.6437505000001,122.68455237151647,123.04812271213508,123.9280761538463,127.90074295377751,119.95540935391512,126.18790720000044,120.56831989999996,123.33832080000002,122.6437505000001,122.81339333333334,225418064,214670672.0,52.27353125186576,1.5,2.75,2.4630921261953884,1.050064556559454,-0.2472843886010781,-0.08730111658306328,0.15998327201801485,28.424594253553852,-2.209429495778427,3704629693.0,2011-12-20,2011,1,354,12,3.13,122.26,124.36,122.75,3011
2011-12-21 14:30:00,123.92998999999999,124.36,122.75,124.17,120.46649135135135,126.48855785714287,126.14680720000044,120.52221989999994,123.42772080000003,122.89275050000009,122.74280521969229,123.1549681681222,123.8749992307694,127.81474490397396,119.93525355756479,126.14680720000044,120.52221989999994,123.42772080000003,122.89275050000009,123.76,194230880,213557475.2,52.832078268342045,1.5,2.75,2.402156974324289,0.9095016684295396,-0.11364665434566995,0.017924954085927425,0.13157160843159738,28.31514539858519,0.17749092375957956,3898860573.0,2011-12-21,2011,2,355,12,1.31,123.56,125.39998999999999,124.23241000000002,3012
2011-12-22 14:30:00,124.63,125.39998999999999,124.23241000000002,125.27,120.70351864864864,126.41141464285715,126.12346970000044,120.52001979999996,123.51812080000003,123.32825050000014,122.84191089735144,123.3563997711582,123.80192230769245,127.59757821989729,120.00626639548766,126.12346970000044,120.52001979999996,123.51812080000003,123.32825050000014,124.96746666666668,119465312,208304159.2,55.40784722551028,1.5,2.75,2.3184307618725546,0.5735138100881473,0.04507235086563405,0.18791204701363995,0.1428396961480059,25.723010061115193,-0.6188020626735432,4018325885.0,2011-12-22,2011,3,356,12,0.94,124.82,126.42998999999999,125.41,3013
2011-12-23 14:30:00,125.67,126.42998999999999,125.41,126.39,120.94054594594593,126.33427142857144,126.10121970000044,120.52221979999996,123.63572100000003,123.8307505000001,122.98105164647491,123.64531407866693,123.81192307692324,127.63402525822303,119.98982089562341,126.10121970000044,120.52221979999996,123.63572100000003,123.8307505000001,126.07666333333331,92187184,207935668.0,57.92710485508402,1.5,2.75,2.235684993167373,0.44334473679619024,0.21236512255476006,0.408296099341456,0.1959309767866959,24.31871009921361,1.7550839904126918,4110513069.0,2011-12-23,2011,4,357,12,0.81,125.92,126.82001000000001,126.06,3014
2011-12-27 14:30:00,126.17,126.82001000000001,126.06,126.49001000000001,121.17757324324323,126.25712821428571,126.08341975000044,120.58451999999994,123.71412100000003,124.16975050000009,123.11865785641706,123.91623749974629,123.7934623076925,127.56093678364063,120.02598783174429,126.08341975000044,120.58451999999994,123.71412100000003,124.16975050000009,126.45667333333334,86075680,201705152.0,58.15444366247712,1.5,2.75,2.13027963651256,0.42674011618701735,0.3106845994518627,0.5842867261015243,0.2736021266496616,22.380596622926834,2.7956196668021143,4196588749.0,2011-12-27,2011,1,361,12,0.6,126.44,126.53,124.73,3015
2011-12-28 14:30:00,126.50998999999999,126.53,124.73,124.83,121.41460054054056,126.17998500000002,126.06476975000044,120.63201999999994,123.80612100000006,124.40875050000008,123.18576931302816,124.00326249977046,123.86115461538476,127.66885510741389,120.05345412335564,126.06476975000044,120.63201999999994,123.80612100000006,124.40875050000008,125.36333333333332,119107008,197698427.2,53.03217257498138,1.5,2.75,2.10668823390452,0.6024681616688148,0.247590404244376,0.5830901319551316,0.3354997277107556,23.173325184288,2.5381877330222005,4077481741.0,2011-12-28,2011,2,362,12,1.44,125.63,126.25,124.8566,3016
2011-12-29 14:30:00,125.24001000000001,126.25,124.8566,126.12,121.65162783783785,126.10284178571429,126.06449475000043,120.77062009999996,123.87692100000004,124.46525000000008,123.30083718310549,124.20485654741137,123.8665392307694,127.68678313361309,120.04629532792568,126.06449475000043,120.77062009999996,123.87692100000004,124.46525000000008,125.7422,123507120,187651805.6,56.25662263026884,1.5,2.75,2.057639074339912,0.6581717644820786,0.2743311862602685,0.6784137105360912,0.4040825242758227,22.264276264166185,3.2205262511764965,4200988861.0,2011-12-29,2011,3,363,12,1.12,125.55,126.33,125.5,3017
2011-12-30 14:30:00,126.02,126.33,125.5,125.5,121.88865513513514,126.02569857142859,126.05274470000046,120.85082009999996,123.96432100000006,124.4917500000001,123.3870788621994,124.328203542896,123.96576923076941,127.88234436369558,120.04919409784321,126.05274470000046,120.85082009999996,123.96432100000006,124.4917500000001,125.77666666666666,95599008,183584018.4,54.32620526551401,1.5,2.75,1.9699505690299175,0.5207370926575164,0.23346000147002915,0.6959075261133592,0.46244752464333005,22.78483251502514,3.215724977383005,4105389853.0,2011-12-30,2011,4,364,12,0.66,125.92,128.38,127.42998999999999,3018
2012-01-03 14:30:00,127.75998999999999,128.38,127.42998999999999,127.495,122.12568243243244,125.94855535714287,126.05141975000046,121.00287019999996,124.08102100000004,124.62350000000008,123.5481738087798,124.62980320547736,124.30769230769245,128.60261098589243,120.01277362949249,126.05141975000046,121.00287019999996,124.08102100000004,124.62350000000008,127.76832999999998,193697808,182213424.8,59.18005042151019,1.5,2.75,2.0349540998134947,1.06302709700235,0.3187045691060409,0.8608282360258812,0.5421236669198403,23.351903875489253,5.989700389866191,4299087661.0,2012-01-03,2012,1,3,1,0.75,127.9,127.81,126.71001000000001,3019
2012-01-04 14:30:00,127.2,127.81,126.71001000000001,127.7,122.36270972972972,125.87141214285715,126.04121970000044,121.10657019999996,124.15562100000004,124.69750000000008,123.71099052216101,124.92220290019378,124.76615307692323,129.1385454309193,120.39376072292721,126.04121970000044,121.10657019999996,124.15562100000004,124.69750000000008,127.40666999999999,127186432,177309552.8,59.654521059272405,1.5,2.75,1.968170949826817,0.7173129140056124,0.3635673755853263,0.996582886401498,0.6330155108161718,21.347879263391718,3.0420481757482585,4426274093.0,2012-01-04,2012,2,4,1,0.87,127.26,128.23,126.42998999999999,3020
2012-01-05 14:30:00,127.00998999999999,128.23,126.42998999999999,128.03999,122.59973702702706,125.79426892857144,126.03496970000046,121.20577009999997,124.20662060000004,124.78650000000007,123.88075520756644,125.21913500493723,125.21653692307709,129.6385643903113,120.79450945584287,126.03496970000046,121.20577009999997,124.20662060000004,124.78650000000007,127.56666000000001,173894944,177062196.8,60.47507085843649,1.5,2.75,1.9561594534106148,0.9821122020553176,0.38855399689603604,1.1187080069362167,0.7301540100401808,15.016940202419546,3.1166868003543424,4600169037.0,2012-01-05,2012,3,5,1,1.42,127.33,128.22,127.28998999999999,3021
2012-01-06 14:30:00,128.2,128.22,127.28998999999999,127.71001000000001,122.83676432432432,125.71712571428571,126.02521975000045,121.27667019999996,124.29984080000004,124.83550050000008,124.03092206217168,125.4563611949432,125.68730692307709,129.75353115225332,121.62108269390087,126.02521975000045,121.27667019999996,124.29984080000004,124.83550050000008,127.74000000000002,148049936,172574568.8,59.216269308036324,1.5,2.75,1.8828630638812849,0.8578896475272548,0.3561312570480142,1.1753180813501984,0.8191868243021843,15.381237843310402,1.9478007503791817,4452119101.0,2012-01-06,2012,4,6,1,0.73,127.75,128.17999,127.41,3022
2012-01-09 14:30:00,128.0,128.17999,127.41,128.02,123.07379162162162,125.63998250000002,126.01081980000043,121.36097019999997,124.37424080000004,125.03900050000007,124.18735649110613,125.70051727161528,126.28192307692323,129.08028092086838,123.48356523297814,126.01081980000043,121.36097019999997,124.37424080000004,125.03900050000007,127.8699966666667,99530128,165507937.6,60.05739712341686,1.5,2.75,1.8033721307469082,0.6013616594059958,0.3294547905693277,1.2310053125138438,0.901550521944516,14.898515053870854,1.2896589920088692,4551649229.0,2012-01-09,2012,0,9,1,0.6,127.79,129.64999,128.95,3023
2012-01-10 14:30:00,129.39,129.64999,128.95,129.13,123.31081891891891,125.5628392857143,125.99996980000046,121.45557019999997,124.38424080000004,125.19300050000008,124.38118564831764,126.0271346743186,126.68192384615402,129.50763364046827,123.85621405183977,125.99996980000046,121.45557019999997,124.38424080000004,125.19300050000008,129.24333000000001,115281936,160816468.8,63.00003195687054,1.5,2.75,1.790987692836414,0.7168540439932853,0.3580822764895275,1.3491533675564256,0.991071091066898,14.855089951000021,2.0871134408163914,4666931165.0,2012-01-10,2012,1,10,1,0.54,129.3,129.37,128.52,3024
2012-01-11 14:30:00,128.73,129.37,128.52,129.2,123.5478462162162,125.48569607142859,125.99106980000046,121.60247029999996,124.39624060000004,125.44250000000008,124.57015876014832,126.3293123243835,127.06884692307709,129.788280660301,124.34941318585315,125.99106980000046,121.60247029999996,124.39624060000004,125.44250000000008,129.03,111540688,155602200.0,63.18423364202179,1.5,2.75,1.7237742862052412,0.7168323327048075,0.3526859959300521,1.4319285859794633,1.0792425900494111,14.864056218015186,3.5007610350076033,4778471853.0,2012-01-11,2012,2,11,1,0.66,128.94,129.7,128.53999,3025
2012-01-12 14:30:00,129.57001,129.7,128.53999,129.50999,123.7848735135135,125.40855285714287,125.97931975000046,121.77117019999996,124.47644040000004,125.76549950000008,124.76387763229937,126.63223400777552,127.3950000000002,130.1892376420572,124.60076235794315,125.97931975000046,121.77117019999996,124.47644040000004,125.76549950000008,129.24999333333332,118983632,149293397.6,64.03806025361038,1.5,2.75,1.6835054086191523,0.7969785262627046,0.3407589180486921,1.5051912376102763,1.1644323195615842,11.238122849005325,2.6879083412622764,4897455485.0,2012-01-12,2012,3,12,1,0.9,129.12,129.05,127.72,3026
2012-01-13 14:30:00,128.64,129.05,127.72,128.84,124.02190081081082,125.33140964285715,125.95966975000044,121.93227019999996,124.61320040000004,126.12049900000008,124.92372556828764,126.84249743560645,127.5834615384617,130.41142640777386,124.75549666914955,125.95966975000044,121.93227019999996,124.61320040000004,126.12049900000008,128.53666666666666,179836128,146354263.2,60.75826649073556,1.5,2.75,1.6911114508606409,1.2287727331471407,0.2620470073689487,1.4919910787727702,1.2299440714038214,11.417530497355518,2.6613545816733093,4717619357.0,2012-01-13,2012,4,13,1,1.04,128.38,130.32001,128.89571,3027
2012-01-17 14:30:00,130.08,130.32001,128.89571,129.34,124.25892810810812,125.25426642857144,125.94341975000044,122.06127019999997,124.72020020000002,126.47824900000008,125.0969128009038,127.08035482269152,127.80269153846169,130.69865637165162,124.90672670527177,125.94341975000044,122.06127019999997,124.72020020000002,126.47824900000008,129.51857333333336,132209184,143009266.4,62.30966967317885,1.5,2.75,1.676032775799166,0.9244798419579894,0.21967063610507,1.5045323665351589,1.2848617304300889,10.508792660583255,1.4471155731597307,4849828541.0,2012-01-17,2012,1,17,1,1.11,129.61,130.84,129.08,3028
2012-01-18 14:30:00,129.31,130.84,129.08,130.77,124.49595540540541,125.17712321428571,125.93151980000044,122.18817019999996,124.81060020000002,126.9372490000001,125.31938680871149,127.4317496014828,128.25961461538478,131.0058227127187,125.51340651805089,125.93151980000044,122.18817019999996,124.81060020000002,126.9372490000001,130.23000000000002,163395120,140154956.8,66.40090776566345,1.5,2.75,1.6820304346706536,1.1658176330728247,0.26113986995189165,1.6112865678699535,1.350146697918062,8.570268677227611,2.4040720438527856,5013223661.0,2012-01-18,2012,2,18,1,1.36,129.96,131.57001,130.8,3029
2012-01-19 14:30:00,131.22,131.57001,130.8,131.46001,124.7329827027027,125.09998000000002,125.92251990000044,122.33997029999996,124.93018040000004,127.49575000000007,125.56019556131105,127.81539344896065,128.67038461538476,131.6046100001471,125.73615923062245,125.92251990000044,122.33997029999996,124.93018040000004,127.49575000000007,131.27667333333332,126328816,137276250.4,68.19491973879936,1.5,2.75,1.6190289750513205,0.9202525246129536,0.30516839532466644,1.7316071920738951,1.4264387967492285,8.68096789574264,2.6710561286360788,5139552477.0,2012-01-19,2012,3,19,1,0.59,131.19,131.95,130.92,3030
2012-01-20 14:30:00,131.24001,131.95,130.92,131.53999,124.97001000000002,125.0228367857143,125.91401980000043,122.47567019999997,125.03578040000004,127.8762500000001,125.79469730400473,128.170116930012,129.13499923076938,131.81589944129095,126.4540990202478,125.91401980000043,122.47567019999997,125.03578040000004,127.8762500000001,131.46999666666667,138230128,132916853.6,68.40550111666829,1.5,2.75,1.5769554768333691,1.0399744220246876,0.3088667570296331,1.8125222430362695,1.503655486006637,8.780911764979825,2.998966173442467,5277782605.0,2012-01-20,2012,4,20,1,0.79,131.44,132.25,130.98,3031
2012-01-23 14:30:00,131.50999,132.25,130.98,131.61,125.2070372972973,124.94569357142859,125.90376980000043,122.57817019999996,125.11038040000004,128.2482500000001,126.0227483901222,128.49772484143944,129.45153769230782,132.25219475051549,126.65088063410019,125.90376980000043,122.57817019999996,125.11038040000004,128.2482500000001,131.61333333333334,129295744,129670096.8,68.60147404781281,1.5,2.75,1.5550300856309858,0.9971130367815072,0.28575284731601824,1.8608465451516596,1.5750936978356411,8.264135316395516,2.804249336041246,5407078349.0,2012-01-23,2012,0,23,1,0.97,131.62,131.5,130.60001,3032
2012-01-24 14:30:00,130.8,131.5,130.60001,131.46001,125.4440645945946,124.86855035714287,125.89446980000044,122.67597039999997,125.27636060000003,128.55775050000008,126.23597433560758,128.77984723749282,129.74076923076942,132.53474754183662,126.94679091970215,125.89446980000044,122.67597039999997,125.27636060000003,128.55775050000008,131.18667333333335,103083248,128850993.6,67.63356663015733,1.5,2.75,1.5160986509430594,0.8000190384251721,0.2323540200775933,1.8655362229326329,1.6331822028550396,8.60169178356894,1.8043909238751767,5303995101.0,2012-01-24,2012,1,24,1,0.69,131.05,132.87,130.75,3033
2012-01-25 14:30:00,131.25999,132.87,130.75,132.56,125.6810918918919,124.79140714285715,125.89296980000044,122.77937039999998,125.44116040000004,128.8662505000001,126.48397534205436,129.13986178630302,130.08846230769242,133.06810395173665,127.10882066364826,125.89296980000044,122.77937039999998,125.44116040000004,128.8662505000001,132.06,198613184,134172293.6,70.8786307124373,1.5,2.75,1.559234461589984,1.4802846300899786,0.24201366961885884,1.9356992898786127,1.6936856202597543,8.526824746813341,2.6006191950464506,5502608285.0,2012-01-25,2012,2,25,1,1.62,131.81,133.39999,131.36,3034
2012-01-26 14:30:00,133.14999,133.39999,131.36,131.88,125.91811918918918,124.71426392857144,125.89006975000046,122.88877039999996,125.54556040000004,129.1357500000001,126.69558415216987,129.40082733046464,130.4092307692309,133.18657480811382,127.631886730348,125.89006975000046,122.88877039999996,125.54556040000004,129.1357500000001,132.21333,184880496,139112534.4,66.44369749894656,1.5,2.75,1.5935741429049843,1.3289995527534575,0.17654437444297374,1.9143660883134717,1.7378217138704977,9.589245796406981,1.8299823820540853,5317727789.0,2012-01-26,2012,3,26,1,1.55,132.38,132.05,131.14999,3035
2012-01-27 14:30:00,131.24001,132.05,131.14999,131.82001,126.15514648648649,124.63712071428571,125.89181980000043,123.02847039999996,125.67276040000004,129.4852505000001,126.89654202855536,129.6312256799442,130.70153923076936,133.19710015128257,128.20597831025614,125.89181980000043,123.02847039999996,125.67276040000004,129.4852505000001,131.67333333333332,135259056,139920136.8,66.0510470446814,1.5,2.75,1.5440338469832005,0.9666875625867741,0.10658293024686527,1.8710503766790796,1.764467446432214,9.690708981174298,2.312954051536784,5182468733.0,2012-01-27,2012,4,27,1,0.69,131.6,131.44,130.06,3036
2012-01-30 14:30:00,130.50999,131.44,130.06,131.37,126.3921737837838,124.55997750000002,125.89136975000044,123.17227029999997,125.77850060000004,129.7477505000001,127.07197175292576,129.79682323423523,130.87384692307705,133.21620365978038,128.53149018637376,125.89136975000044,123.17227029999997,125.77850060000004,129.7477505000001,130.95666666666668,147311744,141110368.0,63.041462302616566,1.5,2.75,1.5594607150558286,1.0439469904861989,0.012340299283158274,1.779892820536162,1.7675525212530037,9.271705376509486,1.5695067264574,5035156989.0,2012-01-30,2012,0,30,1,1.06,130.75,132.17999,130.67999,3037
2012-01-31 14:30:00,132.02,132.17999,130.67999,131.32001,126.62920108108109,124.4828342857143,125.89016980000044,123.28257049999996,125.92330080000004,130.0387510000001,127.23856148810512,129.94188864049858,131.03692461538478,133.17688404327723,128.89696518749224,125.89016980000044,123.28257049999996,125.92330080000004,130.0387510000001,131.39333,157211936,144191014.4,62.69968917453488,1.5,2.75,1.5552135211232694,1.0903032803686274,-0.06668073885598025,1.6842015976830282,1.7508823365390085,9.269296191924647,0.4205934082740583,4877945053.0,2012-01-31,2012,1,31,1,1.15,131.43,133.14,132.13,3038
2012-02-01 14:30:00,132.28999,133.14,132.13,132.47,126.86622837837837,124.40569107142859,125.89231985000043,123.41687059999997,126.13060080000008,130.28750100000008,127.443715939552,130.18266115092726,131.2646176923078,133.3350199275491,129.19421545706652,125.89231985000043,123.41687059999997,126.13060080000008,130.28750100000008,132.58,166234432,142817845.6,67.11628915361345,1.5,2.75,1.5741261267573208,1.1639612073800951,-0.05528686498871704,1.6817737553031122,1.7370606202918293,8.477896362565158,0.7682868729433291,5044179485.0,2012-02-01,2012,2,32,2,0.76,132.64,133.02,132.21001,3039
2012-02-02 14:30:00,132.73,133.02,132.21001,132.67999,127.10325567567568,124.32854785714287,125.90291980000043,123.58447049999997,126.34462060000006,130.5365005000001,127.64906002035387,130.4205019936961,131.56000153846168,133.216835813742,129.9031672631813,125.90291980000043,123.58447049999997,126.34462060000006,130.5365005000001,132.63666666666666,113090368,142113042.4,67.864543624167,1.5,2.75,1.5195449748460834,0.7957775450453659,-0.04768255563926771,1.6774574257427446,1.7251399813820123,8.102854680595938,0.8666565962183933,5157269853.0,2012-02-02,2012,3,33,2,0.61,132.62,134.62,133.77,3040
2012-02-03 14:30:00,134.0,134.62,133.77,134.53999,127.34028297297294,124.25140464285715,125.91906975000043,123.76317039999996,126.64220040000004,130.8615005000001,127.91929256857529,130.81283418477264,131.9600007692309,133.78238355442198,130.1376179840398,125.91906975000043,123.76317039999996,126.64220040000004,130.8615005000001,134.30999666666665,160598496,141448220.0,73.59569906358645,1.5,2.75,1.549578190928506,1.1353871826736317,0.06255635929013748,1.803335430494684,1.7407790712045466,10.991490475890288,2.226267000987748,5317868349.0,2012-02-03,2012,4,34,2,0.64,134.2,134.5134,133.83,3041
2012-02-06 14:30:00,133.98,134.5134,133.83,134.45,127.57731027027029,124.17426142857146,125.92581970000045,123.93027029999998,126.94740040000006,131.1985000000001,128.17539874235663,131.15923092908,132.24307769230782,134.3579174252969,130.12823795931877,125.92581970000045,123.93027029999998,126.94740040000006,131.1985000000001,134.26446666666666,107694432,139430444.8,72.91812125035631,1.5,2.75,1.4896076058621823,0.7723882123052654,0.10675936568806854,1.874228278314632,1.7674689126265637,11.08141012231731,2.274448328430811,5210173917.0,2012-02-06,2012,0,37,2,0.51,134.17,135.02,133.64,3042
2012-02-07 14:30:00,134.17,135.02,133.64,134.78999,127.81433756756756,124.09711821428574,125.93086965000046,124.08447019999996,127.31200020000006,131.53699950000012,128.4347944779505,131.50501750726286,132.49923000000015,134.95225722199427,130.04620277800603,125.93086965000046,124.08447019999996,127.31200020000006,131.53699950000012,134.48333,135528064,141230341.6,73.89596824682278,1.5,2.75,1.4817784911577423,0.9596242738253068,0.1344521422079581,1.9355340903865117,1.8010819481785532,10.88335438295552,1.6822495473747636,5345701981.0,2012-02-07,2012,1,38,2,1.03,134.33,135.22,134.31,3043
2012-02-08 14:30:00,134.86,135.22,134.31,135.19,128.0513648648649,124.01997500000002,125.93861965000046,124.22207029999996,127.68900020000004,131.83999950000015,128.69970449842305,131.85596822085688,132.78000000000014,135.54525985987792,130.01474014012237,125.93861965000046,124.22207029999996,127.68900020000004,131.83999950000015,134.90666666666667,139361376,142434313.6,75.03795651067188,1.5,2.75,1.4409371703607603,0.9784255807302884,0.15386881794464324,1.993417970609357,1.839549152664714,10.249978432952648,2.5098574461631804,5485063357.0,2012-02-08,2012,2,39,2,0.68,134.76,135.59,134.56,3044
2012-02-09 14:30:00,135.41,135.59,134.56,135.36,128.28839216216215,123.9428317857143,125.94146465000046,124.36046029999996,128.00200000000004,132.14799950000014,128.96089255730845,132.18968553315622,133.06846153846163,136.0585693848206,130.07835369210272,125.94146465000046,124.36046029999996,128.00200000000004,132.14799950000014,135.17,148602816,144287420.0,75.5279465154181,1.5,2.75,1.4115845153349917,1.0299083315787336,0.1520509408032258,2.0296128286687463,1.8775618878655205,9.236414017262923,2.685472410448169,5633666173.0,2012-02-09,2012,3,40,2,0.77,135.07,134.47,133.84,3045
2012-02-10 14:30:00,134.16,134.47,133.84,134.36099,128.52541945945947,123.86568857142859,125.93491960000048,124.50097019999995,128.28821980000004,132.39054950000013,129.1726610844728,132.3964764347604,133.29161384615398,136.2001463401214,130.38308135218657,125.93491960000048,124.50097019999995,128.28821980000004,132.39054950000013,134.22366333333332,167907504,146733613.6,67.18217069029544,1.5,2.75,1.4193284785253506,1.144301567176834,0.062068911392786134,1.9551480271065032,1.8930791157137168,10.803709672060213,2.276767907436996,5465758669.0,2012-02-10,2012,4,41,2,0.47,134.16,135.52,134.74001,3046
2012-02-13 14:30:00,135.32001,135.52,134.74001,135.36,128.76244675675676,123.78854535714287,125.93116960000047,124.65287019999997,128.49561960000003,132.71654950000013,129.41530182625817,132.67871677430702,133.50699846153861,136.57712547775105,130.43687144532612,125.93116960000047,124.65287019999997,128.49561960000003,132.71654950000013,135.20667,115841808,143533897.6,70.6721578666279,1.5,2.75,1.400734301487827,0.8070693399745037,0.048911807090224364,1.9542188745764972,1.905307067486273,10.63537674671965,3.0764466131247,5581600477.0,2012-02-13,2012,0,44,2,0.58,135.13,135.27,134.25,3047
2012-02-14 14:30:00,135.0,135.27,134.25,135.19,128.99947405405405,123.71140214285715,125.92496965000046,124.83847019999996,128.70001960000002,133.00904950000015,129.64176057816962,132.9178866053254,133.76161384615398,136.79861909791734,130.72460859439062,125.92496965000046,124.83847019999996,128.70001960000002,133.00904950000015,134.90333333333334,165996128,145223244.8,69.32119384844026,1.5,2.75,1.379967565667269,1.1430410347090658,0.009881827566064816,1.917659351943854,1.9077775243777888,10.748038909422712,2.053295085679776,5415604349.0,2012-02-14,2012,1,45,2,0.76,134.76,135.83,134.28999,3048
2012-02-15 14:30:00,135.63,135.83,134.28999,134.56,129.23650135135136,123.63425892857146,125.91666965000046,125.05547019999996,128.89401960000004,133.19854950000013,129.83463271235905,133.0742783571992,133.97238230769244,136.8152489216732,131.12951569371168,125.91666965000046,125.05547019999996,128.89401960000004,133.19854950000013,134.89333000000002,195195120,146813244.8,64.40749905630965,1.5,2.75,1.3913991681196085,1.3295470736711077,-0.07269740092551502,1.8169057732208955,1.8896031741464103,10.843507953981929,1.4169506645274834,5220409229.0,2012-02-15,2012,2,46,2,1.15,135.06,136.17,134.33,3049
2012-02-16 14:30:00,134.57001,136.17,134.33,136.049,129.47352864864865,123.55711571428574,125.91826465000044,125.28056029999998,129.09059960000002,133.42799900000014,130.07833339030572,133.3575851803231,134.33230538461552,136.9412846538373,131.72332611539377,125.91826465000044,125.28056029999998,129.09059960000002,133.42799900000014,135.51633333333334,186567744,149825191.2,69.84755652364717,1.5,2.75,1.4234420846824918,1.2452361482452758,-0.042848193655966586,1.8360429320764524,1.8788911257324188,12.118792721157375,1.1216070404048772,5406976973.0,2012-02-16,2012,3,47,2,1.37,135.25,136.6275,135.96001,3050
2012-02-17 14:30:00,136.52,136.6275,135.96001,136.41,129.71055594594594,123.47997250000004,125.92616465000044,125.48226019999998,129.29359980000004,133.67149950000012,130.3266340416663,133.64829135362564,134.72384307692323,136.89866262244274,132.54902353140372,125.92616465000044,125.48226019999998,129.29359980000004,133.67149950000012,136.33250333333334,129869376,149407153.6,71.00465532956508,1.5,2.75,1.36944550720517,0.8692313110233834,-0.0159844308063124,1.8589105872245284,1.8748950180308408,9.730609403463731,1.4577910003718917,5536846349.0,2012-02-17,2012,4,48,2,0.49,136.29,137.05,136.05,3051
2012-02-21 14:30:00,136.73,137.05,136.05,136.47,129.94758324324323,123.40282928571432,125.94046465000044,125.67156029999998,129.48839980000002,133.9144995000001,130.5675503537578,133.9170255104232,135.03153538461555,136.96189735422269,133.10117341500842,125.94046465000044,125.67156029999998,129.48839980000002,133.9144995000001,136.52333333333334,134042256,149644479.2,71.20245797064605,1.5,2.75,1.3430565424048009,0.8957380634193153,-0.011572814578209691,1.8604289998080787,1.8720018143862884,9.665904767126888,1.2463907742704117,5670888605.0,2012-02-21,2012,1,52,2,0.74,136.55,136.55,135.78999,3052
2012-02-22 14:30:00,136.25999,136.55,135.78999,136.032,130.18461054054058,123.32568607142859,125.94962465000044,125.88043029999996,129.73003980000004,134.14309900000012,130.78184249674771,134.11845165228766,135.28938230769242,136.7270432948676,133.8517213205173,125.94962465000044,125.88043029999996,129.73003980000004,134.14309900000012,136.12399666666667,124455248,150713079.2,67.57820894189707,1.5,2.75,1.3014103608044594,0.8257760286009737,-0.05321985289048792,1.8054769982731784,1.8586968511636663,9.995982655353163,0.6228271321843427,5546433357.0,2012-02-22,2012,2,53,2,0.56,136.17,136.73,135.5,3053
2012-02-23 14:30:00,135.96001,136.73,135.5,136.631,130.42163783783784,123.24854285714287,125.95917965000044,126.08624029999996,129.94165980000002,134.34664900000013,131.01122122236544,134.3577419711174,135.45022923076937,136.98137674388602,133.91908171765272,125.95917965000044,126.08624029999996,129.94165980000002,134.34664900000013,136.287,137704256,147667632.8,69.83922156311785,1.5,2.75,1.2963096207469973,0.9325283637918518,-0.055252140808575545,1.7896316751529469,1.8448838159615224,10.135500636665467,0.9389775413711484,5684137613.0,2012-02-23,2012,3,54,2,0.91,136.12,137.2,136.63,3054
2012-02-24 14:30:00,136.92999,137.2,136.63,136.92999,130.65866513513512,123.17139964285715,125.96447960000044,126.32404029999998,130.19605940000002,134.59914850000013,131.24332980188052,134.60271797386812,135.64099769230782,137.24248458224923,134.03951080236644,125.96447960000044,126.32404029999998,130.19605940000002,134.59914850000013,136.91999666666666,105539056,143700560.8,70.92900548759252,1.5,2.75,1.2444303621222113,0.7344373286537653,-0.051368141270596857,1.7806736393732765,1.832041780643873,10.156045354665977,1.9120133008844435,5789676669.0,2012-02-24,2012,4,55,2,0.42,136.92,137.53,135.8,3055
2012-02-27 14:30:00,136.02,137.53,135.8,137.16,130.89569243243244,123.09425642857146,125.97807960000046,126.59634039999996,130.47825940000004,134.86614800000012,131.47535608415973,134.84626864302354,135.82330615384632,137.53179643496242,134.11481587273022,125.97807960000046,126.59634039999996,130.47825940000004,134.86614800000012,136.83,145728816,144224048.8,71.7739396217401,1.5,2.75,1.2791139076849096,1.010433538737265,-0.048264597111991936,1.771711034253883,1.819975631365875,8.572150836598517,1.3297872340425403,5935405485.0,2012-02-27,2012,0,58,2,1.27,136.67,137.72,136.92999,3056
2012-02-28 14:30:00,137.2,137.72,136.92999,137.55901,131.1327197297297,123.01711321428574,125.99047465000044,126.84853049999998,130.79463940000002,135.17559850000012,131.713930747526,135.10462496273558,136.00553769230783,137.90018072361568,134.11089466100003,125.99047465000044,126.84853049999998,130.79463940000002,135.17559850000012,137.403,129355808,143326252.0,73.22762877520414,1.5,2.75,1.2441779142788445,0.9025269704254876,-0.03491773021346245,1.7763284685990468,1.8112461988125093,7.910098776995034,1.7523559434869465,6064761293.0,2012-02-28,2012,1,59,2,0.58,137.32,138.19,136.53999,3057
2012-02-29 14:30:00,137.75999,138.19,136.53999,137.02,131.36974702702702,122.93997000000005,126.00537470000044,127.07453049999998,131.09133940000004,135.46059800000015,131.92201189468184,135.28704163295126,136.13323000000014,138.06011511756606,134.20634488243428,126.00537470000044,127.07453049999998,131.09133940000004,135.46059800000015,137.24999666666668,185934688,144762389.6,68.12356189000029,1.5,2.75,1.273165920401785,1.2844129508622038,-0.07563287232912708,1.716705108401101,1.7923379807302278,8.396402775302382,1.828180737217604,5878826605.0,2012-02-29,2012,2,60,2,1.21,137.36,137.99001,136.9312,3058
2012-03-01 14:30:00,137.31,137.99001,136.9312,137.73,131.60677432432433,122.86282678571432,126.02807470000045,127.2869304,131.4141394,135.72359800000012,132.14977613410608,135.51970433457495,136.39238461538477,138.1985812702778,134.58618796049174,126.02807470000045,127.2869304,131.4141394,135.72359800000012,137.55040333333332,145026128,143701974.4,70.99175897724508,1.5,2.75,1.2578547832302305,1.0092145818144027,-0.06821739641152669,1.7070662352158197,1.775283631627346,7.687287411549617,1.2355842380318731,6023852733.0,2012-03-01,2012,3,61,3,0.77,137.46,137.82001,137.0,3059
2012-03-02 14:30:00,137.64,137.82001,137.0,137.312,131.84380162162162,122.78568357142859,126.04878470000048,127.50295029999998,131.75457960000003,135.9551985000001,132.35221628570977,135.69039915985354,136.54253846153864,138.30447793586043,134.78059898721685,126.04878470000048,127.50295029999998,131.75457960000003,135.9551985000001,137.37733666666668,120638256,144079368.8,67.16038123077807,1.5,2.75,1.2265801558566425,0.8373041678677869,-0.10285415659776632,1.6467159358801382,1.7495700924779043,5.910619548397424,0.6612418444395683,5903214477.0,2012-03-02,2012,4,62,3,0.6,137.41,137.2,136.28,3060
2012-03-05 14:30:00,137.10001,137.2,136.28,136.75,132.0808289189189,122.70854035714291,126.06073470000048,127.67465029999998,132.01097980000003,136.06569900000014,132.52467839215254,135.79131352558178,136.66253846153862,138.2427896403407,135.0822872827365,126.06073470000048,127.67465029999998,132.01097980000003,136.06569900000014,136.74333333333334,140765008,143087694.4,62.29262953596509,1.5,2.75,1.2126815732954543,0.9837673923691372,-0.17098804564477188,1.5358350354219397,1.7068230810667115,6.434458749774238,0.2051732981607688,5762449469.0,2012-03-05,2012,0,65,3,0.68,136.74,135.42999,134.36,3061
2012-03-06 14:30:00,135.35001,135.42999,134.36,134.75,132.31785621621623,122.6313971428572,126.06108475000046,127.82515029999996,132.22257980000003,136.08069900000015,132.61194590618578,135.6921408088597,136.677153846154,138.1810194572597,135.1732882350483,126.06108475000046,127.82515029999996,132.22257980000003,136.08069900000015,134.84666333333334,202129808,147809463.2,48.75084803284405,1.5,2.75,1.2967757466314924,1.3675024834269205,-0.34792567929120755,1.2719159819527022,1.6198416612439095,10.719880407897989,-0.9424253116913746,5560319661.0,2012-03-06,2012,1,66,3,0.8,134.89,135.91,134.92999,3062
2012-03-07 14:30:00,135.06,135.91,134.92999,135.69,132.55488351351352,122.55425392857146,126.07148475000044,127.97455029999998,132.43097980000002,136.12569950000017,132.73265390986478,135.69193692230164,136.64953846153864,138.21062484965705,135.08845207342023,126.07148475000044,127.97455029999998,132.43097980000002,136.12569950000017,135.50999666666667,143692128,148217666.4,53.8309519851765,1.5,2.75,1.2870060504435283,0.9694669433818586,-0.3953671044172205,1.125632780722384,1.5209998851396045,11.594109069442506,-0.6887163235283372,5704011789.0,2012-03-07,2012,2,67,3,0.73,135.42,137.32001,136.24001,3063
2012-03-08 14:30:00,136.52,137.32001,136.24001,137.03999,132.7919108108108,122.47711071428574,126.09638470000046,128.13985029999995,132.6439796,136.21819900000014,132.90156905065442,135.8203229297015,136.6979992307694,138.26543356168816,135.13056489985064,126.09638470000046,128.13985029999995,132.6439796,136.21819900000014,136.86667,116968816,147098038.4,59.96825809456851,1.5,2.75,1.3115063325547052,0.7951759063022285,-0.3320901313086684,1.1058872210037691,1.4379773523124375,12.769313212035355,0.08033302273664462,5820980605.0,2012-03-08,2012,3,68,3,0.79,136.78,137.92999,137.13,3064
2012-03-09 14:30:00,137.3,137.92999,137.13,137.57001,133.0289381081081,122.39996750000005,126.12448475000043,128.28985029999996,132.8655796,136.32869950000014,133.084645166315,135.98695979353946,136.78261538461555,138.4093255387145,135.1559052305166,126.12448475000043,128.28985029999996,132.8655796,136.32869950000014,137.54333333333332,122836752,145809735.2,62.098503387135715,1.5,2.75,1.281398737372227,0.8424454775362626,-0.2543057638654607,1.1200951474806118,1.3744009113460725,12.895058096827027,0.2989282589676289,5943817357.0,2012-03-09,2012,4,69,3,0.58,137.53,137.75999,137.09,3065
2012-03-12 13:30:00,137.55,137.75999,137.09,137.58,133.2659654054054,122.32282428571432,126.15043475000046,128.46335029999997,133.12057959999999,136.48965000000015,133.26093359116538,136.13867790844046,136.90169230769246,138.51778179017322,135.28560282521173,126.15043475000046,128.46335029999997,133.12057959999999,136.48965000000015,137.47666333333333,104003504,142614535.2,62.139398418954784,1.5,2.75,1.2377266847027812,0.7292630015176742,-0.20411351322068216,1.1192590198202197,1.323372533040902,12.872792650323452,0.01525890597788675,6047820861.0,2012-03-12,2012,0,72,3,0.49,137.42,140.13,138.09,3066
2012-03-13 13:30:00,138.32001,140.13,138.09,140.062,133.5029927027027,122.24568107142858,126.18574475000048,128.63817029999996,133.3994196,136.72475000000014,133.52764207778634,136.51232763144614,137.1656153846155,139.4858887277745,134.84534204145658,126.18574475000048,128.63817029999996,133.3994196,136.72475000000014,139.42733333333334,184090432,146026966.4,70.6209136933157,1.5,2.75,1.3314604929382958,1.2606605241372733,-0.015623508436128919,1.3038431474957406,1.3194666559318695,16.364141897608572,2.220113851992411,6231911293.0,2012-03-13,2012,1,73,3,1.48,139.11,140.44501,139.48,3067
2012-03-14 13:30:00,140.10001,140.44501,139.48,139.91,133.74002000000002,122.16853785714291,126.21774480000047,128.82597029999997,133.6876196,136.96075000000013,133.77793062375548,136.83591547607028,137.3948469230771,140.128677010422,134.66101683573214,126.21774480000047,128.82597029999997,133.6876196,136.96075000000013,139.94500333333335,145163504,144985335.2,69.59271694910079,1.5,2.75,1.3052854577284179,1.00122887462897,0.08160777449505162,1.421476374050684,1.3398685995556323,16.079678957440514,1.5828069411166823,6086747789.0,2012-03-14,2012,2,74,3,0.69,139.96,140.78,139.75999,3068
2012-03-15 13:30:00,140.12,140.78,139.75999,140.72,133.9770472972973,122.0913946428572,126.24684485000047,129.01657029999996,133.9521196,137.26875000000013,134.0501686385102,137.20582828787315,137.6686930769232,140.91814439988838,134.41924175395806,126.24684485000047,129.01657029999996,133.9521196,137.26875000000013,140.41999666666666,165118432,143481500.8,71.93746361963922,1.5,2.75,1.2849086393192464,1.1507994485655673,0.1777494259924286,1.5620553820461682,1.3843059560537394,16.125615721120607,2.4819389419715594,6251866221.0,2012-03-15,2012,3,75,3,0.73,140.27,140.48,140.0,3069
2012-03-16 13:30:00,140.36,140.48,140.0,140.3,134.2140745945946,122.0142514285715,126.28899485000048,129.17987029999998,134.2041196,137.48130000000015,134.295260064451,137.50051130807572,137.8795384615386,141.41617553569142,134.34290138738578,126.28899485000048,129.17987029999998,134.2041196,137.48130000000015,140.26000000000002,152893376,141797782.4,68.96775817499268,1.5,2.75,1.2445580222250143,1.0782494155564453,0.1892673599861363,1.6208901560364095,1.4316227960502734,16.119720078731596,2.5959780621572297,6098972845.0,2012-03-16,2012,4,76,3,0.34,140.24,141.28,140.11,3070
2012-03-19 13:30:00,140.21001,141.28,140.11,140.85001,134.45110189189188,121.93710821428577,126.33459490000048,129.33347029999996,134.46032000000002,137.70330050000013,134.55230908153135,137.8195111834971,138.17415461538474,142.00146006680015,134.3468491639693,126.33459490000048,129.33347029999996,134.46032000000002,137.70330050000013,140.74667,125291008,141568864.0,70.67502678949268,1.5,2.75,1.2392324492089408,0.8850181068063102,0.20861339163145964,1.6923895355895981,1.4837761439581385,15.631879837275017,4.526909090909089,6224263853.0,2012-03-19,2012,0,79,3,0.84,140.7,140.61,139.64,3071
2012-03-20 13:30:00,140.05,140.61,139.64,140.44,134.6881291891892,121.85996500000005,126.38469490000048,129.50738029999997,134.71491980000002,137.90180050000015,134.7831989214713,138.06908154697356,138.3826161538463,142.38179757105914,134.38343473663346,126.38469490000048,129.50738029999997,134.71491980000002,137.90180050000015,140.23,121729632,140953232.8,67.6855629945602,1.5,2.75,1.2371451314083028,0.8636171699071523,0.17011006654680627,1.6964137271416462,1.5263036605948401,11.732194093872616,3.5006264278870955,6102534221.0,2012-03-20,2012,1,80,3,0.69,140.12,140.64999,139.92,3072
2012-03-21 13:30:00,140.52,140.64999,139.92,140.21001,134.9251564864865,121.78282178571432,126.44051995000046,129.66648039999998,134.95872,138.11070100000015,134.9960150421979,138.2729794948808,138.60554000000013,142.66380157589902,134.54727842410122,126.44051995000046,129.66648039999998,134.95872,138.11070100000015,140.26,122388368,140849888.8,65.99914656907433,1.5,2.75,1.2009197648791397,0.868927686366764,0.10846703390581758,1.661887452977112,1.5534204190712944,12.009553125260133,2.3132079913315984,5980145853.0,2012-03-21,2012,2,81,3,0.52,140.28,139.55,138.74001,3073
2012-03-22 13:30:00,139.17999,139.55,138.74001,139.2,135.16218378378375,121.70567857142858,126.49171990000048,129.7721804,135.16011999999998,138.23915100000016,135.16087719740582,138.36126716203503,138.79400153846166,142.71532219671275,134.87268088021057,126.49171990000048,129.7721804,135.16011999999998,138.23915100000016,139.16333666666668,135216688,140725510.4,59.041998720913035,1.5,2.75,1.2201397816734867,0.9608541309650136,-0.01447436195150553,1.5353274666319123,1.549801828583418,12.561834490654745,1.18484399325114,5844929165.0,2012-03-22,2012,3,82,3,0.58,139.15,139.81,138.55,3074
2012-03-23 13:30:00,139.32001,139.81,138.55,139.64999,135.3992110810811,121.62853535714291,126.5478698500005,129.88268019999998,135.36911980000002,138.37515100000013,135.33692083672324,138.48400267041262,139.17092384615398,142.333508393174,136.00833929913395,126.5478698500005,129.88268019999998,135.36911980000002,138.37515100000013,139.33666333333335,120520944,141474604.8,61.01381101059871,1.5,2.75,1.2229869401253797,0.8518910101949264,-0.07618481403176712,1.454570811043709,1.530755625075476,12.52479974892018,1.5045718854484589,5965450109.0,2012-03-23,2012,4,83,3,0.91,139.18,141.61,140.60001,3075
2012-03-26 13:30:00,140.64999,141.61,140.60001,141.61,135.63623837837838,121.5513921428572,126.60891990000047,130.0437802,135.61112,138.59765100000016,135.58292394116546,138.7817167018019,139.6263084615386,142.32346896523848,136.92914795783872,126.60891990000047,130.0437802,135.61112,138.59765100000016,141.27333666666667,120163936,140196360.8,68.19588988316943,1.5,2.75,1.2756314444021393,0.8571116633435466,0.0002576563964302725,1.5310776955710144,1.5308200391745836,14.337608834475672,1.1052248290042992,6085614045.0,2012-03-26,2012,0,86,3,0.72,141.11,141.83,141.08,3076
2012-03-27 13:30:00,141.74001,141.83,141.08,141.17,135.87326567567567,121.4742489285715,126.6767698500005,130.2354602,135.85772,138.77820050000014,135.80202496308053,139.00917225401122,139.9440015384617,142.29900000919153,137.58900306773185,126.6767698500005,130.2354602,135.85772,138.77820050000014,141.36,119868432,139721992.0,65.28816750892946,1.5,2.75,1.2380863412305576,0.8579066923122596,0.006120842980887442,1.5384710929006928,1.5323502499198054,10.98073864245764,0.9005789436065977,5965745613.0,2012-03-27,2012,1,87,3,0.53,141.46,141.32001,139.64,3077
2012-03-28 13:30:00,141.10001,141.32001,139.64,140.47,136.110292972973,121.39710571428577,126.7406198500005,130.4002601,136.08032,138.95070050000015,135.9850828076656,139.14829870601014,140.16707769230786,142.09009437546948,138.24406100914624,126.7406198500005,130.4002601,136.08032,138.95070050000015,140.47666999999998,148562000,137853357.6,60.84350291187298,1.5,2.75,1.2696523168569471,1.07768140425765,-0.04916759936102477,1.4708907507185245,1.5200583500795493,11.43893291596327,-0.17765776009096074,5817183613.0,2012-03-28,2012,2,88,3,1.2,140.48,140.49338999999998,139.09,3078
2012-03-29 13:30:00,139.64,140.49338999999998,139.09,140.23,136.3473202702703,121.31996250000005,126.7951698000005,130.5400601,136.26951999999997,139.07570050000015,136.15155014854147,139.25131787686635,140.370923846154,141.58485245958337,139.15699523272465,126.7951698000005,130.5400601,136.26951999999997,139.07570050000015,139.93779666666669,164963632,138850232.8,59.35161920327093,1.5,2.75,1.2792050085100222,1.1880688182756869,-0.11041819824201672,1.3820356022770284,1.492453800519045,10.949490834897189,-0.049893086243778764,5652219981.0,2012-03-29,2012,3,89,3,1.01,139.79,141.05,140.05,3079
2012-03-30 13:30:00,140.92,141.05,140.05,140.81,136.58434756756756,121.24281928571432,126.8641198000005,130.69335009999998,136.4565198,139.25060050000016,136.3342344564418,139.39976379335528,140.42846230769248,141.64925509702366,139.2076695183613,126.8641198000005,130.69335009999998,136.4565198,139.25060050000016,140.63666666666668,135486688,139592654.4,61.78998788989721,1.5,2.75,1.2592617936164492,0.9705860855096684,-0.11961275399081694,1.3429378580305242,1.4625506120213407,11.082059038728351,-0.028406103769531305,5787706669.0,2012-03-30,2012,4,90,3,0.71,140.55,142.21001,140.36,3080
2012-04-02 13:30:00,140.64,142.21001,140.36,141.84,136.82137486486488,142.21001,126.93681980000049,130.8491502,136.66251999999997,139.50510050000014,136.550146830699,139.63216724160716,140.57692384615402,141.96707531385064,139.1867723784573,126.93681980000049,130.8491502,136.66251999999997,139.50510050000014,141.47000333333338,151741056,140141456.8,65.72241152017986,1.5,2.75,1.301458094072417,1.0827706480642207,-0.06670702621240321,1.379166829255837,1.4458738554682402,11.631959471507404,0.996866989461696,5939447725.0,2012-04-02,2012,0,93,4,1.32,141.29,141.8826,140.42999,3081
2012-04-03 13:30:00,141.64,141.8826,140.42999,141.25999,137.05840216216214,142.3992507594937,127.0078697500005,130.98295009999998,136.8555198,139.83060000000015,136.73484656282844,139.78719798050173,140.6184615384617,142.05473580319338,139.18218727373005,127.0078697500005,130.98295009999998,136.8555198,139.83060000000015,141.19086,155806624,137825297.6,61.86152795533543,1.5,2.75,1.3122546587815296,1.1304646295935152,-0.08024648759114061,1.3455657459793144,1.425812233570455,11.784838760724744,0.7488623672446614,5783641101.0,2012-04-03,2012,1,94,4,1.03,141.16,140.339,139.34,3082
2012-04-04 13:30:00,140.22,140.339,139.34,139.86,137.29542945945946,142.58849151898738,127.0686697500005,131.14994009999998,137.0235196,140.03910000000016,136.8574015995803,139.79413150616824,140.58461538461555,142.06923666007722,139.09999410915387,127.0686697500005,131.14994009999998,137.0235196,140.03910000000016,139.84633333333332,146895936,137985488.0,53.666497006173174,1.5,2.75,1.3556643260114192,1.0645752544644405,-0.18686905533778675,1.1922259143982217,1.3790949697360084,13.233322527562256,0.4741379310345008,5636745165.0,2012-04-04,2012,2,95,4,0.72,139.84,140.2,139.25999,3083
2012-04-05 13:30:00,139.38,140.2,139.25999,139.78999,137.53245675675672,142.777732278481,127.1203697000005,131.30463989999998,137.16811939999997,140.17660000000015,136.9724050662634,139.79373707700935,140.50307538461553,142.0360852191773,138.97006555005382,127.1203697000005,131.30463989999998,137.16811939999997,140.17660000000015,139.74999333333332,137439376,139009016.0,53.28633767457399,1.5,2.75,1.325974731296318,0.9887083583125283,-0.2609428507486251,1.052916406300227,1.313859257048852,12.478373706299811,0.1002506337451126,5499305789.0,2012-04-05,2012,3,96,4,0.68,139.73,139.84441,137.84,3084
2012-04-09 13:30:00,138.03,139.84441,137.84,138.22,137.76948405405406,142.96697303797467,127.16811970000052,131.42023989999998,137.29491939999997,140.20909950000015,137.0213303577825,139.64385735538943,140.3323061538463,142.29089546267718,138.37371684501542,127.16811970000052,131.42023989999998,137.29491939999997,140.20909950000015,138.63480333333334,127555872,139244972.0,45.502111451249284,1.5,2.75,1.3744343933465817,0.9160537013860724,-0.4058631133103559,0.8065303654109073,1.2123934787212631,13.9734151484745,-2.3938987359649846,5371749917.0,2012-04-09,2012,0,100,4,1.45,138.84,138.34,135.75999,3085
2012-04-10 13:30:00,137.95,138.34,135.75999,135.89999,135.75999,143.15621379746838,127.20611470000051,131.52463970000002,137.37651899999997,140.12509900000015,136.97735622610477,139.28729855963806,140.0007661538463,143.0726616032772,136.92887070441543,127.20611470000051,131.52463970000002,137.37651899999997,140.12509900000015,136.66666,235360256,145812809.6,36.91928209890888,1.5,2.75,1.4605469366789696,1.6141260609794876,-0.6345310894088549,0.41922961696019456,1.0537607063690495,13.075787193332864,-3.733094850180623,5136389661.0,2012-04-10,2012,1,101,4,1.9,137.05,137.53999,136.75,3086
2012-04-11 13:30:00,137.28999,137.53999,136.75,137.0,135.9725985869565,143.34545455696204,127.25706470000051,131.6338098,137.48911899999996,139.97199900000015,136.97824421723791,139.0694606015773,139.8315353846155,143.28049615359717,136.3825746156339,127.25706470000051,131.6338098,137.48911899999996,139.97199900000015,137.09666333333334,154132944,144314935.2,42.46109640985342,1.5,2.75,1.4733650126304707,1.0680318276579874,-0.6839994454115204,0.1987613996046491,0.8827608450161695,14.83836957139802,-2.470278351249376,5290522605.0,2012-04-11,2012,2,102,4,0.58,137.14,138.89999,137.03,3087
2012-04-12 13:30:00,137.13,138.89999,137.03,138.78999,136.18520717391303,143.5346953164557,127.31131465000051,131.78090969999997,137.63851859999997,139.91599850000014,137.04929307146386,139.04284435380805,139.7653815384617,143.2584423302097,136.2723207467136,127.31131465000051,131.78090969999997,137.63851859999997,139.91599850000014,138.23999333333333,154321504,144772835.2,50.13765695696719,1.5,2.75,1.5038382260140088,1.0659562188362808,-0.5729638534715074,0.16655602817678528,0.7395198816482926,17.326097804559133,-1.0268915353348078,5444844109.0,2012-04-12,2012,3,103,4,1.36,137.96,138.8168,137.00999,3088
2012-04-13 13:30:00,138.47,138.8168,137.00999,137.14,136.39781576086955,143.72393607594938,127.34896465000051,131.93125969999997,137.73191859999997,139.73699850000014,137.05285020591626,138.8616210820168,139.4215353846155,142.99957989370932,135.84349087552172,127.34896465000051,131.93125969999997,137.73191859999997,139.73699850000014,137.65559666666664,169246624,144979244.8,44.27399172218564,1.5,2.75,1.5254790670130092,1.1673851952634808,-0.5853737523051116,0.007802691266903139,0.5931764435720147,18.3982651139066,-2.6063489808962546,5275597485.0,2012-04-13,2012,4,104,4,1.32,137.91,138.03999,136.58,3089
2012-04-16 13:30:00,137.84,138.03999,136.58,137.05,136.61042434782607,143.91317683544304,127.38061465000051,132.08196969999997,137.81931880000002,139.57449850000015,137.05273843313523,138.68908574087234,139.1046123076924,142.73648559617928,135.4727390192055,127.38061465000051,132.08196969999997,137.81931880000002,139.57449850000015,137.22333,147825184,144725835.2,43.97190869033166,1.5,2.75,1.5208012765120782,1.0214153112035385,-0.5736172432464588,-0.12384511048605873,0.4497721327604,17.99495171991598,-3.3770445572475962,5127772301.0,2012-04-16,2012,0,107,4,1.07,137.31,139.36,137.69799999999998,3090
2012-04-17 13:30:00,137.84,139.36,137.69799999999998,139.082,136.8230329347826,144.10241759493672,127.4161746500005,132.27617969999997,137.91015900000002,139.48609800000014,137.13231731811032,138.72650614650354,138.99784307692315,142.54346524086782,135.45222091297856,127.4161746500005,132.27617969999997,137.91015900000002,139.48609800000014,138.71333333333334,147877568,145855163.2,51.944297325401095,1.5,2.75,1.5771726139040732,1.013865843043395,-0.4106015211843319,-0.06347976872001483,0.34712175246431703,19.903759122050623,-1.5418307760038736,5275649869.0,2012-04-17,2012,1,108,4,1.21,138.53,139.08,138.38,3091
2012-04-18 13:30:00,138.46001,139.08,138.38,138.61,137.0356415217391,144.29165835443038,127.43962465000051,132.47037969999997,137.99335899999997,139.39459800000014,137.19026565857658,138.71541032302702,138.8732276923078,142.35007433465594,135.39638104995967,127.43962465000051,132.47037969999997,137.99335899999997,139.39459800000014,138.69000000000003,123884192,145962891.2,50.15890501820164,1.5,2.75,1.5146602843394965,0.8487375865298016,-0.3201885945872611,-0.05311399076975931,0.2670746038175017,19.88044775760524,-0.8937508937508937,5151765677.0,2012-04-18,2012,2,109,4,0.51,138.73,139.14999,137.07001,3092
2012-04-19 13:30:00,138.63,139.14999,137.07001,137.72,137.24825010869563,144.4808991139241,127.45917465000052,132.68197969999997,138.05195919999997,139.27009750000016,137.21103955431866,138.62060933988158,138.63553538461548,141.9698272030696,135.30124356616136,127.45917465000052,132.68197969999997,138.05195919999997,139.27009750000016,137.98000000000002,198666752,149776810.4,46.8864349224252,1.5,2.75,1.5550402640295329,1.3264186322931604,-0.30596729755150986,-0.11538451812188555,0.1905827794296243,19.457136535144254,-1.4807855698394357,4953098925.0,2012-04-19,2012,3,110,4,1.52,138.11,138.83,137.87,3093
2012-04-20 13:30:00,138.33,138.83,137.87,137.95,137.46085869565215,144.67013987341772,127.47907465000051,132.89807969999998,138.10715919999998,139.20759750000016,137.24001839532576,138.55674178370242,138.3363046153847,141.1191774461346,135.55343178463488,127.47907465000051,132.89807969999998,138.10715919999998,139.20759750000016,138.21666666666667,143199568,150175954.4,47.83363286426591,1.5,2.75,1.52325167374171,0.9535452501176178,-0.2680737969001188,-0.14450946669552422,0.12356433020459458,19.539064718938448,-0.19534076110549145,5096298493.0,2012-04-20,2012,4,111,4,0.7,138.35,136.91,135.94,3094
2012-04-23 13:30:00,136.53999,136.91,135.94,136.78999,137.67346728260867,144.8593806329114,127.48622460000051,133.06887949999998,138.135759,139.06459750000016,137.22237022296005,138.38847970906406,137.99245846153858,140.31130427711005,135.6736126459671,127.48622460000051,133.06887949999998,138.135759,139.06459750000016,136.54666333333333,171844880,152742151.2,43.60952296109699,1.5,2.75,1.5580194113315868,1.1250652072785523,-0.305425654023742,-0.2582177373250829,0.047207916698659085,19.07094063384292,0.6548933520892727,4924453613.0,2012-04-23,2012,0,114,4,0.71,136.43,137.66,136.8,3095
2012-04-24 13:30:00,136.91,137.66,136.8,137.31,137.8860758695652,145.0486213924051,127.50077465000051,133.24147949999997,138.1947392,138.84959750000016,137.22580668480475,138.28576735581987,137.7963046153847,139.86833409798248,135.72427513278694,127.50077465000051,133.24147949999997,138.1947392,138.84959750000016,137.2566666666667,137484192,153608164.0,45.915267430063686,1.5,2.75,1.50887588195076,0.8950318031273392,-0.2800707191707308,-0.3028804822647544,-0.02280976309402362,16.261270759497002,0.2262773722627754,5061937805.0,2012-04-24,2012,1,115,4,0.63,137.23,139.25,138.53,3096
2012-04-25 13:30:00,138.64999,139.25,138.53,139.19,138.09868445652174,145.23786215189875,127.5368746500005,133.38347939999997,138.2713392,138.75059750000014,137.30283387363593,138.37188475050368,137.75015153846164,139.66311614082366,135.83718693609958,127.5368746500005,133.38347939999997,138.2713392,138.75059750000014,138.98999999999998,150255008,155127492.8,53.34295272762828,1.5,2.75,1.53967046181142,0.9685904496227375,-0.1293118070843949,-0.18444952194951725,-0.055137714865122346,17.404430665781597,0.2882124280000373,5212192813.0,2012-04-25,2012,2,116,4,0.52,138.89,140.32001,138.81,3097
2012-04-26 13:30:00,138.89,140.32001,138.81,140.16,138.31129304347826,145.4271029113924,127.58067470000047,133.53537939999998,138.3707392,138.73509750000017,137.4148796040816,138.5421814409319,137.8993823076924,140.1992327001873,135.5995319151975,127.58067470000047,133.53537939999998,138.3707392,138.73509750000017,139.76333666666665,136292688,154514027.2,56.65089209851979,1.5,2.75,1.537551857396318,0.8820732361314055,0.03436551085554556,-0.012180826295690395,-0.04654633715123595,16.268721738950454,2.202129211025237,5348485501.0,2012-04-26,2012,3,117,4,1.09,139.57,140.78999,139.8,3098
2012-04-27 13:30:00,140.58,140.78999,139.8,140.39,138.52390163043478,145.6163436708861,127.62342470000047,133.69067939999996,138.4873392,138.74309750000015,137.53155099215678,138.71816416084314,138.24476769230782,140.58801241829448,135.90152296632115,127.62342470000047,133.69067939999996,138.4873392,138.74309750000015,140.32666333333336,130725008,152802096.0,57.42174050677784,1.5,2.75,1.4984402961537222,0.8555184216844774,0.15025620266731746,0.14127391618291085,-0.00898228648440659,14.033670482253658,2.4370667639547428,5479210509.0,2012-04-27,2012,4,118,4,0.71,140.29,140.21001,139.49001,3099
2012-04-30 13:30:00,140.11,140.21001,139.49001,139.87,138.7365102173913,145.80558443037975,127.66812475000047,133.82717939999998,138.5637592,138.69609750000015,137.62325487481732,138.82786281219143,138.46553692307705,140.8386823368123,136.09239150934184,127.66812475000047,133.82717939999998,138.5637592,138.69609750000015,139.85667333333333,115092192,151782371.2,55.03877494861001,1.5,2.75,1.4556938464284546,0.7582711423604378,0.1819142692948128,0.21841055013410934,0.0364962808392966,14.376878576577775,0.5665722379603478,5364118317.0,2012-04-30,2012,0,121,4,0.52,139.85,141.66,139.63,3100
2012-05-01 13:30:00,139.78999,141.66,139.63,140.74001,138.94911880434782,141.66,127.7133748000005,133.97197959999997,138.6503594,138.64109800000014,137.74548056600096,139.0099720681732,138.6155384615386,141.28034408189342,135.95073284118376,127.7133748000005,133.97197959999997,138.6503594,138.64109800000014,140.67666999999997,138837312,151137184.0,58.166785670475576,1.5,2.75,1.4967157145407075,0.9186178300106478,0.247409961614896,0.3457587328579166,0.0983487712430206,12.315850695538714,1.5366928793016366,5502955629.0,2012-05-01,2012,1,122,5,1.45,140.64,140.46001,139.46001,3101
2012-05-02 13:30:00,139.92,140.46001,139.46001,140.325,139.16172739130434,141.63249950000002,127.7619498000005,134.10792959999998,138.7274594,138.59434850000014,137.84663819086367,139.13521282358528,138.8605384615386,141.52330649681073,136.19777042626643,127.7619498000005,134.10792959999998,138.7274594,138.59434850000014,140.08167333333333,121080944,149400900.0,56.1596644534809,1.5,2.75,1.4812360206449429,0.8104432034880646,0.2481101580500113,0.4084864688055347,0.16037631075552344,12.257728184334226,1.891519024106876,5381874685.0,2012-05-02,2012,2,123,5,0.72,139.96,140.45,138.99001,3102
2012-05-03 13:30:00,140.34,140.45,138.99001,139.25,139.37433597826086,141.604999,127.7945498000005,134.26092959999997,138.7918194,138.56384850000012,137.9016719873004,139.14614493562476,139.02976923076938,141.48207786414775,136.577460597391,127.7945498000005,134.26092959999997,138.7918194,138.56384850000012,139.5633366666667,143762688,149244237.6,51.22854892743793,1.5,2.75,1.4797184477417311,0.9632712814367314,0.16547657432689705,0.3672220286641448,0.20174545433724766,12.560127263237774,0.9423704240666992,5238111997.0,2012-05-03,2012,3,124,5,1.05,139.72,139.30119,136.92,3103
2012-05-04 13:30:00,138.515,139.30119,136.92,137.0,139.58694456521738,141.57749850000002,127.81629985000048,134.3704296,138.7991994,138.42434900000012,137.86631230152392,138.94175017985097,138.86961538461549,141.54880596717953,136.1904248020515,127.81629985000048,134.3704296,138.7991994,138.42434900000012,137.74039666666667,193931312,152068834.4,42.76474983112462,1.5,2.75,1.5441092729030363,1.2752863712355778,-0.04042012892262367,0.15122029318396812,0.1916404221065918,16.009689040642968,0.15352731585111684,5044180685.0,2012-05-04,2012,4,125,5,1.74,138.11,137.56,136.46001,3104
2012-05-07 13:30:00,136.50999,137.56,136.46001,137.10001,139.7995531521739,141.549998,127.82934985000048,134.49932959999998,138.80259980000002,138.36834950000014,137.83626123087592,138.76634635319851,138.75346230769244,141.59369063882863,135.91323397655626,127.82934985000048,134.49932959999998,138.80259980000002,138.36834950000014,137.04000666666667,127765872,152079334.4,43.213848041455,1.5,2.75,1.5123864676956762,0.8401264544198321,-0.16271804827720532,-0.011757138239914866,0.15096091003729045,15.232617267565637,-0.15293132328308556,5171946557.0,2012-05-07,2012,0,128,5,0.81,137.01,136.77,134.92,3105
2012-05-08 13:30:00,136.28,136.77,134.92,136.55,140.01216173913042,141.52249750000001,127.83919985000044,134.63432959999997,138.79039980000002,138.40085000000016,137.78581961397882,138.55526574813197,138.66346230769244,141.69657784036326,135.63034677502162,127.83919985000044,134.63432959999997,138.79039980000002,138.40085000000016,136.08,213383872,150980515.2,41.29480379679881,1.5,2.75,1.5600738628602713,1.413320597809167,-0.2673187009319854,-0.18318746612769127,0.08413123480429409,15.222957455984238,-1.8966879804583563,4958562685.0,2012-05-08,2012,1,129,5,1.37,135.84,136.61,134.49001,3106
2012-05-09 13:30:00,135.10001,136.61,134.49001,135.74001,140.22477032608694,141.49499699999996,127.84874990000046,134.7743296,138.75401980000004,138.33785050000014,137.70559178597964,138.28714615307177,138.4934630769232,141.89306329292566,135.09386286092078,127.84874990000046,134.7743296,138.75401980000004,138.33785050000014,135.61334,220778192,154312777.6,38.577782383897315,1.5,2.75,1.6000678726559665,1.4307188000483506,-0.3713257534626832,-0.38002595702405984,-0.008700203561376699,12.461609068086796,-3.1535316780821807,4737784493.0,2012-05-09,2012,2,130,5,1.58,135.55,136.85001,135.71001,3107
2012-05-10 13:30:00,136.67999,136.85001,135.71001,136.02,140.43737891304346,141.46749649999995,127.86219990000043,134.9126796,138.73401980000003,138.19935100000015,137.63949014731378,138.07122747182683,138.4342330769232,141.97440942431422,134.89405672953217,127.86219990000043,134.9126796,138.73401980000003,138.19935100000015,136.19333999999998,150600944,154126749.6,40.0462406926296,1.5,2.75,1.5672058817519676,0.9771239865295908,-0.3991022236668173,-0.5075779831448983,-0.10847575947808104,11.376221401003153,-3.1127573188973408,4888385437.0,2012-05-10,2012,3,131,5,0.84,136.28,136.87,135.11,3108
2012-05-11 13:30:00,135.17,136.87,135.11,135.61,140.64998749999998,141.43999599999995,127.88724985000046,135.05287959999998,138.6916198,138.12285100000014,137.55990229839952,137.83682485546237,138.30346384615402,142.1152610247018,134.49166666760615,127.88724985000046,135.05287959999998,138.6916198,138.12285100000014,135.86333333333334,153032368,153316036.8,38.59127977049336,1.5,2.75,1.5809768901982548,0.9981497773754088,-0.4207666683936066,-0.6344340949700893,-0.2136674265764827,10.989779863944118,-3.045685279187811,4735353069.0,2012-05-11,2012,4,132,5,1.3,135.99,135.6144,133.91,3109
2012-05-14 13:30:00,134.31,135.6144,133.91,134.11,140.8625960869565,141.41249549999995,127.90669985000046,135.19107970000002,138.62757980000003,137.9758510000002,137.42461201218777,137.48188915494214,137.91269461538474,142.28167364092766,133.5437155898418,127.90669985000046,135.19107970000002,138.62757980000003,137.9758510000002,134.5448,163909936,154120274.4,33.7588134576084,1.5,2.75,1.5897928266126649,1.0635196221789234,-0.5060667691810941,-0.8462508880528503,-0.34018411887175626,11.838787198309516,-4.710821038026072,4571443133.0,2012-05-14,2012,0,135,5,1.27,134.76,134.81,133.13,3110
2012-05-15 13:30:00,134.02,134.81,133.13,133.34,141.07520467391305,141.384995,127.92674985000043,135.2851798,138.55937980000002,137.68875100000022,137.26443114896472,137.08742352113813,137.38807923076936,142.17000691542333,132.60615154611543,127.92674985000043,135.2851798,138.55937980000002,137.68875100000022,133.76,207629248,157107858.4,31.57315741158804,1.5,2.75,1.5962361961403322,1.3215713721421334,-0.5790405710042631,-1.063984832627085,-0.484944261622822,9.812826091635618,-4.97773026901834,4363813885.0,2012-05-15,2012,1,136,5,1.26,133.97,134.55,132.8,3111
2012-05-16 13:30:00,133.94,134.55,132.8,132.82899,141.2878132608695,141.3574945,127.94699480000048,135.37176970000002,138.52095960000003,137.39970050000016,137.09049228037787,136.68185842388692,136.8064630769232,141.820086547585,131.7928396062614,127.94699480000048,135.37176970000002,138.52095960000003,137.39970050000016,133.39299666666668,207265568,161276927.2,30.176816618870987,1.5,2.75,1.6072193249874511,1.2851532553256633,-0.6226151928202566,-1.2632132526481428,-0.6405980598278862,9.745014855435173,-4.611138240574503,4156548317.0,2012-05-16,2012,2,137,5,1.32,133.68,133.02,130.78999,3112
2012-05-17 13:30:00,132.86,133.02,130.78999,130.86,141.50042184782606,141.329994,127.97384475000048,135.4276697,138.42435960000003,137.0567005000002,136.8461592497748,136.12739571685006,136.1133861538463,141.69974061565833,130.5270316920343,127.97384475000048,135.4276697,138.42435960000003,137.0567005000002,131.55666333333332,247992944,163743236.8,25.497614942139112,1.5,2.75,1.651704373202635,1.5145232795349262,-0.7371045360116519,-1.5619787298424512,-0.8248741938307992,11.128375585416613,-4.4817518248175094,3908555373.0,2012-05-17,2012,3,138,5,1.71,131.9,131.60001,129.55,3113
2012-05-18 13:30:00,131.37,131.60001,129.55,129.74001,141.7130304347826,141.3024935,127.99169480000047,135.46116980000002,138.27836000000002,136.64620100000022,136.5674867301758,135.51907326762623,135.2672323076925,141.1200551805714,129.41440943481354,127.99169480000047,135.46116980000002,138.27836000000002,136.64620100000022,130.29667333333336,319631104,172564813.6,23.285818448322345,1.5,2.75,1.6801547751167316,1.8522379929717028,-0.8341789252402538,-1.8675978503811168,-1.0334189251408628,9.311013443294607,-5.368343882688254,3588924269.0,2012-05-18,2012,4,139,5,1.58,130.58,132.02,129.95,3114
2012-05-21 13:30:00,130.16,132.02,129.95,131.97,141.9256390217391,141.274993,128.0502448500005,135.5159697,138.16635980000004,136.4052015000002,136.387193132914,135.1810662897571,134.62454000000014,139.9233504113456,129.3257295886547,128.0502448500005,135.5159697,138.16635980000004,136.4052015000002,131.31333333333336,177861056,172865622.4,35.317021835742395,1.5,2.75,1.7230001483226791,1.0288977850578114,-0.6995599988739301,-1.9078689237332755,-1.2083089248593453,15.736378231568928,-3.35408275357013,3766785325.0,2012-05-21,2012,0,142,5,1.59,130.99,133.23,131.34,3115
2012-05-22 13:30:00,132.31,133.23,131.34,132.2,142.13824760869562,141.2474925,128.1108448500005,135.5896697,138.05875980000002,136.14970150000022,136.22298948064287,134.89715521454212,134.08223230769246,138.78613471507865,129.37832990030628,128.1108448500005,135.5896697,138.05875980000002,136.14970150000022,132.25666666666666,197531120,175867968.8,36.424494056694456,1.5,2.75,1.7349287091567729,1.1231784920688752,-0.552817388220302,-1.8993306601347228,-1.3465132719144208,16.052084907512473,-2.6079340940081144,3964316445.0,2012-05-22,2012,1,143,5,1.44,132.28,132.46001,129.99001,3116
2012-05-23 13:30:00,131.25,132.46001,129.99001,132.27,142.35085619565217,141.219992,128.21089490000048,135.6511697,137.90291980000003,135.80370150000022,136.06797028532353,134.64694995601428,133.7183861538463,138.18920068511432,129.24757162257828,128.21089490000048,135.6511697,137.90291980000003,135.80370150000022,131.57334,204958320,178603134.4,36.779272489013856,1.5,2.75,1.7874338013598603,1.147562839188336,-0.4151192208209158,-1.8654122979405656,-1.4502930771196498,16.08203472868527,-2.756947507719453,4169274765.0,2012-05-23,2012,2,144,5,1.9,131.23,132.84,131.42,3117
2012-05-24 13:30:00,132.63,132.84,131.42,132.53,142.5634647826087,141.19249150000002,128.2861449000005,135.72146970000003,137.75531980000002,135.4222015000002,135.92922635256573,134.44533567448914,133.36684692307705,137.41775137577886,129.31594247037523,128.2861449000005,135.72146970000003,137.75531980000002,135.4222015000002,132.26333333333332,167357632,180156381.6,38.15965447813368,1.5,2.75,1.7611885298341572,0.928957556283424,-0.2772368039042503,-1.796839081999963,-1.5196022780957124,16.071908597327038,-2.2712189366565982,4336632397.0,2012-05-24,2012,3,145,5,1.08,132.13,132.85001,131.78,3118
2012-05-25 13:30:00,132.48,132.85001,131.78,132.10001,142.77607336956518,141.164991,128.38519500000046,135.7675198,137.58292000000003,135.00770200000022,135.7790610054063,134.2219713245378,133.02454000000014,136.67382179530108,129.3752582046992,128.38519500000046,135.7675198,137.58292000000003,135.00770200000022,132.24334,135465568,180393409.6,36.731269024092065,1.5,2.75,1.7118186348460027,0.750945216348968,-0.18986859819653312,-1.7569380258413787,-1.5670694276448456,16.07465361467042,-1.4987622101260278,4201166829.0,2012-05-25,2012,4,146,5,0.81,132.32,133.92999,131.17,3119
2012-05-29 13:30:00,133.16,133.92999,131.17,133.7,142.98868195652173,141.13749049999996,128.46704500000047,135.8275198,137.45092000000002,134.6992020000002,135.69752920127272,134.17225976981993,132.8676161538463,136.19782427601874,129.53740803167392,128.46704500000047,135.8275198,137.45092000000002,134.6992020000002,132.93332999999998,152883440,182282972.0,44.98360185641555,1.5,2.75,1.7866880180712894,0.8387148745852135,-0.00876037702566368,-1.5780198989269252,-1.5692595219012615,17.05580895618053,0.2699865006749552,4354050269.0,2012-05-29,2012,1,150,5,2.1,132.55,133.6924,131.49001,3120
2012-05-30 13:30:00,132.56,133.6924,131.49001,131.75999,143.20129054347825,141.10998999999995,128.53524495000048,135.86471980000002,137.2691196,134.25020100000023,135.54311589926203,133.94251979174186,132.53992307692323,135.3649086286213,129.71493752522517,128.53524495000048,135.86471980000002,137.2691196,134.25020100000023,132.31413333333333,162370368,183459624.8,38.43709595776471,1.5,2.75,1.8169238739233384,0.8850468770826789,-0.004286285672546963,-1.574617378991945,-1.5703310933193984,18.759895480771746,-0.8047941943998947,4191679901.0,2012-05-30,2012,2,151,5,1.67,132.59,132.45,130.34,3121
2012-05-31 13:30:00,131.71001,132.45,130.34,131.47,143.41389913043474,141.08248949999995,128.58949495000047,135.90231970000002,137.08971960000002,133.8074510000002,135.38338586399686,133.70704171633784,132.2214615384617,134.46355522012502,129.97936785679843,128.58949495000047,135.90231970000002,137.08971960000002,133.8074510000002,131.42,196186192,187214887.2,37.557237695847114,1.5,2.75,1.837857882928813,1.0479198258972644,-0.005447393214738527,-1.5771403348378217,-1.5716929416230832,18.69894175923833,0.4661470273574699,3995493709.0,2012-05-31,2012,3,152,5,1.62,131.39,131.5042,128.16,3122
2012-06-01 13:30:00,129.41,131.5042,128.16,128.16,143.62650771739132,141.05498899999995,128.6323449500005,135.90371969999998,136.84871940000002,133.25295100000022,135.10011583011462,133.17875202906757,131.7637692307694,134.6215963412367,128.90594212030211,128.6323449500005,135.90371969999998,136.84871940000002,133.25295100000022,129.27473333333333,253245008,192689003.2,29.31001318292829,1.5,2.75,1.9454537484338976,1.3142680889637817,-0.2027972342715552,-1.8251894844625267,-1.6223922501909718,22.216275499585567,-1.2178278697527585,3742248701.0,2012-06-01,2012,4,153,6,2.61,129.83,128.74001,127.13498999999999,3123
2012-06-04 13:30:00,128.39,128.74001,127.13498999999999,128.10001,127.13498999999999,141.02748849999998,128.6744950000005,135.8934198,136.62671960000003,132.80795150000023,134.8256018759925,132.6950623120135,131.36069307692327,134.65963624457711,128.06174990926942,128.6744950000005,135.8934198,136.62671960000003,132.80795150000023,127.99167,202548256,193119850.4,29.18492728748577,1.5,2.75,1.921137052117192,1.0488215249777346,-0.3048987064119826,-2.00351563320595,-1.6986169267939677,21.831948952931107,-2.9324770781238167,3539700445.0,2012-06-04,2012,0,156,6,1.26,127.94,129.25999,127.78,3124
2012-06-05 13:30:00,127.85001000000001,129.25999,127.78,129.07001,126.9080163157895,140.99998799999997,128.74729510000049,135.8921199,136.41512000000003,132.4064515000002,134.59989239065948,132.34981923467888,131.07154076923095,134.4626717327921,127.6804098056698,128.74729510000049,135.8921199,136.41512000000003,132.4064515000002,128.70333333333335,164149376,194939025.6,34.08344187925981,1.5,2.75,1.8896265483945345,0.8420549733167436,-0.2755215369167385,-2.0430188479398907,-1.7674973110231522,19.475196446650195,-2.367617246596061,3703849821.0,2012-06-05,2012,1,157,6,1.16,128.52,132.03,129.92999,3125
2012-06-06 13:30:00,129.97,132.03,129.92999,131.97,126.68104263157896,140.97248749999997,128.8439451000005,135.91672,136.22232000000002,132.17745150000022,134.49675935573163,132.31364597423328,131.15692538461556,134.57821405358317,127.73563671564794,128.8439451000005,135.91672,136.22232000000002,132.17745150000022,131.30999666666665,184202752,193479969.6,46.08997635844351,1.5,2.75,1.966081080652068,0.9520507594704524,-0.0414806794709055,-1.819348160361784,-1.7778674808908783,24.00607521533686,-0.2268088001814556,3888052573.0,2012-06-06,2012,2,158,6,1.62,130.98,133.53,131.78,3126
2012-06-07 13:30:00,133.47,133.53,131.78,132.05,126.45406894736843,140.94498699999997,128.9405451000005,135.94881999999998,136.03992000000005,131.9929510000002,134.40080800844805,132.28853683383008,131.33461692307708,134.68224156396357,127.98699228219064,128.9405451000005,135.94881999999998,136.03992000000005,131.9929510000002,132.45333333333335,184772688,191679694.4,46.38012936958422,1.5,2.75,1.9506467177483489,0.9639658941359414,0.1286999731763918,-1.6169925144203887,-1.7456924875967803,24.00693531145829,-0.3621821474383081,4072825261.0,2012-06-07,2012,3,159,6,1.33,132.66,133.125,131.28999,3127
2012-06-08 13:30:00,131.71001,133.125,131.28999,133.10001,126.22709526315788,140.91748649999997,129.02384515000048,135.98642009999998,135.89252020000006,131.84695150000022,134.34979632184223,132.36581999251294,131.42154076923094,134.88724509942787,127.95583643903404,129.02384515000048,135.98642009999998,135.89252020000006,131.84695150000022,132.505,143915632,191345428.8,50.17090995397586,1.5,2.75,1.942386952194896,0.7521247458199012,0.31154357441932623,-1.3562630195726229,-1.6678065939919489,24.43870506424521,0.7570022137015735,4216740893.0,2012-06-08,2012,4,160,6,1.4,132.21,134.25,131.28,3128
2012-06-11 13:30:00,134.17,134.25,131.28,131.41499,126.00012157894736,140.88998599999996,129.09052010000048,135.99286999999995,135.71622000000008,131.6372010000002,134.23470587784843,132.27526475513082,131.36115538461556,134.79773405653714,127.92457671269396,129.09052010000048,135.99286999999995,135.71622000000008,131.6372010000002,132.31499666666664,169756064,192181613.6,44.70844393190609,1.5,2.75,2.0157878841809747,0.8833106394523477,0.31748580691192485,-1.270949335352043,-1.5884351422639678,25.540738631187388,-1.7090575916230366,4046984829.0,2012-06-11,2012,0,163,6,2.26,132.76,133.00999,131.16,3129
2012-06-12 13:30:00,131.78999,133.00999,131.16,132.92,125.77314789473684,140.86248549999996,129.17372010000048,136.00746989999996,135.55842000000007,131.57770100000022,134.18314878459947,132.336668111785,131.41115538461557,134.9173799659066,127.9049308033245,129.17372010000048,136.00746989999996,135.55842000000007,131.57770100000022,132.36333,181931744,193082704.0,49.94999591045703,1.5,2.75,2.0039451781680477,0.9422477530664788,0.4150948347080483,-1.0695665988789074,-1.4846614335869557,25.426205716569317,0.8803962416815604,4228916573.0,2012-06-12,2012,1,164,6,1.41,132.08,133.36,131.62,3130
2012-06-13 13:30:00,132.53,133.36,131.62,132.07001,125.54617421052632,140.83498499999996,129.24422015000047,136.01277009999995,135.36302020000005,131.51420150000018,134.1002805969681,132.3112721011388,131.37577153846172,134.8452088709125,127.90633420601091,129.24422015000047,136.01277009999995,135.36302020000005,131.51420150000018,132.35000333333335,172223872,191312435.2,47.226978846947574,1.5,2.75,1.9850919511560443,0.9002230922415231,0.4138053240071755,-0.9674047785779862,-1.3812101025851615,24.178145326162394,0.456385487183386,4056692701.0,2012-06-13,2012,2,165,6,1.32,132.49,134.0,131.98,3131
2012-06-14 13:30:00,132.34,134.0,131.98,133.47,125.3192005263158,140.8074845,129.30477015000048,136.03137009999998,135.20722040000007,131.54625200000018,134.0755637108125,132.42162713912558,131.48115538461556,135.11167269240102,127.85063807683014,129.30477015000048,136.03137009999998,135.20722040000007,131.54625200000018,133.15,230616256,192479969.6,51.880012682465924,1.5,2.75,1.987585383216328,1.1981311950498148,0.4932410448400821,-0.7646587965350591,-1.2578998413751412,24.804753287569433,4.143258426966294,4287308957.0,2012-06-14,2012,3,166,6,1.53,132.99,134.25999,133.10001,3132
2012-06-15 13:30:00,133.38,134.25999,133.10001,134.14,125.09222684210528,140.77998399999996,129.36707020000048,136.05816999999993,135.09282040000008,131.71025200000014,134.07809062411397,132.58528169730408,131.51500153846172,135.23473778638115,127.7952652905423,129.36707020000048,136.05816999999993,135.09282040000008,131.71025200000014,133.83333333333334,169444432,188552544.0,53.97164000744408,1.5,2.75,1.9284707129865892,0.8986589541852058,0.5713991726195153,-0.543650875600747,-1.1150500482202623,17.874826242589407,4.715058179932998,4456753389.0,2012-06-15,2012,4,167,6,0.87,133.68,134.73,133.28,3133
2012-06-18 13:30:00,133.58,134.73,133.28,134.39999,124.86525315789473,140.75248349999995,129.42797015000048,136.07656989999995,134.98502040000008,131.94325100000015,134.0907141290507,132.7581110594656,131.71807846153862,135.7447372673889,127.69141965568836,129.42797015000048,136.07656989999995,134.98502040000008,131.94325100000015,134.13666333333333,131365440,179139260.8,54.79280957158883,1.5,2.75,1.8942942334875463,0.7333146258020061,0.6171911369773119,-0.3435611269986225,-0.9607522639759344,17.67998640077671,4.129526293520862,4588118829.0,2012-06-18,2012,0,170,6,1.09,134.0,136.25,134.3714,3134
2012-06-19 13:30:00,135.08,136.25,134.3714,135.7,124.63827947368422,140.72498299999998,129.50177015000048,136.11476989999994,134.93462040000009,132.12975100000014,134.1538233788918,133.03829095856412,132.04346307692325,136.58771449172826,127.4992116621182,129.50177015000048,136.11476989999994,134.93462040000009,132.12975100000014,135.44046666666665,137382560,177115336.0,58.75515015330603,1.5,2.75,1.8931732168098647,0.7756672183373212,0.7052610699774509,-0.07917592650412075,-0.7844369964815716,17.83749696866897,2.8263999393801544,4725501389.0,2012-06-19,2012,1,171,6,1.4,135.31,136.10001,134.27,3135
2012-06-20 13:30:00,135.71001,136.10001,134.27,135.48,124.41130578947369,140.69748249999998,129.58992010000048,136.15136979999997,134.92622060000008,132.2937510000002,134.2058303052098,133.27083467679608,132.60654000000017,136.89319174950634,128.31988825049402,129.58992010000048,136.15136979999997,134.92622060000008,132.2937510000002,135.28333666666666,206466624,177562111.2,57.83137039829346,1.5,2.75,1.8886615584663025,1.1627853634125973,0.7166023234281378,0.11131590780360057,-0.6052864156245372,14.330629941621876,2.5975009466111154,4519034765.0,2012-06-20,2012,2,172,6,1.36,135.19,135.78,132.33,3136
2012-06-21 13:30:00,135.64,135.78,132.33,132.44,124.18433210526315,140.66998199999998,129.66717005000046,136.16206979999995,134.83502060000006,132.30225100000018,134.13658205794667,133.1917075647203,132.94038538461558,136.35933856538358,129.52143220384758,129.66717005000046,136.16206979999995,134.83502060000006,132.30225100000018,133.51666666666668,205272320,177577811.2,46.86615002362878,1.5,2.75,2.0001857328615658,1.1559570343437142,0.4976579061576816,0.016785967072564745,-0.4808719390851168,20.446314195727545,-0.4958752444872091,4313762445.0,2012-06-21,2012,3,173,6,2.61,134.06,133.71001,132.62,3137
2012-06-22 13:30:00,133.13,133.71001,132.62,133.46001,123.95735842105265,140.64248149999997,129.73302015000047,136.18346979999995,134.72842100000003,132.34875150000022,134.11004982038014,133.2172601776041,133.27807769230787,135.867866377611,130.68828900700476,129.73302015000047,136.18346979999995,134.72842100000003,132.34875150000022,133.26334,130029184,175711388.8,50.273063577600574,1.5,2.75,1.9480303233714549,0.7400156864504845,0.4038184102382253,0.02390107371266481,-0.3799173365255605,20.41302366333457,1.5561542865087328,4443791629.0,2012-06-22,2012,4,174,6,0.82,133.17,132.10001,130.85001,3138
2012-06-25 13:30:00,132.05,132.10001,130.85001,131.32001,123.73038473684211,140.61498099999997,129.79442025000046,136.17196989999997,134.61202120000004,132.30975150000015,134.0006364940907,133.03656968449894,133.22807846153864,135.9392082572983,130.51694866577895,129.79442025000046,136.17196989999997,134.61202120000004,132.30975150000015,131.42334333333335,146375680,176256894.4,43.911522302638495,1.5,2.75,1.9953138717020664,0.8304678265113016,0.19072663709353774,-0.1415090401586383,-0.3322356772521761,21.285310746993648,-1.2037240445380617,4297415949.0,2012-06-25,2012,0,177,6,0.96,131.48,132.38,130.92999,3139
2012-06-26 13:30:00,131.7,132.38,130.92999,131.98,123.50341105263159,140.58748049999997,129.87472025000045,136.16496999999995,134.51062120000003,132.22375150000022,133.92139584726365,132.93594400026095,133.22269384615404,135.94342251338412,130.50196517892394,129.87472025000045,136.16496999999995,134.51062120000003,132.22375150000022,131.76333,141633936,175694419.2,46.173715368356504,1.5,2.75,1.9563635951519183,0.8061379333783643,0.09231458567718752,-0.2168424451556916,-0.30915703083287915,20.324590153107053,-0.06815324690291656,4439049885.0,2012-06-26,2012,1,178,6,1.11,131.65,133.42999,131.96671,3140
2012-06-27 13:30:00,132.42,133.42999,131.96671,133.173,123.27643736842106,140.55997999999997,129.95723525000048,136.15130009999996,134.39244120000004,132.29440200000022,133.8920469905082,132.95852076214086,133.22830846153863,135.94830240404943,130.50831451902786,129.95723525000048,136.15130009999996,134.39244120000004,132.29440200000022,132.85656666666668,108087936,172980297.6,50.09215033978029,1.5,2.75,1.921143338355352,0.624856920121289,0.10474553385553298,-0.17822511351346293,-0.2829706473689959,20.662450307673982,-0.2225219150370848,4547137821.0,2012-06-27,2012,2,179,6,1.11,132.7,132.99001,131.28,3141
2012-06-28 13:30:00,132.28999,132.99001,131.28,132.78999,123.04946368421055,140.53247949999997,130.03248515000047,136.13469999999995,134.27604100000005,132.36040150000022,133.8488290693118,132.94247021336557,133.33407769230786,135.86409802923666,130.80405735537906,130.03248515000047,136.13469999999995,134.27604100000005,132.36040150000022,132.35333333333332,169242688,171633122.4,48.86231592909576,1.5,2.75,1.9191330999013985,0.986072417919258,0.0851830633366813,-0.1764918181981443,-0.2616748815348256,19.7725434927232,-1.0064186670642594,4377895133.0,2012-06-28,2012,3,180,6,1.3,132.14,136.27,134.85001,3142
2012-06-29 13:30:00,135.2,136.27,134.85001,136.105,122.82249000000002,140.50497899999996,130.11616015000047,136.14785009999997,134.24374100000003,132.7576515000002,133.93730636071132,133.24366352637836,133.57907769230786,136.48950903978124,130.66864634483449,130.11616015000047,136.14785009999997,134.24374100000003,132.7576515000002,135.74167,212251056,169583424.8,58.385480020205975,1.5,2.75,2.0306243070513,1.2516026035582222,0.2823980825428484,0.0913227216437349,-0.19107536089911348,24.43270788405528,1.2686087253429017,4590146189.0,2012-06-29,2012,4,181,6,1.05,135.56,136.64999,135.52,3143
2012-07-02 13:30:00,136.48,136.64999,135.52,136.50999,122.5955163157895,140.47747849999996,130.19156015000047,136.16104999999996,134.21494080000002,133.1781505000002,134.03819591519323,133.55474223815185,133.92061461538478,137.074417159802,130.7668120709676,130.19156015000047,136.16104999999996,134.21494080000002,133.1781505000002,136.22666,129524432,165932233.6,59.380694857184594,1.5,2.75,1.9662932851190635,0.7805863224395241,0.41879237502560657,0.33241510788289474,-0.08637726714271182,24.44735480760996,0.5968975681650694,4719670621.0,2012-07-02,2012,0,184,7,0.83,136.08,137.50999,136.34,3144
2012-07-03 13:30:00,136.48,137.50999,136.34,137.412,122.36854263157896,140.44997799999996,130.27101515000047,136.18156999999997,134.22738100000004,133.59525000000022,134.17050195773467,133.9221001202326,134.22384538461554,137.86622042422596,130.58147034500521,130.27101515000047,136.18156999999997,134.22738100000004,133.59525000000022,137.08732999999998,80450192,161747274.4,61.58429358118524,1.5,2.75,1.9094144790391292,0.4973820566586314,0.5406795428335639,0.5894721613992431,0.04879261856567918,24.141298856105145,1.42604074402127,4800120813.0,2012-07-03,2012,1,185,7,0.86,136.92,137.8,136.28999,3145
2012-07-05 13:30:00,136.89999,137.8,136.28999,136.78999,122.14156894736843,140.42247749999996,130.35341510000046,136.20585999999994,134.21698080000002,133.83624950000018,134.273226979,134.19523248973428,134.42769076923094,138.31674015585142,130.53864138261042,130.35341510000046,136.20585999999994,134.21698080000002,133.83624950000018,136.95999333333333,126177440,158846008.8,59.1992995924053,1.5,2.75,1.8808855876791928,0.7943381200019172,0.5485926851418456,0.7345334749929862,0.18594078985114054,24.325121502100984,3.2844986408939825,4673943373.0,2012-07-05,2012,3,187,7,1.11,137.04,135.77,134.85001,3146
2012-07-06 13:30:00,135.47,135.77,134.85001,135.49001,121.9145952631579,140.39497699999995,130.4300151500005,136.20716009999995,134.14298100000005,134.00825000000015,134.32094396021571,134.31854463356908,134.51153846153863,138.44137113879674,130.5817057842805,130.4300151500005,136.20716009999995,134.14298100000005,134.00825000000015,135.37000666666665,151192000,157166974.4,54.452919825081366,1.5,2.75,1.885106617130679,0.9619832701952172,0.44013748107827616,0.7361126411989858,0.2959751601207096,20.529608569299157,1.5210548837812925,4522751373.0,2012-07-06,2012,4,188,7,0.68,135.31,135.57001,134.7,3147
2012-07-09 13:30:00,135.38,135.57001,134.7,135.32001,121.68762157894741,140.36747649999995,130.52346520000046,136.20846019999993,134.04618120000004,134.11925000000016,134.36012302059942,134.4139222875149,134.48230846153862,138.38188355176356,130.5827333713137,130.52346520000046,136.20846019999993,134.04618120000004,134.11925000000016,135.19667333333334,103780432,155160214.4,53.84494196736118,1.5,2.75,1.81259971590706,0.6688598130733183,0.3355397743597069,0.7153998780703432,0.3798601037106363,20.309721202463475,3.0459942852578217,4418970941.0,2012-07-09,2012,0,191,7,0.65,135.14,136.23,133.67999,3148
2012-07-10 13:30:00,136.00999,136.23,133.67999,134.14,121.46064789473684,140.33997599999995,130.62986520000047,136.20426019999994,133.92118120000004,134.25550050000015,134.35149074528178,134.38783445060872,134.3792315384617,138.23850180523212,130.5199612716913,130.62986520000047,136.20426019999994,133.92118120000004,134.25550050000015,134.68332999999998,167884816,155066652.0,49.69712745102978,1.5,2.75,1.8652718790565543,1.0826622864082989,0.17362181521961378,0.5968873727351536,0.4232655575155398,18.32006332762331,1.6366116078193642,4251086125.0,2012-07-10,2012,1,192,7,1.91,134.95,134.60001,133.38,3149
2012-07-11 13:30:00,134.21001,134.60001,133.38,134.16,121.23367421052632,140.31247549999995,130.73296525000046,136.18537019999994,133.80698120000002,134.31750050000014,134.34398130429028,134.36613593150312,134.51153923076942,138.21040670820577,130.81267175333306,130.73296525000046,136.18537019999994,133.80698120000002,134.31750050000014,134.04666999999998,141734000,153056764.8,49.76775692583053,1.5,2.75,1.819181744838229,0.9260224478493616,0.060450754835240476,0.4988290010595904,0.4383782462243499,18.252131069271254,0.7411412223198357,4392820125.0,2012-07-11,2012,2,193,7,0.91,133.99,134.2269,132.60001,3150
2012-07-12 13:30:00,133.38,134.2269,132.60001,133.50999,121.0067005263158,140.28497499999997,130.81931515000045,136.15637009999992,133.66238080000002,134.38949950000014,134.3112757629456,134.28459822374091,134.51538384615404,138.20997290357414,130.82079478873393,130.81931515000045,136.15637009999992,133.66238080000002,134.38949950000014,133.44563333333335,143583120,151624727.2,47.43654904033533,1.5,2.75,1.8054466202069277,0.9469637482717924,-0.0591303322344206,0.36446533093132416,0.4235956631657448,17.93759487959787,0.5422095445597962,4249237005.0,2012-07-12,2012,3,194,7,1.23,133.41,135.89,133.84,3151
2012-07-13 13:30:00,133.86,135.89,133.84,135.75,120.77972684210528,140.25747449999997,130.91036520000043,136.14917009999994,133.57088080000003,134.50349950000015,134.36769632126143,134.42416029767034,134.8561523076925,138.098503028489,131.613801586896,130.91036520000043,136.14917009999994,133.57088080000003,134.50349950000015,135.16,129644128,146576120.8,55.22090750297263,1.5,2.75,1.8464868616207184,0.8844832793528261,0.008108633109347674,0.4337314545524293,0.4256228214430817,20.056690376966127,-0.2608280371771719,4378881133.0,2012-07-13,2012,4,195,7,1.53,134.86,135.83,134.89999,3152
2012-07-16 13:30:00,135.44,135.83,134.89999,135.42999,120.55275315789477,140.22997399999997,131.01179015000042,136.14314999999996,133.49448060000003,134.56799900000016,134.40935489689826,134.51995360265408,135.12153615384634,137.9120800833895,132.3309922243032,131.01179015000042,136.14314999999996,133.49448060000003,134.56799900000016,135.38666,97525184,142980158.4,53.99076142967302,1.5,2.75,1.7810242286478104,0.6820889352155033,0.025525033387955587,0.4575291131780261,0.43200407979007055,14.114511617586587,-0.7911508893964347,4281355949.0,2012-07-16,2012,0,198,7,0.69,135.36,136.64,134.55,3153
2012-07-17 13:30:00,135.97,136.64,134.55,136.36,120.32577947368422,140.20247349999997,131.11334015000043,136.14043999999996,133.48168059999998,134.66599950000014,134.4858507832944,134.69519611668704,135.3666900000002,137.9840218399627,132.7493581600377,131.11334015000043,136.14043999999996,133.48168059999998,134.66599950000014,135.85,138860192,143354896.0,56.98948568727753,1.5,2.75,1.803093926601536,0.968646316760608,0.09051579803648767,0.5451488273356802,0.4546330292991925,14.627038753154736,-0.7655808808546506,4420216141.0,2012-07-17,2012,1,199,7,1.55,135.6,137.64,135.96001,3154
2012-07-18 13:30:00,136.03999,137.64,135.96001,137.37,120.0988057894737,140.17497299999997,131.23444020000042,136.14484009999995,133.48708040000002,134.74949950000018,134.5989546741456,134.94993934366923,135.71899846153866,138.0739719979357,133.3640249251416,131.23444020000042,136.14484009999995,133.48708040000002,134.74949950000018,136.99000333333333,113349632,142153249.6,60.035841311304026,1.5,2.75,1.7943007889871392,0.7973762985999302,0.18681680044402016,0.6881540298542177,0.5013372294101975,14.76606041846369,0.4240149443683823,4533565773.0,2012-07-18,2012,2,200,7,1.24,136.8,138.17999,137.21001,3155
2012-07-19 13:30:00,137.64999,138.17999,137.21001,137.73,119.87183210526315,140.14747249999996,131.3734402500004,136.15054009999997,133.5106804,134.86199950000022,134.72174076535558,135.21470702522453,135.84399846153866,138.4289359647679,133.2590609583094,131.3734402500004,136.15054009999997,133.5106804,134.86199950000022,137.70666666666668,129847184,138322277.6,61.09361475091949,1.5,2.75,1.735420732630914,0.9387293663244308,0.2557869208638859,0.8210708804900548,0.565283959626169,14.536690848666279,1.6532510404272442,4663412957.0,2012-07-19,2012,3,201,7,0.71,137.7,137.16,136.32001,3156
2012-07-20 13:30:00,136.95,137.16,136.32001,136.47,119.64485842105265,140.11997199999996,131.49409025000043,136.13964999999996,133.52528020000003,135.06349950000018,134.79029995102792,135.33425873710792,135.8409223076925,138.42277562785358,133.25906898753146,131.49409025000043,136.13964999999996,133.52528020000003,135.06349950000018,136.65000333333333,142904432,135203883.2,55.55155816525375,1.5,2.75,1.7121756803001342,1.0569550860355763,0.20004344074328828,0.8153382605552792,0.615294819811991,14.445743299267619,0.8498299697140154,4520508525.0,2012-07-20,2012,4,202,7,0.62,136.74,136.38519,133.84,3157
2012-07-23 13:30:00,134.47,136.38519,133.84,135.09,119.41788473684211,140.09247149999996,131.59744025000043,136.12034999999997,133.5066802,135.14499900000018,134.80205289412487,135.3109960002405,135.66230692307713,138.10205757969572,133.22255626645853,131.59744025000043,136.12034999999997,133.5066802,135.14499900000018,135.10506333333333,145210816,135962964.8,50.1822482401083,1.5,2.75,1.7777345602786956,1.0680174282283672,0.0609399981233325,0.6914698174661567,0.6305298193428241,15.735255743266904,0.7082152974504378,4375297709.0,2012-07-23,2012,0,205,7,1.9,135.11,135.25,133.03,3158
2012-07-24 13:30:00,135.19,135.25,133.03,133.925,119.19091105263159,140.06497099999996,131.68461520000042,136.08229999999998,133.47298020000002,135.2752485000002,134.7676586629827,135.17899638116998,135.44192307692327,137.95100898609223,132.93283716775431,131.68461520000042,136.08229999999998,133.47298020000002,135.2752485000002,134.06833333333333,173301120,137309236.8,46.128789057201004,1.5,2.75,1.8093249488302172,1.2621228115368854,-0.10953791858253104,0.4936074211146604,0.6031453396971914,15.715997314596105,-0.1751639833035072,4201996589.0,2012-07-24,2012,1,206,7,1.67,134.14,134.56,133.25,3159
2012-07-25 13:30:00,134.21001,134.56,133.25,133.96001,118.96393736842107,140.03747049999996,131.77586520000042,136.04878009999996,133.4699804,135.37424900000022,134.73598616639515,135.06290244010617,135.32423076923098,137.95388995207662,132.69457158638534,131.77586520000042,136.04878009999996,133.4699804,135.37424900000022,133.92333666666667,129122256,136683652.8,46.269248026479175,1.5,2.75,1.7736588810566307,0.9446795820487466,-0.21391251989421006,0.3357546898294288,0.5496672097236389,15.716936239073215,0.3370684096373788,4331118845.0,2012-07-25,2012,2,207,7,0.98,133.9,136.46001,135.25999,3160
2012-07-26 13:30:00,135.89,136.46001,135.25999,136.17,118.73696368421055,140.00996999999995,131.8588152000004,136.04298009999994,133.5265804,135.5240990000002,134.79222200300708,135.1683403029532,135.38961461538486,138.0575917384389,132.72163749233076,131.8588152000004,136.04298009999994,133.5265804,135.5240990000002,135.96333333333334,156526432,139105577.6,54.35892982643812,1.5,2.75,1.8255403895525857,1.1252347655684514,-0.13209366232621433,0.3845501318158711,0.5166437941420854,17.944735102426915,0.3093922651933609,4487645277.0,2012-07-26,2012,3,208,7,0.89,135.86,139.07001,136.1364,3161
2012-07-27 13:30:00,136.89,139.07001,136.1364,138.675,118.50999000000002,139.98246949999995,131.9536902000004,136.08223009999998,133.6435006,135.8183495000002,134.94448780681074,135.50230789314813,135.73846076923098,138.81612393870506,132.6607975997569,131.9536902000004,136.08223009999998,133.6435006,135.8183495000002,137.96047000000002,236768880,142481887.2,61.444805445359705,1.5,2.75,1.9046882188702567,1.6617472203161556,0.08126648556696969,0.6182269011007975,0.5369604155338278,18.435571646459078,2.3960793322070004,4724414157.0,2012-07-27,2012,4,209,7,2.15,137.6,139.339,138.27,3162
2012-07-30 13:30:00,138.52,139.339,138.27,138.67999,118.28301631578951,139.95496899999995,132.0433401500004,136.11212999999995,133.79990039999998,135.9470990000002,135.0909780888966,135.80494428427687,136.08615230769254,139.38526771076027,132.7870369046248,132.0433401500004,136.11212999999995,133.79990039999998,135.9470990000002,138.76299666666668,106781936,137208431.2,61.457642148084936,1.5,2.75,1.8449962032366665,0.7782461694671721,0.2061594538642784,0.7946597328641758,0.5885002789998974,18.27290892726158,1.7013713699031898,4831196093.0,2012-07-30,2012,0,212,7,0.77,138.8,138.87,137.71001,3163
2012-07-31 13:30:00,138.49001,138.87,137.71001,137.71001,118.05604263157896,139.92746849999997,132.1293402500004,136.11883019999996,133.9593004,136.0071000000002,135.19368522266538,135.98637911434574,136.409230769231,139.4483041861339,133.37015735232808,132.1293402500004,136.11883019999996,133.9593004,136.0071000000002,138.09667333333334,120575808,136761000.0,57.45328877185955,1.5,2.75,1.7960671887197612,0.8816534538355233,0.20636562532156774,0.8464573106518571,0.6400916853302894,18.755536246007182,0.24751401324889466,4710620285.0,2012-07-31,2012,1,213,7,0.84,138.29,138.73,137.39999,3164
2012-08-01 13:30:00,138.7,138.73,137.39999,137.59,117.82906894736843,139.89996799999994,132.20444020000042,136.11903009999997,134.0717004,136.01600000000022,135.2876583511883,136.13910491297952,136.55076923076945,139.62503429657852,133.47650416496037,132.20444020000042,136.11903009999997,134.0717004,136.01600000000022,137.90666333333334,138293744,139653177.6,56.95879973176408,1.5,2.75,1.7627773895254917,0.9902656450546816,0.18218247096723486,0.867819774039333,0.6856373030720981,18.319919361450488,-0.10164815218179507,4572326541.0,2012-08-01,2012,2,214,8,0.97,138.06,137.57001,135.58,3165
2012-08-02 13:30:00,136.55,137.57001,135.58,136.64,117.6020952631579,139.87246749999994,132.2864902000004,136.10963009999998,134.1605004,136.0085005000002,135.34069135702404,136.18680920698142,136.64384692307718,139.64924128429624,133.63845256185806,132.2864902000004,136.10963009999998,134.1605004,136.0085005000002,136.59667,199556560,143322133.6,53.065274073901726,1.5,2.75,1.7804361474165271,1.3923638658418631,0.09059702711088047,0.7988835869606987,0.7082865598498183,18.666279825399087,0.1245695024547428,4372769981.0,2012-08-02,2012,3,215,8,1.47,136.58,139.64,136.6794,3166
2012-08-03 13:30:00,138.56,139.64,136.6794,139.349,117.37512157894741,139.84496699999994,132.3703352000004,136.10250009999996,134.3020804,136.20145000000022,135.49787993125838,136.48797023488797,136.8737700000002,140.19759211098977,133.54994788901064,132.3703352000004,136.10250009999996,134.3020804,136.20145000000022,138.55613333333332,157825008,143653784.0,61.20838197940106,1.5,2.75,1.8675478511724892,1.0986484560685157,0.19486853725687114,0.9518722314209072,0.7570036941640359,21.08722823616109,3.1527130061440416,4530594989.0,2012-08-03,2012,4,216,8,2.17,138.16,140.17,139.56,3167
2012-08-06 13:30:00,139.72,140.17,139.56,139.62,117.14814789473688,139.81746649999994,132.46278520000038,136.09960009999998,134.4438804,136.41644950000023,135.65953169866,136.7862587839463,137.04684692307714,140.67627538226222,133.41741846389206,132.46278520000038,136.09960009999998,134.4438804,136.41644950000023,139.78333333333333,86327744,142781149.6,61.92014618757433,1.5,2.75,1.7927944332315973,0.6046158350863986,0.2604016977277109,1.0825058163236747,0.8221041185959638,19.60982056941313,4.252380063468354,4616922733.0,2012-08-06,2012,0,219,8,0.44,139.86,140.92,140.03,3168
2012-08-07 13:30:00,140.17999,140.92,140.03,140.32001,116.92117421052632,139.78996599999994,132.55608525000036,136.09560019999998,134.6082804,136.72545000000022,135.84229555361452,137.12280651880852,137.2460784615387,141.26688309898853,133.22527382408882,132.55608525000036,136.09560019999998,134.6082804,136.72545000000022,140.42333666666664,109545056,139864161.6,63.76938740389923,1.5,2.75,1.7575948308579104,0.7832246284311907,0.3250039623598773,1.2283590715458104,0.9033551091859332,18.0716224707527,4.747685521970313,4726467789.0,2012-08-07,2012,1,220,8,0.64,140.48,140.64999,139.81,3169
2012-08-08 13:30:00,139.85001,140.64999,139.81,140.49001,116.6942005263158,139.76246549999993,132.6386853000004,136.09750029999998,134.74408060000002,137.04195050000024,136.02455886523748,137.4434925646363,137.55531000000022,141.8954626896796,133.21515731032085,132.6386853000004,136.09750029999998,134.74408060000002,137.04195050000024,140.3166666666667,89754624,137265192.8,64.22377055580972,1.5,2.75,1.6920516286537743,0.6538775210899641,0.351071452280841,1.3421944245369843,0.9911229722561432,17.995220179887102,3.1725123008004883,4816222413.0,2012-08-08,2012,2,221,8,0.6,140.23,140.89,140.14999,3170
2012-08-09 13:30:00,140.28999,140.89,140.14999,140.61,116.46722684210528,139.73496499999993,132.7142852500004,136.0951002,134.92108080000003,137.39695100000023,136.20438008620854,137.74506470133758,137.9799253846156,142.35219844697806,133.60765232225313,132.7142852500004,136.0951002,134.92108080000003,137.39695100000023,140.54999666666666,90291632,134600618.4,64.56160305516805,1.5,2.75,1.6240486551785032,0.6708114202839353,0.3476279068375956,1.425657855803138,1.0780299489655425,16.476484967456724,1.395348837209304,4906514045.0,2012-08-09,2012,3,222,8,0.53,140.52,140.89,139.81,3171
2012-08-10 13:30:00,140.03999,140.89,139.81,140.84,116.24025315789477,139.70746449999996,132.8032402500004,136.09910019999998,135.10848080000002,137.65145100000024,136.3861691024357,138.03982044406737,138.5118484615387,142.44157215440026,134.5821247686771,132.8032402500004,136.09910019999998,135.10848080000002,137.65145100000024,140.51333333333332,99792624,133108043.2,65.23918874999733,1.5,2.75,1.5851880369514662,0.7497114494430491,0.3320961993731724,1.4931501981820077,1.1610539988088353,13.415647862292884,1.5575498671437744,5006306669.0,2012-08-10,2012,4,223,8,0.77,140.35,140.84,140.03999,3172
2012-08-13 13:30:00,140.60001,140.84,140.03999,140.77,116.01327947368424,139.67996399999996,132.88559025000038,136.10470009999997,135.36068080000004,137.91845150000023,136.5580840395951,138.29983754463237,139.03569384615406,142.12420855725608,135.94717913505204,132.88559025000038,136.10470009999997,135.36068080000004,137.91845150000023,140.54999666666666,79426880,132203128.0,64.83289470186782,1.5,2.75,1.5291038914549342,0.6007942565473943,0.2898998503508581,1.5234288117474082,1.23352896139655,13.441051557164645,2.2220534295219343,4926879789.0,2012-08-13,2012,0,226,8,0.57,140.44,141.38,140.37,3173
2012-08-14 13:30:00,141.28999,141.38,140.37,140.78999,115.7863057894737,139.65246349999995,132.9463902000004,136.12059999999997,135.61448040000002,138.13995100000022,136.72404113608155,138.53699492133404,139.39107769230787,142.12125007922126,136.66090530539452,132.9463902000004,136.12059999999997,135.61448040000002,138.13995100000022,140.84666333333334,102379376,130379087.2,64.90012065516335,1.5,2.75,1.4920250420652952,0.7852438469902097,0.2382848340892294,1.5313850040080863,1.2931001699188571,12.369160260159967,2.325743149938212,5029259165.0,2012-08-14,2012,1,227,8,0.72,140.88,141.19,140.55,3174
2012-08-15 13:30:00,140.64,141.19,140.55,140.95,115.5593321052632,139.62496299999995,133.0081401500004,136.13360009999997,135.85208020000002,138.31895100000023,136.88976501309796,138.76680492882605,139.56607769230789,142.38056387863853,136.75159150597722,133.0081401500004,136.13360009999997,135.85208020000002,138.31895100000023,140.89666666666668,71085808,128265896.0,65.46913964621623,1.5,2.75,1.4311661104892015,0.5542066146717597,0.1918647740649031,1.5329311374999857,1.341066363435083,12.239305587245655,3.1542740046838427,5100344973.0,2012-08-15,2012,2,228,8,0.46,140.87,142.16,140.8,3175
2012-08-16 13:30:00,141.14999,142.16,140.8,141.99001,115.33235842105265,139.59746249999995,133.0905902000004,136.13740019999997,136.05248040000004,138.53195150000022,137.08977462042745,139.07377684036643,139.82069461538478,142.85849948725254,136.78288974351707,133.0905902000004,136.13740019999997,136.05248040000004,138.53195150000022,141.65000333333333,112014192,127374246.4,68.98817431311852,1.5,2.75,1.426082816882829,0.8794100468962617,0.2068564737482628,1.5996369556204115,1.3927804818721488,10.927545041762375,1.8952486203704533,5212359165.0,2012-08-16,2012,3,229,8,0.97,141.48,142.3,141.86,3176
2012-08-17 13:30:00,142.23,142.3,141.86,142.17999,115.10538473684211,139.56996199999998,133.19148015000042,136.14750009999997,136.25508019999998,138.81745100000023,137.28939090982246,139.36960666509344,140.16453923076944,143.1807083007514,137.1483701607875,133.19148015000042,136.14750009999997,136.25508019999998,138.81745100000023,142.11333000000005,90813680,124769708.8,69.59768022201507,1.5,2.75,1.3556483299626267,0.7278503802999979,0.20483558848153693,1.6488249674740703,1.443989378992533,4.297213065794323,1.83354103996562,5303172845.0,2012-08-17,2012,4,230,8,0.31,142.08,142.22,141.59,3177
2012-08-20 13:30:00,141.98,142.22,141.59,142.19,114.87841105263159,139.54246149999994,133.28248010000038,136.16470009999998,136.43688,139.17245100000022,137.48157165845686,139.63821555413216,140.51838538461558,143.31468476937934,137.72208599985183,133.28248010000038,136.16470009999998,136.43688,139.17245100000022,142.0,78255680,121421952.0,69.63154779857626,1.5,2.75,1.3038163063938677,0.6444936744222329,0.18030535600428865,1.669371073997894,1.489065717993605,4.439733826119398,1.3326609654603083,5381428525.0,2012-08-20,2012,0,233,8,0.44,141.9,143.09,141.45,3178
2012-08-21 13:30:00,142.53999,143.09,141.45,141.75999,114.65143736842107,139.51496099999994,133.36003005000038,136.17999999999998,136.64378,139.56420050000023,137.64935276988993,139.84028931088147,140.91223076923097,142.6571943093891,139.16726722907288,133.36003005000038,136.17999999999998,136.64378,139.56420050000023,142.09999666666667,105581008,118035946.4,66.2189220253063,1.5,2.75,1.3278294273657352,0.8944818186335142,0.11446061528334228,1.6321414870977833,1.5176808718144408,4.718971898504346,0.9039646306523684,5275847517.0,2012-08-21,2012,1,234,8,1.16,142.27,142.05,141.07001,3179
2012-08-22 13:30:00,141.39999,142.05,141.07001,141.82001,114.42446368421056,139.48746049999994,133.44172510000038,136.1901001,136.82178019999998,139.95720050000023,137.81290795538445,140.02883413841658,141.10230846153866,142.65215773699072,139.5524591860866,133.44172510000038,136.1901001,136.82178019999998,139.95720050000023,141.64667333333333,133243440,118242005.6,66.46596389420662,1.5,2.75,1.3029837539824694,1.1268706017280208,0.057184122207462725,1.5891610245737695,1.5319769023663068,4.728984858961637,0.8605433468458734,5409090957.0,2012-08-22,2012,2,235,8,0.69,141.56,141.48,140.44,3180
2012-08-23 13:30:00,141.47,141.48,140.44,140.66499,114.19749000000002,139.45995999999994,133.5137501000004,136.17834999999997,136.99367980000002,140.18195000000023,137.92475431007526,140.08942041094835,141.18269230769252,142.50894965252158,139.85643496286343,133.5137501000004,136.17834999999997,136.99367980000002,140.18195000000023,140.86166333333333,111466368,115989002.4,57.71835772311334,1.5,2.75,1.308485628698007,0.9610080757104604,-0.06939077925372628,1.4452384282991488,1.5146292075528751,7.052726381838014,-0.12426157341665332,5297624589.0,2012-08-23,2012,3,236,8,0.74,140.96,141.83,140.22,3181
2012-08-24 13:30:00,140.31,141.83,140.22,141.50999,113.97051631578951,139.43245949999994,133.5819000500004,136.18084999999996,137.15447959999997,140.32369950000023,138.06535178811149,140.2247127527628,141.27422923076944,142.51092348163897,140.0375349798999,133.5819000500004,136.18084999999996,137.15447959999997,140.32369950000023,141.1866633333333,99481184,109124617.6,61.69069467089263,1.5,2.75,1.3300223695052933,0.9116291647834376,-0.1049705554570235,1.3834160132315958,1.4883865686886193,7.812952266761013,0.5256730837536246,5397105773.0,2012-08-24,2012,4,237,8,1.15,141.02,142.08,141.34,3182
2012-08-27 13:30:00,141.89,142.08,141.34,141.53999,113.74354263157898,139.40495899999993,133.67379500000038,136.19764989999996,137.30247939999998,140.4666995000002,138.20161211014636,140.34997725249968,141.35499692307715,142.51077381143705,140.19922003471729,133.67379500000038,136.19764989999996,137.30247939999998,140.4666995000002,141.65333,68785872,107224814.4,61.82781142441054,1.5,2.75,1.2878779145406298,0.6415107583529657,-0.13342334623799368,1.3216073858911273,1.455030732129121,7.791302208569985,0.5327083267780615,5465891645.0,2012-08-27,2012,0,240,8,0.52,141.71,141.84,140.97,3183
2012-08-28 13:30:00,141.17999,141.84,140.97,141.39999,113.51656894736843,139.37745849999993,133.7591949000004,136.21374989999995,137.44247939999997,140.65119850000022,138.3270386940622,140.44997846654732,141.41576538461558,142.4885637649383,140.34296700429292,133.7591949000004,136.21374989999995,137.44247939999997,140.65119850000022,141.40333,75689568,104980502.4,60.7353175367138,1.5,2.75,1.2580294920734425,0.7209869096606647,-0.16646244237432795,1.2469526791612109,1.413415121535539,7.8395384001873865,0.3192550549840468,5390202077.0,2012-08-28,2012,1,241,8,0.62,141.4,141.89,141.12,3184
2012-08-29 13:30:00,141.52,141.89,141.12,141.50999,113.28959526315792,139.34995799999993,133.8334448500004,136.24664979999997,137.55867919999997,140.8471980000002,138.4518603139029,140.55093194592376,141.46730307692332,142.4875980489293,140.4470081049173,133.8334448500004,136.24664979999997,137.55867919999997,140.8471980000002,141.50666333333334,65421296,101336880.0,61.313734843797256,1.5,2.75,1.2231702426396238,0.6455822993563647,-0.1843103643094106,1.1830271661487757,1.3673375304581863,7.830487586330509,-0.3380660371810837,5455623373.0,2012-08-29,2012,2,242,8,0.55,141.5,140.94,140.19,3185
2012-08-30 13:30:00,140.89999,140.94,140.19,140.49001,113.06262157894741,139.32245749999993,133.9085948500004,136.29254999999998,137.6588794,141.03969850000018,138.53178775257336,140.5451298558358,141.44576538461558,142.53361376006393,140.3579170091673,133.9085948500004,136.29254999999998,137.6588794,141.03969850000018,140.54000333333332,96589808,96188542.4,53.45092032007014,1.5,2.75,1.2300859395939356,1.0041716569353063,-0.2633937381552525,1.0380953577641208,1.3014890959193732,7.559609438524803,-1.1886201426797058,5359033565.0,2012-08-30,2012,3,243,8,0.53,140.56,141.82001,140.36,3186
2012-08-31 13:30:00,141.28999,141.82001,140.36,141.16,112.83564789473688,139.29495699999993,133.9839799000004,136.33414999999997,137.83327939999998,141.13024850000016,138.63485489953126,140.60368891718477,141.47422769230792,142.510075163602,140.43838022101386,133.9839799000004,136.33414999999997,137.83327939999998,141.13024850000016,141.11333666666667,151970368,95895810.4,57.32243769571801,1.5,2.75,1.2465090867657962,1.5847446031907144,-0.2682623608645778,0.9661611448386508,1.234423505703229,8.184235869471728,-0.7243828679935306,5511003933.0,2012-08-31,2012,4,244,8,1.04,141.09,141.46001,140.13,3187
2012-09-04 13:30:00,141.03999,141.46001,140.13,141.03,140.13,139.26745649999992,134.0687299000004,136.3565501,137.9846792,141.2007485000002,138.72878215837318,140.64428997269098,141.48038153846176,142.50458347301515,140.45617960390834,134.0687299000004,136.3565501,137.9846792,141.2007485000002,140.87333666666666,120226192,97590732.8,56.34323720024909,1.5,2.75,1.2524734377110975,1.2319427116751809,-0.27680146278591633,0.8884216772208333,1.1652231400067496,8.169002539235702,-0.5149478354223831,5390777741.0,2012-09-04,2012,1,248,9,0.95,140.8,141.47,140.63,3188
2012-09-05 13:30:00,141.09,141.47,140.63,140.91,140.33304703125,139.23995599999992,134.1627549000004,136.3942501,138.17647899999997,141.2302480000002,138.81432011294675,140.66959568957756,141.3973038461541,142.4178776517241,140.37673004058405,134.1627549000004,136.3942501,138.17647899999997,141.2302480000002,141.00333333333333,100660256,97146492.8,55.40243483130791,1.5,2.75,1.2230110493031623,1.0361697380803438,-0.28592445297241875,0.8078175737912261,1.0937420267636448,8.048467317735026,-0.6416654462229976,5290117485.0,2012-09-05,2012,2,249,9,0.6,141.05,143.78,141.75,3189
2012-09-06 13:30:00,141.75999,143.78,141.75,143.77,140.53609406249998,139.21245549999992,134.27170990000042,136.46145009999998,138.412279,141.3942475000002,139.00866050067435,140.96487229057018,141.51961230769254,143.1087797866086,139.93044482877644,134.27170990000042,136.46145009999998,138.412279,141.3942475000002,143.1,158272432,100572383.2,68.78176610663674,1.5,2.75,1.3406531172100795,1.5737166303920298,-0.1041068529495608,0.963608460576694,1.0677153135262547,14.373334272484,2.207379391275698,5448389917.0,2012-09-06,2012,3,250,9,1.43,142.76,144.39,143.88,3190
2012-09-07 13:30:00,144.00999,144.39,143.88,144.33,140.73914109375,139.18495499999997,134.39505490000042,136.5139301,138.63541899999998,141.58024750000018,139.21734048104003,141.28536064384917,141.6842276923079,143.85425467173587,139.51420071287993,134.39505490000042,136.5139301,138.63541899999998,141.58024750000018,144.20000000000005,107272000,101421401.6,70.63913746927254,1.5,2.75,1.2891778945522152,1.057686033792694,0.04131408464594033,1.1193579193336802,1.0780438346877401,13.052175943915453,1.9927992362942184,5555661917.0,2012-09-07,2012,4,251,9,0.35,144.14,144.44,143.46001,3191
2012-09-10 13:30:00,144.19,144.44,143.46001,143.50999,140.942188125,139.15745449999994,134.5166548500004,136.56293,138.849819,141.71374700000018,139.38567967786202,141.49723010633974,141.81884307692332,144.1980088454572,139.43967730838938,134.5166548500004,136.56293,138.849819,141.71374700000018,143.8033333333333,86458432,100754692.0,64.58008348169363,1.5,2.75,1.2670930449413418,0.8581082457182242,0.06813591610610414,1.1632137298203702,1.095077813714266,13.640908761605324,1.391832795805623,5469203485.0,2012-09-10,2012,0,254,9,0.68,143.95,144.37,143.56,3192
2012-09-11 13:30:00,143.60001,144.37,143.56,143.91,141.14523515624995,139.12995399999994,134.6534048500004,136.62483,139.005919,141.87074700000016,139.56310400422038,141.72701771525973,141.97961153846174,144.60688436487072,139.3523387120528,134.6534048500004,136.62483,139.005919,141.87074700000016,143.9466666666667,88760000,101221348.0,66.10730461852364,1.5,2.75,1.2380156845883898,0.8768901200564925,0.09691961143659243,1.2162273280100069,1.1193077165734142,13.638549054698775,1.7751132797109774,5557963485.0,2012-09-11,2012,1,255,9,0.56,143.96,144.55,143.89999,3193
2012-09-12 13:30:00,144.39,144.55,143.89999,144.39,141.3482821875,139.10245349999994,134.7936548500004,136.68922999999998,139.16351919999997,142.05074750000014,139.75239404327056,141.9806350757112,142.26615076923105,145.06437599717069,139.46792554129132,134.7936548500004,136.68922999999998,139.16351919999997,142.05074750000014,144.27999666666668,87640880,100484423.2,67.89612572674842,1.5,2.75,1.1960152785463627,0.8721837396186596,0.1303079516908403,1.2821926561869643,1.1518847044961242,13.556640645707155,2.0351990696911213,5645604365.0,2012-09-12,2012,2,256,9,0.45,144.22,147.03999,143.99001,3194
2012-09-13 13:30:00,144.37,147.03999,143.99001,146.59,141.55132921875,139.07495299999994,134.9280548000004,136.7872301,139.3470792,142.33274750000018,140.02053545333837,142.41962221135773,142.656920769231,146.23404840675673,139.07979313170526,134.9280548000004,136.7872301,139.3470792,142.33274750000018,145.8733333333333,225470128,108203639.2,74.53107423772529,1.5,2.75,1.3284413300787636,2.083757345566248,0.2743015057946212,1.4947615867394006,1.2204600809447794,15.414369834154924,4.341938618980802,5871074493.0,2012-09-13,2012,3,257,9,2.12,145.51,148.11,146.75999,3195
2012-09-14 13:30:00,146.88,148.11,146.75999,147.24001,141.75437625,148.11,135.06400485000043,136.88653019999998,139.55607959999998,142.5952475000002,140.30365210222706,142.87870676265703,143.0953838461541,147.35049520456332,138.84027248774484,135.06400485000043,136.88653019999998,139.55607959999998,142.5952475000002,147.37,169777008,111091780.0,76.10257046026659,1.5,2.75,1.3421240922159954,1.5282589584935986,0.3805299557581261,1.6961225256424368,1.315592569884311,13.808340411602998,4.307176253896299,6040851501.0,2012-09-14,2012,4,258,9,0.92,147.43,147.19,146.37,3196
2012-09-17 13:30:00,146.94,147.19,146.37,146.74001,141.95742328125,148.17789473684212,135.17275485000042,136.96203029999998,139.7810796,142.8232485000002,140.55605829429658,143.2464499281183,143.50615461538484,148.04859809778372,138.96371113298596,135.17275485000042,136.96203029999998,139.7810796,142.8232485000002,146.76667,119427744,112522483.2,72.40184395461371,1.5,2.75,1.3084016570577106,1.0613678315979431,0.3832610428874361,1.7946688734936058,1.41140783060617,14.565476446540876,4.048791037367944,5921423757.0,2012-09-17,2012,0,261,9,0.56,146.78,146.81,146.25,3197
2012-09-18 13:30:00,146.49001,146.81,146.25,146.62,142.1604703125,148.24578947368425,135.28100485000041,137.0266303,140.0070794,143.04474850000014,140.79385992981437,143.56774041115463,143.89923230769253,148.56539711533352,139.2330675000515,135.28100485000041,137.0266303,140.0070794,143.04474850000014,146.56,98326496,113526024.0,71.50308228380828,1.5,2.75,1.254944395839303,0.8661141519410562,0.34435536460078664,1.841852036357153,1.4974966717563665,14.553183894157893,4.0522319210843865,5823097261.0,2012-09-18,2012,1,262,9,0.38,146.53,147.17,146.41,3198
2012-09-19 13:30:00,146.78999,147.17,146.41,146.7,142.36351734375,148.3136842105263,135.3902048500004,137.0897303,140.2582794,143.29174900000015,141.02547326590005,143.8660508481875,144.37692384615406,148.81513550212094,139.93871219018718,135.3902048500004,137.0897303,140.2582794,143.29174900000015,146.76,128318256,114662886.4,71.75479024658974,1.5,2.75,1.2195912247079237,1.1190914517219062,0.2933713837422711,1.8642109014342052,1.5708395176919343,14.408493868760669,2.037977324893913,5951415517.0,2012-09-19,2012,2,263,9,0.52,146.79,146.78999,145.63,3199
2012-09-20 13:30:00,146.03,146.78999,145.63,146.71001,142.56656437499996,148.38157894736844,135.4926549000004,137.1581304,140.5092796,143.53624900000014,141.24839627508044,144.1369041007411,144.8038476923079,148.98228535172248,140.62541003289329,135.4926549000004,137.1581304,140.5092796,143.53624900000014,146.3766666666667,154009744,115701201.6,71.78836834093738,1.5,2.75,1.2153339943716428,1.3310989157436721,0.2323543703338733,1.861282480609276,1.6289281102754027,10.220975674269326,1.6490057507101767,6105425261.0,2012-09-20,2012,3,264,9,0.8,146.21,146.67,145.81,3200
2012-09-21 13:30:00,146.64,146.67,145.81,145.87,142.76961140625,148.44947368421057,135.5907049500004,137.2094303,140.75647980000002,143.79649950000015,141.429635636842,144.30196085305144,145.17615538461558,148.76398285010671,141.5883279191245,135.5907049500004,137.2094303,140.75647980000002,143.79649950000015,146.11666666666667,108737440,115564755.2,64.82399426263649,1.5,2.75,1.192810851916526,0.9409221679379284,0.1134715859553186,1.770767592719551,1.6572960067642324,11.0377681853213,1.6444917876449,5996687821.0,2012-09-21,2012,4,265,9,0.59,146.24,145.98,145.03999,3201
2012-09-24 13:30:00,145.14999,145.98,145.03999,145.645,142.9726584375,148.51736842105262,135.6852799500004,137.2626303,140.95437980000003,144.00325000000015,141.5949440432404,144.42986934323704,145.54038615384638,148.1498803613861,142.93089194630662,135.6852799500004,137.2626303,140.95437980000003,144.00325000000015,145.55499666666663,95682000,115374796.0,63.059337847310154,1.5,2.75,1.1747536482082028,0.8293145757761513,0.0035415661077380367,1.6617229643989049,1.6581813982911668,10.344297896179627,1.2056146202487759,5901005821.0,2012-09-24,2012,0,268,9,0.65,145.51,146.24001,144.06,3202
2012-09-25 13:30:00,145.96001,146.24001,144.06,144.10001,143.17570546874995,148.58526315789476,135.78603000000038,137.31113040000002,141.12778020000005,144.13125100000016,141.69318192389758,144.39845416769063,145.56577153846175,148.1115241980551,143.02001887886846,135.78603000000038,137.31113040000002,141.12778020000005,144.13125100000016,144.8000066666667,133165120,118593758.4,52.492410401006225,1.5,2.75,1.2465576733361892,1.1228678624962103,-0.179261071092768,1.4341050594252067,1.6133661305179747,12.392966391285329,-0.2008380081723034,5767840701.0,2012-09-25,2012,1,269,9,1.51,145.15,144.11,142.95,3203
2012-09-26 13:30:00,144.065,144.11,142.95,143.295,143.3787525,148.6531578947369,135.8722550000004,137.37408040000003,141.26648020000005,144.22600150000017,141.7559983190389,144.29336329457726,145.4861561538464,148.23791945560274,142.73439285209002,135.8722550000004,137.37408040000003,141.26648020000005,144.22600150000017,143.45166666666668,146502128,122134386.4,47.980842721142686,1.5,2.75,1.2403749823836059,1.1995158146551264,-0.35052366965022697,1.1752115434551909,1.525735213105418,12.607218059300955,-2.2477658776178564,5621338573.0,2012-09-26,2012,2,270,9,0.81,143.53,144.97,143.50999,3204
2012-09-27 13:30:00,143.89,144.97,143.50999,144.64,143.58179953125,148.72105263157897,135.97440495000038,137.4494803,141.41188020000004,144.38250200000016,141.8690964241746,144.3263763141413,145.57308000000026,148.1344604497807,143.01169955021976,135.97440495000038,137.4494803,141.41188020000004,144.38250200000016,144.37332999999995,111830256,124454834.4,54.947932121612936,1.5,2.75,1.2714196264990636,0.8985609642175539,-0.3675677974080922,1.066275466345303,1.433843263753395,10.144315148418446,-1.7658311759147705,5733168829.0,2012-09-27,2012,3,271,9,1.02,144.24,144.56,143.46001,3205
2012-09-28 13:30:00,144.09,144.56,143.46001,143.97,143.7848465625,148.7889473684211,136.0790049500004,137.52368030000002,141.53668020000003,144.55650150000014,141.95148479969714,144.29243571279454,145.5776953846156,148.1272612815769,143.0281294876543,136.0790049500004,137.52368030000002,141.53668020000003,144.55650150000014,143.99667,150696064,127160147.2,51.264584447769934,1.5,2.75,1.2648889388919855,1.1850887822816234,-0.4148121252668655,0.9153281071698132,1.330140232436679,9.579422993460916,-1.887699203509672,5582472765.0,2012-09-28,2012,4,272,9,0.77,144.01,145.69,144.00818999999998,3206
2012-10-01 13:30:00,144.52,145.69,144.00818999999998,144.345,143.98789359375,148.85684210526318,136.1920299000004,137.6097302,141.69418020000003,144.71575150000015,142.04534814088552,144.29744183538548,145.5742338461541,148.13035423394925,143.0181134583589,136.1920299000004,137.6097302,141.69418020000003,144.71575150000015,144.68106333333333,135911120,126357184.8,53.15725425171965,1.5,2.75,1.2973968718282725,1.0756105417758564,-0.4108738283090949,0.8165479470503101,1.227421775359405,9.926653934705627,-1.551630064111312,5718383885.0,2012-10-01,2012,0,275,10,1.17,144.85,145.14999,143.83,3207
2012-10-02 13:30:00,144.92,145.14999,143.83,144.5,144.190940625,148.92473684210532,136.30360490000038,137.6945302,141.88238020000006,144.88925150000014,142.14160899810568,144.3167330891583,145.41346461538484,147.956683771954,142.8702454588157,136.30360490000038,137.6945302,141.88238020000006,144.88925150000014,144.49333,113422128,126016981.6,53.95325635744532,1.5,2.75,1.2990106666976808,0.9000543145845353,-0.3881651271967046,0.7422153663635243,1.1303804935602288,10.042714773824727,-1.4996591683708171,5831806013.0,2012-10-02,2012,1,276,10,0.92,144.49,145.42999,144.13,3208
2012-10-03 13:30:00,144.89,145.42999,144.13,145.09,144.39398765625,148.99263157894742,136.4211049000004,137.7893302,142.10568020000005,145.09825150000015,142.2572321746506,144.39037755685752,145.24807923076943,147.56415436168527,142.93200409985363,136.4211049000004,137.7893302,142.10568020000005,145.09825150000015,144.88332999999997,121283008,127048119.2,56.95193873020958,1.5,2.75,1.2990806190764186,0.9546226167195396,-0.3262365374367313,0.7225848217643147,1.048821359201046,10.493117893877583,-1.1042259488633446,5953089021.0,2012-10-03,2012,2,277,10,0.9,144.78,146.34,145.44,3209
2012-10-04 13:30:00,145.64,146.34,145.44,146.125,144.59703468749996,149.0605263157895,136.55027995000037,137.9094802,142.34898000000004,145.21600150000015,142.4089093442721,144.55557969429967,145.20077076923099,147.41594226649445,142.98559927196752,136.55027995000037,137.9094802,142.34898000000004,145.21600150000015,145.96833333333333,124311632,125350079.2,61.667870489399206,1.5,2.75,1.2955748605709605,0.9917156239020548,-0.21382966083674826,0.7815342831551106,0.9953639439918588,11.506877041270167,0.17481318982655478,6077400653.0,2012-10-04,2012,3,278,10,0.62,145.89,147.16,145.7,3210
2012-10-05 13:30:00,146.91,147.16,145.7,146.14,144.80008171875,149.12842105263158,136.6613300000004,138.0374802,142.5483800000001,145.30650150000014,142.5552266248889,144.70647686627115,145.1638476923079,147.29767180293774,143.03002358167802,136.6613300000004,138.0374802,142.5483800000001,145.30650150000014,146.33333333333334,124842064,126228582.4,61.73329952584334,1.5,2.75,1.307319513387321,0.9890158126342072,-0.14028318223101674,0.820009966203088,0.9602931484341048,10.992508458942327,0.3398674860104886,6202242717.0,2012-10-05,2012,4,279,10,1.0,146.43,146.12309,145.31,3211
2012-10-08 13:30:00,145.60001,146.12309,145.31,145.642,145.00312875,149.1963157894737,136.7686900000004,138.16561030000003,142.68772000000004,145.41310200000015,142.67627656116778,144.79557430757862,145.08246307692332,147.0499431624817,143.11498299136488,136.7686900000004,138.16561030000003,142.68772000000004,145.41310200000015,145.69169666666667,78415568,125826439.2,58.18252643179277,1.5,2.75,1.2732252624310827,0.6232042208184811,-0.1273678039651377,0.8010833934776826,0.9284511974428205,11.150932403663463,1.0700832012433577,6123827149.0,2012-10-08,2012,0,282,10,0.56,145.72,145.64999,144.14999,3212
2012-10-09 13:30:00,145.53,145.64999,144.14999,144.2,145.20617578124995,149.2642105263158,136.8633400000004,138.29901030000002,142.79812020000006,145.42760200000015,142.73603042151413,144.7388529449521,144.8893853846156,146.66320206838213,143.11556870084902,136.8633400000004,138.29901030000002,142.79812020000006,145.42760200000015,144.66666,148872816,128832080.0,49.334010218375475,1.5,2.75,1.2894234579717196,1.1555570320684103,-0.2130854478978066,0.6620943875705619,0.8751798354683686,10.906484686595745,0.6315642555567195,5974954333.0,2012-10-09,2012,1,283,10,1.04,144.9,144.32001,143.09,3213
2012-10-10 13:30:00,144.17999,144.32001,143.09,143.28,145.4092228125,149.3321052631579,136.9477900000004,138.4344102,142.90952000000004,145.37210200000015,142.75736256184692,144.59991456924237,144.6901546153848,146.55797044304668,142.8223387877229,136.9477900000004,138.4344102,142.90952000000004,145.37210200000015,143.56333666666666,124247440,130662408.0,44.666677369094884,1.5,2.75,1.2851796395451678,0.9509042570224177,-0.3223324134173675,0.4722643186966593,0.7945967321140268,11.066437708250506,-0.9402654867256536,5850706893.0,2012-10-10,2012,2,284,10,0.86,143.71,144.49001,143.327,3214
2012-10-11 13:30:00,144.28,144.49001,143.327,143.36,145.61226984375,149.4,137.03213995000038,138.5483102,143.02492000000004,145.21060200000016,142.7809954025588,144.48182746740974,144.5143853846156,146.41938615503486,142.6093846141964,137.03213995000038,138.5483102,143.02492000000004,145.21060200000016,143.72567,123601440,125568973.6,45.152597910743076,1.5,2.75,1.2798103795776563,0.9843310529377458,-0.3760478708253204,0.32453689358237625,0.7005847644076967,9.372216975211424,-0.42369938181564576,5974308333.0,2012-10-11,2012,3,285,10,0.81,143.91,143.95,142.58,3215
2012-10-12 13:30:00,143.46001,143.95,142.58,142.89,145.81531687499995,149.4678947368421,137.12243995000037,138.6552102,143.14992000000004,144.99310150000014,142.78527009265454,144.33022485146597,144.42130769230792,146.50779438011037,142.33482100450541,137.12243995000037,138.6552102,143.14992000000004,144.99310150000014,143.14,124181872,123289216.8,42.775919519117735,1.5,2.75,1.286252495322108,1.0072403347443442,-0.426384027670522,0.16760472981954422,0.5939887574900662,9.204383045229916,-1.0080016626831636,5850126461.0,2012-10-12,2012,4,286,10,0.96,143.26,144.23,142.77,3216
2012-10-15 13:30:00,143.23,144.23,142.77,144.08,146.01836390625,149.53578947368422,137.2122399500004,138.7733102,143.24454000000003,144.86010100000016,142.83604381451119,144.30639391323112,144.4816923076925,146.47777745846463,142.48560715692037,137.2122399500004,138.7733102,143.24454000000003,144.86010100000016,143.69333333333338,107689056,122702282.4,49.95808463922678,1.5,2.75,1.2986630313705274,0.8776450926066881,-0.36505426248755796,0.13767092938061865,0.5027251918681767,10.454811089440287,-0.2906574394463581,5957815517.0,2012-10-15,2012,0,289,10,1.02,143.5,145.64,144.66,3217
2012-10-16 13:30:00,144.75999,145.64,144.66,145.53999,146.2214109375,149.60368421052632,137.31243990000038,138.90341009999997,143.36293980000005,144.80610050000013,142.9420809198245,144.42387925482814,144.55092230769247,146.62506963144372,142.47677498394125,137.31243990000038,138.90341009999997,143.36293980000005,144.80610050000013,145.27999666666662,108815440,123226729.6,57.076162129072635,1.5,2.75,1.3173299577012023,0.8830506202121914,-0.21888730477802226,0.22911606089564884,0.4480033656736711,12.009630554445984,0.31014542697634945,6066630957.0,2012-10-16,2012,1,290,10,0.68,145.15,146.32001,145.42,3218
2012-10-17 13:30:00,145.64,146.32001,145.42,146.2,146.42445796875,149.67157894736843,137.4059649000004,139.04441,143.48053960000004,144.78110050000015,143.0698424523804,144.5930336115112,144.72246076923096,146.93996032299188,142.50496121547002,137.4059649000004,139.04441,143.48053960000004,144.78110050000015,145.98000333333331,128834064,123252520.0,59.85609148526063,1.5,2.75,1.2875213892939743,1.0452854351375531,-0.07776231807187084,0.3508004680838326,0.4285627861557034,12.058212972089365,0.05132591958938487,6195465021.0,2012-10-17,2012,2,291,10,0.62,145.87,146.52,145.33,3219
2012-10-18 13:30:00,145.82001,146.52,145.33,145.82001,146.627505,149.73947368421054,137.4965649500004,139.16561009999998,143.58713960000003,144.73660050000012,143.17769216013016,144.709888505653,144.83592307692325,147.11465541842512,142.55719073542141,137.4965649500004,139.16561009999998,143.58713960000003,144.73660050000012,145.89000333333334,148108432,122957454.4,57.54534783267746,1.5,2.75,1.280555575772976,1.2045502464468718,-0.013388680430348576,0.4118269356177677,0.4252156160481163,11.462604546066167,-0.21896127001504725,6047356589.0,2012-10-18,2012,3,292,10,0.82,145.93,145.56,143.05,3220
2012-10-19 13:30:00,145.55,145.56,143.05,143.3896,146.83055203125,149.80736842105262,137.57331300000038,139.28190619999998,143.64273160000005,144.61258050000012,143.18600227149759,144.58414674320989,144.75050769230782,147.15308191495416,142.3479334696615,137.57331300000038,139.28190619999998,143.64273160000005,144.61258050000012,143.99986666666666,185645120,126802838.4,45.45767509273244,1.5,2.75,1.3869451775034765,1.4640454609886713,-0.1313183726534327,0.2610676502313254,0.3923860228847581,14.882278857337306,-1.5465319070048438,5861711469.0,2012-10-19,2012,4,293,10,1.75,144.3,143.67,142.28,3221
2012-10-22 13:30:00,143.14999,143.67,142.28,143.41,147.0335990625,149.87526315789475,137.6518129500004,139.4013062,143.69413160000005,144.50083050000012,143.19478649614476,144.47232324385655,144.62127692307712,147.1158727783443,142.1266810678099,137.6518129500004,139.4013062,143.69413160000005,144.50083050000012,143.12,125578624,128297669.6,45.56104106468872,1.5,2.75,1.38716337911037,0.9788067420984552,-0.20062592110207966,0.14160362150715855,0.3422295426092382,14.889825027245715,-0.5478502080443773,5987290093.0,2012-10-22,2012,0,296,10,0.98,142.98,142.06,140.83,3222
2012-10-23 13:30:00,141.86,142.06,140.83,141.42,147.23664609374995,149.94315789473688,137.71881295000037,139.5339062,143.70713160000003,144.3668300000001,143.12518702570767,144.1816257920607,144.25935384615403,147.11532843841562,141.4033792538924,137.71881295000037,139.5339062,143.70713160000003,144.3668300000001,141.4366666666666,192056320,131242229.6,37.99631772420136,1.5,2.75,1.4723659948881995,1.4633728837535689,-0.3636665998678432,-0.1123537072255658,0.2513128926422774,15.865410595177107,-1.2981574539363578,5795233773.0,2012-10-23,2012,1,297,10,0.87,141.44,142.10001,140.8,3223
2012-10-24 13:30:00,141.92999,142.10001,140.8,141.02,147.439693125,150.01105263157896,137.77826295000037,139.6631061,143.71173180000005,144.25308000000012,143.04263067175842,143.8805185737692,143.8655076923079,146.97623411797096,140.75478126664476,137.77826295000037,139.6631061,143.71173180000005,144.25308000000012,141.30667000000003,120179312,129926088.8,36.67806867133663,1.5,2.75,1.4600548523961845,0.9249821426164566,-0.4746115717976085,-0.3419515721047333,0.13265999969287529,15.629869121238835,-1.6322544642857164,5675054461.0,2012-10-24,2012,2,298,10,0.92,141.45,142.28,140.57001,3224
2012-10-25 13:30:00,142.02,142.28,140.57001,141.42999,147.64274015625,150.0789473684211,137.83941290000038,139.78670590000002,143.72133160000004,144.09257950000008,142.9793898611012,143.64713490007688,143.5415069230771,146.72125720064219,140.361756645512,137.83941290000038,139.78670590000002,143.72133160000004,144.09257950000008,141.42666666666662,134457312,131057441.6,39.013606288461844,1.5,2.75,1.4779073629393145,1.0259418340423334,-0.4943146398958894,-0.4852333001769864,0.009081339718902959,15.80430859978484,-1.0217719924417263,5809511773.0,2012-10-25,2012,3,299,10,1.22,141.43,141.84,140.39,3225
2012-10-26 13:30:00,141.3,141.84,140.39,141.35001,147.84578718749995,150.1468421052632,137.89861300000038,139.880506,143.7085316,143.96158000000014,142.91549261164624,143.42836110006957,143.32227692307708,146.67829932896532,139.96625451718884,137.89861300000038,139.880506,143.7085316,143.96158000000014,141.19333666666668,146023440,130823810.4,38.71362828583271,1.5,2.75,1.4759139798722216,1.1161839695199705,-0.4859382806213482,-0.5983415110577823,-0.11240323043643408,15.759973256313375,-1.8947737368128919,5663488333.0,2012-10-26,2012,4,300,10,1.03,141.12,142.03,140.67999,3226
2012-10-31 13:30:00,141.85001,142.03,140.67999,141.35001,148.04883421875,150.21473684210528,137.96116305000035,139.9735061,143.69193200000004,143.81183050000016,142.85410113667973,143.2304229000629,143.17381615384633,146.69106606038642,139.65656624730616,137.96116305000035,139.9735061,143.69193200000004,143.81183050000016,141.35333333333332,103438496,129200179.2,38.71362828583271,1.5,2.75,1.466920838452777,0.8006064437409077,-0.4541896944639979,-0.6801403485164315,-0.2259506540524336,14.635560861341336,-2.8789200823773533,5663488333.0,2012-10-31,2012,2,305,10,0.96,141.35,143.00999,141.52,3227
2012-11-01 13:30:00,141.64999,143.00999,141.52,142.83,148.25188125,150.28263157894742,138.02861305000036,140.070806,143.70473200000004,143.72833050000014,142.85315599406485,143.19228738577127,143.13304692307707,146.65300495919874,139.61308888695538,138.02861305000036,140.070806,143.70473200000004,143.72833050000014,142.45333000000005,100995568,128578851.2,47.39429196466801,1.5,2.75,1.4807107785632925,0.7854757377082554,-0.3139714681799028,-0.6184149892773121,-0.3044435210974093,14.736309693432926,-2.305061559507508,5764483901.0,2012-11-01,2012,3,306,11,1.05,142.26,143.72,141.41,3228
2012-11-02 13:30:00,143.67999,143.72,141.41,141.56,148.45492828124995,150.35052631578952,138.08256305000037,140.17225610000003,143.70073220000006,143.55183050000014,142.8024439942976,143.03683144426918,143.0307392307694,146.64894853954,139.4125299219988,138.08256305000037,140.17225610000003,143.70073220000006,143.55183050000014,142.23,137702128,129399807.2,41.90870746318648,1.5,2.75,1.539945722951629,1.0641602254257454,-0.2878993768279901,-0.6643177421323969,-0.3764183653044068,14.619534416488955,-2.921416614907648,5626781773.0,2012-11-02,2012,4,307,11,1.63,142.56,142.17,140.92999,3229
2012-11-05 14:30:00,141.35001,142.17,140.92999,141.8486,148.6579753125,150.4184210526316,138.1345060000004,140.26154209999999,143.70130400000005,143.33801050000014,142.7650383474624,142.923666544815,142.85909307692324,146.4736222718489,139.24456388199758,138.1345060000004,140.26154209999999,143.70130400000005,143.33801050000014,141.64953,98378432,128103147.2,43.50883532617673,1.5,2.75,1.5185217427407969,0.7679626469005283,-0.2346162218421309,-0.6696886426070705,-0.4350724207649396,14.930150918200045,-1.0746943990359108,5725160205.0,2012-11-05,2012,0,310,11,0.88,141.55,143.52,142.13,3230
2012-11-06 14:30:00,142.28,143.52,142.13,142.96001,148.86102234375,150.48631578947368,138.19160610000037,140.37044210000002,143.74720440000004,143.17901100000014,142.77268429462075,142.9271278262612,142.66063307692326,145.93155965985702,139.3897064939895,138.19160610000037,140.37044210000002,143.74720440000004,143.17901100000014,142.87000333333333,107068064,127214447.2,49.30057865627797,1.5,2.75,1.5294416182593118,0.8416344712143669,-0.11402634057366155,-0.5776053464820166,-0.463579005908355,13.020460053315945,-0.31377867652185026,5832228269.0,2012-11-06,2012,1,311,11,0.98,142.82,141.67999,139.06,3231
2012-11-07 14:30:00,141.66,141.67999,139.06,139.72,149.064069375,150.5542105263158,138.23215610000037,140.43294210000002,143.7114046000001,142.88291100000015,142.65297118502778,142.621687080903,142.16217153846168,145.0795885318441,139.2447545450793,138.23215610000037,140.43294210000002,143.7114046000001,142.88291100000015,140.15333,264304432,136508890.4,37.2959822860376,1.5,2.75,1.6987679312407902,1.9361701001709997,-0.235008997654804,-0.7573402529768599,-0.522331255322056,18.35406196647964,-1.2020930561448089,5567923837.0,2012-11-07,2012,2,312,11,1.88,140.37,140.41,137.92999,3232
2012-11-08 14:30:00,139.7,140.41,137.92999,138.03999,149.26711640624995,150.6221052631579,138.26505600000038,140.47194199999998,143.6414046000001,142.57491050000016,142.47206996208553,142.18533497795985,141.56370846153862,144.42557121886463,138.70184570421267,138.26505600000038,140.47194199999998,143.6414046000001,142.57491050000016,138.79332666666667,181517248,138141112.0,32.83181340242633,1.5,2.75,1.7545709361521618,1.3139987464412477,-0.4009713423384727,-1.0235454332451468,-0.6225740909066741,17.95710929109585,-2.113182527301107,5386406589.0,2012-11-08,2012,3,313,11,1.8,139.17,139.44,137.55,3233
2012-11-09 14:30:00,137.62,139.44,137.55,138.16,149.4701634375,150.69000000000003,138.29305600000038,140.50954209999998,143.5766048000001,142.31891050000016,142.30296917925864,141.8019697419637,141.16143153846173,144.3366211230963,137.98624195382715,138.29305600000038,140.50954209999998,143.5766048000001,142.31891050000016,138.38333333333333,201055184,141981499.2,33.44465992377457,1.5,2.75,1.764244440712721,1.4160660729239576,-0.4706390974395449,-1.2108729627061052,-0.7402338652665603,18.051080696594425,-2.31209095044128,5587461773.0,2012-11-09,2012,4,314,11,1.37,138.5,138.81,137.96001,3234
2012-11-12 14:30:00,138.59,138.81,137.96001,138.265,149.67321046875,150.7578947368421,138.32498100000038,140.53519210000002,143.51170500000006,142.06416050000013,142.1446174467387,141.46511548082432,140.7656623076925,144.00308610581985,137.52823850956517,138.32498100000038,140.53519210000002,143.51170500000006,142.06416050000013,138.34500333333332,97677440,140685299.2,34.01195616081573,1.5,2.75,1.6989405520903829,0.694297418105786,-0.4761843919138984,-1.3354643551589334,-0.859279963245035,17.87742558936015,-2.1825325657918317,5685139213.0,2012-11-12,2012,0,317,11,0.62,138.39,139.25,137.36,3235
2012-11-13 14:30:00,137.53999,139.25,137.36,137.78999,149.87625749999995,150.82578947368427,138.35483090000037,140.558292,143.45770460000006,141.80916000000013,141.97384774294503,141.11510353026958,140.48643076923096,144.05879569797938,136.91406584048255,138.35483090000037,140.558292,143.45770460000006,141.80916000000013,138.13333,123018192,140627115.2,32.65587267600512,1.5,2.75,1.7125876555124973,0.8747828740214392,-0.4771778394659079,-1.4557522625774195,-0.978574423111512,17.853718198917566,-2.5185848943342903,5562121021.0,2012-11-13,2012,1,318,11,1.38,138.3,138.42999,135.62,3236
2012-11-14 14:30:00,138.21001,138.42999,135.62,135.9299,150.07930453125,150.89368421052637,138.37763040000038,140.593191,143.35310260000008,141.40165500000015,141.73683018439814,140.62127462262492,140.09488461538479,144.39014457161704,135.79962465915258,138.37763040000038,140.593191,143.35310260000008,141.40165500000015,136.6599633333333,191504944,144817909.6,27.955447407607718,1.5,2.75,1.790973537261605,1.3223843965774245,-0.5625711843699366,-1.6817884035739326,-1.119217219203996,18.818316851047303,-4.830987887698669,5370616077.0,2012-11-14,2012,2,319,11,2.07,137.02,136.4901,135.17999,3237
2012-11-15 14:30:00,135.98,136.4901,135.17999,135.7,150.2823515625,150.96157894736842,138.3995303500004,140.6155909,143.2465026000001,140.90965550000016,141.50009174579432,140.1525818014225,139.65411615384636,144.45690362380958,134.85132868388308,138.3995303500004,140.6155909,143.2465026000001,140.90965550000016,135.79003,178128368,148283556.0,27.429926262718087,1.5,2.75,1.7566261417429192,1.2012685209680296,-0.5910711586862534,-1.8580561675618128,-1.2669850088755594,16.60306878739733,-4.139587454083084,5192487709.0,2012-11-15,2012,3,320,11,0.97,135.84,136.64,134.7,3238
2012-11-16 14:30:00,135.89999,136.64,134.7,136.37,134.7,151.02947368421056,138.41903035000038,140.6660908,143.1557026000001,140.41815550000015,141.2989116773318,139.79233591557275,139.2710384615387,144.26237330847968,134.27970361459762,138.41903035000038,140.6660908,143.1557026000001,140.41815550000015,135.90333333333334,239483808,153816043.2,31.472950068805016,1.5,2.75,1.7697242744755677,1.5569494769060606,-0.5236407683767585,-1.9215359693465075,-1.3978952009697492,17.326010622111074,-3.862286973576052,5431971517.0,2012-11-16,2012,4,321,11,1.44,135.67,139.14999,136.4057,3239
2012-11-19 14:30:00,137.89999,139.14999,136.4057,139.13,134.5935294117647,151.09736842105266,138.45128040000037,140.7375908,143.06290260000006,140.08365500000016,141.21385631743644,139.72925630456578,139.10026846153866,143.94516378099718,134.25537314208012,138.45128040000037,140.7375908,143.06290260000006,140.08365500000016,138.22856333333334,151495744,153985408.8,45.053258648756845,1.5,2.75,1.8418861120130268,0.9838318135503756,-0.2650454958715447,-1.7292020708091798,-1.464156574937635,21.96523913157055,-2.6790778763935563,5583467261.0,2012-11-19,2012,0,324,11,2.01,137.78,139.42,138.08,3240
2012-11-20 14:30:00,138.91,139.42,138.08,139.19,134.48705882352942,151.16526315789474,138.47453045000037,140.7977608,142.96010260000006,139.87367500000016,141.13448940302715,139.6778985612738,138.82026846153866,143.1655661510352,134.47497077204213,138.47453045000037,140.7977608,142.96010260000006,139.87367500000016,138.89666666666668,119807376,150693521.6,45.307008695436366,1.5,2.75,1.8060371040120948,0.7950399906242552,-0.07189137018782299,-1.5540207876724141,-1.4821294174845907,21.16378514523234,-0.3793300887489273,5703274637.0,2012-11-20,2012,1,325,11,0.97,138.75,139.57001,139.03,3241
2012-11-21 14:30:00,139.31,139.57001,139.03,139.45,134.38058823529408,151.23315789473688,138.49953045000038,140.8643609,142.8789028000001,139.67567500000015,141.0684309950653,139.6561939363906,138.65796076923098,142.73088082210097,134.58504071636102,138.49953045000038,140.8643609,142.8789028000001,139.67567500000015,139.35000333333332,81710752,148500128.0,46.460840535201655,1.5,2.75,1.7156065965826592,0.5502402799275702,0.08304744177177481,-1.3783201152698723,-1.4613675570416471,16.831219521435518,1.0214503782563298,5784985389.0,2012-11-21,2012,2,326,11,0.39,139.3,141.39999,140.03999,3242
2012-11-23 14:30:00,140.13,141.39999,140.03999,141.35001,134.2741176470588,151.30105263157895,138.53233055000035,140.91681100000002,142.8277030000001,139.67217550000015,141.07947330898432,139.81750975197244,138.61960769230788,142.57944570802294,134.65976967659282,138.53233055000035,140.91681100000002,142.8277030000001,139.67217550000015,140.92999666666663,65409152,142167769.6,54.084106987263745,1.5,2.75,1.7323482682553275,0.4600842524577386,0.310383811814648,-1.073387792273337,-1.383771604087985,16.624270907794575,2.3089244354371745,5850394541.0,2012-11-23,2012,4,328,11,0.97,140.72,141.35629,140.19,3243
2012-11-26 14:30:00,140.64999,141.35629,140.19,141.05,134.16764705882352,151.36894736842106,138.56163055000036,140.9622111,142.7609030000001,139.67367550000014,141.0783174929457,139.93488977559412,138.47268384615404,141.88073400699437,135.0646336853137,138.56163055000036,140.9622111,142.7609030000001,139.67367550000014,140.86543,100124320,141165020.0,52.805568513687675,1.5,2.75,1.6919155348085186,0.7092714611594289,0.4300726562736961,-0.8461807837458649,-1.276253440019561,16.8104102553102,2.014248002025115,5750270221.0,2012-11-26,2012,0,331,11,0.83,140.77,141.39,140.24001,3244
2012-11-27 14:30:00,140.91,141.39,140.24001,140.33,134.06117647058824,151.43684210526317,138.58648055000037,140.9913911,142.63570300000006,139.61867600000016,141.04897170890862,139.97251932077563,138.51960692307708,142.01084085975177,135.0283729864025,138.58648055000037,140.9913911,142.63570300000006,139.61867600000016,140.65333666666666,128646192,140874464.0,49.765034300343416,1.5,2.75,1.6532065680364796,0.9131973840198604,0.4482328269677525,-0.7159624063098704,-1.1641952332776229,17.307801245734208,1.8433922522238544,5621624029.0,2012-11-27,2012,1,332,11,0.82,140.82,141.53999,139.0,3245
2012-11-28 14:30:00,139.75999,141.53999,139.0,141.46001,133.95470588235293,151.50473684210527,138.62197565000034,141.03809130000005,142.52010300000006,139.6241760000002,141.0650908575789,140.11418509974942,138.78268538461558,142.59075479509025,134.9746159741409,138.62197565000034,141.03809130000005,142.52010300000006,139.6241760000002,140.66666666666666,177086432,142427613.6,54.220337197060296,1.5,2.75,1.7165482417481588,1.243343390540386,0.5188465086856116,-0.5156370974206084,-1.0344836061062201,17.364239893283912,4.068354350293797,5798710461.0,2012-11-28,2012,2,333,11,1.83,140.27,142.50999,141.37,3246
2012-11-29 14:30:00,141.99001,142.50999,141.37,142.12,133.84823529411764,151.57263157894738,138.65577565000035,141.10439120000004,142.42770280000005,139.66267550000015,141.1064598435562,140.30521509024945,139.08730076923095,143.26317215299161,134.91142938547026,138.65577565000035,141.10439120000004,142.42770280000005,139.66267550000015,141.99999666666668,151085872,144809982.4,56.639183790047156,1.5,2.75,1.6753655101947176,1.043338791262777,0.5874572145479069,-0.30016208792133625,-0.8876193024692431,13.958360624163895,4.731024318349311,5949796333.0,2012-11-29,2012,3,334,11,0.81,141.94,142.42,141.66,3247
2012-11-30 14:30:00,142.14,142.42,141.66,142.155,133.74176470588233,151.64052631578951,138.6906006500003,141.17274110000002,142.33840280000004,139.62892550000018,141.14757906537753,140.48138508165425,139.38653153846172,143.83257639160695,134.9404866853165,138.6906006500003,141.17274110000002,142.33840280000004,139.62892550000018,142.07833333333338,136568320,146588620.0,56.7696325741031,1.5,2.75,1.6099822594665232,0.9316433976934908,0.6099914718411439,-0.1251299626678133,-0.7351214345089572,13.688370297875464,4.242135367016203,6086364653.0,2012-11-30,2012,4,335,11,0.54,142.04,142.92,141.34,3248
2012-12-03 14:30:00,142.8,142.92,141.34,141.45,133.63529411764705,151.7084210526316,138.7250506500003,141.24584110000006,142.23340280000005,139.62342550000017,141.15943870987252,140.5736341214967,139.66807076923095,144.13753275803057,135.1986087804313,138.7250506500003,141.24584110000006,142.23340280000005,139.62342550000017,141.90333333333334,124656320,145936329.6,53.291799540112216,1.5,2.75,1.6078406695046272,0.8541829189597488,0.5538492556390132,-0.04280986496019068,-0.5966591205992039,14.749196701517816,1.6675052109537791,5961708333.0,2012-12-03,2012,0,338,12,1.12,142.13,141.87,140.87,3249
2012-12-04 14:30:00,141.44,141.87,140.87,141.25,133.52882352941174,151.7763157894737,138.75105565000035,141.31674110000006,142.12420260000005,139.59349550000022,141.16299013301474,140.6380499194494,140.0773092307694,144.04927576085353,136.10534270068527,138.75105565000035,141.31674110000006,142.12420260000005,139.59349550000022,141.33,127622496,147398532.8,52.312703328215726,1.5,2.75,1.5644234788257252,0.8658328789009492,0.4823028035526858,0.006219383841653325,-0.4760834197110325,10.592821620570772,1.4799913786909995,5834085837.0,2012-12-04,2012,1,339,12,0.71,141.37,142.16,140.37,3250
2012-12-05 14:30:00,141.37,142.16,140.37,141.5,133.42235294117646,151.8442105263158,138.7765056500003,141.39664120000006,142.03680260000004,139.52049500000015,141.17620620622992,140.72014040331138,140.52346307692326,143.63914077787882,137.4077853759677,138.7765056500003,141.39664120000006,142.03680260000004,139.52049500000015,141.34333333333333,147300432,149410151.2,53.46364171595146,1.5,2.75,1.58053608748103,0.9858796796398664,0.4324705411558521,0.06450475673378264,-0.3679657844220695,10.570711186702304,1.4700609537468707,5981386269.0,2012-12-05,2012,2,340,12,1.28,141.26,142.03999,141.16,3251
2012-12-06 14:30:00,141.37,142.03999,141.16,141.98,133.31588235294114,151.9121052631579,138.80405565000035,141.45894120000006,141.96350260000003,139.63349500000018,141.20772753147574,140.84012703156745,140.95500153846172,143.0303897690851,138.87961330783835,138.80405565000035,141.45894120000006,141.96350260000003,139.63349500000018,141.72666333333333,103220560,141355957.6,55.67560590506551,1.5,2.75,1.5304970812323846,0.7302172596933403,0.4125529765563677,0.1477254362733902,-0.2648275402829775,10.618078309150453,0.44569505159567535,6084606829.0,2012-12-06,2012,3,341,12,0.62,141.6,142.69,141.67,3252
2012-12-07 14:30:00,142.53,142.69,141.67,142.41499,133.20941176470586,151.98000000000005,138.83597060000034,141.52879120000003,141.92980220000004,139.85224500000018,141.2550711576924,140.99011398094197,141.20769307692325,143.12677655336216,139.28860960048436,138.83597060000034,141.52879120000003,141.92980220000004,139.85224500000018,142.25833,108726320,137716411.2,57.640586883433635,1.5,2.75,1.4940330040015009,0.7894942879545501,0.4086167519078669,0.2459433996018561,-0.16267335230601074,7.684745435834109,0.967734845799346,6193333149.0,2012-12-07,2012,4,342,12,0.72,142.18,142.81,142.14999,3253
2012-12-10 14:30:00,142.21001,142.81,142.14999,142.47301000000002,133.10294117647058,152.04789473684212,138.86518065000035,141.5899213,141.9133624,140.06789550000022,141.30283346523387,141.13134217323318,141.46023230769248,143.09355994067658,139.82690467470837,138.86518065000035,141.5899213,141.9133624,140.06789550000022,142.47766666666666,98840688,132605686.4,57.908622076711744,1.5,2.75,1.434459932287108,0.7453729224088538,0.389914999969445,0.3247203976557955,-0.0651946023136495,7.47306343857695,1.5271217843654068,6292173837.0,2012-12-10,2012,0,345,12,0.46,142.48,144.11,142.99001,3254
2012-12-11 14:30:00,143.06,144.11,142.99001,143.44,132.99647058823527,152.11578947368426,138.89773070000035,141.6506213,141.8893624,140.3266455000002,141.38664391757766,141.351214347211,141.76715538461556,143.26833854536463,140.2659722238665,138.89773070000035,141.6506213,141.8893624,140.3266455000002,143.51333666666667,152570368,135350332.8,62.201472087271696,1.5,2.75,1.4489263656951734,1.1272256583620308,0.4200585250449619,0.459878553992553,0.039820028947591006,7.009130435440343,1.3996817899277587,6444744205.0,2012-12-11,2012,1,346,12,0.78,143.55,144.55,143.31,3255
2012-12-12 14:30:00,144.0,144.55,143.31,143.50999,132.89,152.18368421052637,138.9294806500003,141.70842120000003,141.8801622,140.61264550000018,141.4699123913981,141.556812028429,141.93330769230786,143.67232748075673,140.194287903859,138.9294806500003,141.70842120000003,141.8801622,140.61264550000018,143.78999666666667,145880000,136493423.2,62.49958946173678,1.5,2.75,1.4340030538598043,1.0687694438306097,0.4210353072761767,0.5661141630428119,0.1450788557666352,5.9764918174676245,0.9780396847734192,6590624205.0,2012-12-12,2012,2,347,12,0.87,143.93,143.83,142.27499,3256
2012-12-13 14:30:00,143.42,143.83,142.27499,142.63,132.7835294117647,152.25157894736844,138.95483560000034,141.77002120000003,141.8458622,140.94765050000018,141.51540602310803,141.65902040667385,142.0548461538463,143.75024570766698,140.35944660002565,138.95483560000034,141.77002120000003,141.8458622,140.94765050000018,142.91166333333334,135714944,133703923.2,56.46913598894664,1.5,2.75,1.4426464071555336,1.015040851097479,0.3420946067021923,0.5726971141443755,0.2306025074421833,6.978985450840371,0.3341423094509474,6454909261.0,2012-12-13,2012,3,348,12,1.09,143.05,142.58,141.88,3257
2012-12-14 14:30:00,142.32001,142.58,141.88,142.1051,132.67705882352942,152.31947368421058,138.98026110000038,141.84017220000004,141.7979642,141.26790550000018,141.5385312771038,141.7015041774668,142.1913923076925,143.56440493802455,140.81837967736044,138.98026110000038,141.84017220000004,141.7979642,141.26790550000018,142.18836666666667,137701680,131682588.8,53.17341184828349,1.5,2.75,1.3931716637872813,1.045709089218635,0.2390826895699677,0.529455869404643,0.2903731798346752,7.35592210255946,0.4631318487097946,6317207581.0,2012-12-14,2012,4,349,12,0.49,142.23,143.85001,142.42999,3258
2012-12-17 14:30:00,142.47,143.85001,142.42999,143.77,132.57058823529408,152.38736842105266,139.0104611000003,141.93862220000003,141.7715642,141.6379055000002,141.62603985447228,141.8985037796128,142.369083846154,143.90565329780497,140.83251439450305,139.0104611000003,141.93862220000003,141.7715642,141.6379055000002,143.35,143735744,126895185.6,60.956989639425586,1.5,2.75,1.4182958306596185,1.132712350908922,0.2655864575681212,0.6223562517948267,0.3567697942267055,9.21696519712503,1.7840707964601843,6460943325.0,2012-12-17,2012,0,352,12,1.0,143.14,145.5,143.78999,3259
2012-12-18 14:30:00,144.0,145.5,143.78999,145.37,132.4641176470588,152.45526315789473,139.0507511000003,142.05272210000004,141.75646419999995,141.94990550000014,141.77286182096356,142.22912246726872,142.619083846154,144.82427725886328,140.4138904334448,139.0507511000003,142.05272210000004,141.75646419999995,141.94990550000014,144.88666333333333,177762752,128208536.0,66.68769355103021,1.5,2.75,1.4405604141839308,1.38651261098559,0.36713168491516096,0.8156844003706567,0.4485527154554957,10.412427875332586,2.7349823321554796,6638706077.0,2012-12-18,2012,1,353,12,1.19,144.64,145.58,144.24001,3260
2012-12-19 14:30:00,145.53,145.58,144.24001,144.28999,132.35764705882352,152.52315789473687,139.08845105000034,142.13392200000004,141.719464,142.20490500000014,141.87157272994537,142.4253955656241,142.78331384615402,145.13868594546508,140.42794174684298,139.08845105000034,142.13392200000004,141.719464,142.20490500000014,144.70333333333338,150895312,129762932.8,60.258246268064276,1.5,2.75,1.433376813170793,1.162853742158947,0.3385195319933895,0.8717021304472325,0.5331825984538431,11.992934671418054,1.6269826736160018,6487810765.0,2012-12-19,2012,2,354,12,0.93,144.91,145.14,143.98,3261
2012-12-20 14:30:00,144.38,145.14,143.98,145.12,132.25117647058823,152.59105263157895,139.14030105000032,142.19837200000006,141.709024,142.48840500000014,141.9989620346534,142.68202455937418,143.06562153846173,145.5879272448517,140.54331583207176,139.14030105000032,142.19837200000006,141.709024,142.48840500000014,144.74666666666667,168486944,134101742.4,63.195046760238455,1.5,2.75,1.413849897944307,1.2564112962636642,0.35094861077822503,0.9718683619266244,0.6209197511483994,12.169758591620292,1.899385731796924,6656297709.0,2012-12-20,2012,3,355,12,0.81,144.56,144.0881,141.94,3262
2012-12-21 14:30:00,142.17,144.0881,141.94,142.78999,132.14470588235292,152.6589473684211,139.17580100000038,142.23947200000003,141.68082379999996,142.56040400000015,142.0299827391768,142.6923069822909,143.18408230769248,145.48950384582608,140.87866076955885,139.17580100000038,142.23947200000003,141.68082379999996,142.56040400000015,142.93936333333332,245883808,143125475.2,51.65518771605653,1.5,2.75,1.5400034766625712,1.7179597668158522,0.18598500875734192,0.8534010120950768,0.6674160033377349,16.047617482420275,0.22248424455972465,6410413901.0,2012-12-21,2012,4,356,12,1.51,143.01,142.56,142.19,3263
2012-12-24 14:30:00,142.48,142.56,142.19,142.35001,132.03823529411764,152.7268421052632,139.2023511000003,142.28587200000004,141.662224,142.62540450000014,142.04253282783654,142.65970726969178,143.24946769230792,145.4033631034696,141.0955722811462,139.2023511000003,142.28587200000004,141.662224,142.62540450000014,142.36667,53874544,140812986.4,49.805679898315326,1.5,2.75,1.4728596569009582,0.3825964165475578,0.038676177371553384,0.7157612250521765,0.6770850476806232,16.160657064742878,-0.7598926380368101,6356539357.0,2012-12-24,2012,0,359,12,0.26,142.38,142.71001,141.35001,3264
2012-12-26 14:30:00,142.64,142.71001,141.35001,141.75,131.93176470588233,152.79473684210532,139.2232510500003,142.32747200000003,141.63002400000005,142.69640450000014,142.0310609522351,142.5730684821021,143.23177538461556,145.43040422970077,141.03314653953038,139.2232510500003,142.32747200000003,141.63002400000005,142.69640450000014,141.93667333333337,106947680,139728060.8,47.31754094500244,1.5,2.75,1.464798252836605,0.7653987279840643,-0.10014570502470632,0.5519029163997402,0.6520486214244465,15.680517082084243,-1.2263884904458484,6249591677.0,2012-12-26,2012,2,361,12,0.96,142.03,142.08,139.92,3265
2012-12-27 14:30:00,141.78999,142.08,139.92,141.5616,131.82529411764705,152.8626315789474,139.24315905000032,142.37668800000003,141.603456,142.70148400000016,142.01265071881411,142.4767381504733,143.16613000000018,145.5048821282159,140.82737787178445,139.24315905000032,142.37668800000003,141.603456,142.70148400000016,141.1872,167920560,139269767.2,46.531491573513975,1.5,2.75,1.5144555204911352,1.2057215530406948,-0.19987461882323446,0.4022053478954035,0.602079966718638,15.64429728232725,-0.7490710229264509,6081671117.0,2012-12-27,2012,3,362,12,1.54,141.0,141.42,139.87,3266
2012-12-28 14:30:00,140.64,141.42,139.87,140.03,131.71882352941174,152.9305263157895,139.2429990500003,142.38349800000003,141.522456,142.5969840000002,141.93489971023317,142.2437154694759,142.97820615384634,145.84298006830508,140.11343223938758,139.2429990500003,142.38349800000003,141.522456,142.5969840000002,140.43999999999997,148806624,139155804.8,40.623330500373186,1.5,2.75,1.5271086975989103,1.0693526167583918,-0.3551371941589229,0.1581584740199844,0.5132956681789073,16.388867996593813,-1.4602572321471867,5932864493.0,2012-12-28,2012,4,363,12,1.11,140.64,142.56,139.53999,3267
2012-12-31 14:30:00,139.66,142.56,139.53999,142.41,139.53999,152.99842105263158,139.2554990500003,142.41139800000005,141.4598562,142.60973400000015,141.9535310941456,142.25955209143058,142.89897538461557,145.76525241898503,140.03269835024608,139.2554990500003,142.41139800000005,141.4598562,142.60973400000015,141.50333,243952192,144524998.4,51.02881385516552,1.5,2.75,1.633744504913275,1.6879584480244492,-0.28662946863042443,0.1550088323908767,0.4416383010213011,19.480619803129443,-0.945955345343266,6176816685.0,2012-12-31,2012,0,366,12,2.16,141.05,146.14999,144.73,3268
2013-01-02 14:30:00,145.11,146.14999,144.73,146.06,139.70688620689654,153.06631578947372,139.28219905000032,142.46879790000003,141.45705619999998,142.84023400000018,142.11456909045359,142.6214995112943,143.09513000000018,146.41495667067738,139.77530332932298,139.28219905000032,142.46879790000003,141.45705619999998,142.84023400000018,145.64666333333338,192058944,147895129.6,62.02112694031084,1.5,2.75,1.7841906117051844,1.2986157456262848,0.00024357773936450888,0.4419427731955068,0.4416991954561423,23.55406188296957,0.4746508908302936,6368875629.0,2013-01-02,2013,2,2,1,0.98,145.44,146.37,145.34,3269
2013-01-03 14:30:00,145.99001,146.37,145.34,145.7341,139.8737824137931,153.13421052631585,139.3093695500003,142.52123880000005,141.45533799999995,143.06443900000016,142.25651147906328,142.9179376530758,143.33390692307708,146.92130747963245,139.74650636652177,139.3093695500003,142.52123880000005,141.45533799999995,143.06443900000016,145.81470000000004,144761744,148752092.0,60.710767715687844,1.5,2.75,1.7303198537262428,0.9731745083625446,0.15521221291172327,0.6357144615957964,0.4805022486840731,22.82090352375839,1.0008386583158149,6224113885.0,2013-01-03,2013,3,3,1,0.71,145.86,146.61,145.67,3270
2013-01-04 14:30:00,145.97,146.61,145.67,146.37,140.04067862068965,153.2021052631579,139.3369695000003,142.57883880000003,141.51494599999995,143.3079390000002,142.41782475439413,143.24670549564,143.66197615384633,147.51042843828202,139.81352386941066,139.3369695000003,142.57883880000003,141.51494599999995,143.3079390000002,146.21666666666667,116817680,147227954.4,62.38089040849771,1.5,2.75,1.6738684356029414,0.7934476878121999,0.2804080756597406,0.8310123432587488,0.5506042675990083,22.36441531156836,0.8613561190738699,6340931565.0,2013-01-04,2013,4,4,1,0.65,146.14,146.4442,145.42999,3271
2013-01-07 14:30:00,145.85001,146.4442,145.42999,145.9695,140.2075748275862,153.27000000000004,139.3646170000003,142.6301338,141.566136,143.50741400000018,142.55710613657473,143.50601925796002,143.83116846153862,147.87231300130043,139.79002392177685,139.3646170000003,142.6301338,141.566136,143.50741400000018,145.94789666666668,110002432,147567048.0,60.63273369467824,1.5,2.75,1.6267499759170163,0.7454403506126923,0.31360023393923864,0.9426045600230566,0.629004326083818,22.29646093870445,2.2267037066113824,6230929133.0,2013-01-07,2013,0,7,1,0.7,145.94,145.91,144.98,3272
2013-01-08 14:30:00,145.71001,145.91,144.98,145.54961,140.37447103448275,153.33789473684212,139.3913150000003,142.6779299,141.6487282,143.6641450000002,142.6744592292581,143.70064694767808,143.84498461538482,147.908246555086,139.78172267568362,139.3913150000003,142.6779299,141.6487282,143.6641450000002,145.47987,121265056,148193984.8,58.77310963212774,1.5,2.75,1.581232120494374,0.8182859524538542,0.2854340820120099,0.9857969285988304,0.7003628465868205,19.809209196191144,2.247699174731357,6109664077.0,2013-01-08,2013,1,8,1,0.64,145.44,146.32001,145.64,3273
2013-01-09 14:30:00,145.87,146.32001,145.64,145.92,140.5413672413793,153.40578947368425,139.4249150000003,142.72923000000003,141.74672819999995,143.83649450000019,142.8017353379146,143.9120139050421,143.9703700000002,148.17882657046218,139.76191342953823,139.4249150000003,142.72923000000003,141.74672819999995,143.83649450000019,145.96000333333333,90745568,147789228.8,59.94028017900123,1.5,2.75,1.5233155404590613,0.6140201741143397,0.2700695075331111,1.0379497310032093,0.7678802234700982,19.55163619177893,2.941798941798933,6200409645.0,2013-01-09,2013,2,9,1,0.47,145.98,147.09,145.97,3274
2013-01-10 14:30:00,146.73,147.09,145.97,147.08,140.70826344827586,153.47368421052636,139.4620650500003,142.79053000000005,141.8597284,144.01849450000014,142.96951042270229,144.21372686646666,144.12113923076942,148.61433883429294,139.6279396272459,139.4620650500003,142.79053000000005,141.8597284,144.01849450000014,146.71333333333334,130735376,146697479.2,63.4319925228025,1.5,2.75,1.4980787161405582,0.8911903375092216,0.31330967266398146,1.159517314300075,0.8462076416360935,19.26920603584365,3.898232288982333,6331145021.0,2013-01-10,2013,3,10,1,0.77,146.53,147.14999,146.61,3275
2013-01-11 14:30:00,147.03999,147.14999,146.61,147.07001,140.8751596551724,153.54157894736844,139.4893651000003,142.84133000000003,141.97412839999996,144.19649550000014,143.13031432769438,144.48575383156506,144.45037153846172,149.12858613471943,139.77215694220402,139.4893651000003,142.84133000000003,141.97412839999996,144.19649550000014,146.94333333333338,113917312,145099344.8,63.38075594108482,1.5,2.75,1.4296438078448033,0.7850987346429423,0.31563530770253423,1.2407517762642613,0.9251164685617271,19.162450897094406,5.027501249732198,6217227709.0,2013-01-11,2013,4,11,1,0.37,146.88,147.07001,146.42999,3276
2013-01-14 14:30:00,146.89,147.07001,146.42999,146.97,141.04205586206896,153.60947368421054,139.5183651000003,142.8892301,142.08652819999998,144.41349550000015,143.28089023641218,144.72234870474938,144.80575538461557,149.4936657786959,140.11784499053522,139.5183651000003,142.8892301,142.08652819999998,144.41349550000015,146.82333333333338,89567120,142791953.6,62.83358096453435,1.5,2.75,1.3732421072844596,0.6272560725018332,0.2857303314841817,1.282279382916954,0.9965490514327724,17.086860658493556,3.202022329892565,6127660589.0,2013-01-14,2013,0,14,1,0.44,146.75,147.21001,146.2,3277
2013-01-15 14:30:00,146.28999,147.21001,146.2,147.07001,141.20895206896554,153.67736842105262,139.5513651500003,142.9380302,142.1713284,144.66174100000018,143.42948316831757,144.94593549477318,145.21498692307708,149.68835184723955,140.7416219989146,139.5513651500003,142.9380302,142.1713284,144.66174100000018,146.82667333333333,93172560,140565497.6,63.17594263370236,1.5,2.75,1.3472969567641429,0.6628408933260164,0.24930507270375424,1.3081803923124653,1.058875319608711,15.362850189347752,0.6915034917157292,6220833149.0,2013-01-15,2013,1,15,1,0.69,146.71,147.28,146.61,3278
2013-01-16 14:30:00,146.77,147.28,146.61,147.05,141.3758482758621,153.74526315789475,139.58546515000032,142.99093029999997,142.2811284,144.82574100000016,143.57146422054043,145.1463225905091,145.63717153846167,149.66548092273328,141.60886215419012,139.58546515000032,142.99093029999997,142.2811284,144.82574100000016,146.98,104849504,138621185.6,63.05079767880622,1.5,2.75,1.2989186027095605,0.7563743128164386,0.2024748866861319,1.311968927966376,1.109494041280244,6.1993768379587175,0.9029458445209454,6115983645.0,2013-01-16,2013,2,16,1,0.46,146.94,148.42,147.14461,3279
2013-01-17 14:30:00,147.7,148.42,147.14461,148.0,141.54274448275862,153.8131578947369,139.6214151500003,143.05273019999996,142.4041564,144.95724100000018,143.74513229032317,145.418101391413,146.25024846153863,148.85172799383076,143.64876892924653,139.6214151500003,143.05273019999996,142.4041564,144.95724100000018,147.85487,133833440,136424720.0,66.44885116904824,1.5,2.75,1.3039958453731617,0.9810057883937751,0.21302030044393994,1.3757694168351688,1.1627491163912291,6.687613125852826,1.1136161781785854,6249817085.0,2013-01-17,2013,3,17,1,0.87,147.78,148.49001,147.42999,3280
2013-01-18 14:30:00,147.97,148.49001,147.42999,148.33,141.70964068965515,153.88105263157897,139.6538651500003,143.12938029999995,142.5115562,145.15924150000018,143.924931024036,145.69542506842132,146.70563307692322,148.35832249373462,145.05294366011182,139.6538651500003,143.12938029999995,142.5115562,145.15924150000018,148.08333333333334,169905936,137375251.2,67.5647315912355,1.5,2.75,1.2865689992750793,1.2368016401487023,0.2189223526550532,1.4364020572100458,1.2174797045549923,6.4688298434413385,1.6171186446483694,6419723021.0,2013-01-18,2013,4,18,1,0.72,147.96,149.13,147.98,3281
2013-01-22 14:30:00,148.33,149.13,147.98,149.13,141.87653689655173,153.9489473684211,139.6932152000003,143.20558039999997,142.6997562,145.35974150000018,144.1290513760346,146.02252744285738,146.94178692307707,148.98837606318028,144.89519778297387,139.6932152000003,143.20558039999997,142.6997562,145.35974150000018,148.74666666666667,111797312,134540769.6,70.15608577586588,1.5,2.75,1.2768140707554312,0.8309549018664154,0.25109997414512897,1.5313546722364038,1.2802546980912748,6.2750510320710715,2.45991040443186,6531520333.0,2013-01-22,2013,1,22,1,0.78,148.56,149.5,148.86,3282
2013-01-23 14:30:00,149.13,149.5,148.86,149.37,142.04343310344825,154.0168421052632,139.7407652000003,143.28388049999998,142.92635639999997,145.6887420000002,144.33457877305284,146.34133435306143,147.22147153846166,149.5108126497245,144.9321304271988,139.7407652000003,143.28388049999998,142.92635639999997,145.6887420000002,149.24333333333334,104596064,127476382.4,70.90702257647992,1.5,2.75,1.2313273514157566,0.8205132749358598,0.2617496099561165,1.6074417105364205,1.345692100580304,5.4347588438656365,2.3643092105263275,6636116397.0,2013-01-23,2013,2,23,1,0.43,149.18,150.14,149.00999,3283
2013-01-24 14:30:00,149.14999,150.14,149.00999,149.41,142.2103293103448,154.08473684210531,139.7888652500003,143.3639806,143.1513564,146.04174150000014,144.53361489959983,146.63358822419843,147.45531769230783,149.9599152856831,144.95072009893246,139.7888652500003,143.3639806,143.1513564,146.04174150000014,149.51999666666666,146426320,132103971.2,71.03782392678272,1.5,2.75,1.2240903977432025,1.1084172464302118,0.2449875368318009,1.6519265216200552,1.4069389847882543,5.596158295156528,1.5841718792493769,6782542717.0,2013-01-24,2013,3,24,1,0.76,149.57,150.25,149.3726,3284
2013-01-25 14:30:00,149.88,150.25,149.3726,150.25,142.37722551724138,154.15263157894742,139.8490152500003,143.4513807,143.39105639999997,146.46674150000018,144.7577868643214,146.9780083933224,147.78458692307706,150.53471629817525,145.0344575479789,139.8490152500003,143.4513807,143.39105639999997,146.46674150000018,149.95753333333334,147211568,134117165.6,73.71085773758736,1.5,2.75,1.1993267979044018,1.0976340525943833,0.26241878607289704,1.7349624673793755,1.4725436813064785,4.868138233350208,2.1622287235854567,6929754285.0,2013-01-25,2013,4,25,1,0.59,149.81,150.33,149.50999,3285
2013-01-28 14:30:00,150.28999,150.33,149.50999,150.07001,142.5441217241379,154.2205263157895,139.9198653500003,143.54718069999996,143.63665679999997,146.89216200000016,144.9661093402303,147.2724847368155,148.13231000000013,150.80620816452014,145.4584118354801,139.9198653500003,143.54718069999996,143.63665679999997,146.89216200000016,149.97,113357632,131389019.2,72.17374307205445,1.5,2.75,1.172232740911232,0.8627633624956689,0.23467648803619826,1.7658892913517263,1.531212803315528,5.092640558458749,2.1092808056065846,6816396653.0,2013-01-28,2013,0,28,1,0.55,149.92,150.85001,149.67,3286
2013-01-29 14:30:00,149.77,150.85001,149.67,150.66,142.71101793103446,154.28842105263158,139.98816535000032,143.64218069999995,143.93125879999997,147.42366200000015,145.18939917002518,147.59510523807114,148.4969253846155,151.15736209302102,145.83648867620997,139.98816535000032,143.64218069999995,143.93125879999997,147.42366200000015,150.3933366666666,105694368,129233406.4,74.08167423885277,1.5,2.75,1.1727882594175731,0.8178563959914315,0.2286780324277955,1.8170603438502724,1.5883823114224769,4.881094713506959,2.4410075174401635,6922091021.0,2013-01-29,2013,1,29,1,0.79,150.26,150.94,149.92999,3287
2013-01-30 14:30:00,150.64,150.94,149.92999,150.07001,142.87791413793101,154.35631578947368,140.04456545000028,143.73258079999997,144.218659,147.80666250000016,145.38079567316151,147.83081045349297,148.72692615384628,151.37456454245674,146.07928776523582,140.04456545000028,143.73258079999997,144.218659,147.80666250000016,150.3133333333334,137447632,123908178.4,68.987617894775,1.5,2.75,1.161161240887746,1.109270056059512,0.160797874515914,1.7893796545673697,1.6285817800514557,6.069265564444198,2.0537300238014176,6784643389.0,2013-01-30,2013,2,30,1,0.67,150.43,150.38,149.60001,3288
2013-01-31 14:30:00,149.89,150.38,149.60001,149.7,143.04481034482757,154.4242105263158,140.10736545000032,143.82048079999996,144.485259,147.98866250000015,145.55017623499833,148.00882850554126,148.92923307692317,151.43779691700618,146.42066923684018,140.10736545000032,143.82048079999996,144.485259,147.98866250000015,149.89333666666667,108975808,119754021.6,65.92591788914731,1.5,2.75,1.133934723681478,0.9099970635140656,0.07136197329689907,1.7177842466725792,1.64642227337568,6.5033393825621895,1.148648648648641,6675667581.0,2013-01-31,2013,3,31,1,0.52,149.99,151.42,150.39,3289
2013-02-01 14:30:00,150.64999,151.42,150.39,151.24001,143.21170655172412,154.4921052631579,140.1783155000003,143.8951809,144.7274592,148.26395800000014,145.77330697088072,148.3165600764421,149.2576953846155,151.77229638702445,146.74309438220652,140.1783155000003,143.8951809,144.7274592,148.26395800000014,151.01666999999995,131173008,119074584.8,71.57943765954518,1.5,2.75,1.175796529132801,1.1016037403810457,0.09483409337768522,1.7649648900977866,1.6701307967201011,7.740626181024723,1.9618485808669852,6806840589.0,2013-02-01,2013,4,32,2,0.68,150.9,151.2679,149.42999,3290
2013-02-04 14:30:00,150.32001,151.2679,149.42999,149.535,143.37860275862067,154.56000000000003,140.23058050000031,143.94723089999997,144.9343592,148.42220800000013,145.92082434457168,148.43260197392382,149.44731000000013,151.62227182326333,147.27234817673695,140.23058050000031,143.94723089999997,144.9343592,148.42220800000013,150.07763,159073568,121187379.2,59.75780501815501,1.5,2.75,1.2230903484804576,1.3126248710888864,-0.019461415026523543,1.6458040279369468,1.6652654429634706,10.943124901827742,0.27157513578756864,6647767021.0,2013-02-04,2013,0,35,2,1.23,150.35,151.48,150.28999,3291
2013-02-05 14:30:00,150.35001,151.48,150.28999,151.05,143.54549896551725,154.6278947368421,140.2927805000003,144.02263099999996,145.16635920000004,148.67623300000014,146.1219684879218,148.68187797640724,149.75500230769242,151.59178396636548,147.91822064901942,140.2927805000003,144.02263099999996,145.16635920000004,148.67623300000014,150.93999666666667,113912320,121382873.6,65.24965519971954,1.5,2.75,1.2746553235889957,0.9384546322027428,-0.00857757237673451,1.6545434774925525,1.663121049869287,11.945601882608113,1.1247238401285444,6761679341.0,2013-02-05,2013,1,36,2,0.79,150.88,151.25999,150.41,3292
2013-02-06 14:30:00,150.52,151.25999,150.41,151.16,143.71239517241378,154.69578947368424,140.35998050000032,144.09513099999995,145.362559,148.95675250000014,146.31953835114055,148.91788959770182,149.99807923076938,151.67053524502163,148.32562321651707,140.35998050000032,144.09513099999995,145.362559,148.95675250000014,150.94332999999997,138762752,122257758.4,65.61655806652274,1.5,2.75,1.2443220861897812,1.135001604937,-0.009448554271032528,1.6513103570304963,1.6607589113015289,11.947409897837824,1.1712736764607456,6900442093.0,2013-02-06,2013,2,37,2,0.57,150.83,151.35001,149.86,3293
2013-02-07 14:30:00,151.205,151.35001,149.86,150.96001,143.87929137931033,154.76368421052638,140.42503055000032,144.16083109999997,145.5607592,149.20875300000014,146.50151763148799,149.11237725506354,150.20038769230788,151.63633860709683,148.76443677751888,140.42503055000032,144.16083109999997,145.5607592,149.20875300000014,150.72333999999998,162490000,125844980.0,64.28757541285829,1.5,2.75,1.26187122289051,1.2911917503582582,-0.03740287659103458,1.6140053155627356,1.6514081921537702,12.026879958750404,0.4725524126455981,6737952093.0,2013-02-07,2013,3,38,2,0.99,150.61,151.89,151.22,3294
2013-02-08 14:30:00,151.22,151.89,151.22,151.8,144.04618758620688,154.83157894736846,140.50008060000027,144.21293109999996,145.7901592,149.44475300000013,146.70930125378257,149.3683413260099,150.40577230769247,151.93155146768797,148.87999314769698,140.50008060000027,144.21293109999996,145.7901592,149.44475300000013,151.63666666666668,103133680,124464895.2,67.28471578166203,1.5,2.75,1.2381654212554718,0.8286166138193157,-0.014412757491359729,1.6333922452895706,1.6478050027809303,12.018944122458912,1.1527886217905996,6841085773.0,2013-02-08,2013,4,39,2,0.44,151.56,151.89999,151.3938,3295
2013-02-11 14:30:00,151.74001,151.89999,151.3938,151.77,144.21308379310344,154.89947368421056,140.57238060000026,144.25823099999997,145.996359,149.67975250000012,146.90776002814403,149.59707072353277,150.59038769230787,152.15058715161024,149.0301882330055,140.57238060000026,144.25823099999997,145.996359,149.67975250000012,151.68793000000005,73774944,122457776.8,67.06822650389789,1.5,2.75,1.185881462594367,0.6024520935121207,-0.016184709255278484,1.6275741162118322,1.6437588254671107,11.964878015147574,0.7367582636399932,6767310829.0,2013-02-11,2013,0,42,2,0.33,151.65,152.3,151.61,3296
2013-02-12 14:30:00,151.78,152.3,151.61,152.02,144.37998000000002,154.9673684210527,140.6365306000003,144.31103090000002,146.19435900000005,149.93225250000015,147.10824002704038,149.82782589272009,150.7911569230771,152.3637775874461,149.2185362587081,140.6365306000003,144.31103090000002,146.19435900000005,149.93225250000015,151.9766666666667,65392608,121249051.2,67.99244758839593,1.5,2.75,1.1504613581233407,0.5393246986496831,-0.015478324580801228,1.6244109197411092,1.6398892443219104,11.841086757245607,1.2993868661700054,6832703437.0,2013-02-12,2013,1,43,2,0.46,151.96,152.61,151.72,3297
2013-02-13 14:30:00,152.33,152.61,151.72,152.151,144.54687620689654,155.03526315789478,140.6964856000003,144.36634089999995,146.394279,150.18630200000013,147.3059953200976,150.0490805696039,150.93738769230788,152.63045308580445,149.2443222988113,140.6964856000003,144.36634089999995,146.394279,150.18630200000013,152.16033333333334,82322560,120706551.2,68.49145282302908,1.5,2.75,1.1318569754002459,0.6820057335877227,-0.02081462025361414,1.613870969004893,1.6346855892585068,11.440626719298756,1.637274549098211,6915025997.0,2013-02-13,2013,2,44,2,0.59,152.17,152.47,151.52,3298
2013-02-14 14:30:00,151.69,152.47,151.52,152.28999,144.7137724137931,155.10315789473688,140.7559855500003,144.42224079999997,146.61107880000003,150.44830150000013,147.50144609185847,150.26250051535592,151.1081553846156,152.86350912645585,149.35280164277538,140.7559855500003,144.42224079999997,146.61107880000003,150.44830150000013,152.09333,80834192,119505785.6,69.04290739925139,1.5,2.75,1.1188671914430848,0.6764040049957214,-0.0291012696011399,1.5983090022570818,1.627410271858222,11.187080695927945,0.6942475076535478,6995860189.0,2013-02-14,2013,3,45,2,0.63,152.0,152.59,151.55,3299
2013-02-15 14:30:00,152.42999,152.59,151.55,152.11,144.88066862068962,155.171052631579,140.81718555000032,144.47624069999995,146.82827880000005,150.65380150000013,147.6821736960993,150.43845284722676,151.21969384615406,153.0303661039757,149.4090215883324,140.81718555000032,144.47624069999995,146.82827880000005,150.65380150000013,152.08333333333334,215226432,123575435.2,67.39786531396615,1.5,2.75,1.1132338206257208,1.741660319882086,-0.05909297434684335,1.553544053924668,1.6126370282715112,9.847135401645756,1.7220048818002591,6780633757.0,2013-02-15,2013,4,46,2,0.69,152.07,153.28,152.1629,3300
2013-02-19 14:30:00,152.37,153.28,152.1629,153.25,145.0475648275862,155.2389473684211,140.8797355000003,144.55004069999995,147.06327880000003,150.89980150000014,147.90051982566402,150.70621924272896,151.4643084615387,153.43936317809533,149.48925374498202,140.8797355000003,144.55004069999995,147.06327880000003,150.89980150000014,152.89763333333337,95105376,119835407.2,71.95556580308019,1.5,2.75,1.1172885477238832,0.7936333527975862,-0.01674340969312071,1.5917077661551104,1.6084511758482312,7.043987997350406,1.4564713670969802,6875739133.0,2013-02-19,2013,1,50,2,0.73,152.72,153.19,151.25999,3301
2013-02-20 14:30:00,153.14,153.19,151.25999,151.34,145.21446103448275,155.3068421052632,140.93481050000028,144.60699069999995,147.25047880000002,151.01030150000014,148.03540140112818,150.76657931485002,151.59046230769258,153.28874285187783,149.8921817635073,140.93481050000028,144.60699069999995,147.25047880000002,151.01030150000014,151.92999666666663,160574816,122274282.4,57.46150868469882,1.5,2.75,1.179625794315035,1.3132345808802717,-0.12587748604793236,1.4511043182883157,1.576981804336248,9.580526914602054,0.1190791214607084,6715164317.0,2013-02-20,2013,2,51,2,1.28,152.22,151.4218,149.94,3302
2013-02-21 14:30:00,150.96001,151.4218,149.94,150.42,145.3813572413793,155.3747368421053,140.99066050000027,144.67019059999996,147.41057900000004,151.06280150000015,148.1289150716722,150.73357176105478,151.52738461538485,153.33071064309505,149.72405858767462,140.99066050000027,144.67019059999996,147.41057900000004,151.06280150000015,150.59393333333333,183256944,126207326.4,52.02549047706842,1.5,2.75,1.2012096661496747,1.4520309496073756,-0.2607711978104865,1.25101780707314,1.5117890048836264,10.218570097601527,-0.3577172524034833,6531907373.0,2013-02-21,2013,3,52,2,0.99,150.68,151.89,150.4913,3303
2013-02-22 14:30:00,151.14999,151.89,150.4913,151.89,145.54825344827586,155.4426315789474,141.06511050000032,144.75614059999995,147.59891880000004,151.18680150000014,148.27640859827332,150.84370778381142,151.7085384615387,153.10129186410552,150.3157850589718,141.06511050000032,144.75614059999995,147.59891880000004,151.18680150000014,151.42376666666667,106356496,124203835.2,58.741768656428526,1.5,2.75,1.2204089757104124,0.8563060539051696,-0.25162063189503825,1.1972632150148286,1.4488838469098668,11.738960445628365,0.059288537549390626,6638263869.0,2013-02-22,2013,4,53,2,0.93,151.19,152.86,149.0,3304
2013-02-25 14:30:00,152.63,152.86,149.0,149.0,145.7151496551724,155.51052631578952,141.12461045000032,144.79974059999995,147.71011880000006,151.12430150000014,148.30478473167437,150.6681165663056,151.55084615384638,153.54186175032802,149.5598305573647,141.12461045000032,144.79974059999995,147.71011880000006,151.12430150000014,150.28666666666666,245824752,129134494.4,45.3113315212885,1.5,2.75,1.4089511917310982,1.9036335190080709,-0.430337111045584,0.9109624581028868,1.3412995691484708,15.810998489671075,-1.825130131119464,6392439117.0,2013-02-25,2013,0,56,2,2.59,150.93,150.2,148.73,3305
2013-02-26 14:30:00,149.72,150.2,148.73,150.02,148.73,155.5784210526316,141.1919604500003,144.86024059999997,147.8403190000001,151.12180100000015,148.37204807553024,150.6063911790384,151.46315384615409,153.60965189522753,149.31665579708064,141.1919604500003,144.86024059999997,147.8403190000001,151.12180100000015,149.64999999999995,186596192,132796422.4,49.683904576738094,1.5,2.75,1.4133118208931623,1.4051296610833997,-0.4669285104505854,0.7576389310852392,1.2245674415358243,16.574195074923903,-1.3156163662675964,6579035309.0,2013-02-26,2013,1,57,2,0.99,149.46,152.33,149.75999,3306
2013-02-27 14:30:00,149.89,152.33,149.75999,151.91,148.97184236842105,155.64631578947368,141.27281040000028,144.93589059999996,148.0259190000001,151.18430100000015,148.51079128825455,150.73054440008238,151.53623000000024,153.6739009995484,149.3985590004521,141.27281040000028,144.93589059999996,148.0259190000001,151.18430100000015,151.33333000000005,150781872,135050797.6,56.60707422563271,1.5,2.75,1.4959331194007954,1.116482647119146,-0.3559348896235741,0.7796488295063568,1.135583719129931,18.32528072343392,-0.15839527837478154,6729817181.0,2013-02-27,2013,2,58,2,1.72,151.04,152.87,151.41,3307
2013-02-28 14:30:00,151.89999,152.87,151.41,151.61,149.2136847368421,155.7142105263158,141.3507604000003,145.00699059999997,148.2160170000001,151.26130050000015,148.6323288847936,150.81430207626502,151.5216146153849,153.65446476407467,149.38876446669502,141.3507604000003,145.00699059999997,148.2160170000001,151.26130050000015,151.96333333333334,126865936,134521712.8,55.30625652041605,1.5,2.75,1.4933664680150247,0.9430889137474616,-0.2972057424731742,0.7640765410384631,1.0612822835116371,18.344684633656797,-0.44650997744498855,6602951245.0,2013-02-28,2013,3,59,2,0.96,152.14,152.34,150.41,3308
2013-03-01 14:30:00,151.09,152.34,150.41,152.11,149.45552710526312,155.7821052631579,141.43326040000028,145.07719059999997,148.38281700000005,151.38180050000014,148.76870814421346,150.9377018785255,151.5477684615387,153.7004070187333,149.3951299043441,141.43326040000028,145.07719059999997,148.38281700000005,151.38180050000014,151.62,170634752,137604660.0,57.0766616351553,1.5,2.75,1.5245545774425235,1.2400361441247705,-0.22258211077129866,0.783054645047514,1.0056367558188126,18.455135749049546,0.0,6773585997.0,2013-03-01,2013,4,60,3,1.28,151.38,152.92,151.52,3309
2013-03-04 14:30:00,151.75999,152.92,151.52,152.92,149.6973694736842,155.85000000000005,141.52731040000032,145.1451406,148.53381700000006,151.46580000000014,148.93150390326392,151.12649217580878,151.61699923076947,153.88094612741585,149.35305233412305,141.52731040000032,145.1451406,148.53381700000006,151.46580000000014,152.45333333333338,99010192,135996519.2,59.85124455704097,1.5,2.75,1.5156578219109131,0.7280347510541285,-0.12161723272574798,0.8536152149116276,0.9752324476373756,18.69220185920734,-0.2153344208809217,6872596189.0,2013-03-04,2013,0,63,3,0.92,152.22,154.7,153.64,3310
2013-03-05 14:30:00,153.66,154.7,153.64,154.28999,149.93921184210527,155.91789473684213,141.63206035000027,145.22664049999997,148.73381700000004,151.70354950000018,149.14164061293982,151.42777768287462,151.7815369230771,154.4513400787476,149.1117337674067,141.63206035000027,145.22664049999997,148.73381700000004,151.70354950000018,154.20999666666663,121663056,134125993.6,64.08039235292085,1.5,2.75,1.5345394060601336,0.9070803707358333,0.026579526304845055,1.008456855518432,0.9818773292135868,18.906201194193308,1.9492467292189677,6994259245.0,2013-03-05,2013,1,64,3,0.69,154.17,154.92,154.16,3311
2013-03-06 14:30:00,154.84,154.92,154.16,154.5,150.18105421052633,155.98578947368426,141.74041540000027,145.31522049999995,148.92141700000005,151.8760495000002,149.35177235360888,151.7203702845056,151.95153769230794,154.98576918602703,148.91730619858885,141.74041540000027,145.31522049999995,148.92141700000005,151.8760495000002,154.52666666666667,94469872,133153871.2,64.69434143377262,1.5,2.75,1.479215162770123,0.7094789745774962,0.12252380051919687,1.135032079862583,1.0125082793433862,16.934890130481513,2.712405265257288,7088729117.0,2013-03-06,2013,2,65,3,0.49,154.54,154.98,154.52,3312
2013-03-07 14:30:00,154.7,154.98,154.52,154.776,150.42289657894736,156.05368421052634,141.85999540000032,145.42098049999996,149.16113720000004,152.05684950000014,149.56448716327128,152.01138263836222,152.15661461538485,155.54560422697824,148.76762500379147,141.85999540000032,145.42098049999996,149.16113720000004,152.05684950000014,154.75866666666667,86101312,130520799.2,65.52824898046634,1.5,2.75,1.4078426511436852,0.6596750290202023,0.1846197432647898,1.2432829584243734,1.0586632151595836,16.131444812648994,1.900059253407087,7174830429.0,2013-03-07,2013,3,66,3,0.3,154.75,155.64999,154.66,3313
2013-03-08 14:30:00,155.46001,155.64999,154.66,155.44,150.66473894736842,156.12157894736842,141.98849535000028,145.54258049999996,149.42293700000005,152.28084900000016,149.7948994313783,152.33791762518487,152.3250761538464,156.10938633891683,148.540765968776,141.98849535000028,145.54258049999996,149.42293700000005,152.28084900000016,155.24999666666662,123487632,128570680.8,67.51610690069883,1.5,2.75,1.3779960332048509,0.9604649460641264,0.24658550349113284,1.3668950945234997,1.1203095910323668,15.57738511398145,4.32214765100671,7298318061.0,2013-03-08,2013,4,67,3,0.64,155.15,156.03999,155.13,3314
2013-03-11 13:30:00,155.325,156.03999,155.13,156.03,150.90658131578942,156.18947368421055,142.10879535000024,145.66928049999996,149.70853700000004,152.49234900000016,150.03941317916735,152.6895445180244,152.68584538461562,156.8959920880458,148.4756986811855,142.10879535000024,145.66928049999996,149.70853700000004,152.49234900000016,155.73333,83746688,127601331.2,69.2148654963303,1.5,2.75,1.3445670308330755,0.6563151591948282,0.2999367949277485,1.4952305846920524,1.1952937897643041,7.423034070989763,4.006132515664572,7382064749.0,2013-03-11,2013,0,70,3,0.59,155.58,156.10001,155.21001,3315
2013-03-12 13:30:00,155.92,156.10001,155.21001,155.67999,151.14842368421048,156.25736842105266,142.22619530000026,145.79718039999997,149.99090480000004,152.68784850000014,150.2606122701804,152.97434884964113,153.09046000000023,157.36236886712703,148.81855113287344,142.22619530000026,145.79718039999997,149.99090480000004,152.68784850000014,155.66333666666662,105755680,129200368.0,66.97715741341925,1.5,2.75,1.3120979572021407,0.8185400834152423,0.2844190825691748,1.5508176429757723,1.2663985604065977,8.214035590453083,2.481726021986707,7276309069.0,2013-03-12,2013,1,71,3,0.57,155.66,156.12,155.23,3316
2013-03-13 13:30:00,155.75999,156.12,155.23,155.905,151.39026605263157,156.32526315789474,142.34437030000024,145.9154304,150.30840480000003,152.88209850000018,150.48196080860473,153.25345848300864,153.3993061538464,157.8559496421787,148.94266266551418,142.34437030000024,145.9154304,150.30840480000003,152.88209850000018,155.7516666666667,92550880,130558281.6,67.70011216422316,1.5,2.75,1.2819481031162745,0.7088855556750833,0.2625972613969243,1.5946451371527532,1.3320478757558287,6.040366658970942,2.8329265879559316,7368859949.0,2013-03-13,2013,2,72,3,0.57,155.68,156.8,155.90781,3317
2013-03-14 13:30:00,156.31,156.8,155.90781,156.73,151.63210842105264,156.39315789473687,142.46537030000025,146.02733049999995,150.59480480000005,153.11104850000018,150.7269819533653,153.5845576751031,153.99392153846182,157.98212264751328,150.0057204294104,142.46537030000025,146.02733049999995,150.59480480000005,153.11104850000018,156.47926999999999,126329872,132758647.2,70.27007742083221,1.5,2.75,1.2543089528936842,0.9515754692022804,0.2756595307131344,1.6766222891472466,1.4009627584341122,5.436767998375835,3.0372756557754097,7495189821.0,2013-03-14,2013,3,73,3,0.57,156.35,156.03999,155.31,3318
2013-03-15 13:30:00,155.85001,156.03999,155.31,155.83,151.8739507894737,156.46105263157895,142.58402025000024,146.1236305,150.79020480000003,153.28804900000014,150.92710030813532,153.79840932509325,154.4408446153849,157.8001572706481,151.08153196012168,142.58402025000024,146.1236305,150.79020480000003,153.28804900000014,155.72666333333333,138601056,135646990.4,64.26303480049405,1.5,2.75,1.2661440276869915,1.0217775978021255,0.1991879724722534,1.6499477240244291,1.4507597515521755,7.527429188661612,1.902955793879169,7356588765.0,2013-03-15,2013,4,74,3,0.47,155.67,155.64,154.2,3319
2013-03-18 13:30:00,154.34,155.64,154.2,154.97,152.11579315789473,156.5289473684211,142.69037025000026,146.2151304,150.97492280000003,153.43104900000014,151.08564539409076,153.9099893893701,154.67622923076945,157.70586459634487,151.6465938651941,142.69037025000026,146.2151304,150.97492280000003,153.43104900000014,154.9366666666666,126704256,131220881.6,59.06695855189745,1.5,2.75,1.2921337399950654,0.9655799782402924,0.07270582799519132,1.5416420365461647,1.4689362085509734,8.507713155601056,0.4407350081492714,7229884509.0,2013-03-18,2013,0,77,3,0.93,154.92,155.50999,153.59,3320
2013-03-19 13:30:00,155.3,155.50999,153.59,154.61,152.3576355263158,156.5968421052632,142.8046203000003,146.32733439999996,151.13972280000004,153.49904900000018,151.22385537863622,153.97665706657293,154.9069984615387,157.37158211370374,152.44241480937362,142.8046203000003,146.32733439999996,151.13972280000004,153.49904900000018,154.56999666666667,167567248,134843975.2,56.98965923941846,1.5,2.75,1.3369806157097024,1.2426750824533688,-0.046748459433378464,1.4105006342592503,1.4572490936926288,7.1858458027217305,0.07119741100324507,7062317261.0,2013-03-19,2013,1,78,3,1.25,154.55,155.95,155.25999,3321
2013-03-20 13:30:00,155.52,155.95,155.25999,155.69,152.5994778947368,156.6647368421053,142.92572030000028,146.4501344,151.33413280000005,153.71654900000016,151.39899830496418,154.13983258404218,155.18238307692332,157.06714586325762,153.29762029058892,142.92572030000028,146.4501344,151.33413280000005,153.71654900000016,155.63332999999997,113759248,132503196.8,61.377953019689635,1.5,2.75,1.3371962860161504,0.8585396484562401,-0.06353184598757844,1.3778342862081558,1.4413661321957345,8.164275496909184,0.5905308316534781,7176076509.0,2013-03-20,2013,2,79,3,0.44,155.6,155.6389,154.10001,3322
2013-03-21 13:30:00,154.75999,155.6389,154.10001,154.35898999999998,152.84132026315788,156.7326315789474,143.05671525000028,146.5795243,151.5103204,153.91349850000014,151.51507641065191,154.16070471889532,155.29307461538485,156.7549374867767,153.831211743993,143.05671525000028,146.5795243,151.5103204,153.91349850000014,154.69930000000005,128604944,129770596.8,54.05775153433486,1.5,2.75,1.3552529798721396,0.9910175892787448,-0.1688035117960982,1.2303617424506117,1.3991652542467097,9.709916159404187,-0.6954516212043181,7047471565.0,2013-03-21,2013,3,80,3,1.0,154.87,155.60001,154.73,3323
2013-03-22 13:30:00,154.85001,155.60001,154.73,155.60001,153.08316263157894,156.8005263157895,143.1942152500003,146.72532439999995,151.7039206,154.0989990000002,151.67526988474398,154.29778141233385,155.39384538461564,156.7413683302899,154.0463224389413,143.1942152500003,146.72532439999995,151.7039206,154.0989990000002,155.31000666666668,111163504,130010947.2,58.9711513992082,1.5,2.75,1.3470934813098432,0.8550318753465708,-0.15949371884570285,1.199798105689581,1.359291824535284,10.546344585756446,-0.2755816189194409,7158635069.0,2013-03-22,2013,4,81,3,0.56,155.17,156.27,154.35001,3324
2013-03-25 13:30:00,156.00999,156.27,154.35001,154.95,153.32500499999998,156.86842105263162,143.32361520000032,146.86052450000003,151.8613206,154.3964990000002,151.80369067357756,154.35989746830205,155.428460769231,156.70353193108699,154.153389607375,143.32361520000032,146.86052450000003,151.8613206,154.3964990000002,155.19000333333332,151322256,125285822.4,55.61612070926585,1.5,2.75,1.3880146612162838,1.2078162804157802,-0.19917212044874225,1.1103266739743558,1.3094987944230982,10.519539678450338,-0.468904192504133,7007312813.0,2013-03-25,2013,0,84,3,1.24,155.31,156.23,155.42,3325
2013-03-26 13:30:00,155.59,156.23,155.42,156.19,153.56684736842104,156.93631578947372,143.44471520000027,147.00892439999996,152.04372039999996,154.70499900000019,151.9757028040255,154.53419294751137,155.53723000000025,156.81235391827698,154.2621060817235,143.44471520000027,147.00892439999996,152.04372039999996,154.70499900000019,155.94666666666666,86856560,120298840.8,60.260863279844166,1.5,2.75,1.3802993282722635,0.7220066246889388,-0.1464053896184443,1.1264920574000428,1.272897447018487,11.549014569991932,0.18280363041595624,7094169373.0,2013-03-26,2013,1,85,3,0.52,155.82,156.245,155.0,3326
2013-03-27 13:30:00,155.25999,156.245,155.0,156.19,153.8086897368421,157.00421052631583,143.56541520000027,147.1573243,152.22812039999997,154.91899900000018,152.1409693607304,154.69188885727218,155.5949223076925,156.9143270734766,154.27551754190847,143.56541520000027,147.1573243,152.22812039999997,154.91899900000018,155.81166666666667,99950560,117757275.2,60.260863279844166,1.5,2.75,1.370635090538531,0.8487845853281089,-0.11726217559798367,1.1263197275210075,1.2435819031189912,11.527664651724914,-0.34454156830217064,7094169373.0,2013-03-27,2013,2,86,3,0.8,155.62,156.85001,155.75,3327
2013-03-28 13:30:00,156.09,156.85001,155.75,156.67,154.05053210526316,157.07210526315794,143.6832651500003,147.2957243,152.42012019999996,155.1719990000002,152.3185784054076,154.88028039467488,155.64415307692332,157.06841383478016,154.21989231906647,143.6832651500003,147.2957243,152.42012019999996,155.1719990000002,156.42333666666661,102932816,116560619.2,62.044082762557906,1.5,2.75,1.3513047269286356,0.883083984166069,-0.07355371683580447,1.1516397570742356,1.22519347391004,11.23713615210026,0.5390489636141789,7197102189.0,2013-03-28,2013,3,87,3,0.71,156.3,156.91,155.67,3328
2013-04-01 13:30:00,156.59,156.91,155.67,156.05,154.2923744736842,157.14000000000004,143.80644020000025,147.4406243,152.60012019999996,155.3689990000002,152.46490866401908,154.99168226184867,155.6726153846156,157.11329704988663,154.23193371934454,143.80644020000025,147.4406243,152.60012019999996,155.3689990000002,156.21,99194064,112988584.8,58.398845753262826,1.5,2.75,1.3433543892908766,0.8779122614517427,-0.09303910087868483,1.108894597811684,1.2019336986903688,10.947125458805136,0.6969090791766229,7097908125.0,2013-04-01,2013,0,91,4,0.8,156.29,157.21001,156.37,3329
2013-04-02 13:30:00,156.61,157.21001,156.37,156.82001,154.53421684210525,157.20789473684215,143.92594025000025,147.5903384,152.77652039999995,155.5639995000002,152.6356969517046,155.16580871310117,155.74300076923097,157.3063984852744,154.17960305318755,143.92594025000025,147.5903384,152.77652039999995,155.5639995000002,156.8000066666667,101504320,113113291.2,61.42971764295261,1.5,2.75,1.3302583614843857,0.8973686374355978,-0.062192459480025386,1.1241931243403371,1.1863855838203623,10.603615518664064,1.4294094819222447,7199412445.0,2013-04-02,2013,1,92,4,0.54,156.79,157.03,154.82001,3330
2013-04-03 13:30:00,156.91,157.03,154.82001,155.23,154.7760592105263,157.27578947368426,144.04174020000025,147.71303830000002,152.91452039999996,155.6110000000002,152.7374343261476,155.1719221689963,155.6276161538464,157.10145110389197,154.15378120380075,144.04174020000025,147.71303830000002,152.91452039999996,155.6110000000002,155.69333666666668,154167312,114738504.0,52.86490564473119,1.5,2.75,1.3930963356640726,1.343640596882804,-0.15188492530935085,0.9965294271836741,1.1484143524930248,12.366259167255068,-0.2954589247864397,7045245133.0,2013-04-03,2013,2,93,4,1.43,155.93,156.17,155.09,3331
2013-04-04 13:30:00,155.42999,156.17,155.09,155.86,155.01790157894737,157.34368421052636,144.15369020000026,147.8744383,153.04912039999996,155.6790000000002,152.85988788198497,155.23745339099662,155.6299238461541,157.10511244374032,154.15473524856782,144.15369020000026,147.8744383,153.04912039999996,155.6790000000002,155.70666666666668,131884944,116609257.6,55.51164422288169,1.5,2.75,1.3707323116880663,1.1309989165045504,-0.17040511273025127,0.9354079615802108,1.105813074310462,11.906586652709056,0.9724150177453272,7177130077.0,2013-04-04,2013,3,94,4,0.7,155.63,155.35001,153.77,3332
2013-04-05 13:30:00,153.95,155.35001,153.77,155.158,155.2597439473684,157.41157894736847,144.25878020000025,148.04561840000002,153.16488039999996,155.69810000000018,152.95000992582868,155.2298864013779,155.6443853846156,157.09692516663515,154.19184560259606,144.25878020000025,148.04561840000002,153.16488039999996,155.69810000000018,154.75933666666666,159665936,120287488.8,52.00725871478985,1.5,2.75,1.422108575138919,1.3273694346173766,-0.2279617765369386,0.8208608536392887,1.0488226301762271,11.016744766771774,-0.284068105137018,7017464141.0,2013-04-05,2013,4,95,4,1.03,154.56,156.22,154.75,3333
2013-04-08 13:30:00,155.27,156.22,154.75,156.21001,155.50158631578947,157.47947368421057,144.36783030000024,148.2261185,153.30088059999997,155.73660050000018,153.07785306599223,155.3232315060086,155.76746307692326,157.1159820312105,154.41894412263602,144.36783030000024,148.2261185,153.30088059999997,155.73660050000018,155.72666999999998,86571120,118441663.2,56.444733509457166,1.5,2.75,1.4255293912004248,0.7309178008908608,-0.1945121405419472,0.8056824544987933,1.0001945950407405,10.72588417316364,0.8131719909648419,7104035261.0,2013-04-08,2013,0,98,4,0.95,155.49,157.32001,155.98,3334
2013-04-09 13:30:00,156.5,157.32001,155.98,156.75,155.74342868421053,157.54736842105268,144.47308030000025,148.41096850000002,153.43088059999997,155.77260050000018,153.2218588281102,155.4591142197221,155.84900153846172,157.29368233477126,154.4043207421522,144.47308030000025,148.41096850000002,153.43088059999997,155.77260050000018,156.68333666666666,101922128,119350435.2,58.56262223967946,1.5,2.75,1.4194208632575376,0.8539736602485384,-0.13800759182190758,0.8276851052633559,0.9656926970852636,10.425194085952757,0.3585376784685333,7205957389.0,2013-04-09,2013,1,99,4,0.86,156.65,158.87,157.13,3335
2013-04-10 13:30:00,157.17,158.87,157.13,158.67,155.98527105263156,157.61526315789482,144.58903030000022,148.6197686,153.60288039999998,155.92210100000014,153.43551142308633,155.76491286546283,156.18061769230792,158.02797595919242,154.33325942542336,144.58903030000022,148.6197686,153.60288039999998,155.92210100000014,158.22333333333333,135711008,120848201.6,65.06690892390901,1.5,2.75,1.4694622301677138,1.1229874024041746,0.0183688291959323,0.988653733580179,0.9702849043842467,11.636360138529971,1.5878097189320637,7341668397.0,2013-04-10,2013,2,100,4,1.11,158.0,159.71001,158.53999,3336
2013-04-11 13:30:00,158.7,159.71001,158.53999,159.19,156.22711342105262,157.6831578947369,144.72278030000024,148.85236960000003,153.77348039999995,156.08635100000018,153.66117764178878,156.09111164018066,156.45677076923099,158.86312585762042,154.05041568084147,144.72278030000024,148.85236960000003,153.77348039999995,156.08635100000018,159.14666666666662,110142496,121727782.4,66.5961997617249,1.5,2.75,1.44807349944145,0.9048262757146884,0.13975889891869153,1.1449835280326113,1.0052246291139195,11.625785667608906,1.608476415395424,7451810893.0,2013-04-11,2013,3,101,4,0.74,159.12,159.03999,157.92,3337
2013-04-12 13:30:00,158.67999,159.03999,157.92,158.8,156.46895578947368,157.751052631579,144.84948025000025,149.08336960000003,153.94808019999994,156.18985100000015,153.8627000872088,156.3491010077825,156.7529246153848,159.28878698767713,154.2170622430925,144.84948025000025,149.08336960000003,153.94808019999994,156.18985100000015,158.58666333333332,116359808,121229279.2,64.32184853047227,1.5,2.75,1.4353539637670616,0.9598325484393376,0.17446412053049487,1.2233047797770382,1.0488406592465431,11.852170842717873,1.762255687279718,7335451085.0,2013-04-12,2013,4,102,4,0.71,158.48,158.13,155.10001,3338
2013-04-15 13:30:00,158.0,158.13,155.10001,155.118,156.71079815789471,157.8189473684211,144.96847020000024,149.27084960000005,154.05644019999997,156.1542510000002,153.91192753476926,156.23185329275557,156.67046307692328,159.34036016584403,154.00056598800253,144.96847020000024,149.27084960000005,154.05644019999997,156.1542510000002,156.11600333333334,217258944,125162173.6,47.74392685253084,1.5,2.75,1.5971136806408441,1.7358195191969723,-0.05746773466253741,0.9770059909183716,1.0344737255809089,18.465024771150066,-1.0853270574335516,7118192141.0,2013-04-15,2013,0,105,4,1.95,156.62,157.49001,155.91,3339
2013-04-16 13:30:00,156.28999,157.49001,155.91,157.41,156.95264052631578,157.88684210526318,145.09562020000024,149.45364960000003,154.17983999999996,156.27625100000014,154.04910684713124,156.34405774106457,156.7643092307694,159.44579657907317,154.08282188246562,145.09562020000024,149.45364960000003,154.17983999999996,156.27625100000014,156.93667000000005,147507808,126202351.2,55.442464543168,1.5,2.75,1.6524634177379276,1.1688198088024209,-0.06298658864127415,0.9557404897793162,1.0187270784205904,20.28388429274268,1.4043677124267262,7265699949.0,2013-04-16,2013,1,106,4,1.01,156.7,156.32001,154.28,3340
2013-04-17 13:30:00,156.28999,156.32001,154.28,155.11,157.19448289473684,157.95473684210532,145.20530520000025,149.61284960000003,154.2913399999999,156.30125100000018,154.0907105001849,156.22652843239175,156.6443092307694,159.4678019721665,153.8208164893723,145.20530520000025,149.61284960000003,154.2913399999999,156.30125100000018,155.23667000000003,226834752,129165726.4,47.82781506030864,1.5,2.75,1.7580017450423608,1.7561527993698494,-0.21921200543690225,0.7447120716244626,0.9639240770613648,21.28621265961233,-0.4812010778904144,7038865197.0,2013-04-17,2013,2,107,4,1.32,155.3,155.41,153.55,3341
2013-04-18 13:30:00,155.37,155.41,153.55,154.14,153.55,158.0226315789474,145.31205525000024,149.75974960000005,154.35313999999994,156.22375100000016,154.09264342174632,156.0278114388306,156.49738615384632,159.61295992650392,153.38181238118872,145.31205525000024,149.75974960000005,154.35313999999994,156.22375100000016,154.36666666666667,167583120,131856920.0,45.019555940915495,1.5,2.75,1.7652873346821911,1.2709467201266342,-0.37633066025628137,0.4935107517410131,0.8698414119972945,21.377708896763803,-0.6561053893450552,6871282077.0,2013-04-18,2013,3,108,4,1.21,154.48,155.55,154.12,3342
2013-04-19 13:30:00,154.5,155.55,154.12,155.48,153.6838888888889,158.0905263157895,145.4089302500002,149.9010495,154.43953999999994,156.27980150000016,154.14704956206998,155.97563892084676,156.39430846153863,159.5487906491234,153.23982627395392,145.4089302500002,149.9010495,154.43953999999994,156.27980150000016,155.04999999999995,149687568,132911051.2,49.436402850589545,1.5,2.75,1.7413382393477497,1.1262236409127129,-0.3774962227347447,0.3979711335788636,0.7754673563136083,21.937483760378466,-0.4673260055485697,7020969645.0,2013-04-19,2013,4,109,4,0.93,154.84,156.53999,154.75,3343
2013-04-22 13:30:00,155.78,156.53999,154.75,156.17,153.8177777777778,158.15842105263158,145.50723030000026,150.05224950000004,154.54373979999994,156.30830100000014,154.2263809517927,155.99414949981374,156.46661615384633,159.55339659979325,153.3798357078994,145.50723030000026,150.05224950000004,154.54373979999994,156.30830100000014,155.8199966666666,106553440,132680548.0,51.59286794221092,1.5,2.75,1.7448133651086235,0.8030826040905409,-0.3214733987664854,0.3736256078555016,0.6950990066219871,21.723209440821034,-0.37001594896332535,7127523085.0,2013-04-22,2013,0,112,4,1.16,155.64,157.92999,156.17,3344
2013-04-23 13:30:00,156.95,157.92999,156.17,157.78,153.95166666666668,158.22631578947372,145.60907030000018,150.2267495,154.6633397999999,156.44980100000018,154.3657385615263,156.16423049983152,156.61430846153866,159.75413298791025,153.47448393516706,145.60907030000018,150.2267495,154.6633397999999,156.44980100000018,157.29333,166141248,133421497.6,56.27842992975839,1.5,2.75,1.7458974104580087,1.2452359701289997,-0.1730978574869252,0.4787266847633305,0.6518245422502557,22.458504388873944,-0.5609125858700362,7293664333.0,2013-04-23,2013,1,113,4,1.13,157.05,158.3,157.53999,3345
2013-04-24 13:30:00,157.83,158.3,157.53999,157.88,154.08555555555554,158.2942105263158,145.71452035000019,150.39094939999998,154.7855397999999,156.5343010000002,154.5035527355841,156.32763711889515,156.82369307692326,159.9097069108626,153.73767924298394,145.71452035000019,150.39094939999998,154.7855397999999,156.5343010000002,157.90666333333334,96781184,133917728.8,56.559687411336995,1.5,2.75,1.6754768811395813,0.7226913483915058,-0.07058566055228742,0.5635924665598964,0.6341781271121838,21.238844291479708,-0.8229160123123326,7390445517.0,2013-04-24,2013,2,114,4,0.48,157.92,159.27,158.10001,3346
2013-04-25 13:30:00,158.34,159.27,158.10001,158.52,154.21944444444446,158.3621052631579,145.8296703000002,150.5549494,154.9155397999999,156.65080100000014,154.66106047144353,156.53643358376232,157.0013846153848,160.18990725746912,153.81286197330047,145.8296703000002,150.5549494,154.9155397999999,156.65080100000014,158.63000333333332,131060560,135473228.8,58.4039594610715,1.5,2.75,1.6550856753438978,0.9674277431852276,0.03242883937087593,0.6747141763257787,0.6422853369549028,21.29353913275776,-0.17632241813602084,7521506077.0,2013-04-25,2013,3,115,4,0.74,158.69,158.60001,157.73,3347
2013-04-26 13:30:00,158.33,158.60001,157.73,158.24001,154.35333333333338,158.43000000000004,145.94427030000026,150.7157995,155.03731999999994,156.7293015000002,154.80141143334768,156.6986789567373,157.116000769231,160.36665364946234,153.86534788899962,145.94427030000026,150.7157995,155.03731999999994,156.7293015000002,158.19000666666668,95918752,135122525.6,57.25865638924763,1.5,2.75,1.5990088413907628,0.7098650027009265,0.0715724583464149,0.7317509098879214,0.6601784515415065,21.273297915432988,2.012667775499953,7425587325.0,2013-04-26,2013,4,116,4,0.55,158.17,159.64999,158.42,3348
2013-04-29 13:30:00,158.67,159.64999,158.42,159.3,154.48722222222224,158.4978947368421,146.0700703000002,150.89429950000002,155.17752019999998,156.89180150000018,154.97782667125566,156.94642381800043,157.16446230769253,160.5233232291647,153.8056013862204,146.0700703000002,150.89429950000002,155.17752019999998,156.89180150000018,159.12332999999995,88572688,134591456.8,60.42287383731613,1.5,2.75,1.585506781291422,0.6580855137902036,0.1539823383923179,0.8526563745319038,0.6986740361395859,15.574656322154038,1.2006861063464929,7514160013.0,2013-04-29,2013,0,119,4,0.78,159.03,159.72,158.61,3349
2013-04-30 13:30:00,159.27,159.72,158.61,159.67999,154.62111111111113,158.56578947368425,146.1976702500002,151.07859939999997,155.32891999999995,157.0348005000002,155.1622252331672,157.2067634543813,157.20215384615406,160.660607697791,153.74369999451713,146.1976702500002,151.07859939999997,155.32891999999995,157.0348005000002,159.33666333333338,116010624,135316772.0,61.5225862000905,1.5,2.75,1.5515420111991765,0.8573262743808284,0.21544364228986426,0.967978589001916,0.7525349467120519,13.581755425313494,2.946289729869118,7630170637.0,2013-04-30,2013,1,120,4,0.7,159.17,159.41,158.10001,3350
2013-05-01 13:30:00,159.33,159.41,158.10001,158.28,154.75500000000005,158.63368421052638,146.32152030000026,151.2463994,155.42951999999994,157.1873005000002,155.28449091029788,157.30897645872597,157.1621538461541,160.55720793624428,153.7670997560639,146.32152030000026,151.2463994,155.42951999999994,157.1873005000002,158.59667,138874128,134552112.8,55.413352649235755,1.5,2.75,1.5535732961135214,1.032121496348588,0.14646767650594494,0.9356195423444832,0.7891518658385381,11.23530126711583,2.685869988322314,7491296509.0,2013-05-01,2013,2,121,5,0.83,158.76,159.89,158.53,3351
2013-05-02 13:30:00,158.67999,159.89,158.53,159.75,154.8888888888889,158.70157894736846,146.44152030000024,151.4240994,155.5977199999999,157.3818005000002,155.4596089138156,157.54145489122826,157.51846153846174,160.95262207550272,154.0843010014208,146.44152030000024,151.4240994,155.5977199999999,157.3818005000002,159.39,96407568,132778244.0,59.91443760720973,1.5,2.75,1.5576037749625544,0.7260795526110437,0.18217421869723796,1.0168696392100856,0.8346954205128476,10.552441029946763,2.74633393362491,7587704077.0,2013-05-02,2013,3,122,5,0.86,159.21,161.88,159.782,3352
2013-05-03 13:30:00,161.14,161.88,159.782,161.368,155.0227777777778,158.76947368421057,146.57121035000026,151.6136295,155.8166799999999,157.6923005000002,155.69131052503852,157.90588775873033,157.8229230769233,161.8202631203267,153.82558303351988,146.57121035000026,151.6136295,155.8166799999999,157.6923005000002,161.01000000000005,144202256,132005060.0,64.1985325511789,1.5,2.75,1.5984892196080858,1.092399458020776,0.29065173525682153,1.1980100895838746,0.907358354327053,10.830074409508967,3.3284241531664263,7731906333.0,2013-05-03,2013,4,123,5,1.31,160.83,162.00999,161.42,3353
2013-05-06 13:30:00,161.49001,162.00999,161.42,161.78,155.15666666666667,158.83736842105267,146.69831035000018,151.80669939999999,156.0144799999999,157.9708000000002,155.93008266131153,158.27485082932742,158.33600000000024,162.5168040154314,154.1551959845691,146.69831035000018,151.80669939999999,156.0144799999999,157.9708000000002,161.73666333333333,66882064,131020607.2,65.21789891973589,1.5,2.75,1.530167846778936,0.5104698064626281,0.3614275614122039,1.359142806092308,0.997715244680104,10.838562203397203,2.5351755609075934,7798788397.0,2013-05-06,2013,0,126,5,0.37,161.71,162.64999,161.67,3354
2013-05-07 13:30:00,162.13,162.64999,161.67,162.5999,155.29055555555558,158.90526315789478,146.82445985000018,151.9982984,156.2864779999999,158.2632950000002,156.19164412557382,158.68676027415341,158.98676153846182,162.98199704209776,154.99152603482582,146.82445985000018,151.9982984,156.2864779999999,158.2632950000002,162.30662999999996,90359184,130442460.0,67.21826621642336,1.5,2.75,1.4908694291518705,0.692712970914532,0.43006997121627055,1.535302708700442,1.1052327374841715,10.040835413200801,2.9895490245756244,7889147581.0,2013-05-07,2013,1,127,5,0.61,162.16,163.39,162.33,3355
2013-05-08 13:30:00,162.42,163.39,162.33,163.34,155.42444444444448,158.97315789473691,146.95250985000018,152.19659850000002,156.55287799999994,158.4967950000002,156.47197180692388,159.12992596232928,159.59137692307718,163.65915759045694,155.52359625569747,146.95250985000018,152.19659850000002,156.55287799999994,158.4967950000002,163.02,97419184,128527868.8,68.95396468874995,1.5,2.75,1.4600930413553062,0.7579615604736457,0.4877039824030711,1.7148627154880105,1.2271587330849392,9.952800928507019,3.040625788544028,7986566765.0,2013-05-08,2013,2,128,5,0.65,162.86,163.7,162.47,3356
2013-05-09 13:30:00,163.27,163.7,162.47,162.881,155.55833333333337,159.041052631579,147.08456485000022,152.39910849999998,156.77229799999995,158.6813450000002,156.72330624586803,159.48717110877408,160.10760769230794,164.00745399339547,156.2077613912204,147.08456485000022,152.39910849999998,156.77229799999995,158.6813450000002,163.01699999999997,106738560,128357672.0,66.59882907192454,1.5,2.75,1.4436578241156408,0.831571329838391,0.4577815357905553,1.7993856528231331,1.3416041170325779,10.549041175745717,2.9328802494388038,7879828205.0,2013-05-09,2013,3,129,5,0.76,163.08,163.5498,162.50999,3357
2013-05-10 13:30:00,162.99001,163.5498,162.50999,163.41,155.69222222222226,159.1089473684211,147.22616485000026,152.6121575,157.00829799999994,158.91184500000014,156.98552953034383,159.86077386031945,160.54068461538483,164.5590431825714,156.52232604819827,147.22616485000026,152.6121575,157.00829799999994,158.91184500000014,163.15659666666667,103202880,127699825.6,67.95718928494404,1.5,2.75,1.4148115509645247,0.8081677442792059,0.4365574569078912,1.8873009381674424,1.450743481259551,10.15561734179604,2.580037664783418,7983031085.0,2013-05-10,2013,4,130,5,0.64,163.03,163.81,162.82001,3358
2013-05-13 13:30:00,163.2,163.81,162.82001,163.53999,155.82611111111117,159.1768421052632,147.37423980000025,152.80985739999997,157.23689779999995,159.3329445000002,157.2425671958205,160.21117539743187,160.9760684615387,164.97340373045319,156.97873319262416,147.37423980000025,152.80985739999997,157.23689779999995,159.3329445000002,163.39,81843184,120929037.6,68.29836170965045,1.5,2.75,1.384467154467059,0.6767868629759112,0.3954390588984436,1.945042304882605,1.5496032459841618,9.981898067455043,2.4173348207248666,8064874269.0,2013-05-13,2013,0,133,5,0.61,163.32,165.35001,163.67,3359
2013-05-14 13:30:00,163.67,165.35001,163.67,165.23,155.96000000000004,159.2447368421053,147.53058975000025,153.00845739999997,157.48309779999994,159.7239445000002,157.5557998548079,160.68915869291456,161.49222230769251,165.80788284213878,157.1765617732463,147.53058975000025,153.00845739999997,157.48309779999994,159.7239445000002,164.75000333333332,119000816,119503688.0,72.41118770728393,1.5,2.75,1.4148637862908409,0.99579199597589,0.4426623277504267,2.102931155672195,1.6602688279217683,10.896003268626522,4.390952741976236,8183875085.0,2013-05-14,2013,1,134,5,1.03,164.51,166.45,164.91,3360
2013-05-15 13:30:00,164.96001,166.45,164.91,166.11501,156.0938888888889,159.31263157894742,147.68031480000025,153.22670759999997,157.71959819999995,160.2741950000002,157.89145515461942,161.2059064364465,162.09799153846174,166.62326611472415,157.5727169621994,147.68031480000025,153.22670759999997,157.71959819999995,160.2741950000002,165.82500333333334,120718432,114197872.0,74.2921011044882,1.5,2.75,1.4238020872700663,1.0570987872698714,0.4903987837831098,2.273267307650656,1.7828685238675461,7.631501677379898,3.9843568075117446,8304593517.0,2013-05-15,2013,2,135,5,0.93,165.68,166.36,165.09,3361
2013-05-16 13:30:00,165.78,166.36,165.09,165.34,156.22777777777782,159.38052631578952,147.81363980000026,153.42890759999997,157.93639819999996,160.8341950000002,158.18355495247746,161.5996296329754,162.56260692307717,167.08364978309191,158.0415640630624,147.81363980000026,153.42890759999997,157.93639819999996,160.8341950000002,165.5966666666667,109913568,111314394.4,69.80402636069326,1.5,2.75,1.4128162238936337,0.9874155862092172,0.4288981553762734,2.318991218087888,1.8900930627116144,8.778054882707965,2.461454563482232,8194679949.0,2013-05-16,2013,3,136,5,0.77,165.73,167.03999,165.73,3362
2013-05-17 13:30:00,165.95,167.03999,165.73,166.94,156.36166666666668,159.44842105263163,147.95493985000024,153.67040769999997,158.17967819999996,161.4071950000002,158.52694495434108,162.1082363345968,163.12106923076945,167.86779573511672,158.37434272642224,147.95493985000024,153.67040769999997,158.17967819999996,161.4071950000002,166.56999666666667,129801008,110320066.4,73.37948132901936,1.5,2.75,1.4333286364726592,1.1765856587628014,0.4527438473731418,2.4560228719280417,2.0032790245549,8.657622564973579,3.1895166275188505,8324480957.0,2013-05-17,2013,4,137,5,0.79,166.38,167.58,166.61,3363
2013-05-20 13:30:00,166.78,167.58,166.61,166.92999,156.49555555555554,159.51631578947374,148.1010397500003,153.91620749999996,158.40947799999995,161.94519450000018,158.85647613260224,162.5674509693971,163.78645307692332,168.03066916516087,159.54223698868572,148.1010397500003,153.91620749999996,158.40947799999995,161.94519450000018,167.03999666666667,85071184,109245953.6,73.32098759320724,1.5,2.75,1.4002337338674689,0.7787124483482929,0.4250539572565226,2.5345964711255533,2.1095425138690307,8.877020256505604,2.6630336181018643,8239409773.0,2013-05-20,2013,0,140,5,0.58,167.1,167.8,166.5,3364
2013-05-21 13:30:00,167.08,167.8,166.5,167.17,156.62944444444446,159.58421052631584,148.24893975000026,154.17040749999995,158.63227799999996,162.4146945000002,159.18249667642175,163.00578897231162,164.35722230769255,168.25845610890158,160.45598850648355,148.24893975000026,154.17040749999995,158.63227799999996,162.4146945000002,167.15666666666667,95804192,105729100.8,73.85905410426581,1.5,2.75,1.3930741814483647,0.9061288829196208,0.3815010208361396,2.5864187899142053,2.2049177690780657,8.833292176798679,2.3448022529692567,8335213965.0,2013-05-21,2013,1,141,5,0.78,167.15,169.07001,165.17,3365
2013-05-22 13:30:00,167.34,169.07001,165.17,165.92999,156.76333333333338,169.07001,148.39538970000024,154.41409140000002,158.83727799999994,162.8171940000002,159.44710425773854,163.28428430828197,164.7081446153849,168.27728697988454,161.13900225088517,148.39538970000024,154.41409140000002,158.83727799999994,162.8171940000002,166.72333333333333,244031744,113091628.8,66.40723744048807,1.5,2.75,1.572141025630625,2.1578232322709283,0.23496761440617275,2.4986272870857817,2.2636596726796085,10.475805900278042,1.8719126233262344,8091182221.0,2013-05-22,2013,2,142,5,2.36,167.12,165.91,163.94,3366
2013-05-23 13:30:00,164.16,165.91,163.94,165.45,156.89722222222224,169.19330417647058,148.52589470000024,154.66829140000002,159.02817799999994,163.1636940000002,159.68251193390566,163.4905429455885,164.99045230769252,168.14499848989797,161.8359061254871,148.52589470000024,154.66829140000002,159.02817799999994,163.1636940000002,165.1,211064320,117091816.8,63.72699816440311,1.5,2.75,1.6019873809427236,1.8025539765986451,0.07953672986986904,2.3630805850169447,2.283543855147076,10.488573870588695,1.2483936111621028,7880117901.0,2013-05-23,2013,3,143,5,1.2,164.92,165.38048999999998,163.98,3367
2013-05-24 13:30:00,164.47,165.38048999999998,163.98,165.308,157.03111111111113,169.31659835294118,148.65433470000028,154.89727140000002,159.19973799999997,163.5170935000002,159.90311930904664,163.66363409362762,165.19876769230788,168.03605960587038,162.36147577874542,148.65433470000028,154.89727140000002,159.19973799999997,163.5170935000002,164.88949666666667,151573872,119874572.8,62.91795151088944,1.5,2.75,1.5925597108753862,1.2644372235043326,-0.05193452586819625,2.218625697811831,2.2705602236800266,10.512512235290815,1.0810872618984528,7728544029.0,2013-05-24,2013,4,144,5,0.85,164.68,167.78,165.81,3368
2013-05-28 13:30:00,167.03999,167.78,165.81,166.3,157.16500000000005,169.43989252941176,148.78423465000026,155.09967139999995,159.40913799999996,163.86709350000018,160.15397737535852,163.91471656090118,165.4264600000002,168.10095253790792,162.75196746209247,148.78423465000026,155.09967139999995,159.40913799999996,163.86709350000018,166.63000000000005,143679744,122629925.6,66.150943870853,1.5,2.75,1.6553768743842878,1.1716531939247952,-0.08900880991997573,2.1592992112800573,2.248308021200033,10.862412702478924,0.6475821582037291,7872223773.0,2013-05-28,2013,1,148,5,1.19,166.8,165.8,164.34,3369
2013-05-29 13:30:00,165.42,165.8,164.34,165.22,157.2988888888889,169.56318670588234,148.90788460000027,155.2945304,159.61413799999997,164.14409400000017,160.35264492926603,164.03902926938682,165.60638307692327,167.85202005237156,163.36074610147497,148.90788460000027,155.2945304,159.61413799999997,164.14409400000017,165.12,160363312,124847560.0,60.01607458084221,1.5,2.75,1.677135669071125,1.2844729364354417,-0.1970007360074657,2.002057101190701,2.1990578371981666,10.25331624338179,-0.5387893604557549,7711860461.0,2013-05-29,2013,2,149,5,0.89,165.07,166.59,165.22,3370
2013-05-30 13:30:00,165.35001,166.59,165.22,165.83,157.4327777777778,169.6864808823529,149.03398460000028,155.48913039999996,159.83853799999997,164.52159400000016,160.56744316733403,164.20959791039758,165.79253692307714,167.64599865166988,163.93907519448442,149.03398460000028,155.48913039999996,159.83853799999997,164.52159400000016,165.88000000000005,107793744,123293540.8,62.151147670833204,1.5,2.75,1.6551974069946165,0.8742854110651026,-0.2354804946278235,1.9047072189133871,2.14018771354121,9.978192905764868,0.2963590177815465,7819654205.0,2013-05-30,2013,3,150,5,0.83,165.9,166.31,163.13,3371
2013-05-31 13:30:00,165.37,166.31,163.13,163.44501,157.5666666666667,169.80977505882353,149.14700965000029,155.6638855,159.9936382,164.70634450000014,160.6802889254778,164.13678001416926,165.78523076923096,167.6745539942747,163.89590754418722,149.14700965000029,155.6638855,159.9936382,164.70634450000014,164.2950033333333,176850000,127315662.4,50.74236228358896,1.5,2.75,1.7641118779235732,1.3890671160659962,-0.41897075809978457,1.61647426591648,2.0354450240162647,12.784318159543323,-2.0935605606804852,7642804205.0,2013-05-31,2013,4,151,5,1.95,164.72,164.46001,162.6599,3372
2013-06-03 13:30:00,163.83,164.46001,162.6599,164.35001,157.70055555555558,169.93306923529408,149.26490970000026,155.85188949999997,160.1934586,164.85544500000015,160.82419955585124,164.15708763186746,165.71753923076943,167.73995377251498,163.69512468902388,149.26490970000026,155.85188949999997,160.1934586,164.85544500000015,163.82330666666667,168390688,128525084.0,54.17949888565178,1.5,2.75,1.7666831723576046,1.3101776148226445,-0.4728175389876434,1.4444231002817105,1.917240639269354,11.689369245554486,-1.5455461298476123,7811194893.0,2013-06-03,2013,0,154,6,1.11,163.56,165.10001,162.73,3373
2013-06-04 13:30:00,164.44,165.10001,162.73,163.56,157.83444444444447,170.0563634117647,149.37875975000026,156.02828949999997,160.3526584,164.94444500000014,160.93148584777862,164.10022214311815,165.52100000000019,167.82736942138268,163.2146305786177,149.37875975000026,156.02828949999997,160.3526584,164.94444500000014,163.79667,157631440,133062552.8,50.84421034029914,1.5,2.75,1.8097779457606331,1.1846416342013844,-0.5496774909067899,1.2301437756358666,1.7798212665426565,11.783737198877851,-2.1594783753065654,7653563453.0,2013-06-04,2013,1,155,6,1.46,163.92,163.42,161.13,3374
2013-06-05 13:30:00,163.09,163.42,161.13,161.27200000000002,157.9683333333334,170.17965758823533,149.48036975000025,156.17020949999997,160.47909840000003,164.87805000000014,160.94483934394418,163.83086765329736,165.2080769230771,168.444224852736,161.97192899341817,149.48036975000025,156.17020949999997,160.47909840000003,164.87805000000014,161.94066666666666,211737680,139131477.6,42.6544548050504,1.5,2.75,1.8540795210634455,1.52185316833004,-0.7312779229366029,0.8657238628719028,1.5970017858085055,13.36528945283108,-2.807202001277775,7441825773.0,2013-06-05,2013,2,156,6,1.42,162.27,162.74001,160.25,3375
2013-06-06 13:30:00,161.2,162.74001,160.25,162.73,158.10222222222225,170.30295176470588,149.58406970000024,156.32680939999997,160.60989840000002,164.84755000000013,161.01484564418166,163.7260231148881,164.8842307692309,168.2038247670256,161.56463677143626,149.58406970000024,156.32680939999997,160.60989840000002,164.84755000000013,161.90667,200225440,144271790.4,48.36242216924367,1.5,2.75,1.899503126701772,1.3878349984072844,-0.7282801650423527,0.6866515795055648,1.4149317445479177,14.873218610922954,-1.6440012088244176,7642051213.0,2013-06-06,2013,3,157,6,1.55,161.5,164.95,163.14,3376
2013-06-07 13:30:00,163.85001,164.95,163.14,164.8,158.23611111111111,170.42624594117646,149.69716975000026,156.50510939999995,160.78209840000005,164.94350000000014,161.16328306990005,163.82830662775592,164.72038538461555,167.82308961303636,161.61768115619475,149.69716975000026,156.50510939999995,160.78209840000005,164.94350000000014,164.29666666666662,188337744,148351749.6,55.18301244542831,1.5,2.75,1.922395760508788,1.269535037556443,-0.5690206773188065,0.7036558978994094,1.272676575218216,17.021853226264632,-0.3073051515957977,7830388957.0,2013-06-07,2013,4,158,6,1.11,164.04,165.39999,164.37,3377
2013-06-10 13:30:00,165.31,165.39999,164.37,164.8,158.37000000000003,170.54954011764704,149.81021975000024,156.68240930000002,160.94469840000005,165.0130000000002,161.30589942010005,163.9208488536839,164.53807769230787,167.30383931849042,161.77231606612534,149.81021975000024,156.68240930000002,160.94469840000005,165.0130000000002,164.85666333333333,105667056,148474958.4,55.18301244542831,1.5,2.75,1.8586524919010172,0.7116826779323078,-0.4509736610192498,0.7089594989441537,1.1599331599634035,17.020405876998392,-0.9019843656043296,7830388957.0,2013-06-10,2013,0,161,6,0.63,164.88,164.53999,162.739,3378
2013-06-11 13:30:00,163.3,164.53999,162.739,163.09801000000002,158.50388888888892,170.67283429411762,149.91690985000025,156.84288940000002,161.08565860000004,164.99090100000018,161.3761782663706,163.84248324857114,164.32023307692327,167.05913319047116,161.5813329633754,149.91690985000025,156.84288940000002,161.08565860000004,164.99090100000018,163.459,159505376,152358068.0,49.01000411172081,1.5,2.75,1.87310588533666,1.0469112538234602,-0.4725352084928336,0.5692641493473616,1.0417993578401952,17.392935895458002,-1.2843420893354385,7670883581.0,2013-06-11,2013,1,162,6,1.11,163.64,164.39,161.60001,3379
2013-06-12 13:30:00,164.22,164.39,161.60001,161.75,158.6377777777778,170.79612847058826,150.0165598000003,156.98038939999995,161.1842584,164.81690100000014,161.3908379421992,163.6431991296596,164.03561769230788,167.0050394334887,161.0661959511271,150.0165598000003,156.98038939999995,161.1842584,164.81690100000014,162.58000333333334,177363504,155276202.4,44.74107748399921,1.5,2.75,1.938597607812612,1.1422452459463293,-0.5568032271623602,0.3457953238872449,0.9025985510496052,17.5929687414494,-2.460350961828386,7493520077.0,2013-06-12,2013,2,163,6,1.73,163.0,164.5,161.3,3380
2013-06-13 13:30:00,161.66,164.5,161.3,164.21001,158.77166666666668,170.9194226470588,150.1342849000003,157.13918950000001,161.3638586,164.72165100000018,161.50139370917177,163.69718111731106,163.95115692307712,166.83215470217786,161.0701591439764,150.1342849000003,157.13918950000001,161.3638586,164.72165100000018,163.33667,163587744,157419668.0,52.817886035088435,1.5,2.75,2.0286977786831386,1.0391823720527729,-0.4316689710110024,0.3630123372858521,0.7946813082968545,20.016059027051792,0.4680473267431137,7657107821.0,2013-06-13,2013,3,164,6,1.98,162.9,164.67,162.91,3381
2013-06-14 13:30:00,164.03,164.67,162.91,163.175,158.9055555555556,171.04271682352942,150.24260995000026,157.2796395,161.51015859999998,164.61340100000018,161.5670253284199,163.64744958232902,163.71077230769248,166.27139936469626,161.1501452506887,150.24260995000026,157.2796395,161.51015859999998,164.61340100000018,163.585,141197440,158983861.6,49.53722466769235,1.5,2.75,2.0095050802057712,0.8881243579002361,-0.4039053207735229,0.28979965732995083,0.6937049781034738,18.494696727392427,-0.7149436741743953,7515910381.0,2013-06-14,2013,4,165,6,1.08,163.79,165.22,163.21919,3382
2013-06-17 13:30:00,164.28999,165.22,163.21919,164.44,159.03944444444446,171.166011,150.35711000000026,157.4303395,161.6957986,164.48840100000018,161.67969100181523,163.72293057448817,163.6507723076925,166.10131951857744,161.20022509680754,150.35711000000026,157.4303395,161.6957986,164.48840100000018,164.29306333333332,136295568,159308589.6,53.35098608022626,1.5,2.75,2.0120404316196434,0.8555443767484086,-0.2909252494784977,0.33004841625535164,0.6209736657338494,18.78247782139079,0.538028857911467,7652205949.0,2013-06-17,2013,0,168,6,1.23,164.22,165.99001,164.52,3383
2013-06-18 13:30:00,164.53,165.99001,164.52,165.735,159.17333333333337,171.28930517647058,150.47878505000025,157.5935895,161.88629840000002,164.42865150000014,161.83872272723426,163.91455623406074,163.64346461538486,166.06840666475748,161.21852256601218,150.47878505000025,157.5935895,161.88629840000002,164.42865150000014,165.41500333333337,114695504,160789805.6,56.938819311281264,1.5,2.75,1.9790382579325272,0.713325720943592,-0.12787817100283386,0.461125951980307,0.5890041229831409,18.98442239312717,2.7673743737288694,7766901453.0,2013-06-18,2013,1,169,6,0.89,165.26,165.89,163.38,3384
2013-06-19 13:30:00,165.60001,165.89,163.38,163.45,159.30722222222226,171.41259935294116,150.58848510000024,157.7255895,162.02029840000003,164.24265150000016,161.9019100712643,163.8703127831978,163.6438484615387,166.06866631175438,161.219030611323,150.58848510000024,157.7255895,162.02029840000003,164.24265150000016,164.23999999999995,206149440,166307068.0,49.67844673014474,1.5,2.75,2.016964096651632,1.2395711287508238,-0.17017303591007915,0.376287828095542,0.5464608640056211,18.92409931897515,0.4424506851840465,7560752013.0,2013-06-19,2013,2,170,6,1.54,164.64,163.4668,158.98,3385
2013-06-20 13:30:00,161.86,163.4668,158.98,159.39999,159.44111111111116,171.53589352941177,150.68303500000025,157.81888930000005,162.0348982,163.91615150000015,161.80379555866568,163.4445677562266,163.26307769230792,166.53232873907152,159.99382664554423,150.68303500000025,157.81888930000005,162.0348982,163.91615150000015,160.61559666666668,321255936,170168277.6,39.953992997971305,1.5,2.75,2.1933809468908017,1.8878720554200403,-0.4512060421313753,-0.017546688658597986,0.4336593534727773,23.437150941745845,-3.276705097087384,7239496077.0,2013-06-20,2013,3,171,6,2.82,161.22,159.75999,157.47,3386
2013-06-21 13:30:00,159.64,159.75999,157.47,159.07001,159.57500000000005,171.65918770588237,150.77258505000026,157.9029894,162.03249839999995,163.59715200000016,161.69658828185527,163.02794320801453,162.917693846154,166.866555088902,158.9688326034061,150.77258505000026,157.9029894,162.03249839999995,163.59715200000016,158.76666666666662,271956736,173212898.4,39.279344369188145,1.5,2.75,2.2002815935414586,1.5700720818837126,-0.6287112618595192,-0.3522297238516217,0.2764815380078975,21.504482254423266,-3.4769356796116595,6967539341.0,2013-06-21,2013,4,172,6,1.45,158.61,158.42999,155.73,3387
2013-06-24 13:30:00,157.41,158.42999,155.73,157.06,155.73,171.7824818823529,150.85273505000023,157.97288930000005,161.99769840000002,163.18475200000015,161.51476129040998,162.45956766439414,162.59369384615403,167.583482575521,157.6039051167871,150.85273505000023,157.97288930000005,161.99769840000002,163.18475200000015,157.07333,222334752,176750942.4,35.362342634277084,1.5,2.75,2.281690765431355,1.2578985378015162,-0.8378047833512576,-0.7707744411811746,0.06703034217008305,21.970739373702866,-3.7020745991934456,6745204589.0,2013-06-24,2013,0,175,6,1.73,157.08,160.10001,157.42,3388
2013-06-25 13:30:00,158.48,160.10001,157.42,158.575,155.77739130434782,171.90577605882353,150.94106005000026,158.06163930000002,162.06683839999997,162.79850200000016,161.39947653392332,162.08960883921372,162.2740784615386,167.70112728474354,156.84702963833377,150.94106005000026,158.06163930000002,162.06683839999997,162.79850200000016,158.69833666666662,162262128,177680061.6,40.202625555335295,1.5,2.75,2.3358564250434006,0.9132264281024992,-0.8288687828084205,-0.9690556363404426,-0.1401868535320221,23.0782929531195,-1.9629057187017072,6907466717.0,2013-06-25,2013,1,176,6,1.7,158.76,160.5,159.25,3389
2013-06-26 13:30:00,159.87,160.5,159.25,160.14,155.8247826086956,172.02907023529409,151.02291005000023,158.1506392,162.12143839999996,162.54450200000014,161.35008529729888,161.90393180690762,161.9156169230771,167.24262711101886,156.5886067351353,151.02291005000023,158.1506392,162.12143839999996,162.54450200000014,159.96333333333334,134847936,176404292.8,44.80098444887384,1.5,2.75,2.3065095375403013,0.7644254788792758,-0.6786644988927659,-0.9885174771479796,-0.30985297825521363,23.83037089699987,-2.4785395238694794,7042314653.0,2013-06-26,2013,2,177,6,0.78,159.88,161.82001,160.95,3390
2013-06-27 13:30:00,161.10001,161.82001,160.95,161.08,155.87217391304347,172.15236441176467,151.10666005000027,158.2660892,162.24083839999997,162.30700200000015,161.33949371701266,161.8254621110117,161.62946307692317,166.6994189138693,156.55950723997708,151.10666005000027,158.2660892,162.24083839999997,162.30700200000015,161.28333666666666,129483680,177488789.6,47.416563836052454,1.5,2.75,2.2617595705731377,0.7295315962873635,-0.4861291747574522,-0.9175144467020288,-0.4313852719445767,22.076307736872,-1.283897655890914,7171798333.0,2013-06-27,2013,3,178,6,0.54,161.39,161.39999,159.86,3391
2013-06-28 13:30:00,160.63,161.39999,159.86,160.42,155.91956521739132,172.27565858823527,151.19121010000023,158.35978920000005,162.36643839999996,162.15575150000015,161.3034351398749,161.69160857662962,161.42346230769243,166.4554818858021,156.39144272958274,151.19121010000023,158.35978920000005,162.36643839999996,162.15575150000015,160.55999666666662,160402816,176666430.4,45.77643010619597,1.5,2.75,2.2102046012464838,0.9079416821680458,-0.3781548699268804,-0.9040788593531772,-0.5259239894262968,21.95129312817893,-2.4446606665045065,7011395517.0,2013-06-28,2013,4,179,6,0.96,160.63,162.48,161.08,3392
2013-07-01 13:30:00,161.25999,162.48,161.08,161.36,155.96695652173912,172.39895276470588,151.27846010000027,158.46178920000003,162.48403839999997,162.00625100000016,161.30565336968368,161.66002680742682,161.39346230769246,166.42198614559356,156.36493846979138,151.27846010000027,158.46178920000003,162.48403839999997,162.00625100000016,161.64,131954816,174844636.8,48.50827014037879,1.5,2.75,2.199475701157449,0.7546975327069341,-0.2258718117059567,-0.8082637540587427,-0.582391942352786,21.681444458537197,-2.6397562373668806,7143350333.0,2013-07-01,2013,0,182,7,0.87,161.78,162.3,160.5,3393
2013-07-02 13:30:00,161.12,162.3,160.5,161.21001,156.01434782608695,172.52224694117646,151.36256015000023,158.56428920000005,162.58483859999996,161.88875150000015,161.30190264930397,161.6171680638623,161.16269307692326,165.92110506529332,156.40428108855326,151.36256015000023,158.56428920000005,162.58483859999996,161.88875150000015,161.33667,154863632,174706246.4,48.09192029083792,1.5,2.75,2.1709417225033465,0.8864229825270861,-0.12284562264749145,-0.7359489706621503,-0.6131033480146588,20.80912498392936,-1.3704435607219196,6988486701.0,2013-07-02,2013,1,183,7,1.12,161.4,161.77,160.22,3394
2013-07-03 13:30:00,160.48,161.77,160.22,161.28,156.06173913043474,172.645541117647,151.43601015000024,158.65908920000004,162.65483859999995,161.88915150000014,161.30104372188032,161.58505681968495,161.01692384615401,165.63382337806445,156.4000243142436,151.43601015000024,158.65908920000004,162.65483859999995,161.88915150000014,161.09,75216320,167880178.4,48.314849400937284,1.5,2.75,2.126588742324537,0.4480357402336427,-0.041774888279350934,-0.6653219583638474,-0.6235470700844965,19.60075178896071,1.17942918315114,7063703021.0,2013-07-03,2013,2,184,7,0.97,161.0,163.08,161.3,3395
2013-07-05 13:30:00,162.47,163.08,161.3,163.02,156.1091304347826,172.76883529411762,151.51491010000024,158.77158920000005,162.75763859999995,161.90365150000017,161.36845377200262,161.72171807495306,160.90769307692327,165.25478689714564,156.56059925670084,151.51491010000024,158.77158920000005,162.75763859999995,161.90365150000017,162.46666666666667,122416880,163989750.4,53.64485539982898,1.5,2.75,2.1032609750156417,0.7464910441134497,0.12795608075086715,-0.4636019691459126,-0.5915580498967797,13.585117696516292,2.483177061471244,7186119901.0,2013-07-05,2013,4,186,7,1.1,162.19,164.39,163.0838,3396
2013-07-08 13:30:00,163.86,164.39,163.0838,163.94501,156.15652173913043,172.89212947058826,151.60093510000024,158.89083930000004,162.86613879999996,161.86090200000015,161.4694951927084,161.93346016305276,160.77000153846168,164.57655118553484,156.96345189138853,151.60093510000024,158.89083930000004,162.86613879999996,161.86090200000015,163.80626999999996,108092432,159977484.8,56.22907546694764,1.5,2.75,2.050885191085952,0.6756727806736964,0.2920575937437466,-0.2264860577170964,-0.5185436514608429,13.40968453318197,4.383681395644973,7294212333.0,2013-07-08,2013,0,189,7,0.8,163.74,165.33,164.27,3397
2013-07-09 13:30:00,164.98,165.33,164.27,165.13,156.20391304347825,173.01542364705884,151.69348510000026,159.02062930000002,163.00393859999994,161.87740200000013,161.61304440083745,162.23789252847632,160.89923230769247,165.1491916862944,156.64927292909059,151.69348510000026,159.02062930000002,163.00393859999994,161.87740200000013,164.91,119297872,160659025.6,59.35508778679932,1.5,2.75,2.0033212488655283,0.7425531902391919,0.4599538581831419,0.0563986712680844,-0.4035551869150576,9.0196091421726,4.133690682642287,7413510205.0,2013-07-09,2013,1,190,7,0.65,164.8,165.75,164.63,3398
2013-07-10 13:30:00,164.97,165.75,164.63,165.192,156.2513043478261,173.1387178235294,151.78594510000025,159.14964940000004,163.12177859999994,161.98210150000014,161.75339560080462,162.51923609719285,161.34477153846169,166.06140534861825,156.62813772830518,151.78594510000025,159.14964940000004,163.12177859999994,161.98210150000014,165.19066666666666,121410368,158754275.2,59.51799064853917,1.5,2.75,1.9402268739465618,0.7647691241514358,0.5487122735227906,0.2823351549884308,-0.26637711853435986,8.854491964879921,3.154739602847522,7534920573.0,2013-07-10,2013,2,191,7,0.68,165.19,167.61,165.1774,3399
2013-07-11 13:30:00,167.11,167.61,165.1774,167.44,156.2986956521739,173.262012,151.88959505000025,159.30294940000005,163.27697879999994,162.26660150000015,161.97639969489074,162.9878802784126,161.98861692307713,167.5047430061139,156.47249084004034,151.88959505000025,159.30294940000005,163.27697879999994,162.26660150000015,166.74246666666667,135592192,156665709.6,64.99607340758041,1.5,2.75,1.97539638295038,0.8654873638028063,0.7214705422442154,0.6354610592709093,-0.08600948297330603,9.917455735366586,3.9483486466352034,7670512765.0,2013-07-11,2013,3,192,7,1.47,166.39,167.9332,167.13,3400
2013-07-12 13:30:00,167.39,167.9332,167.13,167.50999,156.34608695652173,173.3853061764706,151.99779500000025,159.44554930000004,163.46157859999994,162.43160050000014,162.19340323626759,163.41855739475426,162.79246230769252,168.2467188609137,157.33820575447137,151.99779500000025,159.44554930000004,163.46157859999994,162.43160050000014,167.52439666666666,104212624,153696953.6,65.15417695880943,1.5,2.75,1.8916680698824957,0.6780396199082505,0.7971821305260814,0.9104681801842958,0.11328604965821434,10.125420585877118,4.419642189253211,7774725389.0,2013-07-12,2013,4,193,7,0.48,167.53,168.39,167.67999,3401
2013-07-15 13:30:00,167.97,168.39,167.67999,168.155,156.39347826086956,173.50860035294116,152.11034500000022,159.61369930000004,163.6296785999999,162.68060050000014,162.42719134464926,163.86964716668243,163.52938538461558,169.0928395244559,157.9659312447753,152.11034500000022,159.61369930000004,163.6296785999999,162.68060050000014,168.07499666666664,69450560,150109609.6,66.64919462353032,1.5,2.75,1.8194067791766029,0.4626656493549364,0.8429773067694325,1.167007683120005,0.3240303763505724,8.760312644931401,4.2110808130887385,7844175949.0,2013-07-15,2013,0,196,7,0.42,168.03,168.36,167.07001,3402
2013-07-16 13:30:00,168.25999,168.36,167.07001,167.52499,156.44086956521738,173.63189452941174,152.22746990000024,159.78474920000005,163.7528183999999,162.83485000000013,162.6271050174081,164.21777505556983,164.09746153846174,169.66869970029285,158.5262233766307,152.22746990000024,159.78474920000005,163.7528183999999,162.83485000000013,167.65166666666667,88702064,147729934.4,63.77122607959228,1.5,2.75,1.7815912949497041,0.6004339226187323,0.7843306831929838,1.3044437303418022,0.5201130471488183,9.952559883834061,3.917238141725808,7755473885.0,2013-07-16,2013,1,197,7,0.77,167.72,168.48,167.73,3403
2013-07-17 13:30:00,168.16,168.48,167.73,167.9501,156.48826086956518,173.75518870588238,152.35074540000025,159.94535020000004,163.8762203999999,162.94560500000014,162.83584991868622,164.57323457408697,164.62593076923105,170.2550547657978,158.99680677266423,152.35074540000025,159.94535020000004,163.8762203999999,162.94560500000014,168.05336666666662,92873872,146638852.8,64.87343859144352,1.5,2.75,1.7225497738818671,0.6333510541484542,0.7288439609466821,1.4311679983321708,0.7023240373854889,9.547871345631409,4.1357266865079305,7848347757.0,2013-07-17,2013,2,198,7,0.45,168.1,169.27,168.2,3404
2013-07-18 13:30:00,168.31,169.27,168.2,168.87,156.53565217391304,173.8784828823529,152.47189540000025,160.1440502000001,164.00162239999997,163.21660500000013,163.07248325520834,164.98245032893584,165.275930769231,170.76193085752251,159.7899306809395,152.47189540000025,160.1440502000001,164.00162239999997,163.21660500000013,168.78,103620256,141512393.6,67.19897476572767,1.5,2.75,1.6937890757474494,0.7322344945481863,0.7081616683676704,1.5875261228450768,0.8793644544774064,9.275028957704253,3.58851674641148,7951968013.0,2013-07-18,2013,3,199,7,0.64,168.74,169.23,168.31,3405
2013-07-19 13:30:00,168.52,169.23,168.31,169.17,156.5830434782609,174.00177705882354,152.59789540000025,160.33555020000006,164.11822239999995,163.70510550000014,163.31160155892567,165.38126458332292,165.87670000000026,171.2245937288993,160.52880627110113,152.59789540000025,160.33555020000006,164.11822239999995,163.70510550000014,168.9033333333333,103831632,130641178.4,67.94432049588721,1.5,2.75,1.6385184274797735,0.7947848700666651,0.6692037044939563,1.7158690850948517,1.0466653806008954,8.501974911393463,3.1870381416305333,8055799645.0,2013-07-19,2013,4,200,7,0.55,168.77,169.74001,169.00999,3406
2013-07-22 13:30:00,169.41,169.74001,169.00999,169.5,156.6304347826087,174.12507123529412,152.72367040000026,160.51145020000004,164.25060239999996,164.22660500000015,163.5542838507325,165.77352509919692,166.51439153846178,171.445103601177,161.58367947574655,152.72367040000026,160.51145020000004,164.25060239999996,164.22660500000015,169.41666666666666,79428560,121014769.6,68.78458653270347,1.5,2.75,1.5736256826597914,0.6563542637195584,0.6212224240585131,1.8231934106740368,1.2019709866155237,8.456334189300316,2.646399806213289,8135228205.0,2013-07-22,2013,0,203,7,0.43,169.38,169.83,169.05,3407
2013-07-23 13:30:00,169.8,169.83,169.05,169.14,156.67782608695654,174.24836541176467,152.84687040000026,160.68675020000003,164.3652023999999,164.83060500000016,163.77333154286063,166.09414175641624,167.11900692307714,171.18600100451056,163.05201284164372,152.84687040000026,160.68675020000003,164.3652023999999,164.83060500000016,169.34,80829632,113939513.6,66.72962474998145,1.5,2.75,1.5169381338983778,0.7094082592257092,0.5246506820196579,1.857784339140096,1.3331336571204382,8.587328791467703,2.3899462443701744,8054398573.0,2013-07-23,2013,1,204,7,0.46,169.44,169.86,168.17999,3408
2013-07-24 13:30:00,169.78999,169.86,168.17999,168.52,156.72521739130434,174.37165958823527,152.96402040000024,160.85085020000002,164.46480259999996,165.32785500000014,163.9594754039249,166.32517587485282,167.5420838461541,170.89746682596896,164.18670086633918,152.96402040000024,160.85085020000002,164.46480259999996,165.32785500000014,168.85333,112914000,111472107.2,63.226270490146476,1.5,2.75,1.5285861243342087,1.0129350098084446,0.3848974526735021,1.814255472962316,1.4293580202888136,9.22523392972932,0.6450071667463046,7941484573.0,2013-07-24,2013,2,205,7,1.0,169.02,169.08,167.94,3409
2013-07-25 13:30:00,168.22,169.08,167.94,168.92999,156.77260869565217,174.49495376470588,153.07804535000022,161.01095010000006,164.53880239999995,165.76735450000018,164.15439754494747,166.5732534105811,167.92554384615408,170.62404692780495,165.22704076450322,153.07804535000022,161.01095010000006,164.53880239999995,165.76735450000018,168.64999666666662,111156560,110287538.4,64.55161294442057,1.5,2.75,1.500829972596052,1.0078795992059244,0.29025929526533445,1.7921821393704818,1.501922844105147,5.677254756367924,0.8477106350492982,8052641133.0,2013-07-25,2013,3,206,7,0.68,168.51,169.16,167.52,3410
2013-07-26 13:30:00,168.22,169.16,167.52,169.11,156.82,174.61824794117646,153.19289535000024,161.15915020000006,164.59870220000005,166.16885450000018,164.348734896126,166.8148483238591,168.2316976923079,170.45296656338803,166.01042882122783,153.19289535000024,161.15915020000006,164.59870220000005,166.16885450000018,168.59666666666666,107814496,109204079.2,65.14557191340485,1.5,2.75,1.51077068883919,0.9872753544539754,0.2135211335450704,1.7688242610364853,1.5553031274914149,5.669893748006537,0.5679283993934242,8160455629.0,2013-07-26,2013,4,207,7,0.98,168.34,169.06,168.11,3411
2013-07-29 13:30:00,168.67999,169.06,168.11,168.59,156.86739130434782,174.74154211764701,153.30763535000025,161.3000502000001,164.66370220000005,166.57735450000018,164.51505901784654,166.98391038825346,168.49308230769253,169.85589033663885,167.13027427874619,153.30763535000025,161.3000502000001,164.66370220000005,166.57735450000018,168.58666666666667,79845120,105176194.4,61.918054014093464,1.5,2.75,1.474287068207819,0.7591558190091731,0.1068654228793764,1.6888849060906352,1.5820194832112588,5.7683041310737,0.6357320182499344,8080610509.0,2013-07-29,2013,0,210,7,0.57,168.58,169.28,168.19,3412
2013-07-30 13:30:00,169.10001,169.28,168.19,168.588,156.91478260869562,174.86483629411762,153.42957535000022,161.43817020000006,164.6966622,166.9387545000002,164.67478219361726,167.13668082746742,168.58139000000025,169.80106188437472,167.36171811562582,153.42957535000022,161.43817020000006,164.6966622,166.9387545000002,168.68599999999998,85216944,102839300.8,61.90535051734539,1.5,2.75,1.4468379919072607,0.8286418065572846,0.019863022669377672,1.6068482615479809,1.5869852388786032,5.187858378799722,0.3798151951085483,7995393565.0,2013-07-30,2013,1,211,7,0.65,168.74,169.85001,168.49001,3413
2013-07-31 13:30:00,168.94,169.85001,168.49001,168.71001,156.96217391304344,174.98813047058826,153.55672540000026,161.57087030000002,164.73226259999996,167.3137545000002,164.83302642131858,167.28652170104198,168.6736992307695,169.72508229266037,167.62231616887863,153.55672540000026,161.57087030000002,164.73226259999996,167.3137545000002,169.01667666666663,142388624,102215550.4,62.411997365778944,1.5,2.75,1.440635278199598,1.3930231108944846,-0.04239149706774503,1.5339958675439218,1.576387364611667,5.047473005749112,-0.09474151714336082,8137782189.0,2013-07-31,2013,2,212,7,0.81,169.17,170.81,169.89999,3414
2013-08-01 13:30:00,169.99001,170.81,169.89999,170.66,157.00956521739127,175.11142464705884,153.69322540000022,161.71717030000005,164.8020626,167.78275450000018,165.06153518910997,167.60780534856175,168.86639153846178,170.31140612312987,167.42137695379367,153.69322540000022,161.71717030000005,164.8020626,167.78275450000018,170.45666333333332,110438368,103976652.8,69.41352008736158,1.5,2.75,1.4877320440424833,1.0621458281834593,0.030882991926906245,1.6149911045202998,1.5841081125933936,7.712084078444861,0.8807708222498133,8248220557.0,2013-08-01,2013,3,213,8,0.54,170.35,170.9725,170.05,3415
2013-08-02 13:30:00,170.28,170.9725,170.05,170.95,157.0569565217391,170.9725,153.83352540000024,161.86987040000002,164.9024628,168.17925450000016,165.29245537777234,167.9261096010797,169.1298538461541,170.74000657013477,167.51970112217342,153.83352540000024,161.86987040000002,164.9024628,168.17925450000016,170.6575,91116624,102411640.0,70.299566237747,1.5,2.75,1.4473583266108765,0.8897096462863009,0.07925619582169174,1.683178357370508,1.6039221615488164,7.709581194389615,0.8554572271386364,8339337181.0,2013-08-02,2013,4,214,8,0.54,170.51,170.96001,170.35001,3416
2013-08-05 13:30:00,170.57001,170.96001,170.35001,170.7,157.1043478260869,171.0105498,153.96662540000025,162.01782040000006,165.00746279999996,168.51700400000016,165.504515951193,168.1902896390721,169.34138461538484,170.99786602785244,167.68490320291724,153.96662540000025,162.01782040000006,165.00746279999996,168.51700400000016,170.6700066666666,54072640,99710650.4,68.458452508931,1.5,2.75,1.3875470175672433,0.5422955299467187,0.07484377398915809,1.697476879035264,1.622633105046106,7.8112413140590835,0.922312876906706,8285264541.0,2013-08-05,2013,0,217,8,0.36,170.66,170.7402,169.35001,3417
2013-08-06 13:30:00,170.37,170.7402,169.35001,169.73,157.15173913043475,171.04859960000002,154.08757545000026,162.14782040000006,165.09590279999995,168.74700400000015,165.670221208009,168.33692872106522,169.4075384615387,171.05208196432673,167.7629949587506,154.08757545000026,162.14782040000006,165.09590279999995,168.74700400000015,169.94007,87494944,98120504.0,61.705856539158106,1.5,2.75,1.3877358020267252,0.8917090764230073,-0.00854165102709925,1.611956041262232,1.6204976922893313,8.52014580519656,0.7180156657963325,8197769597.0,2013-08-06,2013,1,218,8,0.82,170.05,169.42999,168.55,3418
2013-08-07 13:30:00,169.19,169.42999,168.55,169.17999,157.19913043478257,171.0866494,154.2024754000002,162.28132030000006,165.1535026,168.94640350000014,165.80785919985178,168.41722027143996,169.40830692307716,171.05241499883616,167.76419884731814,154.2024754000002,162.28132030000006,165.1535026,168.94640350000014,169.05332666666666,84854624,96292716.8,58.20033449160567,1.5,2.75,1.372897530453386,0.8812153901134919,-0.11023237393309082,1.4827072248729678,1.5929395988060586,8.44989105264321,0.1479903005973066,8112914973.0,2013-08-07,2013,2,219,8,0.52,168.99,170.17999,168.92999,3419
2013-08-08 13:30:00,169.98,170.17999,168.92999,169.8,157.2465217391304,171.12469919999998,154.3223753500002,162.4296203000001,165.2451026,169.06440350000014,165.96441374103406,168.54891357892188,169.4313838461541,171.0883634620856,167.7744042302226,154.3223753500002,162.4296203000001,165.2451026,169.06440350000014,169.63666,102181248,94622169.6,60.897128417447654,1.5,2.75,1.3641191354210014,1.079886969744562,-0.1431465222952768,1.4140064459369626,1.5571529682322394,8.58628568433107,0.4080184495298904,8215096221.0,2013-08-08,2013,3,220,8,0.74,169.55,170.10001,168.72,3420
2013-08-09 13:30:00,169.58,170.10001,168.72,169.31,157.29391304347823,171.162749,154.45197735000022,162.57662030000006,165.31470259999998,169.15440400000014,166.09561320216997,168.6213979999769,169.44446076923103,171.09470514462058,167.79421639384148,154.45197735000022,162.57662030000006,165.31470259999998,169.15440400000014,169.37667000000005,91856432,94004360.0,57.727282599915235,1.5,2.75,1.365254197176644,0.9771507619433822,-0.2017394172462743,1.3049786966743966,1.5067181139206711,8.790381243568653,0.4270715938074612,8123239789.0,2013-08-09,2013,4,221,8,0.82,169.41,169.31,168.38,3421
2013-08-12 13:30:00,168.46001,169.31,168.38,169.11099,157.34130434782602,171.2007988,154.58048230000026,162.71083020000006,165.4280222,169.20220350000017,166.21386327267308,168.6680258095029,169.48992153846183,171.0667200768905,167.9131230000331,154.58048230000026,162.71083020000006,165.4280222,169.20220350000017,168.93366333333333,68593184,93961491.2,56.44226446489793,1.5,2.75,1.3341646116640271,0.7300137867543762,-0.2543256097717186,1.1888111017060226,1.4431367114777411,8.603337190661303,0.3102178090967287,8054646605.0,2013-08-12,2013,0,224,8,0.55,168.84,169.89999,168.41,3422
2013-08-13 13:30:00,169.41,169.89999,168.41,169.61,157.38869565217388,171.23884859999995,154.72143230000026,162.86334030000006,165.533222,169.30645400000014,166.34704510511733,168.7577376371693,169.54223000000027,171.08602946210786,167.99843053789272,154.72143230000026,162.86334030000006,165.533222,169.30645400000014,169.30666333333332,80806000,93566688.0,58.912062905053226,1.5,2.75,1.3452949965451684,0.8636193257155794,-0.2552645972718035,1.1240559648879866,1.3793205621597902,8.729280669846515,0.5334538241091933,8135452605.0,2013-08-13,2013,1,225,8,0.88,169.15,169.8,168.7,3423
2013-08-14 13:30:00,169.53,169.8,168.7,168.74001,157.43608695652168,171.27689840000002,154.8600323500003,162.9947403000001,165.63682219999995,169.34594950000016,166.44088686570097,168.75604929077218,169.51376923076947,171.10141223344758,167.92612622809142,154.8600323500003,162.9947403000001,165.63682219999995,169.34594950000016,169.08000333333334,79829184,92914453.6,53.24374135664607,1.5,2.75,1.3277739253633722,0.8591686320802946,-0.3105674760727421,0.9911112170688624,1.301678693141605,9.327065903799461,-1.1250380874252808,8055623421.0,2013-08-14,2013,2,226,8,0.65,169.25,167.42999,166.09,3424
2013-08-15 13:30:00,167.41,167.42999,166.09,166.38,157.48347826086953,171.31494819999998,154.98478240000026,163.10904030000006,165.73898219999995,169.2214495000002,166.43849914547738,168.52975888212725,169.34376923076945,171.6162428737023,167.07129558783663,154.98478240000026,163.10904030000006,165.73898219999995,169.2214495000002,166.63333,152931744,95380028.0,41.56150939248142,1.5,2.75,1.4222193592659893,1.6033937838642698,-0.4914272697893192,0.6873946059049558,1.178821875694275,9.362398967091117,-2.6732962854635822,7902691677.0,2013-08-15,2013,3,227,8,0.81,166.76,166.63,165.5,3425
2013-08-16 13:30:00,166.06,166.63,165.5,165.83,157.5308695652174,171.352998,155.10718235000027,163.2054403000001,165.80098219999996,169.05444950000015,166.41463643389002,168.2726389885913,169.1316153846156,172.0654346468898,166.1977961223414,155.10718235000027,163.2054403000001,165.80098219999996,169.05444950000015,165.98666666666668,130868128,96731852.8,39.39229691106901,1.5,2.75,1.4013465478898468,1.3528959097948758,-0.6248720642501264,0.3977317953816169,1.0226038596317433,8.966661780402431,-2.852958406561205,7771823549.0,2013-08-16,2013,4,228,8,0.68,166.06,166.21001,164.75999,3426
2013-08-19 13:30:00,165.64,166.21001,164.75999,164.77,157.57826086956518,171.39104780000002,155.22428230000028,163.29124030000006,165.80038219999997,168.81794950000014,166.35014088746297,167.93905432301116,168.82853769230792,172.57535249471263,165.08172288990312,155.22428230000028,163.29124030000006,165.80038219999997,168.81794950000014,165.24666666666667,96437568,97582303.2,35.54210971445757,1.5,2.75,1.4048232230405735,0.9882690286818318,-0.7527254578398466,0.08169703733193501,0.8344224951717816,9.096627911502349,-2.9222883403051787,7675385981.0,2013-08-19,2013,0,231,8,0.88,165.48,166.2,164.86,3427
2013-08-20 13:30:00,165.03999,166.2,164.86,165.58,157.625652173913,171.4290976,155.3380323000003,163.38034030000006,165.81598219999998,168.63994950000014,166.31993928403304,167.71438248272437,168.4377684615387,172.39286853974224,164.4826683833351,155.3380323000003,163.38034030000006,165.81598219999998,168.63994950000014,165.54666666666662,89294368,98005540.0,40.3406883485872,1.5,2.75,1.4066215642519595,0.9111155144903031,-0.7493173386091845,-0.10222417808969908,0.6470931605194854,10.145722333695595,-2.1279053155163274,7764680349.0,2013-08-20,2013,1,232,8,0.81,165.53,166.03,164.19,3428
2013-08-21 13:30:00,165.12,166.03,164.19,164.56,157.67304347826084,171.46714740000002,155.45303230000027,163.46544030000004,165.845222,168.44194950000016,166.2509220572082,167.41396510341733,167.94623000000018,172.11291118114482,163.7795488188556,155.45303230000027,163.46544030000004,165.845222,168.44194950000016,164.92666666666668,159530496,100336364.8,36.641475513660026,1.5,2.75,1.4375771668053914,1.5899569046376294,-0.7788941843428316,-0.3265245699090542,0.4523696144337774,10.363978135201034,-3.085983510011784,7605149853.0,2013-08-21,2013,2,233,8,1.12,165.11,166.3,164.89,3429
2013-08-22 13:30:00,164.89999,166.3,164.89,166.06,157.72043478260866,171.50519719999997,155.57408930000028,163.5578402000001,165.931422,168.29845000000014,166.24343491770986,167.285016045949,167.58930692307717,171.540645373437,163.6379684727173,155.57408930000028,163.5578402000001,165.931422,168.29845000000014,165.75,101471376,99852105.6,44.67592212807371,1.5,2.75,1.459178797747864,1.0162166875727856,-0.6649991297436484,-0.3788792977457831,0.2861198319978653,11.935509686445567,-1.9195558443092549,7706621229.0,2013-08-22,2013,3,234,8,0.86,165.6,166.83,165.77,3430
2013-08-23 13:30:00,166.55,166.83,165.77,166.62,157.7678260869565,171.543247,155.69238925000028,163.67174020000004,165.97962180000002,168.17395000000016,166.25820217583887,167.22168118443003,167.35007615384637,171.1267444822714,163.57340782542133,155.69238925000028,163.67174020000004,165.97962180000002,168.17395000000016,166.40666666666667,90893568,99006059.2,47.35972442456102,1.5,2.75,1.4306660264801596,0.9180606594631532,-0.5256221709495774,-0.3709078816891065,0.15471428926047093,12.340520637042284,-1.4729911994483518,7797514797.0,2013-08-23,2013,4,235,8,0.64,166.3,167.3,165.89,3431
2013-08-26 13:30:00,166.78999,167.3,165.89,166.0,157.81521739130432,171.58129680000002,155.82378925000032,163.77314020000006,166.03612180000002,168.04445000000015,166.24807660031578,167.10533059543673,167.10546153846175,170.78708851203208,163.42383456489142,155.82378925000032,163.77314020000006,166.03612180000002,168.04445000000015,166.39666666666668,89705056,99499056.0,44.77023548249172,1.5,2.75,1.429189881731579,0.9015669053181772,-0.4516868628170094,-0.4098942892607909,0.04179257355621857,12.3949628720419,-2.1284122398443572,7707809741.0,2013-08-26,2013,0,238,8,0.85,166.6,166.0024,163.21001,3432
2013-08-27 13:30:00,164.36,166.0024,163.21001,163.33,157.8626086956521,171.6193466,155.95023930000028,163.8548602000001,166.01392180000002,167.78155000000012,166.13364222383282,166.74577530063326,166.60776923076943,170.44384209794944,162.77169636358943,155.95023930000028,163.8548602000001,166.01392180000002,167.78155000000012,164.18080333333333,158621744,103169296.0,35.71400104758341,1.5,2.75,1.5265613187507503,1.5374898361233365,-0.5524416496272095,-0.6487594884777934,-0.09631783885058384,14.389650344783874,-3.206121654253783,7549187997.0,2013-08-27,2013,1,239,8,1.71,164.61,164.49001,163.05,3433
2013-08-28 13:30:00,163.25999,164.49001,163.05,163.91,163.05,171.6573964,156.07898930000027,163.9318601000001,165.97742179999997,167.54154950000014,166.04644056799626,166.47570146247767,166.1923846153848,169.93642848662574,162.44834074414388,156.07898930000027,163.9318601000001,165.97742179999997,167.54154950000014,163.81667000000004,108112944,101455512.0,38.618665817422425,1.5,2.75,1.5203790816971257,1.065619224315777,-0.5487405375496769,-0.78224351078768,-0.23350297323800304,14.938806702698464,-1.4845534319028724,7657300941.0,2013-08-28,2013,2,240,8,0.88,163.77,165.03999,163.39999,3434
2013-08-29 13:30:00,163.55,165.03999,163.39999,164.17,163.20913043478262,171.6954462,156.20851430000027,164.0060601000001,165.99182179999997,167.21704950000014,165.9728546633689,166.25611084700358,165.8123084615386,169.28757886929785,162.33703805377942,156.20851430000027,164.0060601000001,165.99182179999997,167.21704950000014,164.2033266666666,119200432,101893615.2,39.928977704866966,1.5,2.75,1.5289234330044728,1.1698518279681178,-0.49893347184501,-0.8571698130442655,-0.3582363411992556,13.264006707360954,-1.0010251462341102,7776501373.0,2013-08-29,2013,3,241,8,1.0,164.22,164.53,163.17,3435
2013-08-30 13:30:00,164.50999,164.53,163.17,163.64999,163.36826086956526,171.733496,156.33781430000028,164.0558600000001,166.07682179999995,166.85204900000014,165.88176193147208,166.0079088615747,165.35384615384632,168.22399005226075,162.4837022554319,156.33781430000028,164.0558600000001,166.07682179999995,166.85204900000014,163.78333,134928944,104084231.2,38.17377802261586,1.5,2.75,1.5168574735041542,1.2963437635498432,-0.4714803019623699,-0.947586718652218,-0.4761064166898481,13.256712543188732,-0.6797414577896508,7641572429.0,2013-08-30,2013,4,242,8,0.83,163.85,165.58,163.7,3436
2013-09-03 13:30:00,165.23,165.58,163.7,164.39,163.52739130434784,171.77154579999996,156.48011480000028,164.1078600000001,166.18322159999997,166.53654900000012,165.82326146357124,165.85382230332948,165.01923000000016,167.15175610712768,162.88670389287262,156.48011480000028,164.1078600000001,166.18322159999997,166.53654900000012,164.55666666666662,142375056,108499352.0,42.07596204553351,1.5,2.75,1.5463683682538585,1.312220334735271,-0.37799112970112425,-0.9485953288162534,-0.5706041991151292,13.204472433671894,-0.7186858316221924,7783947485.0,2013-09-03,2013,1,246,9,1.15,164.64,166.03,164.13499,3437
2013-09-04 13:30:00,164.42999,166.03,164.13499,165.75,163.68652173913048,171.8095956,156.63036480000028,164.1773600000001,166.35702159999997,166.33754900000014,165.8203884649998,165.8439344649171,164.97076846153863,167.00370636766002,162.93783055541726,156.63036480000028,164.1773600000001,166.35702159999997,166.33754900000014,165.30499666666663,97389376,108994073.6,48.50816066227942,1.5,2.75,1.5712713419500122,0.8935290955122169,-0.2075848957377573,-0.8300853187873258,-0.6225004230495685,13.802648231225545,0.7231404958677672,7881336861.0,2013-09-04,2013,2,247,9,1.15,165.08,166.39999,165.73,3438
2013-09-05 13:30:00,165.85001,166.39999,165.73,165.96001,163.8456521739131,171.8476454,156.7783148500003,164.28578010000012,166.50472179999997,166.1765500000001,165.82586381931355,165.85498927778218,164.98076923076937,167.03171561702015,162.92982284451858,156.7783148500003,164.28578010000012,166.50472179999997,166.1765500000001,166.03000000000003,63090432,107905864.0,49.4417975272029,1.5,2.75,1.5068941032392975,0.5846802913324525,-0.07081806124410027,-0.7110229996046941,-0.6402049383605937,13.212892160278162,-0.060213175960490875,7944427293.0,2013-09-05,2013,3,248,9,0.4,166.06,166.98,164.48,3439
2013-09-06 13:30:00,166.50999,166.98,164.48,166.03999,164.00478260869568,171.8856952,156.91286480000028,164.37208000000012,166.62272159999995,165.9885495000001,165.83426092443852,165.87260839418389,165.0784607692309,167.19972281739302,162.95719872106883,156.91286480000028,164.37208000000012,166.62272159999995,165.9885495000001,165.83333000000002,159756432,110784623.2,49.81499582904824,1.5,2.75,1.5778302387222052,1.4420451808694692,0.029557903765155106,-0.6032575586541498,-0.6328154624193049,12.133902355371209,-0.3481034689713214,8104183725.0,2013-09-06,2013,4,249,9,1.52,165.73,167.73,166.45,3440
2013-09-09 13:30:00,166.45,167.73,166.45,167.63400000000001,164.16391304347832,171.923745,157.05508480000032,164.49732000000014,166.75380159999997,165.9047495000001,165.90483892740173,166.0403599756902,165.23646076923094,167.75280141879628,162.72012011966558,157.05508480000032,164.49732000000014,166.75380159999997,165.9047495000001,167.27133333333333,87559248,110569764.0,56.678499221667394,1.5,2.75,1.5858430788134759,0.7918914252181998,0.19841739194892186,-0.3847937224831526,-0.5832111144320744,13.231438044678484,0.984337349397582,8191742973.0,2013-09-09,2013,0,252,9,0.77,167.09,168.89999,168.25999,3441
2013-09-10 13:30:00,168.64,168.89999,168.25999,168.87,164.32304347826087,171.9617948,157.20218480000028,164.64462000000015,166.9228016,165.8927000000001,166.02111975377812,166.30984950181494,165.5679992307694,168.70070416961713,162.43529429192168,157.20218480000028,164.64462000000015,166.9228016,165.8927000000001,168.67666,105847744,112432492.0,61.1189034295548,1.5,2.75,1.5629964303268002,0.9414337627596122,0.3780495371191474,-0.11064919303314014,-0.4886987301522875,13.428132864664354,3.3919059572644286,8297590717.0,2013-09-10,2013,1,253,9,0.38,168.58,169.39999,168.35001,3442
2013-09-11 13:30:00,168.64,169.39999,168.35001,169.39999,164.48217391304345,171.9998446,157.3424347000003,164.78381990000014,167.08360139999996,165.8821995000001,166.15362446931624,166.60414859688018,165.8249215384617,169.56571336414794,162.08412971277545,157.3424347000003,164.78381990000014,167.08360139999996,165.8821995000001,169.04999666666666,94545808,113119482.4,62.87604648425084,1.5,2.75,1.526352399589172,0.8358048144675739,0.5090996009110265,0.14767577098649556,-0.3614238299245309,7.074861125829325,3.349392959550977,8392136525.0,2013-09-11,2013,2,254,9,0.62,168.88,169.56,168.72,3443
2013-09-12 13:30:00,169.34,169.56,168.72,168.95,164.6413043478261,172.03789440000003,157.4819347000003,164.91161990000015,167.23840119999997,165.89269900000005,166.26328625483325,166.8275630162249,166.00415230769246,170.08771445022424,161.9205901651607,157.4819347000003,164.91161990000015,167.23840119999997,165.89269900000005,169.07666666666663,83209008,113288473.6,60.38094402192251,1.5,2.75,1.4773272281899457,0.7344878552587366,0.5391291212335643,0.3124875716174245,-0.22664154961613986,7.948104977024674,2.911616007796797,8308927517.0,2013-09-12,2013,3,255,9,0.5,169.14,169.46001,168.74001,3444
2013-09-13 13:30:00,169.13,169.46001,168.74001,169.33,164.80043478260868,172.07594419999998,157.6269347000003,165.02711990000014,167.39940119999994,166.04019900000006,166.3835495389574,167.06589034801303,166.26030615384633,170.7118767524583,161.8087355552343,157.6269347000003,165.02711990000014,167.39940119999994,166.04019900000006,169.17667333333338,72727744,109278273.6,61.76093375247179,1.5,2.75,1.4232324261763782,0.6655279371104561,0.5560059633960406,0.4683659046289108,-0.08764005876712971,7.913211890543994,3.4708281986451754,8381655261.0,2013-09-13,2013,4,256,9,0.43,169.1,171.24001,170.03999,3445
2013-09-16 13:30:00,171.16,171.24001,170.03999,170.31,164.95956521739132,172.113994,157.7711846500003,165.15141990000018,167.54520119999995,166.26419900000005,166.53752798841006,167.37485317201183,166.79722923076937,171.38715685202587,162.20730160951288,157.7711846500003,165.15141990000018,167.54520119999995,166.26419900000005,170.53,126187504,109044242.4,65.1338310971125,1.5,2.75,1.4580022528780654,1.1572138172789943,0.6007775979752703,0.6633319387019583,0.06255434072668792,6.926540696329213,3.60119228663545,8507842765.0,2013-09-16,2013,0,259,9,0.71,170.64,171.11,170.46001,3446
2013-09-17 13:30:00,170.46001,171.11,170.46001,171.07001,165.1186956521739,172.1520438,157.9159347000003,165.27692000000016,167.68770119999994,166.57919950000004,166.71527238102144,167.72677286991544,167.34799923076937,172.1340755026349,162.56192295890384,157.9159347000003,165.27692000000016,167.68770119999994,166.57919950000004,170.88000666666667,82523184,108348523.2,67.52609083236561,1.5,2.75,1.4110020919582045,0.7616456741885708,0.6452776034292955,0.8691513450133073,0.2238737415840118,6.924994780873264,3.2096591251885354,8590365949.0,2013-09-17,2013,1,260,9,0.38,170.79,173.52,170.58,3447
2013-09-18 13:30:00,171.00999,173.52,170.58,173.05098999999998,165.27782608695654,172.19009359999995,158.07041465000032,165.42502980000015,167.84612099999995,166.9527490000001,166.96373189549118,168.23384116801873,168.03115230769248,173.31694047303608,162.74536414234885,158.07041465000032,165.42502980000015,167.84612099999995,166.9527490000001,172.38366333333335,203460624,114056836.0,72.77042575378634,1.5,2.75,1.5202162282469038,1.7838529555562983,0.7637233279982889,1.178527901581873,0.4148045735835841,7.851788875410713,4.27270400863437,8793826573.0,2013-09-18,2013,2,261,9,1.72,172.05,173.60001,172.58501,3448
2013-09-19 13:30:00,173.52,173.60001,172.58501,172.75999,165.43695652173915,173.60001,158.22696460000031,165.55962970000016,167.99748079999995,167.3627485000001,167.1910361348837,168.66490296154075,168.73192153846168,173.92324192127617,163.54060115564718,158.22696460000031,165.55962970000016,167.99748079999995,167.3627485000001,172.98167,146616816,113411152.0,70.95761512116644,1.5,2.75,1.4841293548006953,1.2927901129158796,0.7755745403474039,1.384272749017839,0.6086982086704351,8.429835749496506,4.047217781692228,8647209757.0,2013-09-19,2013,3,262,9,0.59,173.09,172.33,170.58,3449
2013-09-20 13:30:00,172.33,172.33,170.58,170.72,165.59608695652176,173.67963151515147,158.3743146000003,165.67002980000015,168.06308079999997,167.5957485000001,167.32942687469216,168.86062648901301,169.21884461538474,173.84668092744633,164.59100830332318,158.3743146000003,165.67002980000015,168.06308079999997,167.5957485000001,171.21,132867936,114980980.0,59.72516246712832,1.5,2.75,1.533833686600644,1.1555644768378213,0.6066089702809428,1.3669594215216136,0.7603504512406708,12.374787177371314,1.8409153274395489,8514341821.0,2013-09-20,2013,4,263,9,1.03,171.46,170.64999,169.39,3450
2013-09-23 13:30:00,170.49001,170.64999,169.39,169.92999,165.75521739130437,173.75925303030303,158.5164645500003,165.7865297000002,168.11148079999995,167.7612480000001,167.4314097423513,168.96247063291656,169.54038230769248,173.7184806782407,165.36228393714424,158.5164645500003,165.7865297000002,168.11148079999995,167.7612480000001,169.9899933333334,104616432,115667123.2,56.026391249534356,1.5,2.75,1.5192741375577417,0.9044612600860468,0.41155661725597215,1.274796222810636,0.8632396055546638,12.211251948663929,0.6276958607212644,8409725389.0,2013-09-23,2013,0,266,9,0.74,170.02,170.53,169.21001,3451
2013-09-24 13:30:00,169.89999,170.53,169.21001,169.53,165.91434782608695,173.83887454545453,158.65421455000032,165.88432970000017,168.13898079999996,167.93774800000008,167.51370739951398,169.01652104882928,169.81499692307708,173.44963011714938,166.18036372900482,158.65421455000032,165.88432970000017,168.13898079999996,167.93774800000008,169.75666999999996,106333008,116498520.8,54.1963071260105,1.5,2.75,1.5050395563036163,0.9127412714754399,0.23433068517397584,1.1561529620221336,0.9218222768481578,11.73214889637974,0.07674734809606461,8303392381.0,2013-09-24,2013,1,267,9,0.78,169.87,169.98,168.89,3452
2013-09-25 13:30:00,169.64,169.98,168.89,169.03999,166.0734782608696,173.9184960606061,158.7873395500003,165.9610496000002,168.16928079999994,168.2232475000001,167.57356161914092,169.01875618703605,170.04576615384633,173.01182885091515,167.0797034567775,158.7873395500003,165.9610496000002,168.16928079999994,168.2232475000001,169.30333000000002,117306496,114432758.4,51.95725059882565,1.5,2.75,1.4753938737105012,1.0251128928479976,0.0712895314669848,1.0109341911818888,0.939644659714904,11.726369659352779,0.053264279372595584,8186085885.0,2013-09-25,2013,2,268,9,0.65,169.44,170.17,169.05,3453
2013-09-26 13:30:00,169.32001,170.17,169.05,169.69,166.23260869565217,173.99811757575756,158.9234245000003,166.04014960000018,168.20407879999996,168.5122475000001,167.656559202704,169.08268416922306,170.20392000000018,172.83957814388717,167.56826185611314,158.9234245000003,166.04014960000018,168.20407879999996,168.5122475000001,169.63666666666668,77146880,112884455.2,54.63468635448701,1.5,2.75,1.450723597016894,0.6834145575076488,-0.0017230614264942545,0.937490832931786,0.9392138943582804,11.82242301825093,0.21260261028759533,8263232765.0,2013-09-26,2013,3,269,9,0.66,169.61,169.14,168.47,3454
2013-09-27 13:30:00,168.84,169.14,168.47,168.90900000000002,166.39173913043481,174.0777390909091,159.05076950000029,166.10324060000016,168.2048587999999,168.7491975000001,167.70567452808814,169.06614281977326,170.2069200000002,172.83658001061116,167.57725998938926,159.05076950000029,166.10324060000016,168.2048587999999,168.7491975000001,168.83966666666666,99141680,111881517.6,50.9598735070671,1.5,2.75,1.4342433400871155,0.88613099041481,-0.10579984367226848,0.8069640897679449,0.9127639334402132,12.089909398408238,-0.8226175797075982,8164091085.0,2013-09-27,2013,4,270,9,0.4,168.8,168.53999,167.14999,3455
2013-09-30 13:30:00,167.48,168.53999,167.14999,168.00999,166.55086956521743,174.1573606060606,159.17326950000032,166.14994050000016,168.1816585999999,168.96719750000008,167.71760846816312,168.9655568369377,170.09999692307713,172.955537048737,167.24445679741726,159.17326950000032,166.14994050000016,168.1816585999999,168.96719750000008,167.89999,143937376,112331939.2,47.03783154145209,1.5,2.75,1.4574409586523212,1.2813575286342072,-0.2311811643489443,0.6237874780040329,0.8549686423529772,11.74240009186351,-1.7887530374260274,8020153709.0,2013-09-30,2013,0,273,9,0.83,167.84,169.5,167.9671,3456
2013-10-01 13:30:00,168.14,169.5,167.9671,169.34,166.71000000000004,174.23698212121212,159.3068195000003,166.21453050000014,168.17845859999994,169.21469750000009,167.78123166549003,169.00121809056267,170.12999692307716,172.94447913971146,167.31551470644285,159.3068195000003,166.21453050000014,168.17845859999994,169.21469750000009,168.9357,127160432,111571208.0,52.8226828696313,1.5,2.75,1.4628308901771558,1.1397244349993951,-0.22056530332437616,0.5792620131975071,0.7998273165218832,12.502733270599506,-2.1444488702433944,8147314141.0,2013-10-01,2013,1,274,10,0.91,168.73,169.34219,167.83,3457
2013-10-02 13:30:00,168.35001,169.34219,167.83,169.17999,166.86913043478262,174.31660363636365,159.4421939500003,166.27223040000015,168.17925839999995,169.3861970000001,167.83608493351002,169.01824398669956,170.1184576923079,172.94715921866631,167.28975616594948,159.4421939500003,166.27223040000015,168.17925839999995,169.3861970000001,168.78406,113349744,112369226.4,52.085592135640276,1.5,2.75,1.4663565408787858,1.0087258552133274,-0.21985242698904006,0.5250117827855831,0.7448642097746232,9.661820639859062,-2.0722390641490454,8033964397.0,2013-10-02,2013,2,275,10,0.9,168.59,168.94,166.84,3458
2013-10-03 13:30:00,168.78999,168.94,166.84,167.62,167.02826086956526,174.39622515151515,159.5614439500003,166.31303050000014,168.16125839999995,169.4691965000001,167.82761101454886,168.88507789272816,169.91153461538485,173.03238382746548,166.79068540330422,159.5614439500003,166.31303050000014,168.16125839999995,169.4691965000001,167.79999999999995,176698432,118049626.4,45.42978738636613,1.5,2.75,1.5287589308160157,1.4968148344771042,-0.3142262845984568,0.35208135402655216,0.6663076386250091,10.441392438375065,-1.8158388003748795,7857265965.0,2013-10-03,2013,3,276,10,1.26,167.89,169.06,167.53,3459
2013-10-04 13:30:00,167.75,169.06,167.53,168.89,167.18739130434784,174.47584666666665,159.67904395000028,166.34963050000013,168.16045859999994,169.6116970000001,167.8692733277038,168.88554666484933,169.74384153846174,172.83177933844115,166.65590373848238,159.67904395000028,166.34963050000013,168.16045859999994,169.6116970000001,168.49333333333334,96878368,114905723.2,50.9275649688459,1.5,2.75,1.528847578614872,0.8431117728694648,-0.28193189565561905,0.31389276905548513,0.5958246647111042,10.362213515207966,-0.6120108640034742,7954144333.0,2013-10-04,2013,4,277,10,0.91,168.3,168.45,167.25,3460
2013-10-07 13:30:00,167.42,168.45,167.25,167.42999,167.34652173913045,174.5554681818182,159.79474395000028,166.36278030000008,168.12685839999997,169.60149650000008,167.85204653053896,168.74692222057794,169.31145692307717,171.97032675852742,166.65258708762693,159.79474395000028,166.36278030000008,168.12685839999997,169.60149650000008,167.70999666666668,96295120,115342516.8,45.279843963705865,1.5,2.75,1.5367870372852368,0.8348623098538109,-0.3455175095575682,0.1639277777641439,0.5094452873217121,11.102216596767738,-1.2387247094909442,7857849213.0,2013-10-07,2013,0,280,10,0.72,167.85,167.62,165.36,3461
2013-10-08 13:30:00,167.39999,167.62,165.36,165.48,167.50565217391306,174.6350896969697,159.89654395000028,166.36418030000013,168.0646583999999,169.43199650000008,167.75902509796882,168.4357867709991,168.75145769230792,171.33466122381566,166.1682541608002,159.89654395000028,166.36418030000013,168.0646583999999,169.43199650000008,166.15333333333334,178014944,118950876.8,39.050922465156056,1.5,2.75,1.5884451060505766,1.4965416715616846,-0.4963474634094165,-0.11098904194005854,0.385358421469358,12.569920710375525,-2.106004620563453,7679834269.0,2013-10-08,2013,1,281,10,1.37,166.49,166.2,164.53,3462
2013-10-09 13:30:00,165.8,166.2,164.53,165.60001,164.53,174.7147112121212,160.01059405000024,166.3507804000001,168.0048985999999,169.24199750000008,167.6743578392249,168.16571279280868,168.35761230769256,171.1711529670659,165.54407164831917,160.01059405000024,166.3507804000001,168.0048985999999,169.24199750000008,165.44333666666668,168972816,122672227.2,39.6016072191973,1.5,2.75,1.5942704556183915,1.3774333429563754,-0.5607198835500831,-0.31554143296824577,0.2451784505818373,12.690438852605755,-2.4102716718722377,7848807085.0,2013-10-09,2013,2,282,10,1.02,165.36,169.25999,167.23,3463
2013-10-10 13:30:00,167.28999,169.25999,167.23,169.17,164.5810344827586,174.79433272727272,160.1446940000003,166.3731805000001,168.01409839999994,169.25299750000013,167.7330104729808,168.2613591934936,168.2991515384618,171.00925845895839,165.58904461796516,160.1446940000003,166.3731805000001,168.01409839999994,169.25299750000013,168.55333000000002,195954752,128309514.4,53.159487665075034,1.5,2.75,1.7418211373599344,1.5272035976156733,-0.3460802300329458,-0.187421836959345,0.1586583930736008,18.35215223903482,0.15452107347743205,8044761837.0,2013-10-10,2013,3,283,10,1.21,168.24,170.32001,168.77,3464
2013-10-11 13:30:00,168.91,170.32001,168.77,170.25999,164.63206896551725,174.87395424242425,160.28724395000026,166.40408040000008,168.00609819999994,169.29949700000014,167.83210770933448,168.4517049845894,168.35530461538485,171.19237335152505,165.51823587924468,160.28724395000026,166.40408040000008,168.00609819999994,169.29949700000014,169.78333333333333,105039744,129925114.4,56.37908380688278,1.5,2.75,1.7281203418342237,0.80846374071001,-0.12529199884051506,0.002043394522956987,0.12733539336347205,18.496403200590144,1.3392060793527814,8149801581.0,2013-10-11,2013,4,284,10,0.92,169.55,171.08,169.08,3465
2013-10-14 13:30:00,169.21001,171.08,169.08,170.94,164.68310344827586,174.95357575757575,160.4341359500003,166.45418050000006,168.0058981999999,169.33099700000014,167.9539858383802,168.6886854622476,168.50145923076946,171.64388738153312,165.35903108000582,160.4341359500003,166.45418050000006,168.0058981999999,169.33099700000014,170.36666666666667,112106368,129221057.6,58.304592371757224,1.5,2.75,1.7475403174174935,0.8675549487222275,0.06189755780400924,0.2047073406184836,0.14280978281447435,18.136343993338677,0.9448446911538882,8261907949.0,2013-10-14,2013,0,287,10,1.18,170.08,171.14999,169.47,3466
2013-10-15 13:30:00,170.50999,171.14999,169.47,169.7,164.7341379310345,175.03319727272728,160.58248595000026,166.49668050000008,167.98589819999995,169.26249650000014,168.02245698197314,168.78500113250968,168.50222846153866,171.64582467958746,165.35863224348986,160.58248595000026,166.49668050000008,167.98589819999995,169.26249650000014,170.10666333333333,155484496,132869123.2,53.65364946357929,1.5,2.75,1.7427152947448157,1.1702078876968158,0.09554370051967563,0.2622394084640689,0.16669570794439328,18.339188712055964,0.3073708657861872,8106423453.0,2013-10-15,2013,1,288,10,0.99,170.31,172.16,170.63499,3467
2013-10-16 13:30:00,170.72,172.16,170.63499,172.07001,164.78517241379308,175.1128187878788,160.73078600000025,166.56430060000002,168.0326983999999,169.21344750000014,168.18118455130752,169.0978591198897,168.74538307692325,172.42117200083905,165.06959415300744,160.73078600000025,166.56430060000002,168.0326983999999,169.21344750000014,171.62166666666667,161676064,130779895.2,60.190106843138636,1.5,2.75,1.7939499165487582,1.236245554049045,0.2613526607546237,0.4933865338876728,0.2320338731330492,19.897293535457568,2.654820427156659,8268099517.0,2013-10-16,2013,2,289,10,0.89,171.4,173.32001,171.34,3468
2013-10-17 13:30:00,171.37,173.32001,171.34,173.22,164.83620689655172,175.1924403030303,160.8665860000003,166.6335006000001,168.1134985999999,169.2364480000001,168.3787851571386,169.49044396561453,169.14615307692327,173.48933541305973,164.80297074078675,160.8665860000003,166.6335006000001,168.1134985999999,169.2364480000001,172.62667,129389184,129918513.6,62.92263310714754,1.5,2.75,1.8072399225095608,0.9959256799871516,0.4228522331186459,0.7605991645313566,0.3377469314127107,18.75706356391077,2.5637989223755184,8397488701.0,2013-10-17,2013,3,290,10,1.16,172.33,174.50999,173.50999,3469
2013-10-18 13:30:00,173.86,174.50999,173.50999,174.388,164.88724137931038,175.2720618181818,161.00985550000024,166.72518060000004,168.20525859999995,169.41984800000014,168.61444064117237,169.95687787365125,169.5344607692309,174.70195419286077,164.3669673456011,161.00985550000024,166.72518060000004,168.20525859999995,169.41984800000014,174.13599333333332,138315680,130190900.8,65.51189581830545,1.5,2.75,1.7702934994731625,1.062406659375384,0.5733702805550812,1.0544597821065622,0.48108950155148106,18.69430368385174,4.155772809877131,8535804381.0,2013-10-18,2013,4,291,10,0.58,174.01,174.75,174.00999,3470
2013-10-21 13:30:00,174.45,174.75,174.00999,174.39999,164.938275862069,175.35168333333337,161.15000545000024,166.81088050000002,168.30705839999996,169.64334800000015,168.84132492975382,170.380031409494,169.93599923076937,175.70691853683337,164.16507992470537,161.15000545000024,166.81088050000002,168.30705839999996,169.64334800000015,174.38666000000003,104103568,130165257.6,65.5385007668618,1.5,2.75,1.6967018209393658,0.7997799867604609,0.6340342317483413,1.2736322912369076,0.6395980594885663,17.283051985709175,5.3903734590282895,8639907949.0,2013-10-21,2013,0,294,10,0.43,174.38,175.92999,174.42619,3471
2013-10-22 13:30:00,174.91,175.92999,174.42619,175.41,164.98931034482754,175.43130484848484,161.29720795000026,166.9305304000001,168.43303859999997,169.9373480000001,169.09892003054782,170.85907603716126,170.53523000000013,176.81509356081273,164.25536643918753,161.29720795000026,166.9305304000001,168.43303859999997,169.9373480000001,175.25539333333333,126663248,131181769.6,67.79243950077691,1.5,2.75,1.6847945480151256,0.9655552626422262,0.697445484192744,1.5114049147294963,0.8139594305367523,14.055054040014474,5.923906647107086,8766571197.0,2013-10-22,2013,1,295,10,0.86,175.18,174.89,173.96001,3472
2013-10-23 13:30:00,174.81,174.89,173.96001,174.57001,165.04034482758618,175.51092636363637,161.44230995000024,167.0327304000001,168.5322387999999,170.2138490000001,169.31347257836947,171.2124983193364,170.97215384615401,177.51809014735616,164.4262175449518,161.44230995000024,167.0327304000001,168.5322387999999,170.2138490000001,174.47334000000004,105484368,130590663.2,64.04099002051422,1.5,2.75,1.6680227945854729,0.8077481606663591,0.6396022718021663,1.6134622702894603,0.973859998487294,15.104757718875206,3.1920612401726127,8661086829.0,2013-10-23,2013,2,296,10,0.53,174.43,175.37,174.50999,3473
2013-10-24 13:30:00,174.92,175.37,174.50999,175.14999,165.09137931034482,175.59054787878787,161.58845990000032,167.14863030000006,168.66043839999998,170.48684850000006,169.54235561451185,171.58749752701863,171.56600000000014,178.1195208294319,165.01247917056833,161.58845990000032,167.14863030000006,168.66043839999998,170.48684850000006,175.00999333333337,70350432,130250840.8,65.46213037257874,1.5,2.75,1.6103075949722256,0.5401149932538478,0.5979527318527216,1.7213009133031962,1.1233481814504744,11.11946595496996,2.8720781670432474,8731437261.0,2013-10-24,2013,3,297,10,0.49,174.94,176.0,175.17,3474
2013-10-25 13:30:00,175.50999,176.0,175.17,175.95,165.14241379310346,175.6701693939394,161.73280990000032,167.2954103000001,168.85183840000002,170.83889850000006,169.79363578649176,172.0029739530169,172.3713846153847,178.2765517836765,166.46621744709296,161.73280990000032,167.2954103000001,168.85183840000002,170.83889850000006,175.70666666666665,93625056,129975009.6,67.37733741661322,1.5,2.75,1.5560006239027813,0.7203312105006376,0.581315355113105,1.849992375341856,1.2686770202287507,10.989558479786416,2.9308529308529256,8825062317.0,2013-10-25,2013,4,298,10,0.47,175.58,176.47,175.7,3475
2013-10-28 13:30:00,175.89,176.47,175.7,176.23,165.1934482758621,175.74979090909093,161.87860985000032,167.43041030000006,169.05983839999996,171.24989900000006,170.04604222623718,172.40554786225334,173.18907615384626,177.95033304366783,168.42781926402472,161.87860985000032,167.43041030000006,169.05983839999996,171.24989900000006,176.13333333333333,84979018,127027091.7,68.04522481615915,1.5,2.75,1.4998577221954403,0.6689834181254423,0.5467165178438107,1.9520726675335143,1.4053561496897031,11.019714788621984,3.847967000589276,8910041335.0,2013-10-28,2013,0,301,10,0.44,176.08,177.24,176.38,3476
2013-10-29 13:30:00,176.63,177.24,176.38,177.17,165.24448275862068,175.82941242424243,162.0296098500003,167.5541103000001,169.30783839999995,171.64139900000004,170.3254131193259,172.8593052087054,173.80446076923087,178.3936721283529,169.2152494101088,162.0296098500003,167.5541103000001,169.30783839999995,171.64139900000004,176.92999999999995,87401344,125039137.3,70.24745387356933,1.5,2.75,1.4648678848957677,0.6989918987548869,0.5435470938934304,2.0847900170564917,1.5412429231630609,8.865005993492117,2.963904052774793,8997442679.0,2013-10-29,2013,1,302,10,0.49,176.81,177.51,175.66,3477
2013-10-30 13:30:00,177.38,177.51,175.66,176.29,165.29551724137932,175.9090339393939,162.17570980000028,167.66901030000008,169.5220384,171.99689950000004,170.55931848719547,173.18603804597151,174.26830769230781,178.5386140610636,169.9980013235519,162.17570980000028,167.66901030000008,169.5220384,171.99689950000004,176.48666666666665,140001834,126371741.8,65.68368409779995,1.5,2.75,1.492377321688927,1.1078571206335939,0.44285616183973975,2.094813125462736,1.6519569636229958,7.983310137637737,1.772312665973902,8857440845.0,2013-10-30,2013,2,303,10,1.05,176.58,176.89,175.53,3478
2013-10-31 13:30:00,176.15,176.89,175.53,175.79,165.3465517241379,175.98865545454547,162.31940980000027,167.7959302000001,169.74663840000005,172.40539950000004,170.76444325240348,173.4340344225457,174.64138461538468,178.5121396948775,170.7706295358919,162.31940980000027,167.7959302000001,169.74663840000005,172.40539950000004,176.06999999999996,133795417,124226591.05,63.17241843236211,1.5,2.75,1.4829217987111452,1.0770271957808828,0.30956037633189704,2.038907434037867,1.7293470577059702,7.999559604772968,0.8039544005321391,8723645428.0,2013-10-31,2013,3,304,10,0.77,176.21,176.61,175.22,3479
2013-11-01 13:30:00,176.02,176.61,175.22,176.21,165.39758620689653,176.06827696969697,162.46045980000028,167.9405302000001,169.9496384,172.7713995000001,170.97799449740728,173.69841209658898,175.14215384615397,177.82985721193054,172.45445048037737,162.46045980000028,167.9405302000001,169.9496384,172.7713995000001,176.01333333333335,142805050,126522925.15,64.40355368735025,1.5,2.75,1.476284527374636,1.1286891275292332,0.2208227856740752,2.005375539798564,1.7845527541244888,7.318566063291112,1.037849830151943,8866450478.0,2013-11-01,2013,4,305,11,0.79,175.92,176.9,175.9825,3480
2013-11-04 14:30:00,176.69,176.9,175.9825,176.83,165.44862068965514,176.14789848484853,162.6029598000003,168.0667301000001,170.15383839999996,173.24140000000008,171.20748490927366,173.99665856358052,175.50830692307701,177.66701432376502,173.34959952238898,162.6029598000003,168.0667301000001,170.15383839999996,173.24140000000008,176.57083333333333,85676773,125992007.8,66.19985117673366,1.5,2.75,1.4363713468478776,0.6800175225082808,0.17692541241390392,2.0057095196418686,1.8287841072279647,7.417338288302371,0.8095319537084635,8952127251.0,2013-11-04,2013,0,308,11,0.52,176.44,176.75,175.57,3481
2013-11-05 14:30:00,176.14,176.75,175.57,176.27,165.49965517241378,176.22752,162.73865980000028,168.1976801000001,170.35923839999995,173.78090000000003,171.40601491283155,174.2131672718109,175.74292230769242,177.4770421848286,174.00880243055627,162.73865980000028,168.1976801000001,170.35923839999995,173.78090000000003,176.1966666666667,85824778,121382499.5,63.102440463422454,1.5,2.75,1.423773393501602,0.7070605594177932,0.0877260994543998,1.9384417315459643,1.8507156320915643,7.2548876876790915,0.9738156055556244,8866302473.0,2013-11-05,2013,1,309,11,0.67,176.16,177.5,176.54,3482
2013-11-06 14:30:00,177.03,177.5,176.54,177.17,165.5506896551724,176.30714151515147,162.87765980000032,168.3249801000001,170.63603840000002,174.35939950000005,171.6320535437009,174.49477038878132,175.95692230769242,177.65567265941792,174.258171955967,162.87765980000032,168.3249801000001,170.63603840000002,174.35939950000005,177.06999999999996,87347728,117301245.1,65.866584654875,1.5,2.75,1.4099324368229154,0.7446445084665176,0.06778222736396589,1.935443416296522,1.8676611889325558,6.82535481941162,1.1533029490895117,8953650201.0,2013-11-06,2013,2,310,11,0.54,177.02,177.64,174.76,3483
2013-11-07 14:30:00,177.5,177.64,174.76,174.93,165.60172413793103,176.38676303030303,163.00525980000032,168.4169301000001,170.8564384,174.64739950000003,171.76138477728125,174.53622082794502,175.99769230769246,177.56540687840808,174.42997773697672,163.00525980000032,168.4169301000001,170.8564384,174.64739950000003,175.77666666666664,157000422,115353528.6,54.852473383096324,1.5,2.75,1.514937262764135,1.361037012958787,-0.10825013915447056,1.7323485149894682,1.8405986541439383,10.468134338539206,-0.5797101449275259,8796649779.0,2013-11-07,2013,3,311,11,1.65,176.2,177.31,174.85,3484
2013-11-08 14:30:00,174.87,177.31,174.85,177.29,165.6527586206896,176.46638454545453,163.14045980000031,168.5553301000001,171.11883840000004,174.99890000000005,171.97819321738785,174.7984855109979,176.14230769230787,177.8101408484611,174.4744745361546,163.14045980000031,168.5553301000001,171.11883840000004,174.99890000000005,176.48333333333332,136712623,116937172.55,62.052249883693705,1.5,2.75,1.582441743995269,1.1691117547890464,-0.07907986498605024,1.7417488229113758,1.8208286878974258,12.864936693588776,0.6014866935255078,8933362402.0,2013-11-08,2013,4,312,11,1.41,176.08,177.53,176.91,3485
2013-11-11 14:30:00,177.12,177.53,176.91,177.32,165.70379310344828,176.5460060606061,163.2767097500003,168.7345302000001,171.39223859999998,175.31790000000004,172.18767583631382,175.03862974804568,176.3538453846155,177.86009204632106,174.84759872291005,163.2767097500003,168.7345302000001,171.39223859999998,175.31790000000004,177.25333333333333,62614326,114462570.45,62.13491417237028,1.5,2.75,1.5136959051384642,0.5470288300694021,-0.07133662273099127,1.7316579094836868,1.8029945322146783,12.857194290361335,0.08466444657673743,8995976728.0,2013-11-11,2013,0,315,11,0.35,177.22,177.36,176.37,3486
2013-11-12 14:30:00,176.94,177.36,176.37,176.96,165.75482758620691,176.62562757575756,163.4082097500003,168.91343010000008,171.6436386,175.68090000000004,172.37482580351718,175.22161739108898,176.4930769230771,177.8562944883017,175.12985935785252,163.4082097500003,168.91343010000008,171.6436386,175.68090000000004,176.89666666666668,83989617,110887826.5,60.43363133354546,1.5,2.75,1.4762890547714316,0.7574286524589784,-0.10215564081851937,1.6752999811915288,1.777455622010048,12.562718996472276,0.3800555902206682,8911987111.0,2013-11-12,2013,1,316,11,0.56,176.86,178.4261,176.09,3487
2013-11-13 14:30:00,176.09,178.4261,176.09,178.38,165.8058620689655,176.7052490909091,163.5497597000003,169.12663010000009,171.8962386,175.99639950000005,172.61032283083026,175.52241573479478,176.68000000000018,178.33026804347824,175.0297319565221,163.5497597000003,169.12663010000009,171.8962386,175.99639950000005,177.6320333333333,103844266,107996236.6,64.5560616043815,1.5,2.75,1.5377041222877568,0.9615544880940788,-0.041700877794684336,1.7253295247666929,1.767030402561377,12.925518278400073,1.4733488821889775,9015831377.0,2013-11-13,2013,2,317,11,1.33,177.26,179.42,178.25,3488
2013-11-14 14:30:00,178.54,179.42,178.25,179.27,165.85689655172413,176.7848706060606,163.6976097000003,169.33358010000006,172.16243839999996,176.2988995000001,172.87148664138593,175.87932852195718,176.91384615384635,179.03666776612803,174.79102454156467,163.6976097000003,169.33358010000006,172.16243839999996,176.2988995000001,178.98,103435238,106698539.3,66.88490094666105,1.5,2.75,1.511439542124345,0.9694156890861956,0.03906506730067827,1.8158617366872252,1.776796669386547,12.814425046484379,1.736564326655696,9119266615.0,2013-11-14,2013,3,318,11,0.66,178.83,180.12,179.33,3489
2013-11-15 14:30:00,179.56,180.12,179.33,180.05,165.90793103448274,176.86449212121212,163.84165965000028,169.5326801000001,172.44263859999995,176.58199950000008,173.1529969691747,176.2765353293898,177.13538461538482,179.84022489656166,174.43054433420792,163.84165965000028,169.5326801000001,172.44263859999995,176.58199950000008,179.83333333333337,102818190,104923664.8,68.81857300667811,1.5,2.75,1.4641938605440343,0.9799332704970479,0.12121880331381665,1.9283201735288171,1.8071013702150007,12.886945762374461,1.8209579822428312,9222084805.0,2013-11-15,2013,4,319,11,0.44,179.73,180.5,179.02,3490
2013-11-18 14:30:00,180.35,180.5,179.02,179.42,165.95896551724138,176.94411363636365,163.99108465000026,169.71608010000003,172.6783586,176.83300000000008,173.39876179391294,176.57591291706694,177.376153846154,180.28654412883927,174.46576356346887,163.99108465000026,169.71608010000003,172.6783586,176.83300000000008,179.64666666666668,104796009,104958286.85,65.49215608001371,1.5,2.75,1.4653228705051742,0.99845388244349,0.10967655703810264,1.9441970665126287,1.8345205094745265,13.240138324761,1.7870312588642294,9117288796.0,2013-11-18,2013,0,322,11,0.83,179.76,179.87,178.72,3491
2013-11-19 14:30:00,179.33,179.87,178.72,179.03,166.01,177.02373515151515,164.13098465000024,169.90218010000004,172.88155859999995,177.01400000000007,173.61959466473988,176.8096354963939,177.62538461538483,180.50451499032096,174.74625424044868,164.13098465000024,169.90218010000004,172.88155859999995,177.01400000000007,179.20666666666668,93891416,103319695.25,63.44761855572444,1.5,2.75,1.4427998083262334,0.9087465441396566,0.05507881213647137,1.903369024645116,1.8482902125086444,13.124939567089882,1.0498391375515121,9023397380.0,2013-11-19,2013,1,323,11,0.64,179.3,179.93,177.98,3492
2013-11-20 14:30:00,179.39,179.93,177.98,178.47,166.0610344827586,177.10335666666663,164.26753465000024,170.07328010000003,173.06295880000002,177.2089995000001,173.80980663867166,176.9677654491183,177.79923076923095,180.58698930128696,175.01147223717498,164.26753465000024,170.07328010000003,173.06295880000002,177.2089995000001,178.79333333333332,124908601,104290906.9,60.525792320642225,1.5,2.75,1.4790283934457895,1.19769407240623,-0.03461771977719108,1.8050180627871557,1.8396357825643463,13.162034869980252,2.0236666095009386,8898488779.0,2013-11-20,2013,2,324,11,1.1,178.96,180.05,178.86,3493
2013-11-21 14:30:00,178.97,180.05,178.86,179.91,166.11206896551727,177.18297818181819,164.41228460000025,170.26028000000005,173.28215879999996,177.4470000000001,174.04902990774337,177.247978263488,178.03615384615404,180.97365187585876,175.09865581644937,164.41228460000025,170.26028000000005,173.28215879999996,177.4470000000001,179.60666666666668,92841271,105415448.85,64.99041872444059,1.5,2.75,1.4862406510568054,0.8807178835059336,-0.013897222572964107,1.822264254348141,1.8361614769211052,10.53133323743976,1.4778047267189378,8991330050.0,2013-11-21,2013,3,325,11,0.67,179.46,180.83,179.77,3494
2013-11-22 14:30:00,179.98,180.83,179.77,180.81,166.16310344827585,177.2625996969697,164.55733460000022,170.45558000000008,173.5117587999999,177.69000000000008,174.31416598979263,177.58721842887007,178.38538461538482,181.4754840948296,175.29528513594,164.55733460000022,170.45558000000008,173.5117587999999,177.69000000000008,180.47000000000003,81295887,104798990.4,67.46704202518069,1.5,2.75,1.4557948902670337,0.775731585673749,0.04051446276643023,1.8868045553791437,1.8462900926127133,8.312790587350888,1.9681930972253605,9072625937.0,2013-11-22,2013,4,326,11,0.59,180.3,181.17,180.37,3495
2013-11-25 14:30:00,181.13,181.17,180.37,180.63,166.21413793103451,177.3422212121212,164.7016346000002,170.6316800000001,173.7181587999999,177.91000000000008,174.5618457548988,177.87700714993008,178.65153846153862,181.8704044458244,175.43267247725288,164.7016346000002,170.6316800000001,173.7181587999999,177.91000000000008,180.72333333333333,79485709,104524324.95,66.45450217167449,1.5,2.75,1.4089523981051015,0.7604517803680874,0.04417536408666845,1.9015092977210488,1.85733393363438,8.43070984020415,2.0739150090415843,8993140228.0,2013-11-25,2013,0,329,11,0.44,180.77,181.22,180.405,3496
2013-11-26 14:30:00,180.72,181.22,180.405,180.68,166.2651724137931,177.42184272727272,164.84493460000024,170.7990299000001,173.91035859999997,178.08550000000008,174.80177337235375,178.14395884993675,179.09384615384636,181.65960336354422,176.5280889441485,164.84493460000024,170.7990299000001,173.91035859999997,178.08550000000008,180.76833333333332,86993560,104503935.75,66.60443317872857,1.5,2.75,1.3665272268118798,0.8324429063428839,0.030412124780763605,1.8953490896103349,1.864936964829571,8.141571846801076,1.289382217737421,9080133788.0,2013-11-26,2013,1,330,11,0.45,180.81,181.24,180.65,3497
2013-11-27 14:30:00,180.87,181.24,180.65,181.12,166.31620689655168,177.50146424242425,164.98977960000025,170.9589299000001,174.0717388,178.32700000000008,175.04954696559474,178.42739134041898,179.38846153846177,181.93755906990864,176.8393640070149,164.98977960000025,170.9589299000001,174.0717388,178.32700000000008,181.00333333333333,58800056,100443846.85,67.96148655320835,1.5,2.75,1.3110609963253173,0.5854022704627228,0.031268836943954215,1.9040230110095135,1.87275417406556,7.24186303892738,1.0319629608969678,9138933844.0,2013-11-27,2013,2,331,11,0.33,180.94,181.75,180.8,3498
2013-11-29 14:30:00,181.32,181.75,180.8,181.0,166.36724137931034,181.75,165.13332965000023,171.11700990000008,174.23653899999996,178.58750000000006,175.2828980649832,178.67240168895054,179.67153846153863,182.050611922468,177.29246500060933,165.13332965000023,171.11700990000008,174.23653899999996,178.58750000000006,181.1833333333333,55870903,96547621.15,67.15993468949834,1.5,2.75,1.2852709251592225,0.578687515388876,0.005434981442865583,1.8795479008691416,1.8741129194262758,6.9770157023084565,0.5276312135517848,9083062941.0,2013-11-29,2013,4,333,11,0.53,181.28,181.43,180.25,3499
2013-12-02 14:30:00,181.09,181.43,180.25,180.53,166.41827586206898,181.91299980000002,165.27542965000023,171.24790990000008,174.432739,178.80350000000007,175.48866676831722,178.84931581381238,179.94615384615403,181.76900939907642,178.1232982932317,165.27542965000023,171.24790990000008,174.432739,178.80350000000007,180.73666666666668,99725781,94393657.7,63.97723598773421,1.5,2.75,1.2777515733621354,1.0564881521695708,-0.058122321152412,1.801460017985761,1.8595823391381732,6.882899062380271,0.6186601270761418,8983337160.0,2013-12-02,2013,0,336,12,0.65,180.84,180.39,179.17,3500
2013-12-03 14:30:00,179.94,180.39,179.17,179.75,166.46931034482756,182.07599960000002,165.40792965000026,171.3703100000001,174.6291392,178.94950000000009,175.65577787544206,178.93509526011596,180.05153846153866,181.6438632477539,178.4592136753234,165.40792965000026,171.3703100000001,174.6291392,178.94950000000009,179.76999999999995,116563302,95937984.15,58.981680022638514,1.5,2.75,1.2836264609791268,1.2149859415198059,-0.16164317399286698,1.6575283716470892,1.819171545639956,7.061768913441725,0.4021672345416963,8866773858.0,2013-12-03,2013,1,337,12,0.68,179.78,180.48,178.35,3501
2013-12-04 14:30:00,179.1,180.48,178.35,179.73,166.5203448275862,182.23899939999998,165.5498796500003,171.4860600000001,174.83313919999995,179.12250000000012,175.81555129209136,179.01080047343825,180.08692307692326,181.6278196114529,178.5460265423936,165.5498796500003,171.4860600000001,174.83313919999995,179.12250000000012,179.51999999999995,123032637,97798377.1,58.85478044527277,1.5,2.75,1.344081713766332,1.2580232990389777,-0.2359158297463828,1.5242767584569776,1.7601925882033604,6.907401344074332,0.7060010085728643,8743741221.0,2013-12-04,2013,2,338,12,1.19,179.42,179.74,178.7701,3502
2013-12-05 14:30:00,179.41,179.74,178.7701,178.94,166.5713793103448,182.40199919999998,165.6924796500003,171.60021010000008,175.0311394,179.21100000000007,175.93807869240152,179.004057571206,180.00153846153862,181.65970883700396,178.34336808607338,165.6924796500003,171.60021010000008,175.0311394,179.21100000000007,179.15003333333337,106934067,98777694.05,53.91992854145104,1.5,2.75,1.317354448497308,1.082573024491454,-0.336564688095911,1.3394867280834717,1.6760514161793827,7.177474439445477,-0.5391584681229498,8636807154.0,2013-12-05,2013,3,339,12,0.54,179.26,181.11,180.15,3503
2013-12-06 14:30:00,180.67,181.11,180.15,180.94,166.62241379310345,182.564999,165.83772965000034,171.7301091000001,175.2561394,179.51150000000013,176.1342324691701,179.188433040615,180.11846153846167,181.81013974306572,178.42678333385766,165.83772965000034,171.7301091000001,175.2561394,179.51150000000013,180.73333333333332,127727518,97314048.85,62.49389745259429,1.5,2.75,1.378257702176073,1.3125290696400822,-0.2696510787161792,1.3389875677841587,1.608638646500338,8.49116435324424,0.07189867817045266,8764534672.0,2013-12-06,2013,4,340,12,0.53,180.63,181.67,181.16,3504
2013-12-09 14:30:00,181.47,181.67,181.16,181.4,166.67344827586206,182.72799880000002,165.99972965000038,171.85540910000012,175.5059594,179.71700000000013,176.34073315665358,179.3990584653183,180.30076923076942,181.9947669882663,178.60677147327252,165.99972965000038,171.85540910000012,175.5059594,179.71700000000013,181.41,70123608,93984598.1,64.14629783362909,1.5,2.75,1.331953580592067,0.7461180812348445,-0.19888489568734213,1.3600325268911604,1.5589174225785023,8.134276636040253,0.4262857775563363,8834658280.0,2013-12-09,2013,0,343,12,0.28,181.42,181.36,180.635,3505
2013-12-10 14:30:00,180.98,181.36,180.635,180.75,166.7244827586207,182.89099860000002,166.15337965000037,171.97120910000012,175.76075959999997,179.88850000000008,176.51364558188286,179.5277195638594,180.47615384615403,181.8093406231066,179.14296706920143,166.15337965000037,171.97120910000012,175.76075959999997,179.88850000000008,180.915,80976207,94902692.15,60.115943532059106,1.5,2.75,1.2914568962640631,0.8532551096865801,-0.1997979823119973,1.309169944688506,1.5089679270005032,8.418963658299955,0.03874252822669536,8753682073.0,2013-12-10,2013,1,344,12,0.4,181.0,180.85,178.5,3506
2013-12-11 14:30:00,180.81,180.85,178.5,178.72,166.7755172413793,183.0539984,166.28742965000038,172.06340910000011,175.94835959999997,179.97650000000007,176.6001692845541,179.45079389111092,180.38461538461559,181.99526485484964,178.77396591438148,166.28742965000038,172.06340910000011,175.94835959999997,179.97650000000007,179.35666666666668,130590810,97232751.8,49.62848987784497,1.5,2.75,1.3670671179594869,1.3430742993740925,-0.33320337703931235,1.0924637057013626,1.425667082740675,10.634214362484887,-1.3250883392226178,8623091263.0,2013-12-11,2013,2,345,12,1.32,179.68,178.86,177.76,3507
2013-12-12 14:30:00,178.64,178.86,177.76,178.13,166.8265517241379,183.21699819999998,166.42002965000032,172.15330910000011,176.12735979999994,179.96400000000008,176.66016264594413,179.32500399671937,180.17846153846173,182.16154144536,178.1953816315635,166.42002965000032,172.15330910000011,176.12735979999994,179.96400000000008,178.25,115564840,97818780.5,47.05890559687675,1.5,2.75,1.3479908952480966,1.181417713544282,-0.4500021786554396,0.8631643594213756,1.3131665380768152,10.447321144920338,-1.5856353591160246,8507526423.0,2013-12-12,2013,3,346,12,0.62,178.31,178.66,177.77,3508
2013-12-13 14:30:00,178.5,178.66,177.77,178.11,166.87758620689652,183.379998,166.5500296500003,172.24920910000012,176.3371597999999,179.90600000000012,176.7170190127699,179.20928933036515,179.98461538461558,182.2287272066566,177.7405035625746,166.5500296500003,172.24920910000012,176.3371597999999,179.90600000000012,178.18,107807610,98037399.1,46.97012538169738,1.5,2.75,1.3152772598732316,1.0996579977609788,-0.5128677888837283,0.6720818019721548,1.1849495908558831,10.471325563804882,-1.34049742425081,8399718813.0,2013-12-13,2013,4,347,12,0.5,178.22,179.81,178.9,3509
2013-12-16 14:30:00,178.95,179.81,178.9,179.21599999999998,166.92862068965516,183.54299780000002,166.6815096500003,172.35206920000016,176.54367979999995,179.86430000000007,176.815018267171,179.20992844175896,179.87200000000018,182.11215548910167,177.6318445108987,166.6815096500003,172.35206920000016,176.54367979999995,179.86430000000007,179.30866666666668,96194790,97706229.1,52.326392215265344,1.5,2.75,1.3427574555965711,0.9845307805457002,-0.4656059815489842,0.6029421139196529,1.068548095468637,11.343579014559907,-0.2970792767732917,8495913603.0,2013-12-16,2013,0,350,12,0.51,179.36,179.41,178.25,3510
2013-12-17 14:30:00,179.36,179.41,178.25,178.65,166.97965517241374,183.7059976,166.80330970000034,172.44746920000014,176.7680799999999,179.82580000000007,176.88697833512512,179.15660192349617,179.68200000000022,181.8852105245225,177.4787894754779,166.80330970000034,172.44746920000014,176.7680799999999,179.82580000000007,178.76999999999995,89886224,96960739.85,49.56719986662807,1.5,2.75,1.329703351625387,0.9270373157120666,-0.4574379081340408,0.49675071030108603,0.9541886184351268,11.227563153654792,-0.6009013520280332,8406027379.0,2013-12-17,2013,1,351,12,0.65,178.83,181.73,177.32,3511
2013-12-18 14:30:00,178.92,181.73,177.32,181.7,177.32,183.8689974,166.93930970000034,172.57856920000015,177.09247999999997,179.95930000000007,177.07572428276728,179.39883031173466,179.73584615384635,182.09403657430585,177.3776557333869,166.93930970000034,172.57856920000015,177.09247999999997,179.95930000000007,180.25,234906482,104011493.15,61.383930668922034,1.5,2.75,1.5497245407950024,2.2584665875455707,-0.2423939477865825,0.6511961837018987,0.8935901314884812,15.089387723875273,1.5424164524421544,8640933861.0,2013-12-18,2013,2,352,12,2.49,179.52,181.7,180.71,3512
2013-12-19 14:30:00,181.19,181.7,180.71,181.49,177.58102040816325,184.03199719999998,167.0728797000003,172.70758920000014,177.41027979999996,180.11030000000008,177.24883313442348,179.5979893296647,179.80969230769244,182.3180742421237,177.30131037326117,167.0728797000003,172.70758920000014,177.41027979999996,180.11030000000008,181.3,136298872,104581006.7,60.335686020222255,1.5,2.75,1.509744216452501,1.3032851403982515,-0.1164502683137706,0.748027296096268,0.8644775644100385,14.769026984686725,0.3039681662429597,8504634989.0,2013-12-19,2013,3,353,12,0.55,181.2,181.99,180.5683,3513
2013-12-20 14:30:00,180.67,181.99,180.5683,181.56,177.84204081632652,184.194997,167.20347970000032,172.83608910000018,177.6580797999999,180.19280000000006,177.41789850170102,179.78484748874425,179.94892307692322,182.623989771882,177.27385638196446,167.20347970000032,172.83608910000018,177.6580797999999,180.19280000000006,181.37276666666668,197086908,109793288.55,60.57735291963978,1.5,2.75,1.503455343848752,1.7950724548180956,-0.03482073493805793,0.8209516457374662,0.8557723806755241,13.415168780031452,0.0882028665931624,8701721897.0,2013-12-20,2013,4,354,12,0.79,181.28,182.64,182.065,3514
2013-12-23 14:30:00,182.41,182.64,182.065,182.53,178.10306122448978,184.35799680000002,167.3359797000003,172.9547891000002,177.90347999999992,180.27880000000007,177.61837307026173,180.04629058505432,180.16430769230786,183.16522523246638,177.1633901521494,167.3359797000003,172.9547891000002,177.90347999999992,180.27880000000007,182.41166666666663,85597541,110008371.25,63.863047041745006,1.5,2.75,1.4732085335738403,0.7781002484390478,0.07226965608005631,0.9461094507755944,0.8738397946955382,13.674650420500644,0.9847856154910104,8787319438.0,2013-12-23,2013,0,357,12,0.32,182.35,183.01,182.53,3515
2013-12-24 14:30:00,182.54,183.01,182.53,182.93,178.36408163265304,184.5209966,167.47222975000034,173.0745891000002,178.14327999999998,180.39380000000008,177.82667216554557,180.3209295769539,180.4712307692309,183.714846809664,177.22761472879785,167.47222975000034,173.0745891000002,178.14327999999998,180.39380000000008,182.82333333333332,45368841,108302527.85,65.15284480273712,1.5,2.75,1.402265066889994,0.4189084216283138,0.15316377861308006,1.0652945179618882,0.9121307393488082,13.423980471628006,2.3556401074306224,8832688279.0,2013-12-24,2013,1,358,12,0.26,182.77,183.96,183.32,3516
2013-12-26 14:30:00,183.34,183.96,183.32,183.855,178.6251020408163,184.6839964,167.6119797500004,173.20613910000014,178.42637999999994,180.55255000000008,178.06307717866142,180.6575077124821,180.69546153846167,184.40697846785253,176.98394460907085,167.6119797500004,173.20613910000014,178.42637999999994,180.55255000000008,183.71166666666667,63365227,107121111.2,67.99744457845583,1.5,2.75,1.37567470496928,0.5915288432892956,0.24655316626226745,1.2203221971766425,0.9737690309143752,10.903436827835886,3.2139448717228967,8896053506.0,2013-12-26,2013,3,360,12,0.35,183.64,184.18,183.66,3517
2013-12-27 14:30:00,184.1,184.18,183.66,183.845,178.88612244897962,184.84699619999998,167.74755475000038,173.34728910000018,178.66187979999992,180.68880000000007,178.28981925008648,180.9610784065314,180.8835384615386,184.94965674771424,176.81742017536294,167.74755475000038,173.34728910000018,178.66187979999992,180.68880000000007,183.895,61813841,107271800.45,67.93288259919919,1.5,2.75,1.3145550831857609,0.5762356997896365,0.2826472577855448,1.327078103146306,1.0444308453607611,10.381882831055615,3.2199202739879764,8834239665.0,2013-12-27,2013,4,361,12,0.28,183.92,184.02,183.58,3518
2013-12-30 14:30:00,183.87,184.02,183.58,183.82,179.14714285714282,185.009996,167.88750475000037,173.4936892000002,178.8738797999999,180.82980000000006,178.50668908341643,181.23335665352843,181.11969230769245,185.47376254383812,176.76562207154674,167.88750475000037,173.4936892000002,178.8738797999999,180.82980000000006,183.80666666666676,56857458,107321128.2,67.75966970568696,1.5,2.75,1.2520868629582065,0.5297881130548905,0.2793361805397041,1.3936010710353912,1.1142648904956869,10.384617306883731,2.5689670565128027,8777382207.0,2013-12-30,2013,0,364,12,0.24,183.8,184.69,183.93,3519
2013-12-31 14:30:00,184.07,184.69,183.93,184.69,179.40816326530614,185.17299580000002,168.0361047500003,173.64258920000015,179.0799197999999,181.0378000000001,178.74917186445893,181.5625607817638,181.57892307692325,186.08055460758166,177.07729154626477,168.0361047500003,173.64258920000015,179.0799197999999,181.0378000000001,184.43666666666664,86247638,106647221.05,70.57175484794789,1.5,2.75,1.2247949441754775,0.8087190378787653,0.3079804245123592,1.499240421136136,1.1912599966237771,10.261335509104226,3.3809123985446363,8863629845.0,2013-12-31,2013,1,365,12,0.41,184.31,184.07,182.48,3520
2014-01-02 14:30:00,183.98,184.07,182.48,182.92,179.6691836734694,185.3359956,168.1776547500003,173.77868920000012,179.25031999999993,181.19630000000006,178.9127337521272,181.6918407073101,181.94738461538483,186.0235335171991,177.87123571357048,168.1776547500003,173.77868920000012,179.25031999999993,181.19630000000006,183.15666666666664,119636836,106800897.75,59.24907440169019,1.5,2.75,1.29516673387723,1.1201856774654313,0.18597148398176344,1.4237243516009812,1.2377528676192178,12.172404486022332,0.6714364336818927,8743993009.0,2014-01-02,2014,3,2,1,0.87,183.27,183.6,182.63,3521
2014-01-03 14:30:00,183.21,183.6,182.63,182.885,179.9302040816326,185.4989954,168.3136297500003,173.91642930000012,179.39981999999992,181.3540500000001,179.0685088991026,181.80547492566154,182.31469230769244,185.75197319947074,178.8774114159141,168.3136297500003,173.91642930000012,179.39981999999992,181.3540500000001,183.03833333333333,81390502,104718791.0,59.04733158904082,1.5,2.75,1.2719405386002849,0.7772291985303764,0.08623173640802695,1.3455425381292514,1.2593108017212244,7.899636265257575,0.7686373904898242,8662602507.0,2014-01-03,2014,4,3,1,0.53,183.12,183.56,182.08,3522
2014-01-06 14:30:00,183.47,183.56,182.08,182.36,180.1912244897959,185.66199519999998,168.45363480000032,174.04392930000012,179.55561979999996,181.52505000000008,179.1975869814907,181.85828683750333,182.55653846153862,185.49373855323617,179.61933836984107,168.45363480000032,174.04392930000012,179.55561979999996,181.52505000000008,182.66666666666663,108028139,104773494.6,55.968834771333675,1.5,2.75,1.286801928700264,1.0310636236046669,-0.02578878490716985,1.227074820587262,1.2528636054944322,8.101869914680513,0.4406256884776445,8554574368.0,2014-01-06,2014,0,6,1,0.81,182.82,183.79,182.95,3523
2014-01-07 14:30:00,183.09,183.79,182.95,183.48,180.45224489795916,185.824995,168.5930347500003,174.19132920000007,179.72221999999994,181.6520500000001,179.36552474692246,182.01273571012203,182.9280769230771,184.83639288812302,181.01976095803107,168.5930347500003,174.19132920000007,179.72221999999994,181.6520500000001,183.40666666666667,86144169,102694327.15,60.67871184400478,1.5,2.75,1.2970303623645292,0.8388405804945185,-0.034595521615545355,1.2096192034750004,1.2442147250905458,8.721556809989913,0.5204623897441454,8640718537.0,2014-01-07,2014,1,7,1,0.46,183.37,183.83,182.89,3524
2014-01-08 14:30:00,183.45,183.83,182.89,183.52,180.71326530612242,185.9879948,168.73588475000034,174.36272920000008,179.87361999999993,181.75805000000008,179.52844534508236,182.1562846901104,183.0680769230771,184.85889340407056,181.27726044208362,168.73588475000034,174.36272920000008,179.87361999999993,181.75805000000008,183.41333333333336,96582234,104017258.45,60.83982118153618,1.5,2.75,1.2715281936242075,0.9285212419478068,-0.047092420756293496,1.185349199145179,1.2324416199014725,8.288012571400241,0.32252774285245905,8737300771.0,2014-01-08,2014,2,8,1,0.51,183.36,184.13,182.795,3525
2014-01-09 14:30:00,184.1,184.13,182.795,183.64,180.97428571428568,186.1509946,168.8731347500003,174.54082920000008,180.02181999999993,181.90255000000008,179.6896827825301,182.29759091009987,183.2334615384616,184.7929505307789,181.6739725461444,168.8731347500003,174.54082920000008,180.02181999999993,181.90255000000008,183.52166666666665,90683302,104502613.2,61.351423397590935,1.5,2.75,1.2760618940796218,0.867761094418259,-0.05603438785809134,1.1623986350788584,1.2184330229369498,8.223035393518082,-0.1169399798754472,8827984073.0,2014-01-09,2014,3,9,1,0.73,183.46,184.22,183.01,3526
2014-01-10 14:30:00,183.95,184.22,183.01,184.14,181.23530612244895,186.3139944,169.0128847500003,174.73452920000008,180.16121999999996,182.17355000000006,179.86420502635244,182.4730584424713,183.43192307692317,184.7225194713256,182.14132668252083,169.0128847500003,174.73452920000008,180.16121999999996,182.17355000000006,183.79,102026318,103074388.6,63.4916203928041,1.5,2.75,1.2713431873596497,0.9898319008801766,-0.037901013781766135,1.171056755709742,1.208957769491508,7.841633591776772,0.1604612581250442,8930010391.0,2014-01-10,2014,4,10,1,0.66,183.62,184.18,181.34,3527
2014-01-13 14:30:00,183.71,184.18,181.34,181.685,181.49632653061227,186.47699419999998,169.1379597500003,174.89557920000007,180.26911999999993,182.35130000000007,179.93560875080917,182.398005257474,183.36692307692317,184.89579163022802,181.83805452361838,169.1379597500003,174.89557920000007,180.26911999999993,182.35130000000007,182.40166666666664,149891938,104790743.5,49.11131819194022,1.5,2.75,1.3833901025482458,1.4303929239704267,-0.19224273432875205,0.968654351580568,1.1608970859093202,11.05592202501864,-1.1614623000761566,8780118453.0,2014-01-13,2014,0,13,1,1.57,182.76,183.77,181.95,3528
2014-01-14 14:30:00,182.28,183.77,181.95,183.67,181.75734693877547,186.639994,169.27605975000031,175.08667920000005,180.42671999999988,182.6293000000001,180.08205546646374,182.51914761390512,183.42384615384628,184.93844259080046,181.90924971689208,169.27605975000031,175.08667920000005,180.42671999999988,182.6293000000001,183.13,105016055,104651165.75,57.49420243849672,1.5,2.75,1.433505095223372,1.0034867194014032,-0.16280906733046074,0.9573857517462444,1.120194819076705,13.053664194808427,-0.5522767881314691,8885134508.0,2014-01-14,2014,1,14,1,1.0,182.86,184.94,183.7102,3529
2014-01-15 14:30:00,184.1,184.94,183.7102,184.66,182.01836734693882,184.94,169.4152597000003,175.27267920000003,180.59571999999991,182.90150000000008,180.261582703073,182.72303831734268,183.4857692307693,185.1263922182421,181.84514624329654,169.4152597000003,175.27267920000003,180.59571999999991,182.90150000000008,184.4367333333333,98525721,104767712.3,60.94930104552435,1.5,2.75,1.4218261598502746,0.9404206585887244,-0.08285900990178185,1.0166210566994778,1.0994800666012596,13.146538914966545,0.9512355127924826,8983660229.0,2014-01-15,2014,2,15,1,0.67,184.33,184.6618,183.83,3530
2014-01-16 14:30:00,184.28,184.6618,183.83,184.42,182.279387755102,185.04290322580644,169.56120970000026,175.45067920000002,180.74751999999992,183.19000000000003,180.42465789118782,182.88465371569103,183.53000000000011,185.2366521433672,181.82334785663312,169.56120970000026,175.45067920000002,180.74751999999992,183.19000000000003,184.30393333333333,72290520,103887927.1,59.68275246855642,1.5,2.75,1.3796814341466828,0.6958510196320974,-0.05374424578961934,1.0322997593642356,1.086044005153855,11.711851137984414,0.8393252590425659,8911369709.0,2014-01-16,2014,3,16,1,0.45,184.25,184.45,183.32,3531
2014-01-17 14:30:00,184.1,184.45,183.32,183.635,182.54040816326525,185.14580645161288,169.70008470000028,175.62702919999998,180.89481999999992,183.28675000000007,180.55055366016083,182.9561152665776,183.5157692307693,185.21558300408833,181.8159554574504,169.70008470000028,175.62702919999998,180.89481999999992,183.28675000000007,183.80166666666665,107848616,97535033.8,55.61208699525513,1.5,2.75,1.3618470459933478,1.1057423348122117,-0.09267643550269013,0.9701984607754924,1.0628748962781824,12.067259358873027,0.6991664838780309,8803521093.0,2014-01-17,2014,4,17,1,0.62,183.88,184.77,183.05,3532
2014-01-21 14:30:00,184.7,184.77,183.05,184.18,182.80142857142857,185.24870967741936,169.84519470000023,175.8355292,181.03501999999992,183.42125000000004,180.6928848891741,183.0726757173797,183.47653846153855,185.08734993702203,181.8657269860551,169.84519470000023,175.8355292,181.03501999999992,183.42125000000004,184.0,88621138,95151147.1,57.76582142377599,1.5,2.75,1.3874293998509657,0.931372250371956,-0.08712952664716989,0.95396298796922,1.04109251461639,11.950706127078384,0.3815129714410383,8892142231.0,2014-01-21,2014,1,21,1,0.94,183.91,184.57,183.91,3533
2014-01-22 14:30:00,184.49,184.57,183.91,184.3,183.06244897959184,185.35161290322583,169.98564465000024,176.03942919999997,181.22241999999991,183.55825000000007,180.83434038371632,183.18956374429595,183.5826923076924,185.2145558737624,181.9508287416224,169.98564465000024,176.03942919999997,181.22241999999991,183.55825000000007,184.26,61270816,88360342.5,58.246210090620345,1.5,2.75,1.3354701570044685,0.6934198563116706,-0.08091867994700874,0.939944164682629,1.0208628446296375,11.496269205858967,0.42502179598953854,8953413047.0,2014-01-22,2014,2,22,1,0.36,184.24,183.4,181.82,3534
2014-01-23 14:30:00,183.36,183.4,181.82,182.79,183.3234693877551,185.45451612903224,170.11584465000024,176.2256292,181.3324199999999,183.57125000000005,180.91103291768826,183.15151005436297,183.57538461538476,185.22047737192955,181.93029185883995,170.11584465000024,176.2256292,181.3324199999999,183.57125000000005,182.67,132496880,90705309.45,50.46729372140521,1.5,2.75,1.4172222886470076,1.460740069169126,-0.17845563469847234,0.7977933012565472,0.9762489359550196,12.529835169765013,-0.4628621215421446,8820916167.0,2014-01-23,2014,3,23,1,0.87,182.61,181.66,178.83,3535
2014-01-24 14:30:00,181.6,181.66,178.83,178.89,183.5844897959184,185.55741935483871,170.21694465000027,176.37802929999995,181.36381999999983,183.36925000000005,180.83177672483768,182.7456519539475,183.30846153846161,186.2616876352558,180.35523544166745,170.21694465000027,176.37802929999995,181.36381999999983,183.36925000000005,179.79333333333332,208677093,98870722.05,36.79795610498383,1.5,2.75,1.5988492680293631,2.1106055328944566,-0.4880241331654982,0.3662187694981469,0.8542429026636451,17.381770313642303,-2.8510915607689804,8612239074.0,2014-01-24,2014,4,24,1,1.58,180.24,179.52,177.12,3536
2014-01-27 14:30:00,179.06,179.52,177.12,178.01,183.84551020408162,185.6603225806452,170.3110446500003,176.51422929999995,181.38481999999988,183.07700000000008,180.72111881405976,182.29463748214297,182.88769230769242,186.96719758575745,178.80818702962742,170.3110446500003,176.51422929999995,181.38481999999988,183.07700000000008,178.21666666666667,180843004,104744610.9,34.525575231316516,1.5,2.75,1.6560743203129802,1.7265136835789228,-0.7204201528265364,-0.0462822883695253,0.6741378644570111,17.07430188188265,-2.022731650934316,8431396070.0,2014-01-27,2014,0,27,1,1.36,178.32,179.3,178.12,3537
2014-01-28 14:30:00,178.14,179.3,178.12,179.07,184.10653061224488,185.7632258064516,170.41239465000024,176.64742929999997,181.39861999999994,182.83825000000007,180.65636905664562,181.98752915051034,182.54538461538476,187.07696179293592,178.0138074378336,170.41239465000024,176.64742929999997,181.39861999999994,182.83825000000007,178.83,110463152,107177076.45,39.381484891808206,1.5,2.75,1.6299261545763402,1.030660246191106,-0.7668151234239321,-0.28438103982290386,0.4824340836010281,16.516985577595857,-2.5044917515108587,8541859222.0,2014-01-28,2014,1,28,1,0.66,178.71,178.55,176.88,3538
2014-01-29 14:30:00,177.56,178.55,176.88,177.35,184.36755102040814,185.8661290322581,170.52355465000022,176.76132919999995,181.3602199999999,182.51475000000008,180.52670752501248,181.54585970760456,182.0615384615386,187.30895010864745,176.8141268144297,170.52355465000022,176.76132919999995,181.3602199999999,182.51475000000008,177.59333333333333,216597269,115164067.0,34.863201766273896,1.5,2.75,1.6699314292494587,1.8807712739078588,-0.8698615175206499,-0.6048928132997844,0.26496870422086555,15.05436399032556,-3.958626665222572,8325261953.0,2014-01-29,2014,2,29,1,0.94,177.72,179.81,178.26,3539
2014-01-30 14:30:00,178.86,179.81,178.26,179.23,184.6285714285714,185.96903225806446,170.63265465000026,176.89322929999992,181.34381999999994,182.24175000000008,180.47585624952183,181.3253016402136,181.68384615384628,186.98502041251527,176.3826718951773,170.63265465000026,176.89322929999992,181.34381999999994,182.24175000000008,179.1,118938051,116798587.65,42.61329188617735,1.5,2.75,1.7263648985887836,1.0183175446984951,-0.7712878839947189,-0.6991411507725331,0.07214673322218583,16.39843496344955,-2.8142283917145634,8444200004.0,2014-01-30,2014,3,30,1,0.87,179.04,179.29,176.92,3540
2014-01-31 14:30:00,177.02,179.29,176.92,178.18,184.8895918367347,186.07193548387096,170.74800465000018,176.99868929999997,181.31901999999994,182.0047500000001,180.3858226711092,181.02574910305043,181.41423076923093,187.0346575887176,175.79380394974416,170.74800465000018,176.99868929999997,181.31901999999994,182.0047500000001,178.13,194677861,120550638.9,39.76736771871352,1.5,2.75,1.7723388344038706,1.6149052611947623,-0.7367379498212376,-0.8487757040543613,-0.11203775423312362,16.436545828165187,-2.9705666131184056,8249522143.0,2014-01-31,2014,4,31,1,1.34,178.1,178.37,173.83,3541
2014-02-03 14:30:00,177.95,178.37,173.83,174.17,185.15061224489799,186.1748387096774,170.84815465000025,177.05168929999996,181.22181999999992,181.56900000000005,180.14206491930096,180.3728206170456,180.68346153846167,187.31933071765926,174.04759235926412,170.84815465000025,177.05168929999996,181.22181999999992,181.56900000000005,175.45666666666668,254837004,129222964.0,31.19806237812428,1.5,2.75,1.9700289176607364,1.9720721156032297,-0.9313491047830136,-1.2762241352118906,-0.344875030428877,19.8411098463886,-5.434900640677609,7994685139.0,2014-02-03,2014,0,34,2,2.61,176.1,175.84,174.1055,3542
2014-02-04 14:30:00,174.95,175.84,174.1055,175.385,185.4116326530612,186.27774193548385,170.9476796500002,177.1115393999999,181.16011999999992,181.22025000000005,179.95551335383817,179.8977900820889,179.97000000000008,186.73544273382515,173.20455726617507,170.9476796500002,177.1115393999999,181.16011999999992,181.22025000000005,175.1101666666667,165012351,132072174.6,35.717925132727146,1.5,2.75,1.953205423542112,1.249410418960422,-0.9238221260542591,-1.4996526879967007,-0.5758305619424418,20.565252635061334,-4.837221920781347,8159697490.0,2014-02-04,2014,1,35,2,1.0,174.97,175.56,173.71,3543
2014-02-05 14:30:00,174.79,175.56,173.71,175.17,173.71,186.38064516129032,171.0426796500002,177.17373939999993,181.06531999999996,180.80475000000007,179.76784616349158,179.4475243599852,179.25846153846166,185.94742418612446,172.5694988907988,171.0426796500002,177.17373939999993,181.06531999999996,180.80475000000007,174.81333333333333,164230470,135976489.65,35.276299306790506,1.5,2.75,1.9458336075748182,1.2077857754875494,-0.8791471396213616,-1.6747644864691438,-0.7956173468477822,20.408022976437273,-4.168718201214511,7995467020.0,2014-02-05,2014,2,36,2,1.06,174.64,177.48,175.2209,3544
2014-02-06 14:30:00,175.58,177.48,175.2209,177.48,173.59718750000005,186.48354838709682,171.14117965000025,177.25523939999988,180.99871999999996,180.50275000000005,179.67812670609973,179.26014108760566,178.7850000000001,185.02400633114655,172.54599366885373,171.14117965000025,177.25523939999988,180.99871999999996,180.50275000000005,176.72696666666664,132877526,137791254.25,43.37694668554044,1.5,2.75,1.971845492748045,0.9643393314274878,-0.6503870829427869,-1.6086012005262658,-0.958214117583479,22.73614461033614,-0.7881938621499227,8128344546.0,2014-02-06,2014,3,37,2,1.29,176.35,179.87,177.73,3545
2014-02-07 14:30:00,178.31,179.87,177.73,179.68,173.484375,186.58645161290326,171.25017965000023,177.3489393999999,180.97971999999996,180.30475000000007,179.67820016860566,179.30012765069085,178.43884615384633,183.89198096696197,172.98571134073066,171.25017965000023,177.3489393999999,180.97971999999996,180.30475000000007,179.09333333333333,170787197,141796449.0,49.81856315358653,1.5,2.75,2.001713671837472,1.2044532723100845,-0.3237756300319701,-1.3629336551234417,-1.0391580250914716,20.822321998026887,0.9381495421605618,8299131743.0,2014-02-07,2014,4,38,2,1.2,178.8,180.07,179.21,3546
2014-02-10 14:30:00,179.7,180.07,179.21,180.01,173.3715625,186.68935483870968,171.35762965000023,177.43833929999985,180.96631999999997,180.09825000000006,179.69121192669954,179.36773454110119,178.10884615384632,182.52364322010033,173.69404908759228,171.35762965000023,177.43833929999985,180.96631999999997,180.09825000000006,179.76333333333332,92218729,141306069.55,50.724112203404424,1.5,2.75,1.920162695277652,0.6526168995689824,-0.07155541090587225,-1.128602288723812,-1.0570468778179396,20.544446184266857,0.5249343832020985,8391350472.0,2014-02-10,2014,0,41,2,0.48,179.64,182.43900000000002,180.0389,3547
2014-02-11 14:30:00,180.16,182.43900000000002,180.0389,181.98,173.25875000000005,186.79225806451612,171.4763296000003,177.52762939999985,180.9835199999999,180.11300000000008,179.7809683217309,179.616521727663,178.04653846153857,182.2110799629871,173.8819969600901,171.4763296000003,177.52762939999985,180.9835199999999,180.11300000000008,181.48596666666663,117814009,139702173.1,55.846484545546964,1.5,2.75,1.9565082170435342,0.8433226655369759,0.22564008133750854,-0.7749967761460539,-1.0006368574835625,21.154705161061077,2.6106568931491383,8509164481.0,2014-02-11,2014,1,42,2,1.33,181.24,182.83,181.705,3548
2014-02-12 14:30:00,182.22,182.83,181.705,182.07,173.1459375,186.89516129032262,171.59017960000025,177.6207294999999,181.0049199999999,180.03300000000007,179.87073426989838,179.85018632502843,178.29115384615397,182.96728004345684,173.61502764885117,171.59017960000025,177.6207294999999,181.0049199999999,180.03300000000007,182.20166666666668,94717638,139187252.25,56.07115575856758,1.5,2.75,1.897114772968996,0.6805051214738669,0.4149542372944375,-0.4819440608655157,-0.8968982981599531,19.947753592820188,1.5845561568933793,8603882119.0,2014-02-12,2014,2,43,2,0.62,182.27,183.2,180.83,3549
2014-02-13 14:30:00,180.84,183.2,180.83,183.01,173.033125,186.99806451612903,171.70682965000032,177.74362949999988,181.0545199999999,179.9505000000001,179.9938427299023,180.15112096073997,178.6757692307694,183.9768690385091,173.37466942302964,171.70682965000032,177.74362949999988,181.0545199999999,179.9505000000001,182.34666666666664,100542155,139288073.95,58.44926023610185,1.5,2.75,1.9308922891854945,0.7218288841878269,0.5800255503953616,-0.17186636016575108,-0.7518919105611127,19.398184896120554,2.7107419463463818,8704424274.0,2014-02-13,2014,3,44,2,1.31,182.02,184.36,182.67,3550
2014-02-14 14:30:00,182.84,184.36,182.67,184.02,172.92031250000005,187.10096774193545,171.83552965000027,177.88452959999984,181.13991999999993,179.93050000000008,180.15173125029838,180.5195856311457,179.05653846153854,185.07831865401053,173.03475826906654,171.83552965000027,177.88452959999984,181.13991999999993,179.93050000000008,183.6833333333333,96498305,140498463.2,60.89861396435114,1.5,2.75,1.9136856971008185,0.6868281887370851,0.7243938491666536,0.15360040089720428,-0.5707934482694493,18.779806470876135,5.6553941551358005,8800922579.0,2014-02-14,2014,4,45,2,0.93,183.52,184.49,183.65,3551
2014-02-18 14:30:00,184.19,184.49,183.65,184.24,172.8075,187.2038709677419,171.95797965000025,178.0316295999999,181.2301199999999,179.96075000000008,180.3120555149925,180.87391080913184,179.58653846153854,186.10645514884877,173.0666217742284,171.95797965000025,178.0316295999999,181.2301199999999,179.96075000000008,184.1266666666667,80460878,139129076.3,61.43193242710968,1.5,2.75,1.8369938615936168,0.5783182073781942,0.7961508803332614,0.4243951521471274,-0.37175572818613395,9.313129260155266,5.048892436639403,8881383457.0,2014-02-18,2014,1,49,2,0.46,184.07,184.95,182.87,3552
2014-02-19 14:30:00,183.76,184.95,182.87,183.02,172.6946875,187.3067741935484,172.06623965000026,178.1714296999999,181.31171999999992,179.90275000000008,180.41824941636537,181.0783002558812,179.87807692307706,186.64250598928294,173.1136478568711,172.06623965000026,178.1714296999999,181.31171999999992,179.90275000000008,183.61333333333332,126524261,141024232.45,56.804904372566206,1.5,2.75,1.8543514429083576,0.8971809936626249,0.7249229287341593,0.5343979327315651,-0.19052499600259415,11.586382638915948,4.481360963635339,8754859196.0,2014-02-19,2014,2,50,2,1.14,183.91,184.52,182.6,3553
2014-02-20 14:30:00,183.27,184.52,182.6,184.1,172.58187500000003,187.40967741935486,172.17783965000027,178.3155296999999,181.37491999999992,179.89275000000006,180.56263179219414,181.3660811838925,180.33346153846162,187.3708817220406,173.2960413548827,172.17783965000027,178.3155296999999,181.37491999999992,179.89275000000006,183.74,104998099,143210596.6,59.698748263779386,1.5,2.75,1.859040625557762,0.7331726945686086,0.7129370277276053,0.7006462886569125,-0.012290739070692835,11.061980361033433,3.7299977462249294,8859857295.0,2014-02-20,2014,3,51,2,1.05,183.56,184.89,183.8,3554
2014-02-21 14:30:00,184.49,184.89,183.8,183.89,172.4690625,187.51258064516128,172.28429015000026,178.46533969999984,181.42471999999992,179.94775000000007,180.69311681995129,181.60645440447414,181.081153846154,187.3654519268401,174.7968557654678,172.28429015000026,178.46533969999984,181.42471999999992,179.94775000000007,184.19333333333333,118116359,142491570.55,58.87283239122132,1.5,2.75,1.8041091523036343,0.8289357647198731,0.6547615030364341,0.8061611397248498,0.1513996366884157,10.221914543809493,2.3430543187889468,8741740936.0,2014-02-21,2014,4,52,2,0.59,184.34,186.15,184.2,3555
2014-02-24 14:30:00,184.28,186.15,184.2,184.91,172.35625000000005,187.61548387096772,172.39214015000027,178.63433979999988,181.50791999999993,180.2487500000001,180.85848478779633,181.92107779452422,181.81384615384616,187.45941099422237,176.1682813134701,172.39214015000027,178.63433979999988,181.50791999999993,180.2487500000001,185.08666666666664,114063868,137760909.3,61.64820824966721,1.5,2.75,1.836672784281948,0.82798428508921,0.6476882667819109,0.9610099701658044,0.3133217033838934,8.726874081060673,2.7220709960557783,8855804804.0,2014-02-24,2014,0,55,2,1.06,185.18,185.59,184.23,3556
2014-02-25 14:30:00,185.03,185.59,184.23,184.84,172.24343750000003,187.71838709677417,172.50193515000026,178.78933979999988,181.63031999999995,180.59025000000008,181.0146226392553,182.19907038552196,182.5576923076924,186.90454725455064,178.2108373608341,172.50193515000026,178.78933979999988,181.63031999999995,180.59025000000008,184.88666666666663,117084901,134573004.15,61.342268862793524,1.5,2.75,1.8026247282618093,0.8700474641220974,0.6019782795009733,1.06579455276011,0.4638162732591368,8.912865023148845,1.5716012748653774,8738719903.0,2014-02-25,2014,1,56,2,0.74,184.91,185.6,184.33,3557
2014-02-26 14:30:00,185.11,185.6,184.33,184.85,172.130625,187.82129032258064,172.60913515000018,178.94603989999985,181.76471999999995,180.87925000000007,181.16502959457856,182.4515398726151,183.12461538461545,186.4851429566156,179.76408781261534,172.60913515000018,178.94603989999985,181.76471999999995,180.87925000000007,184.92666666666668,98677144,133983703.75,61.371761016333764,1.5,2.75,1.7645801048145362,0.7364861639003617,0.5381811010991021,1.1365426496330144,0.5983615485339123,7.2698968610604,1.5268852639094859,8837397047.0,2014-02-26,2014,2,57,2,0.69,184.96,185.87,184.37,3558
2014-02-27 14:30:00,184.59,185.87,184.37,185.82,172.01781250000005,187.9241935483871,172.72053520000026,179.1280398999999,181.91891999999996,181.3027500000001,181.34757745361472,182.77234559903266,183.5969230769232,186.59448500536138,180.59936114848492,172.72053520000026,179.1280398999999,181.91891999999996,181.3027500000001,185.35333333333332,93880780,127847879.3,64.22298080531986,1.5,2.75,1.745681525899212,0.7343162867778598,0.5264299088941498,1.2563989346515996,0.7299690257574498,7.518433115894165,1.5354352221190113,8931277827.0,2014-02-27,2014,3,58,2,0.81,185.12,187.15,185.05,3559
2014-02-28 14:30:00,185.79,187.15,185.05,186.29,171.90500000000003,188.02709677419358,172.82583520000026,179.3020398999999,182.06039999999996,181.65575000000007,181.54139794562985,183.10736030388668,184.08000000000007,186.5949032708204,181.5650967291798,172.82583520000026,179.3020398999999,182.06039999999996,181.65575000000007,186.16333333333333,150842000,129443076.75,65.54984882280456,1.5,2.75,1.7709899883349822,1.1653153168734456,0.5148074772953736,1.3734783723766668,0.8586708950812932,7.268432384216307,1.2335615693946211,9082119827.0,2014-02-28,2014,4,59,2,1.13,186.1,185.45,183.75,3560
2014-03-03 14:30:00,184.69,185.45,183.75,184.98,171.7921875,188.13,172.92016015000027,179.4775399999999,182.18699999999995,181.99575000000007,181.6762450850169,183.28570694161175,184.31076923076932,186.54773780506468,182.07380065647388,172.92016015000027,179.4775399999999,182.18699999999995,181.99575000000007,184.72666666666663,167748455,128096606.45,58.98365941241434,1.5,2.75,1.8259192748824833,1.30954644036942,0.3891062254485941,1.3450536768920358,0.9559474514434416,8.395269443403075,0.4016500217108015,8914371372.0,2014-03-03,2014,0,62,3,0.93,184.6,187.98,186.75,3561
2014-03-04 14:30:00,186.75,187.98,186.75,187.58,171.67937500000005,188.23290322580644,173.03136015000027,179.69853999999992,182.30459999999994,182.66625000000008,181.90776488560445,183.69468723288685,184.73461538461544,187.190034701907,182.27919606732388,173.03136015000027,179.69853999999992,182.30459999999994,182.66625000000008,187.43666666666667,167545852,123732048.85,66.2168319012955,1.5,2.75,1.9097821838194489,1.3541023005536368,0.44713226020879293,1.5148627767044331,1.0677305164956399,11.413787791006405,2.4915309802207415,9081917224.0,2014-03-04,2014,1,63,3,0.66,187.36,188.07,187.45,3562
2014-03-05 14:30:00,187.72,188.07,187.45,187.75,171.5665625,188.33580645161288,173.13541015000027,179.92003989999992,182.42979999999991,183.28450000000007,182.13687214499248,184.08090749642145,185.09923076923084,187.81581755911975,182.38264397934188,173.13541015000027,179.92003989999992,182.42979999999991,183.28450000000007,187.75666666666663,88376859,119900274.25,66.63118722500099,1.5,2.75,1.8176548849752028,0.7370863790997543,0.461177150256131,1.644201954315804,1.1830248040596727,10.123279427485214,1.9826181423139633,9170294083.0,2014-03-05,2014,2,64,3,0.33,187.76,188.61,187.7796,3563
2014-03-06 14:30:00,188.21,188.61,187.7796,188.18,171.45375,188.43870967741933,173.24166020000027,180.11013989999992,182.56219999999996,183.9350000000001,182.37385755107124,184.47129725866702,185.41923076923084,188.50665898990417,182.3318025485575,173.24166020000027,180.11013989999992,182.56219999999996,183.9350000000001,188.1898666666667,82516500,115814575.75,67.70999694945979,1.5,2.75,1.7492509646198322,0.7124880393131345,0.4624607310900706,1.761100717922261,1.2986399868321905,9.898573168224061,2.3329164174234704,9252810583.0,2014-03-06,2014,3,65,3,0.44,188.19,188.96,187.43,3564
2014-03-07 14:30:00,188.87,188.96,187.43,188.26,171.34093750000005,188.54161290322583,173.34711020000032,180.29013999999992,182.67679999999996,184.47400000000007,182.6046866667155,184.8321260911749,185.7284615384616,189.07583567492838,182.38108740199485,173.34711020000032,180.29013999999992,182.67679999999996,184.47400000000007,188.21666666666664,114513432,114896371.05,67.91781071367002,1.5,2.75,1.7335901814327015,0.9966670918628636,0.4322882592198385,1.8390003108569888,1.40671205163715,9.745575572042744,1.8116921745714099,9367324015.0,2014-03-07,2014,4,66,3,0.82,188.2,188.23,187.08,3565
2014-03-10 13:30:00,187.94,188.23,187.08,188.16,171.228125,188.64451612903224,173.4582602500003,180.46233999999995,182.78139999999996,184.89800000000008,182.8225420915502,185.14906646344397,186.12384615384624,189.30843924184205,182.93925306585044,173.4582602500003,180.46233999999995,182.78139999999996,184.89800000000008,187.82333333333332,74939176,110103970.0,67.33444859092921,1.5,2.75,1.6940480256160784,0.6806219248951695,0.3715089818798392,1.871098278986949,1.49958929710711,9.64179995245727,1.7961480199091069,9292384839.0,2014-03-10,2014,0,69,3,0.61,187.66,188.71,186.8,3566
2014-03-11 13:30:00,188.44,188.71,186.8,187.23,171.11531250000004,188.74741935483868,173.56716025000034,180.63763999999992,182.84889999999996,185.25900000000007,182.9953835781561,185.34725060978263,186.36461538461543,189.36893653291864,183.36029423631228,173.56716025000034,180.63763999999992,182.84889999999996,185.25900000000007,187.58,99009013,110443484.2,62.00085568731144,1.5,2.75,1.7094731666435012,0.8964676704757563,0.2409166968880392,1.8007351682171588,1.5598184713291197,10.340653979736024,1.2875304300784396,9193375826.0,2014-03-11,2014,1,70,3,1.02,187.76,187.35,185.9,3567
2014-03-12 13:30:00,186.32,187.35,185.9,187.28,171.00250000000003,188.85032258064518,173.67702025000034,180.78973989999992,182.91759999999996,185.5240000000001,183.1634077515617,185.53132198027959,186.62538461538472,189.29513096328134,183.95563826748813,173.67702025000034,180.78973989999992,182.91759999999996,185.5240000000001,186.84333333333333,104824323,109793999.9,62.17433228603898,1.5,2.75,1.6909393690261074,0.9547363525827788,0.13540504723221436,1.7290747803693876,1.5936697331371732,10.332121876721528,0.7857065977828048,9298200149.0,2014-03-12,2014,2,71,3,0.78,186.62,187.99,184.66,3568
2014-03-13 13:30:00,187.84,187.99,184.66,185.18,170.8896875,188.9532258064516,173.77142025000038,180.90933989999994,182.9448,185.67950000000008,183.2424898005201,185.49786274406242,186.646153846154,189.2659311527339,184.02637653957402,173.77142025000038,180.90933989999994,182.9448,185.67950000000008,185.94333333333333,155014237,112808829.85,51.53319341368678,1.5,2.75,1.8080151283813863,1.374132124286014,-0.08637204376320584,1.4857046784331658,1.5720767221963716,12.204872676767762,-0.5958451876107066,9143185912.0,2014-03-13,2014,3,72,3,1.8,186.32,185.8,184.44,3569
2014-03-14 13:30:00,184.8,185.8,184.44,184.66,170.77687500000005,189.0561290322581,173.8686202500004,181.0120598999999,182.94419999999997,185.76200000000009,183.2980784357938,185.41806629224698,186.63230769230782,189.2917252554536,183.97289012916198,173.8686202500004,181.0120598999999,182.94419999999997,185.76200000000009,184.96666666666667,153919598,115477702.0,49.28387687132144,1.5,2.75,1.7760140477827169,1.3328945357779982,-0.26836737118422915,1.236617508216085,1.5049848794003142,12.129772628951958,-0.17299167477564775,8989266314.0,2014-03-14,2014,4,73,3,0.74,185.12,186.77,185.51,3570
2014-03-17 13:30:00,185.59,186.77,185.51,186.33,170.66406250000003,189.15903225806449,173.97112025000038,181.13135999999992,183.0124,185.87750000000008,183.41697732066464,185.50491712155682,186.746153846154,189.21016606467893,184.282141627629,173.97112025000038,181.13135999999992,183.0124,185.87750000000008,186.20333333333332,98359454,115570759.45,55.93580000581576,1.5,2.75,1.7998701872268097,0.8510756048337104,-0.275515416816452,1.1605906083797493,1.4361060251962012,12.62649157152096,-0.6663823435334257,9087625768.0,2014-03-17,2014,0,76,3,0.68,186.14,187.91,186.51,3571
2014-03-18 13:30:00,186.71,187.91,186.51,187.66,170.55125,189.26193548387096,174.0921952000004,181.25385999999992,183.10789999999997,186.04850000000005,183.5833703669131,185.71016310998002,186.88769230769242,189.3339661315572,184.4414184838276,174.0921952000004,181.25385999999992,183.10789999999997,186.04850000000005,187.36,101804519,116637941.5,60.39143988750572,1.5,2.75,1.784165173853465,0.8728250661042402,-0.19376791154665374,1.193896135762884,1.387664047309538,10.426301972440577,-0.047936085219708865,9189430287.0,2014-03-18,2014,1,77,3,0.75,187.21,187.94,185.47,3572
2014-03-19 13:30:00,187.7,187.94,185.47,186.66,170.43843750000005,189.36483870967743,174.20374515000037,181.37475989999996,183.19389999999996,186.23050000000006,183.7040225093871,185.80062376617238,186.91615384615392,189.3424779219441,184.48982977036374,174.20374515000037,181.37475989999996,183.19389999999996,186.23050000000006,186.69,176267253,119125091.1,55.82103067665426,1.5,2.75,1.8331533757210745,1.4796819995884145,-0.2088412569015725,1.1266124761825722,1.3354537330841447,10.84423846785759,-0.8077372728238974,9013163034.0,2014-03-19,2014,2,78,3,1.33,186.7,187.89,185.92,3573
2014-03-20 13:30:00,186.25,187.89,185.92,187.747,170.32562500000003,189.46774193548384,174.32468015000038,181.50072999999992,183.27923999999996,186.41285000000005,183.86257064627392,185.98599293129882,187.12900000000005,189.31184049243905,184.94615950756105,174.32468015000038,181.50072999999992,183.27923999999996,186.41285000000005,187.18566666666663,117240972,119737234.75,59.41640752564264,1.5,2.75,1.8429281345981403,0.9791521596835608,-0.1501464101692882,1.1477707203725345,1.297917130541823,11.359458756187875,-0.2724954849675857,9130404006.0,2014-03-20,2014,3,79,3,1.06,186.9,189.0239,186.03,3574
2014-03-21 13:30:00,187.72,189.0239,186.03,186.2,170.2128125,189.57064516129032,174.44932015000037,181.60322999999988,183.33283999999992,186.52835000000005,183.95423454249843,186.00637455688943,187.02284615384616,189.24155844098217,184.80413386671017,174.44932015000037,181.60322999999988,183.33283999999992,186.52835000000005,187.08463333333333,163127905,121987812.05,52.82721757048774,1.5,2.75,1.9251404106982732,1.3372475680860447,-0.21604548307385876,1.0278602766994993,1.243905759773358,12.236572164848551,-1.041666666666671,8967276101.0,2014-03-21,2014,4,80,3,1.61,187.53,187.07,184.62,3575
2014-03-24 13:30:00,186.82,187.07,184.62,185.43,170.10000000000005,189.67354838709682,174.5628201500004,181.69522999999992,183.36863999999997,186.55435000000008,184.01210769769457,185.9514817419476,186.84438461538463,189.17102624110848,184.5177429896608,174.5628201500004,181.69522999999992,183.36863999999997,186.55435000000008,185.70666666666668,121411145,122355175.9,49.86313490147196,1.5,2.75,1.9626303813626813,0.9922845037567388,-0.30650433658304577,0.860775339044551,1.1672796756275967,12.349918431102722,-0.9613843935266694,8845864956.0,2014-03-24,2014,0,83,3,1.33,185.84,186.94,185.27,3576
2014-03-25 13:30:00,186.37,186.94,185.27,186.31,169.98718750000003,189.77645161290326,174.67037015000034,181.78662999999997,183.41203999999996,186.62785,184.1022211213144,185.98562633795257,186.70053846153846,188.9072279577445,184.49384896533246,174.67037015000034,181.78662999999997,183.41203999999996,186.62785,186.1733333333333,103851737,121693517.7,53.101795387877864,1.5,2.75,1.9417282112653458,0.853387583519578,-0.30161705151439233,0.7902583612346064,1.091875412748999,12.595717271048708,-0.5179410508329767,8949716693.0,2014-03-25,2014,1,84,3,0.9,186.1,187.34,184.92,3577
2014-03-26 13:30:00,187.03,187.34,184.92,184.97,169.874375,189.87935483870967,174.77122015000037,181.87342999999996,183.47773999999995,186.63385,184.1362516655766,185.8889000200523,186.44746153846157,188.63526164401924,184.25966143290387,174.77122015000037,181.87342999999996,183.47773999999995,186.63385,185.7433333333333,119842897,122751805.35,48.01555364595745,1.5,2.75,1.9758904818892509,0.9763025208329452,-0.3782126209099213,0.6191096366115971,0.9973222575215184,13.149421019408727,-0.1134031752889124,8829873796.0,2014-03-26,2014,2,85,3,1.31,186.13,185.34,183.9,3578
2014-03-27 13:30:00,184.77,185.34,183.9,184.58,169.76156250000003,189.98225806451612,174.87863010000038,181.96132999999998,183.49593999999996,186.57185,184.15365356104417,185.76424287528545,186.1720769230769,188.32933821556662,184.0148156305872,174.87863010000038,181.96132999999998,183.49593999999996,186.57185,184.60666666666668,142382757,125176904.2,46.616069642487716,1.5,2.75,1.937612590325733,1.1374522952933035,-0.4403759948881095,0.44685226391138144,0.887228258799491,11.548076706746967,-0.04332286364127807,8687491039.0,2014-03-27,2014,3,86,3,0.78,184.62,186.42,185.0,3579
2014-03-28 13:30:00,185.105,186.42,185.0,185.49,169.64875000000004,190.08516129032262,174.99733010000034,182.05413,183.51253999999997,186.53185,184.20605930374833,185.73812450621062,186.03823076923078,188.13128950323875,183.94517203522275,174.99733010000034,182.05413,183.51253999999997,186.53185,185.63666666666663,101641547,122716881.55,50.25908683225657,1.5,2.75,1.9306402624453216,0.8282605108294492,-0.4062681726585384,0.3793930429763179,0.7856612156348564,11.787718788009993,-0.4508130735791356,8789132586.0,2014-03-28,2014,4,87,3,0.77,185.71,187.3,185.5216,3580
2014-03-31 13:30:00,186.65,187.3,185.5216,187.01,169.53593750000005,190.18806451612903,175.1113300500003,182.15592999999996,183.56433999999996,186.63335000000004,184.31601776242485,185.85925550561916,186.0174615384615,188.06569869654217,183.96922438038087,175.1113300500003,182.15592999999996,183.56433999999996,186.63335000000004,186.61053333333336,99744911,119316704.35,55.69742850433318,1.5,2.75,1.9220231008420845,0.8359677007790235,-0.27375267585684604,0.4434703708137988,0.7172230466706448,11.572629994023135,-0.3463710966641829,8888877497.0,2014-03-31,2014,0,90,3,0.96,186.41,188.36,187.0015,3581
2014-04-01 13:30:00,187.62,188.36,187.0015,188.25,169.42312500000003,190.29096774193548,175.2367050500003,182.27572999999992,183.65663999999992,186.66685000000004,184.4702915756631,186.0869454574649,186.25361538461536,188.5536179984876,183.95361277074315,175.2367050500003,182.27572999999992,183.65663999999992,186.66685000000004,187.8705,89193125,115399068.0,59.579937711864645,1.5,2.75,1.8817714507819367,0.7729102716843432,-0.10374884456684152,0.5875369909620929,0.6912858355289344,11.468547063183493,0.8518161362905836,8978070622.0,2014-04-01,2014,1,91,4,0.73,187.68,189.13,188.14,3582
2014-04-02 13:30:00,188.5,189.13,188.14,188.88,169.31031250000004,190.3938709677419,175.35890505000032,182.39282999999998,183.75063999999992,186.72335000000004,184.64322131779397,186.3529506519921,186.57823076923077,189.07012213048242,184.0863394079791,175.35890505000032,182.39282999999998,183.75063999999992,186.72335000000004,188.71666666666667,78773818,114918915.95,61.42939195994932,1.5,2.75,1.8180734900117996,0.6854730341719691,0.04214775643069635,0.7439705310673048,0.7018227746366085,10.974484497961194,0.6034716932893635,9056844440.0,2014-04-02,2014,2,92,4,0.53,188.64,189.22,188.05,3583
2014-04-03 13:30:00,189.17,189.22,188.05,188.63,169.19750000000005,190.4967741935484,175.47338005000026,182.52983,183.83723999999992,186.74585000000008,184.79956557984124,186.5698124946595,186.75515384615383,189.46820853627028,184.0420991560374,175.47338005000026,182.52983,183.83723999999992,186.74585000000008,188.63333333333333,77435320,114664856.95,60.25125214475386,1.5,2.75,1.771782526439527,0.6753186814140093,0.10903066418652728,0.8381111048697676,0.7290804406832403,10.633528858068878,1.3050483351235271,8979409120.0,2014-04-03,2014,3,93,4,0.62,188.64,189.7,186.1,3584
2014-04-04 13:30:00,189.64,189.7,186.1,186.4,169.08468750000003,189.7,175.5881300500003,182.62093,183.90943999999988,186.6528500000001,184.86232771396516,186.55363987612046,186.6582307692308,189.32468495800927,183.9917765804523,175.5881300500003,182.62093,183.90943999999988,186.6528500000001,187.4,169380705,117408220.6,50.877819835786454,1.5,2.75,1.9023694888367035,1.4426647821966907,-0.003724270072524072,0.7244251030925852,0.7281493731651093,11.851958441525268,0.5231084506282688,8810028415.0,2014-04-04,2014,4,94,4,1.93,187.9,186.26,183.96,3585
2014-04-07 13:30:00,185.9,186.26,183.96,184.34,168.97187500000004,189.78654545454543,175.71283010000028,182.69113000000002,184.0184399999999,186.46185000000008,184.8418442742018,186.34281703077568,186.47976923076928,189.41850722823727,183.54103123330128,175.71283010000028,182.69113000000002,184.0184399999999,186.46185000000008,184.85333333333332,140802699,120701396.75,44.0589315918408,1.5,2.75,1.94077166820551,1.1665374452263744,-0.21230443235683627,0.462768832719064,0.6750732650759003,13.343604612525516,-1.0573774891310177,8669225716.0,2014-04-07,2014,0,97,4,1.25,185.11,185.4,183.59,3586
2014-04-08 13:30:00,184.21,185.4,183.59,185.1,168.85906250000005,189.87309090909093,175.84298005000028,182.77253,184.16023999999993,186.35535000000007,184.8519680281547,186.22445350403515,186.2761538461539,189.20224379126896,183.35006390103885,175.84298005000028,182.77253,184.16023999999993,186.35535000000007,184.69666666666672,112659755,121383933.85,46.88716728946301,1.5,2.75,1.9314308347622595,0.9281274006098624,-0.28956217764294234,0.3131205430222224,0.6026827206651647,13.257746234645861,0.07028166729739713,8781885471.0,2014-04-08,2014,1,98,4,0.99,184.5,187.15,185.06,3587
2014-04-09 13:30:00,185.6,187.15,185.06,187.09,168.74625000000003,189.95963636363635,175.99313005000027,182.85962999999995,184.3206399999999,186.34585000000007,184.9397339878349,186.30688650365082,186.34461538461545,189.30185542205925,183.38737534717166,175.99313005000027,182.85962999999995,184.3206399999999,186.34585000000007,186.43333333333337,100253612,121155398.3,53.514336300489646,1.5,2.75,1.9427572037078125,0.8274795296513008,-0.20130390015132785,0.3510528454760049,0.5523567456273327,13.974898473952058,1.359843970094263,8882139083.0,2014-04-09,2014,2,99,4,1.13,186.1,187.17,182.93,3588
2014-04-10 13:30:00,187.09,187.17,182.93,183.155,168.63343750000004,190.0461818181818,176.11603005000026,182.89847999999995,184.43673999999996,186.24460000000008,184.86974441968448,186.00670683663643,186.16961538461553,189.56015076674475,182.77908000248627,176.11603005000026,182.89847999999995,184.43673999999996,186.24460000000008,184.4183333333333,172959331,122052653.0,42.28015361284868,1.5,2.75,2.1068459748715394,1.4170878448664284,-0.3915908767184511,0.06286814972926891,0.45445902644772,19.003907951223386,-1.2588279691627624,8709179752.0,2014-04-10,2014,3,100,4,2.32,185.05,183.42,181.31,3589
2014-04-11 13:30:00,182.17,183.42,181.31,181.51,181.31,190.13272727272727,176.22288005000027,182.91307999999992,184.48233999999997,186.08710000000008,184.73798973655963,185.57844904267108,185.80038461538467,189.99859387013905,181.60217536063038,176.22288005000027,182.91307999999992,184.48233999999997,186.08710000000008,182.08,167250792,122719212.7,38.62930302416696,1.5,2.75,2.107071262380713,1.3628737368847217,-0.5994544995041661,-0.2948590979324877,0.3045954015716784,19.15856818631393,-2.941019196834394,8541928960.0,2014-04-11,2014,4,101,4,1.16,182.36,183.37,181.44,3590
2014-04-14 13:30:00,182.93,183.37,181.44,182.9401,181.47521739130437,190.21927272727268,176.33218055000026,182.94828099999995,184.57754199999994,185.91760500000007,184.66748425669454,185.32717770527387,185.64423846153855,190.09761579601872,181.1908611270584,176.33218055000026,182.94828099999995,184.57754199999994,185.91760500000007,182.58336666666665,132381601,124420320.05,43.219603470651315,1.5,2.75,2.094423315067806,1.0639869833705673,-0.6098262929714369,-0.4576874646426177,0.1521388283288192,19.097694027232837,-2.8206640106241694,8674310561.0,2014-04-14,2014,0,104,4,1.06,182.4,184.33,181.51,3591
2014-04-15 13:30:00,183.32,184.33,181.51,184.2,181.64043478260868,190.30581818181815,176.45108055000026,182.999981,184.77814199999997,185.74460500000006,184.6491515407457,185.21982744762872,185.61500769230773,190.10081316870026,181.12920221591529,176.45108055000026,182.999981,184.77814199999997,185.74460500000006,183.34666666666664,157092533,127184720.75,46.981944871998955,1.5,2.75,2.1462502211343932,1.2351525566407315,-0.5053421762272162,-0.479538891955201,0.025803284272015142,19.141062321635452,-2.477763659466332,8831403094.0,2014-04-15,2014,1,105,4,1.55,182.92,186.14,184.65,3592
2014-04-16 13:30:00,185.47,186.14,184.65,186.125,181.80565217391305,190.39236363636363,176.57490555000027,183.076531,184.99294199999997,185.71785500000007,184.70702795091256,185.3060343573784,185.66385384615398,190.15697381518586,181.170733877122,176.57490555000027,183.076531,184.99294199999997,185.71785500000007,185.6383333333333,105196633,123631189.75,52.19413557559575,1.5,2.75,2.1315180624819363,0.8508907275965125,-0.2907489248977637,-0.33763287185018953,-0.0468839469524258,20.27662137305383,-1.3279966071144544,8936599727.0,2014-04-16,2014,2,106,4,0.81,185.4,186.91,185.56,3593
2014-04-17 13:30:00,185.88,186.91,185.56,186.39,181.97086956521736,190.47890909090907,176.70080550000026,183.14133099999995,185.21734199999992,185.65000500000008,184.7730268547984,185.40926918048518,185.6161615384616,190.06404858983703,181.1682744870863,176.70080550000026,183.14133099999995,185.21734199999992,185.65000500000008,186.2866666666667,105254649,123031873.6,52.88087743958215,1.5,2.75,2.075695343733226,0.8555071618449287,-0.12366538033695156,-0.20146567237361526,-0.07780029203666369,20.344807465093204,-0.005364806866963158,9041854376.0,2014-04-17,2014,3,107,4,0.73,186.24,187.1,186.21,3594
2014-04-21 13:30:00,186.44,187.1,186.21,187.04,182.13608695652172,190.56545454545451,176.82960550000027,183.20363099999997,185.40854199999995,185.69200500000008,184.86192776245332,185.56457687758183,185.52308461538468,189.7937217617628,181.25244746900657,176.82960550000027,183.20363099999997,185.40854199999995,185.69200500000008,186.78333333333333,68329343,118291945.5,54.60348759374926,1.5,2.75,1.9910028191808515,0.577633098442869,0.029732863925454888,-0.04063421212984508,-0.07036707605529997,19.27412968876517,1.464684821525436,9110183719.0,2014-04-21,2014,0,111,4,0.48,186.66,188.4,187.13,3595
2014-04-22 13:30:00,187.23,188.4,187.13,187.89,182.3013043478261,190.65200000000002,176.95395550000026,183.27623099999997,185.57274199999992,185.81500500000007,184.98067569333747,185.7860457463836,185.44693076923085,189.50544984540105,181.38841169306062,176.95395550000026,183.27623099999997,185.57274199999992,185.81500500000007,187.80666666666664,85790307,116510903.6,56.82628305187835,1.5,2.75,1.9459311892393631,0.7363285696807522,0.17920780319861512,0.15364267794296893,-0.025565125255646196,17.918347324234322,1.5072933549432697,9195974026.0,2014-04-22,2014,1,112,4,0.68,187.76,187.92,187.3,3596
2014-04-23 13:30:00,187.81,187.92,187.3,187.45,182.46652173913043,190.73854545454543,177.07148045000022,183.34393099999997,185.72154199999997,185.8720050000001,185.0775119406576,185.9445175800613,185.3561615384616,189.17134877939807,181.5409742975251,177.07148045000022,183.34393099999997,185.72154199999997,185.8720050000001,187.55666666666667,73869384,115011785.95,55.31637954682047,1.5,2.75,1.851221818579407,0.6422766448658908,0.23565473044093896,0.2690032877955275,0.033348557354588554,18.01016237029336,0.19242076006199435,9122104642.0,2014-04-23,2014,2,113,4,0.33,187.61,188.39,186.93,3597
2014-04-24 13:30:00,188.37,188.39,186.93,187.83,182.6317391304348,190.82509090909093,177.18498045000027,183.411031,185.83854199999996,186.0150050000001,185.1854526488671,186.1240873343412,185.46616153846162,189.47303457482917,181.459288502094,177.18498045000027,183.411031,185.83854199999996,186.0150050000001,187.71666666666667,88169916,113428136.9,56.39399024473672,1.5,2.75,1.8232774029665908,0.7773196175983386,0.2826278403260267,0.3866333577621219,0.10400551743609524,17.01072975231278,2.5524828697005333,9210274558.0,2014-04-24,2014,3,114,4,0.78,187.66,187.33,185.87,3598
2014-04-25 13:30:00,187.21,187.33,185.87,186.29,182.79695652173916,190.91163636363635,177.29047045000027,183.463931,185.922942,186.10050500000008,185.2287682312644,186.13988854059446,185.6161615384616,189.58902419445687,181.64329888246627,177.29047045000027,183.463931,185.922942,186.10050500000008,186.49666666666667,100380205,111328009.3,51.0235932925375,1.5,2.75,1.8330433027546917,0.9016617258420698,0.19802645644262887,0.3515385879893813,0.15351213154675244,11.79957765872754,2.633463721007108,9109894353.0,2014-04-25,2014,4,115,4,0.79,186.6,187.69,184.96,3599
2014-04-28 13:30:00,187.05,187.69,184.96,186.875,182.96217391304347,190.9981818181818,177.38764545000026,183.52738100000002,186.000242,186.16975500000007,185.2933263398423,186.2098991557759,185.75270000000003,189.76700972092289,181.73839027907718,177.38764545000026,183.52738100000002,186.000242,186.16975500000007,186.50833333333333,135121094,113001986.65,52.86005738405734,1.5,2.75,1.897111638272213,1.1957408715167928,0.17055286648865914,0.3667032146575764,0.19615034816891724,9.625542681959342,2.150922624400008,9245015447.0,2014-04-28,2014,0,118,4,1.48,186.32,188.04,187.08,3600
2014-04-29 13:30:00,187.48,188.04,187.08,187.75,183.12739130434784,191.0847272727273,177.48884550000028,183.607381,186.074842,186.20675500000007,185.3896664833779,186.3565754266544,185.80346923076922,189.89999858914427,181.70693987239426,177.48884550000028,183.607381,186.074842,186.20675500000007,187.6233333333333,84097551,112219618.65,55.545104939425755,1.5,2.75,1.8448179498241968,0.7494015040479733,0.1984444800288172,0.4442059482049388,0.24576146817612154,9.193566193315151,1.9272529858849141,9329112998.0,2014-04-29,2014,1,119,4,0.51,187.56,188.5,187.18,3601
2014-04-30 13:30:00,187.44,188.5,187.18,188.31,183.29260869565215,191.17127272727268,177.58962050000028,183.693181,186.15624199999996,186.2097550000001,185.50418936638266,186.54261586221108,186.2000076923077,190.1909280800699,182.2090873045455,177.58962050000028,183.693181,186.15624199999996,186.2097550000001,187.99666666666667,101507717,112835348.25,57.2243876817669,1.5,2.75,1.8073309534081827,0.8996091967128751,0.23902094683261785,0.5445376517168938,0.305516704884276,8.796317232720625,1.1739422431161866,9430620715.0,2014-04-30,2014,2,120,4,0.71,187.84,188.84,187.73,3602
2014-05-01 13:30:00,188.22,188.84,187.73,188.325,183.4578260869565,191.25781818181815,177.69362055000022,183.787031,186.262342,186.1820050000001,185.61480939123044,186.71236673247668,186.72423846153848,189.79824789405416,183.65022902902282,177.69362055000022,183.787031,186.262342,186.1820050000001,188.2983333333333,93019095,113547612.1,57.27094794307089,1.5,2.75,1.7575215995933136,0.8192078484052947,0.2500955446089337,0.6181361356454431,0.36804059103650943,7.117671109013441,1.038145823273782,9523639810.0,2014-05-01,2014,3,121,5,0.59,188.28,189.14,187.78,3603
2014-05-02 13:30:00,188.31,189.14,187.78,188.06,183.62304347826088,191.3443636363636,177.79417005000022,183.85823100000005,186.34154199999998,186.15350500000008,185.71069921902526,186.84071275795515,187.11807692307698,189.34788387736495,184.8882699687889,177.79417005000022,183.85823100000005,186.34154199999998,186.15350500000008,188.32666666666668,98121662,114581929.2,56.10898865196547,1.5,2.75,1.7291271996223616,0.8563449985968642,0.22365942950543294,0.6476148779183006,0.4239554484128677,7.265119524786699,0.5453378956373023,9425518148.0,2014-05-02,2014,4,122,5,0.72,188.46,188.55,186.62,3604
2014-05-05 13:30:00,187.14,188.55,186.62,188.42,183.7882608695652,191.43090909090907,177.89192005000018,183.928431,186.43214199999997,186.25450500000008,185.8169463084753,186.99112106672132,187.44269230769237,189.0085865736684,185.87679804171628,177.89192005000018,183.928431,186.43214199999997,186.25450500000008,187.86333333333332,75882739,109907030.9,57.37422069891104,1.5,2.75,1.7434752567921934,0.6904266121886475,0.21447442591400076,0.6920484808053686,0.4775740548913679,7.115136208938524,0.2820799403906547,9501400887.0,2014-05-05,2014,0,125,5,1.03,187.58,188.13,186.74,3605
2014-05-06 13:30:00,188.0,188.13,186.74,186.78,183.9534782608696,191.5174545454545,177.9799700500002,183.988731,186.469542,186.37650500000007,185.85471311990761,186.9710142984621,187.49307692307698,188.92232383864518,186.0638300075088,177.9799700500002,183.988731,186.469542,186.37650500000007,187.21666666666667,85454226,107139607.25,50.265511731777465,1.5,2.75,1.7389413098784636,0.7975969689771286,0.08845941963881693,0.588148329439889,0.4996889098010721,8.467981463867428,-0.35742864763936383,9415946661.0,2014-05-06,2014,1,126,5,0.74,187.44,187.97,186.01,3606
2014-05-07 13:30:00,187.43,187.97,186.01,187.88,184.11869565217395,191.604,178.07187005000014,184.080331,186.53034199999996,186.51550500000008,185.93413613481323,187.05758436527526,187.60769230769242,188.89682806703425,186.31855654835056,178.07187005000014,184.080331,186.53034199999996,186.51550500000008,187.28666666666663,106500480,106831643.5,54.350954718921436,1.5,2.75,1.7547312163157167,0.9969001366154214,0.07048232786317543,0.5877918196300413,0.5173094917668659,9.131021163276387,0.026619815790865645,9522447141.0,2014-05-07,2014,2,127,5,1.05,186.99,189.05,187.08,3607
2014-05-08 13:30:00,187.67,189.05,187.08,187.675,184.28391304347824,191.69054545454543,178.16454505000019,184.175781,186.58684199999996,186.54475500000007,186.00240530599706,187.1163858542966,187.65653846153853,188.9033583215726,186.40971860150447,178.16454505000019,184.175781,186.58684199999996,186.54475500000007,187.93500000000003,93617513,106499838.55,53.46943315642965,1.5,2.75,1.7701075580074512,0.8790390133413024,0.03772100194585204,0.5644607441991809,0.5267397422533289,9.081870292260962,0.7434644908476136,9428829628.0,2014-05-08,2014,3,128,5,1.05,188.06,188.04,186.83,3608
2014-05-09 13:30:00,187.69,188.04,186.83,187.96,184.4491304347826,191.77709090909093,178.2617450500002,184.274281,186.62964199999993,186.78500500000007,186.07917372536969,187.19673005864936,187.6619230769232,188.91332560372132,186.41052055012506,178.2617450500002,184.274281,186.62964199999993,186.78500500000007,187.61,83678568,102035800.4,54.572545754766075,1.5,2.75,1.730099875292632,0.8200902788233531,0.028595288803908606,0.5624838532582146,0.5338885644543061,7.463230617375643,0.5806020066889674,9512508196.0,2014-05-09,2014,4,129,5,0.65,187.44,189.88,187.9992,3609
2014-05-12 13:30:00,188.76,189.88,187.9992,189.785,184.61434782608697,191.86363636363637,178.36602010000027,184.37997099999995,186.69954199999992,187.19875500000006,186.22450024594346,187.4432319578256,187.84153846153853,189.51785945437638,186.16521746870083,178.36602010000027,184.37997099999995,186.69954199999992,187.19875500000006,189.2214,86940045,98020263.05,60.9557820553685,1.5,2.75,1.7436641699145858,0.8869599233339336,0.13297633264583808,0.7001089802616036,0.5671326476157655,8.96566577119128,1.0838881491344856,9599448241.0,2014-05-12,2014,0,132,5,1.0,188.94,190.42,189.77,3610
2014-05-13 13:30:00,190.03,190.42,189.77,189.96,184.7795652173913,191.9501818181818,178.47027010000022,184.493071,186.79914199999988,187.54975000000007,186.37099043237703,187.6829241523184,188.00538461538474,190.02615545665597,185.98461377411357,178.47027010000022,184.493071,186.79914199999988,187.54975000000007,190.05,66453965,94723881.25,61.5142298335896,1.5,2.75,1.6655453006349712,0.7015544984333082,0.19742716071469799,0.8139165985091381,0.6164894377944401,8.743270777725327,0.8762147522701957,9665902206.0,2014-05-13,2014,1,133,5,0.34,190.1,189.88,188.79,3611
2014-05-14 13:30:00,189.79,189.88,188.79,189.06,184.94478260869565,192.0367272727273,178.57262010000028,184.566671,186.82874199999983,187.79275000000007,186.4764417879701,187.81407423305,188.2184615384617,190.0456804618811,186.39124261504227,178.57262010000028,184.566671,186.82874199999983,187.79275000000007,189.2433333333333,72366848,90487597.0,56.998977283757476,1.5,2.75,1.6301492077324744,0.7997432841541808,0.16441791916787607,0.8220118367542852,0.6575939175864092,9.266128301771966,0.390282755874161,9593535358.0,2014-05-14,2014,2,134,5,0.58,189.33,188.72,186.48,3612
2014-05-15 13:30:00,188.67,188.72,186.48,187.4,185.11,192.12327272727268,178.66668010000026,184.625771,186.82174199999986,187.85650000000007,186.5126597570693,187.77463859180716,188.25884615384624,189.98597428969413,186.5317180179984,178.66668010000026,184.625771,186.82174199999986,187.85650000000007,187.53333333333333,154956399,92975585.3,49.7460209035515,1.5,2.75,1.6979956928944413,1.6666353699200644,0.023176826890745742,0.6865649511998413,0.6633881243090956,10.674209228677944,-0.350951823885992,9438578959.0,2014-05-15,2014,3,135,5,1.2,187.6,188.13,186.72,3613
2014-05-16 13:30:00,187.51,188.13,186.72,188.05,185.27521739130435,192.20981818181815,178.76338005000022,184.69067099999992,186.81914199999986,187.93950000000007,186.57294760973326,187.8008634878255,188.2819230769232,189.98914095973203,186.57470519411444,178.76338005000022,184.69067099999992,186.81914199999986,187.93950000000007,187.63333333333333,97457678,92585736.75,52.305246455608795,1.5,2.75,1.6774245719734096,1.052620861711726,-0.031131822435589877,0.6244733462646082,0.655605168700198,10.884658930176823,-0.1963698121218428,9536036637.0,2014-05-16,2014,4,136,5,0.76,187.42,188.89,187.52,3614
2014-05-19 13:30:00,187.69,188.89,187.52,188.74,185.4404347826087,192.2963636363636,178.85378005000018,184.752771,186.82874199999983,188.0245000000001,186.6579300564104,187.89030506041354,188.31500000000008,190.03968503254367,186.59031496745652,178.85378005000018,184.752771,186.82874199999983,188.0245000000001,188.38333333333333,63839398,92361239.5,54.92918658778629,1.5,2.75,1.6554656739753066,0.6911925212956892,-0.025482289269831204,0.623752307112909,0.6492345963827402,11.042280498528905,1.0493628868187217,9599876035.0,2014-05-19,2014,0,139,5,0.73,188.2,188.67,187.07,3615
2014-05-20 13:30:00,188.645,188.67,187.07,187.55,185.60565217391303,192.38290909090907,178.93678005000027,184.79897099999997,186.81654199999986,188.0075000000001,186.6929131914531,187.85789505465988,188.25538461538483,190.02749097411458,186.48327825665496,178.93678005000027,184.79897099999997,186.81654199999986,188.0075000000001,187.7633333333333,111644478,93653948.05,49.83685691565786,1.5,2.75,1.6565038401199292,1.1920957986778646,-0.1024674154504508,0.5211503270696767,0.6236177425201275,10.398384538601288,-0.17564402810303606,9488231557.0,2014-05-20,2014,1,140,5,0.86,187.87,189.22,188.06,3616
2014-05-21 13:30:00,188.1,189.22,188.06,189.13,185.7708695652174,192.4694545454545,179.02893005000027,184.851721,186.8545419999998,188.09150000000014,186.78848522316082,187.97904790659703,188.33769230769246,190.1644069516455,186.51097766373942,179.02893005000027,184.851721,186.8545419999998,188.09150000000014,188.8033333333333,89093285,94415143.1,55.708128669706895,1.5,2.75,1.6574678515399337,0.9436334265324012,-0.050202184941931405,0.5608650113427132,0.6110671962846446,10.965474029662142,0.7752764086852186,9577324842.0,2014-05-21,2014,2,141,5,0.62,188.64,189.98,188.86,3617
2014-05-22 13:30:00,189.18,189.98,188.86,189.59,185.93608695652173,192.556,179.12823005000018,184.909171,186.9007419999998,188.17950000000016,186.8983485477428,188.13247191549252,188.42769230769244,190.37318657108293,186.48219804430198,179.12823005000018,184.909171,186.9007419999998,188.17950000000016,189.4766666666667,61549345,93084114.55,57.27598035146573,1.5,2.75,1.619077290715651,0.6612228659804124,0.008973472854921227,0.6222840373532961,0.6133105644983748,10.945484646409168,0.8672057884656286,9638874187.0,2014-05-22,2014,3,142,5,0.59,189.42,190.48,189.5858,3618
2014-05-23 13:30:00,189.75,190.48,189.5858,190.35,186.10130434782607,192.64254545454543,179.2340801000002,184.97447099999997,187.0041419999998,188.38250000000016,187.0337074282234,188.34366506639802,188.70230769230784,190.64780195571328,186.7568134289024,179.2340801000002,184.97447099999997,187.0041419999998,188.38250000000016,190.1386,60156088,91072908.7,59.80741834113378,1.5,2.75,1.5673003413788176,0.6605267017237586,0.08850321361952829,0.7239395815227851,0.6354363679032569,11.078793417137197,0.2977052981004809,9699030275.0,2014-05-23,2014,4,143,5,0.47,190.03,191.58,190.95,3619
2014-05-27 13:30:00,191.05,191.58,190.95,191.52,186.26652173913044,192.72909090909093,179.34268010000017,185.042771,187.1413419999998,188.61475000000016,187.2096404702539,188.64617315531245,188.98230769230784,191.37106860503332,186.5935467795824,179.34268010000017,185.042771,187.1413419999998,188.61475000000016,191.35,72010355,87917371.75,63.40246080562864,1.5,2.75,1.5432074598517604,0.8190685591098781,0.2025849442757333,0.8886675482479234,0.6860826039721901,10.255269919862537,0.8212255211623511,9771040630.0,2014-05-27,2014,1,147,5,0.33,191.26,191.82,191.06,3620
2014-05-28 13:30:00,191.52,191.82,191.06,191.38,186.4317391304348,192.81563636363637,179.45303010000018,185.127371,187.2423419999998,188.79625000000016,187.37318398122437,188.90653761671132,189.26730769230787,191.8410825775108,186.69353280710487,179.45303010000018,185.127371,187.2423419999998,188.79625000000016,191.42,66722865,87048637.45,62.680000533067144,1.5,2.75,1.4872640698623485,0.7665009695105802,0.2482799683127199,0.9964325643630899,0.7481525960503701,10.298254628067957,1.227123664445146,9704317765.0,2014-05-28,2014,2,148,5,0.4,191.44,192.4,191.33,3621
2014-05-29 13:30:00,191.82,192.4,191.33,192.37,186.59695652173912,192.9021818181818,179.5693251500002,185.222221,187.33654199999984,188.99925000000016,187.56913755058812,189.2363911770245,189.60653846153855,192.53914922962815,186.67392769344897,179.5693251500002,185.222221,187.33654199999984,188.99925000000016,192.03333333333333,64376573,85192080.25,65.6598977377008,1.5,2.75,1.4574594934436085,0.7556638224009091,0.3202642006882833,1.1484828469107242,0.8282186462224409,9.928146314796637,2.6520811099252932,9768694338.0,2014-05-29,2014,3,149,5,0.56,191.86,192.8,192.03,3622
2014-05-30 13:30:00,192.19,192.8,192.03,192.68,186.76217391304348,192.9887272727273,179.68467515000015,185.325421,187.45694199999986,189.21700000000016,187.7695635289964,189.56435392206973,189.82923076923092,193.1905625706553,186.46789896780646,179.68467515000015,185.325421,187.45694199999986,189.21700000000016,192.50333333333333,76315640,84356907.5,66.56029319955236,1.5,2.75,1.408355243911923,0.9046756485235072,0.3608265088422497,1.279251782275253,0.9184252734330032,7.344546083664424,2.4621111406540788,9845009978.0,2014-05-30,2014,4,150,5,0.4,192.42,192.99,191.97,3623
2014-06-02 13:30:00,192.95,192.99,191.97,192.895,186.92739130434785,193.07527272727268,179.80545010000014,185.419571,187.55990199999985,189.45875000000015,187.9705610376632,189.88155831044412,190.05500000000006,193.7941689738973,186.3158310261029,179.80545010000014,185.419571,187.55990199999985,189.45875000000015,192.6183333333333,64655648,82683606.8,67.2025855803931,1.5,2.75,1.3806155836325005,0.7819645332646521,0.3726827457544901,1.384278705626116,1.0115959598716258,7.387849509129981,2.2014411359542234,9909665626.0,2014-06-02,2014,0,153,6,0.53,192.48,192.9,192.25,3624
2014-06-03 13:30:00,192.4,192.9,192.25,192.8,187.09260869565216,193.16181818181815,179.93755010000018,185.512371,187.69190199999986,189.67775000000015,188.15995080089212,190.15950513802085,190.34269230769246,194.30049009352538,186.38489452185948,179.93755010000018,185.512371,187.69190199999986,189.67775000000015,192.65,65047193,82141829.5,66.59392559026922,1.5,2.75,1.3284287562301795,0.7918887781772623,0.34529215466394714,1.4432111532015597,1.0979189985376123,7.540464337275535,2.7992535323913623,9844618433.0,2014-06-03,2014,1,154,6,0.34,192.58,193.3,192.265,3625
2014-06-04 13:30:00,192.47,193.3,192.265,193.19,187.25782608695653,193.2483636363636,180.0743501000002,185.607871,187.84710199999984,189.99825000000016,188.3572076322297,190.44812369630455,190.78807692307706,194.62223421381847,186.9539196323356,180.0743501000002,185.607871,187.84710199999984,189.99825000000016,192.91833333333332,55529372,80645586.8,67.88006804343144,1.5,2.75,1.3074695593565973,0.6885605797340419,0.3249028484500933,1.5040475591002291,1.1791447106501358,5.314013551107663,2.1466716015439133,9900147805.0,2014-06-04,2014,2,155,6,0.54,192.78,194.65,192.7,3626
2014-06-05 13:30:00,193.41,194.65,192.7,194.45,187.42304347826087,193.33490909090904,180.22275010000016,185.710971,188.0099019999999,190.32675000000012,188.59614066625983,190.82925477284698,191.28038461538472,195.2238045710515,187.33696465971798,180.22275010000016,185.710971,188.0099019999999,190.32675000000012,193.9333333333333,92102592,79925692.4,71.67438494089112,1.5,2.75,1.3533645908311271,1.1523527570966654,0.3647515012916638,1.6350840872647154,1.2703325859730517,4.682986741420666,2.5634263410517355,9992250397.0,2014-06-05,2014,3,156,6,1.01,193.68,195.43,194.78,3627
2014-06-06 13:30:00,194.87,195.43,194.78,195.375,187.5882608695652,193.4214545454545,180.3717251000002,185.847871,188.2180019999999,190.7117500000001,188.86197828719085,191.26218288971873,191.7907692307693,195.9957202433026,187.58581821823606,180.3717251000002,185.847871,188.2180019999999,190.7117500000001,195.195,78696219,79179627.7,74.09384172304495,1.5,2.75,1.3266956914860477,0.9938947843777244,0.4180569478052345,1.7929037707295947,1.3748468229243602,4.8072918447875415,2.6398739164696643,10070946616.0,2014-06-06,2014,4,157,6,0.33,195.1,196.05,195.17,3628
2014-06-09 13:30:00,195.35,196.05,195.17,195.58,187.7534782608696,193.508,180.5268251000002,185.966971,188.4380019999999,191.0927500000001,189.1254301190657,191.6734035668884,192.4084615384616,196.28657841816482,188.5303446587584,180.5268251000002,185.966971,188.4380019999999,191.0927500000001,195.6,65118828,78251640.7,74.61141731652724,1.5,2.75,1.2947888563799033,0.8321720467133924,0.4301009380047114,1.9124729954302493,1.482372057425538,4.881449417024707,2.1198830409356737,10136065444.0,2014-06-09,2014,0,160,6,0.45,195.61,195.64,194.92,3629
2014-06-10 13:30:00,195.33,195.64,194.92,195.6,187.9186956521739,193.59454545454545,180.67452510000018,186.076371,188.64020199999987,191.3835000000001,189.37933482027884,192.0473651319466,192.90615384615398,196.6311983040192,189.1811093882886,180.67452510000018,186.076371,188.64020199999987,191.3835000000001,195.38666666666663,57129440,76761110.45,74.66459866931572,1.5,2.75,1.2537325094956242,0.7442497856673463,0.4028651260412615,1.9859534649771151,1.5830883389358534,4.5523720707331305,2.2050370989654087,10193194884.0,2014-06-10,2014,1,161,6,0.37,195.28,195.12,194.48,3630
2014-06-11 13:30:00,194.9,195.12,194.48,194.92,188.08391304347825,193.68109090909093,180.8160251000002,186.18137099999998,188.7984019999999,191.6315000000001,189.59661580771888,192.32094940509452,193.3161538461539,196.6429799007796,189.98932779152824,180.8160251000002,186.18137099999998,188.7984019999999,191.6315000000001,194.84,68772479,76877036.15,69.34590083439083,1.5,2.75,1.2441801873887943,0.8945776586107371,0.30684666554065965,1.966646670861678,1.6598000053210185,5.377085820348685,1.3255705151530814,10124422405.0,2014-06-11,2014,2,162,6,0.33,194.8,194.8,193.11,3631
2014-06-12 13:30:00,194.65,194.8,193.11,193.54,188.24913043478261,193.76763636363637,180.95372510000016,186.280421,188.90420199999988,191.85550000000012,189.75125832506325,192.43704946175225,193.56153846153853,196.41377209265536,190.70930483042167,180.95372510000016,186.280421,188.90420199999988,191.85550000000012,193.8166666666667,106350200,78576203.75,60.00417887700906,1.5,2.75,1.2845958882895927,1.353465743119462,0.12737828954891373,1.819022867257161,1.6916445777082467,6.967135994834477,0.44633589370977017,10018072205.0,2014-06-12,2014,3,163,6,0.88,193.96,194.32,193.3,3632
2014-06-13 13:30:00,193.9,194.32,193.3,194.13,188.41434782608692,193.85418181818181,181.10772510000015,186.379921,189.00920199999993,192.19200000000012,189.9229736848647,192.59828284634725,193.76230769230781,196.3682642283098,191.15635115630573,181.10772510000015,186.379921,189.00920199999993,192.19200000000012,193.91666666666663,82017278,74929247.7,62.3400227166857,1.5,2.75,1.2656961819831918,1.0945963094195061,0.030443628880674645,1.7296991138090902,1.6992554849284156,7.0899030521282675,0.6402446927084606,10100089483.0,2014-06-13,2014,4,164,6,0.53,193.81,194.7,193.66,3633
2014-06-16 13:30:00,193.89,194.7,193.66,194.29,188.57956521739132,193.9407272727273,181.25962510000016,186.47982100000004,189.12240199999997,192.5040000000001,190.0942296187916,192.7593987657428,193.986153846154,196.2065112458409,191.76579644646702,181.25962510000016,186.47982100000004,189.12240199999997,192.5040000000001,194.21666666666667,87424332,74427580.4,62.971586113023186,1.5,2.75,1.2495750261272491,1.1746227880867668,-0.0371900055073191,1.6527679780442668,1.689957983551586,7.086386512315085,0.7728215767634754,10187513815.0,2014-06-16,2014,0,167,6,0.54,194.18,194.97,193.81,3634
2014-06-17 13:30:00,194.02,194.97,193.81,194.83,188.7447826086957,194.02727272727267,181.41292510000017,186.6002210000001,189.29100199999996,192.80850000000012,190.27994610432918,192.956598883291,194.17538461538467,196.22530567030998,192.12546356045945,181.41292510000017,186.6002210000001,189.29100199999996,192.80850000000012,194.53666666666663,84833876,75477304.3,65.09891338143376,1.5,2.75,1.2431768099753029,1.1239653666327352,-0.05857738160814785,1.6167362565414007,1.6753136381495488,7.129590786145911,0.8489052228376287,10272347691.0,2014-06-17,2014,1,168,6,0.6,194.39,196.37,194.4,3635
2014-06-18 13:30:00,194.83,196.37,194.4,196.255,188.91,194.11381818181817,181.57595015000015,186.77387100000007,189.52930199999992,193.24375000000012,190.5142619433751,193.27073232297764,194.45038461538476,196.58165892376442,192.31911030700508,181.57595015000015,186.77387100000007,189.52930199999992,193.24375000000012,195.675,105266767,75158418.75,69.99741892086952,1.5,2.75,1.2950927521199238,1.4005984791956525,0.006754804822990622,1.6837571441782868,1.6770023393552964,7.9803046802377615,0.9282591925945008,10377614458.0,2014-06-18,2014,2,169,6,1.01,195.38,196.6,195.8,3636
2014-06-19 13:30:00,196.43,196.6,195.8,196.48,189.07521739130436,194.2003636363636,181.73640015000015,186.95857100000006,189.7569019999999,193.61125000000013,190.7482124553996,193.57637686364643,194.72615384615398,196.9081823795948,192.54412531271308,181.73640015000015,186.95857100000006,189.7569019999999,193.61125000000013,196.2933333333333,85928920,75000200.5,70.69676565372852,1.5,2.75,1.2597289841113566,1.1457158704529062,0.04641971969525782,1.7350269889743686,1.6886072692791108,7.337956265757134,0.5655790147152858,10463543378.0,2014-06-19,2014,3,170,6,0.41,196.2,196.1039,195.7,3637
2014-06-20 13:30:00,196.03,196.1039,195.7,195.94,189.24043478260867,194.28690909090903,181.8873501500002,187.12727100000006,189.93390199999993,193.92875000000006,190.95181196695256,193.80148382901345,194.9676923076924,196.92720408120547,193.0081805341793,181.8873501500002,187.12727100000006,189.93390199999993,193.92875000000006,195.9146333333333,100587108,76952088.65,66.67957293393172,1.5,2.75,1.225462628103403,1.307139413167832,0.01899127287993529,1.71234636037903,1.6933550874990946,7.212646704505856,0.18406790060332606,10362956270.0,2014-06-20,2014,4,171,6,0.21,195.9,196.05,195.52,3638
2014-06-23 13:30:00,195.97,196.05,195.52,195.88,189.40565217391304,194.3734545454545,182.03695010000015,187.31257100000008,190.18840199999988,194.20525000000012,191.14507424275837,193.99943775005983,195.17461538461552,196.8927962721119,193.4564344971191,182.03695010000015,187.31257100000008,190.18840199999988,194.20525000000012,195.8166666666667,70611486,77474858.55,66.22925919977362,1.5,2.75,1.175786726096017,0.9114116156072672,-0.018462955041350426,1.6702763936974063,1.6887393487387568,7.202339926985598,0.1431492842535793,10292344784.0,2014-06-23,2014,0,174,6,0.27,195.79,196.5,194.48,3639
2014-06-24 13:30:00,195.53,196.5,194.48,194.7,189.57086956521735,194.46,182.18025015000015,187.46727100000007,190.45220199999991,194.3642500000001,191.28448309598352,194.06615796433982,195.1938461538463,196.88453174008052,193.503160567612,182.18025015000015,187.46727100000007,190.45220199999991,194.3642500000001,195.2266666666667,96236917,78686186.65,57.94165971629295,1.5,2.75,1.2360876742320168,1.2230471585574034,-0.13167143847691132,1.5241500506426178,1.655821489119529,8.031519124062115,-0.11286681715575562,10196107867.0,2014-06-24,2014,1,175,6,1.04,195.49,195.78099999999998,194.25,3640
2014-06-25 13:30:00,194.25,195.78099999999998,194.25,195.58,189.73608695652172,194.54654545454545,182.3199801500002,187.6412710000001,190.70499999999993,194.57425000000006,191.45293473927825,194.21033339630745,195.20961538461552,196.9105583879517,193.5086723812793,182.3199801500002,187.6412710000001,190.70499999999993,194.57425000000006,195.20366666666663,82781912,79489139.0,61.78250186310893,1.5,2.75,1.2571528403583017,1.041424187523279,-0.15466215258810267,1.4624937983844006,1.6171559509725033,8.237754527256088,1.0540456753126075,10278889779.0,2014-06-25,2014,2,176,6,0.79,195.02,195.63,194.13,3641
2014-06-26 13:30:00,195.61,195.63,194.13,195.44,189.90130434782608,194.63309090909092,182.45283015000015,187.8539710000001,190.92979999999991,194.72775000000013,191.60929023969868,194.327444501421,195.19884615384623,196.892027746392,193.5056645613005,182.45283015000015,187.8539710000001,190.92979999999991,194.72775000000013,195.0666666666667,84311822,80485901.45,60.83074177797446,1.5,2.75,1.2744990660469944,1.0475352885545646,-0.1846424162347038,1.3863529306791236,1.5709953469138274,6.823175842146993,0.6748055426775884,10194577957.0,2014-06-26,2014,3,177,6,0.77,194.88,195.88,194.885,3642
2014-06-27 13:30:00,194.98,195.88,194.885,195.82,190.0665217391304,194.71963636363637,182.5849302000002,188.05832100000012,191.12369999999987,194.8847500000001,191.77441611265166,194.4695926441428,195.2157692307693,196.9289302593994,193.50260820213933,182.5849302000002,188.05832100000012,191.12369999999987,194.8847500000001,195.5283333333333,71453616,80242800.25,62.518533362568654,1.5,2.75,1.254534847043638,0.8904676279664107,-0.18382595655850345,1.341212901215698,1.5250388577742016,6.729962793901222,0.7874826290596537,10266031573.0,2014-06-27,2014,4,178,6,0.51,195.38,196.165,195.53,3643
2014-06-30 13:30:00,195.7,196.165,195.53,195.72,190.2317391304348,194.80618181818176,182.71878020000025,188.26382100000015,191.3102999999999,195.02600000000007,191.9291448925477,194.58867905898637,195.27730769230783,197.0009916513096,193.553623733306,182.71878020000025,188.26382100000015,191.3102999999999,195.02600000000007,195.805,70504228,80535229.25,61.7642891193925,1.5,2.75,1.2102823579690918,0.8754457975296569,-0.1939630095939231,1.2825850957817977,1.4765481053757208,6.776384428649642,0.4568084997176956,10195527345.0,2014-06-30,2014,0,181,6,0.32,195.85,197.63,196.13,3644
2014-07-01 13:30:00,196.19,197.63,196.13,197.03,190.39695652173916,194.89272727272729,182.85728020000028,188.45932100000016,191.51009999999988,195.23750000000013,192.1291784261733,194.82118581527337,195.5457692307694,197.1887301889273,193.9028082726114,182.85728020000028,188.45932100000016,191.51009999999988,195.23750000000013,196.93,90470121,81806375.65,67.32548674392885,1.5,2.75,1.2602621895427275,1.10590550285551,-0.12000912420495034,1.326536700119533,1.4465458243244833,7.530702079609349,0.39489439759496864,10285997466.0,2014-07-01,2014,1,182,7,0.76,196.88,197.48,196.96,3645
2014-07-02 13:30:00,197.05,197.48,196.96,197.23,190.56217391304347,194.97927272727267,182.99188020000025,188.63482100000016,191.69689999999989,195.43950000000007,192.32921064475468,195.05059669000923,195.78423076923087,197.4358772491581,194.1325842893037,182.99188020000025,188.63482100000016,191.69689999999989,195.43950000000007,197.22333333333333,52474832,81653648.65,68.08859897534424,1.5,2.75,1.2073863188611031,0.6426514046534282,-0.06778953436705315,1.3618089063656669,1.4295984407327198,6.434961060528819,0.3817182410423453,10338472298.0,2014-07-02,2014,2,183,7,0.26,197.22,198.29,197.64,3646
2014-07-03 13:30:00,197.79,198.29,197.64,198.2,190.72739130434783,195.06581818181817,183.12753015000018,188.81672100000014,191.91189999999992,195.62700000000007,192.55943767829373,195.3505398623893,196.08500000000006,197.94907329007145,194.22092670992882,183.12753015000018,188.81672100000014,191.91189999999992,195.62700000000007,198.04333333333332,52938832,79695460.65,71.55808073920807,1.5,2.75,1.1968587246567386,0.6642640818966142,0.017364090095496554,1.4513035533520906,1.433939463256594,6.916533626790758,1.1534143105032106,10391411130.0,2014-07-03,2014,3,184,7,0.33,197.96,197.98,197.22,3647
2014-07-07 13:30:00,197.82,197.98,197.22,197.51,190.89260869565217,195.1523636363636,183.2498252000002,188.97202100000013,192.10549999999992,195.73375000000016,192.75357737718414,195.55620273263798,196.29115384615397,198.1472131698217,194.43509452248628,183.2498252000002,188.97202100000013,192.10549999999992,195.73375000000016,197.57,61696447,78845472.05,66.05639656327826,1.5,2.75,1.1813688157526852,0.7824982893231344,0.012719337507381969,1.4498386351408217,1.4371192976334397,7.0683103139686025,0.832142127833365,10329714683.0,2014-07-07,2014,0,188,7,0.39,197.6,197.22,195.76,3648
2014-07-08 13:30:00,197.15,197.22,195.76,196.24,191.05782608695648,195.23890909090903,183.3672252500002,189.1137210000002,192.30449999999985,195.76675000000012,192.89029983298087,195.6213262819105,196.29000000000008,198.14616643816836,194.4338335618319,183.3672252500002,189.1137210000002,192.30449999999985,195.76675000000012,196.40666666666667,108142552,80996658.25,57.32087051372548,1.5,2.75,1.2219853289132077,1.3351483176776615,-0.0850090474839098,1.3308579882785525,1.415867035762462,8.204707575841558,0.7909604519774117,10221572131.0,2014-07-08,2014,1,189,7,0.75,196.49,197.295,196.31,3649
2014-07-09 13:30:00,196.73,197.295,196.31,197.12,191.22304347826088,195.32545454545453,183.4992252500002,189.2548210000002,192.50939999999989,195.8427500000001,193.05617042776595,195.76405711220474,196.33923076923085,198.24619713236717,194.4322644060945,183.4992252500002,189.2548210000002,192.50939999999989,195.8427500000001,196.90833333333333,72992322,81789802.35,61.15424610546869,1.5,2.75,1.2100578054194056,0.8924379311695452,-0.09855563648338994,1.2926724901582247,1.3912281266416149,7.473401635932678,0.7874015748031454,10294564453.0,2014-07-09,2014,2,190,7,0.5,196.8,196.86,195.06,3650
2014-07-10 13:30:00,195.22,196.86,195.06,196.34,191.3882608695652,195.412,183.6312753000002,189.3780210000002,192.68119999999988,195.91375000000008,193.18494805804963,195.81890881580432,196.3700000000001,198.2630642640177,194.47693573598247,183.6312753000002,189.3780210000002,192.68119999999988,195.91375000000008,196.08666666666667,99040407,83303198.75,56.325160825803955,1.5,2.75,1.2707679621751624,1.1889148134302585,-0.1643412657536205,1.185801544449589,1.3501428102032096,7.69332491965709,0.4604993860008216,10195524046.0,2014-07-10,2014,3,191,7,0.92,195.96,196.75,195.78,3651
2014-07-11 13:30:00,196.22,196.75,195.78,196.61,191.55347826086955,195.49854545454545,183.7666753000002,189.50172100000015,192.84719999999993,196.0672500000001,193.31926382047905,195.89425083334675,196.426153846154,198.30096728856074,194.55134040374713,183.7666753000002,189.50172100000015,192.84719999999993,196.0672500000001,196.38,64243410,81197859.25,57.57404937957354,1.5,2.75,1.2492845363055078,0.7911958590213695,-0.19203760803916348,1.1100958001542551,1.3021334081934186,7.67711541182512,0.4034317230109389,10259767456.0,2014-07-11,2014,4,192,7,0.5,196.26,197.86,197.44,3652
2014-07-14 13:30:00,197.61,197.86,197.44,197.6,191.71869565217392,195.58509090909092,183.90947535000018,189.64752100000013,193.03269999999992,196.24075000000008,193.48713582751913,196.05670313493283,196.64923076923088,198.32942236159946,194.9690391768623,183.90947535000018,189.64752100000013,193.03269999999992,196.24075000000008,197.63333333333333,58657919,80029891.3,61.878506549610606,1.5,2.75,1.2493356408551146,0.7329501270983233,-0.14802202462356506,1.1171058774139624,1.2651279020375277,8.067254646986902,0.9605558961782116,10318425375.0,2014-07-14,2014,0,195,7,0.21,197.65,198.1,196.36,3653
2014-07-15 13:30:00,197.72,198.1,196.36,197.23,191.88391304347823,195.67163636363637,184.0471753500002,189.77882100000016,193.21609999999993,196.38775000000007,193.63391481467517,196.1684456935106,196.776153846154,198.36064674658357,195.1916609457244,184.0471753500002,189.77882100000016,193.21609999999993,196.38775000000007,197.23,111346230,81225986.2,59.45080249916775,1.5,2.75,1.2843830950797481,1.3708202905143674,-0.1478208157404144,1.0803518823620095,1.2281726981024241,8.191476666133402,0.1015073846622284,10207079145.0,2014-07-15,2014,1,196,7,0.89,197.23,198.26,197.42,3654
2014-07-16 13:30:00,198.11,198.26,197.42,197.96,192.0491304347826,195.75818181818175,184.19243035000028,189.91952100000015,193.4068999999999,196.5442500000001,193.80356521409973,196.33906991317622,196.97000000000008,198.46740287986972,195.47259712013047,184.19243035000028,189.91952100000015,193.4068999999999,196.5442500000001,197.88,80073242,80987954.5,62.57091961446663,1.5,2.75,1.266212874002623,0.9887055734936484,-0.1045558119512502,1.0974779331633613,1.2020337451146117,7.562120824097081,0.3701262485423201,10287152387.0,2014-07-16,2014,2,197,7,0.43,197.84,198.1,195.43,3655
2014-07-17 13:30:00,197.35,198.1,195.43,195.71,192.21434782608696,195.84472727272725,184.33093040000026,190.02752100000012,193.58549999999985,196.51700000000008,193.8783273625664,196.27915849287373,196.96153846153854,198.48584099874267,195.43723592433446,184.33093040000026,190.02752100000012,193.58549999999985,196.51700000000008,196.41333333333333,145398459,82994539.1,49.84113869634244,1.5,2.75,1.366483383002435,1.7519039273753858,-0.2265056131217702,0.9189017287123988,1.1454073418341688,10.155221491306909,-1.2563067608476193,10141753928.0,2014-07-17,2014,3,198,7,1.37,196.76,197.91,196.24,3656
2014-07-18 13:30:00,196.35,197.91,196.24,197.7099,192.37956521739133,195.93127272727267,184.47277990000026,190.1562200000002,193.78209799999985,196.5784950000001,194.02858511305402,196.4154195887905,197.11460769230783,198.50306605260963,195.72614933200595,184.47277990000026,190.1562200000002,193.78209799999985,196.5784950000001,197.28663333333333,124330419,84914614.05,58.016980944911815,1.5,2.75,1.426020284216546,1.4641816416522946,-0.1738811016401176,0.928055964784022,1.1019370664241397,11.577227052903561,0.10121006531315566,10266084347.0,2014-07-18,2014,4,199,7,0.85,197.08,197.5,196.43,3657
2014-07-21 13:30:00,197.09,197.5,196.43,197.34,192.54478260869564,196.01781818181817,184.61357995000026,190.2811200000002,193.9753979999999,196.64849500000008,194.15844452038516,196.50347486604855,197.138453846154,198.5309231450904,195.74598454721743,184.61357995000026,190.2811200000002,193.9753979999999,196.64849500000008,197.09,67591618,83264839.55,56.19256269597386,1.5,2.75,1.4155831210582213,0.8117666276101051,-0.1654342464162235,0.8951442584038602,1.0605785048200838,11.448569725878716,0.5605381165919253,10198492729.0,2014-07-21,2014,0,202,7,0.54,196.96,198.56,197.87,3658
2014-07-22 13:30:00,198.01,198.56,197.87,198.2,192.71,196.10436363636362,184.76647995000027,190.4049200000002,194.18019799999993,196.76449500000007,194.3169368921348,196.66504868832962,197.21306923076926,198.71668308749886,195.7094553740398,184.76647995000027,190.4049200000002,194.18019799999993,196.76449500000007,198.21,67677602,83118145.35,59.38999343074644,1.5,2.75,1.401612898125491,0.8142337839110604,-0.10625348553905802,0.9277616478962614,1.0340151334353194,10.918101587877743,0.5478896103896023,10266170331.0,2014-07-22,2014,1,203,7,0.35,198.22,198.85,198.1,3659
2014-07-23 13:30:00,198.495,198.85,198.1,198.64,192.87521739130435,196.19090909090903,184.91522995000028,190.52842000000015,194.35729799999993,196.96149500000007,194.48646877871772,196.85313928944112,197.24691538461548,198.85410924274012,195.63972152649083,184.91522995000028,190.52842000000015,194.35729799999993,196.96149500000007,198.53,65611830,81586891.0,60.960001894596815,1.5,2.75,1.3550691196879558,0.8041957377687059,-0.04493729437123295,0.977843515471278,1.022780809842511,10.73052433022042,1.1714373026382718,10331782161.0,2014-07-23,2014,2,204,7,0.38,198.48,199.06,198.45,3660
2014-07-24 13:30:00,198.83,199.06,198.45,198.65,193.04043478260868,199.06,185.07133000000027,190.6651200000002,194.53109799999993,197.11499500000008,194.64974451288572,197.0242688809229,197.33460769230774,199.10569584190517,195.56351954271037,185.07133000000027,190.6651200000002,194.53109799999993,197.11499500000008,198.72,56888093,80292200.05,60.99690814946468,1.5,2.75,1.3018498968531027,0.7085133171662296,-0.012836127186456771,1.00673565085944,1.0195717780458968,10.323148258610898,1.0375871013681868,10388670254.0,2014-07-24,2014,3,205,7,0.31,198.76,198.26,197.33,3661
2014-07-25 13:30:00,198.09,198.26,197.33,197.72,193.20565217391305,199.18315789473687,185.23253000000028,190.76652000000018,194.70429799999994,197.22899500000008,194.77014668885099,197.09052898750167,197.44845384615388,199.11036349218202,195.78654420012575,185.23253000000028,190.76652000000018,194.70429799999994,197.22899500000008,197.77,76837257,79918471.8,55.72122753396358,1.5,2.75,1.3031463327921664,0.96144552403716,-0.060688515131934524,0.9437111341309788,1.0043996492629133,10.851373191615972,0.06072874493927356,10311832997.0,2014-07-25,2014,4,206,7,0.47,197.8,198.09,196.62,3662
2014-07-28 13:30:00,197.76,198.09,196.62,197.8,193.3708695652174,199.3063157894737,185.39352995000027,190.8670200000002,194.91229799999994,197.32799500000007,194.88896446575882,197.15809765535863,197.5007615384616,199.16083108946253,195.84069198746067,185.39352995000027,190.8670200000002,194.91229799999994,197.32799500000007,197.50333333333333,69258785,79808730.25,56.07318655062283,1.5,2.75,1.3150644518784402,0.8678096341471364,-0.09155157936904046,0.8899601750516126,0.9815117544206532,10.474895849027664,0.28900268721797984,10381091782.0,2014-07-28,2014,0,209,7,0.75,197.36,198.45,196.92,3663
2014-07-29 13:30:00,198.17,198.45,196.92,196.95,193.53608695652173,199.42947368421054,185.53242995000028,190.95472000000018,195.09029799999996,197.38949500000007,194.9697893886702,197.13827883103883,197.54768461538467,199.1051775038362,195.99019172693318,185.53242995000028,190.95472000000018,195.09029799999996,197.38949500000007,197.44,80466351,80306836.4,51.39842013550634,1.5,2.75,1.33041699102998,1.0019863140817236,-0.16928993459959096,0.7698993361711644,0.9391892707707552,10.73193128850334,-0.5102040816326628,10300625431.0,2014-07-29,2014,1,210,7,0.78,197.68,197.91,196.16,3664
2014-07-30 13:30:00,197.65,197.91,196.16,196.98,193.70130434782607,199.55263157894737,185.66603000000026,191.0419200000002,195.25509799999992,197.38699500000007,195.04862117734982,197.12320465665414,197.57614615384617,199.07653389170682,196.0757584159856,185.66603000000026,191.0419200000002,195.25509799999992,197.38699500000007,197.01666666666665,104222452,80994452.95,51.55194123456424,1.5,2.75,1.3603872059564102,1.2867850600131745,-0.21578825089745898,0.6694539571489315,0.8852422080463905,10.458283816421632,0.6489193194011454,10404847883.0,2014-07-30,2014,2,211,7,0.89,197.04,195.78,192.97,3665
2014-07-31 13:30:00,195.61,195.78,192.97,193.09,193.86652173913043,199.6757894736842,185.77678000000026,191.09122000000028,195.36589799999996,197.17999500000008,194.97181250372824,196.739089927449,197.22922307692315,200.0509299342577,194.40751621958856,185.77678000000026,191.09122000000028,195.36589799999996,197.17999500000008,193.9466666666667,183479441,87544683.4,35.772792814344896,1.5,2.75,1.5496452626738086,2.095837621134169,-0.4899418145292755,0.2728149398847961,0.7627567544140716,14.18310565449419,-2.3367064572891905,10221368442.0,2014-07-31,2014,3,212,7,1.46,194.38,193.76,191.57,3666
2014-08-01 13:30:00,192.56,193.76,191.57,192.5,194.0317391304348,199.7989473684211,185.89078000000026,191.14392000000018,195.43329799999995,196.89499500000005,194.8748786800526,196.33536707721572,196.86537692307698,200.64878825163055,193.08196559452338,185.89078000000026,191.14392000000018,195.43329799999995,196.89499500000005,192.61,189260864,94360785.0,34.069492242244365,1.5,2.75,1.5953848867685363,2.0057152343529148,-0.680698726853451,-0.08811665415274206,0.592582072700709,12.142948589748585,-2.452619843924193,10032107578.0,2014-08-01,2014,4,213,8,1.14,192.66,194.3,192.05,3667
2014-08-04 13:30:00,192.87,194.3,192.05,193.89,194.19695652173908,199.92210526315793,185.99987995000018,191.21002000000018,195.51929799999996,196.71399500000007,194.8362559867172,196.10247497462376,196.55230000000003,200.58682787211757,192.51777212788247,185.99987995000018,191.21002000000018,195.51929799999996,196.71399500000007,193.41333333333333,91340487,95842987.0,41.17576984883047,1.5,2.75,1.6421431091422125,0.9530221235696672,-0.6812740167960565,-0.2590104482943616,0.4222635685016948,13.40675863232042,-2.1745711402623624,10123448065.0,2014-08-04,2014,0,216,8,1.17,193.18,193.6,191.31,3668
2014-08-05 13:30:00,193.1,193.6,191.31,192.01,194.36217391304348,200.04526315789474,186.09382995000018,191.27832000000018,195.55249799999996,196.50249500000007,194.7254224186106,195.71271545323106,196.26768461538464,200.96699855278442,191.5683706779849,186.09382995000018,191.27832000000018,195.55249799999996,196.50249500000007,192.30666666666664,152690379,98070378.35,35.58857207962063,1.5,2.75,1.7091328870606246,1.5569469759264982,-0.7697479920026951,-0.5399214215016741,0.22982657050102104,13.494408201002932,-3.3376963350785314,9970757686.0,2014-08-05,2014,1,217,8,1.2,192.46,192.89,191.08,3669
2014-08-06 13:30:00,191.11,192.89,191.08,192.07,194.52739130434784,200.1684210526316,186.18223995000028,191.3524200000002,195.56349799999992,196.24999500000007,194.62128820611613,195.3657901719709,195.83384615384617,200.94387573956402,190.72381656812843,186.18223995000028,191.3524200000002,195.56349799999992,196.24999500000007,192.0133333333333,94818317,99161678.1,35.887573064021616,1.5,2.75,1.7163376808420066,0.9561991972784092,-0.7831165290916284,-0.7490690908635145,0.0340474382281139,13.258761291941278,-3.3123584193304865,10065576003.0,2014-08-06,2014,2,218,8,0.95,191.98,193.13,190.55,3670
2014-08-07 13:30:00,192.935,193.13,190.55,191.03,190.55,200.29157894736844,186.26539000000028,191.39942000000016,195.55649799999995,195.98449500000007,194.48045337450367,194.9528577746404,195.3484615384616,200.96741214486758,189.72951093205558,186.26539000000028,191.39942000000016,195.55649799999995,195.98449500000007,191.57,135733421,100996328.8,33.0258326344037,1.5,2.75,1.778027846496148,1.3439441077981045,-0.8171241810193006,-0.9873577880460118,-0.17023360702671125,13.114992392988526,-3.3835727291118745,9929842582.0,2014-08-07,2014,3,219,8,1.35,191.84,193.37,190.95,3671
2014-08-08 13:30:00,191.46,193.37,190.95,193.24,190.6640740740741,200.4147368421053,186.35454000000016,191.4552200000002,195.57389799999996,195.81599500000004,194.43180814413105,194.78972846276986,194.96692307692314,200.43101218880108,189.5028339650452,186.35454000000016,191.4552200000002,195.57389799999996,195.81599500000004,192.52,117014384,103634877.5,43.36156010353142,1.5,2.75,1.8238830003178528,1.1291023526322015,-0.6530154942695658,-0.9865029748636688,-0.3334874805941028,15.777398673708007,-2.305358948432761,10046856966.0,2014-08-08,2014,4,220,8,1.27,192.16,194.66,193.71,3672
2014-08-11 13:30:00,193.965,194.66,193.71,193.795,190.77814814814812,200.53789473684208,186.45066495000015,191.52657000000016,195.59619799999996,195.625745,194.40683527573373,194.69499241869653,194.5942307692308,199.65111008382928,189.53735145463241,186.45066495000015,191.52657000000016,195.59619799999996,195.625745,194.055,74543691,104429166.1,45.63075812561293,1.5,2.75,1.7950342145808624,0.7138206095471255,-0.4774640523396544,-0.9303175460186708,-0.4528534936790164,15.99277323542656,-1.6019294237116026,10121400657.0,2014-08-11,2014,0,223,8,0.49,194.18,194.15,192.94,3673
2014-08-12 13:30:00,193.61,194.15,192.94,193.53,190.89222222222224,200.6610526315789,186.54256500000017,191.58440000000016,195.60889799999995,195.44074500000005,194.37244957864613,194.58404075977302,194.20038461538468,198.69913394849385,189.7016352822755,186.54256500000017,191.58440000000016,195.60889799999995,195.44074500000005,193.54,73631640,102543436.6,44.70967214221429,1.5,2.75,1.7532460563965155,0.7180531727956542,-0.3551854569909201,-0.8968353149176664,-0.5416498579267464,15.929695367074284,-1.751446847395669,10047769017.0,2014-08-12,2014,1,224,8,0.63,193.54,195.06,193.96,3674
2014-08-13 13:30:00,194.29,195.06,193.96,194.84,191.0062962962963,200.7842105263158,186.63701500000016,191.67080000000016,195.64969799999997,195.284745,194.39078488928746,194.60841783027084,193.97884615384623,198.0231891238676,189.93450318382492,186.63701500000016,191.67080000000016,195.64969799999997,195.284745,194.62,69046544,101992101.7,50.07471445731971,1.5,2.75,1.7372999095110502,0.6769793233900974,-0.17138493582077374,-0.7558810277027135,-0.5844960918819397,16.649420243094227,0.90631311823502,10116815561.0,2014-08-13,2014,2,225,8,0.57,194.51,195.76,194.98,3675
2014-08-14 13:30:00,195.16,195.76,194.98,195.76,191.1203703703704,200.90736842105264,186.73466500000015,191.77410000000012,195.70109799999997,195.28724500000004,194.44447959951145,194.718092322626,193.82192307692318,197.39147279741863,190.25237335642774,186.73466500000015,191.77410000000012,195.70109799999997,195.28724500000004,195.5,57370793,97590718.4,53.48812883165471,1.5,2.75,1.6789213445459743,0.5878714076563248,0.01684294158820432,-0.5634424148966843,-0.5802853564848887,11.728794606517074,1.6935064935064887,10174186354.0,2014-08-14,2014,3,226,8,0.4,195.37,196.65,194.31,3676
2014-08-15 13:30:00,196.47,196.65,194.31,195.72,191.23444444444442,201.03052631578944,186.82741500000014,191.86820000000012,195.72649799999994,195.18775000000005,194.49450000737374,194.81351210142356,193.72730769230782,197.01420151564758,190.44041386896802,186.82741500000014,191.86820000000012,195.72649799999994,195.18775000000005,195.56000000000003,139950669,98371730.9,53.31744411899199,1.5,2.75,1.7261412485069765,1.42267161225685,0.13667523801415982,-0.4094413089671889,-0.5461165469813487,11.445559611646043,0.9438341327556928,10034235685.0,2014-08-15,2014,4,227,8,1.2,195.48,197.45,196.69,3677
2014-08-18 13:30:00,196.8,197.45,196.69,197.36,191.3485185185185,201.1536842105263,186.9327650000002,191.9921000000001,195.76619799999992,195.18875000000003,194.6068725561042,195.05603475843083,193.75653846153855,197.1631957101347,190.34988121294248,186.9327650000002,191.9921000000001,195.76619799999992,195.18875000000003,197.16666666666663,75424360,98763368.0,59.08263182763941,1.5,2.75,1.7264168736136205,0.7636876053072633,0.314258867030091,-0.15329296319373498,-0.467551830223826,11.665360912608893,2.7863132128535093,10109660045.0,2014-08-18,2014,0,230,8,0.39,197.07,198.54,197.4426,3678
2014-08-19 13:30:00,197.84,198.54,197.4426,198.39,191.46259259259259,201.27684210526317,187.0457650000002,192.1302000000001,195.82239799999994,195.1982500000001,194.75523049508053,195.37355525762783,194.16423076923087,198.33671176177185,189.99174977668991,187.0457650000002,192.1302000000001,195.82239799999994,195.1982500000001,198.1242,59134709,98336223.35,62.236939623237326,1.5,2.75,1.6873870969269316,0.6013522482913211,0.4790856507533477,0.1313052332178586,-0.34778041753548905,9.154487465405163,3.2904670172332966,10168794754.0,2014-08-19,2014,1,231,8,0.56,197.99,199.16,198.08,3679
2014-08-20 13:30:00,198.12,199.16,198.08,198.92,191.57666666666668,201.4,187.15931500000016,192.26450000000008,195.88879799999992,195.21225000000007,194.9185547893911,195.71131189975853,194.658076923077,199.40581733860458,189.9103365075494,187.15931500000016,192.26450000000008,195.88879799999992,195.21225000000007,198.72,72762541,98693758.9,63.784044152927656,1.5,2.75,1.6440023042892926,0.7372557475870949,0.5942754336062535,0.3950638744723278,-0.1992115591339257,8.974624138609109,4.1302413233523465,10241557295.0,2014-08-20,2014,2,232,8,0.55,198.62,199.76,198.93,3680
2014-08-21 13:30:00,199.09,199.76,198.93,199.5,191.69074074074075,201.52315789473687,187.27266500000016,192.38940000000008,195.98039799999992,195.25475000000003,195.09821930745417,196.07213933787682,195.08961538461548,200.45880736154945,189.72042340768158,187.27266500000016,192.38940000000008,195.98039799999992,195.25475000000003,199.39666666666668,67790690,99238888.75,65.45210127886197,1.5,2.75,1.5865735682686293,0.6831060973564156,0.6741516764510015,0.6434780364298263,-0.030673640021175255,7.000132722355057,3.2394949285862094,10309347985.0,2014-08-21,2014,3,233,8,0.42,199.34,199.69,198.74,3681
2014-08-22 13:30:00,199.34,199.69,198.74,199.19,191.8048148148148,201.64631578947368,187.38726500000016,192.49880000000007,196.09339799999992,195.32825000000003,195.2586812953972,196.36907844855517,195.64192307692318,201.10664284376548,190.17720331008084,187.38726500000016,192.49880000000007,196.09339799999992,195.32825000000003,199.20666666666668,76107359,99202393.85,63.76170217473104,1.5,2.75,1.541104027678012,0.7671927666894705,0.6693725830812564,0.8060420888303952,0.13666950574913886,6.05994048202355,2.7838695528780466,10233240626.0,2014-08-22,2014,4,234,8,0.48,199.22,200.5949,199.1502,3682
2014-08-25 13:30:00,200.14,200.5949,199.1502,200.2,191.9188888888889,201.76947368421054,187.50241500000016,192.61200000000008,196.21479799999997,195.4482500000001,195.45245849949924,196.7339281201213,196.2673076923077,201.8139859988864,190.7206293857291,187.50241500000016,192.61200000000008,196.21479799999997,195.4482500000001,199.9817,63855022,98932205.7,66.7726658898899,1.5,2.75,1.5342180257010098,0.6454422151835234,0.6944973737125004,1.0047912228897644,0.310293849177264,6.167239533265816,3.4464940836046027,10297095648.0,2014-08-25,2014,0,237,8,0.73,199.87,200.82,200.28,3683
2014-08-26 13:30:00,200.33,200.82,200.28,200.33,192.03296296296296,201.89263157894737,187.6294150000002,192.72900000000007,196.33559799999992,195.61725000000007,195.6437346367738,197.07641115630025,196.98269230769242,202.01829878004227,191.94708583534245,187.6294150000002,192.72900000000007,196.33559799999992,195.61725000000007,200.4766666666667,47298324,97273804.35,67.15099229084157,1.5,2.75,1.4689167381509385,0.4862390683293966,0.6793058123027829,1.1594261145557423,0.4801203022529597,5.706818905290624,2.8176965715458886,10344393972.0,2014-08-26,2014,1,238,8,0.27,200.55,200.57,199.94,3684
2014-08-27 13:30:00,200.43,200.57,199.94,200.25,192.14703703703705,202.0157894736842,187.7442150000002,192.86750000000006,196.44399799999994,195.78075000000007,195.8243724941552,197.3786577128431,197.52192307692314,202.33532989612647,192.70851625771985,187.7442150000002,192.86750000000006,196.44399799999994,195.78075000000007,200.25333333333333,47873708,94456367.15,66.64808245757848,1.5,2.75,1.4089941139972997,0.5068341017601797,0.6246911244859207,1.2609842078603606,0.6362930833744399,5.671377775570824,2.2936248467511287,10296520264.0,2014-08-27,2014,2,239,8,0.32,200.26,200.27,199.39,3685
2014-08-28 13:30:00,199.59,200.27,199.39,200.14,192.26111111111112,202.1389473684211,187.85831500000015,193.02550000000008,196.52169799999996,196.13325000000003,195.99361278850205,197.64164269257233,198.01000000000005,202.48785663013518,193.53214336986488,187.85831500000015,193.02550000000008,196.52169799999996,196.13325000000003,199.9333333333333,58330373,88198913.75,65.91707301151803,1.5,2.75,1.3712088201403514,0.661350242536292,0.5448914496225485,1.3174073954026255,0.772515945780077,5.803610625991466,2.2583282239934537,10238189891.0,2014-08-28,2014,3,240,8,0.44,199.83,200.73,199.82,3686
2014-08-29 13:30:00,200.45,200.73,199.82,200.71,192.37518518518522,202.26210526315793,187.97706500000015,193.1816000000001,196.60629799999992,196.54375000000005,196.17856914973729,197.9338671980416,198.5623076923077,202.4221773899717,194.70243799464376,187.97706500000015,193.1816000000001,196.60629799999992,196.54375000000005,200.42,65906598,82031200.45,67.88287105877376,1.5,2.75,1.338265332987469,0.8034332990186053,0.4956436371738346,1.3920704922473703,0.8964268550735357,5.599610699976723,1.6974057559789189,10304096489.0,2014-08-29,2014,4,241,8,0.46,200.27,200.995,199.86,3687
2014-09-02 13:30:00,200.97,200.995,199.86,200.61,192.4892592592593,202.38526315789474,188.0882150000002,193.3168000000001,196.69969799999996,196.87975000000003,196.35235075170837,198.1887369887043,199.00615384615384,202.34344467244637,195.66886301986142,188.0882150000002,193.3168000000001,196.69969799999996,196.87975000000003,200.48833333333332,72425793,81085465.75,67.15111709337232,1.5,2.75,1.3237463806312206,0.8932031447325072,0.4242392850400676,1.42672596137362,1.0024866763335525,4.4078599803648935,1.1190080145168746,10231670696.0,2014-09-02,2014,1,245,9,0.57,200.43,201.41,200.22,3688
2014-09-03 13:30:00,201.38,201.41,200.22,200.5,192.60333333333332,202.5084210526316,188.1943650000002,193.4902500000001,196.79209799999992,197.30425000000002,196.51500366340602,198.40885727549443,199.37076923076927,202.20803185020642,196.5335066113321,188.1943650000002,193.4902500000001,196.79209799999992,197.30425000000002,200.71,57461742,76324033.9,66.30442642488205,1.5,2.75,1.3141930677289904,0.7528656317522022,0.3410856734206118,1.4288437681093171,1.087758094688705,3.911683482779915,0.7942891614719548,10174208954.0,2014-09-03,2014,2,246,9,0.59,200.82,201.58,199.66,3689
2014-09-04 13:30:00,200.84,201.58,199.66,200.2101,192.71740740740745,202.63157894736844,188.2951655000002,193.67725100000007,196.9022999999999,197.71125500000005,196.659909402096,198.58040420163778,199.71616153846162,201.6367549139912,197.79556816293203,188.2951655000002,193.67725100000007,196.9022999999999,197.71125500000005,200.48336666666668,85236442,75844940.15,64.01364169345607,1.5,2.75,1.357464991462635,1.12382502816175,0.24266870233733795,1.3910939726103777,1.1484252702730398,4.003409562724961,0.35593984962406583,10088972512.0,2014-09-04,2014,3,247,9,0.96,200.62,201.19,199.41,3690
2014-09-05 13:30:00,200.17,201.19,199.41,201.11,192.83148148148152,202.7547368421053,188.4036155000002,193.85895000000008,197.01289999999997,198.21525500000004,196.83442275887657,198.8213180871961,200.00462307692317,201.5031109468816,198.50613520696479,188.4036155000002,193.85895000000008,197.01289999999997,198.21525500000004,200.57,102176784,74167108.3,67.73963256588891,1.5,2.75,1.3876460635010184,1.3776562999692952,0.2152212988439013,1.4174518938279164,1.2022305949840149,4.409260960578972,0.9639038104322586,10191149296.0,2014-09-05,2014,4,248,9,0.89,200.3,201.21,200.0,3691
2014-09-08 13:30:00,200.92,201.21,200.0,200.59,192.94555555555561,202.87789473684208,188.5114155000002,194.02285000000006,197.11589999999995,198.58275500000005,196.98170029774414,198.9897639836536,200.17385384615397,201.37143023619197,198.97627745611595,188.5114155000002,194.02285000000006,197.11589999999995,198.58275500000005,200.6,64145745,71523676.35,63.63926475495805,1.5,2.75,1.3749570589652318,0.8968463070341043,0.14258984992299095,1.3804679073877535,1.2378780574647628,4.644684638023139,0.1948051948052022,10127003551.0,2014-09-08,2014,0,251,9,0.61,200.6,200.55,198.91,3692
2014-09-09 13:30:00,200.41,200.55,198.91,199.32,193.05962962962963,203.00105263157891,188.61566550000015,194.15480000000008,197.18589999999992,198.859005,197.0733983252836,199.02121503282945,200.20462307692318,201.2867469377786,199.12249921606772,188.61566550000015,194.15480000000008,197.18589999999992,198.859005,199.59333333333333,88590876,72226035.6,54.89891518830344,1.5,2.75,1.3967458404677158,1.226578134381226,-0.0027428617153821837,1.2344494803205348,1.2371923420359172,5.295542123246309,-0.5041681225977234,10038412675.0,2014-09-09,2014,1,252,9,0.82,199.73,200.2,198.77,3693
2014-09-10 13:30:00,199.43,200.2,198.77,200.07,193.1737037037037,203.1242105263158,188.71646550000014,194.29160000000007,197.27289999999996,199.186005,197.19091211644897,199.12109931541718,200.2484692307694,201.25649266573362,199.24044579580516,188.71646550000014,194.29160000000007,197.27289999999996,199.186005,199.68,67251103,71907008.75,58.521886310583156,1.5,2.75,1.399121137577163,0.9352510161257404,-0.05710680302418548,1.1658088382556857,1.222915641279871,5.803813982111295,-0.08988764044944161,10105663778.0,2014-09-10,2014,2,253,9,0.72,199.48,200.33,199.12,3694
2014-09-11 13:30:00,199.27,200.33,199.12,200.3,193.28777777777782,203.24736842105264,188.81391550000015,194.42420000000007,197.33829999999992,199.459005,197.31283713149017,199.2333755710917,200.33385384615397,201.13575215781398,199.531955534494,188.81391550000015,194.42420000000007,197.33829999999992,199.459005,199.91666666666663,66823558,71795859.45,59.59384167405522,1.5,2.75,1.3856124848930804,0.930743896819526,-0.08465846104239927,1.1170925649768721,1.2017510260192712,5.845265896243218,0.0799440391725917,10172487336.0,2014-09-11,2014,3,254,9,0.61,199.73,200.12,198.56,3695
2014-09-12 13:30:00,200.1,200.12,198.56,199.13,193.40185185185183,203.37052631578945,188.90641550000015,194.53660000000008,197.37629999999993,199.627505,197.38409842045138,199.2235302786068,200.25154615384633,201.27933855015985,199.22375375753282,188.90641550000015,194.53660000000008,197.37629999999993,199.627505,199.27,117478516,74801245.6,52.202970545536814,1.5,2.75,1.4109258788292895,1.5705422424142093,-0.1831121714813813,0.9728608116675446,1.1559729831489258,6.7566203898250485,-0.7872054207563213,10055008820.0,2014-09-12,2014,4,255,9,0.79,199.34,199.32,198.38,3696
2014-09-15 13:30:00,199.16,199.32,198.38,198.981,193.51592592592598,203.4936842105263,188.9979205000002,194.65191000000007,197.39191999999989,199.790555,197.44672201180626,199.20043215683467,200.1477769230771,201.37582211930751,198.9197317268466,188.9979205000002,194.65191000000007,197.39191999999989,199.790555,198.8936666666667,76401421,71623783.2,51.329899173126876,1.5,2.75,1.3772883160557687,1.0667046278002248,-0.2552696241520136,0.8368859529589088,1.0921555771109224,6.411427881210157,-0.8120233288470261,9978607399.0,2014-09-15,2014,0,258,9,0.47,198.85,200.84,198.5,3697
2014-09-16 13:30:00,198.61,200.84,198.5,200.48,193.63,203.61684210526317,189.0947205000002,194.77841000000006,197.4513199999999,199.946555,197.5656740897746,199.3222957609457,200.16546923076942,201.40546453442752,198.9254739271113,189.0947205000002,194.77841000000006,197.4513199999999,199.946555,199.94000000000003,116200722,73662601.3,58.7960015593861,1.5,2.75,1.4460534363375,1.5774724208660278,-0.2014091579124111,0.8403941297204085,1.0418032876328196,8.018228272808939,-0.009975062344144754,10094808121.0,2014-09-16,2014,1,259,9,1.18,199.67,201.68,199.75,3698
2014-09-17 13:30:00,200.77,201.68,199.75,200.75,193.7440740740741,203.74,189.1934705000002,194.9230100000001,197.54151999999988,200.064555,197.69054961566582,199.45826759323657,200.21239230769245,201.4905600599104,198.93422455547454,189.1934705000002,194.9230100000001,197.54151999999988,200.064555,200.7266666666667,151265896,78269160.65,59.986649668469724,1.5,2.75,1.4806210480276791,1.9326372576859876,-0.14935941273328335,0.8551040217162154,1.0044634344494987,8.049967942629031,0.26966671511576523,10246074017.0,2014-09-17,2014,2,260,9,0.97,200.72,201.85,201.1,3699
2014-09-18 13:30:00,201.36,201.85,201.1,201.82,193.85814814814816,203.86315789473687,189.29992050000016,195.07246000000006,197.63551999999984,200.209555,197.852488846424,199.68319448911882,200.29777692307712,201.8221006079472,198.77345323820703,189.29992050000016,195.07246000000006,197.63551999999984,200.209555,201.59,94990300,79380548.6,64.37952130472421,1.5,2.75,1.4534338303114158,1.1966445391887857,-0.04977857471772662,0.9422402160523404,0.9920187907700669,8.489263304997932,0.353040624533827,10341064317.0,2014-09-18,2014,3,261,9,0.37,201.48,201.899,200.29,3700
2014-09-19 13:30:00,201.52,201.899,200.29,200.7,193.97222222222226,201.899,189.40467050000015,195.20196000000007,197.7227199999999,200.269555,197.9641559504858,199.78003310920272,200.30470000000014,201.83543696075782,198.7739630392425,189.40467050000015,195.20196000000007,197.7227199999999,200.269555,200.963,121649147,82073471.45,57.28964503356946,1.5,2.75,1.464545699574887,1.4821981433319766,-0.06527358894061808,0.9104268045942944,0.9757003935349126,8.844165578904581,0.054838227229665096,10219415170.0,2014-09-19,2014,4,262,9,0.8,201.09,200.38,198.73,3701
2014-09-22 13:30:00,200.35,200.38,198.73,199.15,194.08629629629638,201.969975,189.50177050000016,195.3103600000001,197.77351999999985,200.267555,198.01065963870204,199.7200299559453,200.200853846154,201.84357705727317,198.55813063503481,189.50177050000016,195.3103600000001,197.77351999999985,200.267555,199.42,125552758,84545741.4,49.21239106552086,1.5,2.75,1.5006495781766804,1.4850275829504995,-0.17937646743587665,0.7514798092400667,0.9308562766759434,9.796405442182957,-0.08528998595223132,10093862412.0,2014-09-22,2014,0,265,9,0.83,199.56,199.26,197.95,3702
2014-09-23 13:30:00,198.43,199.26,197.95,198.01,194.2003703703704,202.04095,189.59712050000016,195.40721000000005,197.78171999999984,200.158055,198.01063377051761,199.55716996014095,200.03161538461552,202.04676318041854,198.01646758881247,189.59712050000016,195.40721000000005,197.78171999999984,200.158055,198.40666666666667,111393319,86922656.25,44.26879329816746,1.5,2.75,1.4870317511640605,1.2815222613494397,-0.3227293060498401,0.5274446441136433,0.8501739501634834,9.673769405338637,-1.0296396261308554,9982469093.0,2014-09-23,2014,1,266,9,0.66,198.6,199.69,197.52,3703
2014-09-24 13:30:00,198.04,199.69,197.52,199.56,194.31444444444446,202.111925,189.69022050000012,195.5222100000001,197.82831999999985,200.119555,198.07139323049734,199.5574394877466,199.91238461538475,201.83970775516048,197.98506147560903,189.69022050000012,195.5222100000001,197.82831999999985,200.119555,198.9233333333333,107275635,89921521.8,51.4150978946663,1.5,2.75,1.5358151975094838,1.1929917649592092,-0.3044955792813906,0.4695544760617452,0.7740500553431358,10.581797275716195,-0.3694458312531249,10089744728.0,2014-09-24,2014,2,267,9,1.1,198.6,199.05,196.27,3704
2014-09-25 13:30:00,199.04,199.05,196.27,196.34,194.42851851851853,202.1829,189.7649205000001,195.60141000000007,197.79591999999985,199.924055,198.00349545675235,199.25101667938975,199.5854615384617,202.2448838719449,196.92603920497842,189.7649205000001,195.60141000000007,197.79591999999985,199.924055,197.22000000000003,150300028,95042837.8,39.95346727543228,1.5,2.75,1.6611141119730917,1.5813924697437851,-0.4896546152621998,0.16198178626538606,0.6516364015275858,13.91984864173871,-1.401094762215634,9939444700.0,2014-09-25,2014,3,268,9,1.42,197.66,198.39,196.42,3705
2014-09-26 13:30:00,196.7,198.39,196.42,197.9,194.54259259259257,202.253875,189.85067050000006,195.71261000000007,197.83971999999986,199.81205500000002,197.9994368113895,199.12234842420983,199.47623076923088,202.28286665898628,196.66959487947548,189.85067050000006,195.71261000000007,197.83971999999986,199.81205500000002,197.57,103546740,97303656.15,46.209702863681144,1.5,2.75,1.688891675403584,1.0641608352349663,-0.4864254969711536,0.04360453031364386,0.5300300272847974,14.739346211963987,-0.5432679502062955,10042991440.0,2014-09-26,2014,4,269,9,1.0,197.4,197.89,196.05,3706
2014-09-29 13:30:00,196.2,197.89,196.05,197.54,194.65666666666667,202.32485,189.9447705000001,195.80921000000006,197.83632199999988,199.653555,197.9814196815311,198.9716485742851,199.28161538461552,202.2431621258475,196.32006864338348,189.9447705000001,195.80921000000006,197.83632199999988,199.653555,197.16,95111605,98763906.5,45.04338018860158,1.5,2.75,1.700399412874756,0.9630198760920824,-0.4867088614127645,-0.07835604948115815,0.4083528119316063,14.75557211611655,-1.4664804469273731,9947879835.0,2014-09-29,2014,0,272,9,0.94,196.97,198.3,196.61,3707
2014-09-30 13:30:00,197.69,198.3,196.61,197.02,194.77074074074082,202.395825,190.03922050000008,195.90266000000008,197.82992199999993,199.474055,197.94371694892203,198.785777281496,199.02930769230773,202.15514024695756,195.90347513765803,190.03922050000008,195.90266000000008,197.82992199999993,199.474055,197.31000000000003,131302082,101707720.95,43.3417035124759,1.5,2.75,1.699656597669416,1.2909745766946124,-0.4982804458154641,-0.2144977453377237,0.28378270047774035,13.804676276112106,-1.8580323785803188,9816577753.0,2014-09-30,2014,1,273,9,0.86,197.46,196.77,193.91,3708
2014-10-01 13:30:00,196.7,196.77,193.91,194.35,194.88481481481483,202.4668,190.12042050000008,195.96656000000007,197.75292199999993,199.166555,197.8027868724937,198.363322302306,198.66161538461543,202.65712852492612,194.6661022443048,190.12042050000008,195.96656000000007,197.75292199999993,199.166555,195.01,177797862,107724526.95,35.8521792407293,1.5,2.75,1.8003954121216017,1.6504863565799115,-0.6523929615052653,-0.5317085014038412,0.12068446010142404,15.185806501901606,-3.701318006144089,9638779891.0,2014-10-01,2014,2,274,10,1.47,195.34,195.055,192.35,3709
2014-10-02 13:30:00,194.18,195.055,192.35,194.38,194.9988888888889,202.537775,190.19624050000007,196.01251000000008,197.66772199999988,198.87505,197.66855993631748,197.9839582735149,198.3076923076924,202.89815837316345,193.7172262422213,190.19624050000007,196.01251000000008,197.66772199999988,198.87505,193.9283333333333,157285182,111326963.95,35.98602903280856,1.5,2.75,1.8650100255414879,1.412821983276586,-0.7139739108852678,-0.7717829285051607,-0.057809017619892926,14.391762472310056,-3.1489785749875403,9796065073.0,2014-10-02,2014,3,275,10,1.41,193.7,196.94,195.08,3710
2014-10-03 13:30:00,195.68,196.94,195.08,196.52,195.11296296296294,202.60875,190.28559050000007,196.07811000000007,197.62512199999992,198.64555,197.6235183701874,197.84453367603734,198.003076923077,202.50114067482681,193.50501317132716,190.28559050000007,196.07811000000007,197.62512199999992,198.64555,196.18,121568769,112296563.2,44.82945018314232,1.5,2.75,1.914652166574239,1.0825689187253773,-0.578047130392175,-0.7803679306101117,-0.2023208002179367,16.580240459116823,-1.3206126035651495,9917633842.0,2014-10-03,2014,4,276,10,0.95,196.01,197.6,195.582,3711
2014-10-06 13:30:00,197.34,197.6,195.582,196.29,195.22703703703704,202.679725,190.3585405000001,196.15041000000008,197.59652199999996,198.43055000000004,197.57122353214083,197.696482849748,197.66000000000003,201.94287466365745,193.37712533634263,190.3585405000001,196.15041000000008,197.59652199999996,198.43055000000004,196.49066666666667,104778335,114328192.7,44.12391556127334,1.5,2.75,1.9220341546760795,0.9164697921442784,-0.4753822145278007,-0.7965485683776876,-0.3211663538498869,16.186317026251068,-0.8686429978283919,9812855507.0,2014-10-06,2014,0,279,10,1.03,196.59,195.72,193.22,3712
2014-10-07 13:30:00,195.28,195.72,193.22,193.26,195.34111111111113,202.7507,190.41739050000007,196.20901000000006,197.505722,198.12755000000004,197.40215594264512,197.27396067358157,197.00153846153853,201.15374896571944,192.8493279573576,190.41739050000007,196.20901000000006,197.505722,198.12755000000004,194.0666666666667,147913498,117294323.8,36.070099085786936,1.5,2.75,2.0040317150563594,1.261045660250441,-0.576553022021269,-1.0418576313764731,-0.4653046093552041,18.011660453600086,-3.1569452796151585,9664942009.0,2014-10-07,2014,1,280,10,1.29,194.47,196.92,192.36,3713
2014-10-08 13:30:00,193.37,196.92,192.36,196.64,195.4551851851852,202.821675,190.49279050000013,196.29491000000007,197.49952199999996,197.95605000000003,197.3722674743061,197.21358346657377,196.68923076923085,200.25042729710134,193.1280342413604,190.49279050000013,196.29491000000007,197.49952199999996,197.95605000000003,195.30666666666664,186461453,123254841.3,47.567224890366155,1.5,2.75,2.186600878266617,1.5128124058523291,-0.3897952650225052,-0.9525486906333356,-0.5627534256108304,20.62864104395828,0.15279616990933226,9851403462.0,2014-10-08,2014,2,281,10,2.37,194.64,196.6,192.58,3714
2014-10-09 13:30:00,196.33,196.6,192.58,192.74,195.5692592592593,202.89265,190.54384050000007,196.33491000000006,197.41472199999995,197.57805,197.1906099262941,196.78752789832862,196.19615384615392,200.02307499034447,192.3692327019633,190.54384050000007,196.33491000000006,197.41472199999995,197.57805,193.97333333333336,210704601,130448893.45,38.878969350063045,1.5,2.75,2.3204151012475718,1.6152272006873047,-0.49606378246382293,-1.1828331536906092,-0.6867693712267862,21.69933171039013,-2.607377463365334,9640698861.0,2014-10-09,2014,3,282,10,2.09,194.59,193.65,190.49,3715
2014-10-10 13:30:00,192.69,193.65,190.49,190.54,195.6833333333333,202.963625,190.58189050000013,196.36481000000006,197.36372199999997,197.14855000000003,196.92980169389043,196.1925252413449,195.62153846153853,200.32855349578875,190.91452342728832,190.58189050000013,196.36481000000006,197.36372199999997,197.14855000000003,191.56,221908954,135670415.35,34.99582315613033,1.5,2.75,2.380385451158459,1.6356473401185032,-0.6708040623835714,-1.5252744492062504,-0.8544703868226791,21.35826737011513,-3.5435861091424523,9418789907.0,2014-10-10,2014,4,283,10,1.66,192.07,191.15,187.3,3716
2014-10-13 13:30:00,190.46,191.15,187.3,187.4099,195.79740740740746,203.0346,190.59966500000007,196.34760900000006,197.26191999999998,196.569995,196.55647221569862,195.35608474216926,194.68691538461547,200.57224871462398,188.801582054607,190.59966500000007,196.34760900000006,197.26191999999998,196.569995,188.61996666666667,230938833,143397285.95,30.351064614312822,1.5,2.75,2.4853579189328547,1.6104825936560905,-0.9371288532572556,-2.0258814533942484,-1.088752600136993,22.503004062557167,-4.877728149426463,9187851074.0,2014-10-13,2014,0,286,10,2.06,189.23,189.82,187.04,3717
2014-10-14 13:30:00,188.42,189.82,187.04,187.7,195.9114814814815,203.105575,190.61894000000007,196.3287090000001,197.13812,195.930995,196.20915957978886,194.6269338143436,194.0223000000001,200.8816059357424,187.1629940642577,190.61894000000007,196.3287090000001,197.13812,195.930995,188.1866666666666,215846527,148379576.2,31.261649080549237,1.5,2.75,2.5064037818662217,1.4546916262185683,-1.0264907756841404,-2.3718660697421683,-1.3453752940580281,22.806959738305892,-3.421661950090047,9403697601.0,2014-10-14,2014,1,287,10,1.49,188.43,187.69400000000002,181.92,3718
2014-10-15 13:30:00,185.16,187.69400000000002,181.92,186.43,181.92,203.17655,190.6319900000001,196.28950900000007,197.02652,195.214995,195.82566312567948,193.84627345107282,193.13999230769238,200.69286534250068,185.587119272884,190.6319900000001,196.28950900000007,197.02652,195.214995,185.348,380714600,159852011.4,29.44662671325993,1.5,2.75,2.7402320831614917,2.3816691242460024,-1.0974736580782651,-2.7172173666558592,-1.6197437085775939,22.171236696597685,-4.089926947216786,9022983001.0,2014-10-15,2014,2,288,10,3.17,184.81,187.58,182.89,3719
2014-10-16 13:30:00,183.06,187.58,182.89,186.27,181.74020833333333,203.247525,190.63989000000004,196.23700900000009,196.91052,194.437495,195.45093123839797,193.1247235985897,192.27306923076927,200.18538970238674,184.3607487591518,190.63989000000004,196.23700900000009,196.91052,194.437495,185.58,270391490,168622070.9,29.216483072363488,1.5,2.75,2.8795012200785304,1.6035355784495942,-1.0798769029518158,-2.9695898372673635,-1.8897129343155483,22.10679052395444,-5.215754121717891,8752591511.0,2014-10-16,2014,3,289,10,2.56,185.24,189.75,187.62,3720
2014-10-17 13:30:00,188.42,189.75,187.62,188.47,181.56041666666664,203.3185,190.66764000000006,196.2079090000001,196.85932,193.825995,195.17716922904899,192.68141658920018,191.6153769230769,199.25680981656743,183.97394402958648,190.66764000000006,196.2079090000001,196.85932,193.825995,188.61333333333332,214624921,173270859.6,36.55863442021114,1.5,2.75,2.9223939900729197,1.2386671451591276,-0.8546116535730839,-2.9579775012819027,-2.1033658477088193,22.30953524319942,-3.9839013704213118,8967216432.0,2014-10-17,2014,4,290,10,1.14,188.68,190.45,188.07,3721
2014-10-20 13:30:00,188.13,190.45,188.07,190.3,181.380625,203.389475,190.70471500000008,196.18720900000008,196.80051999999995,193.383495,194.9859076906549,192.45461500927638,191.3038384615385,198.80281657594762,183.80486034712936,190.70471500000008,196.18720900000008,196.80051999999995,193.383495,189.60666666666665,130010813,173493762.35,41.95236009879742,1.5,2.75,2.8836515622105687,0.7493688028836503,-0.5326572945937729,-2.7691874659510347,-2.236530171357262,23.666228305041994,-1.5316154403394286,9097227245.0,2014-10-20,2014,0,293,10,1.27,189.26,194.2,191.48,3722
2014-10-21 13:30:00,191.68,194.2,191.48,194.07,181.2008333333333,203.46045,190.76326500000008,196.2011090000001,196.80602,193.186495,194.9499897420018,192.6084611988691,191.27999230769237,198.741569249902,183.81841536548268,190.76326500000008,196.2011090000001,196.80602,193.186495,193.25,154948579,175671525.35,51.163900225853844,1.5,2.75,2.9562478791955265,0.8820358261891759,-0.04195715287207591,-2.2889766124473567,-2.247019459575281,25.429085823270587,-1.30695687550854,9252175824.0,2014-10-21,2014,1,294,10,1.42,192.84,194.91,192.61,3723
2014-10-22 13:30:00,194.41,194.91,192.61,192.69,181.02104166666663,203.531425,190.80931500000003,196.19905900000006,196.78921999999997,192.84299500000003,194.86136269329586,192.6162267989768,190.98537692307698,197.876759237542,184.09399460861198,190.80931500000003,196.19905900000006,196.78921999999997,192.84299500000003,193.4033333333333,151822409,177898864.05,48.15171378115901,1.5,2.75,2.9093730306815595,0.8534197776402271,0.200220924228367,-1.9967433042898224,-2.1969642285181887,23.261803510179323,-0.025941683096405196,9100353415.0,2014-10-22,2014,2,295,10,1.19,193.76,196.2,194.26,3724
2014-10-23 13:30:00,194.62,196.2,194.26,194.93,180.84125,203.6024,190.8663650000001,196.2203590000001,196.79101999999997,192.772495,194.86405435238228,192.83658615145518,190.8807615384616,197.48204314995303,184.2794799269701,190.8663650000001,196.2203590000001,196.79101999999997,192.772495,195.13,154944169,178131071.1,52.98970219691293,1.5,2.75,2.9522749570614475,0.8698323545869029,0.5044984099478986,-1.566341216083316,-2.0708396260312147,21.301747660775394,2.3039781673139577,9255297584.0,2014-10-23,2014,3,296,10,1.0,195.23,196.49,194.49,3725
2014-10-24 13:30:00,195.25,196.49,194.49,196.43,180.6614583333333,203.673375,190.93031500000006,196.25275900000008,196.80442,192.698995,194.92546398562217,193.17881604179283,191.1246076923077,198.2711026053022,183.97811277931328,190.93031500000006,196.25275900000008,196.80442,192.698995,195.80333333333337,117927286,178850098.4,55.9536353989415,1.5,2.75,2.8842553172713434,0.659363830688281,0.7833729481774063,-1.0916234408094567,-1.8749963889868628,19.94840637560873,4.813032822705745,9373224870.0,2014-10-24,2014,4,297,10,1.03,195.49,196.45,195.03,3726
2014-10-27 13:30:00,195.73,196.45,195.03,196.16,180.48166666666665,203.74435,190.99041500000007,196.26985900000008,196.81322,192.629995,194.97387716265663,193.4627383235268,191.08768461538463,198.1239241337076,184.0514450970617,190.99041500000007,196.26985900000008,196.81322,192.629995,195.88,82953689,178242202.6,55.278042227717364,1.5,2.75,2.7796656517519613,0.4653986978951303,0.9169636165785088,-0.7287918682637269,-1.6457554848422358,16.009724240586245,4.507192328183277,9290271181.0,2014-10-27,2014,0,300,10,0.73,195.74,198.42,196.73,3727
2014-10-28 13:30:00,196.82,198.42,196.73,198.41,180.301875,203.815325,191.0740400000001,196.30020900000008,196.83422,192.699495,195.10862707784656,193.93390610223855,191.52383846153847,199.54911258523063,183.4985643378463,191.0740400000001,196.30020900000008,196.83422,192.699495,197.8533333333333,106735936,177013895.3,59.65025396197977,1.5,2.75,2.7425466766268203,0.6029805503071147,1.1112206936574087,-0.2567296177704748,-1.3679503114278837,16.325686719911953,6.426004398433722,9397007117.0,2014-10-28,2014,1,301,10,0.86,197.58,199.12,196.8,3728
2014-10-29 13:30:00,198.55,199.12,196.8,198.11,180.1220833333333,203.8863,191.14624000000012,196.32550900000007,196.82862,192.887495,195.22632797675453,194.3316293305968,192.10614615384617,200.82955139814376,183.38274090954857,191.14624000000012,196.32550900000007,196.82862,192.887495,198.01,142557417,175251873.05,58.824478668133814,1.5,2.75,2.7123647711534757,0.8134430435406977,1.1680512839441068,0.09211379350225002,-1.0759374904418568,15.104711124038381,6.356364417243787,9254449700.0,2014-10-29,2014,2,302,10,1.18,197.96,199.95,197.4,3729
2014-10-30 13:30:00,197.58,199.95,197.4,199.38,179.94229166666665,203.957275,191.2198400000001,196.3633090000001,196.83782,193.137495,195.3892170757053,194.81242653720662,193.0269230769231,202.093349341292,183.96049681255425,191.2198400000001,196.3633090000001,196.83782,193.137495,198.91,113329976,173054112.75,61.26890266974304,1.5,2.75,2.7007672874996547,0.6548817257161662,1.2332979682971297,0.4656849699295549,-0.7676129983675745,14.446958283812961,5.788719690136359,9367779676.0,2014-10-30,2014,3,303,10,1.29,198.68,201.82,200.77,3730
2014-10-31 13:30:00,201.78,201.82,200.77,201.66,179.7625,204.02825,191.3060400000001,196.43070900000006,196.88101999999995,193.394495,195.63513013156003,195.464576390806,194.10076923076926,203.6814114496186,184.52012701191998,191.3060400000001,196.43070900000006,196.88101999999995,193.394495,201.41666666666663,146902554,174320802.0,65.2566277662055,1.5,2.75,2.6821410526782508,0.8427138489186161,1.3620442632708485,0.934942330720986,-0.4271019325498623,14.402143270469944,5.9695218076720895,9514682230.0,2014-10-31,2014,4,304,10,0.52,201.3,202.45,201.305,3731
2014-11-03 14:30:00,201.92,202.45,201.305,201.77,179.58270833333333,204.099225,191.39671500000009,196.51300900000007,196.93262,193.668495,195.8757132636557,196.06509292501497,195.28076923076927,204.56580255257708,185.99573590896145,191.39671500000009,196.51300900000007,196.93262,193.668495,201.84166666666667,93734143,173768592.4,65.44149624281708,1.5,2.75,2.572345263201232,0.5394193605725496,1.3822530855905049,1.300714424438269,-0.08153866115223607,14.677812034857425,3.967640542072457,9608416373.0,2014-11-03,2014,0,307,11,0.57,201.88,201.6,200.06,3732
2014-11-04 14:30:00,201.23,201.6,200.06,201.07,179.40291666666664,204.1702,191.4811650000001,196.58240900000013,196.95001999999997,194.05899499999998,196.07941078272805,196.54175074168018,196.41923076923084,204.5652159494481,188.27324558901358,191.4811650000001,196.58240900000013,196.95001999999997,194.05899499999998,200.91,93342777,171040056.35,63.13910383325279,1.5,2.75,2.5107491729725733,0.5457363555177523,1.2785306008359263,1.5166245898926718,0.2380939890567456,12.592857831420428,4.348954278893556,9515073596.0,2014-11-04,2014,1,308,11,0.77,200.83,202.59,201.45,3733
2014-11-05 14:30:00,202.54,202.59,201.45,202.34,179.22312499999995,204.241175,191.57136500000007,196.66290900000007,196.99021999999997,194.343995,196.32492408536612,197.09396495675827,197.486153846154,204.77634763259346,190.1959600597144,191.57136500000007,196.66290900000007,196.99021999999997,194.343995,202.1266666666667,91708574,166302412.4,65.50998543497113,1.5,2.75,2.439981374903104,0.5514566666622811,1.2253744456610811,1.7698120461330973,0.544437600472016,10.636272837766823,3.8013645924177886,9606782170.0,2014-11-05,2014,2,309,11,0.57,202.02,203.26,201.64,3734
2014-11-06 14:30:00,202.39,203.26,201.64,203.15,179.04333333333332,204.31215,191.67316500000007,196.74610900000008,197.04821999999996,194.86449500000003,196.59257412123412,197.67073019897174,198.47461538461545,205.048786828801,191.90044394042988,191.67316500000007,196.74610900000008,197.04821999999996,194.86449500000003,202.6833333333333,107089076,161121636.15,66.96923183940143,1.5,2.75,2.38141127669574,0.6646473965811946,1.174549818139297,2.0126248731461374,0.8380750550068403,9.75134378659288,3.4210660286107,9713871246.0,2014-11-06,2014,3,310,11,0.8,202.45,203.5999,202.61,3735
2014-11-07 14:30:00,203.17,203.5999,202.61,203.34,178.86354166666663,204.383125,191.79541500000008,196.81695900000008,197.11221999999995,195.50449500000005,196.85717905765637,198.21066065621255,199.1876923076924,205.70690015880302,192.6684844565817,191.79541500000008,196.81695900000008,197.11221999999995,195.50449500000005,203.1833,89539712,154503174.05,67.31852506904964,1.5,2.75,2.2820176140746136,0.5795331555520233,1.0856068697501993,2.1950836421945894,1.10947677244439,9.622928865278036,3.660277324632956,9803410958.0,2014-11-07,2014,4,311,11,0.49,203.1,204.04,203.13,3736
2014-11-10 14:30:00,203.38,204.04,203.13,203.98,178.68374999999997,204.4541,191.92526500000008,196.89195900000007,197.17762,196.33300000000003,197.13650536912084,198.7601215460971,200.0561538461539,205.8491604441005,194.26314724820733,191.92526500000008,196.89195900000007,197.17762,196.33300000000003,203.71666666666667,66318964,146272180.6,68.52588317698178,1.5,2.75,2.1840163559264267,0.4533942389315826,1.003678263707961,2.364074602079341,1.3603963383713804,9.13054914015385,2.8073181795272384,9869729922.0,2014-11-10,2014,0,314,11,0.45,203.58,204.31,203.65,3737
2014-11-11 14:30:00,204.055,204.31,203.65,204.175,178.50395833333332,204.525075,192.05079000000006,196.9743090000001,197.2489199999999,197.15675,197.41252476641014,199.27582425599257,200.76730769230775,206.12179770664295,195.41281767797255,192.05079000000006,196.9743090000001,197.2489199999999,197.15675,204.045,54499375,138204823.0,68.90284248275525,1.5,2.75,2.0751580447888247,0.3943377214845824,0.8997544982825899,2.4850894612246184,1.5853349629420281,7.877647319796798,3.0614305183988684,9924229297.0,2014-11-11,2014,1,315,11,0.32,203.98,204.24,203.31,3738
2014-11-12 14:30:00,203.35,204.24,203.31,203.96,178.32416666666663,204.59605,192.1838400000001,197.05510900000007,197.31811999999994,198.03325,197.66928850106075,199.72193623161235,201.3465384615386,206.31408759352368,196.37898932955346,192.1838400000001,197.05510900000007,197.31811999999994,198.03325,203.83666666666664,90120295,123675107.75,67.93671597540714,1.5,2.75,1.9933610415896232,0.728685801367333,0.7592764839139363,2.5344305678344483,1.775154083920512,7.78833128840528,2.2971210753335405,9834109002.0,2014-11-12,2014,2,316,11,0.46,203.78,204.83,203.21,3739
2014-11-13 14:30:00,204.16,204.83,203.21,204.19,178.14437499999997,204.667025,192.30864000000008,197.15000900000007,197.3977179999999,198.92925,197.9250026774897,200.147466114316,201.9642307692309,206.1309041262241,197.7975574122377,192.30864000000008,197.15000900000007,197.3977179999999,198.92925,204.07666666666668,85357918,114423429.15,68.44642172858494,1.5,2.75,1.9666923957617928,0.7459828693658758,0.6299193798294254,2.562553308707294,1.9326339288778684,7.509150091996283,1.2545869284935045,9919466920.0,2014-11-13,2014,3,317,11,0.8,204.02,204.49,203.72,3740
2014-11-14 14:30:00,204.1,204.49,203.72,204.24,177.9645833333333,204.738,192.4389400000001,197.23660900000007,197.46031799999992,199.71775000000005,198.1726496313137,200.53723124628587,202.41269230769242,206.1893750510972,198.6360095642877,192.4389400000001,197.23660900000007,197.46031799999992,199.71775000000005,204.15,80417514,107713058.8,68.56341845206236,1.5,2.75,1.8812143674930943,0.7465901989592371,0.5013908668383644,2.559372512425824,2.05798164558746,4.905249425273821,1.2241661297516968,9999884434.0,2014-11-14,2014,4,318,11,0.38,204.1,204.58,203.65,3741
2014-11-17 14:30:00,203.85,204.58,203.65,204.37,177.78479166666665,204.808975,192.58994000000007,197.32590900000002,197.53591799999992,200.42125000000004,198.4156829791053,200.90225684187766,202.89423076923092,205.8637835616484,199.9246779768134,192.58994000000007,197.32590900000002,197.53591799999992,200.42125000000004,204.2,80440954,105234565.85,68.88644097599321,1.5,2.75,1.8132704841007308,0.7643966918118853,0.3840820176254289,2.538084167619246,2.154002149993817,4.900609902392893,1.6412194758044518,10080325388.0,2014-11-17,2014,0,321,11,0.46,204.12,205.92,204.44,3742
2014-11-18 14:30:00,204.44,205.92,204.44,205.55,177.60499999999996,204.87995,192.74076500000007,197.42320900000007,197.6605179999999,200.99525000000008,198.6954601171796,201.34489904741315,203.36884615384628,205.8763246723355,200.86136763535703,192.74076500000007,197.42320900000007,197.6605179999999,200.99525000000008,205.30333333333337,76068107,101290542.25,71.72633978017058,1.5,2.75,1.794465449522106,0.7509892366086134,0.3460881064256096,2.586612283025829,2.2405241766002195,4.468234023690608,1.58643866758921,10156393495.0,2014-11-18,2014,1,322,11,0.72,205.18,205.55,204.3,3743
2014-11-19 14:30:00,205.31,205.55,204.3,205.22,177.42520833333333,204.950925,192.89101500000007,197.51820900000007,197.76351799999992,201.62175000000005,198.9513244263098,201.71395628099282,203.6426923076924,206.12127321491775,201.16411140046702,192.89101500000007,197.51820900000007,197.76351799999992,201.62175000000005,205.0233333333333,82373009,97818072.25,69.80735740262928,1.5,2.75,1.7555750602705267,0.8421041951171758,0.2626454882281437,2.568831036885399,2.306185548657256,4.107414811374571,1.018951513659854,10074020486.0,2014-11-19,2014,2,323,11,0.61,204.92,205.71,204.18,3744
2014-11-20 14:30:00,204.26,205.71,204.18,205.58,177.24541666666664,205.0219,193.03151500000007,197.60370900000007,197.86911799999993,202.15425000000008,199.21127248802318,202.08215092089827,203.93576923076927,206.3597197448497,201.5118187166889,193.03151500000007,197.60370900000007,197.86911799999993,202.15425000000008,205.15666666666667,72840326,93712880.1,70.72743887026797,1.5,2.75,1.7394625559654897,0.7772712344586239,0.19852626673941695,2.5543433820815267,2.3558171153421097,3.7810387135271877,1.101603226123738,10146860812.0,2014-11-20,2014,3,324,11,0.75,204.94,207.8445,205.98,3745
2014-11-21 14:30:00,207.64,207.8445,205.98,206.68,177.06562499999995,205.092875,193.1665150000001,197.69820900000008,198.02011799999997,202.66675000000006,199.50416376300262,202.5200413093841,204.36730769230775,206.58560438949814,202.14901099511738,193.1665150000001,197.69820900000008,198.02011799999997,202.66675000000006,206.8348333333333,142327285,94932880.05,73.39527304176895,1.5,2.75,1.776965230539383,1.4992411999408208,0.19665240119919325,2.6016326168411013,2.4049802156419084,4.454638491699862,1.3236591822727803,10289188097.0,2014-11-21,2014,4,325,11,0.91,206.91,207.39,206.91,3746
2014-11-24 14:30:00,207.17,207.39,206.91,207.26,176.88583333333332,205.16385,193.30276500000008,197.78880900000007,198.18569799999997,203.22175000000007,199.80831420366925,202.97146594658562,204.74576923076927,207.12441734765733,202.36712111388118,193.30276500000008,197.78880900000007,198.18569799999997,203.22175000000007,207.18666666666664,65880759,94079233.55,74.70434646360695,1.5,2.75,1.700753428357997,0.7002688745862982,0.20025755421635694,2.655302158412354,2.455044604195997,4.416565268672462,1.510958736378097,10355068856.0,2014-11-24,2014,0,328,11,0.23,207.15,207.79,206.8,3747
2014-11-25 14:30:00,207.54,207.79,206.8,207.11,176.70604166666664,205.234825,193.4284150000001,197.88480900000008,198.318298,203.65675000000005,200.0946548231332,203.36561204691085,205.05038461538467,207.545007946115,202.55576128465438,193.4284150000001,197.88480900000008,198.318298,203.65675000000005,207.23333333333332,79108301,92697851.8,73.69442458585759,1.5,2.75,1.6499853263324245,0.8533995067186659,0.16006453977981305,2.655125278920764,2.4950607391409507,4.606186439349394,1.5444204746028658,10275960555.0,2014-11-25,2014,1,329,11,0.48,207.3,207.76,207.03,3748
2014-11-26 14:30:00,207.29,207.76,207.03,207.64,176.52624999999995,205.3058,193.55626500000008,197.99880900000008,198.45609799999997,204.1332500000001,200.39055071242203,203.7726966138717,205.38115384615384,208.0172119576202,202.74509573468757,193.55626500000008,197.99880900000008,198.45609799999997,204.1332500000001,207.47666666666663,62167832,88678372.55,74.98141115164873,1.5,2.75,1.5842720887372506,0.7010484091253206,0.13755785865945658,2.6670080624652712,2.529450203805814,4.354295376060882,1.6896028209020957,10338128387.0,2014-11-26,2014,2,330,11,0.35,207.4,207.87,206.91,3749
2014-11-28 14:30:00,207.49,207.87,206.91,207.2,176.34645833333332,205.376775,193.67721500000007,198.09960900000007,198.563698,204.52425000000008,200.6575879393859,204.0991064601696,205.62884615384613,208.2966604532796,202.96103185441277,193.67721500000007,198.09960900000007,198.563698,204.52425000000008,207.32666666666668,57890088,85906378.15,71.8391042016862,1.5,2.75,1.5396812252560188,0.6738741551752871,0.06509980994724797,2.610824966239875,2.545725156292627,4.89835760856247,1.4492753623188306,10280238299.0,2014-11-28,2014,4,332,11,0.46,207.39,206.54,205.38,3750
2014-12-01 14:30:00,206.4,206.54,205.38,205.76,176.16666666666663,205.44775,193.78591500000007,198.19380900000007,198.664898,204.72925000000006,200.85768252999816,204.25728679729636,205.75076923076924,208.28310122433524,203.21843723720326,193.78591500000007,198.19380900000007,198.664898,204.72925000000006,205.8933333333333,103968354,83759668.15,62.59380727551707,1.5,2.75,1.5597039948805882,1.2412698891524918,-0.0988344570608839,2.4221820849665217,2.521016542027406,6.894509620371839,0.6801389636443638,10176269945.0,2014-12-01,2014,0,335,12,0.56,205.96,207.34,205.782,3751
2014-12-02 14:30:00,205.81,207.34,205.782,207.085,175.98687499999997,205.518725,193.90014000000008,198.29855900000007,198.82359799999998,204.9950000000001,201.1018910582336,204.52659281660144,205.99115384615382,208.38752338828135,203.5947843040263,193.90014000000008,198.29855900000007,198.82359799999998,204.9950000000001,206.73566666666667,74507192,82798320.6,66.82453471784788,1.5,2.75,1.5611537095319756,0.8998635655902423,-0.13482943616729326,2.3524797468182896,2.487309182985583,7.620685283333063,0.7467769399172933,10250777137.0,2014-12-02,2014,1,336,12,0.76,206.56,208.15,207.1,3752
2014-12-03 14:30:00,207.3,208.15,207.1,207.89,175.8070833333333,205.5897,194.02449000000013,198.40145900000007,199.02119799999997,205.33600000000007,201.3680914088911,204.84691731025845,206.27576923076924,208.62731813493644,203.924220326602,194.02449000000013,198.40145900000007,199.02119799999997,205.33600000000007,207.7133333333333,68951968,81578780.15,69.11038960456638,1.5,2.75,1.5257141588511203,0.8452194047669882,-0.1216255135561477,2.3352772910403985,2.456902804596546,7.290466870996914,1.301042783354443,10319729105.0,2014-12-03,2014,2,337,12,0.51,207.62,208.265,206.7,3753
2014-12-04 14:30:00,207.54,208.265,206.7,207.66,175.62729166666665,205.660675,194.14229000000012,198.50575900000007,199.18319799999998,205.6020000000001,201.6148329222679,205.11482994737668,206.53884615384612,208.67597634265812,204.40171596503413,194.14229000000012,198.50575900000007,199.18319799999998,205.6020000000001,207.54166666666663,91316591,81559181.0,67.67562534234514,1.5,2.75,1.5285202903617543,1.1196359487719718,-0.14405091683485782,2.276839158552974,2.420890075387832,7.227294186202843,1.011771573110217,10228412514.0,2014-12-04,2014,3,338,12,0.76,207.48,208.47,207.55,3754
2014-12-05 14:30:00,207.87,208.47,207.55,208.0,175.44749999999996,205.73165,194.26284000000012,198.60615900000008,199.41639799999996,205.84450000000007,201.86523163119858,205.38960804762647,206.8180769230769,208.67953019516546,204.95662365098843,194.26284000000012,198.60615900000008,199.41639799999996,205.84450000000007,208.00666666666663,91025470,80756000.7,68.7097710058054,1.5,2.75,1.4850545553359138,1.1271666403856475,-0.15092812507643938,2.2322299190422825,2.383158044118722,7.224238783088621,0.6386684730017385,10319437984.0,2014-12-05,2014,4,339,12,0.44,208.01,208.12,205.93,3755
2014-12-08 14:30:00,207.52,208.12,205.93,206.61,175.26770833333333,205.802625,194.3713400000001,198.71515900000009,199.59059799999997,206.00800000000007,202.05130097899468,205.50583585261447,206.8996153846154,208.61919700434257,205.18003376488818,194.3713400000001,198.71515900000009,199.59059799999997,206.00800000000007,206.88666666666668,108588152,81708422.7,60.226561054858415,1.5,2.75,1.5354078013833483,1.3289713399399643,-0.2577600739451378,2.0609579516873,2.3187180256324376,7.94983541276359,-0.3136157483354132,10210849832.0,2014-12-08,2014,0,342,12,1.06,207.02,206.6,203.91,3756
2014-12-09 14:30:00,204.37,206.6,203.91,206.47,175.08791666666664,205.8736,194.4794900000001,198.80276000000006,199.76919799999996,206.13250000000008,202.22458329354396,205.59766100950836,206.99576923076924,208.44791801612664,205.54362044541185,194.4794900000001,198.80276000000006,199.76919799999996,206.13250000000008,205.66,125180054,84651477.2,59.430676083606905,1.5,2.75,1.618592958427396,1.4787698707755097,-0.3412818433825935,1.8921157214041957,2.233397564786789,7.7442279861070356,-0.30901453333977824,10085669778.0,2014-12-09,2014,1,343,12,1.32,205.26,205.98,202.93,3757
2014-12-10 14:30:00,205.91,205.98,202.93,203.1601,174.90812499999996,205.944575,194.57104050000012,198.8609610000001,199.8919999999999,206.08175500000007,202.2612702232089,205.36551234193612,206.80962307692312,209.2345508737075,204.38469528013871,194.57104050000012,198.8609610000001,199.8919999999999,206.08175500000007,204.02336666666665,159856394,89919328.15,44.46871968894872,1.5,2.75,1.7558363185397243,1.7777756716924489,-0.6073326569590258,1.4742317435880068,2.0815644005470326,11.920902380781214,-2.1575322673858537,9925813384.0,2014-12-10,2014,2,344,12,1.5,204.46,206.19,203.71,3758
2014-12-11 14:30:00,203.88,206.19,203.71,204.19,174.72833333333332,206.01555,194.66289050000015,198.9208610000001,200.08879999999994,206.09325500000008,202.33690668504383,205.25355878556127,206.61808461538465,209.4180618305313,203.818107400238,194.66289050000015,198.9208610000001,200.08879999999994,206.09325500000008,204.69666666666663,159012805,93363953.65,48.78894415902896,1.5,2.75,1.8468408672154584,1.7031498644123666,-0.6955021845388576,1.212186669873461,1.9076888544123185,12.342754042359642,-1.4527027027026984,10084826189.0,2014-12-11,2014,3,345,12,1.22,204.95,203.81900000000002,200.85,3759
2014-12-12 14:30:00,202.64,203.81900000000002,200.85,200.89,174.54854166666664,206.086525,194.73589050000015,198.94336100000007,200.21899999999994,205.92825500000006,202.28016524641464,204.83798175836486,206.12808461538464,210.23276049755225,202.02340873321705,194.73589050000015,198.94336100000007,200.21899999999994,205.92825500000006,201.853,202330191,99212567.3,38.46327040509707,1.5,2.75,1.9534950909857833,2.039360501459375,-0.9422960882601196,0.7298187440871686,1.6721148323472883,14.931003390714887,-2.3668351477449483,9882495998.0,2014-12-12,2014,4,346,12,1.48,202.33,202.53,198.78,3760
2014-12-15 14:30:00,201.98,202.53,198.78,199.51,174.36874999999995,206.1575,194.80854050000016,198.95196100000004,200.27879999999993,205.69175500000011,202.17153131518268,204.3305549242349,205.54346923076926,210.89708749100186,200.1898509705367,194.80854050000016,198.95196100000004,200.27879999999993,205.69175500000011,200.2733333333333,189965750,104689979.1,35.11627405287621,1.5,2.75,2.081816870201084,1.8145552385538688,-1.1508977357193984,0.2334926626980405,1.3843903984174388,14.923394136913352,-3.657918246130824,9692530248.0,2014-12-15,2014,0,349,12,1.89,200.66,202.395,197.86,3761
2014-12-16 14:30:00,198.58,202.395,197.86,197.91,197.86,206.228475,194.86019050000016,198.95386100000005,200.31119999999987,205.3687550000001,202.00441244007752,203.71907350287918,204.7950076923077,211.3522320818869,198.23778330272847,194.86019050000016,198.95386100000005,200.31119999999987,205.3687550000001,199.3883333333333,259543848,113645123.8,31.67477146350461,1.5,2.75,2.2570442366152923,2.283809804781083,-1.3360427311003955,-0.2856630154580557,1.05037971564234,13.824076888186875,-4.800615710231368,9432986400.0,2014-12-16,2014,1,350,12,2.29,200.13,202.34,198.29,3762
2014-12-17 14:30:00,198.44,202.34,198.29,201.79,198.23069767441865,206.29945,194.9303905000002,198.99376100000006,200.48179999999994,205.18075500000012,201.9960041090941,203.53535221689071,204.37885384615387,210.95937437577567,197.798333316532,194.9303905000002,198.99376100000006,200.48179999999994,205.18075500000012,200.80666666666664,253910092,122537223.05,45.59828109056157,1.5,2.75,2.4122553625713428,2.0721058114430644,-1.1440140354355353,-0.3796378286520792,0.7643762067834561,19.125410195973632,-2.826736010786865,9686896492.0,2014-12-17,2014,2,351,12,2.04,200.32,212.97,203.92,3763
2014-12-18 14:30:00,204.74,212.97,203.92,206.78,198.60139534883723,212.97,195.02339050000015,199.09206100000003,200.68459999999996,205.25875500000006,202.18361179109039,203.84436629147254,204.45731538461544,211.12557478884915,197.78905598038173,195.02339050000015,199.09206100000003,200.68459999999996,205.25875500000006,207.89,257633887,131300266.95,57.57295970514633,1.5,2.75,3.03852283667339,1.962173367843256,-0.652201592596273,-0.05087578396188519,0.6013258086343878,24.79621498904562,-0.5865384615384611,9944530379.0,2014-12-18,2014,3,352,12,4.44,208.44,207.33,205.6109,3764
2014-12-19 14:30:00,206.43,207.33,205.6109,206.52,198.97209302325584,213.14573015873012,195.1146905000001,199.18746100000004,200.96019999999996,205.30575500000012,202.35366623065545,204.09918854942757,204.4138538461539,211.02011793488037,197.80758975742745,195.1146905000001,199.18746100000004,200.96019999999996,205.30575500000012,206.4869666666667,245084590,139912480.15,56.870540965829896,1.5,2.75,2.9442783483395787,1.7516992746983335,-0.33182836142596184,0.18654035685193548,0.5183687182778973,24.76389058512662,-0.043560331058517684,9699445789.0,2014-12-19,2014,4,353,12,0.84,206.47,207.47,206.46,3765
2014-12-22 14:30:00,206.75,207.47,206.46,207.47,199.34279069767445,213.32146031746032,195.21124050000012,199.33126100000004,201.29879999999991,205.34525500000007,202.55430677062972,204.42021821138678,204.38154615384624,210.92328727546533,197.83980503222716,195.21124050000012,199.33126100000004,201.29879999999991,205.34525500000007,207.13333333333333,148318934,140212062.6,58.84624523835338,1.5,2.75,2.806115609172465,1.0578186444851572,-0.057728723792876524,0.4462078135368017,0.5039365373296782,24.61219069534077,0.4843318641933453,9847764723.0,2014-12-22,2014,0,356,12,0.49,206.96,208.23,207.3991,3766
2014-12-23 14:30:00,208.17,208.23,207.3991,207.75,199.71348837209305,213.49719047619044,195.31384050000008,199.48376100000004,201.70560199999989,205.36975500000008,202.75805944629133,204.73734028649284,204.38846923076932,210.94424938261338,197.83268907892517,195.31384050000008,199.48376100000004,201.70560199999989,205.36975500000008,207.7930333333333,122167931,143026421.2,59.436048663902646,1.5,2.75,2.66502877994586,0.8541633774725254,0.13037250662766886,0.6669021706142644,0.5365296639865955,24.606741985168103,2.259252678060308,9969932654.0,2014-12-23,2014,1,357,12,0.4,207.81,208.34,207.72,3767
2014-12-24 14:30:00,208.02,208.34,207.72,207.77,200.0841860465116,213.67292063492062,195.4162905000001,199.62256100000005,202.10700199999988,205.40275500000016,202.95460613467202,205.02616502111255,204.37077692307702,210.8886069103109,197.85294693584305,195.4162905000001,199.62256100000005,202.10700199999988,205.40275500000016,207.94333333333336,42963399,141219176.1,59.48071869005183,1.5,2.75,2.5189552956640133,0.3042320468544357,0.23782128624538054,0.8338062717933212,0.5959849855479407,22.207802812789197,1.7532690141534906,10012896053.0,2014-12-24,2014,2,358,12,0.3,208.03,208.85,208.25,3768
2014-12-26 14:30:00,208.31,208.85,208.25,208.44,200.45488372093024,213.84865079365082,195.53259050000008,199.78686100000007,202.54720199999988,205.44275500000006,203.16971961958686,205.351292161959,204.51154615384615,211.29055672227418,197.73253558541825,195.53259050000008,199.78686100000007,202.54720199999988,205.44275500000006,208.5133333333333,57326703,140977119.65,61.02899013467048,1.5,2.75,2.4161727745451542,0.40663834771431995,0.3300254682830677,1.0085168209017752,0.6784913526187075,22.147752173595123,3.7582756732540257,10070222756.0,2014-12-26,2014,4,360,12,0.29,208.55,208.97,208.14,3769
2014-12-29 14:30:00,208.22,208.97,208.14,208.72,200.82558139534885,214.0243809523809,195.65289050000007,199.9533610000001,202.9962019999999,205.5187550000001,203.3873776737207,205.6721214798677,204.68462307692315,211.7630804960796,197.60616565776672,195.65289050000007,199.9533610000001,202.9962019999999,205.5187550000001,208.61,79643948,142064812.65,61.687845158176785,1.5,2.75,2.302874719220501,0.5606169924442581,0.3822000526235223,1.1562414183981105,0.7740413657745882,18.878781040693863,4.616309959400535,10149866704.0,2014-12-29,2014,0,363,12,0.4,208.56,208.37,207.51,3770
2014-12-30 14:30:00,208.21,208.37,207.51,207.6,201.19627906976746,214.2001111111111,195.7592405000001,200.11906100000007,203.37880199999992,205.61075500000013,203.55257854926103,205.85572895797554,205.0261538461539,212.20515544145584,197.84715225085202,195.7592405000001,200.11906100000007,203.37880199999992,205.61075500000013,207.82666666666668,73540761,140543433.0,57.500268691556776,1.5,2.75,2.22481223927618,0.5232600302285202,0.3163339421282257,1.1694587934348704,0.8531248513066446,18.582955913772864,4.896164923450051,10076325943.0,2014-12-30,2014,1,364,12,0.41,207.94,208.19,205.39,3771
2014-12-31 14:30:00,207.99,208.19,205.39,205.54,201.5669767441861,214.37584126984126,195.84864050000007,200.24206100000006,203.68360199999992,205.53350500000016,203.63051664536846,205.82565953340642,205.13000000000005,212.29666213476528,197.96333786523482,195.84864050000007,200.24206100000006,203.68360199999992,205.53350500000016,206.3733333333333,130333829,143334764.85,50.68508991444941,1.5,2.75,2.2658970793278823,0.9092967022787144,0.11922542825842684,1.002156636629678,0.8829312083712513,19.063032382629352,1.8583676098914717,9945992114.0,2014-12-31,2014,2,365,12,1.36,206.79,206.88,204.18,3772
2015-01-02 14:30:00,206.38,206.88,204.18,205.43,201.9376744186047,214.55157142857144,195.94249050000005,200.35841100000007,203.91080199999996,205.41050500000011,203.7010846200599,205.787977673082,205.4792307692308,212.214905992258,198.74355554620357,195.94249050000005,200.35841100000007,203.91080199999996,205.41050500000011,205.49666666666667,121465865,145960459.7,50.341968580884455,1.5,2.75,2.296904430804461,0.8321833546540962,-0.025637821878607747,0.8508839310229916,0.8765217529015994,16.324283495040085,-0.6528677821839609,9824526249.0,2015-01-02,2015,4,2,1,1.32,205.53,204.37,201.35,3773
2015-01-05 14:30:00,204.17,204.37,201.35,201.72,202.3083720930233,214.7273015873016,196.01235550000004,200.44031100000007,204.09140199999993,205.11350500000015,203.6233950271164,205.4005512280266,205.6492307692308,211.86520751178506,199.4332540266765,196.01235550000004,200.44031100000007,204.09140199999993,205.11350500000015,202.48,169632646,149876262.45,40.40656817864056,1.5,2.75,2.424268400032715,1.1318179625448754,-0.35984593788109875,0.4267143305502259,0.7865602684313246,12.616386737537345,-2.3242300987797844,9654893603.0,2015-01-05,2015,0,5,1,1.5,202.86,202.72,198.855,3774
2015-01-06 14:30:00,202.09,202.72,198.855,199.82,202.6790697674419,214.90303174603176,196.08045550000008,200.49011100000007,204.18920199999994,204.70450500000013,203.47424228095488,204.86907015869068,205.7961538461539,211.3258862834785,200.2664214088293,196.08045550000008,200.49011100000007,204.18920199999994,204.70450500000013,200.465,209151408,155782559.35,36.44014002807371,1.5,2.75,2.527177800030379,1.3425855170994792,-0.6788818727030572,-0.06204207244749683,0.6168398002555604,13.190425816316164,-3.6872800886875243,9445742195.0,2015-01-06,2015,1,6,1,1.94,200.79,202.72,200.88,3775
2015-01-07 14:30:00,201.42,202.72,200.88,202.31,203.0497674418605,215.07876190476193,196.16485550000004,200.5556110000001,204.30680199999992,204.48950500000015,203.42858572091748,204.6253491911964,205.8361538461539,211.25581911235543,200.4164885799524,196.16485550000004,200.5556110000001,204.30680199999992,204.48950500000015,201.97000000000003,125346709,156620487.2,44.17428563393315,1.5,2.75,2.5538079571710663,0.800321281340006,-0.6899769341387229,-0.2456313674178432,0.4443455667208797,15.454041250742526,-2.6185318892900105,9571088904.0,2015-01-07,2015,2,7,1,0.92,201.8,206.16,203.99,3776
2015-01-08 14:30:00,204.01,206.16,203.99,205.9,203.4204651162791,215.25449206349205,196.26280550000007,200.6574110000001,204.50160199999988,204.46100500000014,203.52550392794032,204.74674450632048,205.76846153846162,211.1611965155067,200.3757265614165,196.26280550000007,200.6574110000001,204.50160199999988,204.46100500000014,205.35,147217784,157722373.7,53.04555744600313,1.5,2.75,2.6463931030874184,0.9333982271914032,-0.43570697328744606,-0.10028814988842782,0.3354188233990182,19.26972527504687,-0.9000336911007385,9718306688.0,2015-01-08,2015,3,8,1,1.06,205.08,206.42,203.51,3777
2015-01-09 14:30:00,206.4,206.42,203.51,204.25,203.79116279069768,215.43022222222226,196.3592055000001,200.72631100000007,204.61840199999992,204.5155000000002,203.5539155386093,204.69943550571853,205.59384615384616,211.02480322185832,200.16288908583408,196.3592055000001,200.72631100000007,204.61840199999992,204.5155000000002,204.72666666666663,158567288,157657918.4,49.177505717063944,1.5,2.75,2.6652221671526024,1.0057679919234557,-0.3618521030284975,-0.11689630538660367,0.2449557976418938,19.6776852591776,-2.010170792554211,9559739400.0,2015-01-09,2015,4,9,1,1.43,204.96,204.6,201.92,3778
2015-01-12 14:30:00,204.41,204.6,201.92,202.65,204.16186046511632,215.6059523809524,196.4495555000001,200.76891100000012,204.70920199999983,204.43850000000015,203.5184678704286,204.5042511718406,205.223076923077,210.74837195656704,199.697781889587,196.4495555000001,200.76891100000012,204.70920199999983,204.43850000000015,203.05666666666664,144396067,156927081.5,45.69767526185791,1.5,2.75,2.6662777266417033,0.9201475336173891,-0.4009338933411988,-0.25621156903460474,0.1447223243065941,19.689921031375576,-2.908202376389418,9415343333.0,2015-01-12,2015,0,12,1,1.33,203.26,205.48,200.51,3779
2015-01-13 14:30:00,204.12,205.48,200.51,202.08,204.5325581395349,215.78168253968255,196.53250550000007,200.8005110000002,204.76320199999984,204.49800000000027,203.46205736570587,204.27337010785575,204.7869230769232,210.34056296228692,199.23328319155937,196.53250550000007,200.8005110000002,204.76320199999984,204.49800000000027,202.69000000000003,214553306,157538237.25,44.48988255498642,1.5,2.75,2.830829317595867,1.3619125727522383,-0.4421074593500367,-0.4079119998809517,0.03419545946908493,19.51272883210812,-2.6589595375722457,9200790027.0,2015-01-13,2015,1,13,1,2.48,203.0,201.1,198.57,3780
2015-01-14 14:30:00,199.65,201.1,198.57,200.86,204.9032558139535,215.9574126984127,196.60175550000008,200.8141110000002,204.74720199999993,204.56550000000018,203.3600159003841,203.9482872404409,204.25538461538468,209.88739540746778,198.6233738233016,196.60175550000008,200.8141110000002,204.74720199999993,204.56550000000018,200.17666666666665,192991092,157689504.35,41.93514604871643,1.5,2.75,2.879341509196164,1.2238677063227132,-0.5229075526269721,-0.6194389813146302,-0.09653142868765807,19.543655698683622,-2.2769290649021983,9007798935.0,2015-01-14,2015,2,14,1,1.27,199.83,202.01,198.88,3781
2015-01-15 14:30:00,201.63,202.01,198.88,199.0199,205.2739534883721,216.13314285714284,196.65560500000007,200.8124100000002,204.69219999999987,204.62099500000028,203.1898152768396,203.4789170270656,203.5307615384616,209.24610645626962,197.81541662065362,196.65560500000007,200.8124100000002,204.69219999999987,204.62099500000028,199.96996666666664,176613906,153543007.25,38.35746944843748,1.5,2.75,2.8972456871107233,1.1502569160472138,-0.6626906323443083,-0.9248947191180434,-0.2622040867737352,19.452572674414345,-3.1203329601324046,8831185029.0,2015-01-15,2015,3,15,1,1.57,200.44,201.82,198.55,3782
2015-01-16 14:30:00,198.77,201.82,198.55,201.63,205.64465116279072,216.30887301587302,196.71935500000006,200.8267100000002,204.70339999999985,204.61299500000027,203.12864605029685,203.30282969115459,202.985376923077,207.9150271263951,198.05572671975887,196.71935500000006,200.8267100000002,204.70339999999985,204.61299500000027,200.66666666666663,211879605,151441482.9,45.46470909347665,1.5,2.75,2.923870995174241,1.3990856464335373,-0.5466036717317936,-0.9454586764384773,-0.3988550047066836,21.57471251636449,-0.04461629982153649,9043064634.0,2015-01-16,2015,4,16,1,1.65,200.18,202.72,200.17,3783
2015-01-20 14:30:00,202.4,202.72,200.17,202.055,206.01534883720933,216.4846031746032,196.78648000000007,200.84396000000015,204.69769999999986,204.37674500000026,203.08654228361854,203.18398876818748,202.55883846153856,206.71670091054023,198.40097601253686,196.78648000000007,200.84396000000015,204.69769999999986,204.37674500000026,201.6483333333333,130991069,145109342.0,46.545450133990094,1.5,2.75,2.897165924090368,0.9027059677522348,-0.4144299540403883,-0.9168924472571688,-0.5024624932167806,18.933528748296943,1.1185066559903982,9174055703.0,2015-01-20,2015,1,20,1,1.27,201.44,203.66,200.94,3784
2015-01-21 14:30:00,201.5,203.66,200.94,203.08,206.38604651162797,216.6603333333333,196.86988000000008,200.87226000000018,204.6962999999999,204.20474500000026,203.08628572347664,203.1740850759792,202.36960769230774,206.17665350881447,198.5625618758011,196.86988000000008,200.87226000000018,204.6962999999999,204.20474500000026,202.56,122942707,139002247.85,49.16213218857681,1.5,2.75,2.8845112152267696,0.8844656032661418,-0.23986696536589006,-0.8022961999241431,-0.5624292345582531,18.04649468232913,0.3806040235282538,9296998410.0,2015-01-21,2015,2,21,1,1.35,202.3,206.26,202.33,3785
2015-01-22 14:30:00,203.99,206.26,202.33,206.1,206.75674418604652,216.8360634920635,196.97868000000008,200.9318600000002,204.75149999999988,204.13624500000026,203.2044705970658,203.45274364017163,202.42114615384625,206.40648420271546,198.43580810497696,196.97868000000008,200.9318600000002,204.75149999999988,204.13624500000026,204.89666666666668,174356029,140304102.6,55.9968121145582,1.5,2.75,2.959188985567713,1.242700860266933,0.07997686147658778,-0.4624581577125184,-0.5424350191891062,18.606875998288576,0.09713453132588083,9471354439.0,2015-01-22,2015,3,22,1,1.94,204.3,206.1,204.81,3786
2015-01-23 14:30:00,205.79,206.1,204.81,204.97,207.12744186046515,217.0117936507937,197.07803000000007,200.97446000000028,204.77129999999985,203.99724500000028,203.2737070442397,203.5972442458696,202.67114615384625,206.8521301356459,198.49016217204647,197.07803000000007,200.97446000000028,204.77129999999985,203.99724500000028,205.2933333333333,117516753,140071543.7,53.11916033911015,1.5,2.75,2.8399612008843036,0.838976639335774,0.20908757291697927,-0.2810755530428821,-0.4901631259598614,16.004606585179612,0.3525091799265601,9353837686.0,2015-01-23,2015,4,23,1,0.63,205.46,205.56,203.85,3787
2015-01-26 14:30:00,204.71,205.56,203.85,205.45,207.49813953488376,217.1875238095238,197.16983000000008,201.02286000000018,204.79679999999993,203.88124500000026,203.3590518660342,203.7736971748344,203.10422307692315,207.1791674998833,199.0292786539629,197.16983000000008,201.02286000000018,204.79679999999993,203.88124500000026,204.95333333333332,92009711,142523859.3,54.195938895142575,1.5,2.75,2.759249686535426,0.6455740916075515,0.31415215177250483,-0.09747293624423037,-0.4116250880167352,15.297425236804676,1.3816925734024097,9445847397.0,2015-01-26,2015,0,26,1,0.84,204.7,204.12,201.74,3788
2015-01-27 14:30:00,202.97,204.12,201.74,202.74,207.86883720930237,217.363253968254,197.26775500000008,201.04526000000027,204.77239999999992,203.59624500000027,203.33477532226814,203.67524982485017,203.13730000000007,207.19285475632012,199.08174524368,197.26775500000008,201.04526000000027,204.77239999999992,203.59624500000027,202.86666666666667,134044598,146359754.05,47.554859715549746,1.5,2.75,2.827160423211465,0.9158569503622364,0.19434305786153425,-0.16869626568981744,-0.3630393235513517,16.644411451799805,0.3266033254156753,9311802799.0,2015-01-27,2015,1,27,1,1.18,202.93,204.29,199.91,3789
2015-01-28 14:30:00,204.17,204.29,199.91,200.14,208.2395348837209,217.53898412698413,197.3609050000001,201.04455900000028,204.69139999999987,203.16724500000026,203.20949001551259,203.3385593653406,202.69422307692315,206.70396610198398,198.68448005186238,197.3609050000001,201.04455900000028,204.69139999999987,203.16724500000026,201.44666666666663,168514312,150803272.25,42.21065871716333,1.5,2.75,2.9380775358392177,1.117444664732731,-0.05355491105497945,-0.429982962370076,-0.3764280513150965,18.208767052326397,-0.35845862790004346,9143288487.0,2015-01-28,2015,2,28,1,2.19,202.1,202.3,198.68,3790
2015-01-29 14:30:00,200.38,202.3,198.68,201.9902,208.61023255813961,217.71471428571425,197.45615550000008,201.05336100000028,204.64640399999993,202.88675500000028,203.16167472078655,203.21014418768917,202.52039230769242,206.4402043537786,198.60058026160613,197.45615550000008,201.05336100000028,204.64640399999993,202.88675500000028,200.99006666666665,173585424,155805505.4,46.792992540819114,1.5,2.75,2.9867862832792738,1.1141161126133097,-0.08461785417184042,-0.482200369029897,-0.3975825148580566,18.74379225377352,1.4924638189447288,9316873911.0,2015-01-29,2015,3,29,1,1.82,200.49,202.17,199.13,3791
2015-01-30 14:30:00,200.57,202.17,199.13,199.45,208.98093023255817,217.89044444444446,197.53240550000007,201.04196100000027,204.54800399999988,202.58225500000026,203.0161188493832,202.852035217433,202.27423846153846,206.5190118816339,198.02946504144313,197.53240550000007,201.04196100000027,204.54800399999988,202.58225500000026,200.25,197729724,159175300.15,41.8826979470817,1.5,2.75,2.9905872630450387,1.2422136086042743,-0.25813664312171475,-0.7202533187602,-0.4621166756384853,19.4898130517234,-1.081188315230872,9119144187.0,2015-01-30,2015,4,30,1,1.53,200.65,202.03,197.86,3792
2015-02-02 14:30:00,200.05,202.03,197.86,201.92,209.3516279069768,218.0661746031746,197.61138050000008,201.06796100000028,204.4754039999999,202.40675500000026,202.9731337964662,202.7632699586299,202.26193076923084,206.509812289654,198.01404924880768,197.61138050000008,201.06796100000028,204.4754039999999,202.40675500000026,200.6033333333333,163106969,161257355.35,47.63666954797853,1.5,2.75,3.0748310299703934,1.0114699490512264,-0.19152024988376185,-0.7015169879931875,-0.5099967381094257,19.320321276380717,-0.06681349137612003,9282251156.0,2015-02-02,2015,0,33,2,2.11,199.94,204.85,202.55,3793
2015-02-03 14:30:00,203.0,204.85,202.55,204.84,209.72232558139538,218.24190476190475,197.7036305000001,201.11566100000027,204.46780399999992,202.56275500000027,203.04634423582047,202.9610537720937,202.56808461538466,206.9395710852174,198.19659814555197,197.7036305000001,201.11566100000027,204.46780399999992,202.56275500000027,204.08000000000004,124212881,158986367.1,53.49809918674946,1.5,2.75,3.06448595640108,0.7812800761833372,0.05127054405399212,-0.4459085580419355,-0.4971791020959277,20.979357631776065,0.8666535355524871,9406464037.0,2015-02-03,2015,1,34,2,1.14,203.7,205.38,203.51,3794
2015-02-04 14:30:00,203.92,205.38,203.51,204.06,210.09302325581402,218.41763492063487,197.78873050000004,201.15326100000027,204.43740399999993,202.77475500000025,203.08609544225888,203.0657153176086,202.95578461538463,206.8698344966275,199.0417347341418,197.78873050000004,201.15326100000027,204.43740399999993,202.77475500000025,204.3166666666667,134306728,155244133.1,51.82913621817482,1.5,2.75,2.9791655309438596,0.865132390629453,0.15551433260790215,-0.3027861863360499,-0.4583005189439521,21.02604568963636,-0.9898107714701564,9272157309.0,2015-02-04,2015,2,35,2,0.92,204.44,206.3,204.77,3795
2015-02-05 14:30:00,204.86,206.3,204.77,206.12,210.46372093023257,218.59336507936507,197.87988050000007,201.22316100000026,204.42620399999996,202.96525500000027,203.20507209158202,203.35659957307445,203.30116923076926,207.470400234128,199.1319382274105,197.87988050000007,201.22316100000026,204.42620399999996,202.96525500000027,205.73,97953181,153874456.7,55.75495535450509,1.5,2.75,2.9263679930192987,0.6365785660642401,0.3483426272588942,-0.022872234870334296,-0.3712148621292285,20.005780034220408,0.5610577157632852,9370110490.0,2015-02-05,2015,3,36,2,0.75,205.54,207.24,204.92,3796
2015-02-06 14:30:00,206.56,207.24,204.92,205.55,210.83441860465118,218.76909523809525,197.9703805000001,201.28885100000028,204.39200399999993,202.94775500000026,203.2970300487749,203.5654948518293,203.57001538461543,207.83283381077962,199.30719695845124,197.9703805000001,201.28885100000028,204.39200399999993,202.94775500000026,205.90333333333336,125672026,152797168.8,54.433048573501424,1.5,2.75,2.8830559935179223,0.8224761426338679,0.4179511971747672,0.15122413433923046,-0.2667270628355367,19.791576295940178,0.04867364322220625,9244438464.0,2015-02-06,2015,4,37,2,1.13,206.08,205.64,204.135,3797
2015-02-09 14:30:00,204.77,205.64,204.135,204.63,211.2051162790698,218.94482539682542,198.05438050000006,201.33035100000026,204.34240399999987,202.96675500000026,203.34930338019555,203.66687629451218,203.68924615384626,207.97720470173118,199.40128760596127,198.05438050000006,201.33035100000026,204.34240399999987,202.96675500000026,204.80166666666665,87219016,149229755.2,52.27858651701445,1.5,2.75,2.784623422552356,0.5844612951559677,0.3833902568743223,0.2125107582573662,-0.17087949861695612,19.9188846946557,0.9322284699615204,9157219448.0,2015-02-09,2015,0,40,2,0.74,204.89,207.12,204.6801,3798
2015-02-10 14:30:00,205.88,207.12,204.6801,206.81,211.5758139534884,219.12055555555557,198.1569805000001,201.39095100000026,204.32580399999992,203.17475500000026,203.48501697312904,203.96622140932055,203.7438615384616,208.16913879846612,199.31858427845714,198.1569805000001,201.39095100000026,204.32580399999992,203.17475500000026,206.20336666666668,96164183,146818161.0,56.65637497556789,1.5,2.75,2.7635788923700457,0.6549883362181603,0.4823105611563514,0.4320087028284832,-0.05030185832786825,18.962063467656574,3.3326671330069035,9253383631.0,2015-02-10,2015,1,41,2,1.19,205.9,207.45,205.83,3799
2015-02-11 14:30:00,206.61,207.45,205.83,206.93,211.946511627907,219.2962857142857,198.25725550000007,201.44205100000028,204.32040399999988,203.41725500000027,203.6201143467318,204.24848603700437,203.89463076923084,208.60133829941606,199.1879232390457,198.25725550000007,201.44205100000028,204.32040399999988,203.41725500000027,206.73666666666668,91087785,140644884.95,56.89080907455984,1.5,2.75,2.6818946857721837,0.6476437805212909,0.5271450869780535,0.6086295003946987,0.08148441341664513,16.512588388399713,2.445564190737976,9344471416.0,2015-02-11,2015,2,42,2,0.79,206.64,208.99,206.9727,3800
2015-02-12 14:30:00,207.89,208.99,206.9727,208.92,212.31720930232558,219.47201587301586,198.36310550000005,201.52425100000028,204.38360399999988,203.82025500000026,203.82795299980114,204.69339212871827,204.161553846154,209.53689642993427,198.78621126237357,198.36310550000005,201.52425100000028,204.38360399999988,203.82025500000026,208.2942333333333,97545949,135872627.8,60.688117758985044,1.5,2.75,2.637473636788456,0.7179220022415729,0.6538669558026992,0.8988181081700191,0.2449511523673199,16.561682292155982,4.7480571571822505,9442017365.0,2015-02-12,2015,3,43,2,0.97,207.98,209.84,208.76,3801
2015-02-13 14:30:00,209.07,209.84,208.76,209.78,212.68790697674424,219.64774603174604,198.47045550000007,201.6305510000002,204.43750399999993,204.35826000000026,204.0613666076521,205.17783097360217,204.70309230769246,210.77041187120412,198.63577274418068,198.47045550000007,201.6305510000002,204.43750399999993,204.35826000000026,209.46,93670430,131725454.0,62.2362607773812,1.5,2.75,2.526225519874996,0.7111034895351357,0.7516669998684173,1.1845349022028415,0.4328679023344241,13.055736604042742,3.892630744849453,9535687795.0,2015-02-13,2015,4,44,2,0.52,209.3,210.32,209.1,3802
2015-02-17 14:30:00,209.4,210.32,209.1,210.11,213.0586046511628,219.82347619047616,198.57938050000007,201.75155100000018,204.48190399999996,204.78226000000026,204.2985679171559,205.64756135706867,205.47001538461552,211.5567426354961,199.38328813373496,198.57938050000007,201.75155100000018,204.48190399999996,204.78226000000026,209.84333333333333,76968199,124979883.7,62.840977109210385,1.5,2.75,2.4329236970267814,0.6158447001339304,0.7906760016046388,1.4212129043402228,0.630536902735584,12.305678234928155,2.5727396992774905,9612655994.0,2015-02-17,2015,1,48,2,0.58,209.71,210.22,209.3401,3803
2015-02-18 14:30:00,209.66,210.22,209.3401,210.13,213.42930232558143,219.9992063492064,198.68973050000008,201.85725100000028,204.53130399999992,205.18601000000018,204.52725152824783,206.07446027544307,206.09615384615398,212.2958190403838,199.89648865192416,198.68973050000008,201.85725100000028,204.53130399999992,205.18601000000018,209.8967,80652941,122462977.3,62.879773209030816,1.5,2.75,2.321993432953439,0.6585903983244086,0.7692054143216988,1.5920436706377077,0.8228382563160087,10.495851431881798,2.974615309222774,9693308935.0,2015-02-18,2015,2,49,2,0.42,209.78,210.42,209.24,3804
2015-02-19 14:30:00,209.41,210.42,209.24,209.98,213.80000000000004,220.1749365079365,198.79753050000008,201.9936510000002,204.57090399999993,205.53101000000018,204.7410848016499,206.44641643968657,206.90615384615398,212.0889688725165,201.7233388197916,198.79753050000008,201.9936510000002,204.57090399999993,205.53101000000018,209.88,91462491,120888966.5,62.35395726567929,1.5,2.75,2.2404224734567637,0.7565826199697059,0.6983507384072216,1.6957766793250355,0.997425940917814,9.94552625753097,1.8726955171744544,9601846444.0,2015-02-19,2015,3,50,2,0.56,209.83,211.33,208.73,3805
2015-02-20 14:30:00,209.48,211.33,208.73,211.239,214.17069767441865,220.35066666666665,198.9198255000001,202.12704100000028,204.6634839999999,205.78796000000014,204.9959050055068,206.90285296924026,207.62300000000016,212.41182172756058,202.83417827243971,198.9198255000001,202.12704100000028,204.6634839999999,205.78796000000014,210.433,140896392,119215984.65,64.99950795920526,1.5,2.75,2.2661065824955675,1.181858224915479,0.6885847973849711,1.858156937649028,1.1695721402640569,9.111403460943839,2.7676964242276783,9742742836.0,2015-02-20,2015,4,51,2,1.25,210.03,211.21,210.48,3806
2015-02-23 14:30:00,210.94,211.21,210.48,211.209,214.54139534883728,220.52639682539683,199.03647050000012,202.26373100000015,204.7582639999999,206.0999100000001,205.23955578960454,207.312962210265,208.11292307692318,212.9653810083488,203.26046514549762,199.03647050000012,202.26373100000015,204.7582639999999,206.0999100000001,210.9663333333333,74411054,117060699.7,64.88250292177705,1.5,2.75,2.158456112317314,0.635662132472287,0.6337896459729293,1.9618091977302183,1.3280195517572893,8.675788828320636,3.2150711039437065,9668331782.0,2015-02-23,2015,0,54,2,0.35,210.84,212.05,210.76,3807
2015-02-24 14:30:00,211.12,212.05,210.76,211.81,214.91209302325584,220.70212698412698,199.15714550000013,202.4116310000002,204.93126199999992,206.41791000000015,205.4972202684436,207.7412515235731,208.70907692307705,213.32168942903598,204.0964644171181,199.15714550000013,202.4116310000002,204.93126199999992,206.41791000000015,211.54,72472263,116083827.3,66.19533455781885,1.5,2.75,2.0964235328660785,0.624309731042095,0.5924679212943749,2.0686044533752583,1.476136532080883,7.374599086485662,2.4176780619892653,9740804045.0,2015-02-24,2015,1,55,2,0.61,211.4,212.24,211.22,3808
2015-02-25 14:30:00,211.66,212.24,211.22,211.63,215.28279069767447,212.24,199.2754955000001,202.58443100000028,205.08006199999988,206.86241000000015,205.73772143438697,208.11160852132804,209.1329230769232,213.7285969932746,204.53724916057183,199.2754955000001,202.58443100000028,205.08006199999988,206.86241000000015,211.6966666666667,73061687,113034681.75,65.4066737508287,1.5,2.75,2.019536137661359,0.6463652205576277,0.5105652828791134,2.114343135679775,1.6037778528006614,6.139663540686919,2.2712994732518186,9667742358.0,2015-02-25,2015,2,56,2,0.48,211.73,211.71,210.65,3809
2015-02-26 14:30:00,211.52,211.71,210.65,211.38,215.65348837209308,212.22377777777783,199.38347050000007,202.75443100000018,205.28986199999989,207.42441000000017,205.95898726048944,208.4228839002492,209.58138461538482,213.81452118940254,205.348248041367,199.38347050000007,202.75443100000018,205.28986199999989,207.42441000000017,211.24666666666667,72697868,108243859.55,64.26151414971926,1.5,2.75,1.9509978421141196,0.6716119353303307,0.4018898675363856,2.1061401872211434,1.7042503196847578,6.397876252766401,1.1774842044801876,9595044490.0,2015-02-26,2015,3,57,2,0.5,211.18,211.58,210.6,3810
2015-02-27 14:30:00,211.26,211.58,210.6,210.66,216.0241860465117,212.20755555555562,199.48697050000007,202.8958310000002,205.5128619999999,207.85790000000011,206.14334070125454,208.63594257641597,210.04523076923093,213.18742041770162,206.90304112076018,199.48697050000007,202.8958310000002,205.5128619999999,207.85790000000011,210.9466666666667,108075972,104968386.95,60.951675850870096,1.5,2.75,1.8816408533916835,1.029604961458351,0.25122044884389183,2.0182758807396226,1.7670554318957308,5.075494928624861,0.4194870817046408,9486968518.0,2015-02-27,2015,4,58,2,0.47,211.09,212.06,210.72,3811
2015-03-02 14:30:00,210.78,212.06,210.72,211.99,216.3948837209303,212.19133333333332,199.60162050000008,203.05283100000025,205.7944619999999,208.48490000000012,206.3726214580681,208.95537661675732,210.4436923076924,213.12351921192328,207.7638654034615,199.60162050000008,203.05283100000025,205.7944619999999,208.48490000000012,211.59,87491428,99456472.15,64.5807740242924,1.5,2.75,1.8472379352922776,0.8796956709669497,0.2123819709147228,2.032532895539134,1.8201509246244116,5.706230159281738,0.8947694065013542,9574459946.0,2015-03-02,2015,0,61,3,0.64,211.39,212.054,210.08,3812
2015-03-03 14:30:00,211.47,212.054,210.08,211.12,216.7655813953489,212.1751111111111,199.72022050000007,203.23143100000027,205.9810619999999,208.9449000000001,206.55879316559484,209.16153122468518,210.76600000000008,212.5289236206538,209.0030763793464,199.72022050000007,203.23143100000027,205.9810619999999,208.9449000000001,211.0846666666667,110325809,96817414.15,60.612421488421795,1.5,2.75,1.8562923684856856,1.1395244333738488,0.1047900154502055,1.951138443937168,1.846348428486963,6.4032295699330035,0.4711369152429492,9464134137.0,2015-03-03,2015,1,62,3,0.94,211.07,210.49,209.06,3813
2015-03-04 14:30:00,210.4,210.49,209.06,210.2301,217.13627906976745,212.1588888888889,199.83112100000008,203.36733200000026,206.05006399999988,209.21440500000008,206.7027659826303,209.26329967947703,210.866776923077,212.31836692270417,209.41518692344985,199.83112100000008,203.36733200000026,206.05006399999988,209.21440500000008,209.9267,114497192,96331629.7,56.76977186270792,1.5,2.75,1.8708429135938511,1.188573185739429,-0.041763948816549545,1.7941434924662758,1.8359074412828251,6.952818312187811,0.1191065815791996,9349636945.0,2015-03-04,2015,2,63,3,0.68,209.78,210.8,209.85,3814
2015-03-05 14:30:00,210.62,210.8,209.85,210.46,217.5069767441861,212.14266666666668,199.93972100000008,203.54453200000026,206.12886399999985,209.53440500000008,206.8501084931154,209.37727113857449,210.91908461538466,212.25462635124282,209.5835428795266,199.93972100000008,203.54453200000026,206.12886399999985,209.53440500000008,210.37,76872957,93459941.15,57.51905467913143,1.5,2.75,1.80506841976572,0.8225230623312884,-0.1334977359748657,1.6690352713142431,1.8025330072891088,6.957697841727648,-0.368776599018172,9426509902.0,2015-03-05,2015,3,64,3,0.45,210.32,209.94,207.1,3815
2015-03-06 14:30:00,209.42,209.94,207.1,207.5,217.8776744186047,212.12644444444442,200.03947100000008,203.71413200000018,206.1294639999999,209.60340500000007,206.87559443456183,209.1984834110912,210.71831538461544,212.958401036608,208.47822973262282,200.03947100000008,203.71413200000018,206.1294639999999,209.60340500000007,208.18,188127982,97968681.2,46.374247806992685,1.5,2.75,1.9161349612110268,1.9202869702404448,-0.3893301589270397,1.3158703086303092,1.7052004675573489,9.856160156539822,-1.7560804700557282,9238381920.0,2015-03-06,2015,4,65,3,1.37,208.52,208.79,207.5459,3816
2015-03-09 13:30:00,207.74,208.79,207.5459,208.36,218.2483720930233,212.11022222222226,200.13562100000007,203.92363300000028,206.14166399999988,209.74390500000007,206.93380641752026,209.1186278481301,210.5821615384616,213.14118727078235,208.02313580614086,200.13562100000007,203.92363300000028,206.14166399999988,209.74390500000007,208.23196666666664,89818893,96176024.55,49.439482558477785,1.5,2.75,1.871411035410239,0.9339010779480176,-0.4899344313526868,1.0927824283664904,1.5827168597191772,10.406233677482675,-1.6288182805344358,9328200813.0,2015-03-09,2015,0,68,3,0.6,208.17,206.81,204.93,3817
2015-03-10 13:30:00,206.71,206.81,204.93,204.98,218.6190697674419,212.094,200.2125710000001,204.09643300000027,206.08586399999984,209.76140500000002,206.85718655800963,208.7244728149749,210.19754615384625,214.13480524468088,206.2602870630116,200.2125710000001,204.09643300000027,206.08586399999984,209.76140500000002,205.57333333333332,157121263,99671136.9,39.80852690513685,1.5,2.75,1.982738818595222,1.5763968174421414,-0.7574410990104128,0.6359154859561613,1.393356584966574,13.057285190164757,-3.142276614846669,9171079550.0,2015-03-10,2015,1,69,3,0.92,205.87,205.5,204.4,3818
2015-03-11 13:30:00,205.29,205.5,204.4,204.5,218.98976744186047,212.07777777777775,200.28332100000011,204.27713300000028,206.00706399999984,209.64590500000003,206.76474786946025,208.3221420706916,209.6791615384616,214.5864729399287,204.7718501369945,200.28332100000011,204.27713300000028,206.00706399999984,209.64590500000003,204.8,110145718,100370213.65,38.656848735384976,1.5,2.75,1.9196860458384197,1.097394475856035,-0.92873822646,0.2324338018915739,1.1611720283515738,12.983766338578372,-3.2548017787870167,9060933832.0,2015-03-11,2015,2,70,3,0.54,204.95,207.175,205.2,3819
2015-03-12 13:30:00,205.26,207.175,205.2,207.1,219.3604651162791,212.0615555555556,200.3612210000001,204.4854330000002,205.97466399999988,209.65440500000003,206.7778950118343,208.20574758776854,209.36308461538468,214.36395993312718,204.36220929764212,200.3612210000001,204.4854330000002,205.97466399999988,209.65440500000003,206.49166666666667,93993523,100515500.55,47.514370569322864,1.5,2.75,1.973637042564248,0.9351147085343744,-0.8320782126787108,0.12107426250318555,0.9531524751818964,15.935009195168636,-1.689926896420774,9154927355.0,2015-03-12,2015,3,71,3,0.96,206.19,207.9338,204.58,3820
2015-03-13 13:30:00,206.77,207.9338,204.58,205.8272,219.7311627906977,212.04533333333333,200.43345700000015,204.65900500000015,205.9392079999999,209.499765,206.74061285450748,207.97921924607638,208.9028692307693,214.01816029933812,203.78757816220048,200.43345700000015,204.65900500000015,205.9392079999999,209.499765,206.11366666666663,162410893,103758747.75,44.15327707091073,1.5,2.75,2.072220110952514,1.5652742204572336,-0.8177915054861399,-0.06908690667577844,0.7487045988103614,16.098438556960872,-2.9071182602952987,8992516462.0,2015-03-13,2015,4,72,3,1.64,206.26,208.69,205.8641,3821
2015-03-16 13:30:00,206.71,208.69,205.8641,208.58,220.10186046511632,212.02911111111112,200.51450700000012,204.8418050000002,206.00000799999984,209.439765,206.8127456837425,208.0364364607357,208.668253846154,213.53546230882856,203.8010453834793,200.51450700000012,204.8418050000002,206.00000799999984,209.439765,207.71136666666663,136099192,105880185.85,52.053068234178674,1.5,2.75,2.128690103027334,1.285407566178729,-0.5971154240983524,0.002310318687420932,0.5994257427857733,17.865877386742962,-1.2031072375899925,9128615654.0,2015-03-16,2015,0,75,3,1.37,207.28,208.42,206.98,3822
2015-03-17 13:30:00,207.69,208.42,206.98,207.96,220.47255813953493,212.01288888888888,200.59090700000016,204.9807050000002,206.0506079999998,209.33226500000006,206.85773604908593,208.02915679780853,208.40517692307702,213.0208664687997,203.7894873773543,200.59090700000016,204.9807050000002,206.0506079999998,209.33226500000006,207.78666666666663,94510422,106757297.0,50.32637464644402,1.5,2.75,2.0909265242396686,0.8852830172348781,-0.4725299559165513,0.008763297890084232,0.4812932538066355,17.819890308742636,-1.0798168292742023,9034105232.0,2015-03-17,2015,1,76,3,0.7,207.7,211.27,206.62,3823
2015-03-18 13:30:00,207.39,211.27,206.62,210.46,220.84325581395356,211.99666666666667,200.67873200000014,205.15840500000027,206.22540799999985,209.34876500000004,206.9990013020629,208.2606656742077,208.3897923076924,212.9765596053434,203.80302501004138,200.67873200000014,205.15840500000027,206.22540799999985,209.34876500000004,209.45,228808524,114165076.15,56.58075403686944,1.5,2.75,2.273717486793979,2.004190175455858,-0.21451509615395306,0.21314938361419425,0.4276644797681473,19.2721402101425,0.0,9262913756.0,2015-03-18,2015,2,77,3,2.25,208.94,210.4697,209.03,3824
2015-03-19 13:30:00,209.96,210.4697,209.03,209.5,221.2139534883721,211.98044444444446,200.76223200000013,205.3041050000002,206.41900799999985,209.32476500000007,207.0970796823742,208.37869751475932,208.1982538461539,212.3555105678262,204.04099712448158,200.76223200000013,205.3041050000002,206.41900799999985,209.32476500000007,209.66656666666665,117917302,115487816.7,53.780489729251286,1.5,2.75,2.2141448091658367,1.0210367237810982,-0.10671503751646601,0.29427068287256475,0.4009857203890307,19.43937451906,0.9638554216867471,9144996454.0,2015-03-19,2015,3,78,3,0.69,209.75,211.02,209.4903,3825
2015-03-20 13:30:00,209.71,211.02,209.4903,210.41,221.58465116279075,211.96422222222225,200.8483320000001,205.4439050000002,206.58100799999985,209.28331500000007,207.22699812620263,208.5721548943061,208.14363846153856,212.16226776289952,204.12500916017757,200.8483320000001,205.4439050000002,206.58100799999985,209.28331500000007,210.30676666666668,177715081,117328751.15,56.003313861078574,1.5,2.75,2.1652558942254214,1.5146763198118298,0.02086449321088807,0.4270663369026408,0.4062018436917528,17.470005624450096,0.9838740641197844,9322711535.0,2015-03-20,2015,4,79,3,0.73,210.26,211.11,210.0,3826
2015-03-23 13:30:00,210.42,211.11,210.0,210.0,221.95534883720936,211.94799999999998,200.92608200000015,205.5823050000002,206.66300799999985,209.22286500000007,207.33574329772406,208.70814014246739,208.12593846153854,212.10952684739263,204.14235007568442,200.92608200000015,205.5823050000002,206.66300799999985,209.22286500000007,210.37,71784536,117197425.25,54.72627877451534,1.5,2.75,2.089880473209321,0.612509497088973,0.06986661339642057,0.4935351104372785,0.4236684970408579,17.469442845795633,2.4490194165284467,9250926999.0,2015-03-23,2015,0,82,3,0.53,210.56,210.4,208.74,3827
2015-03-24 13:30:00,209.85,210.4,208.74,208.82,222.326046511628,211.93177777777782,200.99330700000016,205.68640500000018,206.7544079999998,209.07336500000005,207.3939494429114,208.7187934622324,207.99978461538467,211.77831339854492,204.22125583222441,200.99330700000016,205.68640500000018,206.7544079999998,209.07336500000005,209.32,77805321,117464078.15,51.11376268690958,1.5,2.75,2.059174725122941,0.662375444692493,0.01775032155538236,0.4458563989850859,0.4281060774297035,14.450233713340447,2.1124694376528086,9173121678.0,2015-03-24,2015,1,83,3,0.8,209.57,209.35,205.71,3828
2015-03-25 13:30:00,209.07,209.35,205.71,205.76,222.69674418604657,211.9155555555556,201.04420700000014,205.76290500000016,206.81660799999986,208.7798650000001,207.32987299416982,208.43700360868644,207.86593846153846,211.8247695784851,203.907107344592,201.04420700000014,205.76290500000016,206.81660799999986,208.7798650000001,206.94,159521708,121787079.2,43.15772986205058,1.5,2.75,2.172090816185587,1.3098409868097074,-0.2150306743689046,0.15931773446857278,0.3743484088374774,17.24938277015978,-0.6470304200869162,9013599970.0,2015-03-25,2015,2,84,3,1.77,207.53,206.37,204.12,3829
2015-03-26 13:30:00,204.96,206.37,204.12,205.27,204.12,211.89933333333332,201.09255700000014,205.82180500000013,206.88040799999985,208.47436500000006,207.2490936610651,208.13538421738298,207.62824615384625,211.80493780937,203.45155449832242,201.09255700000014,205.82180500000013,206.88040799999985,208.47436500000006,205.25333333333333,153067241,125805547.85,42.02956404618245,1.5,2.75,2.1776557578866163,1.2166970663527856,-0.3843445478823926,-0.10608227601551334,0.27826227186687924,15.487391180776346,-0.2707125200167881,8860532729.0,2015-03-26,2015,3,85,3,1.1,205.24,205.95,204.9,3830
2015-03-27 13:30:00,205.13,205.95,204.9,205.74,204.21205882352945,211.88311111111113,201.14665700000012,205.86260500000014,206.97800799999985,208.22836500000008,207.1899135174939,207.90725238715603,207.6867076923077,211.7327231274336,203.64069225718185,201.14665700000012,205.86260500000014,206.97800799999985,208.22836500000008,205.53,118938966,126348697.55,43.55374297757444,1.5,2.75,2.097108918037571,0.9413549035828586,-0.44286178936931736,-0.2753149648447675,0.1675468245245499,15.190969221668372,-1.3615878799501406,8979471695.0,2015-03-27,2015,4,86,3,0.51,205.42,208.61,206.96,3831
2015-03-30 13:30:00,206.98,208.61,206.96,208.25,204.30411764705883,211.8668888888889,201.22020700000016,205.9274050000002,207.16260999999986,208.04136500000007,207.2314855364157,207.9398950169507,207.97516923076927,211.5821600698441,204.36817839169444,201.22020700000016,205.9274050000002,207.16260999999986,208.04136500000007,207.94000000000003,96180365,126783144.4,50.968028261900024,1.5,2.75,2.15231542389203,0.7586210726605074,-0.29766887210778364,-0.20453926561017965,0.09312960649760398,14.829857252054124,0.13944989421042125,9075652060.0,2015-03-30,2015,0,89,3,0.8,207.79,208.1,206.36,3832
2015-03-31 13:30:00,207.26,208.1,206.36,206.43,204.39617647058827,211.85066666666668,201.28170700000015,205.98100500000015,207.25860999999983,207.80686500000007,207.2000547310661,207.79609549152678,207.9236307692308,211.59769121292544,204.24957032553615,201.28170700000015,205.98100500000015,207.25860999999983,207.80686500000007,206.96333333333337,126768703,127605289.1,46.22660731281945,1.5,2.75,2.1335786078997407,0.9934439543540832,-0.3080576632658268,-0.29194247258467954,0.01611519068114726,15.585734127999055,-1.9148531787513072,8948883357.0,2015-03-31,2015,1,90,3,0.84,207.23,206.42,204.51,3833
2015-04-01 13:30:00,206.39,206.42,204.51,205.7,204.4882352941177,211.83444444444447,201.33875700000016,206.0146050000002,207.3315099999999,207.58036000000007,207.141229055338,207.59646734947663,207.91384615384612,211.61079323914623,204.2168990685461,201.33875700000016,206.0146050000002,207.3315099999999,207.58036000000007,205.54333333333332,137303584,128745608.7,44.440823291397294,1.5,2.75,2.118322993049761,1.0664719782399847,-0.3451540782540397,-0.4153274071364024,-0.07017332888236266,13.35148732558769,-1.813842482100244,8811579773.0,2015-04-01,2015,2,91,4,0.93,205.46,206.98,205.4,3834
2015-04-02 13:30:00,205.62,206.98,205.4,206.435,204.5802941176471,211.81822222222226,201.39678200000012,206.04745500000016,207.39860999999985,207.3791100000001,207.11353379826596,207.48585141143124,207.74884615384616,211.5031629591565,203.99452934853585,201.39678200000012,206.04745500000016,207.39860999999985,207.3791100000001,206.27166666666668,86900906,129247006.15,46.67450343081282,1.5,2.75,2.0798713506890634,0.6723630093152452,-0.302766105619002,-0.4486309609061152,-0.14586485528711318,13.654686903989711,-1.8891687657430705,8898480679.0,2015-04-02,2015,3,92,4,0.77,206.19,208.45,205.21,3835
2015-04-06 13:30:00,205.37,208.45,205.21,207.83,204.67235294117646,211.802,201.4546570000001,206.0923550000002,207.43320999999986,207.3956100000001,207.14163051205944,207.5186274674854,207.73884615384617,211.4915521597707,203.98614014792165,201.4546570000001,206.0923550000002,207.43320999999986,207.3956100000001,207.16333333333333,114368155,125559014.8,50.72375137882736,1.5,2.75,2.1627376827827,0.9108717138484588,-0.16997118294088015,-0.35832883396321336,-0.1883576510223332,14.089774580288635,-1.0333333333333274,9012848834.0,2015-04-06,2015,0,96,4,1.58,206.83,208.76,207.24,3836
2015-04-07 13:30:00,207.855,208.76,207.24,207.28,204.76441176470593,211.78577777777775,201.5086570000001,206.12535500000018,207.47940999999992,207.3416100000001,207.14705676648845,207.49590104201062,207.4942307692308,210.90449095817056,204.0839705802911,201.5086570000001,206.12535500000018,207.47940999999992,207.3416100000001,207.76,81236337,125129887.0,49.13943190973664,1.5,2.75,2.1168278482982203,0.6492160981492775,-0.11121022214724374,-0.3273704287063879,-0.2161602065591441,14.108451041032211,-0.7374772531366689,8931612497.0,2015-04-07,2015,1,97,4,0.73,208.0,208.51,207.08,3837
2015-04-08 13:30:00,207.55,208.51,207.08,207.975,204.8564705882353,211.7695555555556,201.56883200000007,206.1633550000002,207.52990999999986,207.49136000000016,207.17952512858696,207.5415295142001,207.3769230769231,210.60307710650054,204.1507690473456,201.56883200000007,206.1633550000002,207.52990999999986,207.49136000000016,207.855,89351939,121741420.8,51.21310994263146,1.5,2.75,2.0677687162769174,0.7339485477731503,-0.02222619900451922,-0.24394295531479315,-0.22171675631027396,14.041088960912564,1.076496889580095,9020964436.0,2015-04-08,2015,2,98,4,0.69,207.8,209.18,207.19,3838
2015-04-09 13:30:00,207.78,209.18,207.19,208.9,204.94852941176467,211.75333333333336,201.6339320000001,206.2127550000002,207.65310999999986,207.71136000000016,207.24699473138747,207.67090765570484,207.26076923076928,210.13082912335116,204.39070933818738,201.6339320000001,206.2127550000002,207.65310999999986,207.71136000000016,208.4233333333333,85548854,120511577.6,53.90674707575329,1.5,2.75,2.0622138079714243,0.7098807907398932,0.09576508524982202,-0.10201039974799643,-0.19777548499781844,10.817883155732577,1.7684025917084791,9106513290.0,2015-04-09,2015,3,99,4,0.96,208.18,210.09,208.96,3839
2015-04-10 13:30:00,209.2,210.09,208.96,210.04,205.04058823529408,211.73711111111112,201.71063200000012,206.27125500000028,207.85110999999992,207.8583600000001,207.35652434976444,207.8965354980186,207.26384615384617,210.1457076084997,204.38198469919263,201.71063200000012,206.27125500000028,207.85110999999992,207.8583600000001,209.6966666666667,72722915,119448047.2,57.05383006770849,1.5,2.75,1.9999128216877504,0.6088246455652395,0.2392547904331753,0.10129300304365074,-0.1379617873895246,10.71791387185649,2.0900165257120555,9179236205.0,2015-04-10,2015,4,100,4,0.54,209.52,210.63,209.03,3840
2015-04-13 13:30:00,209.87,210.63,209.03,209.09,205.13264705882355,211.72088888888888,201.7781820000001,206.31975500000019,207.99310599999993,208.02150000000012,207.42450378702858,208.01019878392162,207.2846153846154,210.2145286454615,204.35470212376927,201.7781820000001,206.31975500000019,207.99310599999993,208.02150000000012,209.58333333333331,74436594,115049332.25,53.75976883972686,1.5,2.75,1.9713476201386249,0.6469971841144693,0.2572802169745129,0.18363848382861647,-0.0736417331458964,11.410722657411785,0.4033613445378168,9104799611.0,2015-04-13,2015,0,103,4,0.77,209.83,209.71,208.1,3841
2015-04-14 13:30:00,208.85,209.71,208.1,209.49,205.2247058823529,211.70466666666667,201.8484320000001,206.37095500000027,208.19390599999988,208.06700000000012,207.5055036385177,208.15113223307202,207.5715384615385,210.57759999073502,204.565476932342,201.8484320000001,206.37095500000027,208.19390599999988,208.06700000000012,209.1,75099866,111999365.95,54.93944940993496,1.5,2.75,1.94553707584301,0.6705383138823028,0.2812895941620511,0.27797025955666754,-0.0033193346053835976,9.27918700568845,1.4823426827496011,9179899477.0,2015-04-14,2015,1,104,4,0.77,208.9,211.04,209.95,3842
2015-04-15 13:30:00,210.05,211.04,209.95,210.43,205.31676470588238,211.68844444444446,201.92148200000008,206.41975500000026,208.36410599999988,208.19050000000016,207.62018977034046,208.36816725849368,207.96846153846158,211.01648330454384,204.92043977237927,201.92148200000008,206.41975500000026,208.36410599999988,208.19050000000016,210.47333333333336,99529320,112250310.85,57.67233403206329,1.5,2.75,1.9172844275685081,0.8866730011376178,0.3416114070378888,0.4236949241919774,0.08208351715408861,7.289596894374754,2.2994652406417204,9279428797.0,2015-04-15,2015,2,105,4,0.52,210.5,210.98,209.7928,3843
2015-04-16 13:30:00,210.03,210.98,209.7928,210.37,205.40882352941173,211.67222222222225,201.99473200000008,206.47125500000027,208.47470599999988,208.18600000000012,207.7280254656213,208.55881799578,208.3246153846154,211.32954840971558,205.3196823595153,201.99473200000008,206.47125500000027,208.47470599999988,208.18600000000012,210.38093333333333,68934864,104256627.85,57.4328957450494,1.5,2.75,1.8651355398850424,0.6612036608279769,0.3569347166911603,0.528251913018039,0.1713171963268787,6.605779605012245,1.9061690120376884,9210493933.0,2015-04-16,2015,3,106,4,0.57,210.39,209.23,207.01,3844
2015-04-17 13:30:00,208.94,209.23,207.01,207.95,205.50088235294118,211.65599999999998,202.04933200000008,206.49495500000026,208.55250599999994,208.1085000000001,207.7367303493224,208.50083532951527,208.30153846153846,211.31300982342742,205.29006709964952,202.04933200000008,206.49495500000026,208.55250599999994,208.1085000000001,208.06333333333333,191113230,107916424.25,48.65821984934589,1.5,2.75,1.9719115727503973,1.7709373835188016,0.1918273500482796,0.41110138388722817,0.21927403383894856,10.212658441042263,0.057739498628675424,9019380703.0,2015-04-17,2015,4,107,4,1.07,208.12,210.25,208.96,3845
2015-04-20 13:30:00,209.06,210.25,208.96,209.85,205.59294117647062,211.63977777777782,202.11243200000007,206.5266550000002,208.6271059999999,208.08050000000014,207.8196036689568,208.62932720289476,208.5646153846154,211.47187277987203,205.65735798935881,202.11243200000007,206.5266550000002,208.6271059999999,208.08050000000014,209.68666666666667,92189481,103640144.25,54.5317778528764,1.5,2.75,1.995346460411084,0.8895151745217684,0.1975398263713326,0.4661988168031144,0.26865899043178176,10.792308040044338,1.2398687765341534,9111570184.0,2015-04-20,2015,0,110,4,0.62,209.6,210.86,209.24,3846
2015-04-21 13:30:00,210.67,210.86,209.24,209.6,205.685,211.6235555555556,202.16943200000009,206.55005500000019,208.70810599999996,208.0605000000002,207.88942313291932,208.72177223119044,208.8646153846154,211.29300345887341,206.4362273103574,202.16943200000009,206.55005500000019,208.70810599999996,208.0605000000002,209.9,72559831,103678909.0,53.6618818623025,1.5,2.75,1.96853599895315,0.6998514133670137,0.172361203056408,0.4841104942522918,0.3117492911958838,10.645307421461007,0.7813439115278279,9039010353.0,2015-04-21,2015,1,111,4,0.77,210.05,210.85,208.9,3847
2015-04-22 13:30:00,210.01,210.85,208.9,210.63,205.77705882352944,211.60733333333332,202.23503200000007,206.58525500000027,208.82810599999996,208.15100000000018,207.99689673554988,208.90350820917237,209.1873076923077,211.33746552334813,207.03714986126732,202.23503200000007,206.58525500000027,208.82810599999996,208.15100000000018,210.1266666666667,78264616,103701873.75,56.72482150989642,1.5,2.75,1.967211999027924,0.7547078289894449,0.2104343056280729,0.5747921732309749,0.36435786760290206,10.800577703662643,0.8281474389660075,9117274969.0,2015-04-22,2015,2,112,4,0.93,209.88,211.94,210.01,3848
2015-04-23 13:30:00,210.15,211.94,210.01,211.16,205.86911764705883,211.59111111111113,202.30963200000008,206.62045500000028,208.91510599999995,208.4210000000002,208.1209400008225,209.1184121892512,209.4434615384616,211.6775725632625,207.2093505136607,202.30963200000008,206.62045500000028,208.91510599999995,208.4210000000002,211.03666666666663,102585942,100855085.45,58.25393228476736,1.5,2.75,1.9645539990973584,1.017161817297335,0.25376805538840264,0.6815679368384053,0.4277998814500027,10.649717535199137,0.5332317653780254,9219860911.0,2015-04-23,2015,3,113,4,0.92,210.98,211.97,211.11,3849
2015-04-24 13:30:00,211.66,211.97,211.11,211.6499,205.96117647058827,211.5748888888889,202.3822815000001,206.66495400000028,209.00950399999996,208.7399950000002,208.2593305890255,209.3595062664653,209.7796076923077,211.92368353838697,207.63553184622845,202.3822815000001,206.66495400000028,209.00950399999996,208.7399950000002,211.57663333333332,61327387,96268092.75,59.67239765005025,1.5,2.75,1.8856572848761175,0.6370479070283648,0.2949899730735498,0.79653734779194,0.5015473747183902,10.327825031967533,1.2243053230666214,9281188298.0,2015-04-24,2015,4,114,4,0.41,211.54,212.48,210.54,3850
2015-04-27 13:30:00,212.33,212.48,210.54,210.77,206.0532352941177,212.48,202.45443150000008,206.71505400000026,209.04650399999997,208.99149500000019,208.35778821298527,209.49383900299244,209.9946076923077,211.92124621651917,208.06796916809628,202.45443150000008,206.71505400000026,209.04650399999997,208.99149500000019,211.2633333333333,79358126,94289050.75,55.99243763835077,1.5,2.75,1.8895389073849664,0.8416473107827952,0.2446375365695146,0.8073442954302834,0.5627067588607688,10.261014530889495,0.6110076853310425,9201830172.0,2015-04-27,2015,0,117,4,0.92,211.51,211.5,209.3301,3851
2015-04-28 13:30:00,210.74,211.5,209.3301,211.44,206.1452941176471,212.48571428571427,202.5285815000001,206.75860400000028,209.07970399999996,209.1509950000002,208.47865926345642,209.67918766937413,210.1899923076923,212.1478960540268,208.2320885613578,202.5285815000001,206.75860400000028,209.07970399999996,209.1509950000002,210.7567,86863531,93823209.05,58.110788831125966,1.5,2.75,1.9095646997146127,0.9258213599761752,0.2378810455948053,0.8600580658542754,0.6221770202594701,10.336149625329313,0.4799695860856298,9288693703.0,2015-04-28,2015,1,118,4,1.04,210.42,211.29,209.6,3852
2015-04-29 13:30:00,210.37,211.29,209.6,210.57,206.23735294117645,212.49142857142857,202.59343150000007,206.78540400000026,209.08890399999996,209.35799500000016,208.56067262567382,209.76402693895758,210.23076153846162,212.19653079257637,208.26499228434682,202.59343150000007,206.78540400000026,209.08890399999996,209.35799500000016,210.48666666666668,125684903,93769019.05,54.445867128394156,1.5,2.75,1.9045957925921408,1.3403670452495793,0.15998245380503795,0.8221550875157675,0.6621726337107295,10.432747158997678,0.09507058991300502,9163008800.0,2015-04-29,2015,2,119,4,0.81,210.44,210.35,207.62,3853
2015-04-30 13:30:00,209.88,210.35,207.62,208.46,206.32941176470592,212.49714285714282,202.64958150000007,206.79340400000027,209.05550399999996,209.49599500000016,208.556724679569,209.6398338971521,210.1823,212.28449937871207,208.08010062128795,202.64958150000007,206.79340400000027,209.05550399999996,209.49599500000016,208.81000000000003,161304890,94969084.35,46.74574061171401,1.5,2.75,1.9792675216927007,1.6984989494636529,-0.037921591128410204,0.6147706448002168,0.6526922359286271,11.950406141412644,0.24525126232268304,9001703910.0,2015-04-30,2015,3,120,4,1.31,208.98,210.77,209.28,3854
2015-05-01 13:30:00,209.4,210.77,209.28,210.72,206.4214705882353,212.50285714285712,202.71338150000008,206.82060400000026,209.07030399999996,209.71024500000016,208.64155900586042,209.74270685932805,210.2769153846154,212.3565604961813,208.19727027304947,202.71338150000008,206.82060400000026,209.07030399999996,209.71024500000016,210.25666666666663,103399711,95794024.6,54.21484158062321,1.5,2.75,2.0028912701432224,1.0793962507761679,-0.02169865028387297,0.6255689230737858,0.6472675733576587,11.534079276061325,0.4145818441744125,9105103621.0,2015-05-01,2015,4,121,5,0.71,210.02,212.02,211.1,3855
2015-05-04 13:30:00,211.23,212.02,211.1,211.32,206.51352941176467,212.50857142857143,202.79143150000007,206.86770400000026,209.07192399999997,209.88474500000012,208.7465959075913,209.89292525367776,210.34537692307697,212.4979898014708,208.19276404468312,202.79143150000007,206.86770400000026,209.07192399999997,209.88474500000012,211.48,70927235,93621978.6,55.980030579733324,1.5,2.75,1.9526847508472789,0.7575917114830129,0.0219966372268976,0.6747633698912807,0.6527667326643831,10.507323463691733,0.8206106870229003,9176030856.0,2015-05-04,2015,0,124,5,0.44,211.56,211.46,208.73,3856
2015-05-05 13:30:00,211.03,211.46,208.73,208.9,206.60558823529408,212.5142857142857,202.84738200000007,206.89200400000027,209.02574399999992,209.9657450000001,208.75261175435244,209.7983609438037,210.23230000000007,212.51817281701005,207.9464271829901,202.84738200000007,206.89200400000027,209.02574399999992,209.9657450000001,209.6966666666667,113326156,95226469.55,47.95021060057878,1.5,2.75,2.008207268643903,1.1900699095065843,-0.11215899928915364,0.5125679835529411,0.6247269828420947,12.636336101053214,-0.8213454873474765,9062704700.0,2015-05-05,2015,1,125,5,1.31,210.1,209.93,206.76,3857
2015-05-06 13:30:00,209.56,209.93,206.76,208.04,206.76,212.52,202.90088200000008,206.94080300000027,208.95034399999997,209.96899500000006,208.72466619535822,209.63089799677482,210.23922307692314,212.49778696124267,207.9806591926036,202.90088200000008,206.94080300000027,208.95034399999997,209.96899500000006,208.2433333333333,135060151,97511880.15,45.45491883841882,1.5,2.75,2.0911924637407684,1.3850635511513103,-0.25094430069001705,0.3110466069795734,0.5619909076695905,12.326330262856887,-1.4775525667740124,8927644549.0,2015-05-06,2015,2,126,5,1.53,208.34,209.38,207.52,3858
2015-05-07 13:30:00,207.92,209.38,207.52,208.87,206.8542857142857,212.52571428571426,202.9542320000001,206.98760300000026,208.895144,209.96749500000016,208.73036556024613,209.55843152089142,210.16383846153846,212.53209068767083,207.79558623540626,202.9542320000001,206.98760300000026,208.895144,209.96749500000016,208.59,88244940,97646684.45,48.25373361580244,1.5,2.75,2.0746787163307125,0.9037167057647086,-0.27693222684398056,0.2158256241146148,0.4927578509585954,12.516690181647961,-1.3134426238802843,9015889489.0,2015-05-07,2015,3,127,5,0.9,208.45,211.86,210.78,3859
2015-05-08 13:30:00,210.88,211.86,210.78,211.62,206.94857142857143,212.53142857142856,203.01913200000013,207.09490300000027,208.899944,210.0464950000001,208.84368455788356,209.75477137604463,210.31922307692315,212.78228097397232,207.856165179874,203.01913200000013,207.09490300000027,208.899944,210.0464950000001,211.42,155877260,101804401.7,56.26166116816664,1.5,2.75,2.1400588080213767,1.5311446007938183,-0.10769751431695207,0.3581359580624053,0.4658334723793574,14.882695824674132,0.4032831996963488,9171766749.0,2015-05-08,2015,4,128,5,0.51,211.32,211.89,210.52,3860
2015-05-11 13:30:00,211.57,211.89,210.52,210.605,207.04285714285717,212.53714285714284,203.07890700000016,207.20585300000027,208.898844,210.12224500000008,208.91275575169206,209.83574553070702,210.31730000000005,212.77942317634967,207.8551768236504,203.07890700000016,207.20585300000027,208.898844,210.12224500000008,211.005,75708065,101867975.25,53.00144174272553,1.5,2.75,2.0850546074484195,0.7431978972213841,-0.06500063708683579,0.38458267602081264,0.4495833131076484,14.952437852389126,-0.3949110858872531,9096058684.0,2015-05-11,2015,0,131,5,0.65,211.2,210.63,208.62,3861
2015-05-12 13:30:00,209.61,210.63,208.62,209.98,207.13714285714283,212.54285714285714,203.14020700000012,207.32655300000027,208.858644,210.14674500000007,208.95460846731197,209.8494840515921,210.22653076923083,212.64429735133518,207.80876418712646,203.14020700000012,207.32655300000027,208.858644,210.14674500000007,209.7433333333333,119727592,104099361.55,51.04013834277907,1.5,2.75,2.0796935640592458,1.1501280144018329,-0.07881642594416832,0.351062780677438,0.4298792066216064,14.879276634451875,-0.28019186018901243,8976331092.0,2015-05-12,2015,1,132,5,0.96,209.62,211.22,209.74,3862
2015-05-13 13:30:00,210.47,211.22,209.74,210.02,207.23142857142852,212.54857142857142,203.20130700000013,207.40885300000028,208.836644,210.12624500000007,208.99638852741737,209.8657236657262,210.10115384615392,212.3754589939836,207.82684869832426,203.20130700000013,207.40885300000028,208.836644,210.12624500000007,210.32666666666668,94667943,103856292.7,51.16469177176703,1.5,2.75,2.0368583094835846,0.9115282332815255,-0.08471062757502046,0.3239909221528308,0.4087015497278512,14.720861623379102,0.7483450062362095,9070999035.0,2015-05-13,2015,2,133,5,0.71,210.48,212.32,210.91,3863
2015-05-14 13:30:00,211.24,212.32,210.91,212.21,207.32571428571427,212.5542857142857,203.2776070000001,207.46315300000026,208.87624199999996,210.21824500000008,209.12241250673432,210.08898807851415,210.21192307692314,212.73266026601812,207.69118588782814,203.2776070000001,207.46315300000026,208.87624199999996,210.21824500000008,211.81333333333333,95934006,105206249.8,57.53442599719802,1.5,2.75,2.0556541445204703,0.9118660363084248,0.0520703018536553,0.4737894270449203,0.421719125191265,14.408646218496964,0.7070994684889944,9166933041.0,2015-05-14,2015,3,134,5,0.67,211.62,212.61,211.86,3864
2015-05-15 13:30:00,212.44,212.61,211.86,212.44,207.42,212.56,203.3549070000001,207.52235300000018,208.915842,210.4427450000001,209.2525139770585,210.31289397579852,210.28884615384624,213.0080150140107,207.56967729368176,203.3549070000001,207.52235300000018,208.915842,210.4427450000001,212.30333333333337,76510099,99476093.25,58.151777905927545,1.5,2.75,1.9623931341975795,0.7691305166932659,0.145905657180124,0.60410119666642,0.458195539486296,13.220728627548382,0.5300018928639052,9243443140.0,2015-05-15,2015,4,135,5,0.35,212.24,213.4,212.16,3865
2015-05-18 13:30:00,212.24,213.4,212.16,213.1,207.5142857142857,212.56571428571425,203.45495700000012,207.5786530000002,209.027842,210.60524500000008,209.40339578187968,210.5783326447701,210.4834615384616,213.5898454976516,207.37707757927163,203.45495700000012,207.5786530000002,209.027842,210.60524500000008,212.88666666666663,74549685,98594103.45,59.951013798660256,1.5,2.75,1.9107936246120387,0.7561272164496771,0.2350136012067661,0.7519625409947537,0.5169489397879876,13.236047121263368,2.010531354715169,9317992825.0,2015-05-18,2015,0,138,5,0.58,212.78,213.57,212.69,3866
2015-05-19 13:30:00,213.24,213.57,212.69,213.03,207.60857142857142,212.57142857142856,203.5576070000001,207.6314530000002,209.121242,210.77674500000006,209.5456155551393,210.81182477383962,210.83500000000006,213.97996912057167,207.69003087942843,203.5576070000001,207.6314530000002,209.121242,210.77674500000006,213.09666666666664,72114610,98571842.4,59.65804665852682,1.5,2.75,1.8371655085683207,0.7315944213293917,0.2693647716236736,0.8536549043175796,0.5842901326939061,10.741941743467807,2.3985771966929486,9245878215.0,2015-05-19,2015,1,139,5,0.41,213.13,213.78,212.50400000000002,3867
2015-05-20 13:30:00,213.15,213.78,212.50400000000002,212.88,207.70285714285717,213.78,203.6525570000001,207.68255300000015,209.279242,210.88924500000007,209.67637572944759,211.00879384299773,211.00115384615398,214.3272792285236,207.6750284637843,203.6525570000001,207.68255300000015,209.279242,210.88924500000007,213.05466666666663,76857530,98501488.1,58.99277486999205,1.5,2.75,1.7970822579562993,0.7802677044023257,0.26187536213430085,0.9116343353617822,0.6497589732274813,10.200129902396359,1.9198544549241108,9169020685.0,2015-05-20,2015,2,140,5,0.6,213.14,213.75,212.51,3868
2015-05-21 13:30:00,212.71,213.75,212.51,213.5,207.79714285714283,213.85647058823528,203.7600070000001,207.7331530000002,209.459242,211.00624500000006,209.82632177927317,211.2460515722361,211.16884615384623,214.75223121839417,207.58546108929832,203.7600070000001,207.7331530000002,209.459242,211.00624500000006,213.25333333333333,64764585,96610420.25,60.93203462896347,1.5,2.75,1.7572906681022784,0.6703685258009215,0.2770964291848228,0.99612950970851,0.7190330805236871,10.153976281555833,0.8883848407522896,9233785270.0,2015-05-21,2015,3,141,5,0.58,213.13,213.54,212.91,3869
2015-05-22 13:30:00,213.04,213.54,212.91,212.99,207.89142857142852,213.9329411764706,203.86460700000006,207.77585300000018,209.577042,211.0732500000001,209.9503875918507,211.41214189868975,211.4834615384616,214.9303896795128,208.03653339741047,203.86460700000006,207.77585300000018,209.577042,211.0732500000001,213.14666666666668,57433495,96415725.65,58.48206082242106,1.5,2.75,1.6767699060949723,0.5956859694080412,0.23300855054220604,1.0102937687014446,0.7772852181592386,7.666052963027671,1.1324517461598822,9176351775.0,2015-05-22,2015,4,142,5,0.3,213.22,212.9089,210.2,3870
2015-05-26 13:30:00,212.4,212.9089,210.2,210.7,207.98571428571427,214.00941176470587,203.96295700000007,207.80685300000027,209.674498,211.06975000000003,209.9797841568761,211.3443188607193,211.688076923077,214.5611014309114,208.81505241524258,203.96295700000007,207.80685300000027,209.674498,211.06975000000003,211.26963333333333,124308584,98663248.55,48.962272031897214,1.5,2.75,1.7562863413739045,1.2599279450747418,0.039931617979627736,0.8271997406337732,0.7872681226541455,9.720868993831264,0.3428897990284784,9052043191.0,2015-05-26,2015,1,146,5,1.29,211.55,212.98,210.7612,3871
2015-05-27 13:30:00,211.25,212.98,210.7612,212.7,208.08,214.08588235294118,204.06025700000006,207.87845300000026,209.756898,211.13275000000004,210.08645928797904,211.47343135017465,211.98269230769242,214.38656295375617,209.57882166162858,204.06025700000006,207.87845300000026,209.756898,211.13275000000004,212.14706666666663,93213981,98980771.05,55.73879716927918,1.5,2.75,1.7936944598471969,0.9417382791745792,0.03727941021016512,0.8338673854168519,0.7965879752066868,10.854030129300556,1.2760689458146741,9145257172.0,2015-05-27,2015,2,147,5,1.05,211.87,212.59,211.63,3872
2015-05-28 13:30:00,212.33,212.59,211.63,212.46,208.1742857142857,214.16235294117647,204.15358200000009,207.94875300000018,209.846898,211.22725000000003,210.17953931590145,211.5673902692056,212.04730769230773,214.45386480983097,209.6407505747846,204.15358200000009,207.94875300000018,209.846898,211.22725000000003,212.2266666666667,74974560,96445253.9,54.79853151894449,1.5,2.75,1.7420019984295396,0.7773794662590442,0.01108422964659106,0.8104432622649256,0.7993590326183345,10.928774186476906,0.11780783186466234,9070282612.0,2015-05-28,2015,3,148,5,0.45,212.11,212.43,210.82,3873
2015-05-29 13:30:00,212.38,212.43,210.82,211.14,208.26857142857145,214.23882352941175,204.24163200000007,208.04295300000018,209.860498,211.36125000000007,210.217204440768,211.5266864340432,212.08846153846162,214.41181251570882,209.7651105612145,204.24163200000007,208.04295300000018,209.860498,211.36125000000007,211.4633333333333,124919611,94625989.95,49.820595967644024,1.5,2.75,1.7347161413988592,1.3201405984339718,-0.09744237563507517,0.6775560630744906,0.7749984387095658,9.913353264838475,-0.6119374882319767,8945363001.0,2015-05-29,2015,4,149,5,0.76,211.62,212.34,210.62,3874
2015-06-01 13:30:00,211.94,212.34,210.62,211.57,208.36285714285717,214.31529411764703,204.3252820000001,208.1604530000002,209.901898,211.40375000000003,210.27025524701241,211.53081153556286,212.2107692307693,214.22396357791737,210.19757488362134,204.3252820000001,208.1604530000002,209.901898,211.40375000000003,211.51,93338750,94122941.9,51.37034282634176,1.5,2.75,1.7336649884417976,0.991668429777374,-0.1399805763591353,0.6000227182606466,0.7400032946197819,9.983739765124486,-0.7179727827311128,9038701751.0,2015-06-01,2015,0,152,6,0.82,211.48,212.19,210.27,3875
2015-06-02 13:30:00,211.02,212.19,210.27,211.36,208.45714285714283,214.39176470588242,204.40328200000008,208.25095300000015,209.920898,211.40575000000004,210.31299033536487,211.5145437702712,212.31384615384624,213.97408781304532,210.65360449464714,204.40328200000008,208.25095300000015,209.920898,211.40575000000004,211.2733333333333,91531012,95153130.75,50.54926256377943,1.5,2.75,1.7469746321245254,0.961933793229394,-0.17945286153596895,0.5156872176998206,0.6951400792357896,9.730578456915877,-0.7839271464112977,8947170739.0,2015-06-02,2015,1,153,6,0.91,211.23,212.67,211.3301,3876
2015-06-03 13:30:00,212.0,212.67,211.3301,211.92,208.55142857142852,214.46823529411762,204.48428200000006,208.31115300000016,209.959298,211.55675000000005,210.3760103222133,211.5531586492929,212.29153846153855,213.9645062741181,210.61857064895904,204.48428200000006,208.31115300000016,209.959298,211.55675000000005,211.9733666666666,87820909,93877868.4,52.71950656495803,1.5,2.75,1.7178978726870593,0.9354804332135858,-0.16538567732000453,0.4884079825857839,0.6537936599057884,9.932652133348713,-0.4509582863585156,9034991648.0,2015-06-03,2015,2,154,6,0.63,212.0,211.859,209.75,3877
2015-06-04 13:30:00,211.07,211.859,209.75,210.1292,208.64571428571426,214.54470588235299,204.54812800000008,208.36994500000011,209.985482,211.66121000000007,210.3663314860481,211.41754353983652,212.11378461538467,214.1396999782887,210.08786925248074,204.54812800000008,208.36994500000011,209.985482,211.66121000000007,210.5794,151882820,94719001.85,45.79764816830881,1.5,2.75,1.7501908817808403,1.6035095074220318,-0.26814403265192466,0.3186136190908826,0.5867576517428073,10.935469461851563,-1.5788290398126477,8883108828.0,2015-06-04,2015,3,155,6,1.01,210.8,210.58,208.98,3878
2015-06-05 13:30:00,209.95,210.58,208.98,209.77,208.74,214.62117647058827,204.6050280000001,208.44114500000012,210.06568199999998,211.70621000000008,210.34294593757562,211.26063463128062,211.8576307692309,214.14517534925722,209.57008618920455,204.6050280000001,208.44114500000012,210.06568199999998,211.70621000000008,209.77666666666667,121704676,96391988.65,44.53459167992232,1.5,2.75,1.7394629616536388,1.2626015678741782,-0.34676708808725,0.1532987916337447,0.5000658797209947,10.601958624621805,-1.5118080661063893,8761404152.0,2015-06-05,2015,4,156,6,0.77,209.78,209.82,208.39,3879
2015-06-08 13:30:00,209.64,209.82,208.39,208.48,208.8342857142857,214.69764705882355,204.65282800000008,208.50514500000008,210.12988199999998,211.54921000000007,210.26988923414132,210.9958122854444,211.50763076923084,214.30588493199954,208.70937660646214,204.65282800000008,208.50514500000008,210.12988199999998,211.54921000000007,208.89666666666665,89063330,93051292.15,40.24219969446831,1.5,2.75,1.7173584643926652,0.9571423237887836,-0.4647521837854717,-0.08087435001084486,0.3838778337746268,10.90056311050092,-1.0536307546274322,8672340822.0,2015-06-08,2015,0,159,6,0.69,209.1,209.1,207.69,3880
2015-06-09 13:30:00,208.45,209.1,207.69,208.45,207.69,214.77411764705883,204.69757800000008,208.5810450000001,210.184082,211.44146000000006,210.19852102888083,210.75335397254486,211.1668615384616,214.27537771138782,208.0583453655354,204.69757800000008,208.5810450000001,210.184082,211.44146000000006,208.41333333333333,105034690,94517623.4,40.14529322695733,1.5,2.75,1.6954042883646174,1.1112709590199026,-0.5197541494266095,-0.26581485300863505,0.2539392964179744,9.4175297127841,-1.998119417019276,8567306132.0,2015-06-09,2015,1,160,6,0.68,208.4,211.41,209.2987,3881
2015-06-10 13:30:00,209.37,211.41,209.2987,210.95,207.73043478260868,214.8505882352941,204.75637800000007,208.7003460000001,210.238082,211.48996000000008,210.2279907924541,210.77208216563588,210.9707076923077,213.77222585929397,208.16918952532157,204.75637800000007,208.7003460000001,210.238082,211.48996000000008,210.5529,134551285,95258808.05,50.78182404487307,1.5,2.75,1.785732553481431,1.4124812996754688,-0.369752901107909,-0.20825182996691186,0.16150107114099715,10.474093114844273,-0.7107220182622702,8701857417.0,2015-06-10,2015,2,161,6,1.01,210.35,212.09,211.2,3882
2015-06-11 13:30:00,211.48,212.09,211.2,211.63,207.7708695652174,214.92705882352942,204.81352800000008,208.8003460000001,210.34208199999998,211.57046000000008,210.28297154569125,210.85378862605148,210.86609230769238,213.45140503270557,208.28077958267914,204.81352800000008,208.8003460000001,210.34208199999998,211.57046000000008,211.64,73876447,94219233.25,53.21706930703332,1.5,2.75,1.73960879966133,0.7840909382480036,-0.21442832964677955,-0.10653434091747728,0.10789398872930228,10.72165839315539,0.23207350573079905,8775733864.0,2015-06-11,2015,3,162,6,0.42,211.64,211.482,209.68,3883
2015-06-12 13:30:00,210.64,211.482,209.68,210.01,207.81130434782608,215.00352941176476,204.86192800000006,208.8798960000001,210.428282,211.46046000000007,210.2722667791936,210.7734278045228,210.81301538461545,213.43781840651948,208.18821236271145,204.86192800000006,208.8798960000001,210.428282,211.46046000000007,210.39066666666668,135382369,96191651.4,47.22251264853786,1.5,2.75,1.7546367425426628,1.4074232745732858,-0.2102014743105887,-0.1548578541589336,0.05534362015165509,11.038009881860757,-0.7373446140757207,8640351495.0,2015-06-12,2015,4,163,6,0.86,210.58,209.45,207.79,3884
2015-06-15 13:30:00,208.64,209.45,207.79,209.11,207.8517391304348,215.08,204.90622800000008,208.94019600000007,210.48178199999998,211.29396000000008,210.22668768981342,210.61500610885395,210.5368615384616,213.06299135978972,208.01073171713352,204.90622800000008,208.94019600000007,210.48178199999998,211.29396000000008,208.78333333333333,124384184,98585355.65,44.24095772746893,1.5,2.75,1.787876975218187,1.2616902701207628,-0.25447350930546264,-0.26274826648017324,-0.008274757174710573,11.095837537493713,-1.0645344436033308,8515967311.0,2015-06-15,2015,0,166,6,0.8,208.62,210.35,208.72,3885
2015-06-16 13:30:00,208.93,210.35,208.72,210.25,207.89217391304348,215.15647058823532,204.95677800000007,208.98169600000008,210.530182,211.15146000000007,210.22760189805598,210.58024362229642,210.36686153846162,212.63689756604165,208.0968255108816,204.95677800000007,208.98169600000008,210.530182,211.15146000000007,209.7733333333333,85308227,99123282.75,48.66251576301996,1.5,2.75,1.7766000484168871,0.8606275401023278,-0.19605486515930007,-0.2533433386238357,-0.05728847346453561,11.72721272221543,-0.7880332200830443,8601275538.0,2015-06-16,2015,1,167,6,0.78,209.54,211.32,209.36,3886
2015-06-17 13:30:00,210.59,211.32,209.36,210.59,207.93260869565216,215.2329411764706,205.00617800000006,209.03789600000007,210.59638199999998,211.02946000000009,210.2418135883283,210.5811728011253,210.32455384615398,212.55554086831845,208.09356682398945,205.00617800000006,209.03789600000007,210.59638199999998,211.02946000000009,210.4233333333333,126708635,101852984.0,49.93757584234601,1.5,2.75,1.7897000449585363,1.244034588127531,-0.12694137699355906,-0.21596519470648445,-0.08902381771292539,11.64002875038873,0.21929365361882408,8727984173.0,2015-06-17,2015,2,168,6,0.94,210.34,213.34,210.6315,3887
2015-06-18 13:30:00,211.31,213.34,210.6315,212.78,207.97304347826088,213.34,205.06702800000005,209.11119600000006,210.69248199999998,211.0244600000001,210.3413503103546,210.79058491530392,210.41763076923087,212.9316953096109,207.90356622885085,205.06702800000005,209.11119600000006,210.69248199999998,211.0244600000001,212.2505,165867949,106303504.95,57.29498380852871,1.5,2.75,1.8582928988900695,1.5603243663321942,0.06360439209426931,-0.00951832759508875,-0.07312271968935806,11.999232306504414,1.4349048958382946,8893852122.0,2015-06-18,2015,3,169,6,1.29,211.99,211.55,210.36,3888
2015-06-19 13:30:00,211.46,211.55,210.36,210.81,208.0134782608696,213.31799999999998,205.11857800000004,209.19189600000007,210.73068199999997,210.8899600000001,210.3597287295564,210.79243397098926,210.37532307692317,212.84260537397103,207.9080407798753,205.11857800000004,209.19189600000007,210.73068199999997,210.8899600000001,210.90666666666664,130478689,109589210.15,50.15447087070082,1.5,2.75,1.8984148346836356,1.190616200458125,0.05464638949537711,-0.004814732820136669,-0.05946112231551377,13.391630190317805,1.11761320030699,8763373433.0,2015-06-19,2015,4,170,6,0.57,210.96,212.59,211.64,3889
2015-06-22 13:30:00,211.905,212.59,211.64,211.89,208.05391304347827,213.296,205.17697750000008,209.30939600000008,210.767682,210.8349600000001,210.41973936761303,210.89696406899026,210.37301538461543,212.8345637676923,207.91146700153857,205.17697750000008,209.30939600000008,210.767682,210.8349600000001,212.04,70696027,110252336.75,53.570701220407074,1.5,2.75,1.889956632206233,0.6412202143189496,0.1156322056006181,0.08507913468525885,-0.03055307091535925,12.894304217380428,1.6502758455265043,8834069460.0,2015-06-22,2015,0,173,6,0.45,212.12,212.44,211.57,3890
2015-06-23 13:30:00,212.14,212.44,211.57,212.04,208.09434782608696,213.274,205.2316275000001,209.40989400000007,210.82668199999998,210.90196000000012,210.4832790002557,211.0058246338484,210.52000000000007,213.129509237701,207.9104907622992,205.2316275000001,209.40989400000007,210.82668199999998,210.90196000000012,212.01666666666665,68476797,107460747.4,54.041825936424964,1.5,2.75,1.8171025870486448,0.6372261375133521,0.15764649844116935,0.16650505213610245,0.008858553694933092,12.860920217062011,0.5167101208817272,8902546257.0,2015-06-23,2015,1,174,6,0.41,212.0,212.17,210.47,3891
2015-06-24 13:30:00,211.72,212.17,210.47,210.5,208.13478260869564,213.252,205.28117750000007,209.52039400000007,210.846882,210.79196000000016,210.48393472573585,210.9576508591961,210.57615384615397,213.1498615991185,208.0024460931894,205.28117750000007,209.52039400000007,210.846882,210.79196000000016,211.04666666666668,92307318,107415414.25,48.590419554633044,1.5,2.75,1.8087381165451697,0.8593488992665688,0.07735618927246324,0.10555379028551216,0.028197601013048905,11.974761921517551,-0.5339507631243187,8810238939.0,2015-06-24,2015,2,175,6,0.81,211.32,211.25,209.77,3892
2015-06-25 13:30:00,211.1,211.25,209.77,209.86,208.1752173913044,213.23,205.33387750000009,209.5997940000001,210.83548199999998,210.6619600000001,210.4594666972756,210.85311268212985,210.6823076923078,213.00281365632242,208.36180172829327,205.33387750000009,209.5997940000001,210.83548199999998,210.6619600000001,210.2933333333333,97107361,108522054.3,46.491498865920065,1.5,2.75,1.7852568225062284,0.8948168335585959,-0.01812373728870486,0.005542929402167829,0.023666666690872692,11.857083589664974,-0.07142517022997823,8713131578.0,2015-06-25,2015,3,176,6,0.71,210.51,210.58,209.16,3893
2015-06-26 13:30:00,210.29,210.58,209.16,209.82,208.21565217391304,213.208,205.38262750000007,209.64959400000006,210.824482,210.59596000000008,210.43438957189224,210.75472099811745,210.78769230769242,212.79662855658694,208.77875605879788,205.38262750000007,209.64959400000006,210.824482,210.59596000000008,209.8533333333333,104174840,107484815.75,46.35671969615839,1.5,2.75,1.7591670494700704,0.9692051781742018,-0.07978710028230651,-0.07606720866201044,0.003719891620296061,11.02704485477028,0.33953421644109777,8608956738.0,2015-06-26,2015,4,177,6,0.68,209.87,209.828,205.33,3894
2015-06-29 13:30:00,208.045,209.828,205.33,205.42,208.25608695652173,213.18599999999998,205.40822750000007,209.6631940000001,210.773882,210.28846000000013,210.23774684358276,210.2466523316301,210.36230769230787,213.85074268500026,206.87387269961545,205.40822750000007,209.6631940000001,210.773882,210.28846000000013,206.8593333333333,202621332,112948944.85,34.50647752744119,1.5,2.75,1.954797974507922,1.7939196534247217,-0.3950855642896755,-0.4901370637417983,-0.09505149945212282,16.348289995872864,-2.2972651605231933,8406335406.0,2015-06-29,2015,0,180,6,2.19,207.58,207.32,205.28,3895
2015-06-30 13:30:00,207.26,207.32,205.28,205.85,208.29652173913044,213.164,205.44182750000007,209.66049400000009,210.693882,210.01296000000016,210.0656783399128,209.82792353814148,209.91769230769245,214.0588118430259,205.776572772359,205.44182750000007,209.66049400000009,210.693882,210.01296000000016,206.15,182925106,117518649.55,36.22234421796849,1.5,2.75,1.9608838334716407,1.5565623558512038,-0.5436893332368095,-0.7746631659981347,-0.2309738327613252,15.915914594511268,-2.250819127214022,8589260512.0,2015-06-30,2015,1,181,6,0.99,206.3,208.03,206.56,3896
2015-07-01 13:30:00,207.73,208.03,206.56,207.5,208.33695652173915,213.142,205.48442250000008,209.67999400000008,210.651882,209.79196000000016,209.96506350305347,209.6062165345089,209.72461538461556,214.0600125566217,205.3892182126094,205.48442250000008,209.67999400000008,210.651882,209.79196000000016,207.36333333333332,135979873,119926597.75,42.45266726669025,1.5,2.75,1.9765349882236676,1.1338591734542889,-0.5009253137837477,-0.8571304749910098,-0.3562051612072621,16.851674694998945,-2.4814362252091366,8725240385.0,2015-07-01,2015,2,182,7,0.71,207.3,208.27,206.81,3897
2015-07-02 13:30:00,208.07,208.27,206.81,207.31,208.37739130434784,213.12,205.51857250000003,209.7067940000001,210.585482,209.65100000000012,209.86094336567882,209.3875292455081,209.586153846154,214.10242554515182,205.06988214715614,205.51857250000003,209.7067940000001,210.585482,209.65100000000012,207.46333333333337,104373652,117551139.35,41.94454082147572,1.5,2.75,1.9396396319219773,0.8878999606225425,-0.4567402238431282,-0.9271304410111724,-0.4703902171680442,15.114132651631445,-1.6602627958825482,8620866733.0,2015-07-02,2015,3,183,7,0.71,207.54,207.65,205.53,3898
2015-07-06 13:30:00,205.77,207.65,205.53,206.72,208.4178260869565,213.09799999999998,205.54842250000004,209.7058940000001,210.496682,209.49850000000012,209.73776911604438,209.13347884117402,209.3146153846155,214.0573806629355,204.57185010629556,205.54842250000004,209.7058940000001,210.496682,209.49850000000012,206.63333333333333,117975369,117364674.0,40.33025340572095,1.5,2.75,1.9525225153561223,1.005203397063072,-0.4384667520465891,-1.0184736572262807,-0.5800069051796916,14.510991451973133,-2.439945254613237,8502891364.0,2015-07-06,2015,0,187,7,1.03,206.59,208.17,204.11,3899
2015-07-07 13:30:00,206.96,208.17,204.11,208.02,204.11,213.076,205.57942250000005,209.71679400000008,210.424084,209.47550000000015,209.6704056212975,209.0274332372527,209.11692307692317,213.84478735074998,204.3890588030964,205.57942250000005,209.71679400000008,210.424084,209.47550000000015,206.76666666666665,173820249,121602519.95,45.32349086303141,1.5,2.75,2.103056621402112,1.4294132150507295,-0.3157773670623517,-0.9747286140076312,-0.6589512469452795,14.730619079158073,-1.8958687040181013,8676711613.0,2015-07-07,2015,1,188,7,1.99,206.14,206.7645,204.25,3900
2015-07-08 13:30:00,206.42,206.7645,204.25,204.53,203.92157894736843,213.054,205.59857250000005,209.67289400000007,210.299284,209.27950000000016,209.468821087129,208.59910626227628,208.48230769230773,213.2871908100489,203.6774245745666,205.59857250000005,209.67289400000007,210.299284,209.27950000000016,205.1815,164020059,124551788.4,36.49431772915466,1.5,2.75,2.222124005587676,1.3168824077679802,-0.4390405800517889,-1.2077519720100156,-0.7687113919582267,16.91853565456928,-2.8361045130641327,8512691554.0,2015-07-08,2015,2,189,7,1.23,205.51,207.35,204.77,3901
2015-07-09 13:30:00,207.04,207.35,204.77,204.9,203.73315789473685,213.032,205.62732250000005,209.62409400000013,210.16848399999995,208.97700000000015,209.28965163273173,208.2468104277737,208.02769230769246,212.9816473948909,203.07373722049397,205.62732250000005,209.62409400000013,210.16848399999995,208.97700000000015,205.6733333333333,144113107,125029879.5,37.87602765976737,1.5,2.75,2.2648294337599837,1.1526293360940174,-0.4626636106228892,-1.3470409052368382,-0.8843772946139491,16.998856658547975,-2.363480415515109,8656804661.0,2015-07-09,2015,3,190,7,1.26,206.06,207.98,206.49,3902
2015-07-10 13:30:00,207.29,207.98,206.49,207.48,203.5447368421053,213.01,205.67467250000004,209.59779400000008,210.10668399999997,208.76950000000016,209.2186849020364,208.17378086322387,207.6884615384617,212.1138070436491,203.26311603327423,205.67467250000004,209.59779400000008,210.10668399999997,208.76950000000016,207.3166666666667,129456890,127808901.65,46.60058596699741,1.5,2.75,2.323055902777127,1.0128941593951957,-0.2805042059146722,-1.2350075520072892,-0.9545033460926171,19.092257733753268,-1.1152416356877342,8786261551.0,2015-07-10,2015,4,191,7,0.72,207.24,209.9,208.94,3903
2015-07-13 13:30:00,208.99,209.9,208.94,209.77,203.35631578947368,212.988,205.72572250000005,209.59419400000007,210.132884,208.75750000000016,209.2403051019565,208.325801733393,207.51384615384632,211.3827560656121,203.64493624208046,205.72572250000005,209.59419400000007,210.132884,208.75750000000016,209.53666666666663,106069400,126343253.2,52.920568801143204,1.5,2.75,2.3299804811501903,0.8395335509692258,0.0032187488777213336,-0.9504799099954652,-0.9536986588731866,20.327953432059296,2.1176126959400365,8892330951.0,2015-07-13,2015,0,194,7,0.46,209.42,211.05,209.65,3904
2015-07-14 13:30:00,209.72,211.05,209.65,210.68,203.16789473684213,212.96599999999998,205.79742250000007,209.60119400000008,210.132084,208.83600000000015,209.2967637254092,208.5500110921175,207.52769230769246,211.44029249641378,203.6150921189711,205.79742250000007,209.60119400000008,210.132084,208.83600000000015,210.46000000000004,81709575,124209522.75,55.19013888630097,1.5,2.75,2.263553303925177,0.6578366391799054,0.2476508308816223,-0.6441351202711587,-0.8917859511527809,15.257488696279859,2.3463687150838055,8974040526.0,2015-07-14,2015,1,195,7,0.67,210.35,211.28,210.04,3905
2015-07-15 13:30:00,210.73,211.28,210.04,210.61,202.97947368421055,212.944,205.8609725000001,209.59490400000007,210.11788399999998,208.85400000000016,209.34826318715787,208.74620051191584,207.58538461538475,211.65289653970692,203.51787269106254,205.8609725000001,209.59490400000007,210.11788399999998,208.85400000000016,210.64333333333335,97914141,124839818.45,54.970613723421536,1.5,2.75,2.190442353644808,0.7843181944326193,0.3915368644894081,-0.402364870541021,-0.793901735030429,15.345806992528914,1.4987951807228983,8876126385.0,2015-07-15,2015,2,196,7,0.59,210.66,212.3,211.58,3906
2015-07-16 13:30:00,211.87,212.3,211.58,212.3,202.791052631579,212.922,205.93477250000007,209.60581400000007,210.185884,208.93950000000015,209.46401757197518,209.0846576060191,207.776153846154,212.43468143435388,203.11762625795402,205.93477250000007,209.60581400000007,210.185884,208.93950000000015,212.06000000000003,106683266,123838550.0,59.19099929246143,1.5,2.75,2.154696471241607,0.8614705679289688,0.576286535826169,-0.07354356524771788,-0.6498301010738868,15.346986112471278,2.4070232984419517,8982809651.0,2015-07-16,2015,3,197,7,0.34,211.94,212.55,211.8,3907
2015-07-17 13:30:00,212.29,212.55,211.8,212.48,202.60263157894738,212.9,206.01207250000007,209.6125140000001,210.274684,208.92450000000017,209.58229139268207,209.408023548303,208.31923076923087,213.3810544694076,203.25740706905418,206.01207250000007,209.6125140000001,210.274684,208.92450000000017,212.27666666666667,89029973,119996651.2,59.62504813551957,1.5,2.75,2.0543610090100635,0.7419371466593061,0.6792857146248011,0.19927704220711465,-0.4800086724176865,15.245593549400883,2.786377708978324,9071839624.0,2015-07-17,2015,4,198,7,0.35,212.18,213.18,212.21,3908
2015-07-20 13:30:00,212.75,213.18,212.21,212.59,202.4142105263158,213.18,206.1032725000001,209.62211400000007,210.349084,209.01350000000016,209.70024074983172,209.71106892465508,208.83769230769246,214.1558652377153,203.5195193776696,206.1032725000001,209.62211400000007,210.349084,209.01350000000016,212.66,70446821,116995057.8,59.90570141818586,1.5,2.75,1.9769066512236304,0.6021350159972313,0.7196304153038489,0.4195293467121246,-0.30010106859172425,14.936251851047773,2.19690414383232,9142286445.0,2015-07-20,2015,0,201,7,0.46,212.7,212.74,211.39,3909
2015-07-21 13:30:00,212.43,212.74,211.39,211.75,202.22578947368424,213.172380952381,206.1901225000001,209.62581400000008,210.35168399999995,209.0065000000001,209.78062346552463,209.90525283659267,209.16461538461553,214.6340359157853,203.6951948534457,206.1901225000001,209.62581400000008,210.35168399999995,209.0065000000001,211.96,77965048,117358508.85,56.666374213732034,1.5,2.75,1.9321276047076583,0.6643322990721521,0.656322603130896,0.5203021853218956,-0.13602041780900026,15.216967484437935,3.530044492250525,9064321397.0,2015-07-21,2015,1,202,7,0.64,212.06,211.77,210.89,3910
2015-07-22 13:30:00,210.93,211.77,210.89,211.37,202.03736842105263,213.16476190476192,206.26437250000012,209.63291400000008,210.366984,208.97300000000013,209.84295195707267,210.04475256644105,209.47692307692319,214.9507342066676,204.00311194717887,206.26437250000012,209.63291400000008,210.366984,208.97300000000013,211.34333333333333,88667920,118368065.0,55.21189242529733,1.5,2.75,1.8569756329428275,0.7490865040329924,0.5592263374936524,0.5630125040580651,0.0037861665644128295,10.013782286901412,3.157637872132747,8975653477.0,2015-07-22,2015,2,203,7,0.42,211.33,211.65,209.75,3911
2015-07-23 13:30:00,211.53,211.65,209.75,210.18,201.8489473684211,213.15714285714287,206.3338225000001,209.61481400000002,210.370984,208.95700000000016,209.85616952738357,210.05763327439902,209.74307692307704,214.98642514646843,204.49972869968562,206.3338225000001,209.61481400000002,210.370984,208.95700000000016,210.52666666666667,90509128,118278155.5,50.813350435551655,1.5,2.75,1.8600488020183403,0.7652226872949502,0.39307517286948507,0.4951301326512692,0.1020549597817841,11.251154224134028,1.301330248698678,8885144349.0,2015-07-23,2015,3,204,7,0.91,210.7,210.37,207.6,3912
2015-07-24 13:30:00,210.3,210.37,207.6,208.0,201.6605263157895,213.14952380952386,206.40752250000008,209.58361400000004,210.330584,208.86400000000015,209.7833785655254,209.86166820064673,209.7415384615386,214.98691941070197,204.49615751237525,206.40752250000008,209.58361400000004,210.330584,208.86400000000015,208.65666666666667,117754979,119310536.4,43.91173273093804,1.5,2.75,1.9250453161598882,0.9869621120905462,0.12827626896800948,0.26240029599179593,0.13412402702378645,11.511529694406619,-0.8437812842637222,8767389370.0,2015-07-24,2015,4,205,7,1.33,208.98,207.55,206.26,3913
2015-07-27 13:30:00,206.94,207.55,206.26,206.79,201.4721052631579,213.14190476190484,206.4582725000001,209.54921300000007,210.22218400000003,208.71250000000015,209.66599117079886,209.5691283720137,209.91538461538474,214.5754976241596,205.2552716066099,206.4582725000001,209.54921300000007,210.22218400000003,208.71250000000015,206.86666666666667,132361082,120719848.5,40.614372642697504,1.5,2.75,1.9118277935770396,1.0964318100515178,-0.12286116434769295,-0.019452428410829725,0.1034087359368632,9.680788129041037,-1.8464021264477,8635028288.0,2015-07-27,2015,0,208,7,0.63,206.9,209.5,206.8,3914
2015-07-28 13:30:00,207.79,209.5,206.8,209.33,201.2836842105264,213.1342857142857,206.54122250000012,209.5379130000001,210.15998399999998,208.9080000000002,209.65281504645387,209.5463542413457,210.25615384615398,213.9463949344983,206.56591275780963,206.54122250000012,209.5379130000001,210.15998399999998,208.9080000000002,208.5433333333333,123544845,116766024.15,49.23235922960797,1.5,2.75,1.9688400940358228,1.0580547372349665,-0.1126745485655276,-0.037434449770046285,0.07524009879548131,12.134313724861212,-0.6077584160296288,8758573133.0,2015-07-28,2015,1,209,7,1.31,208.15,211.04,209.31,3915
2015-07-29 13:30:00,209.48,211.04,209.31,210.77,201.09526315789483,213.1266666666667,206.6423725000001,209.57061300000007,210.113384,209.15400000000014,209.69662622110275,209.66289193264615,210.50923076923087,213.83662255481383,207.18183898364788,206.6423725000001,209.57061300000007,210.113384,209.15400000000014,210.37333333333336,105791255,112909331.6,53.364320418930156,1.5,2.75,1.9517800873189777,0.9369575880121498,-0.009171702840346713,0.06377547024504793,0.07294717308539464,12.878003841686844,-0.7206782854451254,8864364388.0,2015-07-29,2015,2,210,7,0.83,210.18,211.02,209.42,3916
2015-07-30 13:30:00,210.16,211.02,209.42,210.82,200.90684210526317,213.1190476190476,206.7594230000001,209.5952130000001,210.069184,209.32000000000016,209.740680094785,209.77309270096558,210.5900000000001,213.89257708232518,207.28742291767503,206.7594230000001,209.5952130000001,210.069184,209.32000000000016,210.42,91304374,110675556.65,53.50582158713599,1.5,2.75,1.9266529382247664,0.8249732530258749,0.05870850923354382,0.14633280962732442,0.0876243003937806,11.865213818702607,-0.7812499999999984,8955668762.0,2015-07-30,2015,3,211,7,0.76,210.22,211.45,210.16,3917
2015-07-31 13:30:00,211.42,211.45,210.16,210.5,200.7184210526316,213.11142857142858,206.87342300000012,209.65041300000007,210.021584,209.47950000000012,209.77045734596993,209.84232196754027,210.57615384615397,213.8786148256008,207.2736928667072,206.87342300000012,209.65041300000007,210.021584,209.47950000000012,210.70333333333332,103266857,110620216.9,52.409800575258544,1.5,2.75,1.8811777283515685,0.9335260759193104,0.07695640759565403,0.18381980988834806,0.1068634022926941,11.830063127381004,-0.983113034479516,8852401905.0,2015-07-31,2015,4,212,7,0.61,210.8,210.53,208.65,3918
2015-08-03 13:30:00,210.46,210.53,208.65,209.79,200.53000000000003,213.10380952380956,206.99022300000016,209.70331300000007,209.94738400000003,209.63300000000007,209.7712237245593,209.83733892301262,210.51307692307705,213.8417623611491,207.1843914850049,206.99022300000016,209.70331300000007,209.94738400000003,209.63300000000007,209.65666666666667,113965728,110419734.85,49.96428424524402,1.5,2.75,1.8810936048978848,1.0321137625879746,0.03807486016706453,0.15445697750152476,0.11638211733446024,11.866011784075207,-0.9256198347107476,8738436177.0,2015-08-03,2015,0,215,8,0.9,209.59,210.2483,208.8,3919
2015-08-04 13:30:00,209.7,210.2483,208.8,209.38,200.34157894736842,213.0961904761905,207.1057730000001,209.72611300000008,209.875184,209.70100000000008,209.7558816177139,209.7937828351067,210.2884615384616,213.49640213023014,207.08052094669316,207.1057730000001,209.72611300000008,209.875184,209.70100000000008,209.4761,81820823,105819763.55,48.55530392166565,1.5,2.75,1.8501797759766063,0.7732092782586831,-0.01551756329972144,0.09698516320980843,0.11250272650952987,11.758824536817622,-0.941477030799077,8656615354.0,2015-08-04,2015,1,216,8,0.69,209.52,211.31,209.73,3920
2015-08-05 13:30:00,210.45,211.31,209.73,210.07,200.15315789473686,213.08857142857144,207.21377300000012,209.76854100000008,209.862584,209.97800000000007,209.76819998564662,209.8200892317632,210.10307692307705,213.05100850161247,207.15514534454158,207.21377300000012,209.76854100000008,209.862584,209.97800000000007,210.37,85786817,101908101.45,51.056732652721,1.5,2.75,1.8558812205497064,0.8418056639205498,-0.005286277609693635,0.10589487949741284,0.11118115710710648,12.011581768496876,-0.052336092872782215,8742402171.0,2015-08-05,2015,2,217,8,0.75,210.52,210.415,207.65,3921
2015-08-06 13:30:00,210.29,210.415,207.65,208.35,199.96473684210528,213.08095238095243,207.3040230000001,209.76624100000006,209.775584,210.1505000000001,209.712584299935,209.68008073349998,209.77692307692317,212.48014491097152,207.0737012428748,207.3040230000001,209.76624100000006,209.775584,210.1505000000001,208.805,116030803,100503986.25,45.16175242112461,1.5,2.75,1.9208182762247263,1.154489561353095,-0.10937638969779352,-0.02553933001513542,0.08383705968265809,12.486496575544136,0.16826923076922806,8626371368.0,2015-08-06,2015,3,218,8,1.33,209.03,208.34,206.87,3922
2015-08-07 13:30:00,208.16,208.34,206.87,207.95,199.77631578947373,213.07333333333332,207.3734230000001,209.7661410000001,209.685384,210.17400000000012,209.6434633469964,209.5153111398333,209.48461538461547,212.0912886595427,206.87794210968826,207.3734230000001,209.7661410000001,209.685384,210.17400000000012,207.72000000000003,117857956,99924039.55,43.89253442767436,1.5,2.75,1.8893312564943885,1.1794754948935608,-0.1951757563072592,-0.1601326357014159,0.03504312060584329,10.971414508602264,0.5609555587794365,8508513412.0,2015-08-07,2015,4,219,8,0.71,207.6,210.67,209.28,3923
2015-08-10 13:30:00,209.28,210.67,209.28,210.57,199.58789473684212,213.0657142857143,207.46282300000007,209.76724100000007,209.673984,210.21400000000008,209.6797981177024,209.61575769794445,209.42307692307705,211.88241247581746,206.9637413703366,207.46282300000007,209.76724100000007,209.673984,210.21400000000008,210.1733333333333,80270676,98634103.35,53.17510447591153,1.5,2.75,1.9486647381733604,0.8138227375085678,-0.07183890366899973,-0.054755508980406375,0.017083394688593354,12.37704723308549,0.5923661204796162,8588784088.0,2015-08-10,2015,0,222,8,0.66,209.98,209.47,207.76,3924
2015-08-11 13:30:00,208.97,209.47,207.76,208.67,199.39947368421056,213.05809523809523,207.53152300000008,209.75894100000008,209.61598400000003,210.11350000000007,209.64019819151798,209.52568553623541,209.30692307692317,211.75489724240043,206.858948911446,207.53152300000008,209.75894100000008,209.61598400000003,210.11350000000007,208.63333333333333,126081377,100852693.45,47.09067958275285,1.5,2.75,2.010188685446692,1.2501537905133655,-0.11217714713074757,-0.12313803922484112,-0.010960892094093542,11.848721263354369,-0.9963467286615848,8462702711.0,2015-08-11,2015,1,223,8,0.82,208.62,209.14,205.36,3925
2015-08-12 13:30:00,207.11,209.14,205.36,208.92,199.21105263157898,213.0504761904762,207.59397300000006,209.74404100000007,209.56718400000003,210.0290000000001,209.61195512518398,209.46800119945115,209.37769230769246,211.72141917345718,207.03396544192765,207.59397300000006,209.74404100000007,209.56718400000003,210.0290000000001,207.80666666666667,172123672,104563170.0,47.934848601404724,1.5,2.75,2.1366037793433548,1.6461214020194683,-0.11552552091902445,-0.15536779324287409,-0.03984227232384965,11.013089732134421,-0.9012427663409572,8634826383.0,2015-08-12,2015,2,224,8,1.84,207.25,209.55,208.01,3926
2015-08-13 13:30:00,208.73,209.55,208.01,208.66,199.0226315789474,213.04285714285717,207.65647300000006,209.73064100000008,209.501984,209.84700000000007,209.5746235516473,209.39104870426533,209.52153846153854,211.3946164902879,207.6484604327892,207.65647300000006,209.73064100000008,209.501984,209.84700000000007,208.74,89383253,103698169.35,47.09330919455456,1.5,2.75,2.093989223675974,0.8619559396300953,-0.12779753623829265,-0.19958919262171548,-0.07179165638342283,10.990874388896415,-0.8741092636579588,8545443130.0,2015-08-13,2015,3,225,8,0.74,208.78,209.5087,208.26,3927
2015-08-14 13:30:00,208.43,209.5087,208.26,209.42,198.83421052631581,213.03523809523807,207.71152300000008,209.73664100000005,209.4878,209.6940000000001,209.56855988295527,209.39380597052573,209.5284615384617,211.39932059499733,207.657602481926,207.71152300000008,209.73664100000005,209.4878,209.6940000000001,209.0629,72786528,102885997.1,49.8640583011079,1.5,2.75,2.0336114219848342,0.7074483413836693,-0.07963410433810805,-0.1713342868060579,-0.09170018246794984,11.299873572670624,-0.17636684303351188,8618229658.0,2015-08-14,2015,4,226,8,0.6,208.88,210.59,208.16,3928
2015-08-17 13:30:00,208.71,210.59,208.16,210.59,198.64578947368423,213.02761904761903,207.773923,209.7849410000001,209.50420000000003,209.5940000000001,209.6086163581335,209.5077292114281,209.51461538461552,211.35085929977672,207.6783714694544,207.773923,209.7849410000001,209.50420000000003,209.5940000000001,209.78,79072643,103317288.2,53.869341344298036,1.5,2.75,2.0619248918430606,0.7653379640291409,0.030231032760915138,-0.053911391516805914,-0.08414242427772105,11.631296660251019,0.5778966472442487,8697302301.0,2015-08-17,2015,0,229,8,1.17,209.38,210.68,209.699,3929
2015-08-18 13:30:00,210.26,210.68,209.699,209.98,198.4573684210527,213.02,207.82692300000005,209.8320410000001,209.53420000000003,209.50550000000013,209.62318042252042,209.55270738176827,209.4500000000001,211.15217959822743,207.74782040177288,207.82692300000005,209.8320410000001,209.53420000000003,209.50550000000013,210.1196666666667,71692678,103003669.7,51.55675341998467,1.5,2.75,1.9847159709971276,0.6960206195449753,0.05934594705342325,-0.00995999046094198,-0.06930593751436523,11.712878498344608,-0.042842861903176765,8625609623.0,2015-08-18,2015,1,230,8,0.47,210.19,210.01,207.35,3930
2015-08-19 13:30:00,209.09,210.01,207.35,208.32,198.2689473684211,213.012380952381,207.86022300000005,209.85784100000004,209.5316,209.35300000000007,209.57207530791175,209.43530667874268,209.28230769230785,210.96712046612012,207.59749491849547,207.86022300000005,209.85784100000004,209.5316,209.35300000000007,208.56000000000003,172945975,107217572.45,45.79520127785984,1.5,2.75,2.0329505444973326,1.613037593074138,-0.030821874261055957,-0.10783328034068518,-0.07701140607962922,12.408801510708795,-0.014398848092153175,8452663648.0,2015-08-19,2015,2,231,8,1.28,208.68,207.17,203.9,3931
2015-08-20 13:30:00,206.51,207.17,203.9,203.97,198.08052631578948,213.00476190476192,207.87122300000007,209.81504100000006,209.392,209.04250000000008,209.35238608015044,208.91480128076716,208.83461538461552,212.09664510088726,205.5725856683438,207.87122300000007,209.81504100000006,209.392,209.04250000000008,205.0133333333333,194327884,112408510.25,34.81546349259294,1.5,2.75,2.2034540770332365,1.7287648734762944,-0.36262632355826974,-0.5302943105274665,-0.1676679869691967,16.671056859818776,-1.9139216157730172,8258335764.0,2015-08-20,2015,3,232,8,1.6,205.54,203.9404,197.52,3932
2015-08-21 13:30:00,201.73,203.9404,197.52,197.63,197.89210526315796,212.99714285714288,207.85402300000004,209.72704100000007,209.112,208.5240000000001,208.89268466524263,207.84005830164654,207.93076923076939,214.70648360826976,201.1550548532689,207.85402300000004,209.72704100000007,209.112,208.5240000000001,199.6968,346588470,123850184.8,25.296062738829466,1.5,2.75,2.5067787858165755,2.7984493568555417,-0.954660844736676,-1.3609940428900416,-0.4063331981533657,23.71524271282984,-6.145224865840339,7911747294.0,2015-08-21,2015,4,233,8,3.25,200.73,195.84,182.4,3933
2015-08-24 13:30:00,187.49,195.84,182.4,189.55,182.4,212.98952380952386,207.79007300000006,209.56554100000002,208.70279999999997,207.66200000000006,208.13414801170373,206.09814798720402,206.35230769230785,218.1205155915501,194.58409979306558,207.79007300000006,209.56554100000002,208.70279999999997,207.66200000000006,189.2633333333333,507244330,142594347.2,18.393520462818728,1.5,2.75,3.4155803011153907,3.5572541265506774,-1.7876339754546249,-2.640875667471647,-0.8532416920170219,28.846317117019826,-9.162792926630557,7404502964.0,2015-08-24,2015,0,236,8,7.37,189.12,195.45,186.92,3934
2015-08-25 13:30:00,195.43,195.45,186.92,187.27,181.7614705882353,212.98190476190484,207.71067300000007,209.37389100000004,208.266,206.5590000000001,207.31594612889182,204.3049910360417,204.7307692307694,220.18349109514327,189.27804736639544,207.71067300000007,209.37389100000004,208.266,206.5590000000001,189.88,369833070,154908758.45,16.985099709577355,1.5,2.75,3.7808959938928632,2.3874251766040158,-2.353740101366691,-3.7954168187253856,-1.4416767173586946,28.843025328870176,-10.362818303656892,7034669894.0,2015-08-25,2015,1,237,8,4.56,191.18,194.79,188.37,3935
2015-08-26 13:30:00,192.08,194.79,188.37,194.46,181.1229411764706,212.97428571428568,207.66627300000007,209.24019099999998,207.95019999999997,205.74350000000013,206.8117913787392,203.367372842133,203.6930769230771,219.9334186864661,187.4527351596881,207.66627300000007,209.24019099999998,207.95019999999997,205.74350000000013,192.54,339256990,166582045.2,34.117441784978816,1.5,2.75,4.047974851471944,2.03657596827248,-2.113185014016126,-4.083157984878852,-1.969972970862726,39.862810567318185,-6.8053292437458,7373926884.0,2015-08-26,2015,2,238,8,3.41,191.58,199.42,195.21,3936
2015-08-27 13:30:00,197.02,199.42,195.21,199.27,180.48441176470592,212.96666666666667,207.64272300000005,209.160091,207.72379999999995,205.16600000000014,206.5160348540828,202.97714685716798,202.82384615384632,218.70448272016475,186.94320958752786,207.64272300000005,209.160091,207.72379999999995,205.16600000000014,197.96666666666667,274143910,175724022.0,42.64513926815189,1.5,2.75,4.113119504938232,1.5600821497245263,-1.5267102647802868,-3.8783608018380846,-2.3516505370577976,43.781045630684396,-4.8467195110304555,7648070794.0,2015-08-27,2015,3,239,8,2.16,197.32,199.835,197.92,3937
2015-08-28 13:30:00,198.5,199.835,197.92,199.28,179.84588235294117,212.9590476190476,207.618248,209.073141,207.45379999999997,204.60500000000016,206.2322687813736,202.62503763267574,202.10153846153858,217.70460886185347,186.4984680612237,207.618248,209.073141,207.45379999999997,204.60500000000016,199.01166666666663,160414352,178581396.75,42.661755989098,1.5,2.75,3.9561109688712164,0.8982702281389788,-1.057008853320368,-3.6729116037082576,-2.6159027503878898,43.582508665453176,-5.370625385820791,7808485146.0,2015-08-28,2015,4,240,8,0.97,198.88,199.125,197.01,3938
2015-08-31 13:30:00,198.11,199.125,197.01,197.67,179.20735294117645,212.95142857142858,207.586798,208.960841,207.19099999999997,203.99900000000017,205.89649353504524,202.15312928670662,201.236153846154,216.4741923600661,185.9981153322419,207.586798,208.960841,207.19099999999997,203.99900000000017,197.935,163298816,181048051.15,40.621245230872454,1.5,2.75,3.8356744710947015,0.9019639535622804,-0.7860967102334477,-3.5985236381796994,-2.812426927946252,43.07800757303949,-5.862463091723022,7645186330.0,2015-08-31,2015,0,243,8,1.07,198.07,194.77,190.73,3939
2015-09-01 13:30:00,193.12,194.77,190.73,191.77,178.56882352941173,212.94380952380953,207.524698,208.778141,206.7886,203.11850000000015,205.34251339641602,201.16425983082985,199.93692307692325,215.30115203124745,184.5726941225991,207.524698,208.778141,206.7886,203.11850000000015,192.4233333333333,256000392,189757029.6,34.17109442068434,1.5,2.75,4.057412008873651,1.3490956964263106,-0.9259695959404411,-3.969888922871803,-3.0439193269313614,45.09703575551923,-7.944508448540697,7389185938.0,2015-09-01,2015,1,244,9,2.12,192.75,195.46,192.42,3940
2015-09-02 13:30:00,194.62,195.46,192.42,195.41,177.9302941176471,212.9361904761905,207.48054800000003,208.641341,206.456,202.38550000000012,204.9530030671448,200.6162350850365,198.8592307692309,213.3522985265325,184.36616301192933,207.48054800000003,208.641341,206.456,202.38550000000012,194.43,160269331,193481155.3,40.453250881853705,1.5,2.75,4.031168293954105,0.8283459479632329,-0.7050512268351645,-3.9252333604753176,-3.2201821336401535,47.86208623204672,-4.1966955924890925,7549455269.0,2015-09-02,2015,2,245,9,1.58,193.94,198.05,194.96,3941
2015-09-03 13:30:00,196.26,198.05,194.96,195.55,177.29176470588234,212.92857142857144,207.43644799999998,208.501941,206.15699999999995,201.74550000000016,204.58425784882544,200.13373650550918,197.70230769230784,210.5756460408733,184.82896934374241,207.43644799999998,208.501941,206.15699999999995,201.74550000000016,196.18666666666664,152087836,195284006.95,40.68769979076945,1.5,2.75,3.9639419872430968,0.7788033355897914,-0.4913316638591576,-3.8343467134641,-3.3430150496049427,47.04199121218299,-1.0524717907200245,7701543105.0,2015-09-03,2015,3,246,9,1.58,196.5,193.86,191.61,3942
2015-09-04 13:30:00,192.85,193.86,191.61,192.59,176.65323529411762,212.92095238095243,207.371648,208.323541,205.8115999999999,200.9775000000001,204.11389479593032,199.4152854097464,196.36461538461555,207.32932412993821,185.3999066392929,207.371648,208.323541,205.8115999999999,200.9775000000001,192.68666666666667,207080961,199745157.2,37.34023820342837,1.5,2.75,3.9622318452971617,1.0367258155483332,-0.4900426193336336,-3.9555683237719848,-3.4655257044383507,44.43470976115504,1.6037984700606658,7494462144.0,2015-09-04,2015,4,247,9,1.17,192.74,197.61,195.17,3943
2015-09-08 13:30:00,195.94,197.61,195.17,197.43,176.01470588235298,212.91333333333336,207.332698,208.194141,205.56379999999996,200.32050000000012,203.8517812745213,199.22621060881818,195.52692307692317,204.1169365437889,186.93690961005748,207.332698,208.194141,205.56379999999996,200.32050000000012,196.73666666666668,116025739,201532910.35,45.26929996425943,1.5,2.75,4.037786713490221,0.575716089240707,-0.12307379812119555,-3.6193679520898456,-3.49629415396865,39.07787662593647,5.425321727986328,7610487883.0,2015-09-08,2015,1,251,9,1.25,196.39,199.47,194.35,3944
2015-09-09 13:30:00,199.32,199.47,194.35,194.79,175.37617647058826,212.9057142857143,207.278748,208.062541,205.35119999999995,199.62650000000016,203.49641730297142,198.8037143603593,194.8207692307694,201.8937316676196,187.74780679391915,207.278748,208.062541,205.35119999999995,199.62650000000016,196.20333333333332,149347735,202696228.25,42.13715724725789,1.5,2.75,4.115087662526635,0.7368056933738233,-0.0232167045460967,-3.5253150346512716,-3.5020983301051745,39.290634904920566,0.16970070965750492,7461140148.0,2015-09-09,2015,2,252,9,2.63,196.91,197.22,194.25,3945
2015-09-10 13:30:00,194.56,197.22,194.25,195.85,174.73764705882354,212.89809523809524,207.224598,207.922541,205.1512,198.97300000000016,203.19655780089408,198.5224082308013,194.68384615384628,201.6011801821508,187.7665121255418,207.224598,207.922541,205.1512,198.97300000000016,195.7733333333333,158611063,202020597.8,43.81797931357481,1.5,2.75,4.0332956866318765,0.7851232237072412,0.14016353080006996,-3.326893916605087,-3.4670574474051565,33.03247497580574,-1.7162643649320095,7619751211.0,2015-09-10,2015,3,253,9,1.53,195.74,196.82,194.53,3946
2015-09-11 13:30:00,195.375,196.82,194.53,196.74,174.09911764705882,212.8904761904762,207.17199799999997,207.793941,204.93599999999995,198.37700000000015,202.943359455761,198.35265506596303,195.23692307692318,201.54700480071529,188.92684135313115,207.17199799999997,207.793941,204.93599999999995,198.37700000000015,196.03,119691212,203535995.75,45.25587802335985,1.5,2.75,3.9087745661581694,0.5880591860862527,0.32362571496285275,-3.0625253037015914,-3.386151018664444,29.607838976457213,-1.274588518667198,7739442423.0,2015-09-11,2015,4,254,9,1.18,195.68,197.01,195.43,3947
2015-09-14 13:30:00,196.95,197.01,195.43,196.01,173.46058823529413,212.88285714285718,207.11649799999995,207.647741,204.70999999999995,197.70650000000015,202.67146300651547,198.12954505968085,195.90923076923093,200.229326648072,191.58913489038986,207.11649799999995,207.647741,204.70999999999995,197.70650000000015,196.15,79451983,203869268.5,44.25538379647381,1.5,2.75,3.7424335257182983,0.38972025349666667,0.4059352608894029,-2.8787319425526903,-3.284667203442093,29.624900992123003,-0.8397834775130251,7659990440.0,2015-09-14,2015,0,257,9,0.81,196.22,198.99,195.9612,3948
2015-09-15 13:30:00,196.61,198.99,195.9612,198.46,172.8220588235294,212.87523809523807,207.070598,207.520741,204.54479999999995,197.1000000000002,202.50630759449524,198.1610169587589,196.21692307692317,200.64865748034146,191.785188673505,207.070598,207.520741,204.54479999999995,197.1000000000002,197.80373333333333,113806176,205605945.15,48.38001720263279,1.5,2.75,3.691459702452707,0.5535159789128306,0.6225444527825368,-2.5064866374639223,-3.129031090246459,30.3207584364814,3.4885539969755417,7773796616.0,2015-09-15,2015,1,258,9,1.55,197.48,200.41,198.41,3949
2015-09-16 13:30:00,198.82,200.41,198.41,200.18,172.18352941176468,212.86761904761903,207.035498,207.406042,204.38799999999995,196.61000000000016,202.41507984569148,198.35330105792468,196.2869230769232,200.93290982888703,191.6409363249594,207.035498,207.406042,204.38799999999995,196.61000000000016,199.66666666666663,99581557,207000389.1,51.11470475322279,1.5,2.75,3.570641152277514,0.4810694194004295,0.8639692498597031,-2.04906952792183,-2.913038777781533,23.339209056657747,2.441021442096111,7873378173.0,2015-09-16,2015,2,259,9,1.01,199.41,202.89,199.28,3950
2015-09-17 13:30:00,200.02,202.89,199.28,199.73,171.54500000000004,202.89,207.005348,207.295642,204.29199999999997,196.1805000000002,202.30978259684085,198.48441524288427,196.32153846153855,201.0619561396933,191.58112078338382,207.005348,207.295642,204.29199999999997,196.1805000000002,200.63333333333333,276046620,212155421.35,50.36296093835282,1.5,2.75,3.5734524985434044,1.3011527975266608,0.9678386095418968,-1.703240515854162,-2.671079125396059,21.617217919560108,2.137560726156982,7597331553.0,2015-09-17,2015,3,260,9,1.81,201.08,197.56,194.96,3951
2015-09-18 13:30:00,195.71,197.56,194.96,195.45,170.90647058823532,202.645,206.947173,207.135742,204.10299999999995,195.75450000000018,202.0407715146118,198.1954233149905,196.1507692307693,200.84428988106583,191.45724858047282,206.947173,207.135742,204.10299999999995,195.75450000000018,195.99,223657456,213621899.95,43.76952515624237,1.5,2.75,3.6589201772188735,1.0469781237426918,0.7334183300996959,-1.7543062127714393,-2.4877245428711348,25.609195548170447,1.4850199906537127,7373674097.0,2015-09-18,2015,4,261,9,1.33,196.26,197.68,195.21,3952
2015-09-21 13:30:00,196.44,197.68,195.21,196.46,170.26794117647057,202.4,206.890023,206.994642,203.88259999999997,195.6960000000002,201.82191772972507,198.03014490403905,196.51153846153855,200.4653941933501,192.55768272972702,206.890023,206.994642,203.88259999999997,195.6960000000002,196.45,105726209,201578786.9,45.58011642567824,1.5,2.75,3.5739973074175264,0.5244907493785498,0.6351771898890664,-1.6937530555098022,-2.3289302453988685,23.794458460940923,-0.4913133768930754,7479400306.0,2015-09-21,2015,0,264,9,1.27,196.44,194.46,192.56,3953
2015-09-22 13:30:00,193.88,194.46,192.56,193.91,169.62941176470588,202.155,206.821273,206.849142,203.56539999999995,195.91400000000016,201.51164644620644,197.63775015127342,196.396153846154,200.55413810973357,192.23816958257441,206.821273,206.849142,203.56539999999995,195.91400000000016,193.6433333333333,153890876,183911114.2,41.91085479471167,1.5,2.75,3.5972832140305604,0.8367676780678218,0.3988018783362941,-1.8304278974785009,-2.2292297758147948,20.155655968585435,-0.451768571281891,7325509430.0,2015-09-22,2015,1,265,9,0.99,193.51,194.67,192.91,3954
2015-09-23 13:30:00,194.11,194.67,192.91,193.6,168.99088235294118,201.91,206.749273,206.677942,203.22379999999995,196.23050000000015,201.20138580125717,197.2532025178188,196.246153846154,200.6489050032818,191.84340268902602,206.749273,206.677942,203.22379999999995,196.23050000000015,193.72666666666663,92790620,170058991.7,41.47375280743502,1.5,2.75,3.466048698742662,0.5456378346855739,0.23028054551464905,-1.9413790939214837,-2.1716596394361325,18.747783292349485,-1.1488383967321931,7232718810.0,2015-09-23,2015,2,266,9,0.91,193.79,193.45,190.56,3955
2015-09-24 13:30:00,192.15,193.45,190.56,192.9,168.35235294117646,201.665,206.680723,206.493742,202.86959999999993,196.1525000000002,200.8758412600314,196.838611801836,196.27000000000007,200.595971656098,191.94402834390218,206.680723,206.493742,202.86959999999993,196.1525000000002,192.3033333333333,159378840,161065084.2,40.44792713892414,1.5,2.75,3.4356166488324718,0.9895306657654857,0.08770919391342025,-2.062023147044357,-2.1497323409577773,18.397861836996654,-1.951814577615128,7073339970.0,2015-09-24,2015,3,267,9,1.52,192.0,195.0,191.81,3956
2015-09-25 13:30:00,194.64,195.0,191.81,192.85,167.71382352941174,201.42,206.612623,206.333242,202.48059999999995,195.8315000000002,200.561102387089,196.458744011185,195.91769230769242,200.54396612876644,191.2914184866184,206.612623,206.333242,202.48059999999995,195.8315000000002,193.22,155054777,155110627.55,40.37111539537806,1.5,2.75,3.4180726024872947,0.99963993086172,0.010158188132193048,-2.137034605792536,-2.147192793924729,18.023687776570068,-1.6121626447630206,6918285193.0,2015-09-25,2015,4,268,9,1.66,193.4,191.91,187.64,3957
2015-09-28 13:30:00,191.78,191.91,187.64,188.01,167.07529411764705,201.175,206.5368725,206.13294199999996,201.9912,195.2680000000002,200.06890229347766,195.65410172440548,195.396153846154,201.6542368087724,189.13807088353556,206.5368725,206.13294199999996,201.9912,195.2680000000002,189.18666666666664,178515871,156015703.5,33.69970710528541,1.5,2.75,3.5460674165953456,1.1442173255335157,-0.3282837349246064,-2.5575474625804877,-2.229263727655881,22.512107532657232,-5.265544694144925,6739769322.0,2015-09-28,2015,0,271,9,2.28,189.77,189.74,186.93,3958
2015-09-29 13:30:00,188.27,189.74,186.93,188.12,186.93,200.93,206.45652249999995,205.92544199999992,201.5018,194.79050000000015,199.60031788981186,194.93656822684304,194.80153846153854,202.14836968283694,187.45470724024017,206.45652249999995,205.92544199999992,201.5018,194.79050000000015,188.2633333333333,159045572,155803041.3,33.96678700716872,1.5,2.75,3.493491172552821,1.0208117291738643,-0.495859684843091,-2.8490883337097443,-2.3532286488666534,20.23554947484929,-6.024577879908084,6898814894.0,2015-09-29,2015,1,272,9,1.5,188.34,191.825,189.44,3959
2015-09-30 13:30:00,190.37,191.825,189.44,191.63,187.1112,200.685,206.41022249999997,205.725542,201.09939999999997,194.78350000000015,199.28775640393692,194.6216569671437,194.4084615384616,201.8446344422963,186.97228863462695,206.41022249999997,205.725542,201.09939999999997,194.78350000000015,190.965,163452044,151175623.9,41.99615981652274,1.5,2.75,3.5085989459419045,1.081206346521319,-0.3294453233176973,-2.7650353030137746,-2.435589979696078,23.280678438477768,-4.055474891102986,7062266938.0,2015-09-30,2015,2,273,9,1.26,190.63,192.49,189.82,3960
2015-10-01 13:30:00,192.08,192.49,189.82,192.13,187.2924,200.44,206.37332249999992,205.54079199999995,200.71459999999993,194.6195000000002,199.00706007437077,194.38435630360627,194.11000000000007,201.5764912983172,186.64350870168303,206.37332249999992,205.54079199999995,200.71459999999993,194.6195000000002,191.48,131078964,149716105.55,43.05833686418057,1.5,2.75,3.4486990212317687,0.8755167890486181,-0.15375631642406073,-2.627785375226153,-2.4740290588020932,23.605794021744856,-1.6986441545152182,7193345902.0,2015-10-01,2015,3,274,10,1.41,191.16,195.03,189.12,3961
2015-10-02 13:30:00,189.77,195.03,189.12,195.0,187.4736,200.195,206.35877249999993,205.390992,200.41099999999992,194.59200000000016,198.8499204636111,194.44298903659612,193.84384615384624,200.90688772339462,186.78080458429784,206.35877249999993,205.390992,200.41099999999992,194.59200000000016,193.05,211003342,152661880.85,48.848551677979536,1.5,2.75,3.624506234000928,1.3821612888899502,0.17013425544763905,-2.261361239492544,-2.431495494940183,22.824235453618353,-0.7431538226611055,7404349244.0,2015-10-02,2015,4,275,10,3.12,192.08,198.74,196.33,3962
2015-10-05 13:30:00,196.46,198.74,196.33,198.47,187.6548,199.95,206.34217249999992,205.275492,200.22039999999993,194.88600000000017,198.83502162190086,194.82651389025364,193.71230769230775,200.34928640183097,187.07532898278458,206.34217249999992,205.275492,200.22039999999993,194.88600000000017,197.8466666666667,126320842,148623874.9,54.829276693137366,1.5,2.75,3.632755788715148,0.8499364054731693,0.6078386460326812,-1.6716971873993316,-2.2795358334320133,24.92423067481437,2.3516064153473275,7530670086.0,2015-10-05,2015,0,278,10,1.23,197.54,198.98,197.0,3963
2015-10-06 13:30:00,198.31,198.98,197.0,197.79,187.83599999999998,199.705,206.29722249999992,205.131292,200.04039999999992,194.90400000000014,198.79404038182633,195.1087506626104,193.563076923077,199.72215469928668,187.4039991468673,206.29722249999992,205.131292,200.04039999999992,194.90400000000014,197.9233333333333,110274530,148336314.45,53.50893502761698,1.5,2.75,3.5147018038069224,0.7434088571559492,0.8277054537497337,-1.2449040162448457,-2.072609469994579,23.50896725012424,2.1642561983471063,7420395556.0,2015-10-06,2015,1,279,10,1.01,197.99,199.825,197.48,3964
2015-10-07 13:30:00,198.9,199.825,197.48,199.41,188.0172,199.46,206.26167249999997,205.000992,199.84199999999993,195.13500000000016,198.81819566097042,195.51839345664752,193.8676923076924,200.72236013378463,187.01302448160007,206.26167249999997,205.000992,199.84199999999993,195.13500000000016,198.905,124307295,147084292.45,56.21413005016591,1.5,2.75,3.4311516749635707,0.8451432367753149,1.0444042219911616,-0.7671041925056272,-1.8115084144967888,23.63128896232552,3.3748055987558274,7544702851.0,2015-10-07,2015,2,280,10,1.19,198.65,201.55,198.59,3965
2015-10-08 13:30:00,198.95,201.55,198.59,201.21,188.1984,199.215,206.23037249999996,204.882092,199.65079999999983,195.4030000000002,198.91199190955976,196.06045122268108,194.23307692307705,202.0415511544881,186.424602691666,206.23037249999996,204.882092,199.65079999999983,195.4030000000002,200.45,153055231,146806500.85,59.06431670872296,1.5,2.75,3.3974979838947448,1.0425643967659488,1.2568643879594474,-0.24042792954747935,-1.4972923175069268,23.454311695258788,4.334975369458134,7697758082.0,2015-10-08,2015,3,281,10,1.49,200.07,201.9,200.58,3966
2015-10-09 13:30:00,201.38,201.9,200.58,201.33,188.3796,198.97,206.19827249999997,204.76509200000004,199.4609999999999,195.63250000000028,199.0068157562437,196.5623130109972,194.80384615384625,203.47185466778907,186.1358376399034,206.19827249999997,204.76509200000004,199.4609999999999,195.63250000000028,201.27,107069240,146175402.25,59.2547355356562,1.5,2.75,3.2491052707594053,0.7324709790562591,1.3454520437730777,0.18452273720942006,-1.1609293065636574,23.39977286272797,7.0847295356630084,7804827322.0,2015-10-09,2015,4,282,10,0.66,201.24,201.76,200.91,3967
2015-10-12 13:30:00,201.42,201.76,200.91,201.52,188.5608,198.725,206.16702249999997,204.65149200000005,199.28139999999988,195.9080000000002,199.10537200109692,197.03447367661653,195.41307692307706,204.74489308605254,186.08126076010151,206.16702249999997,204.65149200000005,199.28139999999988,195.9080000000002,201.39666666666665,56395585,145022582.35,59.575370535673954,1.5,2.75,3.0777406085623045,0.3888745055159336,1.353155577831704,0.5305151657259728,-0.8226404121057314,14.279094196397093,7.1231129066553285,7861222907.0,2015-10-12,2015,0,285,10,0.42,201.33,202.16,200.05,3968
2015-10-13 13:30:00,200.65,202.16,200.05,200.25,188.742,198.48,206.12607249999996,204.51899200000003,199.09059999999988,195.99750000000026,199.1502593736029,197.3407142788435,195.9784615384616,205.52097804627635,186.4359450306469,206.12607249999996,204.51899200000003,199.09059999999988,195.99750000000026,200.82,88038718,143734209.45,56.381584159331204,1.5,2.75,3.008616279379282,0.6125105382836891,1.2135007749243902,0.6942355565497564,-0.5192652183746338,15.86201479098677,4.4982518394823385,7773184189.0,2015-10-13,2015,1,286,10,1.05,201.1,200.87,198.94,3969
2015-10-14 13:30:00,200.18,200.87,198.94,199.29,188.9232,198.235,206.07892249999998,204.38199200000003,198.88879999999992,195.95300000000026,199.1557393981675,197.52636053800128,196.47384615384624,205.98388146386262,186.96381084382992,206.07892249999998,204.38199200000003,198.88879999999992,195.95300000000026,199.7,99106161,143710439.65,54.02394361886164,1.5,2.75,2.931572259423619,0.6896239496682939,1.0058232188006904,0.7380138051262293,-0.26780941367446115,14.890935012636804,3.7266434185187096,7674078028.0,2015-10-14,2015,2,287,10,0.97,199.9,202.36,199.64,3970
2015-10-15 13:30:00,200.08,202.36,199.64,202.35,189.1044,197.99,206.05267249999997,204.29849199999998,198.73439999999994,196.08400000000026,199.281004519808,197.98575477247726,197.57692307692315,206.18830868728324,188.96553746656303,206.05267249999997,204.29849199999998,198.73439999999994,196.08400000000026,201.45,134142195,136615218.4,59.794999333750276,1.5,2.75,2.9414599551790763,0.9818978922775708,1.0206516534178305,1.008005153097827,-0.012646500320003584,16.187780613837198,3.7692307692307674,7808220223.0,2015-10-15,2015,3,288,10,1.36,201.0,203.29,201.92,3971
2015-10-16 13:30:00,202.83,203.29,201.92,203.27,189.2856,197.745,206.04132249999992,204.204192,198.63279999999992,196.47500000000028,199.43743571510964,198.4890162227176,198.74230769230775,205.896199172736,191.58841621187958,206.04132249999992,204.204192,198.63279999999992,196.47500000000028,202.82666666666668,114580052,131161348.2,61.36519355760108,1.5,2.75,2.8292128155234284,0.8735809258782842,1.0352691291839515,1.2814399111599355,0.2461707819759843,14.979286384619506,2.4185015367561906,7922800275.0,2015-10-16,2015,4,289,10,0.68,202.6,203.37,202.13,3972
2015-10-19 13:30:00,202.5,203.37,202.13,203.37,189.4668,197.5,206.03102249999992,204.113292,198.54119999999992,196.82050000000018,199.59165392236028,198.953871820554,199.64538461538467,205.88563912393604,193.4051301068333,206.03102249999992,204.113292,198.54119999999992,196.82050000000018,202.95666666666668,76523897,129701232.6,61.541013443403436,1.5,2.75,2.715697614414612,0.5900013089004368,0.9942980357059976,1.4890433266084813,0.4947452909024838,12.335718066204198,2.8211739723949707,7999324172.0,2015-10-19,2015,0,292,10,0.61,202.75,203.84,202.5471,3973
2015-10-20 13:30:00,202.85,203.84,202.5471,203.09,189.648,197.255,206.03787249999993,204.032792,198.39159999999995,197.27950000000027,199.72884396462064,199.34778879002502,200.48846153846162,205.21813120431347,195.75879187260966,206.03787249999993,204.032792,198.39159999999995,197.27950000000027,203.15903333333333,78448484,125929113.0,60.7079510252272,1.5,2.75,2.614069213384997,0.6229574887897448,0.8941159577771391,1.6123902381239077,0.7182742803467685,12.031282385118327,1.8454440599769355,7920875688.0,2015-10-20,2015,1,293,10,0.64,203.19,203.79,201.65,3974
2015-10-21 13:30:00,203.61,203.79,201.65,201.85,189.8292,197.01,206.04802249999992,203.935592,198.25519999999997,197.69200000000026,199.81202655424332,199.58609461954646,201.01538461538468,204.5595205338428,197.47124869692652,206.04802249999992,203.935592,198.25519999999997,197.69200000000026,202.43,102038033,126391483.65,57.026349291427024,1.5,2.75,2.58020712671464,0.8073173132658293,0.6987704635761307,1.5917373598169318,0.8929668962408013,12.420926780684145,0.31807564236369285,7818837655.0,2015-10-21,2015,2,294,10,1.06,202.72,205.51,201.85,3975
2015-10-22 13:30:00,202.98,205.51,201.85,205.26,190.0104,196.765,206.06277249999994,203.874592,198.18199999999996,198.31000000000026,200.02567257172402,200.12646656054204,201.53769230769242,205.41322624686399,197.6621583685209,206.06277249999994,203.874592,198.18199999999996,198.31000000000026,204.20666666666668,174911723,127168127.8,63.569331616927975,1.5,2.75,2.657335189092165,1.3754368018619207,0.7491782147955113,1.8294396647351905,1.080261449939679,14.769766635315714,1.952019073163452,7993749378.0,2015-10-22,2015,3,295,10,1.81,203.68,207.95,206.3,3976
2015-10-23 13:30:00,207.25,207.95,206.3,207.51,190.1916,196.52,206.07082249999996,203.830492,198.15899999999996,199.04300000000026,200.3191756081269,200.8296602214428,202.2853846153847,206.69411452413945,197.8766547066299,206.07082249999996,203.830492,198.15899999999996,199.04300000000026,207.25333333333333,144442340,126637505.95,67.1259667201251,1.5,2.75,2.659668389871296,1.1405968470117362,0.8752408628759252,2.174312528534585,1.2990716656586605,15.573343342200832,2.972409686383476,8138191718.0,2015-10-23,2015,4,296,10,0.8,207.12,207.37,206.56,3977
2015-10-26 13:30:00,207.3,207.37,206.56,207.0,190.3728,196.275,206.08457249999992,203.7992,198.11059999999995,199.99250000000018,200.58116872153374,201.41731162892444,202.86923076923085,207.59878733676732,198.13967420169442,206.08457249999992,203.7992,198.11059999999995,199.99250000000018,206.9766666666667,69032965,121163360.65,65.56351452486851,1.5,2.75,2.5375492191662024,0.5697511576904251,0.8639825192025896,2.379049814661897,1.5150672954593076,15.858892334577712,3.3707865168539324,8069158753.0,2015-10-26,2015,0,299,10,0.39,206.96,207.0,205.79,3978
2015-10-27 13:30:00,206.2,207.0,205.79,206.6,190.554,196.03,206.1043224999999,203.7675,198.03079999999997,200.91650000000018,200.81720132068932,201.9109009975983,203.28384615384624,208.29549743069896,198.27219487699352,206.1043224999999,203.7675,198.03079999999997,200.91650000000018,206.4633333333333,77905770,117106370.55,64.29936807706176,1.5,2.75,2.442724274940045,0.665256464136912,0.7722949713196009,2.480436009608809,1.7081410382892082,15.132247398543393,3.668021476240656,7991252983.0,2015-10-27,2015,1,300,10,0.59,206.4,208.98,206.21,3979
2015-10-28 13:30:00,207.0,208.98,206.21,208.95,190.7352,195.785,206.1386724999999,203.7722,198.0102,201.7825000000002,201.13613460223092,202.5812913787794,203.8700000000001,209.56616335116686,198.1738366488333,206.1386724999999,203.7722,198.0102,201.7825000000002,208.04666666666665,135906725,115729104.6,68.18099914665571,1.5,2.75,2.4661011124443264,1.1743521689702938,0.8087407282168597,2.7190669485602825,1.9103262203434228,14.86748253352699,3.261675315048181,8127159708.0,2015-10-28,2015,2,301,10,1.34,207.6,209.27,208.21,3980
2015-10-29 13:30:00,208.35,209.27,208.21,208.83,190.9164,195.54,206.17852249999993,203.776,198.0204,202.61750000000018,201.43785481390807,203.17640648556232,204.4323076923077,210.5193438732056,198.34527151140992,206.17852249999993,203.776,198.0204,202.61750000000018,208.77,90525498,113701431.3,67.77576053504805,1.5,2.75,2.365665318698304,0.7961684999474584,0.7641144980547541,2.865469342911865,2.101354844857111,13.487923793651447,2.7352782014069965,8036634210.0,2015-10-29,2015,3,302,10,0.51,208.74,209.44,207.74,3981
2015-10-30 13:30:00,209.06,209.44,207.74,207.93,191.0976,195.295,206.22307299999989,203.7458,198.0996,203.26400000000018,201.69244874277442,203.62912967741357,205.02307692307699,210.8573015943595,199.18885225179446,206.22307299999989,203.7458,198.0996,203.26400000000018,208.37,131076942,109705111.3,64.6711714104559,1.5,2.75,2.3181177959341386,1.1948116222366023,0.6194939484723947,2.8757222804476044,2.2562283319752097,14.097394461195698,2.242218616315092,7905557268.0,2015-10-30,2015,4,303,10,0.82,208.59,210.62,208.17,3982
2015-11-02 14:30:00,208.32,210.62,208.17,210.39,191.2788,195.05,206.26687299999992,203.7334,198.3548,203.86000000000027,202.03352918423428,204.27302208908844,205.8769230769231,211.34239728180282,200.41144887204342,206.26687299999992,203.7334,198.3548,203.86000000000027,209.72666666666663,86270811,107702609.75,68.86879033857355,1.5,2.75,2.3446808105102708,0.8010094760029712,0.6327955432805643,3.0472227610759153,2.4144272177953505,15.028525216953433,3.594465507902892,7991828079.0,2015-11-02,2015,0,306,11,1.18,209.4,211.66,209.7,3983
2015-11-03 14:30:00,209.97,211.66,209.7,211.0,191.46,211.66,206.31159799999992,203.7433,198.7838,204.52050000000025,202.3851554907349,204.9136866520324,206.5423076923077,212.2298982534041,200.85471713121132,206.31159799999992,203.7433,198.7838,204.52050000000025,210.78666666666663,95246052,106951185.85,69.82616877205163,1.5,2.75,2.317203609759538,0.8905562967163678,0.6248774400454971,3.1955240178522217,2.5706465778067247,14.729946675639644,4.5330691107257906,8087074131.0,2015-11-03,2015,1,307,11,0.93,210.68,211.5,209.7201,3984
2015-11-04 14:30:00,211.35,211.5,209.7201,210.36,191.6412,211.9257575757576,206.34799799999993,203.7558,199.2456,205.06800000000018,202.69789449109825,205.43238316136262,207.0876923076924,212.7752828687862,201.40010174659855,206.34799799999993,203.7558,199.2456,205.06800000000018,210.5267,96224477,105547044.95,67.48136593489932,1.5,2.75,2.278824780491,0.9116738137537028,0.522878019368763,3.2242441020176784,2.7013660826489154,14.060302977312293,2.4846536100555503,7990849654.0,2015-11-04,2015,2,308,11,0.85,210.61,210.98,209.09,3985
2015-11-05 14:30:00,210.43,210.98,209.09,210.15,191.8224,212.19151515151515,206.36824799999994,203.7548,199.5594,205.51500000000016,202.99013392281987,205.88168000313763,207.60923076923083,213.07672048454472,202.1417410539169,206.36824799999994,203.7548,199.5594,205.51500000000016,210.07333333333332,78408744,101814720.6,66.69000812713439,1.5,2.75,2.2510515818844987,0.770112057843235,0.3935070804236389,3.1932499331784636,2.799742852754825,11.731588035664606,1.272227844441239,7912440910.0,2015-11-05,2015,3,309,11,0.9,210.04,210.32,208.46,3986
2015-11-06 14:30:00,209.74,210.32,208.46,210.04,192.0036,212.45727272727277,206.3935979999999,203.7493,199.77480000000003,205.9505000000002,203.26659925917988,206.27771047902928,208.14384615384625,213.0717356285288,203.21595667916364,206.3935979999999,203.7493,199.77480000000003,205.9505000000002,209.60666666666665,110471473,101984832.25,66.25173548718675,1.5,2.75,2.2231193260356052,1.0832147346106948,0.25924692664430626,3.123801511060208,2.864554584415901,10.450870983430551,1.4685990338164212,7801969437.0,2015-11-06,2015,4,310,11,0.89,209.39,209.49,206.95,3987
2015-11-09 14:30:00,209.31,209.49,206.95,208.08,192.1848,212.72303030303033,206.40674799999996,203.70230000000004,199.9508,206.27850000000015,203.45536007254535,206.44935710007408,208.62307692307698,211.9664642852259,205.2796895609281,206.40674799999996,203.70230000000004,199.9508,206.27850000000015,208.1733333333333,131008660,105715486.0,58.83265463496184,1.5,2.75,2.285039374175919,1.2392570375167171,0.010306892593494156,2.8774382001577687,2.8671313075642746,11.977687851230959,0.7163601161665142,7670960777.0,2015-11-09,2015,0,313,11,1.23,208.22,208.6,207.19,3988
2015-11-10 14:30:00,207.51,208.6,207.19,208.56,192.36599999999999,212.98878787878792,206.43584799999996,203.67980000000003,200.1686,206.6940000000002,203.6555420304848,206.65037070959087,208.8769230769231,211.60485703300404,206.14898912084217,206.43584799999996,203.67980000000003,200.1686,206.6940000000002,208.11666666666665,75874602,105107280.2,60.01361371922428,1.5,2.75,2.2225365617347816,0.721877703006152,-0.14177081253216972,2.689917791899063,2.831688604431233,11.906784029160494,-0.1866475233309339,7746835379.0,2015-11-10,2015,1,314,11,0.68,207.9,208.94,207.66,3989
2015-11-11 14:30:00,208.88,208.94,207.66,207.74,192.5472,213.25454545454545,206.47384799999992,203.63830000000004,200.488,207.11650000000014,203.81571685281872,206.75414492772504,208.8946153846154,211.58964346081433,206.19958730841648,206.47384799999992,203.63830000000004,200.488,207.11650000000014,208.11333333333332,67845971,103544270.7,57.005093404542656,1.5,2.75,2.1552125216108693,0.6552363596878373,-0.3078047604274139,2.4469326538969653,2.7547374143243792,10.137366959162199,-0.5219556577120161,7678989408.0,2015-11-11,2015,2,315,11,0.62,208.3,207.06,204.82,3990
2015-11-12 14:30:00,206.5,207.06,204.82,204.84,192.7284,213.52030303030304,206.48809699999993,203.56630000000004,200.6766,207.24100000000016,203.8558848193749,206.5718454107989,208.72846153846157,212.0611328731361,205.39579020378704,206.48809699999993,203.56630000000004,200.6766,207.24100000000016,205.57333333333332,121315200,102902920.95,47.86607034074471,1.5,2.75,2.2098401986386653,1.1789286337065827,-0.6059216284357474,1.9973353787796952,2.6032570072154426,12.744736954738483,-1.4860770451594305,7557674208.0,2015-11-12,2015,3,316,11,1.09,205.94,204.67,202.435,3991
2015-11-13 14:30:00,204.35,204.67,202.435,202.54,192.9096,213.7860606060606,206.5035469999999,203.48670000000004,200.81640000000004,207.2045000000001,203.80428149312488,206.18786013358,208.41615384615383,213.01031427644241,203.82199341586534,206.5035469999999,203.48670000000004,200.81640000000004,207.2045000000001,203.215,153577050,104852770.85,42.101135038790154,1.5,2.75,2.223780184450189,1.4646923372173335,-0.9315261168166749,1.438849361194599,2.3703754780112742,13.804514251513087,-3.7311659299396336,7404097158.0,2015-11-13,2015,4,317,11,1.1,203.55,205.69,202.18,3992
2015-11-16 14:30:00,202.32,205.69,202.18,205.62,202.18,214.0518181818182,206.522047,203.44430000000003,201.07700000000008,207.31700000000012,203.87548614045326,206.1337782160961,208.16000000000003,212.97267557122598,203.3473244287741,206.522047,203.44430000000003,201.07700000000008,207.31700000000012,204.49666666666667,117645231,106908837.55,50.66936195450889,1.5,2.75,2.315653028418033,1.1004256869314355,-0.9118284200189845,1.2305899529875433,2.142418373006528,15.139178997139785,-2.549763033175353,7521742389.0,2015-11-16,2015,0,320,11,1.74,203.94,207.04,204.88,3993
2015-11-17 14:30:00,205.99,207.04,204.88,205.47,202.62852941176467,214.31757575757572,206.525197,203.4008000000001,201.2378,207.43600000000012,203.93801609572967,206.07056124313456,207.90153846153848,212.89983876436668,202.90323815871025,206.525197,203.4008000000001,201.2378,207.43600000000012,205.79666666666665,121123744,109042600.55,50.27912013791585,1.5,2.75,2.304534954959602,1.110792877178863,-0.8807874016992794,1.0414341208824285,1.922221522581708,14.825027729754671,-2.324586423274394,7400618645.0,2015-11-17,2015,1,321,11,1.05,205.96,208.9,205.99,3994
2015-11-18 14:30:00,206.04,208.9,205.99,208.73,203.07705882352943,214.58333333333331,206.548547,203.43390000000008,201.5166,207.7800000000001,204.12593703315204,206.32384112474082,207.9630769230769,212.98092435992424,202.9452294862297,206.548547,203.43390000000008,201.5166,207.7800000000001,207.8733333333333,121342544,110007826.1,57.87294376284576,1.5,2.75,2.384925315319631,1.1030355593946242,-0.624638104407722,1.141423892072055,1.7660619964797768,18.176756194500587,-0.6757078277420966,7521961189.0,2015-11-18,2015,2,322,11,1.41,207.44,209.05,208.2,3995
2015-11-19 14:30:00,208.59,209.05,208.2,208.55,203.52558823529407,214.84909090909093,206.560697,203.46090000000007,201.7706,207.9445000000001,204.29942969851865,206.53585625571787,207.82153846153847,212.65810333377232,202.98497358930481,206.560697,203.46090000000007,201.7706,207.9445000000001,208.6,88220465,105673263.2,57.35209626117898,1.5,2.75,2.2752877927968016,0.8348418732279671,-0.4589321553008401,1.192396802353727,1.6513289576545667,18.176319921462323,-0.7093886878689681,7433740724.0,2015-11-19,2015,3,323,11,0.41,208.62,210.12,208.86,3996
2015-11-20 14:30:00,209.45,210.12,208.86,209.3108,203.97411764705882,215.11484848484852,206.579501,203.47900800000008,202.022016,208.03454000000008,204.4959540240669,206.80013661231618,207.69160000000008,212.2631158018016,203.12008419819855,206.579501,203.47900800000008,202.022016,208.03454000000008,209.43026666666665,94011519,103151722.15,59.03043287529042,1.5,2.75,2.224910093311315,0.911390687818972,-0.2975152669915904,1.2794348739150792,1.5769501409066695,18.35235553711112,0.5915032679738503,7527752243.0,2015-11-20,2015,4,324,11,0.6,209.49,209.98,208.52,3997
2015-11-23 14:30:00,209.38,209.98,208.52,209.07,204.42264705882354,215.38060606060608,206.601701,203.49660800000004,202.28321599999995,208.13804000000007,204.6753283760643,207.0163140778099,207.59236923076932,211.98020485169297,203.20453360984558,206.601701,203.49660800000004,202.28321599999995,208.13804000000007,209.19,64931172,102946632.5,58.24909083355645,1.5,2.75,2.170273658074791,0.630726527164451,-0.21049009351643955,1.3138375240111202,1.5243276175275595,17.459356846934686,0.24453394706558826,7462821071.0,2015-11-23,2015,0,327,11,0.7,209.25,209.83,207.41,3998
2015-11-24 14:30:00,207.87,209.83,207.41,209.35,204.87117647058827,215.64636363636365,206.61440100000002,203.52290800000003,202.501016,208.27554000000006,204.8586488319049,207.2385698799233,207.53083076923082,211.79413175349416,203.26752978496745,206.61440100000002,203.52290800000003,202.501016,208.27554000000006,208.86333333333332,98874365,103995062.25,58.92982571231453,1.5,2.75,2.1881112539265932,0.9507601886165512,-0.14093822027099234,1.3481548421888192,1.4890930624598115,17.43117069602138,0.7750072205641596,7561695436.0,2015-11-24,2015,1,328,11,1.17,208.62,209.74,209.01,3999
2015-11-25 14:30:00,209.5,209.74,209.01,209.32,205.3197058823529,215.9121212121212,206.626351,203.535908,202.683816,208.29404000000008,205.0336037796734,207.43680131993057,207.47544615384624,211.62408667453374,203.32680563315876,206.626351,203.535908,202.683816,208.29404000000008,209.35666666666665,51980062,99798729.1,58.81916872169357,1.5,2.75,2.0839604500746947,0.5208489373438324,-0.10544654629059913,1.3572848795965626,1.4627314258871618,17.222511569016152,2.1870728373364527,7509715374.0,2015-11-25,2015,2,329,11,0.35,209.38,209.8,208.86,4000
2015-11-27 14:30:00,209.43,209.8,208.86,209.56,205.7682352941177,216.1778787878788,206.629551,203.58620800000008,202.880416,208.33054000000007,205.21110951380382,207.6390107180324,207.5892923076924,211.8769434892988,203.30164112608597,206.629551,203.58620800000008,202.880416,208.33054000000007,209.40666666666667,37317779,97138343.15,59.4747760395524,1.5,2.75,2.002248989355073,0.38417145886845394,-0.07569257431172649,1.3681157079975037,1.4438082823092302,14.426090992996368,3.4659820282413403,7547033153.0,2015-11-27,2015,4,331,11,0.45,209.33,209.89,208.56,4001
2015-11-30 14:30:00,209.75,209.89,208.56,208.69,206.21676470588238,216.4436363636364,206.624101,203.624108,203.145216,208.36854000000008,205.34753659169385,207.73910493536263,207.59929230769242,211.89654832408797,203.30203629129682,206.624101,203.624108,203.145216,208.36854000000008,209.04666666666665,112822700,96225631.05,55.99470327016367,1.5,2.75,1.9542312044011385,1.1724807493481229,-0.1217597233165486,1.2916086281635444,1.413368351480093,12.416676219664698,1.493045423596923,7434210453.0,2015-11-30,2015,0,334,11,0.64,209.22,210.82,209.11,4002
2015-12-01 14:30:00,209.44,210.82,209.11,210.68,206.6652941176471,216.70939393939395,206.626951,203.656108,203.429616,208.38304000000008,205.5566528037843,208.01919017961384,207.82544615384626,212.4271815807452,203.22371072694733,206.626951,203.656108,203.429616,208.38304000000008,210.20333333333332,97858418,96805011.4,61.53842119806274,1.5,2.75,1.9667861183724853,1.0108817362320974,-0.030139132424180426,1.3756944359498675,1.405833568374048,10.723629700116867,2.535649973232106,7532068871.0,2015-12-01,2015,1,335,12,0.82,209.96,211.0,208.23,4003
2015-12-02 14:30:00,210.615,211.0,208.23,208.52900000000002,207.11382352941175,211.0,206.618946,203.643698,203.721996,208.25949000000008,205.67321543893001,208.0677434958411,208.10921538461545,212.38282577098641,203.83560499824452,206.618946,203.643698,203.721996,208.25949000000008,209.253,108441259,97464771.75,53.66822719796362,1.5,2.75,2.0241585384887366,1.1126200477661303,-0.12122168907908293,1.2543064570251945,1.3755281461042772,12.916730839467151,-0.09629665117615743,7423627612.0,2015-12-02,2015,2,336,12,1.33,209.62,209.15,204.7511,4004
2015-12-03 14:30:00,208.83,209.15,204.7511,205.61,207.56235294117644,210.967,206.597096,203.592998,203.962196,208.02199000000007,205.67073640210927,207.83367268671338,208.3453692307693,211.57323343855663,205.11750502298202,206.597096,203.592998,203.962196,208.02199000000007,206.5037,166224154,100964755.6,45.21700945057564,1.5,2.75,2.193782928596684,1.6463582070018898,-0.3707800180037375,0.9120531235996054,1.282833141603343,12.191123128795619,-1.40973387676816,7257403458.0,2015-12-03,2015,3,337,12,2.15,206.95,209.97,205.93,4005
2015-12-04 14:30:00,206.08,209.97,205.93,209.62,208.01088235294117,210.93400000000003,206.589001,203.583098,204.296596,207.99549000000007,205.82560948437947,208.00379909750257,208.6530615384616,211.52619308064743,205.77992999627583,206.589001,203.583098,204.296596,207.99549000000007,208.50666666666663,192913879,106690012.35,55.56821173547453,1.5,2.75,2.348512719411206,1.808171868676328,-0.26354795556865906,0.9533981971425192,1.2169461527111782,17.083550587123337,0.14772290775249253,7450317337.0,2015-12-04,2015,4,338,12,1.96,207.95,209.7295,207.2,4006
2015-12-07 14:30:00,209.23,209.7295,207.2,208.35,208.45941176470592,210.90099999999998,206.574706,203.543598,204.606596,207.9109900000001,205.92460519087442,208.0367706120261,208.87460000000007,211.10379858383197,206.64540141616826,206.574706,203.543598,204.606596,207.9109900000001,208.4265,102027111,106267794.25,52.203930494980284,1.5,2.75,2.3614403823104064,0.9600943702659002,-0.27466445576948595,0.8736155829993208,1.1482800387688068,17.339855793072473,-0.3443822643133873,7348290226.0,2015-12-07,2015,0,341,12,1.22,208.46,208.28900000000002,205.78,4007
2015-12-08 14:30:00,206.49,208.28900000000002,205.78,206.949,208.90794117647062,210.868,206.550401,203.488288,204.98537600000003,207.85444000000007,205.9647775363303,207.9331734108808,208.73760000000007,211.19294517453412,206.28225482546608,206.550401,203.488288,204.98537600000003,207.85444000000007,207.00599999999997,103372367,104885979.6,48.7010652407612,1.5,2.75,2.3763374978596628,0.985568971126814,-0.3671108950346964,0.6893914199754363,1.0565023150101327,17.713835097643305,-1.1468832099355062,7244917859.0,2015-12-08,2015,1,342,12,1.22,207.03,208.68,204.18,4008
2015-12-09 14:30:00,206.19,208.68,204.18,205.34,209.3564705882353,210.835,206.518951,203.415788,205.329776,207.69344000000007,205.94027645647418,207.68620451460643,208.49067692307705,211.5445122762005,205.43684156995357,206.518951,203.415788,205.329776,207.69344000000007,206.0666666666667,162401537,109212326.35,44.96910454971941,1.5,2.75,2.5280276765839718,1.4870257087972012,-0.5181245234612994,0.4088466606835084,0.9269711841448078,18.041753317897815,-1.9013949933116712,7082516322.0,2015-12-09,2015,2,343,12,2.2,206.43,207.43,205.14,4009
2015-12-10 14:30:00,205.42,207.43,205.14,205.87,209.805,210.80200000000002,206.49140100000002,203.356988,205.61457600000008,207.5999400000001,205.93752051700463,207.5132326560725,208.22600000000008,211.5353738194675,204.9166261805326,206.49140100000002,203.356988,205.61457600000008,207.5999400000001,206.14666666666668,116128884,111626472.0,46.4254409810285,1.5,2.75,2.5110256996851184,1.0403346260016173,-0.5602436539781849,0.2266666166720768,0.7869102706502616,18.206982517680885,-1.7608322198892907,7198645206.0,2015-12-10,2015,3,344,12,1.12,206.28,204.14,201.51,4010
2015-12-11 14:30:00,203.35,204.14,201.51,201.88,210.25352941176467,210.769,206.447501,203.26208799999998,205.80957600000005,207.45194000000006,205.7784020653574,206.97673430787515,207.67292307692315,212.3527196183017,202.99312653554458,206.447501,203.26208799999998,205.80957600000005,207.45194000000006,202.51,211173305,116119377.25,38.224267240961595,1.5,2.75,2.643095292564754,1.8185879910925893,-0.8190808002647896,-0.2369407296807253,0.5821400705840643,20.73703023451113,-3.2632133786956743,6987471901.0,2015-12-11,2015,4,345,12,1.31,202.82,203.05,199.95,4011
2015-12-14 14:30:00,202.07,203.05,199.95,202.9008,210.70205882352943,210.736,206.40205500000005,203.189296,205.96759200000002,207.4699800000001,205.66555492553942,206.58855008807748,207.17683076923083,212.37854007609587,201.9751214623658,206.40205500000005,203.189296,205.96759200000002,207.4699800000001,201.96693333333332,182385177,117559783.6,41.091420916727664,1.5,2.75,2.6757313430958445,1.5514249126263278,-0.8785395287093852,-0.5160343403026673,0.362505188406718,21.330414216266448,-3.6924245300930334,7169857078.0,2015-12-14,2015,0,348,12,1.55,201.5,206.11,204.58,4012
2015-12-15 14:30:00,204.7,206.11,204.58,205.0308,211.15058823529407,210.703,206.37160900000003,203.159604,206.09880800000008,207.44052000000016,205.6406625755183,206.440192936832,206.8468923076924,212.0069425677153,201.68684204766944,206.37160900000003,203.159604,206.09880800000008,207.44052000000016,205.24026666666668,154069569,119381000.5,46.65495527791162,1.5,2.75,2.713836247160428,1.2905702612200842,-0.7371258806537097,-0.5589021624104191,0.17822371824329053,21.536944065983764,-1.6775604352392222,7323926647.0,2015-12-15,2015,1,349,12,0.75,205.35,208.39,204.8,4013
2015-12-16 14:30:00,206.365,208.39,204.8,208.03,211.59911764705882,210.67,206.36060849999998,203.17200400000002,206.30360800000003,207.56852000000006,205.73436208236072,206.59160313332416,206.72920000000008,211.7027796413881,201.7556203586121,206.36060849999998,203.17200400000002,206.30360800000003,207.56852000000006,207.07333333333332,197017008,123175663.7,53.337619302144105,1.5,2.75,2.7764193723632524,1.5994799790959031,-0.4200720832807767,-0.3468663858576804,0.07320569742309635,23.002843293627702,1.1769855551772712,7520943655.0,2015-12-16,2015,2,350,12,1.75,206.6,208.48,204.84,4014
2015-12-17 14:30:00,208.4,208.48,204.84,204.86,212.04764705882354,210.637,206.3326085,203.127304,206.41260800000006,207.37502000000006,205.70007337324853,206.4266885491981,206.43458461538467,211.3621960522632,201.50697317850617,206.3326085,203.127304,206.41260800000006,207.37502000000006,206.06000000000003,173092476,125763160.3,46.68126167626802,1.5,2.75,2.8381037029087333,1.3763368826538624,-0.4022974293700752,-0.4296660892894977,-0.02736865991942246,23.28910175814525,-2.2707756893426154,7347851179.0,2015-12-17,2015,3,351,12,1.78,206.66,202.93,199.83,4015
2015-12-18 14:30:00,202.77,202.93,199.83,200.0208,212.49617647058827,210.604,206.2952125,203.01981199999997,206.38882400000008,206.94856000000013,205.47735677037602,205.8166039254649,205.61464615384625,210.97224594055248,200.25704636713996,206.2952125,203.01981199999997,206.38882400000008,206.94856000000013,200.9269333333333,251393535,133921813.8,38.734351535077025,1.5,2.75,2.9946677241295383,1.877166444112184,-0.6786444485367232,-0.8756742205903265,-0.19702977205360328,23.131867859872408,-3.9976961843052488,7096457644.0,2015-12-18,2015,4,352,12,1.55,201.38,201.88,200.09,4016
2015-12-21 14:30:00,201.41,201.88,200.09,201.67,212.9447058823529,210.571,206.2617625,202.92831199999992,206.39562400000008,206.5665200000001,205.32804866173385,205.42168926589684,205.0870307692309,210.54273931964005,199.63132221882168,206.2617625,202.92831199999992,206.39562400000008,206.5665200000001,201.2133333333333,99094290,134175952.35,42.33712102932886,1.5,2.75,2.9135628866917136,0.7385398669763942,-0.7092333690296588,-1.0835714833406769,-0.3743381143110181,24.241608273293238,-2.5508700211163253,7195551934.0,2015-12-21,2015,0,355,12,0.89,200.98,203.85,201.55,4017
2015-12-22 14:30:00,202.715,203.85,201.55,203.5,213.3932352941177,210.53799999999998,206.2543625,202.85831199999996,206.4352240000001,206.2880200000001,205.25636047892075,205.23867124057327,204.9247230769232,210.43382483040196,199.4156213234444,206.2543625,202.85831199999996,206.4352240000001,206.2880200000001,202.96666666666667,111026246,136480706.05,46.12315124040593,1.5,2.75,2.8697369662137326,0.8134940770259884,-0.5710276327119894,-1.0881226552010048,-0.5170950224890154,25.085330762041288,-0.8960748027661456,7306578180.0,2015-12-22,2015,1,356,12,1.14,202.7,206.07,204.58,4018
2015-12-23 14:30:00,204.69,206.07,204.58,206.02,213.84176470588238,210.505,206.2619625,202.82061199999995,206.55062400000008,206.12152000000012,205.28630712680618,205.31308350337588,204.64780000000007,209.50879831469132,199.7868016853088,206.2619625,202.82061199999995,206.55062400000008,206.12152000000012,205.55666666666664,110987228,137086349.2,50.90362877628504,1.5,2.75,2.8483271829127514,0.8096154624270935,-0.2889339731571574,-0.8782624889354622,-0.5893285157783048,25.927474118505216,0.0728615145480185,7417565408.0,2015-12-23,2015,2,357,12,0.73,205.32,206.33,205.42,4019
2015-12-24 14:30:00,205.72,206.33,205.42,205.68,214.2902941176471,210.472,206.2548625,202.78361199999992,206.67842400000006,205.9395200000002,205.30174606300992,205.34802793162584,204.44241538461543,208.8663368986246,200.01849387060628,206.2548625,202.78361199999992,206.67842400000006,205.9395200000002,205.81000000000003,48542150,136914453.6,50.25571441489356,1.5,2.75,2.709875241276128,0.3545436491447241,-0.1133019462094358,-0.7309559485400996,-0.6176540023306638,25.90699003910497,1.8823063205864927,7369023258.0,2015-12-24,2015,3,358,12,0.44,205.88,205.26,203.94,4020
2015-12-28 14:30:00,204.86,205.26,203.94,205.21,214.73882352941175,210.43900000000002,206.2517765,202.73501199999995,206.7356240000001,205.72202000000016,205.298148178186,205.3348824143281,204.30864615384624,208.52143291988173,200.09585938781072,206.2517765,202.73501199999995,206.7356240000001,205.72202000000016,204.8033333333333,65899939,138343561.6,49.32115751532875,1.5,2.75,2.640598438327834,0.4763498802390238,-0.02164298738834114,-0.6447077365660903,-0.6230647491777491,22.88086105592445,1.1380930977108046,7303123319.0,2015-12-28,2015,0,362,12,0.65,204.6,207.79,206.47,4021
2015-12-29 14:30:00,206.51,207.79,206.47,207.4,215.18735294117644,210.40599999999998,206.2458765,202.72551199999995,206.81822400000004,205.65752000000012,205.3805737398257,205.5315602796302,204.46710769230774,208.9682513818195,199.96596400279603,206.2458765,202.72551199999995,206.81822400000004,205.65752000000012,207.22,92640672,137334460.2,53.646620866742204,1.5,2.75,2.6362699784472734,0.6745624649857546,0.18238267958019394,-0.3950863997025067,-0.5774690792827006,23.40068545235354,1.1555337051799075,7395763991.0,2015-12-29,2015,1,363,12,0.64,207.13,207.21,205.76,4022
2015-12-30 14:30:00,207.11,207.21,205.76,205.93,215.63588235294117,210.373,206.2357265,202.70531199999996,206.86942400000004,205.42002000000016,205.4021198676757,205.56950691966546,204.47172307692315,208.97873052082264,199.96471563302367,206.2357265,202.70531199999996,206.86942400000004,205.42002000000016,206.30000000000004,63317679,135607423.25,50.5291267280536,1.5,2.75,2.5651078371296117,0.4669189745112276,0.21215392312009876,-0.3122766753825772,-0.5244305985026759,23.304754250061034,-1.0094697880113417,7332446312.0,2015-12-30,2015,2,364,12,0.7,206.48,205.89,203.87,4023
2015-12-31 14:30:00,205.13,205.89,203.87,203.87,216.08441176470592,210.34,206.2027765,202.63831199999996,206.88502400000004,205.18707000000006,205.34203673561,205.40764911779254,204.62480000000005,208.89844180494086,200.35115819505924,206.2027765,202.63831199999996,206.88502400000004,205.18707000000006,204.54333333333332,114877859,135929253.25,46.455036450416024,1.5,2.75,2.5290287059060685,0.845129773417629,0.09300924878557483,-0.4081690375207073,-0.5011782863062823,22.109630919789513,-0.4832568583422869,7217568453.0,2015-12-31,2015,3,365,12,0.99,204.88,201.03,198.59,4024
2016-01-04 14:30:00,200.49,201.03,198.59,201.0192,216.53294117647062,210.307,206.1603725,202.56180399999997,206.86840800000004,204.9575300000001,205.1725137263704,204.9897015827647,204.4800615384616,209.09154826254039,199.8685748143828,206.1603725,202.56180399999997,206.86840800000004,204.9575300000001,200.2130666666667,222353534,138735722.25,41.47165188043723,1.5,2.75,2.7255266554842064,1.6027129162835347,-0.1639062726248901,-0.7060611270873949,-0.5421548544625048,21.839694813232388,0.4991480885987876,6995214919.0,2016-01-04,2016,0,4,1,1.23,199.81,201.9,200.05,4025
2016-01-05 14:30:00,201.4,201.9,200.05,201.36,216.9814705882353,210.274,206.1151225,202.486204,206.79040800000007,204.54453000000007,205.02300338415975,204.64401571773948,204.19769230769242,209.08122293621682,199.31416167916802,206.1151225,202.486204,206.79040800000007,204.54453000000007,201.10333333333332,110845849,134632320.75,42.26894607763406,1.5,2.75,2.662989037235334,0.8233227235667332,-0.2896519243619803,-0.9042197599149802,-0.6145678355529999,16.759535008371678,-0.15371646749639206,7106060768.0,2016-01-05,2016,1,5,1,0.92,200.98,200.06,197.6,4026
2016-01-06 14:30:00,198.34,200.06,197.6,198.82,217.43,210.24099999999999,206.0592225,202.387804,206.61660800000004,204.06803000000008,204.77974834948685,204.08934755414523,203.4892307692309,208.60983450729745,198.3686270311643,206.0592225,202.387804,206.61660800000004,204.06803000000008,198.82666666666668,152112604,137136595.4,38.102855794221426,1.5,2.75,2.741346963147097,1.1092050488516063,-0.5097767987213305,-1.2517888339546632,-0.7420120352333325,17.587563240006407,-2.2997542997543032,6953948164.0,2016-01-06,2016,2,6,1,1.24,198.83,197.44,193.59,4027
2016-01-07 14:30:00,195.33,197.44,193.59,194.05,217.87852941176467,210.208,205.9853725,202.234104,206.35760800000003,203.42308000000008,204.3589739044089,203.13321921565517,202.6576923076924,209.7493565812537,195.56602803413105,205.9853725,202.234104,206.35760800000003,203.42308000000008,195.02666666666664,213436073,142639780.7,31.770070278006013,1.5,2.75,2.9191078943508755,1.496329228442231,-0.9186689376097528,-1.8903482072455235,-0.9716792696357708,20.485377553747472,-5.8101155227647805,6740512091.0,2016-01-07,2016,3,7,1,1.99,195.52,195.85,191.58,4028
2016-01-08 14:30:00,195.19,195.85,191.58,191.923,218.32705882352943,210.175,205.9161875,202.04743399999995,206.06406800000005,202.75223000000008,203.87128865325562,202.06557929035472,202.03478461538467,211.09329982801466,192.97626940275464,205.9161875,202.04743399999995,206.06406800000005,202.75223000000008,193.11766666666668,209817228,145010565.25,29.42183903732536,1.5,2.75,3.0156001876115264,1.4469099381708672,-1.25367802148611,-2.5387767964934085,-1.2850987750072984,17.545957984271507,-6.688545313107742,6530694863.0,2016-01-08,2016,4,8,1,2.23,193.72,193.41,189.82,4029
2016-01-11 14:30:00,193.01,193.41,189.82,192.11,218.77558823529407,210.142,205.85038750000004,201.868734,205.72726800000004,202.06423000000007,203.41006164724558,201.1174288817495,201.29940000000005,211.79514672771015,190.80365327228992,205.85038750000004,201.868734,205.72726800000004,202.06423000000007,191.78,187941323,148601187.2,29.91232113835743,1.5,2.75,3.0566287456392742,1.2647363492934465,-1.3742854482024316,-3.002955585260338,-1.6286701370579064,17.903758236991166,-6.383704497831488,6718636186.0,2016-01-11,2016,0,11,1,1.89,191.62,194.55,191.14,4030
2016-01-12 14:30:00,193.82,194.55,191.14,193.6608,219.22411764705882,210.109,205.78999150000004,201.722142,205.42388400000004,201.65327000000008,203.02773766107913,200.4072737501543,200.54253846153856,211.69299109823487,189.39208582484216,205.78999150000004,201.722142,205.42388400000004,201.65327000000008,193.1169333333333,172330490,146659046.45,34.00815174258139,1.5,2.75,3.0818695495221853,1.1750416641277706,-1.2640208248180351,-3.2086961680804507,-1.9446753432624155,19.74319325753972,-6.624493731919003,6890966676.0,2016-01-12,2016,1,12,1,1.78,192.84,194.86,188.38,4031
2016-01-13 14:30:00,194.45,194.86,188.38,188.83,219.67264705882354,210.076,205.69289150000003,201.570742,205.04188400000004,200.94973000000007,202.47096363515442,199.30467625013958,199.2202307692308,211.48062897568198,186.9598325627796,205.69289150000003,201.570742,205.04188400000004,200.94973000000007,190.69000000000003,221168886,148598231.9,28.43392026717139,1.5,2.75,3.3245931531277444,1.488368220618108,-1.419208171200787,-3.718685557263399,-2.299477386062612,19.567577017314747,-8.303792550866799,6669797790.0,2016-01-13,2016,2,13,1,3.44,191.62,193.26,187.66,4032
2016-01-14 14:30:00,189.55,193.26,187.66,191.93,220.12117647058827,210.043,205.62039150000004,201.513742,204.67268400000003,200.2946900000001,202.05759251220718,198.60232613107868,198.16253846153853,210.3836678379079,185.94140908516914,205.62039150000004,201.513742,204.67268400000003,200.2946900000001,190.95,240795609,152934533.9,35.7156498542943,1.5,2.75,3.4871222136186195,1.5745012121163564,-1.2232807017384235,-3.8285782632356415,-2.6052975614972183,24.524149762969326,-5.856673370284986,6910593399.0,2016-01-14,2016,3,14,1,2.98,190.46,188.76,185.52,4033
2016-01-15 14:30:00,186.77,188.76,185.52,187.81,220.5697058823529,210.01,205.53094150000004,201.496342,204.20888400000004,199.28369000000004,201.4988633940814,197.57448554716643,196.82407692307697,209.46863936892788,184.1795144772261,205.53094150000004,201.496342,204.20888400000004,199.28369000000004,187.3633333333333,324846450,159326006.0,31.175584274437355,1.5,2.75,3.6958991983601455,2.03887901388804,-1.2755275382327276,-4.1997069842881265,-2.9241794460554,25.91537342237299,-6.571113605068575,6585746949.0,2016-01-15,2016,4,15,1,1.75,187.14,190.11,186.2,4034
2016-01-19 14:30:00,189.96,190.11,186.2,188.06,221.0182352941177,209.977,205.43906650000002,201.504242,203.762884,198.44369000000003,200.97184914333317,196.6683440664839,195.33638461538465,207.1791109693277,183.49365826144162,205.43906650000002,201.504242,203.762884,198.44369000000003,188.12333333333336,195244373,160433600.85,31.74258146238529,1.5,2.75,3.7111921127629945,1.2169793108523874,-1.1987959801070511,-4.422674421189214,-3.223878441082163,26.14416129789917,-6.605085419149788,6780991322.0,2016-01-19,2016,1,19,1,2.1,188.16,187.495,181.02,4035
2016-01-20 14:30:00,185.03,187.495,181.02,185.65,181.02,209.944,205.32816650000004,201.41614200000004,203.272884,197.72515000000004,200.3709923141828,195.61897796491402,193.77638461538467,204.95022225042752,182.60254698034183,205.32816650000004,201.41614200000004,203.272884,197.72515000000004,184.72166666666664,286547840,162191316.1,29.24164907920949,1.5,2.75,3.9489641047084953,1.7667273864608588,-1.212268345254973,-4.739213872650879,-3.5269455273959065,25.776608716115195,-6.624082084297347,6494443482.0,2016-01-20,2016,2,20,1,3.58,184.26,188.87,184.64,4036
2016-01-21 14:30:00,186.21,188.87,184.64,186.69,180.5279069767442,209.91099999999997,205.22521650000007,201.29034199999998,202.80588400000002,196.97615,199.83448281166585,194.76859911111268,192.45484615384623,202.5529701071344,182.3567222005581,205.22521650000007,201.29034199999998,202.80588400000002,196.97615,186.73333333333332,195772941,167025248.65,31.740963200450665,1.5,2.75,3.9690380972293178,1.1721158482466356,-1.0586385933808429,-4.85024376912196,-3.7916051757411164,26.70598098250717,-3.792836897706784,6690216423.0,2016-01-21,2016,3,21,1,2.29,186.76,190.76,188.88,4037
2016-01-22 14:30:00,189.78,190.76,188.88,190.52,180.0358139534884,209.878,205.13794150000004,201.20274200000003,202.454684,196.32715,199.46920897591426,194.36397062434008,191.64721538461544,200.47593329548482,182.8184974737461,205.13794150000004,201.20274200000003,202.454684,196.32715,190.0533333333333,168319598,169889916.25,40.12814356756463,1.5,2.75,3.9762496617129375,0.9907568484071224,-0.6278618637714839,-4.576432505455472,-3.9485706416839887,27.94331748522353,-0.7310223370830966,6858536021.0,2016-01-22,2016,4,22,1,1.0,189.82,190.15,187.41,4038
2016-01-25 14:30:00,189.92,190.15,187.41,187.64,179.54372093023258,209.845,205.03164150000003,201.10244200000002,202.036284,195.40815000000003,199.0053184278392,193.723592469641,190.5918307692308,197.62067372177378,183.56298781668772,205.03164150000003,201.10244200000002,202.036284,195.40815000000003,188.4,130371686,170859139.15,36.496635188001754,1.5,2.75,3.9143746858762998,0.7630360696453269,-0.4727423057633917,-4.539498523888227,-4.0667562181248345,28.546191721373766,-2.3267919421165097,6728164335.0,2016-01-25,2016,0,25,1,1.46,188.78,190.53,188.02,4039
2016-01-26 14:30:00,188.42,190.53,188.02,190.2,179.05162790697673,209.812,204.9324415,201.08674200000004,201.68548400000003,194.63415000000006,198.66001182282588,193.3880122344371,189.92875384615382,195.11156856856326,184.7459391237444,204.9324415,201.08674200000004,201.68548400000003,194.63415000000006,189.58333333333331,141036757,175483869.5,41.55936841785036,1.5,2.75,3.8412050654565655,0.8037021146265526,-0.15028537959293686,-4.254612942616006,-4.1043275630230704,29.941783157111818,-1.7870420859564795,6869201092.0,2016-01-26,2016,1,26,1,1.33,189.28,191.56,187.06,4040
2016-01-27 14:30:00,189.58,191.56,187.06,188.13,178.55953488372094,209.77900000000002,204.82764150000003,201.01394200000007,201.351284,193.78015000000008,198.2470701827151,192.8872491644907,189.47336923076924,194.14258316782553,184.8041552937129,204.82764150000003,201.01394200000007,201.351284,193.78015000000008,188.91666666666663,185681707,181472957.9,38.86148742235208,1.5,2.75,3.8882618464953818,1.0231921557277928,-0.03498161052262372,-4.1480545761763485,-4.113072965653726,29.826573664566716,-0.3707038076576905,6683519385.0,2016-01-27,2016,2,27,1,2.41,189.31,190.2,187.16,4041
2016-01-28 14:30:00,189.96,190.2,187.16,189.11,178.06744186046512,209.74599999999998,204.72574150000003,200.94954200000006,201.082684,192.86565000000007,197.88875370496154,192.5275111488249,189.25698461538462,193.7076620897148,184.80630714105445,204.72574150000003,200.94954200000006,201.082684,192.86565000000007,188.82333333333332,143798780,184030863.3,40.82018709779961,1.5,2.75,3.8276717146028543,0.7813840429884024,0.13916176360608912,-3.939120761146114,-4.078282524752203,26.403165978675894,-1.469285677069761,6827318165.0,2016-01-28,2016,3,28,1,1.62,188.68,193.88,189.88,4042
2016-01-29 14:30:00,190.02,193.88,189.88,193.7208,177.57534883720933,209.713,204.64219550000004,200.96085000000005,200.8447,192.25519000000008,197.7253045400611,192.64115770607967,189.3808923076923,194.21551369701766,184.5462709183669,204.64219550000004,200.96085000000005,200.8447,192.25519000000008,192.4936,210529336,191391446.15,49.085009765230645,1.5,2.75,3.894980877845506,1.0999934439860022,0.5724477748230976,-3.3627228062233314,-3.9351705810464286,28.4443537354321,3.1472232575475187,7037847501.0,2016-01-29,2016,4,29,1,2.11,191.88,194.58,191.84,4043
2016-02-01 14:30:00,192.53,194.58,191.84,193.65,177.08325581395349,209.68,204.55859550000002,200.92305000000007,200.6083,191.7441900000001,197.56548867574497,192.7372379245483,189.38006153846152,194.21174366601193,184.54837941091114,204.55859550000002,200.92305000000007,200.6083,191.7441900000001,193.35666666666668,136061564,192450631.4,48.97191339122712,1.5,2.75,3.8124822437136854,0.7069946355083769,0.8453723026588427,-2.878455202722876,-3.7238275053817183,24.62071190034611,2.972455599276828,6901785937.0,2016-02-01,2016,0,32,2,1.43,193.21,191.97,189.54,4044
2016-02-02 14:30:00,191.96,191.97,189.54,190.16,176.59116279069767,209.647,204.46964550000007,200.87675000000007,200.2369,191.20123000000007,197.27507735512756,192.49178669363891,189.4823692307692,194.31945073061593,184.64528773092255,204.46964550000007,200.87675000000007,200.2369,191.20123000000007,190.55666666666664,182564890,190461199.2,43.63476482925386,1.5,2.75,3.833733512019852,0.9585411137115218,0.7833460740895002,-2.7446449127698433,-3.527990986859343,27.49513298139017,2.4293024508483656,6719221047.0,2016-02-02,2016,1,33,2,1.28,190.76,191.78,187.1,4045
2016-02-03 14:30:00,191.41,191.78,187.1,191.3,176.09906976744188,209.614,204.37689550000007,200.83125000000007,199.8919,190.69823000000008,197.0407605961029,192.3782831990066,189.4339076923077,194.1837665121969,184.68404887241851,204.37689550000007,200.83125000000007,199.8919,190.69823000000008,190.06000000000003,205054934,195171653.45,45.715893907434605,1.5,2.75,3.894181118304148,1.0506389138755334,0.8083210971933505,-2.5175896153676547,-3.325910712561005,26.07676762435637,2.4693341903690684,6924275981.0,2016-02-03,2016,2,34,2,2.5,189.44,192.75,189.96,4046
2016-02-04 14:30:00,190.71,192.75,189.96,191.6,175.60697674418606,209.581,204.28689550000007,200.77985000000004,199.537684,190.33723000000006,196.82739743547143,192.30416098957744,189.72544615384612,194.5059744494654,184.9449178582269,204.28689550000007,200.77985000000004,199.537684,190.33723000000006,191.43666666666667,139531794,194542612.95,46.278029026762745,1.5,2.75,3.8153110384252793,0.7172299779681766,0.8310684224773417,-2.287075184464328,-3.1181436069416697,26.032868732081212,0.5668696199873945,7063807775.0,2016-02-04,2016,3,35,2,1.47,191.36,191.6696,187.2,4047
2016-02-05 14:30:00,190.99,191.6696,187.2,187.95,175.11488372093027,209.548,204.1734955000001,200.69925000000006,199.11528400000003,190.03223000000008,196.47926420270787,191.8894789905701,189.7169846153846,194.50964831786843,184.92432091290084,204.1734955000001,200.69925000000006,199.11528400000003,190.03223000000008,188.9398666666667,180788308,192910224.7,40.749085121519855,1.5,2.75,3.8620459642520464,0.937162912339918,0.5972530724235279,-2.37157726641226,-2.9688303388357875,26.078324418074022,0.16520997655084327,6883019467.0,2016-02-05,2016,4,36,2,2.39,189.43,186.12,182.8,4048
2016-02-08 14:30:00,185.77,186.12,182.8,185.42,174.62279069767442,209.515,204.04479550000008,200.56885000000003,198.63668400000003,189.70708000000005,196.0455675673076,191.2733381343253,189.6992923076923,194.55318610162325,184.84539851376138,204.04479550000008,200.56885000000003,198.63668400000003,189.70708000000005,184.78,191526694,191995698.0,37.41254097688193,1.5,2.75,3.9540426810911833,0.9975572160997066,0.2850007178361813,-2.6125794415405608,-2.8975801593767416,25.76811728103588,-2.5131440588853846,6691492773.0,2016-02-08,2016,0,39,2,1.82,184.46,186.94,183.2,4049
2016-02-09 14:30:00,183.36,186.94,183.2,185.43,174.13069767441863,209.482,203.91369600000007,200.42135000000005,198.15888400000003,189.37308,195.62927079996217,190.71682974057998,189.6023692307692,194.73506441923197,184.46967404230645,203.91369600000007,200.42135000000005,198.15888400000003,189.37308,185.19,184513136,191824288.65,37.434347134933354,1.5,2.75,3.9387539181560998,0.9618861995972792,0.1014016445957493,-2.770828103632056,-2.872229748227805,24.054049059646267,-1.435177802583314,6876005909.0,2016-02-09,2016,1,40,2,2.04,185.07,188.34,185.12,4050
2016-02-10 14:30:00,186.41,188.34,185.12,185.27,173.6386046511628,209.449,203.78619600000007,200.27675000000008,197.67308400000005,188.95354000000003,195.22302488623816,190.198084051001,189.1985230769231,194.78496282063355,183.61208333321258,203.78619600000007,200.27675000000008,197.67308400000005,188.95354000000003,186.2433333333333,148214057,190618467.0,37.21095528686849,1.5,2.75,3.8874143525735216,0.7775430121363844,-0.003015595230832613,-2.8759992422663463,-2.872983647035513,23.455099777275013,-2.030564221881446,6727791852.0,2016-02-10,2016,2,41,2,1.74,186.73,184.1,181.09,4051
2016-02-11 14:30:00,182.34,184.1,181.09,182.86,181.09,209.416,203.64329600000008,200.15085000000008,197.15648400000006,188.65504000000004,194.73820038089545,189.4992189032866,188.8308307692308,195.3333111401807,182.32835039828083,203.64329600000008,200.15085000000008,197.15648400000006,188.65504000000004,182.6833333333333,219058885,190512966.95,33.92681368189682,1.5,2.75,3.9083133273896986,1.1498371397338631,-0.19591234206582,-3.117874074617788,-2.921961732551968,23.878899880976476,-5.606419135167718,6508732967.0,2016-02-11,2016,3,42,2,1.66,182.6,186.65,183.96,4052
2016-02-12 14:30:00,184.96,186.65,183.96,186.63,181.094375,209.38299999999998,203.52359600000008,200.05255000000008,196.67548400000004,188.39004000000008,194.42023173850743,189.22595996011643,188.5562153846154,195.10557754819328,182.00685322103752,203.52359600000008,200.05255000000008,196.67548400000004,188.39004000000008,185.74666666666667,127632393,184854806.15,42.4791597766598,1.5,2.75,3.8998623754332913,0.6904467114392091,-0.03931467729524574,-2.971105079171025,-2.931790401875779,22.380261002125174,-3.625096824167317,6636365360.0,2016-02-12,2016,4,43,2,1.46,185.3,189.81,187.63,4053
2016-02-16 14:30:00,188.77,189.81,187.63,189.78,181.09875,209.35,203.43019600000008,200.01125000000008,196.30050400000005,188.48854000000009,194.23826186640912,189.27872567820057,188.68313846153848,195.25844276196332,182.10783416111371,203.43019600000008,200.01125000000008,196.30050400000005,188.48854000000009,189.07333333333332,120250668,174625017.05,48.47972395434825,1.5,2.75,3.8484436343309136,0.6886222262504855,0.2886528600203229,-2.570974326850376,-2.8596271868706986,25.27765375762921,-0.19983172065628704,6756616028.0,2016-02-16,2016,1,47,2,1.16,188.72,193.32,191.01,4054
2016-02-17 14:30:00,191.16,193.32,191.01,192.88,181.103125,209.317,203.34099600000005,200.00405000000006,196.045904,188.72954000000007,194.18499669517732,189.62170418503865,188.9731384615385,195.92020585810212,182.02607106497487,203.34099600000005,200.00405000000006,196.045904,188.72954000000007,192.4033333333333,136009496,171663273.2,53.60879101986914,1.5,2.75,3.82641194616442,0.7923039882942183,0.7029903317668547,-1.9808892721621305,-2.683879603928985,24.93130598700524,0.8259278619968552,6892625524.0,2016-02-17,2016,2,48,2,1.21,192.16,193.27,191.72,4055
2016-02-18 14:30:00,193.2,193.27,191.72,192.09,181.1075,209.284,203.244846,199.99595000000008,195.695304,189.05154000000007,194.10283996203316,189.8567799769397,188.84769230769237,195.49994769778274,182.19543691760197,203.244846,199.99595000000008,195.695304,189.05154000000007,192.36,102342997,162453031.05,52.18305290274946,1.5,2.75,3.6638110928669616,0.6299851491752144,0.8998895808047442,-1.5590176279230548,-2.4589072087277986,24.928318759397968,0.2557411273486477,6790282527.0,2016-02-18,2016,3,49,2,0.81,192.5,192.18,190.45,4056
2016-02-19 14:30:00,191.17,192.18,190.45,192.0,181.111875,209.25099999999998,203.16034600000003,199.98745000000008,195.368304,189.31704000000008,194.02037564979653,190.06089616961214,188.72076923076926,195.05713781725086,182.3844006442877,203.16034600000003,199.98745000000008,195.368304,189.31704000000008,191.5433333333333,114792988,158404033.4,52.01333854716407,1.5,2.75,3.5256817290907514,0.7246847541446504,0.9928023146208752,-1.2179043154517046,-2.21070663007258,24.921198891824236,2.1548284118116583,6675489539.0,2016-02-19,2016,4,50,2,0.91,191.32,194.95,193.79,4057
2016-02-22 14:30:00,193.87,194.95,193.79,194.78,181.11625,209.218,203.094046,200.05515000000008,195.124924,189.53004000000007,194.0501648400006,190.5103346296491,189.07615384615391,196.1686657737841,181.9836419185237,203.094046,200.05515000000008,195.124924,189.53004000000007,194.50666666666663,103640292,155170068.1,56.69805655821093,1.5,2.75,3.4845616055842683,0.6679142006511758,1.1965615740703135,-0.715004662484688,-1.9115662365550012,22.69621233524869,5.0479991370941715,6779129831.0,2016-02-22,2016,0,53,2,0.6,194.37,194.32,192.18,4058
2016-02-23 14:30:00,194.0,194.32,192.18,192.32,181.120625,209.185,203.011296,200.09715000000008,194.864524,189.76404000000008,193.982315238432,190.68268371253964,189.15461538461545,196.36537919940585,181.94385156982497,203.011296,200.09715000000008,194.864524,189.76404000000008,192.94,111455289,154224248.25,51.872218588541976,1.5,2.75,3.42137863375682,0.7226833021700271,1.1219841269847488,-0.5090860778240653,-1.6310702048088142,22.46824909086336,3.715687860648216,6667674542.0,2016-02-23,2016,1,54,2,1.11,193.25,193.53,189.32,4059
2016-02-24 14:30:00,190.63,193.53,189.32,193.2,181.125,209.152,202.919196,200.11285000000007,194.611124,189.91404000000009,193.95163620947383,190.92242812086917,189.27769230769238,196.70264878554715,181.85273582983757,202.919196,200.11285000000007,194.611124,189.91404000000009,192.01666666666665,150812152,154713018.0,53.40020951670308,1.5,2.75,3.4777087313456185,0.9747864397551859,1.087453865902233,-0.27175287243102275,-1.3592067383332558,22.35291536193109,4.280239650240178,6818486694.0,2016-02-24,2016,2,55,2,2.22,191.42,195.55,192.83,4060
2016-02-25 14:30:00,193.73,195.55,192.83,195.54,181.129375,209.11900000000003,202.84387099999995,200.1469500000001,194.484324,190.28454000000008,194.01392498557288,191.3621968712626,189.86153846153846,197.941804436409,181.781272486668,202.84387099999995,200.1469500000001,194.484324,190.28454000000008,194.64,110728317,150965348.5,57.28381627445451,1.5,2.75,3.4235866791066467,0.73346842901502,1.1705298003521416,0.10395551210692132,-1.0665742882452205,22.528762304017647,6.934266652083548,6929215011.0,2016-02-25,2016,3,56,2,1.41,194.19,196.68,194.9,4061
2016-02-26 14:30:00,196.57,196.68,194.9,195.0892,181.13375,209.08599999999998,202.76941699999998,200.14784200000008,194.32809200000003,190.58350000000007,194.05609263319752,191.71714955019002,190.60532307692313,198.69337976626142,182.51726638758487,202.76941699999998,200.14784200000008,194.32809200000003,190.58350000000007,195.5564,129833663,150267092.65,56.310192810261704,1.5,2.75,3.3061876305990285,0.8640192653650839,1.1421938316196016,0.3611680012792817,-0.7810258303403199,20.00480947063444,4.532604618764405,6799381348.0,2016-02-26,2016,4,57,2,0.91,195.79,196.23,193.33,4062
2016-02-29 14:30:00,195.11,196.23,193.33,193.56,181.138125,209.053,202.687117,200.09874200000007,194.098676,190.57546000000008,194.0366380201309,191.89265911683853,191.2307076923077,198.8659683674899,183.5954470171256,202.687117,200.09874200000007,194.098676,190.57546000000008,194.3733333333333,125918102,146036530.95,53.018269548765424,1.5,2.75,3.2771742284133816,0.8622370113893754,0.9740881992382079,0.43658441870744014,-0.5375037805307679,19.370935523980158,1.991779955738224,6673463246.0,2016-02-29,2016,0,60,2,1.5,194.78,198.21,194.4542,4063
2016-03-01 14:30:00,195.01,198.21,194.4542,198.11,181.1425,209.02,202.616617,200.10194200000007,193.900276,190.79846000000006,194.196377705616,192.4847868199968,192.2184000000001,199.8357602405033,184.6010397594968,202.616617,200.10194200000007,193.900276,190.79846000000006,196.92473333333336,141799687,146323437.1,60.430588091373316,1.5,2.75,3.3752332120981405,0.9690838994103974,1.1129302223373867,0.8536589973909656,-0.25927122494642113,21.24137373782524,2.7115304852758286,6815262933.0,2016-03-01,2016,1,61,3,1.93,196.33,199.06,197.25,4064
2016-03-02 14:30:00,197.74,199.06,197.25,199.0,181.146875,208.987,202.54941699999995,200.09784200000007,193.783076,191.24046000000007,194.38475505049382,193.10528331333043,193.4599384615385,199.70987612498115,187.2100007980959,202.54941699999995,200.09784200000007,193.783076,191.24046000000007,198.43666666666664,102414960,142315940.6,61.703355603986815,1.5,2.75,3.2634308398054164,0.7196309813800297,1.200773518379086,1.2416956730274364,0.04092215464835042,19.860665496679673,3.597272112030817,6917677893.0,2016-03-02,2016,2,62,3,0.92,198.16,199.795,198.11,4065
2016-03-03 14:30:00,198.79,199.795,198.11,199.775,181.15125,208.954,202.482792,200.08349200000006,193.77816,191.66421000000008,194.5961372053764,193.74049442634654,194.47109230769237,200.2060302559459,188.7361543594388,202.482792,200.08349200000006,193.77816,191.66421000000008,199.22666666666663,95172197,136821803.75,62.82470333316364,1.5,2.75,3.1506857798193133,0.6955923280612356,1.2419710724991029,1.593385995272229,0.3514149227731261,19.319922792483688,4.04947916666667,7012850090.0,2016-03-03,2016,3,63,3,0.85,198.95,201.35,199.03,4066
2016-03-04 14:30:00,200.01,201.35,199.03,200.43,181.155625,208.921,202.419792,200.07449200000008,193.75336000000001,192.10571000000007,194.82491613849888,194.37759019526592,195.2903230769231,201.15201997700547,189.42862617684074,202.419792,200.07449200000008,193.75336000000001,192.10571000000007,200.27,129293601,136309894.1,63.789722024834354,1.5,2.75,3.0913510812607905,0.9485268978724856,1.2412835124408312,1.9030193133241653,0.661735800883334,19.127557070584647,2.9007084916315877,7142143691.0,2016-03-04,2016,4,64,3,1.17,200.19,201.07,199.25,4067
2016-03-07 14:30:00,199.34,201.07,199.25,200.59,181.16,208.888,202.358342,200.06519200000008,193.69516000000002,192.73771000000008,195.0509978585577,194.96924827190728,195.8834,202.19267618326825,189.57412381673183,202.358342,200.06519200000008,193.69516000000002,192.73771000000008,200.3033333333333,100218998,132281428.6,64.03531779092557,1.5,2.75,3.0005402897421622,0.7576195620252018,1.179960337499086,2.1366862227571914,0.9567258852581054,18.070117791168087,4.3001247920133165,7242362689.0,2016-03-07,2016,0,67,3,0.91,200.16,199.92,198.21,4068
2016-03-08 14:30:00,199.32,199.92,198.21,198.4,181.164375,208.855,202.282842,200.04669200000006,193.54276000000002,193.38671000000008,195.1823312758692,195.2959865317256,196.36878461538464,202.4008337489413,190.33673548182801,202.282842,200.04669200000006,193.54276000000002,193.38671000000008,198.84333333333333,123974866,128903837.2,58.215170127122434,1.5,2.75,2.956215983332008,0.9617624167979384,0.9311857177555029,2.1207080324524843,1.189522314696981,17.54211577410846,2.69151138716357,7118387823.0,2016-03-08,2016,1,68,3,0.86,199.06,199.79,198.43,4069
2016-03-09 14:30:00,199.36,199.79,198.43,199.38,181.16875,208.822,202.214792,200.04759200000007,193.41675999999995,194.08421000000007,195.34694573563903,195.6849401953708,196.9364769230769,202.59455010101368,191.2784037451402,202.214792,200.04759200000007,193.41675999999995,194.08421000000007,199.2,94801213,124418241.05,59.96857468752432,1.5,2.75,2.8443434130940064,0.7619559013207895,0.7781409742873553,2.1621985325561752,1.3840575582688202,17.554284577651515,1.9637925744093296,7213189036.0,2016-03-09,2016,2,69,3,0.69,199.11,201.07,197.38,4070
2016-03-10 14:30:00,199.96,201.07,197.38,199.54,181.173125,208.789,202.15899199999998,200.01949200000013,193.30336,194.79771000000008,195.5113792362022,196.0520887481926,197.3026307692308,202.97116393092753,191.634097607534,202.15899199999998,200.01949200000013,193.30336,194.79771000000008,199.33,156838697,124849473.05,60.261765697764424,1.5,2.75,2.9047474550158623,1.256222338537135,0.6390166960071739,2.1828284282777872,1.5438117322706133,16.634442924118648,2.2814179360005507,7370027733.0,2016-03-10,2016,3,70,3,1.87,199.22,202.81,201.12,4071
2016-03-11 14:30:00,201.26,202.81,201.12,202.76,181.1775,208.75599999999997,202.10929199999998,200.0143920000001,193.21056,195.79271000000008,195.79563887399817,196.6909374388409,198.1057076923077,203.68043136614207,192.53098401847325,202.10929199999998,200.0143920000001,193.21056,195.79271000000008,202.23,137964528,120794755.2,65.70547538334378,1.5,2.75,2.9308369225147297,1.1421400521204086,0.7097362231540831,2.4309820112132168,1.7212457880591339,18.137695071302183,4.753048150444301,7507992261.0,2016-03-11,2016,4,71,3,0.84,201.96,203.04,201.77,4072
2016-03-14 13:30:00,202.16,203.04,201.77,202.5,181.181875,208.72299999999998,202.05949200000003,200.00569200000007,193.14196,196.58621000000008,196.0585549965865,197.2441814922847,198.8210923076923,204.07152168584744,193.5706629295372,202.05949200000003,200.00569200000007,193.14196,196.58621000000008,202.43666666666664,73611974,118093734.25,64.93199853344231,1.5,2.75,2.8122057137636767,0.6233351368512593,0.6845714452181837,2.5769600945818643,1.89238864936368,16.936588428719965,2.2159406390389114,7434380287.0,2016-03-14,2016,0,74,3,0.63,202.4,202.2,201.05,4073
2016-03-15 13:30:00,201.36,202.2,201.05,202.17,181.18625,208.69,202.01464199999998,199.99649200000007,193.10796000000002,197.20571000000007,196.2982195065243,197.713307064448,199.3310923076923,204.49490408191508,194.1672805334695,202.01464199999998,199.99649200000007,193.10796000000002,197.20571000000007,201.80666666666667,93169090,116739655.35,63.90375168065095,1.5,2.75,2.7149053056376995,0.7980928992866005,0.5945999084208107,2.6356385348896936,2.0410386264688833,12.25408155365873,1.5929648241205967,7341211197.0,2016-03-15,2016,1,75,3,0.57,201.62,203.82,201.55,4074
2016-03-16 13:30:00,201.6,203.82,201.55,203.34,181.190625,208.657,201.973492,200.0113920000001,193.154376,197.72871000000004,196.57436776117038,198.2491825821197,199.96576923076924,204.91169816450846,195.01984029703,201.973492,200.0113920000001,193.154376,197.72871000000004,202.9033333333333,129303179,116404339.5,65.96182789672005,1.5,2.75,2.6831263552350046,1.1108106412132512,0.5630964895744737,2.744909238436975,2.181812748862501,12.369920776082342,1.7845075710173934,7470514376.0,2016-03-16,2016,2,76,3,1.13,202.68,205.23,202.77,4075
2016-03-17 13:30:00,203.24,205.23,202.77,204.63,181.195,208.624,201.939842,200.00509200000016,193.21977599999997,198.35571000000004,196.89027490779117,198.85687947906064,200.8173076923077,204.77076112982704,196.8638542547884,201.939842,200.00509200000016,193.21977599999997,198.35571000000004,204.21,134278505,118001114.9,68.12009382456553,1.5,2.75,2.667188758432503,1.137942680573775,0.5762659244726906,2.9021451544533647,2.3258792299806736,12.571511383894224,2.0954946864241824,7604792881.0,2016-03-17,2016,3,77,3,1.21,204.0,204.78,203.8,4076
2016-03-18 13:30:00,204.17,204.78,203.8,204.38,181.199375,208.59099999999998,201.902142,199.97379200000015,193.33097599999996,198.97471000000004,197.18398961728957,199.38289095724534,201.2996153846154,205.34307251458984,197.25615825464092,201.902142,199.97379200000015,193.33097599999996,198.97471000000004,204.32,138372404,119180085.7,67.2304023743506,1.5,2.75,2.546675275687324,1.1610362854437852,0.5171524462144794,2.972319787748773,2.455167341534294,12.72085859989042,1.8894261927314384,7466420477.0,2016-03-18,2016,4,78,3,0.48,204.29,204.94,203.8,4077
2016-03-21 13:30:00,204.07,204.94,203.8,204.67,181.20375,208.558,201.874846,199.95049200000014,193.543376,199.46921000000003,197.47755865190564,199.8864251517934,201.73576923076928,205.9138914555487,197.55764700598985,201.874846,199.95049200000014,193.543376,199.46921000000003,204.47,72926659,117644404.05,67.75647936605213,1.5,2.75,2.446198470281085,0.6198905896875934,0.449115107980695,3.016561226510163,2.5674461185294684,12.705290470744364,3.1602822580645067,7539347136.0,2016-03-21,2016,0,81,3,0.56,204.37,205.23,203.57,4078
2016-03-22 13:30:00,203.76,205.23,203.57,204.56,181.208125,208.525,201.848796,199.93009200000014,193.79611599999996,200.08121000000003,197.7553014498701,200.33152751828925,202.10384615384618,206.3683583070792,197.83933400061318,201.848796,199.93009200000014,193.79611599999996,200.08121000000003,204.45333333333332,97471939,116945236.55,67.31504139487974,1.5,2.75,2.3900414366895792,0.8334836191324972,0.3525004071898987,3.0080716275168413,2.6555712203269426,9.91049874813302,2.5980539672986294,7441875197.0,2016-03-22,2016,1,82,3,0.82,204.4,204.33,203.01,4079
2016-03-23 13:30:00,204.11,204.33,203.01,203.2092,181.2125,208.492,201.82244199999997,199.8726840000002,194.01809999999992,200.58167000000003,197.96917982438504,200.60559156416645,202.31763076923082,206.50297529752876,198.13228624093293,201.82244199999997,199.8726840000002,194.01809999999992,200.58167000000003,203.5164,81052455,113457251.7,61.97529639384637,1.5,2.75,2.3300384769260383,0.7143876110653224,0.1630502944510952,2.8593840883908115,2.6963337939397163,11.238005042049007,1.8388293074070448,7360822742.0,2016-03-23,2016,2,83,3,0.65,203.67,203.16,201.74,4080
2016-03-24 13:30:00,202.0,203.16,201.74,203.12,181.216875,208.459,201.795792,199.81558400000014,194.20728399999996,200.96067,198.17117277244841,200.84505903424582,202.51224615384618,206.59211474341626,198.43237756427615,201.795792,199.81558400000014,194.20728399999996,200.96067,202.6733333333333,84360853,112138878.5,61.62764620700953,1.5,2.75,2.268550014288464,0.7522890734099859,0.005484772054955123,2.70318975900841,2.6977049869534553,11.304676565327744,0.17754981258631564,7276461889.0,2016-03-24,2016,3,84,3,0.7,202.45,203.86,202.705,4081
2016-03-28 13:30:00,203.61,203.86,202.705,203.24,181.22125,208.426,201.757242,199.76868400000015,194.49548399999992,201.36821000000003,198.36995031078368,201.07314865003195,202.88455384615392,206.20879594840213,199.5603117439057,201.757242,199.76868400000015,194.49548399999992,201.36821000000003,203.26833333333332,62408185,108767604.6,61.93698056948916,1.5,2.75,2.189010727553574,0.5737754842492873,-0.11049810740717092,2.5595823526944907,2.670080460101662,6.7619230627460505,0.3654320987654366,7338870074.0,2016-03-28,2016,0,88,3,0.57,203.28,205.25,202.4,4082
2016-03-29 13:30:00,202.76,205.25,202.4,205.1208,181.225625,208.393,201.724696,199.7159920000002,194.75929999999997,201.94625,198.63468951428243,201.4586392547908,203.32615384615391,206.159915411034,200.4923922812738,201.724696,199.7159920000002,194.75929999999997,201.94625,204.2569333333333,92922863,107117842.65,66.49582440849223,1.5,2.75,2.2362242470140328,0.8674825846112202,-0.08171578768553056,2.567935725494749,2.64965151318028,8.382255453932633,1.4595637334916236,7431792937.0,2016-03-29,2016,1,89,3,1.41,203.82,206.87,205.59,4083
2016-03-30 13:30:00,206.3,206.87,205.59,206.02,181.23,208.36,201.70474599999997,199.6661920000002,195.12349999999995,202.34175,198.92430953333016,201.8930545638584,203.82461538461544,206.02880582424692,201.62042494498402,201.70474599999997,199.6661920000002,195.12349999999995,202.34175,206.16,86365310,104346123.8,68.44190416654268,1.5,2.75,2.2014368007987453,0.8276810566105571,-0.02616343443766489,2.6169472201331985,2.643110654570864,8.325959515699555,1.3179895741123275,7518158247.0,2016-03-30,2016,2,90,3,0.62,206.23,206.41,205.33,4084
2016-03-31 13:30:00,205.91,206.41,205.33,205.52,181.234375,208.32700000000003,201.68679599999996,199.61779200000015,195.4727,202.66775,199.18296406143486,202.23847793872898,204.0369230769231,206.3203034456879,201.7535427081583,201.68679599999996,199.61779200000015,195.4727,202.66775,205.75333333333333,94584110,103954581.3,66.14134651594236,1.5,2.75,2.121334172170262,0.909859948615848,-0.0459783324047649,2.5856377390649072,2.6316160714696717,8.255957670319319,0.4349313394907955,7423574137.0,2016-03-31,2016,3,91,3,0.53,205.87,207.14,203.98,4085
2016-04-01 13:30:00,204.35,207.14,203.98,206.92,181.23875,208.294,201.67014599999993,199.58549200000016,195.8981,203.02500000000003,199.48637723549626,202.68433718265962,204.3769230769231,206.94250198609726,201.81134416774898,201.67014599999993,199.58549200000016,195.8981,203.02500000000003,206.0133333333333,114423478,104917145.35,69.25733122457666,1.5,2.75,2.1955245884438144,1.090607999467458,0.009365121540480636,2.6433224733952727,2.633957351854792,8.367559842345782,1.2427830511791722,7537997615.0,2016-04-01,2016,4,92,4,1.55,205.56,207.07,205.89,4086
2016-04-04 13:30:00,206.83,207.07,205.89,206.25,181.243125,208.261,201.64844599999992,199.54759200000012,196.2893,203.31599999999997,199.75161734390812,203.0239241176444,204.69076923076926,207.0926626881526,202.288875773386,201.64844599999992,199.54759200000012,196.2893,203.31599999999997,206.4033333333333,63496969,101627313.75,66.12117527976798,1.5,2.75,2.1229871178406854,0.6248021979228985,-0.023208730010300996,2.604946439341916,2.6281551693522167,8.648841281924822,0.7719743978111168,7474500646.0,2016-04-04,2016,0,95,4,0.57,206.48,206.2642,203.89,4087
2016-04-05 13:30:00,204.67,206.2642,203.89,204.1892,181.2475,208.22799999999998,201.60549199999997,199.5086840000001,196.562684,203.49596000000003,199.92564019316663,203.1349027731068,204.75609230769228,207.05130950262586,202.46087511275883,201.60549199999997,199.5086840000001,196.562684,203.49596000000003,204.78113333333332,99662158,101599471.75,57.49690961302628,1.5,2.75,2.1409308951377795,0.980931852138296,-0.19788457972798976,2.3807994446922294,2.578684024420219,10.663111090569249,-0.1812671098944088,7374838488.0,2016-04-05,2016,1,96,4,1.16,205.08,206.49,203.98,4088
2016-04-06 13:30:00,204.29,206.49,203.98,206.42,181.251875,208.195,201.58354199999997,199.48728400000007,196.938284,203.89696,200.1803209699052,203.4477691756681,204.89378461538465,207.35125621888128,202.43631301188802,201.58354199999997,199.48728400000007,196.938284,203.89696,205.63,91839761,99992716.5,63.10660923685742,1.5,2.75,2.167292974056511,0.9184645063623208,-0.17813950721815086,2.356009640397531,2.5341491476156817,12.4057526031484,1.5800465726945323,7466678249.0,2016-04-06,2016,2,97,4,1.23,205.24,205.56,203.09,4089
2016-04-07 13:30:00,205.14,205.56,203.09,203.95,181.25625,208.162,201.54384199999996,199.44938400000007,197.21328400000002,204.12546000000003,200.32815152010502,203.4956006827473,204.8607076923077,207.3562312790377,202.36518410557758,201.54384199999996,199.44938400000007,197.21328400000002,204.12546000000003,204.2,113859037,100945607.7,54.52556272880601,1.5,2.75,2.2503434759096157,1.1279246278686774,-0.3371582946466014,2.1127012793074296,2.4498595739540314,13.90259370625092,0.40862544308782206,7352819212.0,2016-04-07,2016,3,98,4,1.22,204.32,205.85,203.87,4090
2016-04-08 13:30:00,205.34,205.85,203.87,204.4992,181.260625,208.129,201.50613799999994,199.4459760000001,197.54066799999998,204.37342000000004,200.4917220487283,203.59118157010468,204.84756923076924,207.34876265344715,202.34637580809127,201.50613799999994,199.4459760000001,197.54066799999998,204.37342000000004,204.73973333333333,95040598,97855702.75,55.959518407084076,1.5,2.75,2.231033227630357,0.9712320828435316,-0.40644003609791257,1.9418095288316408,2.3482495649295534,13.952174876059571,0.6195630781342221,7447859810.0,2016-04-08,2016,4,99,4,0.97,204.86,206.07,203.91,4091
2016-04-11 13:30:00,205.25,206.07,203.91,204.0201,181.265,208.09599999999998,201.47373849999997,199.46077700000006,197.83887,204.436425,200.63008981152328,203.63203094438046,204.80603846153846,207.3426312429242,202.26944568015273,201.47373849999997,199.46077700000006,197.83887,204.436425,204.6667,83757486,95145350.65,54.34945163694872,1.5,2.75,2.22595942565676,0.8803108657206887,-0.4805418169037981,1.7475722937998055,2.228114110703604,14.05986260009574,-0.536610621643436,7364102324.0,2016-04-11,2016,0,102,4,1.06,204.99,206.25,203.7,4092
2016-04-12 13:30:00,204.22,206.25,203.7,205.92,181.269375,208.063,201.4540384999999,199.46377700000008,198.082854,204.607425,200.8375372698949,203.84993275920138,205.01456153846158,207.434811838956,202.5943112379671,201.4540384999999,199.46377700000008,198.082854,204.607425,205.29,115350567,97232280.3,59.344897268076856,1.5,2.75,2.249105180966992,1.1863402426035667,-0.4008626929736376,1.7270357444865567,2.1278984374601944,14.073119100677307,-0.048538976798380117,7479452891.0,2016-04-12,2016,1,103,4,1.25,204.98,208.1,206.84,4093
2016-04-13 13:30:00,207.0,208.1,206.84,208.0008,181.27375,208.03000000000003,201.4449424999999,199.48908500000007,198.36987,204.898965,201.1184495338206,204.24525344880124,205.3900076923077,208.02311153897918,202.75690384563615,201.4449424999999,199.48908500000007,198.36987,204.898965,207.6469333333333,96336433,97390647.45,63.99227716184539,1.5,2.75,2.244169096612207,0.9891754036182864,-0.2165153259779955,1.8572542799877,2.073769605965696,15.005852218062508,1.207084468664844,7575789324.0,2016-04-13,2016,2,104,4,0.61,207.47,208.6,207.6,4094
2016-04-14 13:30:00,208.07,208.6,207.6,208.01,181.278125,207.997,201.4578925,199.48188500000006,198.72687,205.132465,201.3887064148473,204.6038007393916,205.7569307692308,208.41860289300115,203.09525864546046,201.4578925,199.48188500000006,198.72687,205.132465,208.07,65212883,94186132.65,64.01186536592125,1.5,2.75,2.1552998754256207,0.6923830628266059,-0.1079389157274262,1.9388459613064128,2.046784877033839,14.86840835205549,0.5267736323216718,7641002207.0,2016-04-14,2016,3,105,4,0.48,208.1,208.1721,207.4,4095
2016-04-15 13:30:00,208.01,208.1721,207.4,207.78,181.2825,207.96400000000003,201.46754249999995,199.47418500000006,199.05647000000005,205.289965,201.63934537897092,204.9062959070686,205.96148461538465,208.79907933227142,203.12388989849788,201.46754249999995,199.47418500000006,199.05647000000005,205.289965,207.78403333333333,75761615,91260288.15,63.08787057315298,1.5,2.75,2.0564998843237903,0.8301706748446201,-0.06756519863908661,1.9623283787349808,2.029893577374067,14.469259798897006,0.7418181818181824,7565240592.0,2016-04-15,2016,4,106,4,0.37,207.79,209.28,207.0,4096
2016-04-18 13:30:00,207.14,209.28,207.0,209.2392,181.286875,207.93099999999998,201.4762385,199.47346900000008,199.40925400000003,205.532925,201.93737889352104,205.31895343972874,206.20911538461544,209.54247305409783,202.875757715133,201.4762385,199.47346900000008,199.40925400000003,205.532925,208.5064,82530960,88468215.95,66.40147679978804,1.5,2.75,2.0724641783006623,0.9328882595150828,0.0358987271922282,2.0747669863643523,2.038868259172124,14.71282155098469,2.473196427626932,7647771552.0,2016-04-18,2016,0,109,4,1.1,208.14,210.2,208.94,4097
2016-04-19 13:30:00,209.74,210.2,208.94,209.9,181.29125,207.898,201.4891885,199.48176900000007,199.84825400000003,205.794425,202.24963854475553,205.755243588326,206.5460384615385,210.3804440237299,202.71163289934708,201.4891885,199.48176900000007,199.84825400000003,205.794425,209.68,88316060,89237686.0,67.81071070169953,1.5,2.75,2.0144310227077566,0.9896722333207968,0.1224487803922516,2.191929234662439,2.0694804542701872,12.77002084184989,1.685883150857484,7736087612.0,2016-04-19,2016,1,110,4,0.6,209.57,210.92,209.39,4098
2016-04-20 13:30:00,209.95,210.92,209.39,210.1,181.295625,210.92,201.5060885,199.48926900000006,200.341854,206.07142499999995,202.55749585672584,206.1690299132473,206.79065384615387,211.0692799021013,202.51202779020645,201.5060885,199.48926900000006,200.341854,206.07142499999995,210.13666666666663,81100314,88419104.75,68.2448427094171,1.5,2.75,1.97982880680006,0.9172261382798044,0.16417418407064946,2.274698184358499,2.1105240002878496,11.691230075195275,3.0154449620004935,7817187926.0,2016-04-20,2016,2,111,4,0.73,210.15,210.25,208.65,4099
2016-04-21 13:30:00,210.12,210.25,208.65,208.97,181.3,210.91915789473686,201.5108385,199.4857690000001,200.812654,206.35946499999997,202.8089666074425,206.43578896912854,206.99988461538464,211.41610361763358,202.5836656131356,201.5108385,199.4857690000001,200.812654,206.35946499999997,209.29,85695041,88651234.05,63.069237621642934,1.5,2.75,1.9526981777429129,0.9666536728825154,0.0903653721658686,2.223480715495185,2.1331153433293166,9.177287728670358,2.1862188213939207,7731492885.0,2016-04-21,2016,3,112,4,0.77,209.45,209.29,207.91,4100
2016-04-22 13:30:00,208.55,209.29,207.91,208.97,181.304375,210.9183157894737,201.5330385,199.47986900000006,201.286654,206.651965,203.05057576009185,206.6771424006401,207.36763846153846,211.5778081065802,203.15746881649673,201.5330385,199.47986900000006,201.286654,206.651965,208.72333333333333,99251724,89395777.6,63.06923762164293,1.5,2.75,1.9117911650469903,1.1102506926456894,0.01991913123835509,2.1580142573772605,2.1380951261389054,9.27860577322564,2.426182518291083,7731492885.0,2016-04-22,2016,4,113,4,0.66,208.6,208.66,207.54,4101
2016-04-25 13:30:00,208.26,208.66,207.54,208.61,181.30875,210.9174736842105,201.5515885,199.47906900000007,201.801654,206.920465,203.26859239695096,206.8612240767696,207.5361,211.756361756348,203.315838243652,201.5515885,199.47906900000007,201.801654,206.920465,208.27,66166494,89583693.05,61.35014101405147,1.5,2.75,1.8773775104007773,0.7385997579165442,-0.06774636569178805,2.0534121690241705,2.1211585347159585,9.174669876420234,1.3063325563325692,7665326391.0,2016-04-25,2016,0,116,4,0.54,208.1,209.52,208.36,4102
2016-04-26 13:30:00,209.04,209.52,208.36,208.9192,181.313125,210.9166315789473,201.5587845,199.46146100000013,202.247438,207.110385,203.49018485197251,207.05722178374398,207.91834615384616,211.64095380116746,204.19573850652492,201.5587845,199.46146100000013,202.247438,207.110385,208.93306666666663,75864174,88730758.6,62.30061158539147,1.5,2.75,1.8261362596578643,0.854992960693565,-0.11874780018463182,1.9727237844851688,2.0914715846698004,8.003110954950138,0.4415367633201369,7741190565.0,2016-04-26,2016,1,117,4,0.56,208.94,209.81,208.05,4103
2016-04-27 13:30:00,208.47,209.81,208.05,209.35,181.3175,210.91578947368416,201.5566845,199.46967100000006,202.638838,207.27688500000002,203.71998152444417,207.27558161386355,208.2914846153846,211.50620686807326,205.07676236269592,201.5566845,199.46967100000006,202.638838,207.27688500000002,209.07,77329437,88278964.95,63.64217006182661,1.5,2.75,1.8214122411108733,0.8759667384387474,-0.13606445299368186,1.9213910184276983,2.0574554714213797,5.899814449957493,0.6441997980866321,7818520002.0,2016-04-27,2016,2,118,4,0.85,208.93,209.76,206.96,4104
2016-04-28 13:30:00,208.46,209.76,206.96,207.4475,181.321875,210.91494736842102,201.540522,199.48804600000008,202.930188,207.37326000000002,203.86615871956403,207.2919547934956,208.55513076923077,210.71425380681396,206.39600773164761,201.540522,199.48804600000008,202.930188,207.37326000000002,208.05583333333337,97216169,88410567.9,54.43026586608725,1.5,2.75,1.89131136674581,1.0995989654761622,-0.27995600624569983,1.7075104636142555,1.9874664698599556,8.15384606002218,-0.16002502647031006,7721303833.0,2016-04-28,2016,3,119,4,1.35,208.36,207.13,205.03,4105
2016-04-29 13:30:00,206.72,207.13,205.03,206.3308,181.32625,210.91410526315792,201.519126,199.45515400000008,203.215004,207.3438,203.9628113187968,207.20041624173408,208.58673076923077,210.59759677992488,206.5758647585366,201.519126,199.45515400000008,203.215004,207.3438,206.1636,142424137,89810600.85,49.86759260214571,1.5,2.75,1.928896269121109,1.5858276823899011,-0.4448532253456297,1.4313999381779183,1.876253163523548,8.669022151658872,-1.3899881093026547,7578879696.0,2016-04-29,2016,4,120,4,1.02,206.08,208.18,206.41,4106
2016-05-02 13:30:00,206.92,208.18,206.41,207.97,181.330625,210.91326315789473,201.497476,199.45135400000012,203.534404,207.4298,204.11995597296158,207.27370993299752,208.5843615384615,210.59805396551945,206.5706691114036,201.497476,199.45135400000012,203.534404,207.4298,207.52,62188015,89745153.15,55.733488183466555,1.5,2.75,1.9232036784696007,0.6929400955621412,-0.4373831939464857,1.3295241710904406,1.7669073650369265,8.975975297819128,-0.9194854692710848,7641067711.0,2016-05-02,2016,0,123,5,0.86,207.3,206.8,205.28,4107
2016-05-03 13:30:00,206.52,206.8,205.28,206.1592,181.335,210.9124210526316,201.465872,199.44345600000008,203.761988,207.5283,204.19992632696312,207.1675661298549,208.4419923076923,210.8256953873421,206.05828922804244,201.465872,199.44345600000008,203.761988,207.5283,206.0797333333333,106422142,90083152.35,48.92336025992946,1.5,2.75,1.9779748442932008,1.1813767527419352,-0.5414423560310508,1.090104419998113,1.6315467760291638,9.716052051935916,-1.875678248453116,7534645569.0,2016-05-03,2016,1,124,5,0.74,206.04,205.85,204.42,4108
2016-05-04 13:30:00,204.99,205.85,204.42,205.01,181.339375,210.91157894736838,201.427972,199.4401560000001,204.015788,207.4578,204.23169392198415,206.96208364129726,208.2289153846154,211.2272095415166,205.23062122771415,201.427972,199.4401560000001,204.015788,207.4578,205.09333333333333,92243810,90103354.8,45.15257835216492,1.5,2.75,1.9609194982722584,1.0237555549929425,-0.6664950796519484,0.7984279264642282,1.4649230061161769,9.763469733257498,-1.8950088529454028,7442401759.0,2016-05-04,2016,2,125,5,0.7,205.14,205.98,204.47,4109
2016-05-05 13:30:00,205.56,205.98,204.47,204.97,181.34375,210.91073684210525,201.394072,199.4311560000001,204.251188,207.5088,204.2606471015142,206.77236138974519,207.90051538461537,211.29347618453167,204.50755458469902,201.394072,199.4311560000001,204.251188,207.5088,205.14,67619222,87791364.05,45.0225033527561,1.5,2.75,1.9287109626813816,0.7702263512102248,-0.7258450607077038,0.557616680231547,1.2834617409392508,9.645896342111918,-1.914150356510504,7374782537.0,2016-05-05,2016,3,126,5,0.74,205.22,205.77,203.88,4110
2016-05-06 13:30:00,204.06,205.77,203.88,205.72,181.348125,210.9098947368421,201.365822,199.46955600000013,204.45478799999992,207.56984000000003,204.317876626945,206.6721364954837,207.57897692307685,210.94520158594486,204.21275226020884,201.365822,199.46955600000013,204.45478799999992,207.56984000000003,205.1233333333333,89315004,87505084.35,48.044728742169724,1.5,2.75,1.9259458939184275,1.02068359414135,-0.6888323093864688,0.4224213542061648,1.1112536635926336,10.12810824356975,-1.3853602415991633,7464097541.0,2016-05-06,2016,4,127,5,0.93,204.82,206.4,205.36,4111
2016-05-09 13:30:00,205.57,206.4,205.36,205.8892,181.3525,210.9090526315789,201.344368,199.4994400000001,204.67078799999996,207.663295,204.37949715137853,206.59757111496143,207.2550692307692,210.39112018931942,204.11901827221897,201.344368,199.4994400000001,204.67078799999996,207.663295,205.88306666666665,74374922,87035956.15,48.72948085759133,1.5,2.75,1.8626640443528248,0.8545309925913877,-0.6288568448283959,0.3251826075571387,0.9540394523855346,10.218472240722186,-1.4503214639918214,7538472463.0,2016-05-09,2016,0,130,5,0.51,205.88,208.5,206.64,4112
2016-05-10 13:30:00,206.72,208.5,206.64,208.45,181.356875,210.90821052631577,201.346618,199.53363200000013,204.96858799999995,207.789795,204.5391247140696,206.77399291353652,207.2150692307692,210.2749446806052,204.1551937809332,201.346618,199.53363200000013,204.96858799999995,207.789795,207.8633333333333,77472207,85142038.15,57.795601035307435,1.5,2.75,1.916102326899052,0.909917224009982,-0.4035731926916962,0.4495729615209143,0.8531461542126105,12.86441550903685,-0.4299020778600457,7615944670.0,2016-05-10,2016,1,131,5,0.9,207.57,208.54,206.5,4113
2016-05-11 13:30:00,207.91,208.54,206.5,206.5,181.36125,210.90736842105258,201.345168,199.51833200000016,205.13638799999995,207.71475500000003,204.6160217841061,206.74789835034255,207.0250692307692,209.9281956488297,204.12194281270874,201.345168,199.51833200000016,205.13638799999995,207.71475500000003,207.18,81726989,84411565.95,50.47607489133995,1.5,2.75,1.9249521606919764,0.9681965744884988,-0.3734362054491733,0.3863508974011438,0.7597871028503171,13.766417553721256,-0.4567420672700278,7534217681.0,2016-05-11,2016,2,132,5,0.99,207.52,207.4899,205.37,4114
2016-05-12 13:30:00,207.29,207.4899,205.37,206.56,181.365625,210.90652631578945,201.33131799999995,199.53533200000012,205.28758799999991,207.64225500000003,204.69225622394504,206.7300032693576,206.8673769230769,209.6282284841933,204.10652536196048,201.33131799999995,199.53533200000012,205.28758799999991,207.64225500000003,206.4733,89586308,85630237.2,50.68303462155074,1.5,2.75,1.9388770063568352,1.0461994609539629,-0.33806855688933923,0.3372014067386431,0.6752699636279823,12.857370795223346,0.11108375482477248,7623803989.0,2016-05-12,2016,3,133,5,1.03,206.43,206.86,204.38,4115
2016-05-13 13:30:00,206.21,206.86,204.38,204.76,181.37,210.90568421052632,201.301268,199.58272400000016,205.38728799999996,207.49125500000005,204.69491284261383,206.54238391037117,206.54743846153846,209.24631862079747,203.84855830227943,201.301268,199.58272400000016,205.38728799999996,207.49125500000005,205.33333333333331,96474630,86665887.95,44.654130628892524,1.5,2.75,1.97752864875992,1.113178809817987,-0.4192067898058208,0.1512614763707063,0.5704682661765271,13.460228346307387,-1.5434918497860306,7527329359.0,2016-05-13,2016,4,134,5,1.21,205.62,207.34,204.89,4116
2016-05-16 13:30:00,204.96,207.34,204.89,206.78,181.374375,210.90484210526319,201.281068,199.63382400000015,205.51428799999996,207.36829500000005,204.7766809664329,206.5650140141453,206.34974615384616,208.5240375738475,204.17545473384487,201.281068,199.63382400000015,205.51428799999996,207.36829500000005,206.33666666666667,77486827,86413681.3,51.61060931863382,1.5,2.75,2.020562316705641,0.8966962850592041,-0.3243763190393289,0.164997867377366,0.4893741864166949,13.9437231970421,0.3011265080578517,7604816186.0,2016-05-16,2016,0,137,5,1.2,206.12,206.8,204.23,4117
2016-05-17 13:30:00,206.46,206.8,204.23,204.8508,181.37875,210.90400000000002,201.252822,199.64733200000015,205.59950399999997,207.1158350000001,204.77958759520027,206.4017555366077,206.15000000000006,208.36099424623063,203.9390057537695,201.252822,199.64733200000015,205.59950399999997,207.1158350000001,205.2936,114924940,87744125.3,45.702424740583496,1.5,2.75,2.0598078655123824,1.3097736128437991,-0.3755126425652049,0.019983383210188777,0.3954960257753937,14.08209325898222,-0.07765474854885053,7489891246.0,2016-05-17,2016,1,138,5,1.26,205.52,206.3,203.63,4118
2016-05-18 13:30:00,204.44,206.3,203.63,204.91,181.383125,210.90315789473686,201.228422,199.63623200000015,205.72970399999997,206.85633500000003,204.7847018071532,206.25968358074027,206.0407076923077,208.34369835057308,203.7377170340424,201.228422,199.63623200000015,205.72970399999997,206.85633500000003,204.9466666666667,123493379,89863778.55,45.90706203027951,1.5,2.75,2.1033930179757845,1.3742286491023583,-0.3877065623229724,-0.08913717712832181,0.2985693851946506,13.725940195907086,-0.02927257647460715,7613384625.0,2016-05-18,2016,2,139,5,1.31,204.96,204.54,202.78,4119
2016-05-19 13:30:00,204.06,204.54,202.78,204.2,202.78,210.90231578947368,201.202522,199.62143200000014,205.82610400000002,206.617835,204.76177232451974,206.0635232397174,205.7507076923077,207.95629328760705,203.5451220970084,201.202522,199.62143200000014,205.82610400000002,206.617835,203.84,115430507,91350551.85,43.776160727694375,1.5,2.75,2.1052935166918,1.2635994491805578,-0.423057797743454,-0.2302528619846669,0.1928049357587871,13.86638102428906,-0.7388683647676503,7497954118.0,2016-05-19,2016,3,140,5,0.87,203.66,206.1,204.86,4120
2016-05-20 13:30:00,204.92,206.1,204.86,205.49,203.09897058823532,210.90147368421046,201.179622,199.62423200000018,205.945104,206.443835,204.79033027257782,206.00890197879195,205.6992307692308,207.89549540142932,203.50296613703225,201.179622,199.62423200000018,205.945104,206.443835,205.48333333333332,104990408,91637486.05,48.45745299100254,1.5,2.75,2.090629694070957,1.1457146253740993,-0.34247085788150605,-0.2352836365930955,0.10718722128841056,14.225118396163206,-0.19389069460660352,7602944526.0,2016-05-20,2016,4,141,5,0.61,205.48,205.84,204.985,4121
2016-05-23 13:30:00,205.51,205.84,204.985,205.21,203.41794117647058,210.9006315789473,201.163922,199.60233200000016,205.99410399999996,206.273835,204.80678790894729,205.93281607604985,205.71461538461537,207.89409029363492,203.53514047559585,201.163922,199.60233200000016,205.99410399999996,206.273835,205.34500000000003,58682576,91263290.15,47.53235530032887,1.5,2.75,2.002370430208745,0.6430030727968445,-0.2928537882332742,-0.25888001400318217,0.033973774230092034,14.227896697363764,-1.5543295754377455,7544261950.0,2016-05-23,2016,0,144,5,0.42,205.41,208.24,206.14,4122
2016-05-24 13:30:00,206.17,208.24,206.14,207.87,203.73691176470592,210.8997894736842,201.163522,199.62173200000012,206.10150399999995,206.221375,204.92691387330228,206.11730978309268,205.9376923076923,208.34806527909504,203.5273193362896,201.163522,199.62173200000012,206.10150399999995,206.221375,207.41666666666663,93537808,92146971.85,56.10558678271676,1.5,2.75,2.0757725423366917,1.0150936717949242,-0.07695763738266873,-0.06222327249824389,0.01473436488442484,14.398621285296025,0.6634382566585978,7637799758.0,2016-05-24,2016,1,145,5,1.02,207.19,209.77,207.8691,4123
2016-05-25 13:30:00,208.67,209.77,207.8691,209.28,204.05588235294118,210.89894736842103,201.157072,199.67583200000016,206.24370399999995,206.217875,205.0976231331728,206.4185183751791,206.2115384615385,209.20028177916717,203.22279514390985,201.157072,199.67583200000016,206.24370399999995,206.217875,208.9730333333333,79221525,92241576.25,59.85060666696453,1.5,2.75,2.0632816464555,0.8588483438887462,0.1522447094758667,0.20504025172925824,0.05279554225339152,13.620347550534465,1.3168086754453907,7717021283.0,2016-05-25,2016,2,146,5,0.91,208.82,209.71,208.97,4124
2016-05-26 13:30:00,209.44,209.71,208.97,209.34,204.37485294117644,210.89810526315787,201.160422,199.75904000000014,206.363704,206.31249999999997,205.2639908534405,206.69675472040012,206.47698461538462,209.88729813296607,203.06667109780327,201.160422,199.75904000000014,206.363704,206.31249999999997,209.34,55280699,90144802.75,60.00697397768709,1.5,2.75,1.9687615288515363,0.6132433297714438,0.2912711138043965,0.4168844345088871,0.12561332070449066,13.620455965447375,2.2367649931627334,7772301982.0,2016-05-26,2016,3,147,5,0.35,209.34,210.25,209.47,4125
2016-05-27 13:30:00,209.53,210.25,209.47,210.24,204.69382352941173,210.89726315789466,201.167022,199.8478400000002,206.475904,206.50796,205.4591284670311,207.03420665179058,206.61467692307698,210.45051201550166,202.77884183065223,201.167022,199.8478400000002,206.475904,206.50796,209.98666666666668,64211214,86234156.6,62.374143276069155,1.5,2.75,1.8931357053621407,0.7446146229254129,0.4194319623286769,0.6499032736153367,0.2304713112866599,12.055571391447401,1.6732759454492736,7836513196.0,2016-05-27,2016,4,148,5,0.37,209.86,210.69,209.18,4126
2016-05-31 13:30:00,210.56,210.69,209.18,209.84,205.01279411764702,210.89642105263158,201.172922,199.95804000000015,206.585104,206.60145999999997,205.63092735067693,207.3014250659058,206.8716000000001,211.0723594683261,202.670840531674,201.172922,199.95804000000015,206.585104,206.60145999999997,209.9033333333333,109879380,88618724.85,60.65576296124444,1.5,2.75,1.865768869264844,1.2399115444956663,0.4501451542727667,0.7931527541276182,0.3430075998548515,11.360868196068092,2.435528687220168,7726633816.0,2016-05-31,2016,1,152,5,0.72,209.94,210.48,208.89,4127
2016-06-01 13:30:00,209.12,210.48,208.89,210.27,205.33176470588242,210.8955789473684,201.177172,200.1202400000002,206.697104,206.807,205.81285176829743,207.58414648820045,207.15698461538463,211.72254082673496,202.59142840403442,201.177172,200.1202400000002,206.697104,206.807,209.88,69936215,86794428.5,61.87181992519083,1.5,2.75,1.846071092888784,0.8057684831694006,0.4701126957814201,0.9306484695816266,0.4605357738002066,9.028909987479572,2.6157825386755227,7796570031.0,2016-06-01,2016,2,153,6,0.76,209.68,210.93,209.2399,4128
2016-06-02 13:30:00,209.8,210.93,209.2399,210.91,205.65073529411762,210.8947368421053,201.178772,200.31011000000018,206.824104,207.10199999999998,206.01273993424653,207.90089444170516,207.6300615384616,212.37507195721057,202.88505111971256,201.178772,200.31011000000018,206.824104,207.10199999999998,210.35996666666665,63044749,85334475.45,63.67158351226922,1.5,2.75,1.8349303005395856,0.73879576416849,0.4946285677283496,1.0788214834606435,0.5841929157322939,8.90751885535856,3.2859941234084267,7859614780.0,2016-06-02,2016,3,154,6,0.81,210.08,210.69,208.86,4129
2016-06-03 13:30:00,210.25,210.69,208.86,210.28,205.9697058823529,210.89389473684207,201.180272,200.49181000000016,206.96552000000003,207.36749999999992,206.18008346623688,208.12747592344758,207.8992923076923,212.81493184285927,202.9836527725253,201.180272,200.49181000000016,206.96552000000003,207.36749999999992,209.94333333333333,101757126,87041370.65,60.63731103460682,1.5,2.75,1.850292421929614,1.169066218053633,0.4385342909527774,1.1323607794232655,0.6938264884704883,8.786043535110096,2.3310136746313654,7757857654.0,2016-06-03,2016,4,155,6,0.88,209.78,211.77,210.51,4130
2016-06-06 13:30:00,210.7,211.77,210.51,211.35,206.28867647058826,210.8930526315789,201.19542199999995,200.66870200000017,207.13012000000003,207.64899999999997,206.3828252910904,208.43438297835732,208.3992307692308,213.29495236475083,203.50350917371074,201.19542199999995,200.66870200000017,207.13012000000003,207.64899999999997,211.21,64887045,85819972.7,63.79323520336294,1.5,2.75,1.8245572489346424,0.7560832631213363,0.4423462094506165,1.246759250283759,0.8044130408331425,8.64203911844685,2.9920569173042186,7822744699.0,2016-06-06,2016,0,158,6,0.6,211.14,212.34,211.5,4131
2016-06-07 13:30:00,211.525,212.34,211.5,211.68,206.60764705882355,210.89221052631578,201.233972,200.8972020000001,207.29892000000004,207.93854,206.59055763261622,208.74348936137088,208.92,213.65804243900456,204.18195756099547,201.233972,200.8972020000001,207.29892000000004,207.93854,211.84,60974761,85149964.65,64.73238051073932,1.5,2.75,1.7649460168678828,0.7160867447289069,0.4352730757895393,1.348504385570067,0.9132313097805274,8.28139061643891,1.8328763169288507,7883719460.0,2016-06-07,2016,1,159,6,0.4,211.92,212.52,211.6899,4132
2016-06-08 13:30:00,211.84,212.52,211.6899,212.37,206.92661764705883,212.52,201.307672,201.10160200000013,207.44390400000003,208.13454,206.8172024313372,209.0888713269546,209.54846153846157,213.75281712726536,205.34410594965766,201.307672,201.10160200000013,207.44390400000003,208.13454,212.1933,66170920,84584900.3,66.67857598908343,1.5,2.75,1.6988784442344629,0.7823018028668174,0.44373047125603815,1.467894398850575,1.024163927594537,5.507590302810594,1.4764908256880749,7949890380.0,2016-06-08,2016,2,160,6,0.39,212.1,212.22,211.19,4133
2016-06-09 13:30:00,211.51,212.22,211.19,212.08,207.24558823529406,212.56705882352944,201.420322,201.3443020000001,207.565104,208.41353999999995,207.02358664971612,209.37374072438752,210.05538461538464,213.736769098968,206.3740001318013,201.420322,201.3443020000001,207.565104,208.41353999999995,211.83,73786869,84187894.3,65.05371575161266,1.5,2.75,1.661815698217716,0.8764546211010292,0.3979260888150571,1.521571538613358,1.123645449798301,4.9628271634688215,1.308875513518682,7876103511.0,2016-06-09,2016,3,161,6,0.49,211.7,210.86,209.43,4134
2016-06-10 13:30:00,210.46,210.86,209.43,210.07,207.5645588235294,212.61411764705883,201.534322,201.5644020000001,207.65610400000003,208.58903999999995,207.1430538399233,209.44005113158866,210.4292307692308,212.83124865857533,208.02721287988632,201.534322,201.5644020000001,207.65610400000003,208.58903999999995,210.12,113829158,85400036.8,55.042036419699386,1.5,2.75,1.7324002912021652,1.3328935474182373,0.20983928080774092,1.3859445508079773,1.1761052700002363,7.981469079673746,-0.08085996955860726,7762274353.0,2016-06-10,2016,4,162,6,0.68,210.14,210.37,208.35,4135
2016-06-13 13:30:00,209.36,210.37,208.35,208.4492,207.88352941176467,212.66117647058826,201.604268,201.7923940000001,207.68668799999998,208.77349999999996,207.19427525796556,209.34568435715167,210.47378461538463,212.69926962297168,208.24829960779758,201.604268,201.7923940000001,207.68668799999998,208.77349999999996,209.0564,117751153,86463862.95,48.55314847339811,1.5,2.75,1.7529431275448686,1.3618539466377149,-0.03320800521070266,1.134595263486858,1.1678032686975608,8.755266291800197,-0.6627906976744248,7644523200.0,2016-06-13,2016,0,165,6,0.97,209.36,208.74,206.9199,4136
2016-06-14 13:30:00,208.0,208.74,206.9199,208.04,208.2025,212.70823529411769,201.64811800000004,202.00589400000013,207.722488,208.83649999999997,207.22744093412373,209.2213334659944,210.37840000000003,212.88846928252548,207.86833071747452,201.64811800000004,202.00589400000013,207.722488,208.83649999999997,207.89996666666664,125059286,88842485.9,47.04521521063271,1.5,2.75,1.7577400470059492,1.40765180907663,-0.22056534449280285,0.8920965880815572,1.11266193257436,8.757984726990472,-1.0605412089218709,7519463914.0,2016-06-14,2016,1,166,6,0.88,207.83,209.36,207.53,4137
2016-06-15 13:30:00,208.54,209.36,207.53,207.75,208.52147058823533,212.75529411764708,201.69046800000004,202.17819400000008,207.793704,208.9814599999999,207.24793344651104,209.08120646923302,210.25609230769228,213.09061563644744,207.4215689789372,201.69046800000004,202.17819400000008,207.793704,208.9814599999999,208.2133333333333,109124496,88552463.7,45.955901254824425,1.5,2.75,1.7629014722198109,1.232314623901311,-0.35508594417265593,0.6688045023585403,1.0238904465311962,8.560717540238349,-1.4982694040111881,7410339418.0,2016-06-15,2016,2,167,6,0.88,208.44,208.57,205.59,4138
2016-06-16 13:30:00,206.73,208.57,205.59,208.37,208.8404411764706,212.80235294117645,201.74396800000005,202.38549400000008,207.832704,209.15445999999991,207.2919360564518,209.01347251978225,210.11224615384617,213.11994351240173,207.10454879529055,201.74396800000005,202.38549400000008,207.832704,209.15445999999991,207.51,149533065,89854448.0,48.69121838334252,1.5,2.75,1.849837081346967,1.664169869476022,-0.3905543202002708,0.5356975462808578,0.9262518664811286,8.550069111433423,-0.9083127258892888,7559872483.0,2016-06-16,2016,3,168,6,1.45,207.08,207.2,205.75,4139
2016-06-17 13:30:00,207.17,207.2,205.75,206.52,209.15941176470588,212.84941176470593,201.81771800000007,202.54869400000007,207.884104,209.27046,207.26166405423803,208.7759989464696,209.85686153846157,213.42520649378585,206.28851658313718,201.81771800000007,202.54869400000007,207.884104,209.27046,206.49,117055748,89935710.05,41.87991910957507,1.5,2.75,1.9048487183936125,1.301549161450135,-0.518818847855895,0.2777283066612597,0.7965471545171547,9.609502317159519,-2.2853087295954504,7442816735.0,2016-06-17,2016,4,169,6,0.7,206.48,209.61,207.75,4140
2016-06-20 13:30:00,208.82,209.61,207.75,207.85,209.47838235294117,212.89647058823533,201.87991800000003,202.74589400000008,207.95112,209.38846,207.28473605211101,208.68780857061537,209.6707076923077,213.38300932665092,205.95840605796445,201.87991800000003,202.74589400000008,207.95112,209.38846,208.40333333333336,82789603,88825669.8,47.55943452708836,1.5,2.75,1.9895023813654973,0.9320459185549536,-0.4943997030642988,0.17854752568678126,0.6729472287510799,9.9842370411655,-1.8093348450491369,7525606338.0,2016-06-20,2016,0,172,6,0.9,208.68,208.92,207.78,4141
2016-06-21 13:30:00,208.3,208.92,207.78,208.44,209.79735294117646,212.94352941176476,201.94436800000003,202.93919400000007,208.039518,209.54996,207.33004052065567,208.66420775436632,209.4807076923077,213.17262577328484,205.78878961133057,201.94436800000003,202.93919400000007,208.039518,209.54996,208.38,72461663,89514624.15,49.89838925210632,1.5,2.75,1.9288236398393892,0.8094952493860188,-0.4216597165727386,0.14587258303515682,0.5675322996078954,10.15989364738255,-1.8505438621274224,7598068001.0,2016-06-21,2016,1,173,6,0.55,208.35,209.5,207.93,4142
2016-06-22 13:30:00,208.65,209.5,207.93,208.1,210.11632352941174,212.99058823529413,202.02191800000003,203.08298600000006,208.08311800000004,209.56146,207.3602350100417,208.61047368252187,209.31301538461537,213.04232789857556,205.58370287065517,202.02191800000003,203.08298600000006,208.08311800000004,209.56146,208.51,95560471,89615757.3,48.55440351091985,1.5,2.75,1.903193379850861,1.0663355851594194,-0.3808356924863273,0.0914876839999863,0.4723233764863136,9.69311123741242,-1.8766503206337315,7502507530.0,2016-06-22,2016,2,174,6,0.76,208.72,210.87,209.27,4143
2016-06-23 13:30:00,209.81,210.87,209.27,210.81,210.43529411764703,213.03764705882355,202.08881800000003,203.25458600000005,208.139302,209.63796,207.4955199116087,208.81995237942456,209.2714769230769,212.92026952772846,205.62268431842534,202.08881800000003,203.25458600000005,208.139302,209.63796,210.3166666666667,102731356,90791248.85,58.21499377999585,1.5,2.75,1.9651081384329436,1.1315116522929072,-0.16664416189939724,0.2640181741120671,0.4306623360114643,12.966073902560366,0.3522635312038888,7605238886.0,2016-06-23,2016,3,175,6,0.76,210.07,206.905,202.72,4144
2016-06-24 13:30:00,203.63,206.905,202.72,203.13,210.75426470588238,213.0847058823529,202.130518,203.3842860000001,208.041702,209.32746000000003,207.32432305233,208.27805215281268,208.61378461538465,213.24022935228652,203.98733987848274,202.130518,203.3842860000001,208.041702,209.32746000000003,204.2516666666667,333444400,104699433.9,37.00649209640618,1.5,2.75,2.4026004142591617,3.184777487130233,-0.5177032222047263,-0.21646669174444355,0.3012365304602828,24.45061628494064,-2.551796792695772,7271794486.0,2016-06-24,2016,4,176,6,2.06,204.81,201.6,198.65,4145
2016-06-27 13:30:00,201.59,201.6,198.65,199.6,198.65,213.1317647058824,202.149268,203.4672860000001,207.878102,208.79546000000005,207.0214084228268,207.451570995402,207.6314769230769,213.81229241029445,201.45066143585944,202.149268,203.4672860000001,207.878102,208.79546000000005,199.95,248988660,113938306.2,31.352607199366087,1.5,2.75,2.5509860989549358,2.185293676061335,-0.9386240509114796,-0.8720435331790668,0.06658051773241286,25.70249055055749,-4.0569121322822514,7022805826.0,2016-06-27,2016,0,179,6,1.49,200.12,203.23,201.12,4146
2016-06-28 13:30:00,201.48,203.23,201.12,203.1997,198.49115384615382,213.17882352941174,202.1815665,203.58328300000008,207.757312,208.46344500000004,206.87153750428456,207.04663090060177,206.9483769230769,212.97251341358375,200.9242404325701,202.1815665,203.58328300000008,207.757312,208.46344500000004,202.51656666666668,159382399,116413457.15,41.21557477516789,1.5,2.75,2.6280585204581546,1.369106312121923,-0.9241274054284824,-1.0885787390531902,-0.16445133362470776,28.710208301681753,-2.1902767749699117,7182188225.0,2016-06-28,2016,1,180,6,1.05,202.18,206.93,204.72,4147
2016-06-29 13:30:00,204.84,206.93,204.72,206.66,198.3323076923077,213.22588235294117,202.2348165,203.77038300000007,207.69251200000002,208.28294499999998,206.86324191588125,207.00980891006827,206.68606923076922,212.43430984100223,200.93782862053624,202.2348165,203.77038300000007,207.69251200000002,208.28294499999998,206.1033333333333,137328614,119783077.1,48.826856264752614,1.5,2.75,2.706790054711143,1.1464775937034264,-0.6442693697198054,-0.9697880457744644,-0.3255186760546591,30.771004402004753,-0.8206555646206306,7319516839.0,2016-06-29,2016,2,181,6,1.08,205.82,209.54,206.56,4148
2016-06-30 13:30:00,207.21,209.54,206.56,209.475,198.17346153846157,213.2729411764706,202.2898915,204.01093300000008,207.680012,208.21119500000003,206.96566380153297,207.24458901387132,206.76497692307686,212.63474140749042,200.89521243866344,202.2898915,204.01093300000008,207.680012,208.21119500000003,208.52500000000003,165021948,124881937.05,54.040271232911365,1.5,2.75,2.7263050508032043,1.321423673416667,-0.25247169444307715,-0.6411082941085056,-0.3886365996654284,31.787018647530758,1.4308541545612938,7484538787.0,2016-06-30,2016,3,182,6,1.44,208.05,210.49,209.29,4149
2016-07-01 13:30:00,209.36,210.49,209.29,209.9208,198.01461538461535,213.32,202.3385955,204.2558410000001,207.699028,208.19323500000004,207.0815514955905,207.4994662506455,206.90965384615384,212.9870360298645,200.8322716624432,202.3385955,204.2558410000001,207.699028,208.19323500000004,209.90026666666665,106055333,125096847.4,54.825186742891006,1.5,2.75,2.61728326146012,0.8477858171827918,0.03832752167533898,-0.3407271975712547,-0.3790547192465937,31.214081814723052,0.9962954053403992,7590594120.0,2016-07-01,2016,4,183,7,0.57,209.89,209.08,207.71,4150
2016-07-05 13:30:00,208.95,209.08,207.71,208.41,197.85576923076923,213.36705882352945,202.3819955,204.48724100000007,207.687828,208.046235,207.13364751537128,207.58618375058398,206.96042307692304,213.07594470140012,200.84490145244598,202.3819955,204.48724100000007,207.687828,208.046235,208.4,109803713,127342680.8,51.60843364888417,1.5,2.75,2.588248742784397,0.8622695258980287,0.12562568762636828,-0.2220226097136333,-0.3476482973400016,31.429179516359138,-0.0143926309729424,7480790407.0,2016-07-05,2016,1,187,7,0.66,208.4,209.8,207.06,4151
2016-07-06 13:30:00,207.83,209.8,207.06,209.66,197.6969230769231,213.41411764705882,202.45304550000003,204.75524100000007,207.708828,207.945235,207.2327201618273,207.78369006005215,207.05965384615382,213.30395010316658,200.8153575891411,202.45304550000003,204.75524100000007,207.708828,207.945235,208.84,96021491,129095017.3,54.012598263806254,1.5,2.75,2.5990881182997985,0.7438047804498803,0.2566985036046735,-0.026775167834159674,-0.2834736714388332,31.57425799218901,0.7496395963479108,7576811898.0,2016-07-06,2016,2,188,7,1.32,208.43,210.6495,208.63,4152
2016-07-07 13:30:00,209.87,210.6495,208.63,209.52599999999998,197.5380769230769,213.46117647058827,202.51837550000005,204.98420100000007,207.720964,207.80303500000002,207.32265270450074,207.9496243400472,207.29088461538456,213.65951140994056,200.92225782082858,202.51837550000005,204.98420100000007,207.720964,207.80303500000002,209.60183333333333,85593827,130066162.65,53.70457376194347,1.5,2.75,2.557688966992669,0.6580791287763882,0.31942865402493714,0.11581214609233825,-0.2036165079325989,31.553939630092568,-0.6090792656894796,7491218071.0,2016-07-07,2016,3,189,7,0.97,209.64,212.94,210.7785,4153
2016-07-08 13:30:00,211.05,212.94,210.7785,212.65,197.37923076923082,213.5082352941177,202.61207550000003,205.21290100000007,207.786964,207.831535,207.53156828471643,208.39727916480462,207.66011538461535,214.64258295719657,200.6776478120342,202.61207550000003,205.21290100000007,207.786964,207.831535,212.12283333333332,133970972,133075367.8,59.50292782212946,1.5,2.75,2.618854040778906,1.0067300524116982,0.5432244337508149,0.4754140342559197,-0.06781039949489517,31.83458985939602,4.686653866981741,7625189043.0,2016-07-08,2016,4,190,7,1.03,211.86,214.07,212.95,4154
2016-07-11 13:30:00,213.19,214.07,212.95,213.4,197.22038461538463,213.5552941176471,202.71107550000005,205.41810100000006,207.906014,207.99803500000002,207.76170286178638,208.87372876815655,208.04165384615382,215.66548083128342,200.41782686102425,202.71107550000005,205.41810100000006,207.906014,207.99803500000002,213.47333333333333,73633937,131065606.75,60.77316504068962,1.5,2.75,2.5332216092946966,0.5618097594470565,0.7035000327167776,0.8115646414010769,0.10806460868429926,20.718093527281145,6.913827655310628,7698822980.0,2016-07-11,2016,0,193,7,0.53,213.51,215.3,213.4308,4155
2016-07-12 13:30:00,214.53,215.3,213.4308,214.95,197.06153846153848,213.6023529411765,202.82132550000003,205.64670100000006,208.078398,208.323075,208.0435968672065,209.45242126642742,208.5685769230769,217.0359135745982,200.10124027155558,202.82132550000003,205.64670100000006,208.078398,208.323075,214.56026666666676,101275629,130241830.55,63.33288836877772,1.5,2.75,2.4879914943450765,0.7775967872404878,0.8650112134083335,1.1893286254447162,0.32431741203638265,14.987100773351562,5.782636490112918,7800098609.0,2016-07-12,2016,1,194,7,0.88,214.37,215.45,214.35,4156
2016-07-13 13:30:00,215.44,215.45,214.35,214.92,196.9026923076923,213.64941176470592,202.93167549999998,205.87590100000008,208.217398,208.667075,208.3132597351592,209.9731430505772,208.8847307692308,217.9490907795251,199.82037075893643,202.93167549999998,205.87590100000008,208.217398,208.667075,214.90666666666667,87324129,128355072.7,63.24686370327076,1.5,2.75,2.3888492447489997,0.6803325117044634,0.9160267054508238,1.4693507938499124,0.5533240883990886,13.913849594328802,3.9969031259072834,7712774480.0,2016-07-13,2016,2,195,7,0.51,214.9,216.67,215.66,4157
2016-07-14 13:30:00,216.4,216.67,215.66,216.12,196.74384615384616,213.6964705882353,203.07222550000003,206.08930100000006,208.41661399999998,209.085575,208.61940641221176,210.55855799814125,209.8839615384615,219.0538237085688,200.71409936835425,203.07222550000003,206.08930100000006,208.41661399999998,209.085575,216.15,91230870,127460391.4,65.27845973027131,1.5,2.75,2.3432171558383565,0.7157585897700295,0.9715192404541698,1.7677231389668009,0.7962038985126311,11.937112860110648,3.1722162549230264,7804005350.0,2016-07-14,2016,3,196,7,0.47,216.16,217.0125,215.308,4158
2016-07-15 13:30:00,216.78,217.0125,215.308,215.83,196.585,213.74352941176477,203.21077549999998,206.32440100000008,208.633014,209.458575,208.90217478820347,211.06060009355642,211.13242307692303,218.6283437604203,203.63650239342581,203.21077549999998,206.32440100000008,208.633014,209.458575,216.05016666666668,107155401,125341508.2,64.35267294920166,1.5,2.75,2.2975945018499027,0.8549075445064733,0.9296062809132756,1.9582117496542253,1.0286054687409498,10.810228469221721,2.814966406378024,7696849949.0,2016-07-15,2016,4,197,7,0.79,216.16,216.6,215.67,4159
2016-07-18 13:30:00,215.97,216.6,215.67,216.4092,196.42615384615382,213.7905882352941,203.33467150000004,206.55649300000007,208.861798,209.95303499999997,209.1965679337641,211.56999056083671,212.14853846153844,218.5722347497625,205.72484217331439,203.33467150000004,206.55649300000007,208.861798,209.95303499999997,216.2264,58725918,122425016.7,65.40787012068499,1.5,2.75,2.199909180289196,0.479688870648935,0.8821901436831461,2.1313431483448824,1.2491530046617365,10.798746507953675,3.8382035410968767,7755575867.0,2016-07-18,2016,0,200,7,0.43,216.14,216.23,215.63,4160
2016-07-19 13:30:00,215.92,216.23,215.63,216.19,196.2673076923077,213.8376470588236,203.45497150000008,206.76299300000005,209.07119800000004,210.37003499999992,209.47082017165573,212.0099914598046,212.88161538461537,218.7867819453332,206.97644882389758,203.45497150000008,206.76299300000005,209.07119800000004,210.37003499999992,216.01666666666665,54345728,121002822.95,64.6281742840264,1.5,2.75,2.0984299531256823,0.44912776970878104,0.7808476409785265,2.2252125558848945,1.4443649149063682,9.09608251212747,3.114566440904322,7701230139.0,2016-07-19,2016,1,201,7,0.28,215.93,217.37,216.24,4161
2016-07-20 13:30:00,216.75,217.37,216.24,217.085,196.10846153846157,213.884705882353,203.56539650000005,206.98295100000007,209.29511400000004,210.80228499999996,209.76941545904182,212.49332560648992,213.467,219.41392839345525,207.52007160654472,203.56539650000005,206.98295100000007,209.29511400000004,210.80228499999996,216.8983333333333,58159457,120287712.65,66.38987643967711,1.5,2.75,2.0328278136167053,0.4835028925126044,0.7203436098767537,2.3447944272523102,1.6244508173755563,8.985405085962915,3.607666828937696,7759389596.0,2016-07-20,2016,2,202,7,0.52,216.8,217.22,215.75,4162
2016-07-21 13:30:00,216.96,217.22,215.75,216.265,195.94961538461536,213.93176470588242,203.65437150000002,207.21000100000003,209.451414,211.21053499999996,210.0241442645696,212.85253269158608,213.95501538461536,219.6954673538677,208.21456341536302,203.65437150000002,207.21000100000003,209.451414,211.21053499999996,216.41166666666663,67777310,118898554.6,63.280178504552936,1.5,2.75,1.9926258269297976,0.5700431786409622,0.5775189606467879,2.346349518184041,1.7688305575372536,9.666706060599907,1.6999764871855068,7691612286.0,2016-07-21,2016,3,203,7,0.68,216.48,217.3,216.1,4163
2016-07-22 13:30:00,216.41,217.3,216.1,217.24,195.79076923076923,213.97882352941173,203.75162150000003,207.40130100000005,209.666214,211.53203499999992,210.30711899929238,213.27038672095887,214.63424615384616,219.6309491976893,209.637543110003,203.75162150000003,207.40130100000005,209.666214,211.53203499999992,216.88,62787477,116901360.65,65.35793913059024,1.5,2.75,1.9360096964348132,0.5370979144373201,0.5038208709299421,2.3986066461996813,1.8947857752697392,6.388751664227688,1.7994376757263368,7754399763.0,2016-07-22,2016,4,204,7,0.56,216.7,217.06,215.97,4164
2016-07-25 13:30:00,217.0,217.06,215.97,216.65,195.6319230769231,214.02588235294118,203.8378215,207.57780100000008,209.868014,212.20803499999988,210.55585943069264,213.5922546522961,215.1719384615385,219.34896551584973,210.99491140722728,203.8378215,207.57780100000008,209.868014,212.20803499999988,216.56,55873147,103022798.0,63.033601817958406,1.5,2.75,1.8884375752608988,0.5423376969435445,0.3762903916032083,2.3651487647737497,1.9888583731705411,6.8773681135373375,0.7908816003721876,7698526616.0,2016-07-25,2016,0,207,7,0.5,216.52,217.17,215.76,4165
2016-07-26 13:30:00,216.53,217.17,215.76,216.75,195.4730769230769,214.0729411764706,203.91552150000004,207.74755100000004,210.10781400000002,213.0655349999999,210.7987669039988,213.8929923044584,215.7276307692308,218.4053961790396,213.0498653594221,203.91552150000004,207.74755100000004,210.10781400000002,213.0655349999999,216.56,70080493,94077389.65,63.272015171470365,1.5,2.75,1.8542634627422632,0.7449238681124482,0.264880717952146,2.319959270610724,2.055078552658578,5.836027739311607,0.8514796203238473,7768607109.0,2016-07-26,2016,1,208,7,0.65,216.46,217.27,215.62,4166
2016-07-27 13:30:00,217.19,217.27,215.62,216.52,195.31423076923082,214.12000000000003,203.9914715,207.90845100000007,210.302614,213.73154999999988,211.0231289861949,214.14318351355757,216.02532307692314,218.04886591695487,214.00178023689134,203.9914715,207.90845100000007,210.302614,213.73154999999988,216.47,84083893,90312464.35,62.277148960153255,1.5,2.75,1.8396732154035305,0.9310330927759696,0.14775198637931375,2.23976853563272,2.0920165492534064,5.915559655768262,0.1850823616509373,7684523216.0,2016-07-27,2016,2,209,7,0.77,216.44,217.11,215.75,4167
2016-07-28 13:30:00,216.29,217.11,215.75,216.77,195.15538461538463,214.16705882352943,204.0677215,208.07025100000007,210.540998,214.23704999999993,211.24849647693242,214.3933565122664,216.28455384615387,217.6541661497641,214.91494154254363,204.0677215,208.07025100000007,210.540998,214.23704999999993,216.5433333333333,65035718,86697819.55,62.958912234074795,1.5,2.75,1.805410842874708,0.7501424872916542,0.06347446372116837,2.1713596289048667,2.1078851651836983,5.083596578228083,0.4355279618218032,7749558934.0,2016-07-28,2016,3,210,7,0.63,216.43,217.54,216.13,4168
2016-07-29 13:30:00,216.46,217.54,216.13,217.12,194.99653846153848,214.21411764705886,204.15207150000003,208.25745100000003,210.785198,214.61929999999992,211.4787515170527,214.65303684443145,216.45147692307697,217.64777715333085,215.2551766928231,204.15207150000003,208.25745100000003,210.785198,214.61929999999992,216.93,79519436,82422693.95,63.94145180397872,1.5,2.75,1.7771672112407997,0.9647759881306329,0.010442504616177128,2.12093829595392,2.1104957913377427,5.016761330831996,0.3284518403099342,7829078370.0,2016-07-29,2016,4,211,7,0.65,216.83,217.65,216.405,4169
2016-08-01 13:30:00,217.19,217.65,216.405,216.94,194.8376923076923,214.26117647058825,204.2403215,208.433051,211.03999800000003,214.97025999999988,211.6929181242271,214.87084285924755,216.6068615384616,217.4353063448077,215.77841673211543,204.2403215,208.433051,211.03999800000003,214.97025999999988,216.9983333333333,73311422,80785498.4,63.01567970662684,1.5,2.75,1.7391552675807431,0.9074824498452312,-0.0540724800570862,2.042905191266385,2.096977671323472,4.8861545470722785,0.3469170636939729,7755766948.0,2016-08-01,2016,0,214,8,0.58,217.03,216.83,214.57,4170
2016-08-02 13:30:00,216.65,216.83,214.57,215.5492,194.67884615384617,214.3082352941177,204.30631750000003,208.59314300000003,211.24118199999998,215.32721999999993,211.84414486445345,214.93544830122397,216.5629538461539,217.53756917101413,215.58833852129368,204.30631750000003,208.59314300000003,211.24118199999998,215.32721999999993,215.64973333333336,92295506,79910088.05,56.24012673134033,1.5,2.75,1.78421560561069,1.1549919196966771,-0.19955000582148094,1.84754016404662,2.0470901698681008,6.2044823326974905,-0.7074648179284587,7663471442.0,2016-08-02,2016,1,215,8,1.05,215.7,216.245,215.13,4171
2016-08-03 13:30:00,215.48,216.245,215.13,216.18,194.52,214.3552941176471,204.3708675000001,208.72734300000005,211.46058200000004,215.65321999999992,212.0141783991808,215.05397703444078,216.589876923077,217.49916287843982,215.68059096771407,204.3708675000001,208.72734300000005,211.46058200000004,215.65321999999992,215.8516666666667,53993626,77808694.8,58.423632524653996,1.5,2.75,1.7364144909242132,0.6939279233353751,-0.2586785075440634,1.723742035438022,1.9824205429820851,5.92176300404937,-0.03930363211799392,7717465068.0,2016-08-03,2016,2,216,8,0.52,215.69,216.78,214.25,4172
2016-08-04 13:30:00,216.31,216.78,214.25,216.4097,214.25,214.4023529411765,204.43606600000004,208.86644000000004,211.631376,215.99740499999996,212.18655179529134,215.18309350735115,216.58991538461544,217.49917080897038,215.68065996026056,204.43606600000004,208.86644000000004,211.631376,215.99740499999996,215.81323333333333,46585528,75858279.85,59.221559053761176,1.5,2.75,1.7930991701439123,0.6141126333488829,-0.2855931844036164,1.625429062477565,1.9110222468811813,5.556255890833175,-0.38220401399375,7764050596.0,2016-08-04,2016,3,217,8,1.18,215.52,218.23,217.07,4173
2016-08-05 13:30:00,217.21,218.23,217.07,218.18,214.82777777777775,214.44941176470596,204.51151600000009,209.02654000000007,211.809376,216.273905,212.4215889797897,215.4685131733177,216.74299230769236,217.9520270567636,215.5339575586211,204.51151600000009,209.02654000000007,211.809376,216.273905,217.82666666666668,71892161,72754339.3,64.82462412966129,1.5,2.75,1.7950420865622043,0.9881494587361336,-0.1919375305748248,1.6711003336626504,1.8630378642374752,6.859230667399935,0.7062081698592204,7835942757.0,2016-08-05,2016,4,218,8,0.53,217.65,218.52,217.74,4174
2016-08-08 13:30:00,218.4,218.52,217.74,218.05,215.40555555555562,214.49647058823533,204.59251600000007,209.17364000000006,211.98357599999997,216.50640499999997,212.64231098058227,215.7143690615732,216.8172230769231,218.2062352863256,215.42821086752065,204.59251600000007,209.17364000000006,211.98357599999997,216.50640499999997,218.1033333333333,39906479,71067966.4,64.1278009917135,1.5,2.75,1.7225390803791898,0.5615255511236916,-0.14845555553395573,1.6774684198200305,1.8259239753539864,6.606450411499159,0.5997693194925081,7796036278.0,2016-08-08,2016,0,221,8,0.36,218.13,218.76,217.8,4175
2016-08-09 13:30:00,218.13,218.76,217.8,218.18,215.9833333333333,214.54352941176475,204.6571160000001,209.30914000000004,212.14237599999998,216.667905,212.85947525585357,215.94919105570904,216.9645307692308,218.48773789872595,215.44132363973569,204.6571160000001,209.30914000000004,212.14237599999998,216.667905,218.24666666666667,51251728,68566771.35,64.53831371542125,1.5,2.75,1.6680720032092464,0.7474717999828937,-0.1217699144807276,1.6737115822530768,1.7954814967338044,6.605542621137201,0.7666728246813211,7847288006.0,2016-08-09,2016,1,222,8,0.44,218.28,218.4038,217.23,4176
2016-08-10 13:30:00,218.31,218.4038,217.23,217.64,216.5611111111111,214.59058823529412,204.70776600000005,209.44174000000004,212.298376,216.80390500000004,213.04694681444752,216.11022047897487,216.9953,218.5552396004316,215.43536039956845,204.70776600000005,209.44174000000004,212.298376,216.80390500000004,217.7579333333333,57941092,67097619.5,61.39535120218404,1.5,2.75,1.6327668601228715,0.8635342420754585,-0.1494910920630257,1.6086176316550225,1.758108723718048,6.787480784706028,0.4013470498685132,7789346914.0,2016-08-10,2016,2,223,8,0.54,217.82,218.94,217.95,4177
2016-08-11 13:30:00,218.26,218.94,217.95,218.65,217.13888888888889,214.63764705882357,204.76601600000006,209.58154000000005,212.465976,216.93040499999998,213.26667439035157,216.35210424288204,217.14914615384617,218.92242605733242,215.3758662503599,204.76601600000006,209.58154000000005,212.465976,216.93040499999998,218.5133333333333,72504270,66161289.5,64.84388698425714,1.5,2.75,1.6089977986855242,1.095871476326047,-0.11060212023979464,1.6198560734183047,1.7304581936580994,7.187348189476436,0.704679439941047,7861851184.0,2016-08-11,2016,3,224,8,0.45,218.44,218.71,217.99,4178
2016-08-12 13:30:00,218.29,218.71,217.99,218.46,217.71666666666667,214.68470588235297,204.82531600000004,209.72054000000003,212.616976,217.061905,213.47033421818088,216.5528562197504,217.28068461538464,219.16615820510282,215.39521102566644,204.82531600000004,209.72054000000003,212.616976,217.061905,218.38666666666668,61313544,63869196.65,63.691251920837466,1.5,2.75,1.5454979559222723,0.9599861469370776,-0.10833093336281464,1.5950445269545812,1.7033754603173956,7.233524079212526,0.7006545588642068,7800537640.0,2016-08-12,2016,4,225,8,0.33,218.35,219.5,218.88,4179
2016-08-15 13:30:00,218.89,219.5,218.88,219.09,218.29444444444442,214.73176470588243,204.87601600000005,209.879348,212.793176,217.195945,213.6907132684483,216.79448896072654,217.4783769230769,219.53456431973527,215.4221895264186,204.87601600000005,209.879348,212.793176,217.195945,219.15666666666667,49813482,63423574.85,65.85835167590518,1.5,2.75,1.5093909590706809,0.7854095597388105,-0.07655273161409992,1.6076845457997706,1.6842372774138703,7.275404790656145,1.6426876091398113,7850351122.0,2016-08-15,2016,0,228,8,0.28,219.19,218.68,217.96,4180
2016-08-16 13:30:00,218.6,218.68,217.96,217.96,218.87222222222226,214.77882352941182,204.92166600000004,210.02774800000003,212.92537599999991,217.2844450000001,213.8581362775288,216.90549001208595,217.5699153846154,219.59756492472576,215.54226584450504,204.92166600000004,210.02774800000003,212.92537599999991,217.2844450000001,218.2,53213621,63366969.5,59.05044799736368,1.5,2.75,1.482291604851346,0.8397690692782775,-0.14009057959506174,1.5091240529200434,1.6492146325151051,6.828430825569893,0.8233879174761778,7797137501.0,2016-08-16,2016,1,229,8,0.33,218.32,218.53,217.02,4181
2016-08-17 13:30:00,218.0,218.53,217.02,218.37,219.45,214.82588235294116,204.97386600000004,210.179048,213.05917599999992,217.34869500000005,214.03507210978253,217.04496715379204,217.66606923076927,219.71766882190877,215.61446963962982,204.97386600000004,210.179048,213.05917599999992,217.34869500000005,217.97333333333336,75134339,64215713.6,60.640256804260474,1.5,2.75,1.4842707759333922,1.1700304300597228,-0.16144142493782931,1.4474128513428184,1.6088542762806477,6.753280948895014,0.9058281583496572,7872271840.0,2016-08-17,2016,2,230,8,0.7,217.78,218.9,218.21,4182
2016-08-18 13:30:00,218.34,218.9,218.21,218.86,220.02777777777774,214.87294117647065,205.01621600000007,210.31644,213.18897599999997,217.478445,214.22428496822243,217.21782742485948,217.81376153846162,219.91095180462855,215.71657127229454,205.01621600000007,210.31644,213.18897599999997,217.478445,218.65666666666667,52989266,63476311.4,62.51339064799014,1.5,2.75,1.4275371490810067,0.8347880466160799,-0.1497576569624659,1.421657205077565,1.5714148620400312,6.790453951611282,0.3116692639105357,7925261106.0,2016-08-18,2016,3,231,8,0.32,218.56,218.75,217.74,4183
2016-08-19 13:30:00,218.31,218.75,217.74,218.54,220.60555555555558,214.92000000000004,205.05391600000007,210.44163999999998,213.31817599999997,217.543445,214.3935286949588,217.34374862249192,218.0438230769231,219.70841247725122,216.379233676595,205.05391600000007,210.44163999999998,213.31817599999997,217.543445,218.34333333333333,75443004,64109087.75,60.48883212264195,1.5,2.75,1.4055702098609348,1.1767911016640538,-0.16933189546912364,1.3597499927036267,1.5290818881727504,5.214664199886042,0.22471910112358665,7849818102.0,2016-08-19,2016,4,232,8,0.46,218.24,218.8,217.83,4184
2016-08-22 13:30:00,218.26,218.8,217.83,218.53,221.1833333333333,214.96705882352947,205.09476600000005,210.57174,213.48737599999995,217.637445,214.55574325594083,217.4567249441594,218.2245923076924,219.50677937298386,216.94240524240087,205.09476600000005,210.57174,213.48737599999995,217.637445,218.38666666666663,61368766,64383868.7,60.42297631206316,1.5,2.75,1.3744580520137253,0.9531699048087799,-0.18730251551753208,1.2949537437758352,1.4822562592933672,5.1948580681041285,0.16041800348335974,7788449336.0,2016-08-22,2016,0,235,8,0.45,218.32,219.6,218.9,4185
2016-08-23 13:30:00,219.25,219.6,218.9,218.97,221.76111111111112,219.6,205.13886600000006,210.69224000000003,213.697792,217.74844500000003,214.728851363551,217.60084637804889,218.42153846153852,219.22548435149974,217.61759257157718,205.13886600000006,210.69224000000003,213.697792,217.74844500000003,219.15666666666667,53399159,63549802.0,62.36454785419471,1.5,2.75,1.3527110482984586,0.8402726258690782,-0.17418111994734484,1.264529859359186,1.438710979306531,5.294647980763694,0.611100900569754,7841848495.0,2016-08-23,2016,1,236,8,0.32,219.25,218.91,217.36,4186
2016-08-24 13:30:00,218.8,218.91,217.36,217.85,222.3388888888889,219.7335849056604,205.17791600000004,210.80823999999998,213.893992,217.814945,214.85124934929408,217.62457529442523,218.39615384615388,219.24839211041981,217.543915581888,205.17791600000004,210.80823999999998,213.893992,217.814945,218.04,71728949,62932054.8,54.971884618612975,1.5,2.75,1.3710888305628532,1.139783997645664,-0.2414182581277113,1.1369381566468917,1.378356414774603,5.986053269302839,-0.3658815458495364,7770119546.0,2016-08-24,2016,2,237,8,0.71,218.14,218.19,217.22,4187
2016-08-25 13:30:00,217.4,218.19,217.22,217.7,222.91666666666663,219.86716981132076,205.226016,210.943348,214.092992,217.86144500000003,214.96296506108646,217.6317585997181,218.3692307692308,219.28337472483682,217.4550868136248,205.226016,210.943348,214.092992,217.86144500000003,217.70333333333332,69224776,63141507.7,54.04782647633974,1.5,2.75,1.342439628379792,1.0963434121482023,-0.2930445116245912,1.012050775243864,1.305095286868455,5.2462926944202986,-0.3478897738716558,7700894770.0,2016-08-25,2016,3,238,8,0.45,217.7,219.12,216.25,4188
2016-08-26 13:30:00,217.92,219.12,216.25,217.29,223.49444444444444,220.00075471698116,205.26966600000003,211.05204800000004,214.271392,217.86994500000003,215.05422133320076,217.5992101616497,218.30076923076922,219.3797847803119,217.22175368122657,205.26966600000003,211.05204800000004,214.271392,217.86994500000003,217.5533333333333,122506348,65290853.3,51.49959002026425,1.5,2.75,1.4515510834955216,1.87631715329412,-0.3481045163921106,0.8699646413783171,1.2180691577704277,5.308885792927933,-0.8215801725318415,7578388422.0,2016-08-26,2016,4,239,8,1.33,217.68,218.665,217.4,4189
2016-08-29 13:30:00,217.44,218.665,217.4,218.3608,224.07222222222225,220.13433962264148,205.32277000000005,211.196156,214.508208,217.94098500000004,215.18389108483998,217.67174252720687,218.3562153846154,219.36554333110863,217.34688743812214,205.32277000000005,211.196156,214.508208,217.94098500000004,218.14193333333333,70502167,65150390.55,57.17812562611492,1.5,2.75,1.4460831489601274,1.0821449634425868,-0.3071357963126489,0.8341494123796167,1.1412852086922656,5.884293482854347,0.18388695173426486,7648890589.0,2016-08-29,2016,0,242,8,0.58,218.03,218.59,217.35,4190
2016-08-30 13:30:00,218.26,218.59,217.35,218.0,224.65,220.26792452830188,205.38857000000007,211.33116400000003,214.711208,218.06352500000003,215.2943267285717,217.70300514366338,218.3062153846154,219.31677416937578,217.29565659985505,205.38857000000007,211.33116400000003,214.711208,218.06352500000003,217.98,58114543,63441342.4,54.84792149675759,1.5,2.75,1.4313629240344046,0.916035834071506,-0.2987871228031953,0.7678013051882715,1.0665884279914668,5.1251850123608005,-0.16943719375372282,7590776046.0,2016-08-30,2016,1,243,8,0.57,217.97,217.75,216.465,4191
2016-08-31 13:30:00,217.61,217.75,216.465,217.38,225.22777777777776,220.40150943396225,205.46277000000006,211.46476300000003,214.89000799999997,218.12352500000003,215.37611783725518,217.67224274902873,218.2231384615385,219.34130957691156,217.10496734616547,205.46277000000006,211.46476300000003,214.89000799999997,218.12352500000003,217.19833333333332,85269453,65005133.75,51.00150022123938,1.5,2.75,1.4387655723176611,1.3117341366903963,-0.32718225595965955,0.6576106080418924,0.984792864001552,5.214092440052021,-0.6762313807913818,7505506593.0,2016-08-31,2016,2,244,8,0.59,217.11,217.73,216.03,4192
2016-09-01 13:30:00,217.37,217.73,216.03,217.39,225.80555555555557,220.53509433962262,205.52162000000004,211.57946300000003,215.07580799999997,218.17254000000003,215.4550936083432,217.6453624872165,218.09236923076924,219.1713801264938,217.01335833504467,205.52162000000004,211.57946300000003,215.07580799999997,218.17254000000003,217.05,97844207,67568067.7,51.06111360179931,1.5,2.75,1.4574251742949702,1.4480835449435236,-0.3361683327390468,0.5645824480777435,0.9007507808167904,4.944664450211717,-0.5262194563924251,7603350800.0,2016-09-01,2016,3,245,9,0.79,216.88,218.87,217.7,4193
2016-09-02 13:30:00,218.39,218.87,217.7,218.37,226.38333333333333,220.66867924528302,205.58612000000005,211.68315499999997,215.227008,218.18204,215.569403662918,217.71437558367202,218.1239076923077,219.2095462678551,217.03826911676026,205.58612000000005,211.68315499999997,215.227008,218.18204,218.3133333333334,79293856,67938152.45,56.62991806791669,1.5,2.75,1.459037661845331,1.1671476650525252,-0.26984879447033805,0.5634397877288677,0.8332885821992058,5.717364569588293,-0.07321649201482477,7682644656.0,2016-09-02,2016,4,246,9,0.54,218.28,219.12,217.86,4194
2016-09-06 13:30:00,218.7,219.12,217.86,219.0308,226.9611111111111,220.80226415094342,205.63762400000005,211.79336300000003,215.545024,218.23108,215.70514469574474,217.83974933760803,218.17473846153842,219.35909669614983,216.99038022692704,205.63762400000005,211.79336300000003,215.545024,218.23108,218.67026666666663,56702089,68777932.95,59.9400614567815,1.5,2.75,1.4448206859992352,0.82442269733842,-0.17956129368876927,0.6088369650882441,0.7883982587770134,5.987534673832742,0.027766360688679003,7739346745.0,2016-09-06,2016,1,250,9,0.58,218.49,219.22,218.3,4195
2016-09-07 13:30:00,218.84,219.22,218.3,219.01,227.5388888888889,220.93584905660373,205.689924,211.90566300000003,215.933224,218.27258,215.83474686453903,217.95120178164538,218.1862769230769,219.39968117214173,216.97287267401214,205.689924,211.90566300000003,215.933224,218.27258,218.84333333333333,76554855,70043089.3,59.78538309460474,1.5,2.75,1.4073334941421458,1.0929679967728094,-0.12207302147298148,0.6358069819357866,0.7578800034087679,5.879384563083858,0.5324764746385112,7662791890.0,2016-09-07,2016,2,251,9,0.42,218.76,218.94,218.15,4196
2016-09-08 13:30:00,218.62,218.94,218.15,218.51,228.11666666666667,221.06943396226413,205.73592000000005,211.998371,216.23942999999997,218.31608,215.93965875220417,218.00442065958396,218.18396923076924,219.39478516255627,216.97315329898223,205.73592000000005,211.998371,216.23942999999997,218.31608,218.53333333333333,74102880,70851178.7,56.04157106461139,1.5,2.75,1.368238244560563,1.0458948088043594,-0.118459495912688,0.6098056335179081,0.7282651294305961,5.151992979072423,0.3720716582452928,7588689010.0,2016-09-08,2016,3,252,9,0.36,218.54,217.03,213.25,4197
2016-09-09 13:30:00,216.97,217.03,213.25,213.28,228.69444444444443,221.20301886792453,205.75697,212.032171,216.37183,218.04758,215.83535840898048,217.55447583486165,217.7801230769231,220.63958666743252,214.92065948641363,205.75697,212.032171,216.37183,218.04758,214.52,221589073,78305418.85,32.861249394235394,1.5,2.75,1.6462212270919507,2.82980509209038,-0.4503906015141521,0.16527687753790588,0.615667479052058,15.018769178234825,-1.845459984352704,7367099937.0,2016-09-09,2016,4,253,9,1.77,215.14,216.81,212.31,4198
2016-09-12 13:30:00,212.39,216.81,212.31,216.34,212.31,221.3366037735849,205.79192000000003,212.094571,216.50912999999997,217.94158,215.855148275295,217.43881146963676,217.5778153846154,220.4440542622353,214.71157650699558,205.79192000000003,212.094571,216.50912999999997,217.94158,215.15333333333336,168110913,83645287.3,46.74163185656829,1.5,2.75,1.8500625680139544,2.0098073475085068,-0.4451592399683884,0.05921842909157249,0.5043776690599608,17.691599948153407,-0.9254408300390949,7535210850.0,2016-09-12,2016,0,256,9,2.12,214.56,215.1499,212.5,4199
2016-09-13 13:30:00,214.84,215.1499,212.5,213.23,212.23538461538465,221.4701886792453,205.81147000000004,212.137171,216.57531400000002,217.64857999999995,215.75220128410692,217.0379722820523,217.2224307692308,220.89718222988463,213.54767930857702,205.81147000000004,212.137171,216.57531400000002,217.64857999999995,213.62663333333333,182828839,90296055.15,38.11651464281695,1.5,2.75,1.9922009560129577,2.024771056678881,-0.6216155903544275,-0.2726418188830735,0.348973771471354,18.99382310433646,-2.1880733944954174,7352382011.0,2016-09-13,2016,1,257,9,1.25,213.82,214.7,212.5,4200
2016-09-14 13:30:00,213.29,214.7,212.5,213.15,212.16076923076923,221.6037735849056,205.82942000000008,212.178971,216.670114,217.40807999999996,215.6501541749263,216.66768920757116,216.87243076923082,221.12056029307706,212.62430124538457,205.82942000000008,212.178971,216.670114,217.40807999999996,213.45,134185491,94344648.65,37.92266088725577,1.5,2.75,2.0070437448691743,1.4222904310959028,-0.707915836198075,-0.5359210237762397,0.17199481242183526,19.025717696279198,-1.945901186861712,7218196520.0,2016-09-14,2016,2,258,9,1.04,213.6,215.73,212.75,4201
2016-09-15 13:30:00,212.96,215.73,212.75,215.28,212.08615384615382,221.73735849056604,205.86237000000008,212.245671,216.782514,217.2535799999999,215.6356383249292,216.5355283306596,216.71781538461545,221.0395728346886,212.39605793454223,205.86237000000008,212.245671,216.782514,217.2535799999999,214.58666666666667,145736123,97874737.85,45.82307233589577,1.5,2.75,2.076540620235661,1.489006522023599,-0.5905334604126146,-0.5661720130939331,0.02436144731868159,20.25195532136244,-0.9706058236349352,7363932643.0,2016-09-15,2016,3,259,9,1.4,214.24,213.69,212.57,4202
2016-09-16 13:30:00,213.48,213.69,212.57,213.37,212.01153846153846,221.87094339622644,205.8758200000001,212.290179,216.85939400000004,216.97907999999995,215.54678976316725,216.2340494420253,216.3339076923077,220.88429642054047,211.783518964075,205.8758200000001,212.290179,216.85939400000004,216.97907999999995,213.21,155236354,102987092.25,40.807761690176,1.5,2.75,2.1217877187902574,1.5073379644816605,-0.6081175580964548,-0.7357855003018869,-0.12766794220543212,20.7328804334282,-2.2896918074827126,7208696289.0,2016-09-16,2016,4,260,9,0.53,213.13,214.88,213.03,4203
2016-09-19 13:30:00,214.13,214.88,213.03,213.41,211.9369230769231,222.00452830188684,205.90022500000006,212.330779,216.87459400000003,216.72257999999997,215.46299408618032,215.96509235230863,215.98083076923083,220.66951999616543,211.29214154229626,205.90022500000006,212.330779,216.87459400000003,216.72257999999997,213.7733333333333,80250490,103227466.55,40.9535151891746,1.5,2.75,2.1023743103052386,0.7774141193432205,-0.5835437717899271,-0.857097656942841,-0.2735538851529139,20.394347226529504,-2.566214431942906,7288946779.0,2016-09-19,2016,0,263,9,0.87,213.96,214.59,213.38,4204
2016-09-20 13:30:00,214.41,214.59,213.38,213.42,211.8623076923077,222.13811320754715,205.93927500000007,212.390504,216.87499400000004,216.46707999999995,215.382876671036,215.72270260446967,215.67621538461543,220.4749740201307,210.8774567491002,205.93927500000007,212.390504,216.87499400000004,216.46707999999995,213.79666666666665,69665279,103642292.2,40.99263395528376,1.5,2.75,2.0386332881405798,0.6721703806547034,-0.5344189546364819,-0.9415775784485164,-0.4071586238120344,20.18132514977112,-2.5523948678142565,7358612058.0,2016-09-20,2016,1,264,9,0.57,213.98,216.03,213.44,4205
2016-09-21 13:30:00,214.24,216.03,213.44,215.82,211.7876923076923,222.27169811320755,205.97027500000004,212.48539599999995,216.892394,216.30957999999995,215.4000187623679,215.7319690230916,215.55544615384625,220.2535728853373,210.85731942235515,205.97027500000004,212.48539599999995,216.892394,216.30957999999995,215.09666666666664,110284425,106486555.5,49.61943968374789,1.5,2.75,2.0794451961305387,1.0356652488397935,-0.318738965647108,-0.8055823308709193,-0.4868433652238114,21.671373188598395,-1.231064939819687,7468896483.0,2016-09-21,2016,2,265,9,1.21,214.74,217.53,216.71,4206
2016-09-22 13:30:00,217.0,217.53,216.71,217.18,211.7130769230769,222.40528301886792,206.01442500000005,212.577496,216.937594,216.27607999999992,215.46982194815743,215.8698767351781,215.46390769230774,219.98203576379927,210.94577962081627,206.01442500000005,212.577496,216.937594,216.27607999999992,217.14,76678713,106734043.7,53.7461503743484,1.5,2.75,2.0530562535497863,0.7184091442794273,-0.07561562287138003,-0.5813628938130364,-0.5057472709416564,22.105254355174488,1.8285821455363864,7545575196.0,2016-09-22,2016,3,266,9,0.38,217.12,216.88,215.88,4207
2016-09-23 13:30:00,216.72,216.88,215.88,215.99,211.63846153846157,222.53886792452832,206.05963000000003,212.675804,216.934994,216.19057999999993,215.4902210874453,215.8813170461136,215.23000000000008,219.27538103176903,211.18461896823112,206.05963000000003,212.675804,216.934994,216.19057999999993,216.25,73630921,106954350.95,49.89499739477716,1.5,2.75,1.9992665211533736,0.6884331525177658,0.009401055585898764,-0.4939959514592829,-0.5033970070451816,16.762631279361287,-0.1617823795876834,7471944275.0,2016-09-23,2016,4,267,9,0.46,216.38,215.23,214.01,4208
2016-09-26 13:30:00,215.02,215.23,214.01,214.24,211.56384615384616,222.67245283018863,206.10413000000003,212.768104,216.90319399999998,216.03807999999992,215.4411928095063,215.72500113695992,214.86307692307705,218.28823618599003,211.437917660164,206.10413000000003,212.768104,216.90319399999998,216.03807999999992,214.4933333333333,89827305,105320398.8,44.80996438014003,1.5,2.75,1.9978903410709916,0.8528956025943191,-0.044896493529857806,-0.5595176239575039,-0.5146211304276461,15.278036552442298,0.4736669324204002,7382116970.0,2016-09-26,2016,0,270,9,0.57,214.62,215.68,213.62,4209
2016-09-27 13:30:00,214.05,215.68,213.62,215.57,211.4892307692308,222.80603773584903,206.15263,212.874104,216.88641,215.89853999999985,215.4462440718786,215.7102391239161,214.63692307692318,217.39166036289936,211.88218579094703,206.15263,212.874104,216.88641,215.89853999999985,214.95666666666668,78494829,105720031.9,49.05910965561432,1.5,2.75,2.0023267452802065,0.7424782946929852,0.012993598472545331,-0.4983791323369644,-0.5113727308095097,13.038220992882982,1.1353506920009324,7460611799.0,2016-09-27,2016,1,271,9,0.96,214.65,216.82,214.71,4210
2016-09-28 13:30:00,215.83,216.82,214.71,216.64,211.41461538461542,222.93962264150943,206.22643000000005,212.983304,216.89541,215.8305399999999,215.49305802984412,215.79878777878122,214.89538461538467,217.72193582065637,212.06883341011303,206.22643000000005,212.983304,216.89541,215.8305399999999,216.05666666666664,87411015,107184855.5,52.24462695042961,1.5,2.75,2.010017692045905,0.815516470048327,0.12154382857859025,-0.35944294508627195,-0.4809867736648622,13.176208112576148,0.6317354143441031,7548022814.0,2016-09-28,2016,2,272,9,0.98,215.76,216.87,214.04,4211
2016-09-29 13:30:00,216.4,216.87,214.04,214.68,211.34,223.0732075471698,206.28532600000003,213.071212,216.84731000000002,215.69553999999988,215.4611734012228,215.69223656175444,214.7676923076924,217.4688618987733,212.06652271661147,206.28532600000003,213.071212,216.84731000000002,215.69553999999988,215.19666666666663,128070615,109324913.6,46.50751237356887,1.5,2.75,2.0685878568997698,1.1714677906683475,0.0625119250265091,-0.4028468673817258,-0.4653587924082349,13.304764961116376,0.6139569761447262,7419952199.0,2016-09-29,2016,3,273,9,1.32,215.46,217.12,215.36,4212
2016-09-30 13:30:00,215.65,217.12,215.36,216.3,211.26538461538465,223.20679245283017,206.34167200000005,213.149712,216.84801000000002,215.64103999999992,215.49406856195918,215.7501187939683,215.00384615384624,217.66244657757184,212.3452457301206,206.34167200000005,213.149712,216.84801000000002,215.64103999999992,216.26,117202914,110292848.95,51.27058011945058,1.5,2.75,2.095117295692643,1.0626519771298373,0.12986209577795454,-0.3030311726857917,-0.4328932684637463,12.733904765172625,1.3542008340752612,7537155113.0,2016-09-30,2016,4,274,9,0.82,216.24,216.04,215.04,4213
2016-10-03 13:30:00,215.82,216.04,215.04,215.78,211.19076923076923,223.3403773584905,206.38042200000004,213.24251199999995,216.81881,215.51153999999988,215.5052815595294,215.7529646231142,215.206153846154,217.66223626097977,212.75007143132808,206.38042200000004,213.24251199999995,216.81881,215.51153999999988,215.62,83512057,110503759.0,49.739600980259674,1.5,2.75,2.035466060286027,0.7557395128974753,0.13602971247905982,-0.2628561278649215,-0.3988858403439813,12.907032276063735,1.1058007684378286,7453643056.0,2016-10-03,2016,0,277,10,0.47,215.54,216.17,213.99,4214
2016-10-04 13:30:00,215.91,216.17,213.99,214.68,211.11615384615382,223.4739622641509,206.429522,213.32371199999997,216.77941,215.2939999999999,215.4729175768028,215.6507775161509,215.16000000000003,217.6312998759788,212.68870012402127,206.429522,213.32371199999997,216.77941,215.2939999999999,214.9466666666666,119948052,113666057.15,46.57152542967801,1.5,2.75,2.045789913122738,1.0552671132219351,0.06620168870051824,-0.3161337294683335,-0.38233541816885175,13.390741368373849,-0.5282179594106137,7333695004.0,2016-10-04,2016,1,278,10,1.02,215.08,216.13,215.33,4215
2016-10-05 13:30:00,215.41,216.13,215.33,215.63,211.04153846153847,223.6075471698113,206.507568,213.432412,216.75701,215.12499999999986,215.4790776718301,215.64879870508892,215.33384615384625,217.5851847431779,213.08250756451454,206.507568,213.432412,216.75701,215.12499999999986,215.6966666666667,72815963,113479112.55,49.55957354274364,1.5,2.75,2.0032334907568274,0.6416684212957392,0.08307689392777451,-0.2784893007591336,-0.3615661946869081,11.917231395574081,-0.7136937102864036,7406510967.0,2016-10-05,2016,2,279,10,0.37,215.73,216.04,214.735,4216
2016-10-06 13:30:00,215.37,216.04,214.735,215.78,210.9669230769231,223.74113207547168,206.578118,213.522412,216.74221,214.98849999999985,215.49087854744462,215.66129406650902,215.516153846154,217.48033366654903,213.55197402575882,206.578118,213.522412,216.74221,214.98849999999985,215.5183333333333,62927376,112920337.35,50.03472864677562,1.5,2.75,1.9533596699884808,0.5572722990098293,0.1021678971321136,-0.2338563232717661,-0.3360242204038797,11.238126842540124,-0.0972267234594231,7469438343.0,2016-10-06,2016,3,280,10,0.61,215.39,216.3,214.19,4217
2016-10-07 13:30:00,216.1,216.3,214.19,215.04,210.8923076923077,223.87471698113205,206.63581800000003,213.624304,216.70761,215.07649999999984,215.47319703578012,215.602123203032,215.6407692307693,217.22623128984432,214.0553071716944,206.63581800000003,213.624304,216.70761,215.07649999999984,215.17666666666665,89788255,106330296.45,47.649970039478035,1.5,2.75,1.964548264989305,0.844427768921169,0.06461635554525846,-0.2552537759723066,-0.31987013151756505,10.972765789095918,0.3734129947722101,7379650088.0,2016-10-07,2016,4,281,10,0.99,215.24,216.7,215.985,4218
2016-10-10 13:30:00,216.155,216.7,215.985,216.16,210.8176923076923,224.00830188679242,206.68651800000006,213.736804,216.68841,215.06749999999985,215.50013048535737,215.65525432655272,215.66692307692315,217.27441294273646,214.05943321110982,206.68651800000006,213.736804,216.68841,215.06749999999985,216.28166666666664,51855023,100517501.95,51.42367963831712,1.5,2.75,1.9427948174900689,0.5158805381553754,0.112084459048734,-0.17976455770664754,-0.29184901675538155,10.19307967873657,0.27369299995361296,7431505111.0,2016-10-10,2016,0,284,10,0.33,216.34,215.74,212.58,4219
2016-10-11 13:30:00,215.66,215.74,212.58,213.43,210.7430769230769,224.14188679245282,206.72526800000009,213.829104,216.61821,215.07749999999987,215.4189488976963,215.44332534307156,215.3784615384616,217.13527414445642,213.62164893246683,206.72526800000009,213.829104,216.61821,215.07749999999987,213.91666666666663,130367373,97894428.65,43.24130053671972,1.5,2.75,2.0597380448122062,1.3317139166938692,-0.03560059628493695,-0.3363497621115528,-0.3007491658266158,12.171876852983727,-1.4817208271787203,7301137738.0,2016-10-11,2016,1,285,10,1.49,214.16,214.32,213.01,4220
2016-10-12 13:30:00,213.59,214.32,213.01,213.71,210.66846153846157,224.27547169811317,206.76776800000007,213.91130399999997,216.58142599999996,215.10549999999992,215.35193129386508,215.27824673896947,215.20307692307705,217.12786877381512,213.27828507233886,206.76776800000007,213.91130399999997,216.58142599999996,215.10549999999992,213.68,73866117,94878459.95,44.22160843562898,1.5,2.75,2.0061853273256203,0.7785341060439503,-0.10568966714282653,-0.43286124975514895,-0.32717158261232243,11.69183173165993,-0.4518352897335564,7375003855.0,2016-10-12,2016,2,286,10,0.61,213.66,213.59,211.21,4221
2016-10-13 13:30:00,212.16,213.59,211.21,213.01,210.59384615384616,224.40905660377356,206.79581800000008,213.98930399999998,216.51802599999996,214.99199999999993,215.2600908509684,215.06222324002,215.1084615384616,217.31379557774434,212.90312749917905,206.79581800000008,213.98930399999998,216.51802599999996,214.99199999999993,212.6033333333333,101356960,92659501.8,42.25666532918821,1.5,2.75,2.0414578039452183,1.093864720088534,-0.18576931571531094,-0.5593832272564612,-0.3736139115411502,10.724773590848429,-1.521035598705511,7273646895.0,2016-10-13,2016,3,287,10,1.13,212.4,214.69,213.03,4222
2016-10-14 13:30:00,214.15,214.69,213.03,213.12,210.5192307692308,224.54264150943396,206.83176800000007,214.04180399999996,216.45223199999998,214.97949999999992,215.17616571955787,214.87724959811334,214.92000000000007,217.34332257607412,212.49667742392612,206.83176800000007,214.04180399999996,216.45223199999998,214.97949999999992,213.6133333333333,93346237,89564995.95,42.68763145021614,1.5,2.75,2.015639389377703,1.0422178442581618,-0.2157972438060871,-0.6433604662987591,-0.42756322249267203,9.418522105963582,-1.2327370469923054,7366993132.0,2016-10-14,2016,4,288,10,0.78,213.86,213.39,212.17,4223
2016-10-17 13:30:00,213.09,213.39,212.17,212.38,210.4446153846154,224.67622641509436,206.87431800000005,214.072804,216.336232,214.92799999999997,215.06651216192813,214.63941630305493,214.59230769230786,217.14530477079919,212.0393106138165,206.87431800000005,214.072804,216.336232,214.92799999999997,212.64666666666665,58275674,88466255.15,40.497868258309104,1.5,2.75,1.9588080044221527,0.6587333656340487,-0.2666327782276259,-0.7608541952772043,-0.4942214170495785,9.476795304155237,-1.0713620272032849,7308717458.0,2016-10-17,2016,0,291,10,0.58,212.78,214.31,213.27,4224
2016-10-18 13:30:00,214.24,214.31,213.27,213.71,210.37,224.8098113207547,206.93777200000005,214.116504,216.249432,214.94249999999997,215.01331560655842,214.5509004646688,214.51769230769244,217.11243437396593,211.922950241419,206.93777200000005,214.116504,216.249432,214.94249999999997,213.76333333333332,76869656,88826474.0,45.87215049920533,1.5,2.75,1.9567502898205709,0.8653912796313405,-0.1951349603324346,-0.7381401174651216,-0.543005157132687,10.146882170615237,-0.8904141353243925,7385587114.0,2016-10-18,2016,1,292,10,0.49,213.79,214.64,213.6,4225
2016-10-19 13:30:00,214.02,214.64,213.6,214.28,210.29538461538465,224.9433962264151,207.00237200000004,214.1569039999999,216.171432,214.86549999999997,214.98455813179143,214.5251004204146,214.36230769230787,216.7447583226136,211.9798570620021,207.00237200000004,214.1569039999999,216.171432,214.86549999999997,214.1733333333333,66519224,86638213.95,48.03825579465718,1.5,2.75,1.891268126261958,0.7677815708249605,-0.09876567340968112,-0.6664622488947884,-0.5676965754851073,9.886437826252633,-0.6951524701084438,7452106338.0,2016-10-19,2016,2,293,10,0.49,214.12,214.53,213.11,4226
2016-10-20 13:30:00,213.87,214.53,213.11,213.88,210.22076923076924,225.07698113207542,207.077672,214.19730399999992,216.096232,214.70049999999992,214.94124212662317,214.46366228513702,214.216153846154,216.46199154779305,211.9703161445149,207.077672,214.19730399999992,216.096232,214.70049999999992,213.84,73639830,86486269.8,46.628070900092354,1.5,2.75,1.8576061172432456,0.8514626676614975,-0.05353729575927635,-0.6346181951842027,-0.5810808994249264,9.870361704407546,-0.5394345238095223,7378466508.0,2016-10-20,2016,3,294,10,0.67,213.82,214.08,212.76,4227
2016-10-21 13:30:00,212.96,214.08,212.76,213.98,210.14615384615382,225.21056603773587,207.17732200000003,214.23440399999996,216.002832,214.59999999999994,214.90354635695164,214.41759921036208,214.16230769230785,216.39460425166072,211.93001113295497,207.17732200000003,214.23440399999996,216.002832,214.59999999999994,213.60666666666668,89089092,87259178.35,47.046582513340816,1.5,2.75,1.819205680297301,1.0209710162827816,-0.010703141334129862,-0.5944598260925886,-0.5837566847584588,9.755002932285851,-1.0085122131754287,7467555600.0,2016-10-21,2016,4,295,10,0.62,213.42,215.32,214.48,4228
2016-10-24 13:30:00,215.0,215.32,214.48,214.89,210.07153846153847,225.34415094339627,207.292157,214.2742039999999,215.931432,214.63249999999996,214.90301512726725,214.46258976175613,214.10538461538476,216.21969651119502,211.99107271957442,207.292157,214.2742039999999,215.931432,214.63249999999996,214.89666666666665,60146592,85775142.7,50.82544531759455,1.5,2.75,1.7849767031332084,0.7012123804954042,0.08010162551858269,-0.4836296528602304,-0.5637312783788131,9.565948583208458,0.6840650330318978,7527702192.0,2016-10-24,2016,0,298,10,0.39,214.9,214.98,213.98,4229
2016-10-25 13:30:00,214.68,214.98,213.98,214.17,209.9969230769231,225.4777358490566,207.402457,214.31310399999992,215.833032,214.56249999999997,214.8742694360019,214.43472407016029,213.98153846153855,215.8649861374357,212.09809078564152,207.402457,214.31310399999992,215.833032,214.56249999999997,214.3766666666667,66542329,85177517.7,47.91212427931837,1.5,2.75,1.7289069386236935,0.7812193968174304,0.09200794713929317,-0.4487213444546967,-0.5407292915939899,6.1225452893080545,0.21524495812080835,7461159863.0,2016-10-25,2016,1,299,10,0.47,214.48,214.42,212.93,4230
2016-10-26 13:30:00,213.21,214.42,212.93,213.74,209.9223076923077,225.61132075471698,207.50285300000002,214.33700399999995,215.748632,214.41749999999996,214.82978828164886,214.3685598730022,213.88153846153858,215.66496379415955,212.0981131289177,207.50285300000002,214.33700399999995,215.748632,214.41749999999996,213.6966666666667,75705478,84592240.85,46.208591381666004,1.5,2.75,1.7118421572934284,0.8949458867538678,0.07213552053614136,-0.4505598909238131,-0.5226954114599545,6.226477691752657,0.3427069151683105,7385454385.0,2016-10-26,2016,2,300,10,0.7,213.68,214.62,213.08,4231
2016-10-27 13:30:00,214.58,214.62,213.08,213.17,209.8476923076923,225.7449056603773,207.624553,214.35190399999996,215.644632,214.34199999999996,214.7646985451136,214.25441131366864,213.65153846153862,214.88743355668788,212.4156433663893,207.624553,214.35190399999996,215.644632,214.34199999999996,213.6233333333333,77220213,82049720.75,43.976476165123465,1.5,2.75,1.6995677174867545,0.9411392542734522,0.024287651265789908,-0.4923358473777171,-0.516623498643507,6.1174397367828135,0.02346096096095296,7308234172.0,2016-10-27,2016,3,301,10,0.72,213.85,213.93,211.71,4232
2016-10-28 13:30:00,213.14,213.93,211.71,212.54,209.7730769230769,225.87849056603773,207.72760300000002,214.35360399999996,215.518232,214.1539999999999,214.6774554649131,214.0911340457002,213.5830769230771,214.9519256164386,212.2142282297156,207.72760300000002,214.35360399999996,215.518232,214.1539999999999,212.72666666666663,140623183,83220734.2,41.585443063947636,1.5,2.75,1.736741451951986,1.689761384008554,-0.042470835421105635,-0.569712042919889,-0.5272412074987833,6.3460824033898735,0.07533666070251276,7167610989.0,2016-10-28,2016,4,302,10,1.05,212.82,213.19,212.36,4233
2016-10-31 13:30:00,212.93,213.19,212.36,212.55,209.69846153846157,226.01207547169813,207.851303,214.35830399999992,215.398432,213.99249999999992,214.5940258388381,213.94435937468108,213.49384615384636,214.96535063687742,212.02234167081528,207.851303,214.35830399999992,215.398432,213.99249999999992,212.7,61272507,82108756.7,41.63968396944085,1.5,2.75,1.671974205383986,0.7462359614562281,-0.07664243609169097,-0.6230442526133969,-0.5464018165217059,6.008775716605912,-0.5427916335220611,7228883496.0,2016-10-31,2016,0,305,10,0.39,212.78,212.99,209.6,4234
2016-11-01 13:30:00,212.93,212.99,209.6,211.01,209.62384615384616,226.14566037735847,207.966053,214.36770399999992,215.24803199999997,213.8089999999999,214.45347580594242,213.66489657709243,213.34000000000012,215.31406258173948,211.3659374182608,207.966053,214.36770399999992,215.24803199999997,213.8089999999999,211.2,122781818,82250445.0,36.083020078108895,1.5,2.75,1.7946903335708448,1.4927799843514524,-0.18734057144944427,-0.7805775308335114,-0.5932369593840672,5.9416864263195395,-1.5260406944185223,7106101678.0,2016-11-01,2016,1,306,11,1.62,211.3,211.1,209.23,4235
2016-11-02 13:30:00,210.65,211.1,209.23,209.74,209.5492307692308,226.27924528301884,208.086503,214.38061199999996,215.06343199999995,213.5144999999999,214.2686336174741,213.2910969030836,213.08000000000013,215.83668697473823,210.323313025262,208.086503,214.38061199999996,215.06343199999995,213.5144999999999,210.0233333333333,103330806,83776187.15,32.25974680051456,1.5,2.75,1.8000695954586423,1.233415001508576,-0.32254332072013003,-0.9964161102842296,-0.6738727895640997,5.931070007942027,-1.9356648587993204,7002770872.0,2016-11-02,2016,2,307,11,0.89,210.16,210.24,208.46,4236
2016-11-03 13:30:00,209.99,210.24,208.46,208.78,209.4746153846154,226.41283018867924,208.196953,214.38801199999992,214.88203199999995,213.16449999999992,214.05339308345555,212.86146862659947,212.8030769230771,216.38512090005173,209.2210329461024,208.196953,214.38801199999992,214.88203199999995,213.16449999999992,209.16,88939346,85076785.65,29.69813218345145,1.5,2.75,1.7986360529258822,1.0454008731111482,-0.4454989184742437,-1.2307464376569044,-0.7852475191826607,6.088060115668743,-2.430133657351149,6913831526.0,2016-11-03,2016,3,308,11,0.85,209.35,209.89,208.38,4237
2016-11-04 13:30:00,208.91,209.89,208.38,208.55,208.38,226.5464150943396,208.28710300000003,214.39601199999993,214.69903199999996,212.83999999999992,213.83757374684944,212.4508525669233,212.40615384615398,216.59106842818846,208.2212392641195,208.28710300000003,214.39601199999993,214.69903199999996,212.83999999999992,208.94,109122059,86043475.85,29.101899927258273,1.5,2.75,1.7780191920026045,1.2682200239124812,-0.5067304265784974,-1.4186605524057825,-0.911930125827285,5.879863196838808,-2.950346689003665,6804709467.0,2016-11-04,2016,4,309,11,0.72,209.14,213.19,211.3,4238
2016-11-07 14:30:00,211.45,213.19,211.3,213.15,208.2792307692308,226.68,208.41465300000004,214.44381199999992,214.6162319999999,212.68949999999992,213.8106100705024,212.51743803674015,212.31923076923093,216.39024244870384,208.24821908975804,208.41465300000004,214.44381199999992,214.6162319999999,212.68949999999992,212.54666666666668,109794861,88940467.75,50.50450654551774,1.5,2.75,1.982446392573846,1.2344758665832405,-0.21667035686694855,-1.1827680719109708,-0.9660977150440222,14.947913400836134,-0.4762571788765849,6914504328.0,2016-11-07,2016,0,312,11,0.89,212.24,214.77,212.38,4239
2016-11-08 14:30:00,212.69,214.77,212.38,214.11,208.17846153846156,226.81358490566035,208.53420300000005,214.5197119999999,214.53121599999992,212.72349999999992,213.82235085205133,212.6691106046697,212.33692307692326,216.43680963904316,208.23703651480326,208.53420300000005,214.5197119999999,214.53121599999992,212.72349999999992,213.75333333333333,106772138,87760706.0,53.649261533078544,1.5,2.75,2.011557364532858,1.216628065868112,0.04656457928984459,-0.9078919909317164,-0.9544565702215609,15.136356541868247,0.1731075138018174,7021276466.0,2016-11-08,2016,1,313,11,1.13,213.58,217.1,212.34,4240
2016-11-09 14:30:00,212.37,217.1,212.34,216.3792,208.0776923076923,226.94716981132072,208.67544900000007,214.60500399999992,214.49879999999993,212.85695999999993,213.92261944608848,213.02245245184398,212.52147692307705,217.0898294718589,207.9531243742952,208.67544900000007,214.60500399999992,214.49879999999993,212.85695999999993,215.2730666666667,258428972,96988848.75,60.1021847359072,1.5,2.75,2.207874695637653,2.664522523265852,0.3626307864700905,-0.5011680871339479,-0.8637988736040384,16.208289190700807,1.5054651217338322,7279705438.0,2016-11-09,2016,2,314,11,2.24,214.72,218.31,215.22,4241
2016-11-10 14:30:00,217.3,218.31,215.22,216.92,207.9769230769231,227.08075471698112,208.81449900000007,214.68980399999992,214.4895999999999,213.05245999999988,214.040163781536,213.39364745643027,212.6776307692309,217.67754177357327,207.67771976488862,208.81449900000007,214.68980399999992,214.4895999999999,213.05245999999988,216.81666666666663,172113313,100526666.4,61.478603098140276,1.5,2.75,2.2708836459492496,1.7121159903498002,0.5841129389035461,-0.13365769997460575,-0.7177706388781518,16.024274991632126,2.0607885574480083,7451818751.0,2016-11-10,2016,3,315,11,1.44,216.76,216.7,215.32,4242
2016-11-11 14:30:00,216.08,216.7,215.32,216.42,207.87615384615384,227.2143396226415,208.92799500000004,214.77300399999996,214.47019999999992,213.21745999999993,214.13349069206402,213.6818715081988,212.85070769230785,218.18955937316872,207.51185601144695,208.92799500000004,214.77300399999996,214.47019999999992,213.21745999999993,216.14666666666665,100552732,100886991.15,59.43697767465753,1.5,2.75,2.2229633855243027,0.996686796323393,0.6669484417637832,0.11591491332657712,-0.5510335284372061,15.958633367604461,1.820748059280158,7351266019.0,2016-11-11,2016,4,316,11,0.64,216.01,217.27,215.72,4243
2016-11-14 14:30:00,217.03,217.27,215.72,216.59,207.7753846153846,227.34792452830186,209.042695,214.83080399999992,214.43459999999996,213.42795999999993,214.22982439041442,213.9588361264656,213.06993846153858,218.75940253228012,207.38047439079708,209.042695,214.83080399999992,214.43459999999996,213.42795999999993,216.52666666666667,94579982,102702206.55,59.924278364198884,1.5,2.75,2.174894572272568,0.9209147999556784,0.6997782611136392,0.3236892979548429,-0.37608896315879625,15.93447513873558,2.644424434860913,7445846001.0,2016-11-14,2016,0,319,11,0.72,216.5,218.28,216.8,4244
2016-11-15 14:30:00,217.04,218.28,216.8,218.28,207.67461538461535,227.48150943396226,209.183295,214.98230399999989,214.41958399999996,213.6564599999999,214.38865480647664,214.37037554299272,213.46301538461555,219.79555917865056,207.13047159058053,209.183295,214.98230399999989,214.41958399999996,213.6564599999999,217.78666666666663,91652580,103441352.75,64.49121511487255,1.5,2.75,2.14025924568167,0.8860342364383861,0.7949524062264144,0.6176015446242218,-0.17735086160219266,15.09032061129515,4.071707828740341,7537498581.0,2016-11-15,2016,1,320,11,0.68,217.54,218.14,217.42,4245
2016-11-16 14:30:00,217.56,218.14,217.42,217.87,207.57384615384612,227.6150943396226,209.316145,215.16500399999993,214.39678399999997,213.83595999999991,214.52517814739915,214.70367311032672,213.87301538461554,220.5918263241973,207.15420444503377,209.316145,215.16500399999993,214.39678399999997,213.83595999999991,217.81,65617697,103396276.4,62.62662036619238,1.5,2.75,2.0488121567044093,0.6346234050649042,0.7883846296092427,0.8081299254093608,0.01974529580011805,14.310721422872145,4.353865312769424,7471880884.0,2016-11-16,2016,2,321,11,0.33,217.78,219.06,217.92,4246
2016-11-17 14:30:00,218.05,219.06,217.92,218.99,207.47307692307686,227.748679245283,209.453095,215.32290699999993,214.40638399999992,214.0914599999999,214.70026920044228,215.11189471886703,214.36840000000012,221.55718937832555,207.1796106216748,209.453095,215.32290699999993,214.40638399999992,214.0914599999999,218.65666666666667,69797191,103204144.45,65.55625282686457,1.5,2.75,1.9874684312255224,0.6763022102645802,0.8142354188196486,1.0375395693246787,0.2233041505050302,13.277626194304357,5.005993766482856,7541678075.0,2016-11-17,2016,3,322,11,0.52,218.49,219.27,218.29,4247
2016-11-18 14:30:00,219.07,219.27,218.29,218.5,207.37230769230771,227.88226415094337,209.605845,215.4413069999999,214.51078399999992,214.31745999999993,214.8492782514053,215.43457141230823,214.94455384615398,222.16485912526386,207.7242485670441,209.605845,215.4413069999999,214.51078399999992,214.31745999999993,218.68666666666664,86265751,103062977.4,63.22130612711845,1.5,2.75,1.9155064004237008,0.8370197832068453,0.7544481499831471,1.166364337983964,0.411916188000817,13.47597319389325,2.509969505043394,7455412324.0,2016-11-18,2016,4,323,11,0.45,218.78,220.18,219.0,4248
2016-11-21 14:30:00,219.17,220.18,219.0,220.15,207.27153846153846,228.01584905660374,209.77949500000003,215.54805699999997,214.58698399999992,214.58045999999985,215.0571496925267,215.8836598492313,215.74532307692317,222.7859722664439,208.7046738874025,209.77949500000003,215.54805699999997,214.58698399999992,214.58045999999985,219.77666666666667,72402638,103675779.7,67.42833383493054,1.5,2.75,1.898684514679151,0.6983563394411588,0.7789690135007501,1.3856274548767544,0.6066584413760044,8.348483880742632,2.820979870160194,7527814962.0,2016-11-21,2016,0,326,11,0.54,219.59,220.79,219.73,4249
2016-11-22 14:30:00,220.51,220.79,219.73,220.58,207.1707692307692,228.14943396226414,209.955245,215.65464899999995,214.73398399999994,214.90095999999986,215.27373205752562,216.3309303397807,216.65301538461551,222.86101306591857,210.4450177033124,209.955245,215.65464899999995,214.73398399999994,214.90095999999986,220.36666666666667,67428957,103720111.1,68.44146369904779,1.5,2.75,1.8387784779163543,0.6501049438231851,0.7754141790650189,1.5759261652072782,0.8005119861422592,8.33531724791472,1.941406567729253,7595243919.0,2016-11-22,2016,1,327,11,0.48,220.26,220.76,219.75,4250
2016-11-23 14:30:00,219.98,220.76,219.75,220.7,207.07,228.2830188679245,210.13239500000003,215.777549,214.88498399999992,215.24895999999984,215.48652687879917,216.74703221218255,217.58763076923088,222.04654280165897,213.12871873680274,210.13239500000003,215.777549,214.88498399999992,215.24895999999984,220.4033333333333,56620237,102765849.05,68.73374329974042,1.5,2.75,1.7795800152080428,0.5509635498895341,0.7328975898162714,1.7166339734125984,0.983736383596327,6.862811421682523,1.74257790890651,7651864156.0,2016-11-23,2016,2,328,11,0.46,220.26,221.56,221.01,4251
2016-11-25 14:30:00,221.1,221.56,221.01,221.52,206.9692307692308,228.41660377358485,210.325695,215.896149,215.00978399999997,215.66645999999986,215.72313366786582,217.2016005729271,218.23147692307703,222.34517382984444,214.11778001630955,210.325695,215.896149,215.00978399999997,215.66645999999986,221.36333333333332,37872255,100798451.15,70.72873216633718,1.5,2.75,1.7138957284074692,0.37572258866995495,0.7111912601443207,1.872725458776728,1.161534198632407,6.931115295762236,2.3565289714444244,7689736411.0,2016-11-25,2016,4,330,11,0.25,221.28,221.48,220.36,4252
2016-11-28 14:30:00,221.16,221.48,220.36,220.48,206.86846153846156,228.55018867924525,210.49494500000003,216.005689,215.1519839999999,216.06345999999985,215.90967744559657,217.5138290897912,218.72147692307698,222.22734524665285,215.21560859950108,210.49494500000003,216.005689,215.1519839999999,216.06345999999985,220.7733333333333,76572511,97595917.55,65.05883671279128,1.5,2.75,1.6743317478069353,0.7845872339974738,0.5833444762408609,1.8907147939334836,1.3073703176926224,7.592332311825098,1.7960201301999106,7613163900.0,2016-11-28,2016,0,333,11,0.51,220.92,221.44,220.17,4253
2016-11-29 14:30:00,220.52,221.44,220.17,220.91,206.7676923076923,228.6837735849056,210.65059500000007,216.08828899999992,215.30198399999992,216.48145999999986,216.10576852616143,217.83727393838245,219.07000000000005,222.47453995533328,215.66546004466687,210.65059500000007,216.08828899999992,215.30198399999992,216.48145999999986,220.84,69886690,98026626.7,66.26305369472135,1.5,2.75,1.6454509086778693,0.7129357844158071,0.4881552573286005,1.9175643893533727,1.4294091320247726,7.561515615109569,1.2048744731537453,7683050590.0,2016-11-29,2016,1,334,11,0.58,220.8,221.82,220.31,4254
2016-11-30 14:30:00,221.63,221.82,220.31,220.38,206.6669230769231,228.817358490566,210.78809500000008,216.15808899999996,215.44118399999988,216.94995999999983,216.2733854467041,218.07943832520317,219.3361538461539,222.56311277137527,216.10919492093254,210.78809500000008,216.15808899999996,215.44118399999988,216.94995999999983,220.83666666666667,113291793,97552125.45,63.36434588255579,1.5,2.75,1.6357758437723064,1.1613462287714815,0.35604758177867124,1.874468609248112,1.5184210274694403,6.9370292206582045,1.1520631569284394,7569758797.0,2016-11-30,2016,2,335,11,0.69,221.06,220.73,219.15,4255
2016-12-01 14:30:00,220.73,220.73,219.15,219.57,206.56615384615384,228.95094339622642,210.92549500000007,216.20428899999993,215.51618399999992,217.44145999999984,216.40266444879418,218.22139657994572,219.5784615384616,222.33139391797482,216.82552915894843,210.92549500000007,216.20428899999993,215.51618399999992,217.44145999999984,219.8166666666667,79040487,96337609.5,59.10858342840875,1.5,2.75,1.6317918549314263,0.8204530651136823,0.18904498515868484,1.7547272589177965,1.5656822737591116,7.274769494479343,0.2648522763596439,7490718310.0,2016-12-01,2016,3,336,12,0.72,219.94,220.25,219.26,4256
2016-12-02 14:30:00,219.67,220.25,219.26,219.68,206.4653846153846,229.08452830188682,211.0638950000001,216.25188899999995,215.56618399999988,217.98645999999985,216.53118741158653,218.36031119137948,219.8161538461539,221.9627438210993,217.66956387120845,211.0638950000001,216.25188899999995,215.56618399999988,217.98645999999985,219.73,74840347,95632659.55,59.50633495810553,1.5,2.75,1.5859495795791825,0.7825814669607817,0.06720685906368297,1.649690847588715,1.5824839885250324,6.727652211829509,0.5400457665903922,7565558657.0,2016-12-02,2016,4,337,12,0.45,219.76,221.4,220.42,4257
2016-12-05 14:30:00,220.65,221.4,220.42,221.0,206.36461538461538,229.21811320754716,211.19499500000006,216.30068899999995,215.66638399999988,218.60895999999985,216.70643496407328,218.61171012553382,220.02538461538464,222.05956357102505,217.99120565974425,211.19499500000006,216.30068899999995,215.66638399999988,218.60895999999985,220.94,67837821,93568447.65,64.02810941262271,1.5,2.75,1.5955246096092406,0.7250074432542966,0.057130099203420937,1.6538966125293086,1.5967665133258877,7.222632308033424,0.3861003861003835,7633396478.0,2016-12-05,2016,0,340,12,0.44,220.91,221.7441,220.662,4258
2016-12-06 14:30:00,221.22,221.7441,220.662,221.7,206.26384615384612,229.35169811320756,211.34189500000008,216.35938899999996,215.81558399999992,219.03645999999983,216.90226104391363,218.905832970721,220.32,222.1155843273981,218.5244156726019,211.34189500000008,216.35938899999996,215.81558399999992,219.03645999999983,221.3687,59877377,91072573.45,66.18458863020514,1.5,2.75,1.5588514232085804,0.6574688156020257,0.07793427630529193,1.6941843587075027,1.6162500824022108,6.1714019348018,0.5077522894187941,7693273855.0,2016-12-06,2016,1,341,12,0.49,221.2,224.67,221.38,4259
2016-12-07 14:30:00,221.52,224.67,221.38,224.6,206.16307692307686,229.4852830188679,211.4988950000001,216.44129699999996,215.99618399999991,219.56095999999988,217.20413315983856,219.44813459255715,220.7515384615385,223.50315165161769,217.99992527145932,211.4988950000001,216.44129699999996,215.99618399999991,219.56095999999988,223.55,110738050,91270869.05,73.32043380088388,1.5,2.75,1.6825048929793955,1.2132901894396941,0.2572246695095881,1.9377809192891962,1.6805562497796078,9.393278428754268,1.7671046669687385,7804011905.0,2016-12-07,2016,2,342,12,1.49,223.02,225.7,224.26,4260
2016-12-08 14:30:00,224.57,225.7,224.26,225.15,206.0623076923077,229.61886792452827,211.64694500000007,216.530897,216.16638399999997,219.99949999999984,217.5157357810214,219.99116939326598,221.26307692307697,224.56725967656877,217.9588941695852,211.64694500000007,216.530897,216.16638399999997,219.99949999999984,225.03666666666663,99714387,83335139.8,74.42281759221027,1.5,2.75,1.6651831149094387,1.1965467057391317,0.3758946768790152,2.150424595878377,1.7745299189993615,9.36320153802565,1.6386782231852632,7903726292.0,2016-12-08,2016,3,343,12,0.64,224.98,226.53,225.37,4261
2016-12-09 14:30:00,225.41,226.53,225.37,226.51,205.96153846153842,229.75245283018864,211.80404900000008,216.625147,216.40298399999992,220.4789999999999,217.86845202490287,220.6120104034312,221.7523076923077,226.00081985790302,217.50379552671242,211.80404900000008,216.625147,216.40298399999992,220.4789999999999,226.13666666666663,88005766,79129762.45,76.9581362986635,1.5,2.75,1.6448128924159071,1.1121702286874489,0.5011836906280347,2.4010095322844047,1.8998258416563705,9.608335871092509,2.734941944847606,7991732058.0,2016-12-09,2016,4,344,12,0.51,225.95,226.96,225.76,4262
2016-12-12 14:30:00,226.4,226.96,225.76,226.25,205.8607692307692,229.88603773584904,211.9674990000001,216.724997,216.60198399999996,220.97049999999984,218.19714018078903,221.14896179358055,222.18846153846158,226.99371408863308,217.38320898829,211.9674990000001,216.724997,216.60198399999996,220.97049999999984,226.3233333333333,102016125,79202932.1,75.41899071936828,1.5,2.75,1.6130405429576293,1.288034701432474,0.5195265978187269,2.5492340889297798,2.0297074911110524,8.858426491299339,2.4172740029876434,7889715933.0,2016-12-12,2016,0,347,12,0.53,226.36,228.34,227.0,4263
2016-12-13 14:30:00,227.02,228.34,227.0,227.76,205.76,228.34,212.11574900000008,216.83019699999997,216.84158399999995,221.52899999999985,218.57215429134632,221.77858447990624,222.7315384615385,228.27954903305545,217.1835278900215,212.11574900000008,216.83019699999997,216.84158399999995,221.52899999999985,227.7,110477485,79997807.25,78.15191062498859,1.5,2.75,1.6471090756035132,1.3810064150227068,0.5816493505552685,2.756769179305138,2.1751198287498696,9.141051194026788,3.3487612306016863,8000193418.0,2016-12-13,2016,1,348,12,0.59,227.67,228.23,225.365,4264
2016-12-14 14:30:00,227.41,228.23,225.365,225.88,205.65923076923082,228.45205128205131,212.25014900000008,216.92249699999996,217.06558399999992,221.90899999999988,218.85873647599945,222.16919548181994,223.0669230769231,228.80529799891534,217.32854815493093,212.25014900000008,216.92249699999996,217.06558399999992,221.90899999999988,226.49166666666667,142501812,82540268.85,68.01313377882374,1.5,2.75,1.7341012844889752,1.7264519971332757,0.4502883081046103,2.7379802138806326,2.2876919057760223,10.880527255706847,2.8737987885412406,7857691606.0,2016-12-14,2016,2,349,12,1.27,226.8,227.81,225.8904,4265
2016-12-15 14:30:00,226.16,227.81,225.8904,226.81,205.55846153846156,228.56410256410254,212.38532400000008,217.02309699999995,217.28918399999992,222.35599999999994,219.17055073184258,222.61117686450373,223.55384615384617,229.4046924487621,217.70299985893024,212.38532400000008,217.02309699999995,217.28918399999992,222.35599999999994,226.8368,124972554,85508011.7,70.08091262977659,1.5,2.75,1.74809404988262,1.4615303468692395,0.38284287133324657,2.7662454949425808,2.3834026236093337,10.16677985365507,3.2456300072833186,7982664160.0,2016-12-15,2016,3,350,12,0.85,226.85,226.08,224.67,4266
2016-12-16 14:30:00,226.01,226.08,224.67,225.04,205.4576923076923,228.67615384615382,212.5083740000001,217.10829699999996,217.47438399999996,222.65849999999992,219.4007252129468,222.84249335359863,223.87153846153848,229.5599063288549,218.18317059422202,212.5083740000001,217.10829699999996,217.47438399999996,222.65849999999992,225.2633333333333,156420152,89839159.75,61.881741956170394,1.5,2.75,1.7760873320338626,1.7411132565718368,0.1858138305418331,2.6156699117866253,2.429856081244792,11.95321884052902,1.8280542986425303,7826244008.0,2016-12-16,2016,4,351,12,0.63,225.38,226.02,225.08,4267
2016-12-19 14:30:00,225.25,226.02,225.08,225.53,205.3569230769231,228.78820512820513,212.63307400000008,217.19589699999997,217.68418399999993,223.00999999999993,219.64108893008608,223.09844636754158,224.2676923076924,229.63658936585585,218.89879524952886,212.63307400000008,217.19589699999997,217.68418399999993,223.00999999999993,225.5433333333333,90341147,90042929.55,63.16649805034521,1.5,2.75,1.7192239511743022,1.0033119474398529,0.06169729801745305,2.506977703766609,2.4452804057491555,11.734134891122904,1.7275597654488104,7916585155.0,2016-12-19,2016,0,354,12,0.42,225.55,226.57,225.88,4268
2016-12-20 14:30:00,226.15,226.57,225.88,226.4,205.25615384615384,228.90025641025642,212.77307400000007,217.288697,217.88898399999994,223.32249999999993,219.9061442661612,223.41288004682337,224.79307692307697,229.51850655507155,220.0676472910824,212.77307400000007,217.288697,217.88898399999994,223.32249999999993,226.28333333333333,89838810,90914738.15,65.39654959988654,1.5,2.75,1.6707079546618515,0.9881655255034136,0.013897398481040657,2.462652153850456,2.448754755369416,11.764961066990026,0.8014247551202188,8006423965.0,2016-12-20,2016,1,355,12,0.31,226.22,226.45,225.77,4269
2016-12-21 14:30:00,226.25,226.45,225.77,225.77,205.1553846153846,229.0123076923077,212.90502400000008,217.376997,218.13578399999992,223.58199999999997,220.1360993929784,223.6373676614116,225.2615384615385,228.96307116820157,221.56000575487545,212.90502400000008,217.376997,218.13578399999992,223.58199999999997,225.99666666666667,67909039,90938742.25,62.44807800984521,1.5,2.75,1.599943100757432,0.7467558635604508,-0.07932113498689652,2.349603336635795,2.4289244716226914,9.730363385438226,0.275371974239398,7938514926.0,2016-12-21,2016,2,356,12,0.3,226.11,225.74,224.92,4270
2016-12-22 14:30:00,225.6,225.74,224.92,225.38,205.05461538461537,229.12435897435898,213.03422400000008,217.475305,218.36918399999993,223.81599999999997,220.34174255403803,223.80333264603908,225.5984615384616,228.36679729123185,222.8301257856913,213.03422400000008,217.475305,218.36918399999993,223.81599999999997,225.34666666666664,56219071,90918683.95,60.625825656921386,1.5,2.75,1.5463757364176172,0.6183445311517842,-0.18062349050934312,2.2031451084860123,2.3837685989953554,9.72290535399884,-0.4988742218886564,7882295855.0,2016-12-22,2016,3,357,12,0.36,225.33,225.72,225.21,4271
2016-12-23 14:30:00,225.43,225.72,225.21,225.71,204.95384615384614,229.2364102564103,213.14897400000007,217.570605,218.62318399999992,224.02549999999994,220.5522624538797,223.98492001308296,225.90692307692314,227.52266076719948,224.29118538664682,213.14897400000007,217.570605,218.62318399999992,224.02549999999994,225.54666666666665,36697822,90859962.3,61.64567907839072,1.5,2.75,1.4723488981020725,0.4038943124236802,-0.23532179679524126,2.089616353001304,2.3249381497965453,9.036579411326333,-0.2386740331491677,7918993677.0,2016-12-23,2016,4,358,12,0.23,225.46,226.73,226.0,4272
2016-12-27 14:30:00,226.02,226.73,226.0,226.27,204.85307692307688,229.34846153846158,213.26782400000005,217.669208,218.88618399999987,224.315,220.7764874556883,224.2025466785037,226.0353846153847,227.4705177452207,224.6002514855487,213.26782400000005,217.669208,218.88618399999987,224.315,226.33333333333331,42672487,89164961.1,63.37913828970919,1.5,2.75,1.4400382625233517,0.4785791018530485,-0.2427278036363143,2.0215283952511527,2.264256198887467,9.158394262918359,-0.6541974007727348,7961666164.0,2016-12-27,2016,1,362,12,0.32,226.36,226.59,224.27,4273
2016-12-28 14:30:00,226.57,226.59,224.27,224.4,204.7523076923077,229.46051282051286,213.37897400000008,217.73140800000002,219.12658399999992,224.4895,220.9185859868378,224.2213517567414,225.97769230769242,227.5988059579992,224.3565786573856,213.37897400000008,217.73140800000002,219.12658399999992,224.4895,225.08666666666667,64095014,88875377.3,54.518210728944226,1.5,2.75,1.5028926723431115,0.7211785305129726,-0.3746273755866474,1.7959719794041575,2.170599354990805,9.208770011072408,-0.6552151584912298,7897571150.0,2016-12-28,2016,2,363,12,1.03,225.43,224.89,223.84,4274
2016-12-29 14:30:00,224.48,224.89,223.84,224.35,204.65153846153842,229.5725641025641,213.4840240000001,217.794408,219.3393839999999,224.688,221.0531512422559,224.2336039703851,225.81153846153853,227.61309071789228,224.00998620518482,213.4840240000001,217.794408,219.3393839999999,224.688,224.36,48696080,85645591.65,54.29961449101633,1.5,2.75,1.470543195747174,0.568576608110804,-0.460640709074533,1.5947984686476389,2.055439177722172,8.131440642540966,-1.0846082624222952,7848875070.0,2016-12-29,2016,3,364,12,0.47,224.36,224.83,222.73,4275
2016-12-30 14:30:00,224.73,224.83,222.73,223.53,222.73,229.6846153846154,213.57852400000007,217.847908,219.5243839999999,224.886,221.15028256608903,224.16659406844363,225.60230769230782,227.75009587613602,223.45451950847956,213.57852400000007,217.847908,219.5243839999999,224.886,223.69666666666672,108998328,87143483.7,50.70864568508135,1.5,2.75,1.5155043960509489,1.2507914920550738,-0.5614741839721951,1.353596447756928,1.915070631729123,7.667667265528122,-0.6709918236757869,7739876742.0,2016-12-30,2016,4,365,12,0.94,223.78,225.83,223.8837,4276
2017-01-03 14:30:00,225.04,225.83,223.8837,225.24,223.1076315789473,229.79666666666668,213.68282400000007,217.923908,219.75158399999992,225.16399999999996,221.31066364192867,224.26882320478236,225.4084615384616,227.16076720465682,223.6561558722664,213.68282400000007,217.923908,219.75158399999992,225.16399999999996,224.98456666666667,91366522,87969792.45,57.08268031669907,1.5,2.75,1.5715397963330249,1.0386124538367034,-0.5035723763195625,1.28560516132967,1.7891775376492325,8.08111494502496,-0.12858599742827653,7831243264.0,2017-01-03,2017,1,3,1,0.87,224.86,226.75,225.61,4277
2017-01-04 14:30:00,225.62,226.75,225.61,226.58,223.48526315789474,229.908717948718,213.79237400000008,218.003208,220.00358399999996,225.44299999999996,221.51730428342162,224.48893528051732,225.46230769230775,227.30970342842616,223.6149119561894,213.79237400000008,218.003208,220.00358399999996,225.44299999999996,226.31333333333336,78744433,88515123.05,61.30535746678764,1.5,2.75,1.5671440965949508,0.889615585299692,-0.3716784695179245,1.3245794507518271,1.6962579202697514,8.698336598989384,0.0795053003533599,7909987697.0,2017-01-04,2017,2,4,1,0.51,226.18,226.58,225.48,4278
2017-01-05 14:30:00,226.27,226.58,225.48,226.4,223.86289473684207,230.02076923076925,213.90157400000007,218.082608,220.23378399999996,225.67799999999997,221.70878254681688,224.67094144427762,225.4307692307693,227.19728621296204,223.66425224857662,213.90157400000007,218.082608,220.23378399999996,225.67799999999997,226.1533333333333,78379012,89440204.8,60.44502123755373,1.5,2.75,1.5337766611238846,0.8763286284424966,-0.2964775635617174,1.3256609658176046,1.6221385293793216,8.44206299539232,0.2790450458431126,7831608685.0,2017-01-05,2017,3,5,1,0.49,226.03,227.75,225.9,4279
2017-01-06 14:30:00,226.53,227.75,225.9,227.21,224.24052631578945,230.13282051282056,214.0215780000001,218.16380800000002,220.49458399999992,225.80849999999992,221.92451656458883,224.91275654482257,225.59769230769243,227.58167670348567,223.61370791189916,214.0215780000001,218.16380800000002,220.49458399999992,225.80849999999992,226.95333333333332,71559922,87481298.4,62.96381834155758,1.5,2.75,1.5563640424721783,0.8180025137807053,-0.19689766844521284,1.376016443822806,1.5729141122680188,8.462517183418232,0.8119620197000676,7903168607.0,2017-01-06,2017,4,6,1,0.82,226.82,227.0701,226.4163,4280
2017-01-09 14:30:00,226.91,227.0701,226.4163,226.46,224.61815789473687,230.2448717948718,214.13827800000007,218.248808,220.74898399999992,225.87399999999997,222.1023786600951,225.06011306436332,225.6692307692309,227.70469271320016,223.63376882526163,214.13827800000007,218.248808,220.74898399999992,225.87399999999997,226.6488,46939676,84842562.85,59.20451162607112,1.5,2.75,1.5018880394384515,0.55325622450831,-0.18636442381341206,1.3399585825012537,1.5263230063146658,8.669180271994518,0.33228479021753576,7856228931.0,2017-01-09,2017,0,9,1,0.29,226.74,227.45,226.01,4281
2017-01-10 14:30:00,226.48,227.45,226.01,226.46,224.9957894736842,230.3569230769231,214.2543780000001,218.329708,221.01478399999988,225.8714999999999,222.27326577146388,225.19343562966202,225.67384615384626,227.7161757205608,223.6315165871317,214.2543780000001,218.329708,221.01478399999988,225.8714999999999,226.64,63771939,83630871.5,59.20451162607112,1.5,2.75,1.4974674651928477,0.7625406486407355,-0.18390805459132187,1.296437938075513,1.4803459926668352,8.649033213011318,0.08397047774782239,7856228931.0,2017-01-10,2017,1,10,1,0.64,226.73,227.1,225.59,4282
2017-01-11 14:30:00,226.36,227.1,225.59,227.1,225.3734210526316,230.4689743589744,214.36427400000008,218.412108,221.30598399999988,225.91399999999996,222.46254946670058,225.37501318874183,225.776153846154,227.95611204560973,223.5961956466981,214.36427400000008,218.412108,221.30598399999988,225.91399999999996,226.59666666666664,74650016,82262566.05,61.48057611790514,1.5,2.75,1.4983626462505006,0.9074603380914108,-0.14538041283402192,1.2986204766243077,1.4440008894583296,8.68238761989212,1.2032085561497274,7930878947.0,2017-01-11,2017,2,11,1,0.67,226.34,226.75,224.955,4283
2017-01-12 14:30:00,226.5,226.75,224.955,226.53,225.75105263157891,230.58102564102563,214.4668240000001,218.49200799999997,221.58558399999993,225.85249999999994,222.6220573307516,225.4850119326712,225.86461538461543,228.06631564204,223.66291512719098,214.4668240000001,218.49200799999997,221.58558399999993,225.85249999999994,226.07833333333332,72113181,80344350.85,58.3577313784179,1.5,2.75,1.544551028661178,0.8975513553483394,-0.16315170076427954,1.2400612635029802,1.4032129642672595,7.05571567704529,0.9716960106975738,7858765766.0,2017-01-12,2017,3,12,1,0.8,225.85,227.4,226.69,4284
2017-01-13 14:30:00,226.73,227.4,226.69,227.05,226.1286842105263,230.69307692307686,214.57447400000012,218.577208,221.90638399999992,225.91099999999992,222.7957021413104,225.63405841527398,225.9676923076924,228.25460697555238,223.68077763983246,214.57447400000012,218.577208,221.90638399999992,225.91099999999992,227.04666666666668,62717865,76355153.5,60.33702802379039,1.5,2.75,1.4963688123282366,0.8213966199413115,-0.14534535756270506,1.2215312673138785,1.3668766248765831,7.0510952169357015,1.5747326980718517,7921483631.0,2017-01-13,2017,4,13,1,0.31,227.04,226.78,225.8,4285
2017-01-17 14:30:00,226.31,226.78,225.8,226.25,226.5063157894737,230.80512820512817,214.67112400000016,218.650008,222.23658399999988,225.88299999999992,222.9311648024354,225.6927195185812,225.966153846154,228.25227973889687,223.680027953411,214.67112400000016,218.650008,222.23658399999988,225.88299999999992,226.27666666666667,61240814,73168566.5,55.93238071494329,1.5,2.75,1.4787710400190772,0.8369825586237226,-0.19008112712425707,1.129275215971262,1.319356343095519,7.0182239673244275,0.4484105842656681,7860242817.0,2017-01-17,2017,1,17,1,0.43,226.29,226.8,225.9,4286
2017-01-18 14:30:00,226.535,226.8,225.9,226.75,226.88394736842102,230.91717948717945,214.77362400000013,218.739008,222.59598399999987,225.96849999999992,223.0809230454772,225.79341289776397,226.14692307692317,228.27530107420972,224.01854507963662,214.77362400000013,218.739008,222.59598399999987,225.96849999999992,226.48333333333332,54793302,68087224.0,57.99624004513502,1.5,2.75,1.4374302514462864,0.8047515933385682,-0.18827576205975305,1.0840116405208278,1.2722874025805808,5.791875857972398,0.0750286874393095,7915036119.0,2017-01-18,2017,2,18,1,0.4,226.35,227.0,225.41,4287
2017-01-19 14:30:00,226.84,227.0,225.41,225.91,227.2615789473684,231.0292307692308,214.88222800000014,218.82110799999995,222.94318399999992,225.98749999999993,223.19186723977214,225.80451643131025,226.26692307692318,228.13672166112548,224.39712449272082,214.88222800000014,218.82110799999995,222.94318399999992,225.98749999999993,226.10666666666665,66608787,66900606.0,53.46589471097808,1.5,2.75,1.4483280906286946,0.9956380215748718,-0.24248050665284504,0.9691867692645246,1.2116672759173697,5.20008296759979,-0.21643109540636446,7848427332.0,2017-01-19,2017,3,19,1,0.71,226.2,227.31,225.9719,4288
2017-01-20 14:30:00,226.7,227.31,225.9719,226.74,227.63921052631576,231.14128205128205,214.9838280000002,218.915608,223.21498399999993,226.00449999999992,223.3310097009576,225.8936101045188,226.51384615384617,227.5219529387748,225.50573936891757,214.9838280000002,218.915608,223.21498399999993,226.00449999999992,226.67396666666664,129168623,68867096.65,57.037052411250976,1.5,2.75,1.4448760841552168,1.8756217305989769,-0.22182163990356016,0.9343902260379195,1.1562118659414795,5.653064617208044,-0.20685709255754536,7977595955.0,2017-01-20,2017,4,20,1,0.59,226.64,226.805,225.27,4289
2017-01-23 14:30:00,226.35,226.805,225.27,226.15,228.01684210526315,231.25333333333333,215.09482800000018,218.9935,223.45578399999988,226.0234999999999,223.44155834013569,225.9180281898027,226.58384615384625,227.31741649379367,225.85027581389875,215.09482800000018,218.9935,223.45578399999988,226.0234999999999,226.075,75061645,69224726.95,53.872148290583574,1.5,2.75,1.4513135067155585,1.084318397589577,-0.24543819008003465,0.8494141283414365,1.0948523184214711,5.391067503659574,-0.13688951691248002,7902534310.0,2017-01-23,2017,0,23,1,0.68,226.04,228.08,226.27,4290
2017-01-24 14:30:00,226.4,228.08,226.27,227.6,228.3944736842105,231.36538461538458,215.2103320000002,219.0895,223.68019999999993,226.13449999999992,223.60463448365982,226.07821598125003,226.66230769230773,227.57401459002526,225.7506007945903,215.2103320000002,219.0895,223.68019999999993,226.13449999999992,227.31666666666672,95555295,71191538.15,59.779011314102746,1.5,2.75,1.4855053990930192,1.342228268739829,-0.16482025777321296,0.8888269962049549,1.0536472539781678,6.313522281657167,0.5034001589684652,7998089605.0,2017-01-24,2017,1,24,1,0.8,227.18,229.57,228.51,4291
2017-01-25 14:30:00,228.7,229.57,228.51,229.57,228.77210526315787,231.47743589743592,215.3380815000002,219.2114,223.93319999999989,226.32749999999987,223.83857038626138,226.4107668401786,226.90615384615398,228.6876232216733,225.12468447063455,215.3380815000002,219.2114,223.93319999999989,226.32749999999987,229.21666666666664,84437712,73578532.65,66.12569645202643,1.5,2.75,1.5201121563006603,1.1475862450486092,0.010464547462699423,1.066727938306542,1.0562633908438426,7.816697622636307,1.0876265962131215,8082527317.0,2017-01-25,2017,2,25,1,0.46,229.04,229.71,229.01,4292
2017-01-26 14:30:00,229.4,229.71,229.01,229.33,229.14973684210528,231.58948717948718,215.45513150000028,219.3308,224.19139999999987,226.48049999999984,224.0539205671923,226.6887890458759,227.06923076923084,229.27071923822228,224.8677423002394,215.45513150000028,219.3308,224.19139999999987,226.48049999999984,229.35,59970719,74443444.25,64.78449205579031,1.5,2.75,1.4615327165649004,0.8055876458187922,0.0948351076561007,1.1748072754139685,1.0799721677578678,7.8675558954240135,1.2360393766830051,8022556598.0,2017-01-26,2017,3,26,1,0.31,229.36,229.59,228.76,4293
2017-01-27 14:30:00,229.42,229.59,228.76,228.97,229.52736842105259,231.70153846153846,215.5599775000002,219.4368,224.43899999999988,226.70899999999992,224.24670799592982,226.9060472319829,227.26230769230773,229.64870702498783,224.8759083596277,215.5599775000002,219.4368,224.43899999999988,226.70899999999992,229.10666666666665,59711118,74224249.45,62.7292144027576,1.5,2.75,1.4164232368102656,0.8044691383538133,0.10992526812575963,1.2173787529150673,1.1074534847893076,7.732384858305338,0.8456287161418135,7962845480.0,2017-01-27,2017,4,27,1,0.36,229.18,228.2,226.41,4294
2017-01-30 14:30:00,228.17,228.2,226.41,227.55,229.905,231.81358974358972,215.6576775000002,219.521992,224.62439999999984,226.86899999999986,224.37624885883457,226.96737606703218,227.3461538461539,229.69012205885718,225.0021856334507,215.6576775000002,219.521992,224.62439999999984,226.86899999999986,227.38666666666668,79737252,75776308.05,55.279583869961776,1.5,2.75,1.4981072913238185,1.0522715351529983,0.01290349951744596,1.123582859186115,1.110679359668669,8.718346527213155,0.574585635359121,7883108228.0,2017-01-30,2017,0,30,1,0.79,227.3,227.6,226.32,4295
2017-01-31 14:30:00,226.98,227.6,226.32,227.53,230.28263157894736,231.92564102564103,215.7564275000002,219.607192,224.81759999999986,227.06899999999987,224.4999253741744,227.0209592987434,227.37923076923087,229.72050539295967,225.03795614550202,215.7564275000002,219.607192,224.81759999999986,227.06899999999987,227.15,75880805,74120431.9,55.18018661626051,1.5,2.75,1.4825281990864028,1.0237501732636287,-0.05998649317737347,1.035696243196952,1.0956827363743256,8.395233084832148,0.3439911797133412,7807227423.0,2017-01-31,2017,1,31,1,0.57,226.96,228.59,226.94,4296
2017-02-01 14:30:00,228.255,228.59,226.94,227.62,230.66026315789472,232.0376923076923,215.8483315000002,219.69829199999998,224.99019999999985,227.18799999999987,224.62228124185384,227.07801079410117,227.46307692307698,229.75422892909316,225.17192491706075,215.8483315000002,219.69829199999998,224.99019999999985,227.18799999999987,227.71666666666667,79117651,73507988.35,55.56736304127696,1.5,2.75,1.4944904705802315,1.0763136466650431,-0.10677347800585467,0.9622158888670072,1.0689893668728618,8.329751055189858,0.7569386038688009,7886345074.0,2017-02-01,2017,2,32,2,0.73,227.76,228.1,226.82,4297
2017-02-02 14:30:00,227.2,228.1,226.82,227.77,231.03789473684208,232.14974358974357,215.93768150000014,219.843192,225.17559999999986,227.24749999999992,224.74572119315368,227.14391452799634,227.51846153846162,229.8017903655088,225.23513271141442,215.93768150000014,219.843192,225.17559999999986,227.24749999999992,227.56333333333333,69657560,73053644.7,56.245773147085295,1.5,2.75,1.4791697226816436,0.9535124535682474,-0.13067453396299045,0.9056461994191238,1.0363207333821145,7.911806746470416,0.4542647966834265,7956002634.0,2017-02-02,2017,3,33,2,0.56,227.46,229.55,228.46,4298
2017-02-03 14:30:00,228.82,229.55,228.46,229.34,231.41552631578946,232.2617948717949,216.03388150000015,219.97319199999998,225.35939999999988,227.39449999999997,224.92588898950058,227.35306552532998,227.75615384615392,230.1042272096996,225.40808048260826,216.03388150000015,219.97319199999998,225.35939999999988,227.39449999999997,229.11666666666667,80563168,73162852.5,62.67025769749461,1.5,2.75,1.5006575996329552,1.1011485370940124,-0.04805928391305248,0.9762466284907988,1.0243059124038512,8.52174545364756,1.4105682069422938,8036565802.0,2017-02-03,2017,4,34,2,0.48,229.0,229.326,228.54,4299
2017-02-06 14:30:00,228.87,229.326,228.54,228.93,231.79315789473682,232.37384615384616,216.13368150000016,220.130192,225.52639999999988,227.48049999999995,225.08291295069665,227.50324976101285,227.92384615384617,230.27191951739186,225.57577279030053,216.13368150000016,220.130192,225.52639999999988,227.48049999999995,228.932,57790108,72474361.8,60.184978018398674,1.5,2.75,1.4506106282306015,0.797386918141858,-0.029261942274039443,0.987728484561302,1.0169904268353414,8.40281702767413,0.5843585237258403,7978775694.0,2017-02-06,2017,0,37,2,0.34,228.93,229.6556,228.72,4300
2017-02-07 14:30:00,229.38,229.6556,228.72,228.94,232.1707894736842,232.48589743589744,216.23353150000014,220.288092,225.6911999999999,227.60449999999992,225.2341712663556,227.64008311710685,228.15692307692314,230.24641892501626,226.06742722883004,216.23353150000014,220.288092,225.6911999999999,227.60449999999992,229.1052,57931151,73023935.55,60.22640749387648,1.5,2.75,1.4138241547855583,0.7933172947154312,-0.024579704289561244,0.98626579647339,1.0108455007629509,7.7388247641564725,-0.2744261009713793,8036706845.0,2017-02-07,2017,1,38,2,0.41,229.19,229.39,228.31,4301
2017-02-08 14:30:00,228.61,229.39,228.31,229.24,232.5484210526316,232.59794871794875,216.33668150000014,220.42769200000004,225.84559999999988,227.74349999999993,225.39126258924358,227.79245615357289,228.34923076923084,230.33952199703725,226.35893954142443,216.33668150000014,220.42769200000004,225.84559999999988,227.74349999999993,228.98,51566218,72413649.5,61.520017248770806,1.5,2.75,1.3899795723008743,0.7121063274127621,-0.010426845847754995,0.9978119434532572,1.0082387893010123,5.8810914238431575,-0.03924475646448498,8088273063.0,2017-02-08,2017,2,39,2,0.47,228.85,230.95,229.52,4302
2017-02-09 14:30:00,229.56,230.95,229.52,230.6,232.9260526315789,232.71,216.44508550000015,220.599992,226.04799999999992,227.91849999999994,225.59552680143014,228.059841281804,228.69153846153856,230.57916368758103,226.80391323549603,216.44508550000015,220.599992,226.04799999999992,227.91849999999994,230.35666666666668,65955245,71978910.95,66.7928333061124,1.5,2.75,1.4128381742793816,0.916313460838768,0.07659058633184257,1.1039770222158154,1.0273864358839728,6.7765080360869385,0.7118836528802879,8154228308.0,2017-02-09,2017,3,40,2,0.62,230.24,231.77,230.6216,4303
2017-02-10 14:30:00,231.0,231.77,230.6216,231.51,233.3036842105263,232.82205128205132,216.5558855000002,220.780992,226.25999999999988,228.16749999999996,225.82746692686425,228.3884278263941,228.99230769230775,231.2898937679636,226.694721616652,216.5558855000002,220.780992,226.25999999999988,228.16749999999996,231.30053333333333,66015892,71674046.5,69.77705886164652,1.5,2.75,1.395492590402284,0.92105713607226,0.17582400996764955,1.2471664483435347,1.0713424383758852,6.8813375618592145,1.7402768622280729,8220244200.0,2017-02-10,2017,4,41,2,0.5,231.2,233.07,232.05,4304
2017-02-13 14:30:00,232.08,233.07,232.05,232.77,233.6813157894737,232.93410256410255,216.68249800000012,220.97449200000003,226.50779999999992,228.45349999999996,226.09972312581073,228.80572041435659,229.23846153846162,232.29213369005126,226.18478938687187,216.68249800000012,220.97449200000003,226.50779999999992,228.45349999999996,232.63,55182050,71297255.75,73.34844067556418,1.5,2.75,1.407243119659264,0.7739715844533048,0.29944764419463565,1.4456519936191796,1.146204349424544,5.444824528509059,2.3029930119105213,8275426250.0,2017-02-13,2017,0,44,2,0.44,232.56,233.71,232.16,4305
2017-02-14 14:30:00,232.56,233.71,232.16,233.7,234.05894736842103,233.04615384615383,216.8193440000001,221.15329200000005,226.79039999999995,228.82599999999996,226.3977731993084,229.27184227965594,229.57461538461544,233.4469600560425,225.70227071318837,216.8193440000001,221.15329200000005,226.79039999999995,228.82599999999996,233.19,71108983,71790664.2,75.63683253758441,1.5,2.75,1.4174400396836029,0.9905045982288042,0.4101357039057401,1.658873979306719,1.248738275400979,5.3002726773283015,2.671118530884801,8346535233.0,2017-02-14,2017,1,45,2,0.67,232.94,235.14,233.39,4306
2017-02-15 14:30:00,233.45,235.14,233.39,234.92,234.4365789473684,233.15820512820514,216.95409400000008,221.33069200000003,227.09519999999992,229.23449999999997,226.73197817188446,229.80976206254584,230.03230769230774,234.81105006851104,225.2535653161045,216.95409400000008,221.33069200000003,227.09519999999992,229.23449999999997,234.4833333333333,86785826,73390290.4,78.27243764992247,1.5,2.75,1.4411943225633457,1.1825246299883831,0.5244858853966112,1.9043456321467431,1.3798597467501321,5.262015773622132,3.1391315801027253,8433321059.0,2017-02-15,2017,2,46,2,0.75,234.26,235.155,233.85,4307
2017-02-16 14:30:00,234.96,235.155,233.85,234.72,234.81421052631578,233.27025641025642,217.09689800000007,221.517992,227.36959999999993,229.67499999999995,227.04523392984984,230.27740377087483,230.58384615384617,235.7302058139779,225.4374864937145,217.09689800000007,221.517992,227.36959999999993,229.67499999999995,234.575,84722437,74295972.9,76.80555931138363,1.5,2.75,1.4314661566659643,1.1403368674374004,0.5433204963569975,2.059010367196379,1.5156898708393811,5.5850444189357225,2.3458620388942157,8348598622.0,2017-02-16,2017,3,47,2,0.56,234.5,235.09,233.93,4308
2017-02-17 14:30:00,233.95,235.09,233.93,235.09,235.19184210526313,233.3823076923077,217.2472980000001,221.72649199999998,227.63739999999993,230.0925,227.36071495220867,230.73574626888671,231.16538461538462,236.50491277306992,225.8258564576994,217.2472980000001,221.72649199999998,227.63739999999993,230.0925,234.70333333333332,77204104,71697746.95,77.64040383630805,1.5,2.75,1.4120757169041094,1.0767995827517425,0.5364381877861317,2.186237605572046,1.6497994177859143,5.046609616762835,2.6907788406936604,8425802726.0,2017-02-17,2017,4,48,2,0.5,234.51,236.69,235.51,4309
2017-02-21 14:30:00,235.52,236.69,235.51,236.49,235.56947368421046,233.49435897435902,217.4048980000001,221.935692,227.87519999999992,230.6095,227.71872613055345,231.28377043375463,231.84769230769237,237.46056297782872,226.234821637556,217.4048980000001,221.935692,227.87519999999992,230.6095,236.23000000000005,88946051,72391967.25,80.50035948873844,1.5,2.75,1.425498879982387,1.2286729367753157,0.5783073368523217,2.3726835888513165,1.7943762519989948,4.5848049767016175,3.2978072857517304,8514748777.0,2017-02-21,2017,1,52,2,0.5,236.1,236.54,235.83,4310
2017-02-22 14:30:00,236.02,236.54,235.83,236.28,235.94710526315788,233.6064102564103,217.55769800000004,222.132092,228.09779999999992,231.04349999999997,228.0544623607278,231.75960182101608,232.5023076923077,238.04476010059443,226.95985528402105,217.55769800000004,222.132092,228.09779999999992,231.04349999999997,236.21666666666667,62115185,70719961.75,78.87073635458732,1.5,2.75,1.3743918171265006,0.8783260548072906,0.5444735869665145,2.4749682357071383,1.9304946487406236,4.8463088111085835,3.0710172744721653,8452633592.0,2017-02-22,2017,2,53,2,0.3,236.18,236.9,235.56,4311
2017-02-23 14:30:00,236.88,236.9,235.56,236.44,236.32473684210527,233.71846153846158,217.7104520000001,222.349692,228.29639999999992,231.38699999999997,228.3833069740326,232.2053540285384,233.0484615384616,238.6359081613152,227.461014915608,217.7104520000001,222.349692,228.29639999999992,231.38699999999997,236.30000000000004,74615902,70228871.25,79.21596325915914,1.5,2.75,1.3719352587603222,1.06246762438176,0.487335917875245,2.5396645460846803,2.052328628209435,4.946791522304187,2.5325238508239387,8527249494.0,2017-02-23,2017,3,54,2,0.57,236.23,236.7932,235.41,4312
2017-02-24 14:30:00,235.46,236.7932,235.41,236.74,236.70236842105263,233.83051282051284,217.85190200000008,222.55409200000003,228.50619999999992,231.75749999999996,228.7110204260313,232.63722507343948,233.64923076923085,239.0111274574023,228.2873340810594,217.85190200000008,222.55409200000003,228.50619999999992,231.75749999999996,236.3144,82381612,71349415.9,79.87976631595116,1.5,2.75,1.3727398831345865,1.1546220941102336,0.4264107905269632,2.585342116368139,2.158931325841176,4.689293743602667,2.2590816811368923,8609631106.0,2017-02-24,2017,4,55,2,0.59,236.1,237.31,236.35,4313
2017-02-27 14:30:00,236.64,237.31,236.35,237.11,237.08,233.9425641025641,218.0049520000001,222.76739200000003,228.69319999999996,232.16449999999992,229.04039217403007,233.0632036378738,234.2776923076924,239.1798999977688,229.375484617616,218.0049520000001,222.76739200000003,228.69319999999996,232.16449999999992,236.9233333333333,56515440,71189632.0,80.69854141918537,1.5,2.75,1.3432584629106878,0.7938717817785601,0.3698009135896125,2.6211824678281914,2.251381554238579,4.644472064320821,1.8645014391889003,8666146546.0,2017-02-27,2017,0,58,2,0.41,236.83,236.95,236.015,4314
2017-02-28 14:30:00,236.67,236.95,236.015,236.47,237.45763157894729,234.0546153846154,218.15450200000006,222.98529200000004,228.90499999999992,232.61049999999992,229.331749343676,233.38766043426682,234.83384615384625,238.8914963905957,230.77619591709683,218.15450200000006,222.98529200000004,228.90499999999992,232.61049999999992,236.4783333333333,96961938,72050866.3,75.01227896147489,1.5,2.75,1.3255257155599265,1.3457428477858566,0.2535646437610453,2.568337358939885,2.3147727151788398,5.025691527805153,1.1852802738553745,8569184608.0,2017-02-28,2017,1,59,2,0.4,236.48,240.32,238.37,4315
2017-03-01 14:30:00,238.39,240.32,238.37,239.78,237.83526315789476,240.32,218.32960200000008,223.226792,229.16439999999997,233.22299999999993,229.74148466353185,233.99645467862237,235.54000000000008,239.59979158236527,231.48020841763488,218.32960200000008,223.226792,229.16439999999997,233.22299999999993,239.49,149158170,75714734.55,82.0549638466056,1.5,2.75,1.5058453073056457,1.970001887829375,0.3575508503249636,2.7617112780850452,2.404160427760081,8.65919471832754,2.068789375106425,8718342778.0,2017-03-01,2017,2,60,3,0.82,239.34,239.57,238.21,4316
2017-03-02 14:30:00,239.56,239.57,238.21,238.27,238.2128947368421,240.55038461538464,218.48705200000006,223.45169200000004,229.42899999999997,233.75549999999996,230.07593624535411,234.40345899494403,236.0600000000001,239.62318785531173,232.4968121446885,218.48705200000006,223.45169200000004,229.42899999999997,233.75549999999996,238.6833333333333,70245978,75271150.9,72.07498126825381,1.5,2.75,1.5104277853552417,0.9332390585248777,0.28570103958208604,2.761286727237689,2.475585687655603,9.818974129768543,1.5124403544648992,8648096800.0,2017-03-02,2017,3,61,3,0.57,238.89,238.61,237.73,4317
2017-03-03 14:30:00,238.17,238.61,237.73,238.42,238.59052631578945,240.78076923076924,218.6548980000001,223.68549199999998,229.68679999999992,234.28799999999995,230.40315443181083,234.78598670971127,236.4946153846155,239.7077098947929,233.2815208744381,218.6548980000001,223.68549199999998,229.68679999999992,234.28799999999995,238.25333333333336,81974300,75886987.9,72.43365788251636,1.5,2.75,1.4653972292584403,1.0802154923848282,0.2126932569831124,2.741452258884493,2.528759001901381,9.730421200526845,1.4164787953549636,8730071100.0,2017-03-03,2017,4,62,3,0.37,238.17,238.12,237.01,4318
2017-03-06 14:30:00,237.5,238.12,237.01,237.71,238.96815789473686,241.01115384615383,218.81889800000005,223.900992,229.91299999999995,234.70649999999992,230.68969739526923,235.06446416592925,236.8030769230771,239.63059428602452,233.9755595601296,218.81889800000005,223.900992,229.91299999999995,234.70649999999992,237.61333333333332,55391533,74628406.15,67.98263953726045,1.5,2.75,1.4614402843114094,0.7422312207588262,0.08741890682257214,2.6380326354295955,2.550613728607024,10.073107178768494,0.5158780498118308,8674679567.0,2017-03-06,2017,0,65,3,0.47,237.56,237.77,236.76,4319
2017-03-07 14:30:00,237.36,237.77,236.76,237.0,239.3457894736842,241.24153846153843,218.98289800000006,224.13669199999998,230.13759999999994,235.10999999999993,230.93716024251358,235.2488009120312,236.9630769230771,239.57330985833298,234.3528439878212,218.98289800000006,224.13669199999998,230.13759999999994,235.10999999999993,237.17666666666665,65103737,74994087.6,63.763026981079065,1.5,2.75,1.4291945497177383,0.8681182621655098,-0.06424727224406722,2.47030463830194,2.534551910546007,9.807130545810493,0.30472320975114225,8609575830.0,2017-03-07,2017,1,66,3,0.43,237.26,237.64,236.4,4320
2017-03-08 14:30:00,237.34,237.64,236.4,236.56,239.72342105263158,241.4719230769231,219.1382480000001,224.36519200000004,230.3611999999999,235.49099999999996,231.157663762415,235.3736770156473,237.10461538461556,239.39263926000442,234.8165915092266,219.1382480000001,224.36519200000004,230.3611999999999,235.49099999999996,236.86666666666667,78168795,76005969.8,61.22676070323821,1.5,2.75,1.4156806533093267,1.0284559910976887,-0.20712754489113072,2.275642479432093,2.482770024323224,9.862572238149449,0.0507528336998835,8531407035.0,2017-03-08,2017,2,67,3,0.52,237.02,237.24,235.74,4321
2017-03-09 14:30:00,236.7,237.24,235.74,236.86,240.1010526315789,241.7023076923077,219.29649800000007,224.60369200000005,230.58419999999995,235.87199999999996,231.3812847913399,235.51523158558567,237.24076923076942,239.22331555829174,235.258222903247,219.29649800000007,224.60369200000005,230.58419999999995,235.87199999999996,236.61333333333332,90683918,77961854.8,62.327054736135715,1.5,2.75,1.421703463787232,1.1631831776275288,-0.2893138048176023,2.1211277683012213,2.410441573118824,9.880565684076432,0.050688519050437,8622090953.0,2017-03-09,2017,3,68,3,0.64,236.49,238.02,236.59,4322
2017-03-10 14:30:00,237.97,238.02,236.59,237.69,240.47868421052632,241.9326923076923,219.44559800000007,224.84939200000005,230.81259999999997,236.22649999999993,231.62868538775794,235.72235238695842,237.33307692307704,239.27860251336858,235.3875513327855,219.44559800000007,224.84939200000005,230.81259999999997,236.22649999999993,237.4333333333333,81991652,78763675.15,65.26401338566478,1.5,2.75,1.4222960735167158,1.0409830654023258,-0.29466712735084544,2.042107663930267,2.3367747912811123,10.051594408024169,0.2446122053055477,8704082605.0,2017-03-10,2017,4,69,3,0.6,237.3,237.86,237.24,4323
2017-03-13 13:30:00,237.62,237.86,237.24,237.81,240.8563157894736,242.16307692307686,219.58824800000005,225.10369200000005,231.08079999999995,236.54149999999993,231.87108988235568,235.92117596915287,237.4507692307693,239.31045425850203,235.59108420303662,219.58824800000005,225.10369200000005,231.08079999999995,236.54149999999993,237.63666666666668,57256824,78325721.75,65.68059096811035,1.5,2.75,1.3649892111226654,0.7310092102662303,-0.29622135853647696,1.9664980931105165,2.2627194516469933,10.025247401316204,0.5666680762887484,8761339429.0,2017-03-13,2017,0,72,3,0.26,237.55,237.24,236.19,4324
2017-03-14 13:30:00,237.18,237.24,236.19,236.9,241.233947368421,242.39346153846157,219.72604800000008,225.33559200000008,231.33179999999996,236.74799999999988,232.0683020438319,236.014397305424,237.486153846154,239.28404215380542,235.68826553850246,219.72604800000008,225.33559200000008,231.33179999999996,236.74799999999988,236.77666666666667,59880778,78560658.15,59.82164568167089,1.5,2.75,1.3832042674710467,0.7622234768663276,-0.36036996283570977,1.812256998102356,2.1726269609380657,10.168628862740023,-1.201101009258485,8701458651.0,2017-03-14,2017,1,73,3,0.44,236.72,239.44,237.29,4325
2017-03-15 13:30:00,237.56,239.44,237.29,238.95,241.6115789473684,242.62384615384616,219.86959800000008,225.58229200000008,231.64019999999996,237.0104999999999,232.33817255191693,236.29397851443127,237.65615384615398,239.554793658251,235.7575140340569,219.86959800000008,225.58229200000008,231.64019999999996,237.0104999999999,238.56000000000003,96081750,79809296.5,66.96975705828933,1.5,2.75,1.4658325340802567,1.203891704520914,-0.27066709076921525,1.8342930974765463,2.104960188245762,7.723556504768608,0.2853905233558477,8797540401.0,2017-03-15,2017,2,74,3,0.91,238.36,239.2,238.1,4326
2017-03-16 13:30:00,239.11,239.2,238.1,238.48,241.98921052631576,242.85423076923075,220.0127980000001,225.8282920000001,231.90499999999992,237.18849999999983,232.57902853027318,236.50217103686643,237.76153846153855,239.67921086727142,235.84386605580573,220.0127980000001,225.8282920000001,231.90499999999992,237.18849999999983,238.59333333333333,78343951,79387202.75,64.15178556501144,1.5,2.75,1.4397016387888095,0.9868586911509488,-0.2494390744660846,1.7931613451631565,2.042600419629241,6.8492343497384605,0.02516567402063681,8719196450.0,2017-03-16,2017,3,75,3,0.46,238.65,237.97,237.03,4327
2017-03-17 13:30:00,237.75,237.97,237.03,237.03,242.36684210526315,243.08461538461538,220.14659800000013,226.05879200000007,232.11399999999998,237.3039999999998,232.75357643104675,236.55244046192672,237.80461538461552,239.62710084529246,235.98212992393857,220.14659800000013,226.05879200000007,232.11399999999998,237.3039999999998,237.34333333333333,89002111,79601186.45,56.2832825106342,1.5,2.75,1.4404372360181796,1.1181003069081767,-0.33421536730355905,1.6248312104997922,1.9590465778033512,7.689206706828668,-0.2860628496908026,8630194339.0,2017-03-17,2017,4,76,3,0.4,237.5,237.36,236.32,4328
2017-03-20 13:30:00,237.03,237.36,236.32,236.77,242.7444736842105,243.315,220.27589800000007,226.27759200000008,232.32139999999995,237.38799999999983,232.91108323767241,236.5731604179337,237.57307692307705,239.06830800098248,236.07784584517162,220.27589800000007,226.27759200000008,232.32139999999995,237.38799999999983,236.8166666666667,52536979,78367830.2,54.98105616832302,1.5,2.75,1.411834576302597,0.6703896084135809,-0.4042842297389615,1.4536912906296493,1.8579755203686108,7.549297061425816,-0.09704641350210537,8577657360.0,2017-03-20,2017,0,79,3,0.44,236.84,237.61,233.58,4329
2017-03-21 13:30:00,237.47,237.61,233.58,233.73,243.12210526315792,243.5453846153846,220.39314800000008,226.47319200000007,232.4518,237.24999999999986,232.94319762050876,236.3023832352733,237.22384615384632,239.70231389962012,234.74537840807244,220.39314800000008,226.47319200000007,232.4518,237.24999999999986,234.97333333333336,131809275,80510991.4,42.576926776605866,1.5,2.75,1.598846392280983,1.637158761902912,-0.6379532940516914,1.0605339028039964,1.6984871968556878,10.402211753635273,-1.1963138315860722,8445848085.0,2017-03-21,2017,1,80,3,1.73,235.6,234.61,233.05,4330
2017-03-22 13:30:00,233.77,234.61,233.05,234.28,243.49973684210525,243.77576923076919,220.50779800000007,226.67859200000007,232.6082,237.1499999999998,232.99562124323387,236.10977530810445,236.90538461538475,239.7273382799921,234.08343095077743,220.50779800000007,226.67859200000007,232.6082,237.1499999999998,233.98,97569204,82283692.35,44.994785181332986,1.5,2.75,1.5960716499751988,1.1857659909691691,-0.7313550392602057,0.7842933977804307,1.5156484370406365,10.610559989138483,-1.0892510343662976,8543417289.0,2017-03-22,2017,2,81,3,0.67,233.83,235.34,233.6,4331
2017-03-23 13:30:00,234.0,235.34,233.6,234.03,243.87736842105258,244.00615384615384,220.61954800000007,226.88719200000008,232.75960000000003,237.0294999999998,233.03618511604824,235.91170146923736,236.62230769230786,239.78263049806546,233.46198488655025,220.61954800000007,226.88719200000008,232.75960000000003,237.0294999999998,234.32333333333332,100410277,83573411.1,44.08611092582547,1.5,2.75,1.6063522464055424,1.201461992257966,-0.7813308974425903,0.5389848152373986,1.3203157126799892,10.514936729333998,-1.5398207749589787,8443007012.0,2017-03-23,2017,3,82,3,0.74,234.47,235.04,232.96,4332
2017-03-24 13:30:00,234.38,235.04,232.96,233.86,244.255,244.23653846153846,220.72699800000007,227.10039200000008,232.89480000000003,236.8854999999998,233.06849158208558,235.71630132931,236.38076923076943,239.85325857538055,232.90827988615825,220.72699800000007,227.10039200000008,232.89480000000003,236.8854999999998,233.95333333333332,112504853,85079573.15,43.44362197512212,1.5,2.75,1.6401842288051454,1.322348583033529,-0.7945822096014383,0.32708795067819096,1.1216701602796293,10.096132151076855,-1.6609898658592943,8330502159.0,2017-03-24,2017,4,83,3,0.89,234.0,233.92,231.61,4333
2017-03-27 13:30:00,231.93,233.92,231.61,233.62,231.61,244.4669230769231,220.8346980000001,227.3110920000001,233.0366,236.71099999999984,233.0901193631802,235.51665358366142,236.15461538461557,239.9214309373314,232.38779983189968,220.8346980000001,227.3110920000001,233.0366,236.71099999999984,233.05,87454452,86626523.75,42.501907386242436,1.5,2.75,1.6880282124619188,1.00955744515836,-0.786776854989405,0.13819909154287302,0.9249759465322779,10.016083999120466,-1.38455044322499,8243047707.0,2017-03-27,2017,0,86,3,1.0,232.76,235.81,233.14,4334
2017-03-28 13:30:00,233.27,235.81,233.14,235.32,231.76310344827587,244.6973076923077,220.9609480000001,227.55419200000009,233.20200000000008,236.6534999999998,233.1775656626633,235.4979246709317,236.03615384615398,239.8036466950882,232.26866099721985,220.9609480000001,227.55419200000009,233.20200000000008,236.6534999999998,234.75666666666663,93483915,86452622.6,50.66042152235831,1.5,2.75,1.7581690544289257,1.081331163688723,-0.6405832677599219,0.12424686183237554,0.7648301295922975,11.137486800222952,-1.5191462649089749,8336531622.0,2017-03-28,2017,1,87,3,1.15,234.48,235.81,234.725,4335
2017-03-29 13:30:00,234.99,235.81,234.725,235.54,231.9162068965517,244.9276923076923,221.09640200000007,227.81219200000007,233.38780000000008,236.44149999999985,233.27021014648045,235.5019318451287,235.87076923076938,239.5202535908678,232.22128487067096,221.09640200000007,227.81219200000007,233.38780000000008,236.44149999999985,235.3583333333333,60786374,82034032.8,51.61719065830908,1.5,2.75,1.710085550541146,0.7409897078715848,-0.5083044503736799,0.12944956662519758,0.6377540169988775,9.558171878364524,-1.23280778262328,8397317996.0,2017-03-29,2017,2,88,3,0.46,235.27,236.52,235.27,4336
2017-03-30 13:30:00,235.47,236.52,235.27,236.29,232.06931034482758,245.15807692307686,221.23765200000008,228.08729200000008,233.57860000000008,236.3424999999998,233.38863327799103,235.57698595511647,235.75384615384633,239.24111123574195,232.2665810719507,221.23765200000008,228.08729200000008,233.57860000000008,236.3424999999998,236.02666666666667,56737890,81358628.4,54.83276457698613,1.5,2.75,1.6772222969310637,0.697380119549803,-0.35669952485386136,0.1918796109315508,0.5485791357854122,9.902879728013476,-0.312196768341564,8454055886.0,2017-03-30,2017,3,89,3,0.53,235.9,236.51,235.68,4337
2017-03-31 13:30:00,235.9,236.51,235.68,235.74,232.2224137931035,245.38846153846148,221.37760200000008,228.35919200000006,233.77520000000007,236.20849999999982,233.4808437376777,235.59251110224827,235.66461538461553,239.08879740155052,232.24043336768042,221.37760200000008,228.35919200000006,233.77520000000007,236.20849999999982,235.97666666666672,73733094,80946568.1,52.09827143185613,1.5,2.75,1.6167064185788438,0.9108859798591016,-0.2830787224688001,0.1947307326994121,0.4778094551682122,9.407057533793159,-0.4350213287156317,8380322792.0,2017-03-31,2017,4,90,3,0.35,236.1,236.03,233.91,4338
2017-04-03 13:30:00,235.8,236.03,233.91,235.33,232.37551724137933,245.61884615384614,221.51240200000007,228.58099200000007,233.9470000000001,236.08949999999973,233.55335966953342,235.5675100448913,235.38615384615397,238.23714599151586,232.5351617007921,221.51240200000007,228.58099200000007,233.9470000000001,236.08949999999973,235.09000000000003,85546486,82454315.75,50.09279389594565,1.5,2.75,1.6526559601089268,1.0375016179792869,-0.2526165151707908,0.16203881120472374,0.4146553263755145,9.428028727019985,0.6845505497796701,8294776306.0,2017-04-03,2017,0,93,4,0.91,234.97,235.58,234.555,4339
2017-04-04 13:30:00,235.0,235.58,234.555,235.48,232.52862068965518,245.84923076923081,221.65720200000007,228.79469200000008,234.1336000000001,236.01349999999974,233.62891419229683,235.5591757549016,235.15538461538475,237.38532929055356,232.925439940216,221.65720200000007,228.79469200000008,234.1336000000001,236.01349999999974,235.205,56466195,82022438.65,50.838405288905676,1.5,2.75,1.6078233915297182,0.6884237524435028,-0.2144885025203661,0.1465446982250569,0.361033200745423,5.235517511497437,0.5122076148198688,8351242501.0,2017-04-04,2017,1,94,4,0.44,235.07,237.39,234.54,4340
2017-04-05 13:30:00,236.26,237.39,234.54,234.78,232.681724137931,246.07961538461535,221.79185200000006,228.9787000000001,234.27720000000008,235.92449999999968,233.67405481220678,235.48496854014908,234.98230769230784,236.9354850460016,233.0291303386141,221.79185200000006,228.9787000000001,234.27720000000008,235.92449999999968,235.57,108800604,83554029.1,47.287895393104954,1.5,2.75,1.696550292134738,1.3021586771092049,-0.22731059657426025,0.07689495502759769,0.3042055516018579,5.522166838947788,0.3204717343930265,8242441897.0,2017-04-05,2017,2,95,4,1.22,235.96,236.04,234.425,4341
2017-04-06 13:30:00,234.94,236.04,234.425,235.44,232.8348275862069,246.31,221.92685200000008,229.16390000000007,234.39460000000008,235.85349999999968,233.74330756466927,235.48068582203965,234.8800000000001,236.56942411667785,233.19057588332245,221.92685200000008,229.16390000000007,234.39460000000008,235.85349999999968,235.30166666666665,69135757,82476621.05,50.778376723697825,1.5,2.75,1.6907252712679697,0.8382467191288991,-0.1840849654631973,0.07409934477286129,0.2581843102360586,5.639460013579912,0.6756178910459181,8311577654.0,2017-04-06,2017,3,96,4,0.69,235.23,236.0,234.64,4342
2017-04-07 13:30:00,235.15,236.0,234.64,235.2,232.9879310344828,246.5403846153846,222.0623520000001,229.3517000000001,234.51200000000009,235.72899999999973,233.80043275821163,235.45395383898827,234.99307692307704,236.55115038069388,233.43500346546017,222.0623520000001,229.3517000000001,234.51200000000009,235.72899999999973,235.28,74412311,82097654.0,49.494901708951986,1.5,2.75,1.6671020376059729,0.9063877878897734,-0.16501199561646268,0.05191931571548025,0.21693131133194293,5.667086881056092,0.6763119595924938,8237165343.0,2017-04-07,2017,4,97,4,0.58,235.32,236.255,234.73,4343
2017-04-10 13:30:00,235.36,236.255,234.73,235.34,233.14103448275864,246.7707692307692,222.18500200000008,229.5392000000001,234.6394000000001,235.6054999999997,233.8608079441641,235.44310109241792,235.07461538461553,236.58510415693303,233.56412661229797,222.18500200000008,229.5392000000001,234.6394000000001,235.6054999999997,235.4416666666667,67615302,82615577.9,50.284313347170745,1.5,2.75,1.6569518920626896,0.8184328394076391,-0.13745047456414655,0.045118218126759764,0.1825686926909063,5.575647271113094,0.008499065102843036,8304780645.0,2017-04-10,2017,0,100,4,0.65,235.49,235.18,233.34,4344
2017-04-11 13:30:00,234.9,235.18,233.34,235.06,233.2941379310345,247.00115384615384,222.34465200000008,229.70700000000016,234.78960000000012,235.51349999999974,233.90783508360863,235.40661527409242,235.15384615384625,236.53976519821185,233.76792710948058,222.34465200000008,229.70700000000016,234.78960000000012,235.51349999999974,234.52666666666664,88045276,84023802.8,48.646608803743604,1.5,2.75,1.681455328343926,1.0478611187067102,-0.1325034559120802,0.01693937280080604,0.14944282871288625,3.7864178198926486,-0.2037870425405408,8216735369.0,2017-04-11,2017,1,101,4,0.79,234.26,234.96,233.77,4345
2017-04-12 13:30:00,234.74,234.96,233.77,234.03,233.4472413793104,247.23153846153843,222.51680200000007,229.86860000000016,234.91960000000012,235.26749999999973,233.9126258646436,235.27550905751218,235.16692307692318,236.50618543679832,233.8276607170481,222.51680200000007,229.86860000000016,234.91960000000012,235.26749999999973,234.25333333333336,81864436,83312937.1,43.0873522836232,1.5,2.75,1.6534942334622165,0.9826137314273128,-0.18955134582558406,-0.0874963535690938,0.10205499225649024,4.426303896258629,-0.9564518176816584,8134870933.0,2017-04-12,2017,2,102,4,0.51,234.36,234.49,232.51,4346
2017-04-13 13:30:00,233.64,234.49,232.51,232.51,233.60034482758618,247.46192307692303,222.66335350000008,230.00380000000013,235.01740000000007,234.96899999999974,233.85762092877525,235.01212724251099,235.08153846153854,236.87045899811508,233.2926179249621,222.66335350000008,230.00380000000013,235.01740000000007,234.96899999999974,233.17,92880394,84039759.25,36.46475314935632,1.5,2.75,1.6768160739292024,1.105195860017888,-0.3133045281418213,-0.2895756679207864,0.023728860221034903,4.839225599963594,-1.370153559005692,8041990539.0,2017-04-13,2017,3,103,4,0.85,233.5,234.57,232.88,4347
2017-04-17 13:30:00,233.11,234.57,232.88,234.57,233.75344827586207,247.6923076923077,222.80290350000007,230.1645000000001,235.1534000000001,234.84599999999972,233.88555736294086,234.9700198860814,235.02384615384625,236.8266053802197,233.2210869274728,222.80290350000007,230.1645000000001,235.1534000000001,234.84599999999972,234.00666666666663,68405367,83009922.05,48.106101264893816,1.5,2.75,1.7041863543628308,0.8240625374734948,-0.2431986282685279,-0.2802694251146249,-0.03707079684609707,7.643582101307714,-0.3229507500106316,8110395906.0,2017-04-17,2017,0,107,4,0.73,233.72,234.49,233.08,4348
2017-04-18 13:30:00,233.72,234.49,233.08,233.87,233.90655172413798,247.9226923076923,222.92487850000006,230.30170000000007,235.24400000000009,234.70099999999974,233.88494727027657,234.86525608740695,234.89538461538467,236.76931286918773,233.0214563615817,222.92487850000006,230.30170000000007,235.24400000000009,234.70099999999974,233.81333333333333,83225821,84544364.15,45.083233724138466,1.5,2.75,1.6888873290511983,0.984404127191014,-0.23084313173811602,-0.3256247115187421,-0.09478157978062607,7.750383332257793,-0.6837098692033231,8027170085.0,2017-04-18,2017,1,108,4,0.6,233.79,234.95,233.18,4349
2017-04-19 13:30:00,234.52,234.95,233.18,233.44,234.0596551724138,248.15307692307687,223.0424745000001,230.43030000000007,235.33420000000007,234.68649999999974,233.86749835771667,234.72951741241585,234.676153846154,236.5126310500881,232.83967664221973,223.0424745000001,230.43030000000007,235.33420000000007,234.68649999999974,233.85666666666665,68699868,81388893.8,43.28394486789484,1.5,2.75,1.6946810912618258,0.8440938903632083,-0.2375752573336317,-0.3917506514476656,-0.15417539411403394,7.733487117951277,-0.5707470823749908,7958470217.0,2017-04-19,2017,2,109,4,0.76,234.06,235.845,233.78,4350
2017-04-20 13:30:00,234.15,235.845,233.78,235.34,234.2127586206897,248.38346153846155,223.17712450000008,230.57670000000005,235.46220000000008,234.73949999999974,233.9252435201592,234.78765861123335,234.64538461538467,236.42196067203525,232.86880855873414,223.17712450000008,230.57670000000005,235.46220000000008,234.73949999999974,234.98833333333332,92572186,81139042.9,52.33598169377945,1.5,2.75,1.7454181561716955,1.1409080350391956,-0.10668158677784753,-0.2875273775863434,-0.18084579080849586,9.116589334014144,-0.042473666326874916,8051042403.0,2017-04-20,2017,3,110,4,0.88,234.81,235.31,234.13,4351
2017-04-21 13:30:00,235.25,235.31,234.13,234.59,234.36586206896555,248.61384615384614,223.30177450000008,230.70740000000006,235.5692000000001,234.76749999999973,233.95131240172162,234.7688339815921,234.58846153846162,236.32050961295303,232.85641346397026,223.30177450000008,230.70740000000006,235.5692000000001,234.76749999999973,234.67666666666665,110389847,81638021.4,49.01073509223938,1.5,2.75,1.7071740021594322,1.3521867030452062,-0.06526205615225097,-0.2624233609988096,-0.1971613048465586,9.147919273965973,-0.25935374149659235,7940652556.0,2017-04-21,2017,4,111,4,0.5,234.72,237.41,236.61,4352
2017-04-24 13:30:00,237.18,237.41,236.61,237.17,234.5189655172414,248.8442307692308,223.43999450000007,230.87430000000003,235.70060000000007,234.93299999999985,234.0775354447913,234.9975164595357,234.7184615384617,236.8952459863068,232.54167709061653,223.43999450000007,230.87430000000003,235.70060000000007,234.93299999999985,237.06333333333333,119209877,81973272.6,58.72579216104007,1.5,2.75,1.786661573433758,1.4542529927004526,0.13056710266921426,-0.033952426510040816,-0.16451952917925505,11.176331998660876,0.7775983683181712,8059862433.0,2017-04-24,2017,0,114,4,0.34,237.01,238.95,237.81,4353
2017-04-25 13:30:00,237.91,238.95,237.81,238.55,234.67206896551727,249.07461538461536,223.56949450000008,231.05070000000003,235.84140000000008,235.17949999999985,234.25292621166219,235.33584822529426,235.0084615384617,237.99475686262429,232.02216621429906,223.56949450000008,231.05070000000003,235.84140000000008,235.17949999999985,238.43666666666664,75050935,81353096.75,62.80770432129258,1.5,2.75,1.7861857467599183,0.9225332285829672,0.3360327515153213,0.2555214102148966,-0.08051134130042471,11.52854508492315,1.4847273036671529,8134913368.0,2017-04-25,2017,1,115,4,0.48,238.38,239.53,238.35,4354
2017-04-26 13:30:00,238.51,239.53,238.35,238.4,234.82517241379315,249.305,223.69449450000008,231.23090000000005,235.95400000000006,235.33349999999984,234.4155565563029,235.62767220383762,235.236153846154,238.72793354189952,231.7443741504084,223.69449450000008,231.23090000000005,235.95400000000006,235.33349999999984,238.76,84702455,80914023.75,62.08892445954256,1.5,2.75,1.7428867648484958,1.046820453049092,0.4383606045364579,0.4674394143701477,0.029078809833689767,11.487718247521762,1.8672819723967031,8050210913.0,2017-04-26,2017,2,116,4,0.5,238.94,238.95,237.98,4355
2017-04-27 13:30:00,238.77,238.95,237.98,238.6,234.97827586206898,249.5353846153846,223.81274450000006,231.42120000000003,236.05200000000008,235.48649999999984,234.5796523776244,235.9107510415674,235.49769230769246,239.42200041009892,231.57338420528598,223.81274450000006,231.42120000000003,236.05200000000008,235.48649999999984,238.51,57410326,80745221.35,62.701830524609505,1.5,2.75,1.6876805673593174,0.7110058656121326,0.4920165599487535,0.6440995097696316,0.1520829498208781,10.899543922758578,2.6192421831319104,8107621239.0,2017-04-27,2017,3,117,4,0.41,238.46,238.93,237.93,4356
2017-04-28 13:30:00,238.9,238.93,237.93,238.08,235.13137931034484,249.7657692307692,223.92854450000007,231.60520000000002,236.11520000000007,235.57599999999985,234.7169209118352,236.11734618046574,235.70846153846162,239.8637758089175,231.55314726800583,223.92854450000007,231.60520000000002,236.11520000000007,235.57599999999985,238.31333333333336,63532845,81084969.1,59.986400309762935,1.5,2.75,1.6385605268336518,0.7835341827860425,0.4652830558126211,0.7336867695866545,0.2684037137740334,9.911363437240603,1.4963550326128745,8044088394.0,2017-04-28,2017,4,118,4,0.42,238.43,239.17,238.195,4357
2017-05-01 13:30:00,238.68,239.17,238.195,238.68,235.28448275862075,249.99615384615385,224.04134450000006,231.78200000000004,236.1944000000001,235.7229999999999,234.8723357780377,236.36140844899282,235.98692307692318,240.40778539874242,231.566060755104,224.04134450000006,231.78200000000004,236.1944000000001,235.7229999999999,238.68166666666667,66882521,80742440.45,62.02971328540447,1.5,2.75,1.599377632059818,0.8283440607844546,0.4599797195705389,0.8433783632372069,0.3833986436666681,9.032808268613698,2.056698165647583,8110970915.0,2017-05-01,2017,0,121,5,0.41,238.68,238.98,238.3,4358
2017-05-02 13:30:00,238.84,238.98,238.3,238.77,235.43758620689655,250.22653846153844,224.15604450000006,231.95270000000005,236.2680000000001,235.89499999999992,235.02518535536962,236.59079812051726,236.35153846153855,240.84788806574102,231.8551888573361,224.15604450000006,231.95270000000005,236.2680000000001,235.89499999999992,238.6833333333333,57375732,79333902.75,62.340368947297705,1.5,2.75,1.5337078011984009,0.7232183216903444,0.4347910116699822,0.9268874082541458,0.4920963965841637,8.585002376370161,2.2832419465387304,8168346647.0,2017-05-02,2017,1,122,5,0.29,238.64,238.8775,237.7,4359
2017-05-03 13:30:00,238.29,238.8775,237.7,238.48,235.5906896551724,250.45692307692303,224.26639850000007,232.09150000000002,236.30780000000007,236.04499999999993,235.16066828261,236.77072210903947,236.81076923076932,240.83901917745342,232.7825192840852,224.26639850000007,232.09150000000002,236.30780000000007,236.04499999999993,238.3525,73137731,80167479.55,60.619345405842886,1.5,2.75,1.5082643868270869,0.9123117180500158,0.3732172828326008,0.9586180001249148,0.5854007172923139,8.487922590805342,1.3342398232344634,8095208916.0,2017-05-03,2017,2,123,5,0.5,238.29,238.9225,237.78,4360
2017-05-04 13:30:00,238.83,238.9225,237.78,238.76,235.7437931034483,250.6873076923077,224.37924850000007,232.2276,236.35740000000007,236.24399999999991,235.30181854603703,236.9601771462738,237.133076923077,241.06186914001452,233.20428470613945,224.37924850000007,232.2276,236.35740000000007,236.24399999999991,238.4875,61462732,77800585.95,61.71823512694671,1.5,2.75,1.4821383591965815,0.7900034588364176,0.3275913550728564,0.9948899111333844,0.6672985560605279,7.59072671857455,1.777569376358748,8156671648.0,2017-05-04,2017,3,124,5,0.48,238.35,239.72,238.68,4361
2017-05-05 13:30:00,239.19,239.72,238.68,239.7,235.89689655172413,250.9176923076923,224.49232350000003,232.35950000000003,236.42260000000007,236.45699999999997,235.474296250114,237.22111265615246,237.5815384615385,241.2396998000388,233.92337712303825,224.49232350000003,232.35950000000003,236.42260000000007,236.45699999999997,239.36666666666665,62001269,77443861.55,65.22636583875104,1.5,2.75,1.4505570478253966,0.8005962998109306,0.3357259977512527,1.086956053249594,0.7512300554983412,7.084095079323151,1.066745372517604,8218672917.0,2017-05-05,2017,4,125,5,0.44,239.2,239.92,239.17,4362
2017-05-08 13:30:00,239.75,239.92,239.17,239.66,236.05,251.1480769230769,224.60929850000008,232.49360000000004,236.48100000000008,236.67999999999992,235.6384414952076,237.4533876412808,238.0600000000001,240.9785665606675,235.14143343933262,224.60929850000008,232.49360000000004,236.48100000000008,236.67999999999992,239.58333333333337,48385730,76142532.5,64.95359131593665,1.5,2.75,1.4005172586950112,0.6354625780275958,0.3138237950533369,1.1435097993150125,0.8296860042616754,4.415259655949236,0.46531125550198493,8170287187.0,2017-05-08,2017,0,128,5,0.31,239.54,240.19,239.04,4363
2017-05-09 13:30:00,239.96,240.19,239.04,239.44,236.2031034482759,251.37846153846152,224.72029850000007,232.61040000000008,236.52760000000006,236.88499999999993,235.78752222088573,237.6425888183017,238.37538461538463,240.9110698103866,235.8396994203826,224.72029850000007,232.61040000000008,236.52760000000006,236.88499999999993,239.55666666666676,51363200,75329927.4,63.38357302177912,1.5,2.75,1.382623168788225,0.6818432165381324,0.26204078184489304,1.1572369815677916,0.8951961997228987,3.3153532022382586,0.4362416107382517,8118923987.0,2017-05-09,2017,1,129,5,0.48,239.62,239.87,239.15,4364
2017-05-10 13:30:00,239.39,239.87,239.15,239.87,236.3562068965517,251.60884615384614,224.8363985000001,232.75030000000004,236.5956000000001,237.12549999999987,235.94761938869416,237.8547232165586,238.78153846153847,240.212704659529,237.35037226354797,224.8363985000001,232.75030000000004,236.5956000000001,237.12549999999987,239.63,54293799,73642353.55,65.1563559899172,1.5,2.75,1.335292942446209,0.737263223983422,0.23512784414997825,1.1891060049103714,0.9539781607603932,3.3390309797077364,0.5322715842414125,8173217786.0,2017-05-10,2017,2,130,5,0.3,239.51,239.57,238.13,4365
2017-05-11 13:30:00,239.35,239.57,238.13,239.38,236.50931034482758,251.8392307692308,224.94954850000008,232.87600000000003,236.58760000000007,237.39299999999992,236.08222254992182,237.9999876721245,238.95153846153852,240.06677134244163,237.8363055806353,224.94954850000008,232.87600000000003,236.58760000000007,237.39299999999992,239.02666666666664,62358346,72667049.05,61.502235872343064,1.5,2.75,1.3642005894143376,0.8581378604915291,0.16596565400845376,1.1614352282709604,0.9954695742625066,3.661850189861527,0.5460349462365519,8110859440.0,2017-05-11,2017,3,131,5,0.6,238.85,239.4273,238.67,4366
2017-05-12 13:30:00,239.09,239.4273,238.67,238.98,236.6624137931035,252.06961538461536,225.06184850000008,233.0154,236.60180000000008,237.71649999999985,236.19586088129745,238.09332217954122,238.9846153846154,240.07548985057971,237.89374091865108,225.06184850000008,233.0154,236.60180000000008,237.71649999999985,239.02576666666667,53912730,70718665.85,58.61245736715465,1.5,2.75,1.3208505473133143,0.76235502115316,0.07931336767644083,1.0946112838580575,1.015297916181617,3.5442551056330203,0.12569130216188326,8056946710.0,2017-05-12,2017,4,132,5,0.32,239.05,240.44,239.45,4367
2017-05-15 13:30:00,239.47,240.44,239.45,240.3,236.81551724137933,252.3,225.17949850000016,233.1631,236.63940000000005,238.00299999999987,236.35680751340342,238.30348197196582,239.13076923076926,240.36842113998185,237.8931173215567,225.17949850000016,233.1631,236.63940000000005,238.00299999999987,240.06333333333336,61918937,70394344.35,64.53457983750502,1.5,2.75,1.3307897939337927,0.8796010186860985,0.09582669448537297,1.1350812842883329,1.03925458980296,4.491478451223276,0.6407840180927257,8118865647.0,2017-05-15,2017,0,135,5,0.41,239.94,240.67,239.63,4368
2017-05-16 13:30:00,240.64,240.67,239.63,240.08,236.96862068965518,252.5303846153846,225.2942985000001,233.2999,236.6868000000001,238.31349999999992,236.50281506189742,238.47267416511195,239.2446153846154,240.53709339530758,237.9521373739232,225.2942985000001,233.2999,236.6868000000001,238.31349999999992,240.1266666666667,51241791,68795142.85,62.918656994472435,1.5,2.75,1.3100190943670926,0.7448460585615312,0.07763896238300694,1.1363032927817187,1.0586643303987118,4.583138388872525,0.6709158000671012,8067623856.0,2017-05-16,2017,1,136,5,0.43,240.15,238.64,235.75,4369
2017-05-17 13:30:00,238.1,238.64,235.75,235.82,237.1217241379311,252.7607692307692,225.38869850000012,233.4004,236.66320000000007,238.43249999999992,236.47603800064653,238.2200385303394,239.07076923076926,241.24812770852915,236.89341075300942,225.38869850000012,233.4004,236.66320000000007,238.43249999999992,236.73666666666668,172174107,73968854.8,41.3352400916917,1.5,2.75,1.5257320161980157,2.3276567883270785,-0.21934560692653693,0.7844823217405406,1.0038279286670777,11.574137321108141,-1.2313620371921583,7895449749.0,2017-05-17,2017,2,137,5,1.23,237.2,237.75,235.43,4370
2017-05-18 13:30:00,235.73,237.75,235.43,236.77,235.43,252.99115384615382,225.49480250000008,233.5143,236.66740000000007,238.50399999999993,236.48756592218982,238.08193962268803,238.92384615384617,241.4211128252713,236.42657948242103,225.49480250000008,233.5143,236.66740000000007,238.50399999999993,236.65,107047656,74692628.3,45.8003858458977,1.5,2.75,1.5824654436124423,1.4331756484729297,-0.34251624924102003,0.5756826171158025,0.9181988663568224,11.890884325080064,-1.2223612849394987,8002497405.0,2017-05-18,2017,3,138,5,0.99,236.59,239.08,237.27,4371
2017-05-19 13:30:00,237.33,239.08,237.27,238.31,235.53324324324325,253.22153846153842,225.60545250000007,233.6403,236.69640000000007,238.6899999999999,236.5590339252412,238.10365965862252,238.8884615384616,241.40639532082082,236.3705277561024,225.60545250000007,233.6403,236.69640000000007,238.6899999999999,238.22,115011373,74923704.6,52.157422432780784,1.5,2.75,1.6344321976401253,1.535046533190245,-0.31185379538203883,0.5283816221292739,0.8402354175113127,12.345909559756295,-0.5632980055078004,8117508778.0,2017-05-19,2017,4,139,5,0.76,238.18,239.71,238.82,4372
2017-05-22 13:30:00,238.9,239.71,238.82,239.52,235.63648648648652,253.4519230769231,225.72100400000008,233.7728,236.7330000000001,238.80749999999995,236.67515024189842,238.23854921494416,238.9684615384616,241.49547066938348,236.44145240753969,225.72100400000008,233.7728,236.7330000000001,238.80749999999995,239.35,61010602,72013740.85,56.476867854309084,1.5,2.75,1.617687040665831,0.8472077867344951,-0.2067281647610374,0.581825211560016,0.7885533763210534,12.766974033410158,0.03341129301704498,8178519380.0,2017-05-22,2017,0,142,5,0.37,239.26,240.24,239.51,4373
2017-05-23 13:30:00,239.95,240.24,239.51,240.05,235.73972972972973,253.6823076923077,225.83035400000009,233.9293,236.77780000000007,238.88249999999996,236.80749729123573,238.4110683373304,239.06769230769243,241.6547625704118,236.480622044973,225.83035400000009,233.9293,236.77780000000007,238.88249999999996,239.93333333333328,48341683,70678278.25,58.2547213427112,1.5,2.75,1.554280823475416,0.6839680337006512,-0.1033661528977906,0.6593456851988151,0.7627118380966057,12.815894147714937,0.07504064701713713,8226861063.0,2017-05-23,2017,1,143,5,0.3,239.88,240.73,239.93,4374
2017-05-24 13:30:00,240.32,240.73,239.93,240.61,235.84297297297297,253.9126923076923,225.94315400000008,234.0919,236.8520000000001,238.99299999999997,236.95661504452062,238.6204904004418,239.13769230769242,241.8362520813297,236.43913253405515,225.94315400000008,234.0919,236.8520000000001,238.99299999999997,240.4233333333333,49181099,68902210.45,60.10888817499362,1.5,2.75,1.5004036217985992,0.7137811498179591,-0.004377828278642637,0.7572395527483025,0.7616173810269451,12.843046561652162,0.5138273874175028,8276042162.0,2017-05-24,2017,2,144,5,0.33,240.33,242.08,240.96,4375
2017-05-25 13:30:00,241.2,242.08,240.96,241.76,235.94621621621621,254.1430769230769,226.06105400000013,234.2742,236.90820000000008,239.15099999999995,237.1449830819904,238.91949131468544,239.2992307692309,242.33398800485168,236.26447353361,226.06105400000013,234.2742,236.90820000000008,239.15099999999995,241.6,64071661,69235277.2,63.67684435591442,1.5,2.75,1.4982319345272703,0.9254192889979502,0.1243424219699415,0.9170454084893721,0.7927029865194305,12.980359855883744,1.1632772616955398,8340113823.0,2017-05-25,2017,3,145,5,0.46,241.52,241.9,241.45,4376
2017-05-26 13:30:00,241.54,241.9,241.45,241.71,236.04945945945943,254.37346153846158,226.18140400000007,234.4389,236.97280000000006,239.33249999999992,237.32400335328492,239.18525404662014,239.47384615384624,242.77080548454327,236.17688682314926,226.18140400000007,234.4389,236.97280000000006,239.33249999999992,241.68666666666667,46629905,68390130.2,63.4112818543527,1.5,2.75,1.4233582249181809,0.6818221410550845,0.18808574086904128,1.027810162605732,0.8397244217366908,12.897584385631285,0.5867665418227201,8293483918.0,2017-05-26,2017,4,146,5,0.19,241.68,241.79,241.16,4377
2017-05-30 13:30:00,241.34,241.79,241.16,241.5,236.15270270270267,254.6038461538461,226.29565400000007,234.5881,237.06220000000005,239.47349999999992,237.48776792766586,239.40570604218013,239.59923076923087,243.06649714124146,236.13196439722026,226.29565400000007,234.5881,237.06220000000005,239.47349999999992,241.48333333333332,35201897,66806099.0,62.23727731197228,1.5,2.75,1.3666897802811675,0.5269263963459384,0.19712173624297932,1.086126592040415,0.8890048557974357,12.623491722258525,0.5914695101632736,8258282021.0,2017-05-30,2017,1,150,5,0.26,241.48,241.88,240.64,4378
2017-05-31 13:30:00,241.84,241.88,240.64,241.44,236.25594594594597,254.83423076923077,226.4105540000001,234.7385,237.15560000000005,239.60699999999989,237.6427574206986,239.59944832387728,239.75769230769242,243.3562061363474,236.15917847903745,226.4105540000001,234.7385,237.15560000000005,239.60699999999989,241.32,91796016,68527113.2,61.884741319161655,1.5,2.75,1.357640510261085,1.3395576103153284,0.1805179285416804,1.1146522664745362,0.9341343379328558,12.601979484058134,2.3831736069883833,8166486005.0,2017-05-31,2017,2,151,5,0.52,241.26,243.38,241.64,4379
2017-06-01 13:30:00,241.97,243.38,241.64,243.36,236.35918918918918,255.06461538461537,226.5319040000001,234.9,237.34820000000008,239.85099999999989,237.86696301204373,239.9575961025556,240.09461538461548,244.13218217192073,236.05704859731026,226.5319040000001,234.9,237.34820000000008,239.85099999999989,242.7933333333333,68962024,68318327.85,68.10981598952056,1.5,2.75,1.399237616671007,1.0094220126612774,0.2746615255193472,1.2774612448320397,1.0027997193126923,5.452093314854606,2.783291802170885,8235448029.0,2017-06-01,2017,3,152,6,0.72,242.51,244.35,243.08,4380
2017-06-02 13:30:00,243.42,244.35,243.08,244.17,236.46243243243245,255.295,226.66295400000013,235.07709999999997,237.54600000000005,240.12149999999988,238.1141409331401,240.35877742612175,240.39230769230775,244.97977660291443,235.80483878170116,226.66295400000013,235.07709999999997,237.54600000000005,240.12149999999988,243.86666666666667,88666128,69678497.65,70.31266806905582,1.5,2.75,1.3900063583373623,1.2725034406650986,0.3618206712849528,1.4550755584188837,1.0932548871339307,5.4259167491343625,2.458981998237584,8324114157.0,2017-06-02,2017,4,153,6,0.52,243.72,244.3,243.76,4381
2017-06-05 13:30:00,243.97,244.3,243.76,243.99,236.5656756756757,255.5253846153846,226.7910540000001,235.2524,237.74520000000004,240.3359999999999,238.34456677889932,240.7046081474435,240.693076923077,245.6565024437547,235.72965140239933,226.7910540000001,235.2524,237.74520000000004,240.3359999999999,244.01666666666665,44698825,68813375.45,69.1692279961839,1.5,2.75,1.3292916184561236,0.6495659413260187,0.3760289222193194,1.5632910399080802,1.1872621176887606,5.349449136373709,1.8662324649298592,8279415332.0,2017-06-05,2017,0,156,6,0.22,244.03,243.98,243.12,4382
2017-06-06 13:30:00,243.34,243.98,243.12,243.21,236.6689189189189,255.7557692307692,226.91280400000008,235.4135,237.9322,240.51349999999988,238.53536808168755,240.94321689530602,241.26153846153855,245.50246612604576,237.02061079703134,226.91280400000008,235.4135,237.9322,240.51349999999988,243.43666666666672,50375430,68912860.45,64.29022006803905,1.5,2.75,1.2964850742806866,0.7310018720896093,0.3046205013079999,1.5680377443237603,1.2634172430157604,5.892090622129506,1.3163924182461972,8229039902.0,2017-06-06,2017,1,157,6,0.35,243.55,243.92,242.83,4383
2017-06-07 13:30:00,243.6,243.92,242.83,243.66,236.77216216216218,255.98615384615383,227.03840400000013,235.5848,238.133,240.72449999999992,238.73633403926846,241.20195814337208,241.79153846153847,245.31638517858985,238.2666917444872,227.03840400000013,235.5848,238.133,240.72449999999992,243.47,54144311,69051916.0,65.78949299995534,1.5,2.75,1.2817361404034928,0.7841101903674911,0.26109399133018085,1.5897847321784866,1.3286907408483055,5.880455043332857,1.2676114874693416,8283184213.0,2017-06-07,2017,2,158,6,0.45,243.38,244.33,243.17,4384
2017-06-08 13:30:00,243.77,244.33,243.17,243.78,236.87540540540542,256.21653846153845,227.16465400000013,235.7521,238.3022,240.91999999999993,238.93412486125789,241.44748593924146,242.21230769230775,245.2460173163131,239.17859806830245,227.16465400000013,235.7521,238.3022,240.91999999999993,243.76,65950691,69634760.6,66.1970622291161,1.5,2.75,1.2730407018032452,0.9470943883736136,0.21567013946035685,1.598278415173752,1.3826082757133948,5.879259480909601,0.8355393778954378,8349134904.0,2017-06-08,2017,3,159,6,0.48,243.75,245.01,241.95,4385
2017-06-09 13:30:00,244.09,245.01,241.95,243.41,236.97864864864863,245.01,227.28685400000006,235.9237,238.4596,241.12149999999988,239.1096493765027,241.63439204026605,242.51153846153855,245.16790783058502,239.8551690924921,227.28685400000006,235.9237,238.4596,241.12149999999988,243.45666666666668,132256362,73129661.4,63.67801362871334,1.5,2.75,1.400680651674442,1.8085187250709736,0.13967605268054473,1.557203341564076,1.4175272888835313,5.627957974322992,0.7033221629225057,8216878542.0,2017-06-09,2017,4,160,6,1.26,243.48,243.42,242.38,4386
2017-06-12 13:30:00,243.13,243.42,242.38,243.36,237.0818918918919,245.077,227.4144040000001,236.0898,238.601,241.34049999999988,239.2763297931104,241.79873565547882,242.7661538461539,245.03642375165091,240.49588394065688,227.4144040000001,236.0898,238.601,241.34049999999988,243.0533333333333,86108102,74739430.0,63.327308735196155,1.5,2.75,1.37491774798341,1.1521107666997192,0.06860817295031629,1.5032875050714267,1.4346793321211104,5.6278773645920195,0.7701863354037324,8130770440.0,2017-06-12,2017,0,163,6,0.43,242.9,244.61,243.5799,4387
2017-06-13 13:30:00,243.98,244.61,243.5799,244.55,237.18513513513514,245.144,227.54865400000014,236.2762,238.7772,241.55299999999988,239.48314038945904,242.06076083114755,243.06923076923084,245.1513814552589,240.9870800832028,227.54865400000014,236.2762,238.7772,241.55299999999988,244.2466333333333,60066953,74646830.8,67.86369383200002,1.5,2.75,1.3659950516988808,0.8046818914648417,0.08333097128158595,1.5388430462230929,1.455512074941507,6.00186970425031,1.2881047051027228,8190837393.0,2017-06-13,2017,1,164,6,0.42,244.09,244.87,243.29,4388
2017-06-14 13:30:00,244.86,244.87,243.29,244.24,237.2883783783784,245.211,227.68340400000017,236.4512,238.9554,241.76099999999988,239.6696839035979,242.26830741865732,243.26000000000008,245.28092134358533,241.23907865641485,227.68340400000017,236.4512,238.9554,241.76099999999988,244.13333333333333,78602311,76014856.8,65.58760949203803,1.5,2.75,1.381281119434676,1.034038795952846,0.055137487297226784,1.5244339340630404,1.4692964467658136,6.122389618719384,0.36160420775805197,8112235082.0,2017-06-14,2017,2,165,6,0.65,244.08,243.91,242.36,4389
2017-06-15 13:30:00,242.68,243.91,242.36,243.77,237.3916216216216,245.278,227.8104500000001,236.6274,239.1212,242.15849999999992,239.83048061326076,242.41132575973754,243.4184615384616,245.24177797842842,241.59514509849484,227.8104500000001,236.6274,239.1212,242.15849999999992,243.34666666666664,66464888,70729395.85,62.18243457892882,1.5,2.75,1.4169038966179133,0.9397067117744936,-0.008813637695610055,1.458279399646301,1.4670930373419109,4.548311803358444,-0.16382028914280106,8045770194.0,2017-06-15,2017,3,166,6,0.64,243.14,242.83,241.6337,4390
2017-06-16 13:30:00,242.77,242.83,241.6337,242.64,237.4948648648649,245.345,227.93365000000009,236.7778,239.2784,242.4519999999999,239.94065784411325,242.43310425881012,243.50615384615392,245.03838275980647,241.9739249325013,227.93365000000009,236.7778,239.2784,242.4519999999999,242.3679,84553097,69604667.9,54.814012632453604,1.5,2.75,1.468289332573777,1.214761876624082,-0.1339241057420737,1.299687905164319,1.4336120109063928,4.816417441958138,-0.5533013648100426,7961217097.0,2017-06-16,2017,4,167,6,0.5,242.23,244.73,243.48,4391
2017-06-19 13:30:00,243.59,244.73,243.48,244.66,237.5981081081081,245.412,228.07005000000012,236.9287,239.4628,242.76949999999988,240.12573008552056,242.6451895674949,243.75384615384615,244.8485758630522,242.65911644464023,228.07005000000012,236.9287,239.4628,242.76949999999988,244.29,65123802,67110289.35,63.207204665977684,1.5,2.75,1.5126972373899361,0.9703996604806772,-0.08947868653829573,1.321763652733523,1.4112423392718187,7.018202919510324,0.5961925907651776,8026340899.0,2017-06-19,2017,0,170,6,0.51,244.1,244.26,242.99,4392
2017-06-20 13:30:00,244.25,244.26,242.99,243.01,237.70135135135132,245.479,228.19815000000014,237.0655,239.61899999999997,242.94399999999987,240.2388387096178,242.67993341820969,243.7269230769231,244.87498859683723,242.57885755700897,228.19815000000014,237.0655,239.61899999999997,242.94399999999987,243.42,56906368,66905077.65,54.32992772506857,1.5,2.75,1.5239331490049397,0.8505537994843057,-0.17509571055121256,1.1923727010828031,1.3674684116340157,7.904202196901419,-0.26676516457358845,7969434531.0,2017-06-20,2017,1,171,6,0.52,243.62,243.59,242.41,4393
2017-06-21 13:30:00,243.42,243.59,242.41,242.95,237.80459459459462,245.546,228.32105000000013,237.2053,239.7712,243.08899999999986,240.34515876022098,242.70565404504686,243.63307692307689,244.8197305143824,242.44642333177143,228.32105000000013,237.2053,239.7712,243.08899999999986,242.98333333333335,55977569,67286871.95,54.0327459223624,1.5,2.75,1.4993664955045871,0.8319240793597331,-0.23587600435726674,1.0726234061874322,1.308499410544699,7.808028320887197,-0.340470916400038,7913456962.0,2017-06-21,2017,2,172,6,0.49,243.0,243.53,242.64,4394
2017-06-22 13:30:00,242.96,243.53,242.64,242.84,237.90783783783783,245.613,228.44009600000007,237.35819999999995,239.9268,243.20049999999983,240.4429956715849,242.71844889789952,243.54461538461535,244.7820224847457,242.30720828448503,228.44009600000007,237.35819999999995,239.9268,243.20049999999983,243.00333333333333,44148059,67035219.95,53.45544644455647,1.5,2.75,1.4558403172542604,0.6585800573628161,-0.2805561874652547,0.9578041762131306,1.238360363678385,7.792156806713108,-0.2341727948728455,7869308903.0,2017-06-22,2017,3,173,6,0.37,243.08,243.51,242.47,4395
2017-06-23 13:30:00,242.91,243.51,242.47,243.13,238.01108108108107,245.68,228.56069600000006,237.5142,240.10879999999997,243.26899999999983,240.5483683903463,242.75764424095672,243.53846153846158,244.78323760495388,242.29368547196918,228.56069600000006,237.5142,240.10879999999997,243.26899999999983,243.03666666666663,66986801,67180976.95,54.825775382214175,1.5,2.75,1.426137437450384,0.9971096587335352,-0.28663641424065256,0.8800648458775697,1.1667012601182225,7.803330337961676,-0.09451019066404427,7936295704.0,2017-06-23,2017,4,174,6,0.43,242.99,244.38,243.045,4396
2017-06-26 13:30:00,243.9,244.38,243.045,243.29,238.11432432432431,245.747,228.68459600000008,237.6709,240.32439999999997,243.3479999999999,240.65588335543072,242.80834478943703,243.51,244.7592705564317,242.2607294435683,228.68459600000008,237.6709,240.32439999999997,243.3479999999999,243.57166666666663,56700477,67684505.55,55.60241927878048,1.5,2.75,1.4196276204896432,0.8377172373389673,-0.2758471945852239,0.8218922668866924,1.0977394614719165,7.815360609662802,-0.5152320588836717,7992996181.0,2017-06-26,2017,0,177,6,0.55,243.71,243.38,241.31,4397
2017-06-27 13:30:00,243.04,243.38,241.31,241.33,238.21756756756758,245.81400000000002,228.82484600000006,237.80650000000003,240.4596,243.33949999999987,240.68231930227657,242.66755004758588,243.32153846153844,245.01223419735715,241.63084272571973,228.82484600000006,237.80650000000003,240.4596,243.33949999999987,242.0066666666667,82247666,70036794.0,45.32296012077772,1.5,2.75,1.4660827904546685,1.174349385552971,-0.3897148571839344,0.6105958899919983,1.0003107471759327,8.358667223088782,-1.1914510317720262,7910748515.0,2017-06-27,2017,1,178,6,0.86,242.34,243.715,242.23,4398
2017-06-28 13:30:00,242.5,243.715,242.23,243.49,238.32081081081085,245.88099999999997,228.96059600000007,237.94800000000004,240.65199999999996,243.4419999999999,240.79242442767745,242.74587861448242,243.3276923076924,245.02021257408202,241.6351720413026,228.96059600000007,237.94800000000004,240.65199999999996,243.4419999999999,243.145,70042599,68949123.15,55.16111666312414,1.5,2.75,1.53171973399362,1.0158591697768384,-0.3119288936240894,0.6103996301458211,0.9223285237699104,10.214090486342966,-0.11486237026705548,7980791114.0,2017-06-28,2017,2,179,6,0.61,242.97,243.72,239.955,4399
2017-06-29 13:30:00,243.66,243.72,239.955,241.35,239.955,245.948,229.10119600000007,238.0722,240.81019999999992,243.3414999999999,240.81429013639598,242.61293779405557,243.1730769230769,245.16610144516028,241.1800524009936,229.10119600000007,238.0722,240.81019999999992,243.3414999999999,241.675,106949719,70848507.9,46.276924763974584,1.5,2.75,1.6912397529940748,1.509554995158903,-0.3918008242514738,0.4325774934555682,0.824378317707042,11.319422658713894,-0.5316518298714112,7873841395.0,2017-06-29,2017,3,180,6,1.57,241.84,242.71,241.575,4400
2017-06-30 13:30:00,242.28,242.71,241.575,241.8,240.11103448275864,246.015,229.24444600000007,238.2008,240.93939999999992,243.22299999999993,240.8529454251648,242.53551514700263,242.96153846153842,244.90830455557816,241.01477236749875,229.24444600000007,238.2008,240.93939999999992,243.22299999999993,242.0283333333333,86820694,70756236.2,48.16740128823178,1.5,2.75,1.6675797706373563,1.2270394620001002,-0.4001219074094917,0.32422593344517736,0.7243478408546691,11.167384444089285,-1.1689691817215668,7960662089.0,2017-06-30,2017,4,181,6,0.47,242.14,243.38,242.21,4401
2017-07-03 13:30:00,242.88,243.38,242.21,242.21,240.26706896551727,246.082,229.3790960000001,238.3305,241.09179999999992,243.13399999999996,240.90616325162893,242.50451370443096,242.80538461538464,244.63929788209316,240.97147134867612,229.3790960000001,238.3305,241.09179999999992,243.13399999999996,242.6,39153806,70478985.25,49.89732658781084,1.5,2.75,1.6613240727346867,0.5555387306033893,-0.36480084840426896,0.2683467803493329,0.6331476287536019,9.869743696463152,-0.3292045594831418,7999815895.0,2017-07-03,2017,0,184,7,0.48,242.8,243.01,241.7,4402
2017-07-05 13:30:00,242.63,243.01,241.7,242.77,240.42310344827587,246.149,229.52609600000008,238.4522,241.20379999999992,243.11199999999997,240.97925488881995,242.52979811353282,242.72846153846157,244.47593173020041,240.98099134672276,229.52609600000008,238.4522,241.20379999999992,243.11199999999997,242.4933333333333,54427596,70681593.55,52.2418816043196,1.5,2.75,1.6362294961107808,0.7700391752132476,-0.2935732239604566,0.2661810988030311,0.5597543227634877,9.290118069973804,-0.07408931878986558,8054243491.0,2017-07-05,2017,2,186,7,0.54,242.36,242.03,240.34,4403
2017-07-06 13:30:00,241.89,242.03,240.34,240.55,240.5791379310345,246.216,229.66179600000007,238.5426,241.24379999999994,242.95649999999995,240.9624213637682,242.34124591224392,242.56769230769237,244.6672329731317,240.46815164225305,229.66179600000007,238.5426,241.24379999999994,242.95649999999995,240.97333333333336,66115317,71280143.85,43.54293177337683,1.5,2.75,1.6929273892457255,0.9275418570861934,-0.3803179223488477,0.0843569198274281,0.4646748421762758,10.654831538528065,-0.943007741722942,7988128174.0,2017-07-06,2017,3,187,7,0.7,241.18,242.28,240.5645,4404
2017-07-07 13:30:00,241.21,242.28,240.5645,242.11,240.7351724137931,246.283,229.80524600000007,238.636,241.31799999999996,242.873,241.007424447542,242.31922249203018,242.37153846153853,244.09537757864476,240.64769934443237,229.80524600000007,238.636,241.31799999999996,242.873,241.65150000000003,57972268,70881222.7,49.860944178015025,1.5,2.75,1.6955754328710302,0.8178790629129483,-0.3194317211214723,0.06538519077443539,0.3848169118959077,11.487776134208849,-0.4195286472257565,8046100442.0,2017-07-07,2017,4,188,7,0.71,241.42,242.8,241.76,4405
2017-07-10 13:30:00,241.95,242.8,241.76,242.37,240.8912068965517,246.35,229.93799600000008,238.7227,241.39339999999996,242.821,241.06085878293248,242.32405844517018,242.3223076923077,244.00649941984523,240.63811596477024,229.93799600000008,238.7227,241.39339999999996,242.821,242.31,36663274,66101568.3,50.848211830588276,1.5,2.75,1.6487486162373866,0.5546505921554663,-0.2514400008349161,0.07051691085226253,0.32195691168717866,11.482274707198716,-0.3781495334785596,8082763716.0,2017-07-10,2017,0,191,7,0.43,242.28,242.55,240.85,4406
2017-07-11 13:30:00,242.16,242.55,240.85,242.19,241.04724137931038,246.417,230.06304600000007,238.7954,241.47559999999996,242.7625,241.10513883066062,242.3112909742016,242.26384615384617,243.90913852366128,240.61855378403115,230.06304600000007,238.7954,241.47559999999996,242.7625,241.8633333333333,50354614,64313893.9,50.11253184331774,1.5,2.75,1.6524094293632887,0.7829507894249893,-0.21006560664400054,0.05937490338217799,0.2694405100261785,11.467098823818654,0.35635851323912704,8032409102.0,2017-07-11,2017,1,192,7,0.71,241.7,244.2,243.3,4407
2017-07-12 13:30:00,243.3,244.2,243.3,244.01,241.20327586206898,246.484,230.2031460000001,238.8883,241.58219999999997,242.73549999999997,241.21905495494843,242.4730727861824,242.35384615384618,244.22751041177085,240.4801818959215,230.2031460000001,238.8883,241.58219999999997,242.73549999999997,243.83666666666667,59610405,64291066.5,56.90224559943663,1.5,2.75,1.677951612980196,0.9271957714373894,-0.05942924125321801,0.19515395845965602,0.254583199712874,11.152065924973996,0.21356113187399145,8092019507.0,2017-07-12,2017,2,193,7,0.37,243.75,244.55,243.76,4408
2017-07-13 13:30:00,244.02,244.55,243.76,244.42,241.35931034482758,246.551,230.35404600000007,238.9816,241.69519999999997,242.7445,241.34458221161708,242.6584944255936,242.4530769230769,244.59770003308373,240.30845381307012,230.35404600000007,238.9816,241.69519999999997,242.7445,244.2433333333333,39471637,62334532.8,58.27978396339033,1.5,2.75,1.6145264977673264,0.6332226332175221,0.061946349020168164,0.3320161359880842,0.2700697869679161,10.016899949082534,1.2720116014087397,8131491144.0,2017-07-13,2017,3,194,7,0.32,244.16,245.97,244.31,4409
2017-07-14 13:30:00,244.43,245.97,244.31,245.56,241.51534482758626,246.618,230.5039960000001,239.0723,241.83679999999995,242.834,241.50989271312235,242.9348282898228,242.62769230769237,245.3169433197397,239.93844129564502,230.5039960000001,239.0723,241.83679999999995,242.834,245.28,60262692,62024423.0,61.92401487152818,1.5,2.75,1.6177746050696598,0.9715961726882972,0.20506484964658397,0.526400849026146,0.32133599937956203,8.331426532908507,1.5550041356492932,8191753836.0,2017-07-14,2017,4,195,7,0.68,245.14,245.91,245.33,4410
2017-07-17 13:30:00,245.47,245.91,245.33,245.53,241.67137931034486,246.685,230.64844600000006,239.1648,241.97219999999996,242.97849999999997,241.6675439792744,243.18198750031587,242.95076923076928,245.93207985155442,239.96945860998417,230.64844600000006,239.1648,241.97219999999996,242.97849999999997,245.59,33531917,59473364.0,61.77110139214972,1.5,2.75,1.5436478475646829,0.5638140294199602,0.2791748260178065,0.6703045319018202,0.3911297058840136,8.397236716598979,1.3707113661698498,8158221919.0,2017-07-17,2017,0,198,7,0.24,245.62,245.72,244.67,4411
2017-07-18 13:30:00,245.06,245.72,244.67,245.66,241.82741379310346,246.752,230.8033460000001,239.257,242.09139999999994,243.02849999999995,241.824110882048,243.41798869076197,243.11769230769238,246.4261258561008,239.8092587592839,230.8033460000001,239.257,242.09139999999994,243.02849999999995,245.35,42742498,58354298.8,62.2066224427164,1.5,2.75,1.508387287024349,0.7324652832603311,0.31572115919192223,0.7857811548739164,0.4700599956819942,8.41548623689627,1.1904271532726391,8200964417.0,2017-07-18,2017,1,199,7,0.43,245.2,247.0,246.01,4412
2017-07-19 13:30:00,246.02,247.0,246.01,246.99,241.9834482758621,246.81900000000002,230.95679600000008,239.3595,242.23799999999991,243.22749999999994,242.02669476902645,243.75818024402272,243.5515384615385,247.27244692092327,239.8306300021537,230.95679600000008,239.3595,242.23799999999991,243.22749999999994,246.66666666666663,51034260,58060693.4,66.4213850257471,1.5,2.75,1.4963596236654677,0.8789812351776013,0.40266911355940815,0.9733963876312544,0.5707272740718462,8.716417020443066,2.6771980877156505,8251998677.0,2017-07-19,2017,2,200,7,0.4,246.5,247.42,246.47,4413
2017-07-20 13:30:00,247.28,247.42,246.47,247.1,242.13948275862072,246.886,231.11339600000008,239.4594,242.3911999999999,243.43499999999997,242.22564791533915,244.07644879221104,243.9592307692308,247.97304124757716,239.94542029088447,231.11339600000008,239.4594,242.3911999999999,243.43499999999997,246.99666666666667,47135183,57618574.1,66.7516430103476,1.5,2.75,1.4573339362607904,0.8180553534385364,0.4378745579876833,1.1180704715564502,0.6801959135687672,5.4536081527612685,2.0610466316963283,8299133860.0,2017-07-20,2017,3,201,7,0.39,246.94,246.91,246.18,4414
2017-07-21 13:30:00,246.44,246.91,246.18,246.88,242.2955172413793,246.953,231.27439600000008,239.56349999999995,242.53139999999988,243.63699999999997,242.40817152650231,244.3434536691433,244.3184615384616,248.47513066465888,240.16179241226428,231.27439600000008,239.56349999999995,242.53139999999988,243.63699999999997,246.65666666666667,88711019,59846722.1,65.36691893956561,1.5,2.75,1.41895294081359,1.4823037233646583,0.4167454382834988,1.2011277114231405,0.7843822731396417,5.2181671503092595,1.8607913520650208,8210422841.0,2017-07-21,2017,4,202,7,0.3,246.54,246.98,246.28,4415
2017-07-24 13:30:00,246.79,246.98,246.28,246.82,242.45155172413794,247.02,231.43034600000007,239.63389999999995,242.68019999999993,243.82149999999996,242.58118440781598,244.57931522446302,244.63000000000005,248.8817471521672,240.3782528478329,231.43034600000007,239.63389999999995,242.68019999999993,243.82149999999996,246.69333333333333,46622256,58828494.85,64.97106540850099,1.5,2.75,1.3675991593269043,0.7925114541665007,0.3706755075900899,1.247726657627254,0.8770511500371642,5.351817222910948,1.911722201577272,8163800585.0,2017-07-24,2017,0,205,7,0.28,246.63,247.8,247.16,4416
2017-07-25 13:30:00,247.68,247.8,247.16,247.42,242.60758620689654,247.08700000000002,231.58854600000006,239.72539999999992,242.84899999999993,244.02799999999996,242.77094188201926,244.849856631657,245.1584615384616,248.93118017586482,241.3857429010584,231.58854600000006,239.72539999999992,242.84899999999993,244.02799999999996,247.46,54915591,58739250.55,67.11568371230956,1.5,2.75,1.3399135050892697,0.9349045227135606,0.3526630353042581,1.3178799441674869,0.9652169088632288,5.100365293129405,1.397483709684028,8218716176.0,2017-07-25,2017,1,206,7,0.26,247.48,247.79,247.13,4417
2017-07-26 13:30:00,247.75,247.79,247.13,247.43,242.7636206896552,247.15400000000002,231.75049600000008,239.8155,242.99159999999992,244.33299999999997,242.95365004350867,245.0955845714992,245.5676923076923,249.07365341892327,242.0617311964613,231.75049600000008,239.8155,242.99159999999992,244.33299999999997,247.45,47575422,57005638.35,67.15178048271994,1.5,2.75,1.2913482547257502,0.8345739715762696,0.3147244659001425,1.3586224912384068,1.0438980253382644,3.891732537871317,1.2314867850421485,8266291598.0,2017-07-26,2017,2,207,7,0.27,247.46,248.0,245.68,4418
2017-07-27 13:30:00,247.96,248.0,245.68,247.2,242.91965517241383,247.22099999999998,231.90569600000006,239.9104,243.13399999999996,244.5185,243.12017357121425,245.2960050884993,245.93923076923082,249.00732425427898,242.87113728418254,231.90569600000006,239.9104,243.13399999999996,244.5185,246.96,70766568,57041836.8,65.37432286748631,1.5,2.75,1.3648233793881963,1.240608156573247,0.25025184731738426,1.3567128344849948,1.1064609871676103,4.1030219272084345,0.6678612151816201,8195525030.0,2017-07-27,2017,3,208,7,0.94,246.84,247.06,246.13,4419
2017-07-28 13:30:00,246.65,247.06,246.13,246.91,243.07568965517243,247.288,232.07309600000008,240.0095,243.35579999999996,244.79649999999992,243.26879421548043,245.44971888959458,246.3023076923077,248.50474206356296,244.09987332105243,232.07309600000008,240.0095,243.35579999999996,244.79649999999992,246.7,50088359,54198768.8,63.1061898223585,1.5,2.75,1.3437645665747533,0.924160458050848,0.1681285275516171,1.316621646607132,1.1484931190555148,3.60637668613657,0.5620494440597872,8145436671.0,2017-07-28,2017,4,209,7,0.38,246.6,247.48,246.53,4420
2017-07-31 13:30:00,247.37,247.48,246.53,246.77,243.23172413793102,247.355,232.23839600000008,240.11159999999995,243.55579999999995,245.04499999999996,243.4060964031086,245.57545994772843,246.51461538461533,248.28122213435105,244.7480086348796,232.23839600000008,240.11159999999995,243.55579999999995,245.04499999999996,246.92666666666665,65838659,53149667.05,61.98808059238447,1.5,2.75,1.315638526105127,1.2387407608416994,0.08843658100917162,1.2590388453169794,1.1706022643078078,3.645379067198757,0.4518440120491792,8079598012.0,2017-07-31,2017,0,212,7,0.39,247.0,247.5,246.71599999999998,4421
2017-08-01 13:30:00,247.46,247.5,246.71599999999998,247.32,243.3877586206897,247.422,232.40994600000005,240.2162,243.736,245.30049999999991,243.559582818673,245.74160661937336,246.7376923076923,248.0686527208217,245.4067318945628,232.40994600000005,240.2162,243.736,245.30049999999991,247.1786666666667,55050401,53944496.8,64.63877074230433,1.5,2.75,1.2776643456690462,1.0205007788672154,0.05827877879923625,1.2434507378068531,1.1851719590076168,3.7770977264805086,0.13360864812339934,8134648413.0,2017-08-01,2017,1,213,8,0.32,247.11,247.6,246.37,4422
2017-08-02 13:30:00,247.47,247.6,246.37,247.44,243.5437931034483,247.489,232.5815460000001,240.31369999999995,243.8944,245.53399999999988,243.7117560414701,245.90335836990926,246.8823076923077,248.07092431150744,245.69369107310789,232.5815460000001,240.31369999999995,243.8944,245.53399999999988,247.13666666666668,47211216,53583677.8,65.20881893931822,1.5,2.75,1.2742597495498278,0.8810745723019409,0.033174515879251576,1.2266401038566812,1.1934655879774296,2.2903895045399447,0.1375961149332268,8181859629.0,2017-08-02,2017,2,214,8,0.5,246.98,247.34,246.64,4423
2017-08-03 13:30:00,247.31,247.34,246.64,246.96,243.6998275862069,247.556,232.7544460000001,240.40519999999992,244.03259999999997,245.85449999999986,243.83913815749088,246.00399090610838,246.9923076923077,247.8887332040841,246.09588218053125,232.7544460000001,240.40519999999992,244.03259999999997,245.85449999999986,246.98000000000005,40855997,52320711.8,60.974558548936045,1.5,2.75,1.2403840531534125,0.7808761691961539,-0.02581248929483415,1.161199976358887,1.1870124656537209,2.5804896207849093,0.032404406999356976,8141003632.0,2017-08-03,2017,3,215,8,0.28,246.99,247.79,246.97,4424
2017-08-04 13:30:00,247.52,247.79,246.97,247.41,243.85586206896556,247.623,232.92294600000008,240.51029999999992,244.16859999999997,246.11949999999987,243.97917195523632,246.13789653409802,247.12692307692302,247.61539854618184,246.63844760766426,232.92294600000008,240.51029999999992,244.16859999999997,246.11949999999987,247.39,60191838,52431690.3,63.375589873336295,1.5,2.75,1.211070906499596,1.148004911830966,-0.04353508537850392,1.1325936089305912,1.1761286943090952,2.7244989330069123,0.2390405963860317,8201195470.0,2017-08-04,2017,4,216,8,0.33,247.38,247.87,247.37,4425
2017-08-07 13:30:00,247.49,247.87,247.37,247.87,244.01189655172416,247.69,233.09089600000007,240.59949999999992,244.29079999999996,246.39449999999988,244.13175344718783,246.30285876894584,247.19461538461536,247.81462111089286,246.57460965833783,233.09089600000007,240.59949999999992,244.29079999999996,246.39449999999988,247.70333333333332,31995021,52198277.65,65.69880413082592,1.5,2.75,1.160280127463911,0.6129516612508382,-0.033727499592836274,1.1339693198180498,1.167696819410886,2.8584680782373417,0.1818769703338522,8233190491.0,2017-08-07,2017,0,219,8,0.2,247.62,248.91,246.83,4426
2017-08-08 13:30:00,247.51,248.91,246.83,247.26,244.1679310344828,248.91,233.25779600000013,240.68729999999988,244.4018,246.6479999999999,244.25442978259224,246.39401507666526,247.2069230769231,247.8252774495812,246.588568704265,233.25779600000013,240.68729999999988,244.4018,246.6479999999999,247.66666666666663,61719353,52766514.6,60.24158143583017,1.5,2.75,1.2259744040736305,1.1696689362158477,-0.0753866875038347,1.0734634600310926,1.148850147534927,2.979539768601169,-0.06870630077194192,8171471138.0,2017-08-08,2017,1,220,8,0.84,247.87,247.31,246.06,4427
2017-08-09 13:30:00,246.47,247.31,246.06,247.25,244.3239655172414,249.00512195121948,233.42414600000006,240.78949999999992,244.5168,246.80999999999992,244.37190312445136,246.4755374503162,247.23538461538465,247.82428791873218,246.64648131203705,233.42414600000006,240.78949999999992,244.5168,246.80999999999992,246.8733333333333,62632619,52917625.3,60.1533691618993,1.5,2.75,1.2276905180683713,1.1835871062793135,-0.10865798882137878,1.0130276615082041,1.121685650329583,2.9788590058803868,0.020226537216833082,8108838519.0,2017-08-09,2017,2,221,8,0.51,246.68,246.44,243.7,4428
2017-08-10 13:30:00,246.29,246.44,243.7,243.76,244.48,249.10024390243905,233.56849600000007,240.85939999999988,244.5632,246.77699999999993,244.34790692349247,246.2169148360004,247.0,248.9464049701497,245.05359502985024,233.56849600000007,240.85939999999988,244.5632,246.77699999999993,244.63333333333333,120479470,56968016.95,38.79974372293368,1.5,2.75,1.3935697667777742,2.1148615740959187,-0.3567656052789412,0.6757286437309062,1.0324942490098474,8.670190329596794,-1.2757684986432327,7988359049.0,2017-08-10,2017,3,222,8,1.12,245.07,244.8,243.75,4429
2017-08-11 13:30:00,244.02,244.8,243.75,244.12,244.63603448275865,249.19536585365853,233.7182460000001,240.96329999999983,244.5784,246.7049999999999,244.338969397081,246.0172086611432,246.74615384615385,249.2014719482394,244.29083574406815,233.7182460000001,240.96329999999983,244.5784,246.7049999999999,244.22333333333336,74869947,57698379.7,41.12156958720324,1.5,2.75,1.3690290691507911,1.2976091770563185,-0.48001110408339703,0.4324803689056012,0.912491472988998,8.827145042376593,-1.0738744579973276,8063228996.0,2017-08-11,2017,4,223,8,0.43,244.28,246.79,245.55,4430
2017-08-14 13:30:00,245.59,246.79,245.55,246.54,244.79206896551727,249.29048780487804,233.88224600000012,241.08589999999992,244.6258,246.75549999999993,244.4252843226857,246.06699831246289,246.6776923076923,249.10236235786667,244.2530222575179,233.88224600000012,241.08589999999992,244.6258,246.75549999999993,246.2933333333333,73291919,59686379.8,53.80802927681914,1.5,2.75,1.461955564211448,1.227950484609556,-0.3859762839563542,0.43002111804355536,0.8159974019999096,10.862752420826917,-0.31538088306647305,8136520915.0,2017-08-14,2017,0,226,8,0.5,246.17,247.0,246.16,4431
2017-08-15 13:30:00,246.98,247.0,246.16,246.51,244.94810344827587,249.38560975609755,234.04894600000014,241.21069999999992,244.6762,246.79799999999992,244.50703787865882,246.10918894937117,246.62461538461537,249.0313701787743,244.21786059045638,234.04894600000014,241.21069999999992,244.6762,246.79799999999992,246.55666666666664,55242746,60311392.2,53.65369073470696,1.5,2.75,1.4175301667677735,0.9159587266168264,-0.31615738832574697,0.42080066659272575,0.7369580549184728,10.762649249158496,-0.3758486905916613,8081278169.0,2017-08-15,2017,1,227,8,0.34,246.58,247.57,246.45,4432
2017-08-16 13:30:00,247.11,247.57,246.45,246.94,245.1041379310345,249.48073170731703,234.2209460000002,241.34149999999988,244.75080000000003,246.79549999999992,244.60244815792703,246.18831381133583,246.6269230769231,249.03482525506885,244.2190208987773,234.2209460000002,241.34149999999988,244.75080000000003,246.79549999999992,246.98666666666668,56715544,60595456.4,55.61867663928008,1.5,2.75,1.396278011998647,0.9359702421516872,-0.2350998749120989,0.4430832112783492,0.6781830861904481,10.821315298756037,-0.008098477486236731,8137993713.0,2017-08-16,2017,2,228,8,0.45,247.01,246.6,243.09,4433
2017-08-17 13:30:00,246.24,246.6,243.09,243.09,245.26017241379316,249.57585365853657,234.37364600000012,241.43619999999987,244.7394,246.59499999999989,244.54313646545933,245.89323630549438,246.34384615384616,249.3967694788797,243.29092282881268,234.37364600000012,241.43619999999987,244.7394,246.59499999999989,244.26,128490396,64663217.05,39.47919637537088,1.5,2.75,1.5715438682844578,1.9870708860749453,-0.42385114336346186,0.14836915698612074,0.5722203003495826,14.031880322058447,-1.7460894870862105,8009503317.0,2017-08-17,2017,3,229,8,1.44,244.84,244.18900000000002,242.2,4434
2017-08-18 13:30:00,242.9,244.18900000000002,242.2,242.71,245.41620689655176,249.67097560975608,234.53214600000013,241.51009999999988,244.718,246.38649999999993,244.4712487609315,245.59007094306634,245.9892307692308,249.53707051533226,242.44139102312928,234.53214600000013,241.51009999999988,244.718,246.38649999999993,243.033,136747986,67065065.4,38.29791970064772,1.5,2.75,1.6013621634069968,2.0390345582217235,-0.5494053398948817,-0.11453637451901955,0.43486896537586217,13.86564936646182,-2.0817363940775397,7872755331.0,2017-08-18,2017,4,230,8,0.82,243.19,243.2,241.83,4435
2017-08-21 13:30:00,242.64,243.2,241.83,242.9,241.83,249.7660975609756,234.69794600000012,241.58369999999988,244.7078,246.19049999999987,244.4096311624636,245.3338737103933,245.64,249.43316794738243,241.8468320526176,234.69794600000012,241.58369999999988,244.7078,246.19049999999987,242.6433333333333,65469736,68007439.4,39.27627459111954,1.5,2.75,1.5848362945922096,0.9626849147330196,-0.5911388033480021,-0.30405453880914024,0.2870842645388617,13.772182385219285,-1.7633260535468678,7938225067.0,2017-08-21,2017,0,233,8,0.57,242.52,245.62,243.55,4436
2017-08-22 13:30:00,243.57,245.62,243.55,245.44,241.88208333333336,249.86121951219508,234.88124600000015,241.67519999999985,244.7494,246.09149999999985,244.45003778354342,245.34398097607018,245.5230769230769,249.23920712380797,241.8069467223459,234.88124600000015,241.67519999999985,244.7494,246.09149999999985,244.87,63140101,68418664.9,50.56184823393484,1.5,2.75,1.6659194164070517,0.922849066000994,-0.4268284831901835,-0.2464513394488677,0.18037714374131586,15.489919089223314,-0.7320525783619827,8001365168.0,2017-08-22,2017,1,234,8,0.85,244.58,245.05,244.16,4437
2017-08-23 13:30:00,244.33,245.05,244.16,244.56,241.93416666666667,249.95634146341462,235.0612960000001,241.76339999999985,244.7496,245.9479999999999,244.4543500273261,245.26931612120637,245.30384615384617,248.88256563659493,241.72512667109746,235.0612960000001,241.76339999999985,244.7496,245.9479999999999,244.59,50203837,68550085.65,47.28312299581271,1.5,2.75,1.638353743806548,0.7323672395732447,-0.35927091149374496,-0.2687114956258654,0.09055941586787958,15.565034468035766,0.3281916639317408,7951161331.0,2017-08-23,2017,2,235,8,0.36,244.6,245.18,243.75,4438
2017-08-24 13:30:00,245.0,245.18,243.75,243.99,241.98625,250.05146341463416,235.21549600000012,241.84999999999985,244.7446,245.78749999999985,244.43614022233288,245.14747649061528,245.00538461538463,248.31534734244144,241.69542188832787,235.21549600000012,241.84999999999985,244.7446,245.78749999999985,244.30666666666667,50741671,67548840.8,45.236905297866535,1.5,2.75,1.6234713335346522,0.7511849263296314,-0.3352952407988085,-0.328559635130631,0.00673560566817745,13.222339901877339,-0.053252498771094316,7900419660.0,2017-08-24,2017,3,236,8,0.59,244.46,245.61,244.39,4439
2017-08-25 13:30:00,244.9,245.61,244.39,244.56,242.03833333333336,250.1465853658537,235.36774600000007,241.94079999999988,244.7604,245.66999999999993,244.4409974685159,245.0915263486519,244.79769230769242,247.84404350566933,241.7513411097154,235.36774600000007,241.94079999999988,244.7604,245.66999999999993,244.8533333333333,64445912,68266718.45,47.67547761484933,1.5,2.75,1.6232233811393202,0.9440311979724286,-0.2663763631764778,-0.3262348483024198,-0.059858485125942,13.264118473397627,-0.8031151131662164,7964865572.0,2017-08-25,2017,4,237,8,0.5,245.0,245.2,244.09,4440
2017-08-28 13:30:00,245.17,245.2,244.09,244.57,242.09041666666667,250.24170731707318,235.5087000000001,242.03869999999992,244.799,245.55999999999986,244.4460563913192,245.04185717258983,244.59153846153853,247.28890864697425,241.89416827610282,235.5087000000001,242.03869999999992,244.799,245.55999999999986,244.62,40565606,67003065.8,47.719461899539795,1.5,2.75,1.5865645682007965,0.605429102618764,-0.2080315617184406,-0.31989793727399274,-0.11186637555555216,11.755429034053536,-0.786986329155003,8005431178.0,2017-08-28,2017,0,240,8,0.45,244.64,245.15,242.93,4441
2017-08-29 13:30:00,243.06,245.15,242.93,244.85,242.1425,250.3368292682927,235.64835000000008,242.13279999999992,244.8028,245.43649999999988,244.46189731714986,245.0235850609146,244.67538461538467,247.33160072553972,242.0191685052296,235.64835000000008,242.13279999999992,244.8028,245.43649999999988,244.31000000000003,51135715,66807331.5,49.011882736652716,1.5,2.75,1.6318099561864536,0.7654207083544416,-0.14166800200858762,-0.2889513780662867,-0.14728337605769906,11.804467974098575,-0.8463594395399706,8056566893.0,2017-08-29,2017,1,241,8,0.91,244.04,246.32,244.62,4442
2017-08-30 13:30:00,244.83,246.32,244.62,246.01,242.19458333333336,250.43195121951217,235.7963000000001,242.2408999999999,244.8628,245.36499999999992,244.5226072262812,245.11752934082747,244.82076923076926,247.54548755401333,242.0960509075253,235.7963000000001,242.2408999999999,244.8628,245.36499999999992,245.65,62030805,67548310.95,54.076887508461674,1.5,2.75,1.636680673601706,0.9183176326335662,-0.017274893243610367,-0.168876992612212,-0.15160209936860164,12.146490031431696,1.201201201201196,8118597698.0,2017-08-30,2017,2,242,8,0.69,245.47,247.77,246.0473,4443
2017-08-31 13:30:00,246.72,247.77,246.0473,247.49,242.24666666666667,250.5270731707317,235.9508000000001,242.3623999999999,244.9536,245.39149999999992,244.63897557034863,245.3434789274154,244.89384615384625,247.84096509602074,241.94672721167169,235.9508000000001,242.3623999999999,244.9536,245.39149999999992,247.10243333333332,103803880,70695705.1,59.592137136977435,1.5,2.75,1.6454891969158714,1.4683194665527144,0.15743014573633815,0.045185582801821056,-0.1122445629345171,7.701786442478743,1.9694285361130568,8222401578.0,2017-08-31,2017,3,243,8,0.7,246.91,248.33,247.67,4444
2017-09-01 13:30:00,247.92,248.33,247.67,247.84,242.29875,250.6221951219512,236.0986000000001,242.49019999999985,245.0536,245.41299999999995,244.7645059401389,245.58124283909007,244.9961538461539,248.23817162681686,241.75413606549088,236.0986000000001,242.49019999999985,245.0536,245.41299999999995,247.9466666666667,62006989,70786462.65,60.79137808586914,1.5,2.75,1.5879542542790237,0.8759724201305318,0.2820386257802823,0.2403037192908357,-0.041734906489446534,7.411498502565258,2.0337587484561537,8284408567.0,2017-09-01,2017,4,244,9,0.27,248.0,247.52,244.95,4445
2017-09-05 13:30:00,247.26,247.52,244.95,246.06,242.35083333333336,250.71731707317073,236.23955000000007,242.61049999999992,245.1122,245.32249999999996,244.8153096287609,245.62683875917682,244.92846153846162,248.03940347997607,241.8175195969471,236.23955000000007,242.61049999999992,245.1122,245.32249999999996,246.17666666666665,91398777,73756650.45,52.29157386646733,1.5,2.75,1.6809575218305233,1.2391937058199205,0.2321409237748252,0.24844124822908495,0.01630032445425978,9.140039306559274,0.2526075619295977,8193009790.0,2017-09-05,2017,1,248,9,1.05,246.24,247.28,246.23,4446
2017-09-06 13:30:00,246.84,247.28,246.23,246.9,242.40291666666667,250.81243902439027,236.37910000000008,242.75439999999992,245.18439999999995,245.30449999999993,244.8970621923389,245.7480922106837,245.2215384615385,248.30218620718185,242.14089071589515,236.37910000000008,242.75439999999992,245.18439999999995,245.30449999999993,246.8033333333333,57916867,73566526.15,55.45671543230772,1.5,2.75,1.648031984556914,0.7872720112121264,0.24215503067820546,0.3189941128020166,0.07683908212381116,7.2866297590619835,0.9568204121687944,8250926657.0,2017-09-06,2017,2,249,9,0.43,246.76,247.27,246.4,4447
2017-09-07 13:30:00,247.25,247.27,246.4,246.87,242.455,250.9075609756097,236.52095000000008,242.87739999999994,245.2952,245.28549999999993,244.97443230244326,245.854940571571,245.5415384615385,248.36572897763858,242.71734794543843,236.52095000000008,242.87739999999994,245.2952,245.28549999999993,246.84666666666664,58034730,73336631.7,55.31556829313502,1.5,2.75,1.5924582713742776,0.7913470888246426,0.2331224548704429,0.3682421507118647,0.13511969584142186,6.81537333071746,1.1803762449280688,8192891927.0,2017-09-07,2017,3,250,9,0.35,246.84,247.11,246.3,4448
2017-09-08 13:30:00,246.54,247.11,246.3,246.58,242.50708333333336,251.0026829268293,236.65310000000008,243.00449999999992,245.357,245.42649999999992,245.03739574156316,245.923993850469,245.8246153846154,248.24129607562932,243.40793469360156,236.65310000000008,243.00449999999992,245.357,245.42649999999992,246.66333333333333,63832825,70504299.45,53.88776130030695,1.5,2.75,1.5365683948475437,0.905374927457704,0.19550136406125165,0.3794964009179864,0.1839950368567348,6.642476052996655,0.8259731763166545,8129059102.0,2017-09-08,2017,4,251,9,0.33,246.7,249.3,248.02,4449
2017-09-11 13:30:00,248.04,249.3,248.02,249.21,242.55916666666667,251.09780487804883,236.79625000000007,243.16219999999996,245.5142,245.68099999999993,245.2010272811097,246.236946817091,246.1146153846154,249.11208729774924,243.1171434714816,236.79625000000007,243.16219999999996,245.5142,245.68099999999993,248.84333333333333,71364848,70329044.5,63.171938480716754,1.5,2.75,1.6210992237870048,1.0147279620726255,0.32783569683991315,0.5937896579066262,0.26595396106671304,8.622075793994469,1.8972073435008443,8200423950.0,2017-09-11,2017,0,254,9,0.52,248.66,250.09,249.42,4450
2017-09-12 13:30:00,249.63,250.09,249.42,250.05,242.61125,251.19292682926832,236.94300000000013,243.30929999999992,245.67919999999995,245.85649999999995,245.3911830740073,246.6000947392728,246.5369230769231,250.04307928581247,243.0307668680337,236.94300000000013,243.30929999999992,245.67919999999995,245.85649999999995,249.8533333333333,56896027,69509249.9,65.5571891188956,1.5,2.75,1.5681635649450756,0.8185389294497335,0.4447767900423066,0.8219249486195963,0.3771481585772897,8.573136455978382,2.1237492342250426,8257319977.0,2017-09-12,2017,1,255,9,0.27,249.76,250.21,249.59,4451
2017-09-13 13:30:00,249.72,250.21,249.59,250.17,242.66333333333336,251.28804878048783,237.08625000000012,243.46509999999992,245.8384,246.03949999999992,245.5785876593404,246.9400857164849,247.01230769230773,250.68034975101943,243.34426563359608,237.08625000000012,243.46509999999992,245.8384,246.03949999999992,249.99000000000004,59228002,69708512.7,65.8969977593829,1.5,2.75,1.5004375960204277,0.8496523552997853,0.4989769993308942,1.0008694077409075,0.5018924084100133,8.61182344696538,1.690988171212551,8316547979.0,2017-09-13,2017,2,256,9,0.25,249.9,250.32,249.6,4452
2017-09-14 13:30:00,249.8,250.32,249.6,250.09,242.71541666666667,251.3831707317073,237.23430000000008,243.59429999999992,245.98479999999995,246.19699999999997,245.75550579034663,247.24007755301014,247.4376923076924,251.15183288617717,243.7235517292076,237.23430000000008,243.59429999999992,245.98479999999995,246.19699999999997,250.00333333333333,95446349,71645052.95,65.43351932176098,1.5,2.75,1.4446920534475398,1.3322112981982241,0.4971103712650588,1.1232803724913367,0.626170001226278,8.546102960121656,1.050547496868558,8221101630.0,2017-09-14,2017,3,257,9,0.29,249.96,249.29,248.57,4453
2017-09-15 13:30:00,248.69,249.29,248.57,249.19,242.7675,251.47829268292682,237.37570000000008,243.70069999999996,246.1576,246.50199999999992,245.89019183778402,247.4257844527235,247.79307692307702,251.2142003068787,244.3719535392753,237.37570000000008,243.70069999999996,246.1576,246.50199999999992,249.01666666666665,95432382,69992152.25,60.29560597347447,1.5,2.75,1.450071192487002,1.3634726027445456,0.4067364880465958,1.1345906112845228,0.727854123237927,8.533095187716285,0.5447062621045813,8125669248.0,2017-09-15,2017,4,258,9,0.29,248.93,250.12,249.28,4454
2017-09-18 13:30:00,249.61,250.12,249.28,249.72,242.81958333333336,251.5734146341464,237.5224000000001,243.81389999999996,246.3098,246.85249999999994,246.040380393165,247.6442811715117,248.16769230769242,251.26931623815796,245.06606837722683,237.5224000000001,243.81389999999996,246.3098,246.85249999999994,249.70666666666668,46235238,65466514.85,62.17898495780754,1.5,2.75,1.4129232501665023,0.7062425440843518,0.3559577447916625,1.1728013042275052,0.8168435594358426,8.564951939521404,1.4874420872957799,8171904486.0,2017-09-18,2017,0,261,9,0.34,249.7,250.07,249.6,4455
2017-09-19 13:30:00,250.0,250.07,249.6,249.97,242.87166666666667,251.66853658536584,237.6744000000001,243.9276,246.46179999999995,247.206,246.19448312284484,247.86577820279632,248.4723076923077,251.44146353035802,245.5031518542574,237.6744000000001,243.9276,246.46179999999995,247.206,249.88,47108148,64548435.45,63.06888332479072,1.5,2.75,1.3455715894403235,0.7298108416042174,0.313978128237667,1.2093162197329264,0.8953380914952593,6.911775570625501,1.243418388011338,8219012634.0,2017-09-19,2017,1,262,9,0.19,249.83,250.19,248.92,4456
2017-09-20 13:30:00,250.07,250.19,248.92,250.06,242.92375,251.76365853658533,237.8263000000001,244.04739999999995,246.61919999999992,247.437,246.34607201998818,248.0747517072919,248.67,251.6929583065673,245.64704169343273,237.8263000000001,244.04739999999995,246.61919999999992,247.437,249.72333333333336,59574083,64370134.55,63.40272698977954,1.5,2.75,1.3401736187660156,0.9254925970944704,0.2687878288238854,1.2313228775251162,0.9625350487012309,6.837359934289234,1.2921780694292533,8278586717.0,2017-09-20,2017,2,263,9,0.51,249.56,249.98,249.185,4457
2017-09-21 13:30:00,249.88,249.98,249.185,249.39,242.97583333333336,251.85878048780492,237.96825000000013,244.15449999999996,246.72679999999988,247.6785,246.4654417446945,248.20001344945462,248.7892307692308,251.79405214154232,245.7844093969192,237.96825000000013,244.15449999999996,246.72679999999988,247.6785,249.5183333333333,48211398,64270512.6,59.11832881749343,1.5,2.75,1.3069469317113005,0.750132464323927,0.17484003943006576,1.181085097988813,1.0062450585587472,7.1770441668943725,1.1395895855300404,8230375319.0,2017-09-21,2017,3,264,9,0.32,249.58,249.63,249.02,4458
2017-09-22 13:30:00,249.05,249.63,249.02,249.44,243.02791666666667,251.9539024390244,238.10695000000013,244.26119999999992,246.82719999999992,247.951,246.58209108803985,248.31810740664935,249.04923076923077,251.61768389894866,246.48077763951284,238.10695000000013,244.26119999999992,246.82719999999992,247.951,249.3633333333333,51214032,64294130.65,59.33914873307621,1.5,2.75,1.2571650080176349,0.7965584335963022,0.10080712040004293,1.1322539590588008,1.031446838658758,7.066201991905607,0.09229164158741213,8281589351.0,2017-09-22,2017,4,265,9,0.24,249.32,249.5532,248.08,4459
2017-09-25 13:30:00,249.15,249.5532,248.08,248.93,243.08,252.04902439024391,238.2286000000001,244.36569999999992,246.8945999999999,248.1695,246.67416594733243,248.37638289173043,249.2053846153846,251.45982454773377,246.9509446830354,238.2286000000001,244.36569999999992,246.8945999999999,248.1695,248.85440000000003,57064357,63925052.9,56.01558992352879,1.5,2.75,1.2725960788735176,0.8926759448954636,0.007169732691563623,1.0404090045232124,1.0332392718316488,3.8966109971953986,-0.4479104179164185,8224524994.0,2017-09-25,2017,0,268,9,0.59,248.82,249.7,248.805,4460
2017-09-26 13:30:00,249.42,249.7,248.805,249.08,243.13208333333336,252.14414634146343,238.34825000000012,244.4689,246.9655999999999,248.395,246.7685123807703,248.44339404489887,249.37538461538455,251.1902059100755,247.5605633206937,238.34825000000012,244.4689,246.9655999999999,248.395,249.195,54081959,64600870.55,56.78229705455659,1.5,2.75,1.2456249303825508,0.8371707461456184,-0.05174341274220207,0.968560005903896,1.0203034186460982,3.2676929540989303,-0.4357037214693909,8278606953.0,2017-09-26,2017,1,269,9,0.36,249.25,250.49,248.87,4461
2017-09-27 13:30:00,249.88,250.49,248.87,250.05,243.18416666666667,252.2392682926829,238.46595000000016,244.57239999999996,247.05339999999993,248.655,246.89719816975966,248.59640413586087,249.6423076923077,250.50501020275917,248.77960518185623,238.46595000000016,244.57239999999996,247.05339999999993,248.655,249.80333333333337,81001426,66094156.1,61.460720052538605,1.5,2.75,1.2723660067837976,1.2255459601820984,-0.03335533337080165,0.9786092519325962,1.0119645853033978,4.0805439830525385,-0.01599424207285059,8359608379.0,2017-09-27,2017,2,270,9,0.65,249.68,250.44,249.63,4462
2017-09-28 13:30:00,249.73,250.44,249.63,250.35,243.23625,252.33439024390245,238.58645000000016,244.67929999999996,247.1205999999999,248.872,247.03260216310247,248.7634132657789,249.73,250.63005128071583,248.82994871928415,238.58645000000016,244.67929999999996,247.1205999999999,248.872,250.14,44778841,65231557.9,62.801917036973904,1.5,2.75,1.239339863442098,0.6864597817615513,-0.0101620885766196,0.9992619745826232,1.0094240631592428,4.136091802606473,0.4655082467193694,8404387220.0,2017-09-28,2017,3,271,9,0.32,250.04,251.32,250.13,4463
2017-09-29 13:30:00,250.34,251.32,250.13,251.23,243.28833333333336,252.429512195122,238.70380000000011,244.79719999999998,247.20319999999992,249.059,247.19720599984356,248.99832628808568,249.8207692307692,251.01990896197984,248.6216294995586,238.70380000000011,244.79719999999998,247.20319999999992,249.059,250.89333333333332,85578002,64320264.0,66.48624409091494,1.5,2.75,1.235815587481948,1.3304983014373202,0.0518645190656013,1.0742547119912444,1.0223901929256431,3.8039894415396183,0.6046772385071243,8489965222.0,2017-09-29,2017,4,272,9,0.48,250.72,252.32,251.2926,4464
2017-10-02 13:30:00,251.49,252.32,251.2926,252.32,243.34041666666667,252.52463414634147,238.83600000000013,244.9217,247.31199999999993,249.283,247.39809988220262,249.31467616541084,249.98615384615383,251.77860877579587,248.1936989165118,238.83600000000013,244.9217,247.31199999999993,249.283,251.97753333333333,59022985,64171063.8,70.39732724640473,1.5,2.75,1.225400188376095,0.9197756980304259,0.14826308861864712,1.2077190536989522,1.0594559650803048,4.263117676816698,0.9401128135376222,8548988207.0,2017-10-02,2017,0,275,10,0.41,251.81,252.89,252.23,4465
2017-10-03 13:30:00,252.46,252.89,252.23,252.86,243.3925,252.61975609756095,238.96625000000014,245.05649999999997,247.43279999999996,249.62299999999993,247.61229204368487,249.65232605441932,250.19923076923078,252.559145520522,247.83931601793952,238.96625000000014,245.05649999999997,247.43279999999996,249.62299999999993,252.66,66810169,62941633.4,72.13242922712773,1.5,2.75,1.1850144606349449,1.061462268947091,0.22571432902557165,1.3415988763622693,1.1158845473366976,4.309272438890668,1.1197312644965254,8615798376.0,2017-10-03,2017,1,276,10,0.26,252.56,253.44,252.56,4466
2017-10-04 13:30:00,252.69,253.44,252.56,253.16,243.44458333333336,252.71487804878052,239.10685000000018,245.19829999999996,247.54759999999993,249.93599999999992,247.82984921844232,249.98639023971276,250.50461538461533,253.25780224171294,247.7514285275177,239.10685000000018,245.19829999999996,247.54759999999993,249.93599999999992,253.0533333333333,55953619,62843471.0,73.07656977727513,1.5,2.75,1.163227713446734,0.8903648717939211,0.2713989406608281,1.4551332231627327,1.1837342825019046,4.279941067557984,1.5116885199887768,8671751995.0,2017-10-04,2017,2,277,10,0.35,253.0,254.68,253.196,4467
2017-10-05 13:30:00,253.54,254.68,253.196,254.66,243.49666666666667,252.81,239.25250000000025,245.34189999999995,247.69219999999993,250.32549999999992,248.09769826869945,250.43149593116863,250.88461538461536,254.3668570621642,247.40237370706646,239.25250000000025,245.34189999999995,247.69219999999993,250.32549999999992,254.17866666666663,63522757,63117872.35,77.23039098138344,1.5,2.75,1.1887114482005394,1.0064147385665163,0.3707406054687774,1.6471600393378765,1.276419433869099,4.24368768734236,2.092687620269403,8735274752.0,2017-10-05,2017,3,278,10,0.59,253.94,254.7008,253.85,4468
2017-10-06 13:30:00,254.15,254.7008,253.85,254.37,243.54875,252.90512195121948,239.39235000000028,245.48479999999992,247.8355999999999,250.71499999999992,248.34367088561316,250.80659155677162,251.2230769230769,255.1151468459143,247.33100700023945,239.39235000000028,245.48479999999992,247.8355999999999,250.71499999999992,254.30693333333332,80645998,63958531.0,74.82677084470346,1.5,2.75,1.164574916186215,1.2609107297977185,0.3834272064053797,1.7557034418758235,1.372276235470444,4.52194060957981,2.1853533121761126,8654628754.0,2017-10-06,2017,4,279,10,0.34,254.28,254.7,253.65,4469
2017-10-09 13:30:00,254.63,254.7,253.65,253.95,243.60083333333336,253.00024390243905,239.53325000000027,245.66609999999997,247.97639999999996,250.9519999999999,248.5635269293146,251.1059637894601,251.5223076923077,255.60420132414242,247.440414060473,239.53325000000027,245.66609999999997,247.97639999999996,250.9519999999999,254.1,35803138,62180445.5,71.36271457535864,1.5,2.75,1.1563909936014838,0.5757941698889887,0.3319648350511959,1.7872322792844386,1.4552674442332427,4.3985121712690285,1.9551951180343567,8618825616.0,2017-10-09,2017,0,282,10,0.41,254.18,255.05,253.98,4470
2017-10-10 13:30:00,254.6,255.05,253.98,254.62,243.65291666666667,253.09536585365854,239.67945000000026,245.84459999999996,248.13339999999997,251.18049999999988,248.80103567718467,251.4406339047496,251.92461538461532,256.1160323683538,247.7331984008769,239.67945000000026,245.84459999999996,248.13339999999997,251.18049999999988,254.55,43057363,61488512.3,73.47248274480907,1.5,2.75,1.1523630654870938,0.7002505246821528,0.31179751173378945,1.84501433390048,1.5332168221666902,4.316871536223983,1.827634473105376,8661882979.0,2017-10-10,2017,1,283,10,0.42,254.52,255.02,254.32,4471
2017-10-11 13:30:00,254.51,255.02,254.32,255.02,243.705,253.19048780487805,239.82600000000028,246.01169999999993,248.28739999999996,251.42299999999992,249.04491663102056,251.7815259138211,252.3538461538461,256.5822813142294,248.12541099346282,239.82600000000028,246.01169999999993,248.28739999999996,251.42299999999992,254.7866666666667,47674325,60910828.45,74.67217711328436,1.5,2.75,1.120051417952303,0.7826904708599477,0.2943611038230667,1.901168201945524,1.6068070981224567,4.188747033299812,1.8653884561613805,8709557304.0,2017-10-11,2017,2,284,10,0.28,254.67,255.06,254.365,4472
2017-10-12 13:30:00,254.66,255.06,254.365,254.64,243.75708333333336,253.2856097560976,239.96785000000025,246.16289999999992,248.4313999999999,251.65049999999994,249.26433166509815,252.0537615410762,252.79307692307685,256.6801235347362,248.90603031141757,239.96785000000025,246.16289999999992,248.4313999999999,251.65049999999994,254.68833333333336,47080269,58492524.45,71.37001717352382,1.5,2.75,1.0896906023842805,0.8048937781826238,0.2291017398210917,1.8931842728988213,1.6640825330777298,4.629623700525047,1.3573219758786756,8662477035.0,2017-10-12,2017,3,285,10,0.27,254.71,255.27,254.64,4473
2017-10-13 13:30:00,255.14,255.27,254.64,254.95,243.80916666666667,253.3807317073171,240.12060000000028,246.31189999999992,248.5912,251.93849999999992,249.48729905078065,252.3295937752594,253.24461538461532,256.6332626335577,249.85596813567298,240.12060000000028,246.31189999999992,248.5912,251.93849999999992,254.95333333333332,54800435,56460927.1,72.44072234821337,1.5,2.75,1.0568555593568336,0.9705904209284584,0.18080089594932525,1.8900836530143863,1.709282757065061,4.486760782616005,1.0423272035510445,8717277470.0,2017-10-13,2017,4,286,10,0.25,254.96,255.51,254.82,4474
2017-10-16 13:30:00,255.21,255.51,254.82,255.29,243.86125,253.47585365853658,240.27530000000027,246.45869999999994,248.7488,252.21699999999996,249.71485595075,252.61153722523468,253.64769230769227,256.6443792357256,250.6510053796589,240.27530000000027,246.45869999999994,248.7488,252.21699999999996,255.20666666666668,38521675,56075248.95,73.60658221620388,1.5,2.75,1.0306515908313454,0.6869639586325902,0.14716378210355874,1.8932374846945093,1.7460737025909507,4.101928695849673,0.9610060903266544,8755799145.0,2017-10-16,2017,0,289,10,0.27,255.16,255.52,254.98,4475
2017-10-17 13:30:00,255.23,255.52,254.98,255.47,243.91333333333336,253.5709756097561,240.43500000000026,246.59579999999997,248.90079999999998,252.49199999999993,249.94054787425,252.88377177521235,254.04153846153838,256.4982385140833,251.58483840899345,240.43500000000026,246.59579999999997,248.90079999999998,252.49199999999993,255.32333333333332,31560964,55297889.75,74.22816941516962,1.5,2.75,0.995605048629108,0.5707444559401111,0.11393468100651273,1.888492053849092,1.7745573728425792,4.060559867579428,0.91246642439564,8787360109.0,2017-10-17,2017,1,290,10,0.21,255.25,255.95,255.5,4476
2017-10-18 13:30:00,255.9,255.95,255.5,255.72,243.96541666666667,253.6660975609756,240.58740000000026,246.7359,249.06999999999996,252.77499999999992,250.16719305565198,253.15388874900162,254.38692307692295,256.3851281887569,252.38871796508903,240.58740000000026,246.7359,249.06999999999996,252.77499999999992,255.72333333333333,40888330,54363602.1,75.10510738350916,1.5,2.75,0.958776116584171,0.7521269456131201,0.08691079506642208,1.8831958666756063,1.7962850716091845,4.059339235476911,0.4162412628602852,8828248439.0,2017-10-18,2017,2,291,10,0.18,255.72,255.83,254.35,4477
2017-10-19 13:30:00,254.83,255.83,254.35,255.79,244.0175,253.76121951219508,240.73345000000026,246.8788,249.24079999999995,253.09499999999989,250.3876952887636,253.40494696338246,254.65384615384602,256.38562227131735,252.9220700363748,240.73345000000026,246.8788,249.24079999999995,253.09499999999989,255.32333333333332,61903788,55048221.6,75.35794589658411,1.5,2.75,0.9960063939710172,1.1245374727963964,0.0535075877581952,1.8631695563069288,1.8096619685487332,2.5974106756639914,0.5582419310453227,8890152227.0,2017-10-19,2017,3,292,10,0.58,255.09,257.14,255.7744,4478
2017-10-20 13:30:00,256.7,257.14,255.7744,257.11,244.06958333333336,253.85634146341462,240.88700000000026,247.0355,249.50779999999997,253.47849999999988,250.65131508136116,253.75780915734603,254.98076923076908,256.8348534798592,253.12668498167903,240.88700000000026,247.0355,249.50779999999997,253.47849999999988,256.6748,89176377,56946338.85,79.57135079469835,1.5,2.75,1.0224059372587997,1.5659720853151913,0.0975071218837722,1.9315458709034488,1.8340387490196768,3.531074602683413,1.2443394368970369,8979328604.0,2017-10-20,2017,4,293,10,0.53,256.46,257.51,256.02,4479
2017-10-23 13:30:00,257.48,257.51,256.02,256.11,244.12166666666667,253.95146341463416,241.03150000000028,247.163,249.74759999999995,253.83749999999984,250.86538115660187,253.9818273328369,255.20769230769218,256.8213675938977,253.5940170214867,241.03150000000028,247.163,249.74759999999995,253.83749999999984,256.5466666666667,63915306,57288886.3,69.83019880432633,1.5,2.75,1.0558055131688862,1.115666757166477,0.039435448003740436,1.8833330590243518,1.843897611020612,4.311191729507916,0.5851857670253747,8915413298.0,2017-10-23,2017,0,296,10,0.58,256.76,256.83,256.15,4480
2017-10-24 13:30:00,256.6,256.83,256.15,256.56,244.17375,254.0465853658537,241.18200000000027,247.28690000000003,249.94799999999992,254.21149999999992,251.0886995426175,254.22736758685247,255.3538461538461,257.0826881578591,253.6250041498331,241.18200000000027,247.28690000000003,249.94799999999992,254.21149999999992,256.5133333333333,66935910,57931583.85,71.51983530380646,1.5,2.75,1.0318194050853922,1.1554303464810243,0.01287746267001677,1.8599944393581325,1.847116976688116,4.206271982043848,0.6038742059446286,8982349208.0,2017-10-24,2017,1,297,10,0.27,256.49,256.31,254.0,4481
2017-10-25 13:30:00,256.18,256.31,254.0,255.29,244.22583333333336,254.14170731707318,241.32615000000027,247.3999,250.12359999999995,254.47349999999992,251.25345642329918,254.3285706738189,255.4246153846153,257.059327599011,253.78990317021962,241.32615000000027,247.3999,250.12359999999995,254.47349999999992,255.2,103715291,59067277.1,61.11685609777999,1.5,2.75,1.1409751618650072,1.7558840713854404,-0.10233187183696567,1.7192021368919086,1.8215340087288745,5.2767054791051535,0.2552623311341524,8878633917.0,2017-10-25,2017,2,298,10,0.91,255.16,256.3,255.48,4482
2017-10-26 13:30:00,255.99,256.3,255.48,255.62,244.27791666666667,254.2368292682927,241.46875000000026,247.524,250.29719999999998,254.73699999999985,251.42469342630702,254.45156394297896,255.55307692307687,256.9491237510283,254.15703009512538,241.46875000000026,247.524,250.29719999999998,254.73699999999985,255.8,69797972,60318233.65,62.63761618065221,1.5,2.75,1.131619793160365,1.1571620681899726,-0.16472519371067085,1.6156275165905356,1.7803527103012065,5.2099345577448535,0.26279662678957283,8948431889.0,2017-10-26,2017,3,299,10,0.32,255.89,257.89,255.6254,4483
2017-10-27 13:30:00,256.47,257.89,255.6254,257.71,244.33,254.33195121951218,241.62465000000032,247.6645,250.58959999999993,255.06099999999984,251.6711760370401,254.7618911865048,255.7907692307692,257.48975465727784,254.09178380426047,241.62465000000032,247.6645,250.58959999999993,255.06099999999984,257.0751333333333,85562544,60317460.75,70.50549229913223,1.5,2.75,1.212932665077481,1.4185369035118078,-0.07804917069329731,1.6827912469345847,1.7608404176278818,6.863834647234093,0.9479415566610472,9033994433.0,2017-10-27,2017,4,300,10,0.89,256.76,257.6,256.41,4484
2017-10-30 13:30:00,257.07,257.6,256.41,256.75,244.38208333333336,254.4270731707317,241.77315000000027,247.7942,250.87039999999996,255.28249999999989,251.870345604215,254.9512348830281,255.92384615384609,257.6314857927363,254.2162065149559,241.77315000000027,247.7942,250.87039999999996,255.28249999999989,256.92,54285687,60080595.85,63.853978066665725,1.5,2.75,1.2191517604290862,0.9035477466890004,-0.09694905539938037,1.6396540983786565,1.7366031537780369,7.388677170013093,0.5010373037930094,8979708746.0,2017-10-30,2017,0,303,10,0.46,257.0,257.44,256.805,4485
2017-10-31 13:30:00,257.18,257.44,256.805,257.15,244.43416666666667,254.52219512195126,241.92765000000026,247.93160000000003,251.15539999999996,255.49699999999993,252.07739087463798,255.1606410846445,256.116923076923,257.7668812976966,254.46696485614947,241.92765000000026,247.93160000000003,251.15539999999996,255.49699999999993,257.13166666666666,60304781,59755326.45,65.32197572644225,1.5,2.75,1.1813552061127228,1.009195072349906,-0.09401812123436648,1.6190805022350787,1.7130986234694452,7.410440664055186,0.5592053808853349,9040013527.0,2017-10-31,2017,1,304,10,0.25,257.12,258.43,257.07,4486
2017-11-01 13:30:00,258.04,258.43,257.07,257.49,244.48625,254.61731707317074,242.08135000000027,248.07290000000003,251.39639999999991,255.71349999999993,252.2896500560247,255.38248479086883,256.31230769230757,257.96481448453085,254.6598009000844,242.08135000000027,248.07290000000003,251.39639999999991,255.71349999999993,257.66333333333336,54202736,59667782.3,66.56497290823677,1.5,2.75,1.1941155485332438,0.9084087578029526,-0.08117247065910904,1.6116330351455588,1.6928055058046678,7.418501223782562,0.6646076859924224,9094216263.0,2017-11-01,2017,2,305,11,0.53,257.75,257.75,256.19,4487
2017-11-02 13:30:00,257.41,257.75,256.19,257.59,244.53833333333336,254.71243902439025,242.23975000000027,248.20330000000004,251.65699999999995,255.85999999999993,252.49750691657277,255.5927243345956,256.48923076923074,258.1584537398112,254.82000779865035,242.23975000000027,248.20330000000004,251.65699999999995,255.85999999999993,257.1766666666667,56449535,59314121.2,66.94030902267855,1.5,2.75,1.2202501522094409,0.951704819323868,-0.0779170889835743,1.5954091445752001,1.6733262335587742,7.416445821142862,0.1866905215666296,9150665798.0,2017-11-02,2017,3,306,11,0.61,256.97,258.5,257.3,4488
2017-11-03 13:30:00,257.77,258.5,257.3,258.45,244.59041666666667,254.80756097560973,242.39830000000026,248.34540000000004,251.94619999999995,256.0639999999999,252.7309380178836,255.8648458265389,256.7184615384615,258.57303337218974,254.86388970473328,242.39830000000026,248.34540000000004,251.94619999999995,256.0639999999999,258.0833333333333,59589730,58261307.8,70.0537734933171,1.5,2.75,1.2188037127659084,1.0228011050586132,-0.0321643412385062,1.633120807010641,1.6652851482491475,7.084977144730599,0.9136699074616278,9210255528.0,2017-11-03,2017,4,307,11,0.47,257.9,259.0,258.22,4489
2017-11-06 14:30:00,258.3,259.0,258.22,258.85,244.6425,254.9026829268293,242.56180000000026,248.4962,252.232,256.3089999999999,252.97090123286858,256.14914622401136,256.9592307692308,259.0325849679025,254.88587657055905,242.56180000000026,248.4962,252.232,256.3089999999999,258.69,49652598,58953780.8,71.40278332187921,1.5,2.75,1.1874605904254842,0.8422292400286565,0.00854368129228611,1.6759647498645052,1.667421068572219,6.509964910449768,0.8925787340193406,9259908126.0,2017-11-06,2017,0,310,11,0.3,258.61,259.35,258.09,4490
2017-11-07 14:30:00,258.97,259.35,258.09,258.67,244.69458333333336,254.9978048780488,242.71715000000026,248.6565,252.514,256.5115,253.19439530216786,256.38922753601025,257.1807692307692,259.3214155966844,255.04012286485406,242.71715000000026,248.6565,252.514,256.5115,258.7033333333334,57502161,59676020.7,69.87730392622416,1.5,2.75,1.1926419768236671,0.9635723080309206,0.006922068191333564,1.6760736538113858,1.6691515856200525,6.566296861591049,1.323984488229082,9202405965.0,2017-11-07,2017,1,311,11,0.49,258.72,259.22,258.15,4491
2017-11-08 14:30:00,258.47,259.22,258.15,259.11,244.74666666666667,255.0929268292683,242.86485000000027,248.801,252.7992,256.71599999999995,253.4263798001221,256.64834872305687,257.3346153846154,259.70766425617387,254.96156651305688,242.86485000000027,248.801,252.7992,256.71599999999995,258.82666666666665,50469579,59815783.4,71.48123875161728,1.5,2.75,1.1838818356219802,0.8437501965409351,0.01840524194940718,1.6921581380568114,1.6737528961074042,5.438665635027438,1.36530787888272,9252875544.0,2017-11-08,2017,2,312,11,0.41,258.68,258.39,256.36,4492
2017-11-09 14:30:00,257.73,258.39,256.36,258.17,244.79875,255.18804878048783,243.0090500000002,248.9526,253.0424,256.89249999999987,253.61240412168598,256.7932678922896,257.4930769230769,259.79181750958304,255.19433633657073,243.0090500000002,248.9526,253.0424,256.89249999999987,257.64000000000004,95085497,62216044.8,63.68012445186169,1.5,2.75,1.2957474187918387,1.528311503980401,-0.050610050052388944,1.610490333541918,1.661100383594307,6.184384815813138,0.178495207791718,9157790047.0,2017-11-09,2017,3,313,11,0.79,257.38,258.2926,257.37,4493
2017-11-10 14:30:00,257.73,258.2926,257.37,258.09,244.85083333333336,255.28317073170726,243.15465000000015,249.104,253.2544,257.0494999999999,253.78799611691392,256.916766188262,257.6107692307692,259.86255773756807,255.3589807239703,243.15465000000015,249.104,253.2544,257.0494999999999,257.9175333333333,59984662,62475256.15,63.04946804155644,1.5,2.75,1.269094031735278,0.9601347108682484,-0.11146378380434864,1.5217706538388711,1.6332344376432195,4.194821119317203,0.5219084712755502,9097805385.0,2017-11-10,2017,4,314,11,0.36,257.83,258.59,257.27,4494
2017-11-13 14:30:00,257.31,258.59,257.27,258.33,244.90291666666667,255.37829268292683,243.30855000000014,249.25890000000004,253.4642,257.2014999999999,253.9661139162506,257.051359884618,257.8446153846154,259.67594303055284,256.013287738678,243.30855000000014,249.25890000000004,253.4642,257.2014999999999,258.06333333333333,50228648,63060604.8,64.19508004710269,1.5,2.75,1.2727301723256148,0.7965138957880722,-0.1433362567498837,1.4540641167058652,1.5974003734557491,3.396094084464237,0.4588761423293825,9148034033.0,2017-11-13,2017,0,317,11,0.51,257.93,257.85,256.52,4495
2017-11-14 14:30:00,257.41,257.85,256.52,257.73,244.955,255.4734146341464,243.45955000000018,249.40490000000003,253.6976,257.3144999999999,254.11371729208398,257.1159922765591,258.0069230769231,259.32209804896,256.69174810488624,243.45955000000018,249.40490000000003,253.6976,257.3144999999999,257.3666666666667,61315152,64548314.2,59.249405329253904,1.5,2.75,1.311106588588071,0.9499109738175006,-0.20865317446746912,1.3365839053714126,1.5452370798388817,3.7163187119873102,0.09320750320401146,9086718881.0,2017-11-14,2017,1,318,11,0.52,257.18,257.22,255.63,4496
2017-11-15 14:30:00,256.62,257.22,255.63,256.44,245.00708333333336,255.56853658536582,243.6036500000002,249.5364,253.8884,257.3504999999999,254.2049440649434,257.05161205974395,257.9092307692308,259.46481547828273,256.3536460601788,243.6036500000002,249.5364,253.8884,257.3504999999999,256.43,80811525,66544473.95,50.28037564868677,1.5,2.75,1.3674561179746392,1.2143987352085754,-0.3350670267271973,1.1264032964298851,1.4614703231570825,4.683986276720237,-0.4464459024030348,9005907356.0,2017-11-15,2017,2,319,11,0.62,256.42,259.04,257.4748,4497
2017-11-16 14:30:00,257.52,259.04,257.4748,258.62,245.05916666666667,255.6636585365854,243.75790000000026,249.7093,254.1234,257.49199999999985,254.378083513377,257.2009823397684,258.0530769230769,259.4949642464664,256.6111895996874,243.75790000000026,249.7093,254.1234,257.49199999999985,258.37826666666666,67777027,66838135.9,61.019334561053064,1.5,2.75,1.4554949666907375,1.0140472364669884,-0.27093745191082985,1.122798508268545,1.3937359601793748,6.933101822958374,0.06577674598569004,9073684383.0,2017-11-16,2017,3,320,11,0.61,258.26,258.5882,257.77,4498
2017-11-17 14:30:00,258.22,258.5882,257.77,257.86,245.11125,255.75878048780487,243.90050000000028,249.85299999999995,254.349,257.52949999999987,254.51462925795045,257.2637459264571,258.1076923076924,259.4595947585973,256.75578985678743,243.90050000000028,249.85299999999995,254.349,257.52949999999987,258.0727333333333,75756833,66167158.7,56.44233280315592,1.5,2.75,1.4122453262128296,1.1449310275431246,-0.27774713708978793,1.04655203881714,1.3242991759069278,6.896734120670048,-0.3824608846822519,8997927550.0,2017-11-17,2017,4,321,11,0.32,258.18,258.525,257.86,4499
2017-11-20 14:30:00,258.14,258.525,257.86,258.3,245.16333333333336,255.85390243902438,244.04735000000028,250.02249999999995,254.53080000000003,257.6389999999999,254.66307516940338,257.36243679060397,258.17,259.4761746850064,256.8638253149936,244.04735000000028,250.02249999999995,254.53080000000003,257.6389999999999,258.2283333333333,48075514,65375169.1,58.38837415501862,1.5,2.75,1.3588706600547678,0.7353788091387131,-0.2514489626733605,1.0099879725652272,1.2614369352385877,6.9121952951409185,-0.1430393938222463,9046003064.0,2017-11-20,2017,0,324,11,0.26,258.19,260.2,259.18,4500
2017-11-21 14:30:00,259.18,260.2,259.18,259.99,245.21541666666667,255.94902439024392,244.20260000000027,250.2044,254.72960000000003,257.81049999999993,254.8719741823679,257.6126809057846,258.3546153846154,259.93114741871534,256.77808335051554,244.20260000000027,250.2044,254.72960000000003,257.81049999999993,259.79,69176799,65487213.55,64.87882923190301,1.5,2.75,1.3975227557651397,1.0563405472609242,-0.12543283420596585,1.1046458924811304,1.2300787266870965,7.8958585418377085,0.33962409787348824,9115179863.0,2017-11-21,2017,1,325,11,0.39,259.69,260.15,259.57,4501
2017-11-22 14:30:00,260.0,260.15,259.57,259.76,245.2675,256.04414634146343,244.35520000000028,250.3799,254.92140000000003,258.03399999999993,255.06366146933388,257.8171874861861,258.4553846153846,260.20174109297716,256.7090281377921,244.35520000000028,250.3799,254.92140000000003,258.03399999999993,259.82666666666665,45033392,62553118.6,63.42881300479994,1.5,2.75,1.339128273210486,0.7199224116701354,-0.0657654254116431,1.1478719449225423,1.2136373703341854,7.89257380876021,0.6158732618042277,9070146471.0,2017-11-22,2017,2,326,11,0.22,259.86,260.48,260.16,4502
2017-11-24 14:30:00,260.32,260.48,260.16,260.36,245.31958333333336,256.1392682926829,244.50400000000027,250.5558,255.12680000000003,258.27099999999984,255.27136101955608,258.0593601065493,258.57153846153847,260.58748788330763,256.55558903976936,244.50400000000027,250.5558,255.12680000000003,258.27099999999984,260.33333333333337,27746365,60450538.25,65.58939271403713,1.5,2.75,1.2949048251240245,0.4589928527228622,0.0023065807914104397,1.2165205963234484,1.214214015532038,7.552427102367657,0.8795381456081363,9097892836.0,2017-11-24,2017,4,328,11,0.12,260.32,260.75,260.0,4503
2017-11-27 14:30:00,260.41,260.75,260.0,260.23,245.37166666666667,256.23439024390245,244.64760000000027,250.7526,255.34760000000003,258.39699999999993,255.4658174501617,258.26608771544943,258.69153846153847,260.8937589654784,256.48931795759853,244.64760000000027,250.7526,255.34760000000003,258.39699999999993,260.32666666666665,52274922,58786157.15,64.69753462911927,1.5,2.75,1.25598305190088,0.8892386326021312,0.02548582702615798,1.2460712993147354,1.2205854722885774,7.5637747109391675,0.7354933612046739,9045617914.0,2017-11-27,2017,0,331,11,0.29,260.38,262.9,260.655,4504
2017-11-28 14:30:00,260.76,262.9,260.655,262.87,245.42375,256.32951219512194,244.79810000000032,250.9602,255.6106000000001,258.70299999999986,255.75617755015537,258.7045555520733,258.98076923076917,262.11660146274903,255.8449369987894,244.79810000000032,250.9602,255.6106000000001,258.70299999999986,262.14166666666665,98971719,61020458.75,72.7893550688832,1.5,2.75,1.3569842624793855,1.6219432142502537,0.19602890806045134,1.4656216073641417,1.2695926993036903,9.246262844139435,1.9943351569471877,9144589633.0,2017-11-28,2017,1,332,11,0.86,261.78,263.63,262.2,4505
2017-11-29 14:30:00,263.02,263.63,262.2,262.71,245.47583333333336,256.42463414634153,244.94315000000032,251.1636,255.86540000000005,258.98099999999994,256.0288764697571,259.0860264518758,259.33,262.9936677713075,255.66633222869243,244.94315000000032,251.1636,255.86540000000005,258.98099999999994,262.84666666666664,77512102,61880824.8,71.71645139454459,1.5,2.75,1.3621996723022871,1.2526029226423627,0.2708603874948121,1.6081681836722057,1.3373077961773934,9.020231945689456,2.4450163781001333,9067077531.0,2017-11-29,2017,2,333,11,0.55,262.91,266.05,263.67,4506
2017-11-30 14:30:00,263.76,266.05,263.67,265.01,245.52791666666667,256.51975609756096,245.0936000000003,251.3918,256.16440000000006,259.3569999999999,256.38107739251166,259.65021440884,259.8623076923077,264.5252295484781,255.1993858361373,245.0936000000003,251.3918,256.16440000000006,259.3569999999999,264.91,127894389,65565407.45,76.97124691666038,1.5,2.75,1.5034711242806975,1.950638209600572,0.4381530068620279,1.884999054754928,1.4468460478929004,8.592687847397011,2.470806588817565,9194971920.0,2017-11-30,2017,3,334,11,0.9,264.86,265.31,260.76,4507
2017-12-01 14:30:00,264.76,265.31,260.76,264.46,245.58,256.6148780487805,245.2423000000003,251.5963,256.46580000000006,259.7004999999999,256.69789788692304,260.10828922704565,260.33384615384614,265.4947795128603,255.172912794832,245.2423000000003,251.5963,256.46580000000006,259.7004999999999,263.51,164390902,70962475.8,73.45667274255254,1.5,2.75,1.7210803296892199,2.316589157110553,0.471749740711815,2.036533223782669,1.5647834830708542,8.396257209263744,2.559528426277812,9030581018.0,2017-12-01,2017,4,335,12,1.74,263.03,266.8,264.08,4508
2017-12-04 14:30:00,266.31,266.8,264.08,264.14,245.63208333333336,256.71000000000004,245.38755000000037,251.7935,256.75980000000004,259.985,256.9897450286124,260.49226168161283,260.8269230769231,266.1216425631606,255.53220359068558,245.38755000000037,251.7935,256.75980000000004,259.985,265.00666666666666,94040560,72685017.3,71.41353935243008,1.5,2.75,1.7924317347114207,1.293809418959855,0.4333901369284039,2.106521154231359,1.6731310173029552,8.058383720745338,2.2609368950832267,8936540458.0,2017-12-04,2017,0,338,12,1.03,265.44,265.15,263.04,4509
2017-12-05 14:30:00,264.43,265.15,263.04,263.19,245.68416666666667,256.80512195121946,245.52105000000043,251.9698,257.045,260.20199999999994,257.23289228239224,260.7491891405068,261.34615384615387,266.1160887817686,256.57621891053907,245.52105000000043,251.9698,257.045,260.20199999999994,263.7933333333333,77994544,74102114.6,65.58168893950983,1.5,2.75,1.8151151822320304,1.052527912611012,0.3107476565660092,2.061565588010467,1.7508179314444576,8.769859689778112,1.2308165698680675,8858545914.0,2017-12-05,2017,1,339,12,0.8,264.1,263.73,262.71,4510
2017-12-06 14:30:00,262.87,263.73,262.71,263.24,245.73625,256.90024390243906,245.6558500000004,252.1469,257.32820000000004,260.43049999999994,257.46846513406314,260.9864092223633,261.70153846153846,266.2910840811088,257.11199284196806,245.6558500000004,252.1469,257.32820000000004,260.43049999999994,263.2266666666667,75898566,75021934.85,65.74026619041278,1.5,2.75,1.758321240644031,1.0116849978843219,0.2048168305228284,2.006838969597993,1.8020221390751647,8.282840480519384,1.3396981829381038,8934444480.0,2017-12-06,2017,2,340,12,0.39,263.22,264.43,262.94,4511
2017-12-07 14:30:00,263.09,264.43,262.94,264.07,245.78833333333336,256.99536585365854,245.79400000000038,252.331,257.6086,260.67849999999993,257.72734885429594,261.2800845345192,262.17923076923074,266.34293815227403,258.01552338618745,245.79400000000038,252.331,257.6086,260.67849999999993,263.81333333333333,77218569,76359384.35,68.3473454728977,1.5,2.75,1.7391554377408869,1.011251854075484,0.16422457338272656,2.007302855803573,1.8430782824208465,8.22712299193673,1.424950069135036,9011663049.0,2017-12-07,2017,3,341,12,0.57,263.68,265.52,264.72,4512
2017-12-08 14:30:00,264.99,265.52,264.72,265.51,245.84041666666667,257.0904878048781,245.93785000000042,252.51619999999997,257.9118,261.04549999999995,258.03255086000985,261.68293362646966,262.7338461538462,266.59251502327356,258.87517728441884,245.93785000000042,252.51619999999997,257.9118,261.04549999999995,265.25,76563873,75433303.15,72.28751420919286,1.5,2.75,1.7185014779022512,1.0149876752414229,0.20526765251432927,2.0996628480637582,1.8943951955494291,8.509892444557487,2.0289743688275648,9088226922.0,2017-12-08,2017,4,342,12,0.3,265.12,266.38,265.4793,4513
2017-12-11 14:30:00,265.58,266.38,265.4793,266.31,245.8925,257.1856097560976,246.08385000000038,252.7083,258.21340000000004,261.45649999999995,258.3571567086369,262.123606614425,263.22,267.1649285847114,259.27507141528855,246.08385000000038,252.7083,258.21340000000004,261.45649999999995,266.05643333333336,83077533,76587946.7,74.20837366357054,1.5,2.75,1.660087086623517,1.0847337809619069,0.25401548150846875,2.2119145474350153,1.9578990659265458,8.376506181089674,1.3086316430174605,9171304455.0,2017-12-11,2017,0,345,12,0.34,265.93,267.32,266.345,4514
2017-12-12 14:30:00,266.57,267.32,266.345,266.78,245.94458333333336,257.2807317073171,246.23540000000037,252.9073,258.50260000000003,261.8789999999999,258.6874642886904,262.5670726511464,263.75999999999993,267.5825726335153,259.93742736648454,246.23540000000037,252.9073,258.50260000000003,261.8789999999999,266.815,85195750,78336301.8,75.2919299696611,1.5,2.75,1.6136522947218364,1.0875641055600611,0.28339827497847603,2.312146909649641,2.028748634671165,6.7546157833893545,1.5492368010353597,9256500205.0,2017-12-12,2017,1,346,12,0.37,266.83,267.56,266.65,4515
2017-12-13 14:30:00,267.06,267.56,266.65,266.75,245.99666666666667,257.3758536585366,246.37025000000037,253.1066,258.78040000000004,262.3299999999999,259.0036421597221,262.9654466843706,264.2515384615384,267.8347630183926,260.66831390468417,246.37025000000037,253.1066,258.78040000000004,262.3299999999999,266.9866666666667,102905409,80415814.65,75.07512118357167,1.5,2.75,1.5633914165274214,1.279666312501878,0.2665483908555375,2.3619341232405877,2.0953857323850498,6.704485552614437,0.6565789970189839,9153594796.0,2017-12-13,2017,2,347,12,0.34,267.1,267.22,265.6,4516
2017-12-14 14:30:00,267.09,267.22,265.6,265.66,246.04875,257.47097560975607,246.5072000000004,253.28900000000002,259.03040000000004,262.79099999999994,259.2646758005173,263.2220708096686,264.6692307692307,267.45773973435655,261.88072180410484,246.5072000000004,253.28900000000002,259.03040000000004,262.79099999999994,266.16,100666692,81408573.0,67.47278593512435,1.5,2.75,1.5674348867754633,1.2365613140031333,0.15334981751531496,2.2870730042791934,2.1337231867638784,5.622974810574423,0.4537548211449919,9052928104.0,2017-12-14,2017,3,348,12,0.61,266.41,267.04,265.39,4517
2017-12-15 14:30:00,265.45,267.04,265.39,266.51,246.10083333333336,257.5660975609756,246.64765000000043,253.47979999999995,259.26740000000007,263.18549999999993,259.5488061612814,263.5352069230335,264.94923076923067,267.6894324635271,262.2090290749344,246.64765000000043,253.47979999999995,259.26740000000007,263.18549999999993,266.31333333333333,144610290,85250236.15,70.02213219487321,1.5,2.75,1.5733323948629323,1.6963036881863234,0.10915256117694573,2.2701638882350608,2.161011327058115,5.6400208430334855,0.8972514575603864,9197538394.0,2017-12-15,2017,4,349,12,0.62,266.22,268.6,267.98,4518
2017-12-18 14:30:00,268.1,268.6,267.98,268.2,246.15291666666667,257.66121951219515,246.8001000000004,253.6898,259.54400000000004,263.7025,259.88806866476057,263.97947293036367,265.37153846153836,268.28770925061696,262.45536767245983,246.8001000000004,253.6898,259.54400000000004,263.7025,268.26,83676072,85646198.1,74.32998235026109,1.5,2.75,1.6102372238012963,0.9769969228791722,0.16387894360802102,2.3658600065681408,2.20198106296012,6.2883215378089465,1.9035677647326992,9281214466.0,2017-12-18,2017,0,352,12,0.23,268.29,268.53,267.09,4519
2017-12-19 14:30:00,268.48,268.53,267.09,267.17,246.205,257.7563414634146,246.95095000000043,253.89239999999995,259.80840000000006,264.146,260.17363459947586,264.2833326512814,265.53769230769217,268.59524440898775,262.4801402063967,246.95095000000043,253.89239999999995,259.80840000000006,264.146,267.59666666666664,82382876,87361566.2,67.92356100979416,1.5,2.75,1.5980774221012035,0.9430105203402362,0.10378234010652987,2.331708988093282,2.2279266479867528,6.362306992602807,1.4929342045281897,9198831590.0,2017-12-19,2017,1,353,12,0.54,267.81,268.33,266.69,4520
2017-12-20 14:30:00,268.27,268.33,266.69,267.03,246.25708333333336,257.85146341463417,247.10330000000042,254.0949999999999,260.05660000000006,264.49799999999993,260.4425116740062,264.54492001782603,265.73538461538453,268.8208604209741,262.64990880979497,247.10330000000042,254.0949999999999,260.05660000000006,264.49799999999993,267.35,76751500,87740301.25,67.07730345609818,1.5,2.75,1.6010718919511169,0.8747576530574085,0.031428456625504975,2.267212218768634,2.2357837621431287,6.428830170687501,1.120914908925656,9122080090.0,2017-12-20,2017,2,354,12,0.61,267.51,268.385,267.3,4521
2017-12-21 14:30:00,267.74,268.385,267.3,267.58,246.30916666666667,257.9465853658536,247.25690000000043,254.2976,260.30780000000004,264.88899999999995,260.7224131769863,264.8339752542236,265.99999999999994,269.0828358573196,262.9171641426802,247.25690000000043,254.2976,260.30780000000004,264.88899999999995,267.75499999999994,67032339,88840248.6,68.72579861949886,1.5,2.75,1.583495328240324,0.7545266932087357,-0.0008525861283148473,2.234718029482736,2.2355706156110497,6.352355667184239,0.7796316522918132,9189112429.0,2017-12-21,2017,3,355,12,0.41,267.84,267.635,266.9,4522
2017-12-22 14:30:00,267.6,267.635,266.9,267.51,246.36125,258.0417073170732,247.40600000000043,254.49829999999997,260.56520000000006,265.2465,260.98859305239864,265.0888347538213,266.33230769230755,269.0404737348041,263.6241416498109,247.40600000000043,254.49829999999997,260.56520000000006,265.2465,267.3483333333333,78720873,91388974.0,68.25735024416579,1.5,2.75,1.5228885190803019,0.8613826105543104,-0.04588953140192675,2.178208701358642,2.2240982327605687,5.8215945771751825,0.4506026810859482,9110391556.0,2017-12-22,2017,4,356,12,0.28,267.27,267.4377,266.885,4523
2017-12-26 14:30:00,267.05,267.4377,266.885,267.19,246.41333333333336,258.1368292682927,247.55290000000042,254.70059999999995,260.81000000000006,265.5945,261.2317854817163,265.2889457296478,266.63615384615366,268.6974534879004,264.5748542044071,247.55290000000042,254.70059999999995,260.81000000000006,265.5945,267.1709,45244433,91037449.55,66.04122804586325,1.5,2.75,1.4587536248602806,0.4969870446024594,-0.112410542590613,2.0835850545223025,2.1959955971129155,5.724375476156727,0.15368468400930546,9065147123.0,2017-12-26,2017,1,360,12,0.21,267.16,267.73,267.01,4524
2017-12-27 14:30:00,267.38,267.73,267.01,267.32,246.46541666666667,258.23195121951215,247.7050000000004,254.89969999999997,261.05060000000003,265.81699999999995,261.47053899223727,265.48237946968135,266.88615384615366,268.34102446606886,265.4312832262386,247.7050000000004,254.89969999999997,261.05060000000003,265.81699999999995,267.3533333333333,57750986,88976412.9,66.51683569466157,1.5,2.75,1.4059855087988338,0.6490594992282499,-0.15993605366928998,1.9960755300263031,2.156011583695593,5.654021339011303,0.21368322399249975,9122898109.0,2017-12-27,2017,2,361,12,0.27,267.37,267.92,267.45,4525
2017-12-28 14:30:00,267.89,267.92,267.45,267.87,246.5175,258.3270731707317,247.8496000000004,255.09969999999996,261.2986,266.075,261.7214982474437,265.70977190114024,267.0676923076922,268.37151282024433,265.76387179514006,247.8496000000004,255.09969999999996,261.2986,266.075,267.74666666666667,45116139,87356614.75,68.52529285293988,1.5,2.75,1.3484151153132042,0.5164593331496972,-0.16589624203851816,1.9486412811474447,2.1145375231859638,5.745758505395889,0.8318903862079272,9168014248.0,2017-12-28,2017,3,362,12,0.18,267.68,268.55,266.64,4526
2017-12-29 14:30:00,268.53,268.55,266.64,266.86,246.56958333333336,258.42219512195123,247.99150000000043,255.29569999999995,261.5214000000001,266.1674999999999,261.92300812009296,265.81931743436496,267.1099999999999,268.3466953483276,265.87330465167224,247.99150000000043,255.29569999999995,261.5214000000001,266.1674999999999,267.35,96007424,85762266.5,61.25845476737783,1.5,2.75,1.3885283213622628,1.119459966697592,-0.2446690929271917,1.8087011570269735,2.053370249954165,5.657059008479491,0.1313271547033968,9072006824.0,2017-12-29,2017,4,363,12,0.72,267.6,268.81,267.4,4527
2018-01-02 14:30:00,267.84,268.81,267.4,268.77,246.62166666666667,258.5173170731707,248.1502000000004,255.5109,261.78100000000006,266.3829999999999,262.19151760557946,266.1003348215683,267.2630769230768,268.76309506889487,265.7630587772586,248.1502000000004,255.5109,261.78100000000006,266.3829999999999,268.32666666666665,86655749,81875508.85,68.13936233415916,1.5,2.75,1.4286334412649573,1.0583842496632008,-0.17804487835599805,1.8308141520091683,2.008859030365166,6.706810992519246,0.212527964205814,9158662573.0,2018-01-02,2018,1,2,1,0.53,268.1,270.64,268.96,4528
2018-01-03 14:30:00,268.96,270.64,268.96,270.47,246.67375,258.61243902439026,248.31870000000043,255.778,262.0482,266.69949999999994,262.51616397398817,266.5164934099904,267.54923076923063,269.7866257041217,265.3118358343396,248.31870000000043,255.778,262.0482,266.69949999999994,270.0233333333333,90070416,81677001.65,72.77433811575199,1.5,2.75,1.4601596240317465,1.102763497440408,-0.036777060492028564,1.9628877047501303,1.999664765242159,6.7020426499769865,1.2351686192312052,9248732989.0,2018-01-03,2018,2,3,1,0.62,269.8,272.16,270.5447,4529
2018-01-04 14:30:00,271.2,272.16,270.5447,271.61,246.72583333333336,258.7075609756098,248.5081000000004,256.0529,262.3582,267.12049999999994,262.8727849946161,267.0015892757056,268.006923076923,270.8606211862846,265.15322496756136,248.5081000000004,256.0529,262.3582,267.12049999999994,271.43823333333336,80636408,81809094.85,75.3627093568195,1.5,2.75,1.4765767937437642,0.985665568698075,0.1082163600046666,2.1349352152479923,2.0267188552433257,6.216724002622144,1.7151630902894959,9329369397.0,2018-01-04,2018,3,4,1,0.6,271.35,273.56,271.95,4530
2018-01-05 14:30:00,272.51,273.56,271.95,273.42,246.77791666666667,258.8026829268293,248.70380000000043,256.3217,262.69540000000006,267.62949999999995,263.28640126933703,267.61286648754316,268.5384615384615,272.4550679671262,264.62185510979685,248.70380000000043,256.3217,262.69540000000006,267.62949999999995,272.9766666666667,83523995,82190366.3,78.8076766140073,1.5,2.75,1.5103927370477803,1.016226095101367,0.29045530914543605,2.3897879916751212,2.0993326825296847,6.644749676381847,2.1825248523806087,9412893392.0,2018-01-05,2018,4,5,1,0.59,272.76,274.1,272.98,4531
2018-01-08 14:30:00,273.31,274.1,272.98,273.92,246.83,258.8978048780488,248.9032500000004,256.5958,263.06800000000004,268.122,263.7034051411277,268.21354586968187,268.9784615384615,273.8200750403448,264.13684803657816,248.9032500000004,256.5958,263.06800000000004,268.122,273.6666666666667,57319192,81195397.45,79.65402051095373,1.5,2.75,1.4825075415443678,0.7059413932334905,0.40222262122123903,2.602110959056233,2.1998883378349943,6.649952567778026,2.396172105715684,9470212584.0,2018-01-08,2018,0,8,1,0.41,273.54,275.25,274.08099999999996,4532
2018-01-09 14:30:00,274.4,275.25,274.08099999999996,274.54,246.88208333333336,258.9929268292683,249.10665000000043,256.8718,263.44640000000004,268.5735,264.12836964539724,268.8160653106646,269.54538461538453,275.08311319934916,264.0076560314199,249.10665000000043,256.8718,263.44640000000004,268.5735,274.6236666666667,57253957,80229901.65,80.68414249529216,1.5,2.75,1.4716141457197691,0.7136236717548063,0.4707020222045095,2.7882658655906307,2.3175638433861216,6.443459301815401,2.7508514540214914,9527466541.0,2018-01-09,2018,1,9,1,0.43,274.67,274.42,272.92,4533
2018-01-10 14:30:00,273.68,274.42,272.92,274.12,246.93416666666667,259.08804878048784,249.30915000000041,257.1821,263.7746000000001,268.96399999999994,264.52019828675424,269.32120194774416,270.0907692307692,275.91905812881845,264.2624803327199,249.30915000000041,257.1821,263.7746000000001,268.96399999999994,273.82,69574318,79554740.9,77.81013110652195,1.5,2.75,1.4822131353112145,0.8745464721889377,0.4410164002926451,2.8688343437519284,2.4278179434592833,6.517616827113169,2.5437677689660374,9457892223.0,2018-01-10,2018,2,10,1,0.55,273.67,276.12,274.56,4534
2018-01-11 14:30:00,274.75,276.12,274.56,276.12,246.98625,259.1831707317073,249.51315000000042,257.5162,264.1620000000001,269.4309999999999,264.9750924715874,269.96870652414947,270.74769230769226,277.18882528897984,264.3065593264047,249.51315000000042,257.5162,264.1620000000001,269.4309999999999,275.6,62361455,78413026.15,81.23747024013204,1.5,2.75,1.5191979113604133,0.7952945838451102,0.5047925940103529,3.058808685972224,2.5540160919618713,6.879197311185079,3.0798521670959795,9520253678.0,2018-01-11,2018,3,11,1,0.57,275.34,278.11,276.0819,4535
2018-01-12 14:30:00,276.42,278.11,276.0819,277.92,247.03833333333336,259.27829268292686,249.7250500000004,257.86639999999994,264.57740000000007,269.9895,265.48273590407416,270.72597256946864,271.5484615384615,278.7266329197026,264.3702901572203,249.7250500000004,257.86639999999994,264.57740000000007,269.9895,277.3706333333334,90816076,77808559.5,83.68053732071851,1.5,2.75,1.555548060548955,1.1671733365016224,0.6098915324543435,3.3163805075298,2.7064889750754566,7.068807267887899,4.14449524095031,9611069754.0,2018-01-12,2018,4,12,1,0.73,277.1,280.09,276.18,4536
2018-01-16 14:30:00,279.35,280.09,276.18,276.97,247.09041666666667,259.3734146341464,249.92845000000042,258.1817,264.9670000000001,270.55499999999995,265.9332168490124,271.3206418485668,272.3007692307692,279.5437879874688,265.0577504740695,249.92845000000042,258.1817,264.9670000000001,270.55499999999995,277.74666666666667,106555142,78102982.0,77.9142450885347,1.5,2.75,1.7237231990811699,1.3642903160854984,0.5584926650477331,3.404604806385123,2.84611214133739,6.934245835945267,3.0509357443167198,9504514612.0,2018-01-16,2018,1,16,1,1.42,278.14,280.05,276.97,4537
2018-01-17 14:30:00,278.03,280.05,276.97,279.61,247.1425,259.4685365853659,250.14780000000042,258.5322,265.40740000000005,271.2099999999999,266.46956128630603,272.1101045296557,273.24615384615385,280.8416445669596,265.650663125348,250.14780000000042,258.5322,265.40740000000005,271.2099999999999,278.87666666666667,113258799,76535407.45,81.69015670818692,1.5,2.75,1.820600113432514,1.47982225186416,0.6395309137126075,3.645525783478149,3.0059948697655416,7.468109877161773,3.3793026953081617,9617773411.0,2018-01-17,2018,2,17,1,1.11,278.51,279.96,278.58,4538
2018-01-18 14:30:00,279.48,279.96,278.58,279.14,247.19458333333336,259.56365853658536,250.36685000000043,258.8837,265.8212000000001,271.75699999999995,266.9664412358626,272.7796183839742,274.11307692307685,281.62842484834175,266.59772899781194,250.36685000000043,258.8837,265.8212000000001,271.75699999999995,279.22666666666663,100728006,77388004.15,79.0974657356377,1.5,2.75,1.7891286767587626,1.3015971545765723,0.5993994673043992,3.7552442038960407,3.1558447365916416,7.9386050787546525,2.7723574242479923,9517045405.0,2018-01-18,2018,3,18,1,0.5,279.27,280.41,279.14,4539
2018-01-19 14:30:00,279.8,280.41,279.14,280.41,247.24666666666667,259.6587804878049,250.59150000000042,259.2421999999999,266.2524000000001,272.41900000000004,267.49363961877003,273.50632139502426,275.15538461538455,282.0942899397513,268.2164792910178,250.59150000000042,259.2421999999999,266.2524000000001,272.41900000000004,279.9866666666667,140920098,80314865.25,80.86474740261666,1.5,2.75,1.7520480569902823,1.7545954607699477,0.5951015426169688,3.899721664862852,3.3046201222458835,7.956987774730548,2.556506473557168,9657965503.0,2018-01-19,2018,4,19,1,0.45,279.77,282.69,280.11,4540
2018-01-22 14:30:00,280.17,282.69,280.11,282.69,247.29875,259.7539024390244,250.83105000000043,259.62339999999995,266.73280000000005,273.20199999999994,268.0895753199947,274.380957452641,276.2261538461538,283.1892324688047,269.26307522350294,250.83105000000043,259.62339999999995,266.73280000000005,273.20199999999994,281.83,91322408,81043410.65,83.55320886162717,1.5,2.75,1.8111874814909756,1.1268332276191044,0.6765881631110311,4.150355326134672,3.4737671630236413,8.226860625336636,3.2016647196261614,9749287911.0,2018-01-22,2018,0,22,1,0.92,281.4,283.62,282.37,4541
2018-01-23 14:30:00,282.74,283.62,282.37,283.29,247.35083333333336,259.8490243902439,251.07030000000043,260.0078,267.2164000000001,273.98749999999995,268.6856704054851,275.2294376952466,277.2123076923077,284.26587483719504,270.15874054742034,251.07030000000043,260.0078,267.2164000000001,273.98749999999995,283.0933333333333,97084700,82546028.7,84.18299758907354,1.5,2.75,1.7711026613844771,1.1761280527842035,0.6988154548083885,4.347286481534127,3.6484710267257374,8.208951805362569,3.187149413564508,9846372611.0,2018-01-23,2018,1,23,1,0.44,283.0,284.7,281.84,4542
2018-01-24 14:30:00,284.02,284.7,281.84,283.18,247.40291666666667,259.9441463414634,251.3102000000004,260.37949999999995,267.7166000000001,274.771,269.2540754876229,275.98663410522306,278.1023076923076,285.0222194473972,271.182395937218,251.3102000000004,260.37949999999995,267.7166000000001,274.771,283.24,134816117,85350790.9,83.55132336305022,1.5,2.75,1.8488810427141584,1.5795532247376045,0.6358316728124622,4.443260617741316,3.8074289449288536,8.474956713762111,3.305121844447688,9711556494.0,2018-01-24,2018,2,24,1,1.01,283.27,284.27,282.405,4543
2018-01-25 14:30:00,284.16,284.27,282.405,283.3,247.455,260.0392682926829,251.55000000000047,260.7376,268.22080000000005,275.5765,269.80489605673574,276.6831451428209,278.86230769230764,285.7282779754484,271.9963374091669,251.55000000000047,260.7376,268.22080000000005,275.5765,283.325,84587313,87317934.9,83.69505794653105,1.5,2.75,1.8500323968060048,0.9687278231771372,0.5359698282465652,4.4773912302370595,3.941421401990495,8.153159425231356,2.6003187020136203,9796143807.0,2018-01-25,2018,3,25,1,0.66,283.34,286.6285,283.96,4544
2018-01-26 14:30:00,284.25,286.6285,283.96,286.58,247.50708333333336,286.6285,251.8076000000005,261.12499999999994,268.78580000000005,276.5395,270.4627432701971,277.6257027482666,279.83615384615376,287.19544954180594,272.4768581505016,251.8076000000005,261.12499999999994,268.78580000000005,276.5395,285.7228333333333,107743119,89817541.55,87.03097302553877,1.5,2.75,1.9556372256055727,1.1995776898438166,0.6186706854243429,4.714759758770923,4.0960890733465805,9.202968135552982,3.1160046056418995,9903886926.0,2018-01-26,2018,4,26,1,0.94,285.29,286.43,284.5,4545
2018-01-29 14:30:00,285.93,286.43,284.5,284.68,247.55916666666667,286.9481483050847,252.0608500000005,261.5112,269.3248000000001,277.38,271.02028274979716,278.29754058176496,280.61615384615374,287.70942059259295,273.5228870997145,252.0608500000005,261.5112,269.3248000000001,277.38,285.2033333333334,90118337,92067651.45,77.18028539692999,1.5,2.75,1.96452028091946,0.9788273685784346,0.4794774174260237,4.695435845129111,4.215958427703088,10.715213786422071,2.78369498501642,9813768589.0,2018-01-29,2018,0,29,1,0.68,285.47,284.736,281.22,4546
2018-01-30 14:30:00,282.6,284.736,281.22,281.76,247.61125,287.26779661016946,252.3071000000005,261.85979999999995,269.8312000000001,278.12500000000006,271.4414481321581,278.62729862159694,281.20384615384603,287.233013916099,275.17467839159303,252.3071000000005,261.85979999999995,269.8312000000001,278.12500000000006,282.572,131796419,93857101.2,65.00324658284438,1.5,2.75,2.075340260853781,1.4042242655582888,0.1423151085686971,4.3938523134139595,4.2515372048452615,12.636654036874736,0.7689281499230991,9681972170.0,2018-01-30,2018,1,30,1,1.25,282.98,283.3,280.68,4547
2018-01-31 14:30:00,282.73,283.3,280.68,281.9,247.66333333333336,287.5874449152542,252.5437500000005,262.21009999999995,270.2968,278.78150000000005,271.8515874210931,278.93898446715906,281.64846153846145,286.91693290429555,276.3799901726273,252.5437500000005,262.21009999999995,270.2968,278.78150000000005,281.96,118948131,95471720.3,65.28604002629497,1.5,2.75,2.1142445279356545,1.2458991063136842,-0.1062980680745671,4.118664619752053,4.22496268782662,11.628822849694087,0.9887511642903172,9800920301.0,2018-01-31,2018,2,31,1,0.93,281.99,283.06,280.68,4548
2018-02-01 14:30:00,281.07,283.06,280.68,281.58,247.71541666666667,287.90709322033894,252.7823000000005,262.5600999999999,270.7712,279.33700000000005,272.2330937967365,279.19050975600106,281.9299999999999,286.7428801548272,277.11711984517257,252.7823000000005,262.5600999999999,270.7712,279.33700000000005,281.7733333333333,90102470,95473323.0,64.01278635743748,1.5,2.75,2.133227061654536,0.943744987277755,-0.3154915011514179,3.830598311387348,4.146089812538766,11.590126408368935,0.4172461752433789,9710817831.0,2018-02-01,2018,3,32,2,0.85,281.87,280.23,275.41,4549
2018-02-02 14:30:00,280.08,280.23,275.41,275.45,247.7675,288.2267415254237,252.99235000000047,262.8225,271.11420000000004,279.52900000000005,272.35924698117816,278.83427073162005,281.81307692307684,287.1478244673438,276.47832937880986,252.99235000000047,262.8225,271.11420000000004,279.52900000000005,277.03000000000003,173174790,100100242.1,45.64722613479135,1.5,2.75,2.4215679858220662,1.7300136979388985,-0.8590726950427245,3.0722489437353597,3.9313216387780847,17.169083491380988,-2.5611093423891926,9537643041.0,2018-02-02,2018,4,33,2,1.75,277.82,275.85,263.31,4550
2018-02-05 14:30:00,273.45,275.85,263.31,263.93,247.81958333333336,288.5463898305085,253.13530000000046,262.9613,271.19300000000004,279.0545000000001,272.028688276034,277.4148163762277,280.6069230769229,291.54073621885163,269.6731099349944,253.13530000000046,262.9613,271.19300000000004,279.0545000000001,267.69666666666666,294681820,110658133.35,28.878776115056247,1.5,2.75,3.14431312969192,2.6629928689285998,-1.9257654423686048,1.524114835817329,3.4498802781859337,27.86676774588767,-6.833986374386676,9242961221.0,2018-02-05,2018,0,36,2,4.76,269.58,269.7,258.7,4551
2018-02-06 14:30:00,259.94,269.7,258.7,269.13,247.87166666666667,288.86603813559316,253.3080000000005,263.1509,271.38040000000007,278.81500000000005,271.91501422599345,276.62578624515845,279.836923076923,292.36863149901814,267.3052146548278,253.3080000000005,263.1509,271.38040000000007,278.81500000000005,265.8433333333333,355026780,125543512.75,39.65476342287888,1.5,2.75,3.705433620428212,2.82791816337798,-2.1929960325746642,0.7086352374676039,2.901631270042268,31.464146421510037,-4.961508581114488,9597988001.0,2018-02-06,2018,1,37,2,4.25,264.2,272.36,267.58,4552
2018-02-07 14:30:00,268.5,272.36,267.58,267.67,247.92375,289.185686440678,253.4605000000005,263.3267,271.52660000000003,278.47150000000005,271.74854307987596,275.77285422180995,278.856923076923,292.95124792415805,264.762598229688,253.4605000000005,263.3267,271.52660000000003,278.47150000000005,269.2033333333334,167376100,131049619.9,37.91762979625626,1.5,2.75,3.7821883618261984,1.2771963789572196,-2.365157921207385,-0.05481613146696418,2.3103417897404213,31.319299431990427,-5.5171196611366025,9430611901.0,2018-02-07,2018,2,38,2,1.79,269.97,268.17,257.59,4553
2018-02-08 14:30:00,268.01,268.17,257.59,257.63,247.97583333333336,289.5053347457627,253.55590000000046,263.41110000000003,271.4746,277.64700000000005,271.19487472380246,274.04496334354235,276.9292307692307,294.75914765335114,259.09931388511035,253.55590000000046,263.41110000000003,271.4746,277.64700000000005,261.13,246449505,139893379.25,28.62967937083277,1.5,2.75,4.267746335981474,1.7616952733665556,-3.0108724610254525,-1.4532487865413939,1.557623674484058,36.06695661532984,-10.101891269453553,9184162396.0,2018-02-08,2018,3,39,2,4.11,262.88,263.61,252.92,4554
2018-02-09 14:30:00,260.8,263.61,252.92,261.5,252.92,289.82498305084744,253.67140000000046,263.5289,271.4472,276.91600000000005,270.81468355816315,272.85020492987167,275.25307692307683,294.42254525102817,256.08360859512544,253.67140000000046,263.5289,271.4472,276.91600000000005,259.3433333333333,283565310,150953572.0,35.216902181867106,1.5,2.75,4.726478740554227,1.8784935410471768,-3.0249851141179716,-2.2236077181634077,0.8013773959545649,36.83398341760154,-8.142475762259384,9467727706.0,2018-02-09,2018,4,40,2,4.23,258.26,267.01,261.6644,4555
2018-02-12 14:30:00,263.83,267.01,261.6644,265.34,253.0131932773109,290.1446313559322,253.80510000000046,263.6826,271.49980000000005,276.2870000000001,270.599990085294,272.1349473175029,273.8807692307692,293.13792528174184,254.62361317979665,253.80510000000046,263.6826,271.49980000000005,276.2870000000001,264.6714666666667,143735976,153599567.0,41.0325975021744,1.5,2.75,4.782444544800351,0.9357837317340876,-2.637502109125459,-2.4955002404522593,0.1420018686732002,39.28919034285236,-5.827654741624082,9611463682.0,2018-02-12,2018,0,43,2,2.04,264.34,266.62,263.31,4556
2018-02-13 14:30:00,263.97,266.62,263.31,266.0,253.10638655462185,290.46427966101686,253.9447000000004,263.842,271.5196,275.73850000000004,270.41959831724324,271.5506666205979,272.54999999999995,291.4064292239249,253.69357077607498,253.9447000000004,263.842,271.5196,275.73850000000004,265.31,81223640,152332991.9,41.99640923547843,1.5,2.75,4.6772699344574695,0.5331979565747634,-2.215547995374739,-2.6274331255452243,-0.4118851301704847,39.583191990921605,-5.6402979780063776,9692687322.0,2018-02-13,2018,1,44,2,1.26,264.97,270.0,264.3,4557
2018-02-14 14:30:00,264.31,270.0,264.3,269.59,253.19957983193282,290.78392796610166,254.0992500000004,264.04400000000004,271.6222,275.23750000000007,270.38706504990034,271.3639364662552,271.2430769230769,288.29775890529993,254.18839494085393,254.0992500000004,264.04400000000004,271.6222,275.23750000000007,267.9633333333333,120735685,152706836.2,47.064692165645845,1.5,2.75,4.750322081996222,0.7906370664498124,-1.6020721533331348,-2.4144753218369037,-0.8124031685037684,40.99386095260117,-4.258114922934872,9813423007.0,2018-02-14,2018,2,45,2,2.16,267.15,273.04,268.77,4558
2018-02-15 14:30:00,271.57,273.04,268.77,273.03,253.2927731092437,291.1035762711864,254.2705500000004,264.2799,271.80000000000007,274.9320000000001,270.49070955774744,271.5226091837547,270.3469230769231,285.61382117426814,255.080024979578,254.2705500000004,264.2799,271.80000000000007,274.9320000000001,271.61333333333334,111200286,153230450.2,51.443001869186624,1.5,2.75,4.716013361853636,0.7257061886515296,-0.9066348228211912,-1.9456966970302572,-1.0390618742090665,42.151742493954465,-0.8785623525140737,9924623293.0,2018-02-15,2018,3,46,2,1.59,270.9,275.32,272.27,4559
2018-02-16 14:30:00,272.32,275.32,272.27,273.11,253.3859663865546,291.4232245762712,254.44370000000043,264.5217,271.99840000000006,274.56700000000006,270.5934268299926,271.6737892614924,269.68153846153837,283.59472832119764,255.76834860187918,254.44370000000043,264.5217,271.99840000000006,274.56700000000006,273.56666666666666,160420135,154205452.05,51.54337798794993,1.5,2.75,4.597012407435519,1.0403013179325522,-0.4086425394878248,-1.5498650485688472,-1.1412225090810224,40.39826328258508,3.4781949759405935,10085043428.0,2018-02-16,2018,4,47,2,1.12,273.79,273.67,270.5,4560
2018-02-20 14:30:00,272.03,273.67,270.5,271.4,253.47915966386554,291.7428728813559,254.60690000000042,264.7449,272.1616000000001,274.00250000000005,270.62505715038503,271.64771409373117,268.8738461538461,280.95442570810604,256.79326659958616,254.60690000000042,264.7449,272.1616000000001,274.00250000000005,271.8566666666667,86369662,153957814.75,49.20209983134803,1.5,2.75,4.4950829497615565,0.5609956346824545,-0.17381280419164913,-1.3584885143205838,-1.1846757101289347,30.89417824751473,0.8434585516293174,9998673766.0,2018-02-20,2018,1,51,2,1.17,272.09,274.72,269.94,4561
2018-02-21 14:30:00,271.9,274.72,269.94,270.05,253.57235294117646,292.0625211864407,254.75865000000042,264.9449,272.28120000000007,273.3405000000001,270.6025058895856,271.4955508467092,267.986923076923,277.65872311498407,258.31512303886205,254.75865000000042,264.9449,272.28120000000007,273.3405000000001,271.57,98883740,154047766.75,47.37261085041049,1.5,2.75,4.515434167635734,0.6419031063298424,-0.09286790494744036,-1.3007605913132352,-1.2078926863657948,29.1991603311915,0.8891545559831118,9899790026.0,2018-02-21,2018,2,52,2,1.77,272.33,273.05,269.64,4562
2018-02-22 14:30:00,271.1,273.05,269.64,270.4,253.66554621848735,292.38216949152536,254.91235000000043,265.1454,272.3790000000001,272.7015,270.59456448215093,271.3912126708321,267.59846153846155,276.4072118947911,258.789711182132,254.91235000000043,265.1454,272.3790000000001,272.7015,271.03000000000003,110511290,152832525.4,47.91335459903057,1.5,2.75,4.436474584233181,0.7230875084394829,-0.003916611838827189,-1.2127884511643288,-1.2088718393255016,28.966698365407147,4.956720878779638,10010301316.0,2018-02-22,2018,3,53,2,1.26,271.35,274.71,271.25,4563
2018-02-23 14:30:00,271.79,274.71,271.25,274.71,253.7587394957983,292.70181779661016,255.08870000000042,265.3802,272.547,272.27200000000005,270.7559541103019,271.70728765456244,268.4276923076923,277.71553433193696,259.13985028344763,255.08870000000042,265.3802,272.547,272.27200000000005,273.5566666666667,92766428,153241481.15,54.15963730665189,1.5,2.75,4.427440685359384,0.6053610765429488,0.3381168355331552,-0.7862257949090576,-1.1243426304422128,15.81873509927034,5.051625239005729,10103067744.0,2018-02-23,2018,4,54,2,1.28,272.98,278.01,275.26,4564
2018-02-26 14:30:00,275.93,278.01,275.26,277.9,253.85193277310924,293.0214661016949,255.27885000000043,265.63599999999997,272.7694,271.83799999999997,271.03611277264304,272.29706978269934,269.1023076923077,279.68055868586623,258.52405669874923,255.27885000000043,265.63599999999997,272.7694,271.83799999999997,277.0566666666667,86491406,152178895.5,58.159038744132786,1.5,2.75,4.346909207833715,0.5683534876227302,0.7486008955486556,-0.18859151100639335,-0.9371924065550491,15.267519009135532,4.7335494083063265,10189559150.0,2018-02-26,2018,0,57,2,1.0,276.64,278.92,274.36,4565
2018-02-27 14:30:00,278.11,278.92,274.36,274.43,253.94512605042016,293.34111440677964,255.4541000000004,265.8517,272.923,271.32550000000003,271.16920638940206,272.5002059938708,269.6223076923077,280.5273612952377,258.71725408937766,255.4541000000004,265.8517,272.923,271.32550000000003,275.90333333333336,99099165,152627936.9,52.76610070826453,1.5,2.75,4.362129978702734,0.6492858844375823,0.7537383668486373,0.0049805520057475405,-0.7487578148428897,17.51546319780893,3.169172932330829,10090459985.0,2018-02-27,2018,1,58,2,1.66,276.64,276.19,271.29,4566
2018-02-28 14:30:00,275.68,276.19,271.29,271.65,254.0383193277311,293.6607627118644,255.61745000000042,266.0366,273.0428,270.82,271.1880610407981,272.41923399445454,270.70076923076925,279.14363954669767,262.25789891484084,255.61745000000042,266.0366,273.0428,270.82,273.0433333333333,121907767,152133504.3,48.85734875527471,1.5,2.75,4.400549265938253,0.8013209684541526,0.5468594003058345,-0.0651835644605967,-0.6120429647664312,19.174646075715533,0.7641232983419275,9968552218.0,2018-02-28,2018,2,59,2,1.81,273.74,273.17,266.0,4567
2018-03-01 14:30:00,271.41,273.17,266.0,267.7,254.131512605042,293.9804110169491,255.75445000000042,266.16700000000003,273.06660000000005,270.11,271.0512743333158,271.96978313783984,271.1776923076923,278.04030519355825,264.3150794218264,255.75445000000042,266.16700000000003,273.06660000000005,270.11,268.9566666666667,176855077,155028851.6,43.88320398644081,1.5,2.75,4.598367175514093,1.1407881512037208,0.14202450538332434,-0.43451233303727577,-0.5765368384206001,19.866998787016943,-1.9521664285975844,9791697141.0,2018-03-01,2018,3,60,3,2.7,269.59,269.72,264.82,4568
2018-03-02 14:30:00,265.8,269.72,264.82,269.08,254.2247058823529,294.3000593220338,255.89945000000043,266.31410000000005,273.0842,269.485,270.9739694574995,271.69456569614084,271.4653846153846,277.5999254878553,265.3308437429139,255.89945000000043,266.31410000000005,273.0842,269.485,267.87333333333333,139083217,157477888.95,45.953455593031684,1.5,2.75,4.6199123772630895,0.8831920336712135,-0.025838770682339415,-0.6088353017735244,-0.5829965310911851,18.43156525474238,-1.4755959137344037,9930780358.0,2018-03-02,2018,4,61,3,1.85,267.27,272.89,267.61,4569
2018-03-05 14:30:00,267.73,272.89,267.61,272.19,254.31789915966385,294.6197076271186,256.0813000000004,266.4965,273.18460000000005,269.322,271.02165692975444,271.74174991555594,271.94153846153847,277.204271569281,266.67880535379595,256.0813000000004,266.4965,273.18460000000005,269.322,270.8966666666667,97307387,153684518.8,50.394884496634596,1.5,2.75,4.667061493172866,0.6331632343959943,0.0740902935501837,-0.4903836641534554,-0.5644739577036391,19.88034541931657,0.2910832719233679,10028087745.0,2018-03-05,2018,0,64,3,1.97,270.25,273.39,271.18,4570
2018-03-06 14:30:00,273.3,273.39,271.18,272.88,254.41109243697483,294.93935593220334,256.26185000000044,266.67910000000006,273.3016,269.7695,271.0945331285876,271.850154685503,272.19461538461536,277.2945859147514,267.09464485447927,256.26185000000044,266.67910000000006,273.3016,269.7695,272.48333333333335,79213163,142911085.95,51.350118890923795,1.5,2.75,4.491557100803376,0.5542828428839603,0.18202034880510956,-0.3369485216972521,-0.5189688705023616,19.55772712202258,1.0479540825772946,10107300908.0,2018-03-06,2018,1,65,3,0.81,272.28,273.18,270.2,4571
2018-03-07 14:30:00,270.42,273.18,270.2,272.78,254.5042857142857,295.25900423728814,256.43420000000043,266.85670000000005,273.4056,269.95199999999994,271.160629868643,271.9387113821217,272.1753846153846,277.26448376725403,267.08628546351514,256.43420000000043,266.85670000000005,273.4056,269.95199999999994,272.05333333333334,87063502,129512922.05,51.1962477370014,1.5,2.75,4.383588736460278,0.6722379560426264,0.23847658277568284,-0.2208731420327581,-0.459349724808441,19.257834929580977,0.8801775147928979,10020237406.0,2018-03-07,2018,2,66,3,1.1,271.69,274.24,272.42,4572
2018-03-08 14:30:00,273.55,274.24,272.42,274.1,254.59747899159663,295.5786525423729,256.6071000000004,267.0513,273.5374,270.2735,271.275899285559,272.14454839334826,272.2515384615384,277.423259473443,267.0798174496338,256.6071000000004,267.0513,273.5374,270.2735,273.5866666666667,66901150,124489174.55,53.190184149835204,1.5,2.75,4.200475255284545,0.5374053626898275,0.34978803995474594,-0.02211467486500851,-0.3719027148197545,19.38320912638047,-0.22205234611042804,10087138556.0,2018-03-08,2018,3,67,3,0.67,273.33,278.87,275.34,4573
2018-03-09 14:30:00,275.7,278.87,275.34,278.87,254.69067226890755,295.8983008474576,256.8012000000004,267.2905,273.77099999999996,271.3355,271.5737071567135,272.7850675939817,272.82615384615383,279.0455603895171,266.60674730279044,256.8012000000004,267.2905,273.77099999999996,271.3355,277.6933333333333,113625335,117847966.05,59.611766804304416,1.5,2.75,4.241155594192788,0.9641688253812676,0.7090202602728144,0.5143726105212636,-0.19464764975155086,19.788226901818785,0.3490464195753967,10200763891.0,2018-03-09,2018,4,68,3,1.28,277.1,279.91,278.0801,4574
2018-03-12 13:30:00,279.2,279.91,278.0801,278.52,254.78386554621846,296.21794915254236,256.99075000000045,267.5228,273.99500000000006,272.1865,271.8461107976267,273.3312516326501,273.47769230769217,280.1550393343044,266.80034528108007,256.99075000000045,267.5228,273.99500000000006,272.1865,278.8367,71924793,107265940.2,58.972489982955075,1.5,2.75,4.068923051750446,0.6705277823127681,0.8764504259712614,0.9009153827125259,0.02446495674126456,18.749953711873253,1.4903618409065973,10128839098.0,2018-03-12,2018,0,71,3,0.66,279.0,280.41,276.03,4575
2018-03-13 13:30:00,279.84,280.41,276.03,276.72,254.87705882352935,280.41,257.1655500000004,267.73530000000005,274.172,272.7555,272.0372437075237,273.65398957239773,273.9638461538461,280.59420773333767,267.33348457435443,257.1655500000004,267.73530000000005,274.172,272.7555,277.72,91968937,104677588.25,55.6662234068789,1.5,2.75,4.091142833768276,0.8785924335623008,0.8203525933622171,1.0499056984440358,0.22955310508181884,17.51966200942224,1.866372170071802,10036870161.0,2018-03-13,2018,1,72,3,1.59,278.22,278.02,274.67,4576
2018-03-14 13:30:00,277.81,278.02,274.67,275.3,254.97025210084038,280.20940322580645,257.3335000000004,267.9311,274.3408,273.2205,272.1651949346797,273.81075247026456,274.00923076923067,280.6674193033902,267.35104223507125,257.3335000000004,267.9311,274.3408,273.2205,275.99666666666667,105895079,105911160.2,53.135338612185485,1.5,2.75,4.038204059927683,0.9998481633099888,0.649473445703746,1.0413949122115014,0.3919214665077554,16.576462907032873,2.838998879342556,9930975082.0,2018-03-14,2018,2,73,3,1.22,276.35,276.61,274.43,4577
2018-03-15 13:30:00,275.88,276.61,274.43,275.0,255.06344537815124,280.0088064516129,257.50100000000043,268.1232,274.4654,273.491,272.2763637607706,273.92401413976324,273.7861538461538,280.0930220850248,267.4792856072828,257.50100000000043,268.1232,274.4654,273.491,275.34666666666664,83433038,104046027.85,52.59132182839522,1.5,2.75,3.905475198504277,0.8018858549822092,0.4856048628586092,0.9989275450810168,0.5133226822224077,13.303553650931676,2.20008919280512,9847542044.0,2018-03-15,2018,3,74,3,0.79,275.52,275.39,274.14,4578
2018-03-16 13:30:00,274.5,275.39,274.14,274.2,255.15663865546216,279.80820967741937,257.6648000000004,268.2941,274.54,273.5495,272.35180047603455,273.95029850740485,273.7684615384615,280.06929345499583,267.46762962192724,257.6648000000004,268.2941,274.54,273.5495,274.57666666666665,100343673,103503197.2,51.089179145619156,1.5,2.75,3.7157983986111134,0.9694741391041783,0.30170500449497784,0.89045393784113,0.5887489333461522,13.56040555417911,0.7384547558690587,9747198371.0,2018-03-16,2018,4,75,3,0.46,274.76,273.38,268.62,4579
2018-03-19 13:30:00,273.35,273.38,268.62,270.49,255.2498319327731,279.60761290322586,257.8004500000004,268.4379,274.5176,273.4185,272.27878869266067,273.6207462686044,273.67923076923074,280.1286432006273,267.22981833783416,257.8004500000004,268.4379,274.5176,273.4185,270.83,109208442,100942612.55,44.71121365909272,1.5,2.75,3.848955655853177,1.0818864228019232,-0.07150678328111937,0.499365454244753,0.5708722375258724,14.661317444942545,-0.8758428613309829,9637989929.0,2018-03-19,2018,0,78,3,1.77,271.0,271.67,270.18,4580
2018-03-20 13:30:00,270.94,271.67,270.18,270.95,255.343025210084,279.40701612903234,257.9343500000004,268.5818,274.4682,273.39599999999996,272.22667933216417,273.36638948111823,273.92923076923074,279.64206361920736,268.2163979192541,257.9343500000004,268.5818,274.4682,273.39599999999996,270.93333333333334,59757271,99611993.0,45.6177372679745,1.5,2.75,3.680458823292237,0.5999003654108196,-0.27752860566989457,0.22396148043850414,0.5014900861083987,14.603503550085733,-0.6708702984089685,9697747200.0,2018-03-20,2018,1,79,3,0.55,270.92,273.27,270.19,4581
2018-03-21 13:30:00,270.9,273.27,270.19,270.43,255.4362184873949,279.20641935483883,258.0665500000004,268.7332,274.3984,273.415,272.1562213191381,273.08673334005937,274.03307692307686,279.4298815880503,268.6362722581034,258.0665500000004,268.7332,274.3984,273.415,271.2966666666667,78709578,98603284.9,44.725002132690456,1.5,2.75,3.6375689073427897,0.7982449882863892,-0.42986775910790814,-0.03584461277648643,0.3940231463314217,14.617338917741424,-1.3389273987595824,9619037622.0,2018-03-21,2018,2,80,3,1.14,271.73,268.87,263.36,4582
2018-03-22 13:30:00,267.91,268.87,263.36,263.67,255.52941176470586,279.0058225806452,258.1688500000004,268.8137,274.181,273.0785,271.8234283262307,272.18990159338705,273.37769230769226,281.0852396731434,265.6701449422411,258.1688500000004,268.8137,274.181,273.0785,265.3,148785916,100517016.2,35.10655194478471,1.5,2.75,3.882742556818304,1.4802062538740581,-0.9378162521479464,-0.7782471688535111,0.15956908329443514,19.668986222227712,-5.450568365188077,9470251706.0,2018-03-22,2018,3,81,3,2.09,266.12,265.02,257.83,4583
2018-03-23 13:30:00,264.17,265.02,257.83,258.05,255.62260504201683,278.80522580645163,258.24080000000043,268.8171,273.85959999999994,272.24550000000005,271.2832938820648,270.8432442987788,272.236923076923,283.48029072085006,260.9935554329961,258.24080000000043,268.8171,273.85959999999994,272.24550000000005,260.29999999999995,183534751,105055432.35,29.438380830631477,1.5,2.75,4.118975231331282,1.7470277061783943,-1.5671366809109541,-1.7993517678442572,-0.2322150869333033,16.817686386025454,-7.349561970415041,9286716955.0,2018-03-23,2018,4,82,3,2.79,261.42,265.43,259.41,4584
2018-03-26 13:30:00,262.13,265.43,259.41,265.11,255.7157983193277,278.6046290322581,258.34745000000044,268.9007,273.6394,271.60600000000005,271.0412039259054,270.2972210322284,271.6469230769231,283.50267243744594,259.79117371640024,258.34745000000044,268.9007,273.6394,271.60600000000005,263.31666666666666,141956102,107828667.15,42.08797508291377,1.5,2.75,4.351905571950476,1.3164968625878075,-1.4267608721386338,-2.015666177106596,-0.5889053049679618,26.058620826094483,-4.195576756287949,9428673057.0,2018-03-26,2018,0,85,3,2.32,262.42,266.77,258.84,4585
2018-03-27 13:30:00,266.17,266.77,258.84,260.6,255.80899159663863,278.40403225806455,258.4334000000004,268.93519999999995,273.29299999999995,270.91450000000003,270.63174494841894,269.37367617201613,270.6084615384616,283.72115379539014,257.495769281533,258.4334000000004,268.93519999999995,273.29299999999995,270.91450000000003,262.07,129941445,109370781.15,37.467190618260034,1.5,2.75,4.607483745382585,1.1880818956736507,-1.5464315987678252,-2.5219448034277434,-0.9755132046599182,26.991745407657195,-5.339629495096254,9298731612.0,2018-03-27,2018,1,86,3,3.06,262.8,262.64,258.58,4586
2018-03-28 13:30:00,260.75,262.64,258.58,259.83,255.90218487394955,278.20343548387103,258.5157500000004,268.9586,272.9502,270.3235000000001,270.2081471073044,268.4647546318241,269.14384615384614,282.48954217791646,255.79815012977585,258.5157500000004,268.9586,272.9502,270.3235000000001,260.35,146452306,110598008.1,36.72583225253136,1.5,2.75,4.568377763569544,1.3241857472476488,-1.5806184255090674,-2.9512862365462524,-1.3706678110371853,27.04609554235129,-5.516363636363641,9152279306.0,2018-03-28,2018,2,87,3,1.57,260.61,265.26,259.8389,4587
2018-03-29 13:30:00,261.12,265.26,259.8389,263.15,255.9953781512605,278.0028387096774,258.60875000000044,269.0142,272.6209999999999,270.09600000000006,269.93135702466503,267.95858752403143,267.96153846153845,280.4723530968972,255.45072382617968,258.60875000000044,269.0142,272.6209999999999,270.09600000000006,262.7496333333333,124244790,107967493.75,42.05012142702884,1.5,2.75,4.629922209028862,1.1507610826615118,-1.2948166758178743,-2.9891886558095284,-1.6943719799916537,29.002860232092768,-4.029905178701681,9276524096.0,2018-03-29,2018,3,88,3,2.09,262.55,263.13,254.67,4588
2018-04-02 13:30:00,262.55,263.13,254.67,257.47,254.67,277.8022419354839,258.67490000000043,269.0044,272.1876,269.5155000000001,269.4426763570312,266.9596744265046,266.48076923076917,279.0511678207131,253.91037064082542,258.67490000000043,269.0044,272.1876,269.5155000000001,258.42333333333335,186286343,110327650.05,36.405924106643035,1.5,2.75,4.9049277655268,1.688482831960763,-1.3948423108518146,-3.437924868556422,-2.0430825577046074,30.62711317000862,-4.813486635365441,9090237753.0,2018-04-02,2018,0,92,4,3.32,258.9,261.31,256.84,4589
2018-04-03 13:30:00,258.87,261.31,256.84,260.77,254.72147058823532,277.6016451612904,258.7599000000004,269.0236,271.79479999999995,268.94450000000006,269.1025714018534,266.3701816239804,265.3630769230769,277.15802338883867,253.5681304573151,258.7599000000004,269.0236,271.79479999999995,268.94450000000006,259.64,119956861,111460123.75,41.33289377383909,1.5,2.75,4.873861496560601,1.0762311844284131,-1.1551918179832343,-3.4870723301836506,-2.3318805122004163,32.01970293681997,-3.757150765823956,9210194614.0,2018-04-03,2018,1,93,4,1.74,259.08,264.355,256.6,4590
2018-04-04 13:30:00,256.75,264.355,256.6,263.56,254.77294117647057,277.4010483870968,258.8645000000004,269.07250000000005,271.4121999999999,268.47850000000005,268.88521566060433,266.10254527883933,264.4830769230769,274.8969150084643,254.0692388376895,258.8645000000004,269.07250000000005,271.4121999999999,268.47850000000005,261.50500000000005,123715339,113685232.55,45.1986081579635,1.5,2.75,5.079657103949129,1.0882269950548649,-0.7451158763279273,-3.263275357610325,-2.5181594812823977,32.96238868594243,-2.540398624412973,9333909953.0,2018-04-04,2018,2,94,4,3.02,260.48,266.64,264.32,4591
2018-04-05 13:30:00,265.55,266.64,264.32,265.64,254.8244117647059,277.20045161290335,258.9694000000004,269.1378,271.0591999999999,268.12150000000014,268.75795230136487,266.05849334752133,263.82461538461536,272.6605476731929,254.98868309603782,258.9694000000004,269.1378,271.0591999999999,268.12150000000014,265.53333333333336,82652618,113464688.35,47.95208993646633,1.5,2.75,4.936824453667048,0.7284435290126984,-0.29332969504957696,-2.8848216000943694,-2.5914919050447924,33.52583131688045,0.7471460537793342,9416562571.0,2018-04-05,2018,3,95,4,0.88,265.48,265.11,258.0,4592
2018-04-06 13:30:00,263.42,265.11,258.0,259.72,254.87588235294118,276.99985483870967,259.0529500000004,269.15330000000006,270.5899999999999,267.4025000000001,268.4035227993506,265.454827314424,262.99615384615385,271.1718684974387,254.820439194869,259.0529500000004,269.15330000000006,270.5899999999999,267.4025000000001,260.9433333333333,179521209,119095691.3,41.55277217263729,1.5,2.75,5.129908421262257,1.5073694693772688,-0.34895647463276713,-3.027687498335752,-2.6787310237029844,32.845357937615994,0.6471614028289152,9237041362.0,2018-04-06,2018,4,96,4,2.76,261.56,264.84,259.9356,4593
2018-04-09 13:30:00,261.37,264.84,259.9356,261.0,254.92735294117645,276.7992580645162,259.14320000000043,269.18240000000003,270.14399999999995,266.50900000000007,268.1131885719251,265.0305580463836,262.23076923076917,269.0321919848183,255.4293464767201,259.14320000000043,269.18240000000003,270.14399999999995,266.50900000000007,261.9252,105442932,118686571.15,43.31423347205211,1.5,2.75,5.129200676886378,0.8884150159392316,-0.2594212982772284,-3.00300764654952,-2.7435863482722915,30.36135287044889,-1.5502998755233728,9342484294.0,2018-04-09,2018,0,99,4,1.89,262.39,266.04,262.98,4594
2018-04-10 13:30:00,264.27,266.04,262.98,265.15,254.97882352941173,276.5986612903226,259.2547500000004,269.2506000000001,269.71539999999993,265.84050000000013,267.9969850985163,265.0419334705375,261.8246153846154,267.07211803098016,256.5771127382506,259.2547500000004,269.2506000000001,269.71539999999993,265.84050000000013,264.7233333333333,105573736,120369018.3,48.71125411117074,1.5,2.75,5.122829199965923,0.8770839663814056,0.10015296668284757,-2.618395139918732,-2.71854810660158,27.412480137843904,1.7459708365310644,9448058030.0,2018-04-10,2018,1,100,4,1.16,264.51,265.64,263.39,4595
2018-04-11 13:30:00,263.47,265.64,263.39,263.76,255.03029411764703,276.3980645161291,259.3579000000004,269.31090000000006,269.2969999999999,265.19250000000017,267.8308288201431,264.9198445685816,261.8315384615385,267.088989415408,256.57408750766905,259.3579000000004,269.31090000000006,269.2969999999999,265.19250000000017,264.2633333333333,91140243,120327583.6,47.09393246651722,1.5,2.75,4.917627114254072,0.7574343327875156,0.2563548972964713,-2.3981044849809905,-2.654459382277462,25.47094684933105,1.5125274217757791,9356917787.0,2018-04-11,2018,2,101,4,0.85,264.52,267.0,265.06,4596
2018-04-12 13:30:00,265.26,267.0,265.06,265.93,255.08176470588236,276.19746774193555,259.47110000000043,269.40580000000006,268.9803999999999,264.72400000000016,267.7562865134708,265.01604984776424,262.4376923076923,267.62802150338456,257.2473631120001,259.47110000000043,269.40580000000006,268.9803999999999,264.72400000000016,265.99666666666667,68890480,118477353.65,49.89105787909467,1.5,2.75,4.797796606093066,0.5814653845452429,0.5035052239290363,-2.0250778523661666,-2.5285830762952033,25.607113044901237,1.0564316929507998,9425808267.0,2018-04-12,2018,3,102,4,0.73,266.03,267.54,264.01,4597
2018-04-13 13:30:00,267.41,267.54,264.01,265.15,255.1332352941176,275.996870967742,259.59020000000044,269.4711000000001,268.64539999999994,264.2315000000001,267.65407919921705,265.02880700512003,262.4407692307692,267.6374750603542,257.24406340118423,259.59020000000044,269.4711000000001,268.64539999999994,264.2315000000001,265.56666666666666,85079176,118559660.55,48.89048132504556,1.5,2.75,4.707239705657849,0.7176064405491418,0.6052945161883119,-1.7719649310598131,-2.3772594472481248,24.85149070748786,2.9828717908882387,9340729091.0,2018-04-13,2018,4,103,4,1.34,265.77,268.2,266.07,4598
2018-04-16 13:30:00,267.0,268.2,266.07,267.33,255.18470588235286,275.79627419354847,259.7094000000004,269.5658000000001,268.3603999999999,263.8880000000001,267.6413702110125,265.2479682427277,262.9584615384616,268.63705207946833,257.27987099745485,259.7094000000004,269.5658000000001,268.3603999999999,263.8880000000001,267.2,63405287,116712741.25,51.8000004599556,1.5,2.75,4.588865440968003,0.5432593418758382,0.798159061573986,-1.3795606202806423,-2.1777196818546285,20.464960632051913,2.5156267975610698,9404134378.0,2018-04-16,2018,0,106,4,0.8,267.14,270.87,268.75,4599
2018-04-17 13:30:00,269.33,270.87,268.75,270.19,255.23617647058828,275.5956774193549,259.8536000000004,269.6847000000001,268.25519999999995,263.87300000000016,267.74131647724727,265.71863793389645,263.75538461538457,270.2964389429284,257.21433028784094,259.8536000000004,269.6847000000001,268.25519999999995,263.87300000000016,269.93666666666667,64682036,114486420.95,55.38809913639985,1.5,2.75,4.513946480898861,0.5649756142542772,1.0795743784794491,-0.8282517087553174,-1.9078260872347663,20.16263165334094,2.5155562300804357,9468816414.0,2018-04-17,2018,1,107,4,0.79,269.81,271.3,269.87,4600
2018-04-18 13:30:00,270.69,271.3,269.87,270.39,255.28764705882355,271.3,259.9965500000004,269.78870000000006,268.38439999999986,263.84500000000014,267.845186419316,266.16352955923963,264.3123076923077,271.7268885616073,256.89772682300804,259.9965500000004,269.78870000000006,268.38439999999986,263.84500000000014,270.52000000000004,57303857,114363750.25,55.6368065840046,1.5,2.75,4.293664589406085,0.5010666131071545,1.229523793392047,-0.3709213454947076,-1.6004451388867549,19.684147908566967,1.7881343171209156,9526120271.0,2018-04-18,2018,2,108,4,0.53,270.59,269.88,267.72,4601
2018-04-19 13:30:00,269.65,269.88,267.72,268.89,255.33911764705883,270.9356,260.1299500000004,269.88000000000005,268.37959999999987,263.76800000000014,267.88615950091145,266.42319341074057,265.1907692307692,271.81887006810956,258.56266839342885,260.1299500000004,269.88000000000005,268.37959999999987,263.76800000000014,268.83,77655909,114311066.8,53.23952958605303,1.5,2.75,4.177688547305648,0.6793385030328489,1.177919969821687,-0.1280451766096462,-1.3059651464313329,19.867060964424372,3.5307253965809173,9448464362.0,2018-04-19,2018,3,109,4,0.81,268.8,269.06,265.61,4602
2018-04-20 13:30:00,268.81,269.06,265.61,266.61,255.39058823529408,270.57120000000003,260.24915000000044,269.94250000000005,268.3583999999999,263.91500000000013,267.8361140302875,266.4409845144796,265.64,271.7825527141465,259.49744728585347,260.24915000000044,269.94250000000005,268.3583999999999,263.91500000000013,267.09333333333336,99953133,111869427.65,49.73185758349129,1.5,2.75,4.1257107939266735,0.8934803288054545,0.950229143150454,-0.11817871749326515,-1.0684078606437193,14.701654991356838,2.149425287356327,9348511229.0,2018-04-20,2018,4,110,4,1.3,267.34,267.89,265.35,4603
2018-04-23 13:30:00,267.26,267.89,265.35,266.57,255.4420588235294,270.2068,260.3792500000004,270.00590000000005,268.5371999999999,264.34100000000007,267.786462499688,266.45327170357683,265.8715384615385,271.90904098214014,259.8340359409368,260.3792500000004,270.00590000000005,268.5371999999999,264.34100000000007,266.6033333333333,65557954,105970587.8,49.6700290410505,1.5,2.75,4.012445737217623,0.6186429212200708,0.7648921262057135,-0.11229270288657743,-0.8771848290922909,14.699371169132835,0.5355459174052484,9282953275.0,2018-04-23,2018,0,113,4,0.96,266.62,267.9762,261.28,4604
2018-04-24 13:30:00,267.73,267.9762,261.28,262.98,255.49352941176468,269.8424,260.4836000000004,270.00700000000006,268.56679999999994,264.23450000000014,267.59797377421,266.12248392228383,265.6669230769231,271.8991044933262,259.43474166052,260.4836000000004,270.00700000000006,268.56679999999994,264.23450000000014,264.07873333333333,112885452,104517055.3,44.34175727065118,1.5,2.75,4.204142470273509,1.0800672835259262,0.3875212789210688,-0.3927832304409549,-0.7803045093620237,14.357964855584422,-0.2957233848953491,9170067823.0,2018-04-24,2018,1,114,4,2.56,264.63,264.13,260.85,4605
2018-04-25 13:30:00,262.91,264.13,260.85,263.63,255.545,269.478,260.5899000000004,270.0162000000001,268.53259999999995,264.38600000000014,267.4423669595351,265.8851045011139,265.9676923076923,271.34105769831194,260.5943269170727,260.5899000000004,270.0162000000001,268.53259999999995,264.38600000000014,262.87,103840948,103212030.45,45.48209811316208,1.5,2.75,4.138132293825398,1.0060934519673526,0.17927340568796654,-0.5562127522520655,-0.735486157940032,14.168549070476475,-0.8648892565712825,9273908771.0,2018-04-25,2018,2,115,4,1.26,262.49,267.2452,264.29,4606
2018-04-26 13:30:00,264.79,267.2452,264.29,266.31,255.59647058823532,269.1136,260.7105000000004,270.02920000000006,268.53879999999987,264.7100000000001,267.39796041210235,265.9255707391031,266.37615384615384,270.92021870524496,261.83208898706266,260.7105000000004,270.02920000000006,268.53879999999987,264.7100000000001,265.9484,67731942,99276012.25,50.02817253857912,1.5,2.75,4.100779987123587,0.6822588907926245,0.21708649095711616,-0.4641280442436369,-0.6812145352007529,14.612275779470297,0.4374882142183764,9341640713.0,2018-04-26,2018,3,116,4,1.12,265.77,267.34,265.5,4607
2018-04-27 13:30:00,267.0,267.34,265.5,266.56,255.64794117647057,268.74920000000003,260.8232500000004,270.05020000000013,268.47819999999984,264.8805000000002,267.3650992194709,265.9859925734742,266.4846153846154,270.9734090576397,261.99582171159113,260.8232500000004,270.05020000000013,268.47819999999984,264.8805000000002,266.46666666666664,57053647,95916455.1,50.44330779284758,1.5,2.75,3.939295702329042,0.5948264762341077,0.2515718865076915,-0.3667496770661387,-0.6183215635738302,14.482345175436148,-0.2880335166273826,9398694360.0,2018-04-27,2018,4,117,4,0.69,266.42,267.89,264.43,4608
2018-04-30 13:30:00,267.26,267.89,264.43,264.51,255.6994117647059,268.3848,260.9237000000004,270.05390000000006,268.3077999999998,265.2325000000002,267.2531345441975,265.8454218521909,266.54230769230765,270.90711205900743,262.17750332560786,260.9237000000004,270.05390000000006,268.3077999999998,265.2325000000002,265.61,82182324,90711254.15,46.99567641238386,1.5,2.75,3.9050602950198234,0.90597715542664,0.13480975919378646,-0.4498093645815969,-0.5846191237753835,14.280881916038814,-2.1022243606351108,9316512036.0,2018-04-30,2018,0,120,4,1.31,266.16,265.1,262.11,4609
2018-05-01 13:30:00,263.87,265.1,262.11,264.98,255.75088235294118,268.0204,261.0208000000004,270.07180000000017,268.1451999999998,265.4430000000002,267.1639920130525,265.76300072341087,266.4692307692307,270.903846087111,262.0346154513504,261.0208000000004,270.07180000000017,268.1451999999998,265.4430000000002,264.06333333333333,74203365,88423579.35,47.87528535951447,1.5,2.75,3.839698845375551,0.8391807428003649,0.08988273246400291,-0.4722657081953798,-0.5621484406593827,12.410768366224438,-2.000813639557664,9390715401.0,2018-05-01,2018,1,121,5,1.14,263.6,265.68,262.76,4610
2018-05-02 13:30:00,264.76,265.68,262.76,263.2,255.80235294117645,267.656,261.1091500000004,270.0714000000001,267.98119999999983,265.4250000000002,267.008541345874,265.5189054164193,266.31923076923067,271.04457625296953,261.5938852854919,261.1091500000004,270.0714000000001,267.98119999999983,265.4250000000002,263.88000000000005,86368943,86556259.55,44.84031912239458,1.5,2.75,3.7740060707058696,0.9978358982819516,-0.051458900435627175,-0.6264720662039167,-0.5750131657682895,12.559251026124727,-2.1161069582357093,9304346458.0,2018-05-02,2018,2,122,5,1.11,264.22,263.36,259.05,4611
2018-05-03 13:30:00,262.26,263.36,259.05,262.62,259.05,267.2916,261.1939500000004,270.05690000000016,267.8325999999999,265.27400000000017,266.8364416852515,265.2428191862842,265.95692307692303,271.0264421535739,260.8874040002721,261.1939500000004,270.05690000000016,267.8325999999999,265.27400000000017,261.6766666666667,136311479,89239202.6,43.864546108723246,1.5,2.75,3.812291351369736,1.5274842785294005,-0.16912349684433292,-0.7864175368237056,-0.6172940399793727,12.426132006807835,-1.4965680207044032,9168034979.0,2018-05-03,2018,3,123,5,1.66,261.21,266.7892,261.15,4612
2018-05-04 13:30:00,261.52,266.7892,261.15,266.02,259.2404347826087,266.9272,261.2891000000004,270.06200000000007,267.74499999999995,265.58900000000017,266.80442436426125,265.3168364066381,265.63615384615383,270.08319288498643,261.1891148073211,261.2891000000004,270.06200000000007,267.74499999999995,265.58900000000017,264.6530666666667,91222075,84824245.9,50.644836711868464,1.5,2.75,3.942784826271899,1.075424532598173,-0.011399844251887227,-0.6315438452942317,-0.6201440010423445,14.438723230990405,-0.2063247927373716,9259257054.0,2018-05-04,2018,4,124,5,2.16,263.97,268.02,266.11,4613
2018-05-07 13:30:00,266.89,268.02,266.11,266.92,259.4308695652174,266.5628,261.38820000000044,270.06810000000013,267.58919999999995,265.88500000000016,266.80895674213343,265.4695186536249,265.36923076923074,268.98098475639654,261.7574767820649,261.38820000000044,270.06810000000013,267.58919999999995,265.88500000000016,267.01666666666665,55304907,82317344.65,52.28765711579739,1.5,2.75,3.804014481538192,0.6718499878142024,0.1511455161695464,-0.4312121058304115,-0.5823576219999579,14.585902168306301,1.4982127918472878,9314561961.0,2018-05-07,2018,0,127,5,0.72,267.06,267.325,265.15,4614
2018-05-08 13:30:00,266.5,267.325,265.15,266.92,259.6213043478261,266.1984,261.4884000000004,270.06950000000006,267.36959999999993,265.9735000000002,266.8133113796968,265.60765973423213,265.2176923076923,268.3607447568221,262.07463985856253,261.4884000000004,270.06950000000006,267.36959999999993,265.9735000000002,266.465,67499247,80413620.2,52.28765711579739,1.5,2.75,3.687656304285465,0.8394006740664064,0.25041174461852944,-0.26934294122679603,-0.5197546858453255,11.731864810092054,1.2479611576831242,9314561961.0,2018-05-08,2018,1,128,5,0.82,266.24,269.865,267.09,4615
2018-05-09 13:30:00,267.68,269.865,267.09,269.5,259.8117391304348,265.834,261.6018000000004,270.0970000000001,267.2709999999999,266.2605000000002,266.91867171774794,265.97835880716235,265.43999999999994,269.27759540094706,261.6024045990528,261.6018000000004,270.0970000000001,267.2709999999999,266.2605000000002,268.8183333333333,59666143,78839915.2,57.04158222314309,1.5,2.75,3.6346094254079313,0.7568012072138809,0.4688909729732112,0.06635903037118851,-0.4025319426020227,12.631613909928578,1.197852127220156,9374228104.0,2018-05-09,2018,2,129,5,1.04,268.48,272.39,270.22,4616
2018-05-10 13:30:00,270.34,272.39,270.22,272.02,260.0021739130435,265.4696,261.7248000000004,270.1606000000001,267.2783999999999,266.56500000000017,267.118723807248,266.55375320648017,265.8592307692307,271.05087767873584,260.6675838597256,261.7248000000004,270.1606000000001,267.2783999999999,266.56500000000017,271.5433333333333,72063931,78998587.75,61.11678546000165,1.5,2.75,3.581423037878793,0.9122179655673656,0.7457398007556988,0.5296428083426008,-0.21609699241309804,12.4542833964623,2.0483193277310847,9446292035.0,2018-05-10,2018,3,130,5,0.8,271.3,273.15,271.58,4617
2018-05-11 13:30:00,272.16,273.15,271.58,272.85,260.1926086956522,265.1052,261.8519000000004,270.2240000000001,267.3813999999999,266.95000000000016,267.3434797363755,267.153395758244,266.6184615384615,272.71222049535186,260.5247025815711,261.8519000000004,270.2240000000001,267.3813999999999,266.95000000000016,272.5266666666667,59871511,77738204.5,62.38254903505849,1.5,2.75,3.4377499637445927,0.7701684311476477,0.93510914592366,0.9527894399914772,0.017680294067817043,12.43979118187263,3.15299988658275,9506163546.0,2018-05-11,2018,4,131,5,0.58,272.36,274.08,272.36,4618
2018-05-14 13:30:00,273.34,274.08,272.36,272.98,260.3830434782609,264.7408,261.98080000000044,270.2718000000001,267.4593999999999,267.2325000000002,267.56451974671376,267.70831044793505,267.33769230769224,274.02864212572103,260.64674248966344,261.98080000000044,270.2718000000001,267.4593999999999,267.2325000000002,273.14000000000004,54790606,77307470.45,62.58797323861101,1.5,2.75,3.3150535377628336,0.7087362408971435,1.0129173245873506,1.2838269498020054,0.2709096252146547,10.801320835129598,3.0190957808136463,9560954152.0,2018-05-14,2018,0,134,5,0.63,273.22,271.61,270.03,4619
2018-05-15 13:30:00,271.59,271.61,270.03,271.1,260.5734782608696,264.3764,262.10175000000044,270.31110000000007,267.4375999999999,267.2780000000002,267.7031660311564,268.03132850051264,267.70615384615377,274.65281896064454,260.759488731663,262.10175000000044,270.31110000000007,267.4375999999999,267.2780000000002,270.91333333333336,87036036,78425170.45,57.68224398554001,1.5,2.75,3.288978285065492,1.1097972181710445,0.8861401443392325,1.3785848056386951,0.4924446612994628,12.25488737266513,3.0015197568389187,9473918116.0,2018-05-15,2018,1,135,5,0.59,270.82,272.76,271.11,4620
2018-05-16 13:30:00,271.14,272.76,271.11,272.24,260.76391304347834,264.012,262.2291000000004,270.36320000000006,267.42479999999995,267.37050000000016,267.88108108875804,268.4321543576067,268.1430769230769,275.45150992197443,260.83464392417943,262.2291000000004,270.36320000000006,267.42479999999995,267.37050000000016,272.0366666666667,53942631,78257109.15,59.74281585789089,1.5,2.75,3.1726226932750974,0.6893000723628186,0.8284883459728656,1.5280550937655448,0.6995667477926792,10.83664013498612,3.6630873505445143,9527860747.0,2018-05-16,2018,2,136,5,0.61,271.94,273.23,271.13,4621
2018-05-17 13:30:00,271.94,273.23,271.13,272.01,260.954347826087,263.6476,262.3525500000004,270.4075000000001,267.40939999999995,267.52650000000017,268.0429994774342,268.7729015616442,268.7199999999999,275.97406623371035,261.46593376628954,262.3525500000004,270.4075000000001,267.40939999999995,267.52650000000017,272.12333333333333,56536400,77201133.7,59.11737258030553,1.5,2.75,3.0960067866125915,0.7323260331862199,0.7278667083676347,1.6094001332522223,0.8815334248845879,10.606351948392515,2.2517103977144606,9471324347.0,2018-05-17,2018,3,137,5,0.77,272.18,272.03,270.93,4622
2018-05-18 13:30:00,271.62,272.03,270.93,271.33,261.14478260869566,263.2832,262.47200000000043,270.44570000000016,267.3539999999999,267.76250000000016,268.17190145871126,269.0164347462495,269.20846153846145,276.2411887527736,262.17573432414935,262.47200000000043,270.44570000000016,267.3539999999999,267.76250000000016,271.43,64367959,75421875.0,57.21040621923596,1.5,2.75,2.953434873283119,0.853438859747255,0.5752102563256409,1.6005462452916392,1.025335988965998,9.229054975661088,1.6521804285928248,9406956388.0,2018-05-18,2018,4,138,5,0.41,271.48,273.98,271.3512,4623
2018-05-21 13:30:00,273.01,273.98,271.3512,273.37,261.33521739130435,262.9188,262.6040500000004,270.50750000000016,267.2439999999999,268.1025000000002,268.37574846033044,269.43106000851145,269.9907692307692,276.41196711344014,263.5695713480982,262.6040500000004,270.50750000000016,267.2439999999999,268.1025000000002,272.90040000000005,58025875,75045271.05,61.24888705540468,1.5,2.75,2.9317609537628977,0.7732116119793799,0.5702149192022212,1.7381046379687746,1.1678897187665531,9.743661167583356,2.4164543683500628,9464982263.0,2018-05-21,2018,0,141,5,0.97,272.67,274.25,272.24,4624
2018-05-22 13:30:00,273.96,274.25,272.24,272.61,261.52565217391304,262.5544,262.7300500000004,270.56040000000013,267.1257999999999,268.5840000000002,268.5417975403175,269.733816198177,270.75923076923067,275.6850963255746,265.8333652128867,262.7300500000004,270.56040000000013,267.1257999999999,268.5840000000002,273.03333333333336,52966358,72049316.35,59.014260574436506,1.5,2.75,2.8659208856369762,0.7351403272544723,0.4780434782320351,1.7654440665565971,1.287400588324562,10.11620416592574,1.1539888682745876,9412015905.0,2018-05-22,2018,1,142,5,0.74,273.24,273.39,270.99,4625
2018-05-23 13:30:00,271.17,273.39,270.99,273.36,261.7160869565218,262.19,262.8575000000004,270.61530000000016,267.0586,269.0705000000001,268.73074665638353,270.07916703644594,271.3238461538461,275.58522576763613,267.06246654005605,262.8575000000004,270.61530000000016,267.0586,269.0705000000001,272.58,64694184,70091978.15,60.54411763078953,1.5,2.75,2.83264082237719,0.9229898443093092,0.4313386380738253,1.826573885916844,1.3952352478430183,8.954106797979842,0.4926108374384354,9476710089.0,2018-05-23,2018,2,143,5,0.89,272.19,273.22,270.78,4626
2018-05-24 13:30:00,272.91,273.22,270.78,272.8,261.90652173913054,261.8256,262.9852000000004,270.6747000000001,267.00859999999994,269.3950000000001,268.89032521887816,270.3382939853558,271.77615384615376,275.24662300936865,268.30568468293893,262.9852000000004,270.6747000000001,267.00859999999994,269.3950000000001,272.26666666666665,76043827,70507572.4,58.779875502974654,1.5,2.75,2.8145950493502503,1.0785200002148991,0.3309954797591106,1.8089795975419063,1.477984117782796,7.561468945387168,-0.018325087044167625,9400666262.0,2018-05-24,2018,3,144,5,0.9,272.0,272.86,271.58,4627
2018-05-25 13:30:00,272.15,272.86,271.58,272.15,262.0969565217392,261.4612,263.10970000000043,270.7085000000002,266.9515999999999,269.67450000000014,269.0181556024516,270.510837415322,272.1784615384615,274.22386683814375,270.1330562387792,263.10970000000043,270.7085000000002,266.9515999999999,269.67450000000014,272.19666666666666,56374755,70473627.8,56.714080867943004,1.5,2.75,2.704981117253806,0.7999411518871745,0.19579502154338124,1.7227278947120226,1.5269328731686411,7.478201999270603,-0.30405157887026185,9344291507.0,2018-05-25,2018,4,145,5,0.47,272.22,271.17,267.76,4628
2018-05-29 13:30:00,270.31,271.17,267.76,269.02,262.28739130434786,261.0968,263.23600000000044,270.6940000000002,266.8479999999999,269.9000000000001,269.01822793176717,270.368852899577,272.1415384615384,274.386599312544,269.8964776105328,263.23600000000044,270.6940000000002,266.8479999999999,269.9000000000001,269.31666666666666,115908607,72159941.95,47.9711971152075,1.5,2.75,2.8253396088785334,1.6062735621421882,-0.11287994825144775,1.3858329378543317,1.4987128861057797,9.8553773428265,-0.7672445592032611,9228382900.0,2018-05-29,2018,1,149,5,1.27,269.47,273.11,270.42,4629
2018-05-30 13:30:00,270.5,273.11,270.42,272.61,262.4778260869565,260.7324,263.37845000000044,270.7040000000002,266.89039999999994,270.28150000000005,269.1590817383646,270.5822954805697,272.18692307692305,274.4441423957008,269.9297037581453,263.37845000000044,270.7040000000002,266.89039999999994,270.28150000000005,272.0466666666667,69678449,71933696.15,56.29351790658251,1.5,2.75,2.9156724939586405,0.9686482515051466,-0.08499215207646182,1.392472696010202,1.4774648480866641,12.268144165173448,0.1359094916250384,9298061349.0,2018-05-30,2018,2,150,5,0.99,271.76,272.49,270.255,4630
2018-05-31 13:30:00,272.15,272.49,270.255,270.94,262.66826086956524,260.368,263.5004500000004,270.6792000000001,266.89019999999994,270.66850000000005,269.2289216701934,270.6163625776582,272.04,274.35339909751974,269.7266009024802,263.5004500000004,270.6792000000001,266.89019999999994,270.66850000000005,271.2283333333333,93519941,72291246.05,52.11724585503239,1.5,2.75,2.8756244586758815,1.2936551257577888,-0.1831024562279897,1.2485867778016768,1.4316892340296663,12.57584606876132,-0.39336789088636204,9204541408.0,2018-05-31,2018,3,151,5,0.83,271.37,273.94,272.33,4631
2018-06-01 13:30:00,272.41,273.94,272.33,273.6,262.85869565217394,260.0036,263.63590000000045,270.67600000000016,266.95359999999994,271.2175000000001,269.4003365066564,270.9005185226432,272.08769230769224,274.5000853595064,269.67529925587814,263.63590000000045,270.67600000000016,266.95359999999994,271.2175000000001,273.29,71258411,69038592.65,57.52275473636082,1.5,2.75,2.8845084259133187,1.032153296653274,-0.07829501254601977,1.3338204683471415,1.4121154808931615,13.868178425029805,0.8366196144915928,9275799819.0,2018-06-01,2018,4,152,6,0.59,273.14,275.185,274.26,4632
2018-06-04 13:30:00,274.53,275.185,274.26,274.9,263.0491304347826,259.6392,263.7757000000004,270.67960000000016,267.17819999999995,271.66150000000005,269.6160095848267,271.28142152048673,272.38,275.13885148897685,269.62114851102314,263.7757000000004,270.67960000000016,267.17819999999995,271.66150000000005,274.78166666666664,45392351,66747106.45,59.905039389627994,1.5,2.75,2.791686395490937,0.6800647011418125,0.06158959230304095,1.4891024712719627,1.4275128789689218,13.901231252959628,0.5596810183999608,9321192170.0,2018-06-04,2018,0,155,6,0.34,274.72,275.53,274.18,4633
2018-06-05 13:30:00,275.05,275.53,274.18,275.1,263.2395652173913,259.2748,263.93575000000044,270.6894000000001,267.5192,272.0705000000001,269.8310680324806,271.6450956613928,272.6,275.7125651058589,269.487434894141,263.93575000000044,270.6894000000001,267.5192,272.0705000000001,274.93666666666667,51135038,66538613.0,60.274171309184524,1.5,2.75,2.6887087958130107,0.7685017119307852,0.1457870947410278,1.6097467473952063,1.4639596526541787,13.332015372145966,0.9133927588863244,9372327208.0,2018-06-05,2018,1,156,6,0.49,274.86,277.52,275.09,4634
2018-06-06 13:30:00,275.79,277.52,275.09,277.4,263.43000000000006,258.9104,264.10920000000044,270.7022000000002,267.765,272.59450000000004,270.12788889395193,272.19318178887914,273.01461538461535,277.01243490860986,269.01679586062085,264.10920000000044,270.7022000000002,267.765,272.59450000000004,276.67,62732215,66300261.4,64.34005543437229,1.5,2.75,2.670229596112082,0.9461835243985932,0.32435204375701976,1.8693997073504531,1.5450476635934336,13.805575430197624,1.4779045946736769,9435059423.0,2018-06-06,2018,2,157,6,0.88,276.3,278.28,276.34,4635
2018-06-07 13:30:00,277.95,278.28,276.34,277.37,263.62043478260875,258.546,264.28155000000044,270.6967000000002,268.1003999999999,272.98800000000006,270.4118932510519,272.6862120947002,273.47923076923075,277.96059362192057,268.9978679165409,264.28155000000044,270.6967000000002,268.1003999999999,272.98800000000006,277.33,72969402,66965424.35,64.24768826394491,1.5,2.75,2.618070339246933,1.089657875064298,0.4032695897823966,2.0491346508214288,1.6458650610390326,13.826655175621898,1.6752199413489708,9362090021.0,2018-06-07,2018,3,158,6,0.7,277.31,278.25,276.66,4636
2018-06-08 13:30:00,276.85,278.25,276.66,278.19,263.81086956521744,258.1816,264.44530000000043,270.7089000000002,268.46759999999995,273.29650000000004,270.7169170451283,273.21038237139544,273.85,278.9839233759833,268.71607662401664,264.44530000000043,270.7089000000002,268.46759999999995,273.29650000000004,277.70000000000005,72139719,66969213.75,65.69726829124893,1.5,2.75,2.544636743586436,1.07720719656799,0.4689189672132781,2.2320137700556297,1.7630948028423519,13.65981086294941,2.2193643211464344,9434229740.0,2018-06-08,2018,4,159,6,0.57,277.46,279.37,278.31,4637
2018-06-11 13:30:00,278.44,279.37,278.31,278.56,264.00130434782614,257.8172,264.61530000000045,270.69840000000016,268.77579999999995,273.582,271.0244889257115,273.71986976459584,274.30769230769226,279.9532223507581,268.66216226462643,264.61530000000045,270.69840000000016,268.77579999999995,273.582,278.74666666666667,58892515,66920263.95,66.36004319101869,1.5,2.75,2.44716269047312,0.8800400883654912,0.4930239548741791,2.3793747464350763,1.8863507915608968,13.392119213698848,3.546204743141782,9493122255.0,2018-06-11,2018,0,162,6,0.38,278.84,279.33,278.19,4638
2018-06-12 13:30:00,279.03,279.33,278.19,278.92,264.1917391304348,257.4528,264.78995000000043,270.6962000000001,269.2048,273.879,271.33411681097766,274.2151202632058,274.7353846153846,280.85172648529084,268.61904274547834,264.78995000000043,270.6962000000001,269.2048,273.879,278.81333333333333,72329028,67797185.05,67.02757760615796,1.5,2.75,2.353793926867896,1.066844116708648,0.4880642226312064,2.496431069849905,2.0083668472186984,10.160102749449019,2.3146619713143326,9565451283.0,2018-06-12,2018,1,163,6,0.41,278.76,279.48,277.8,4639
2018-06-13 13:30:00,279.19,279.48,277.8,278.03,264.3821739130435,279.48,264.95730000000043,270.6724000000001,269.54999999999995,274.22549999999995,271.5967004654492,274.5784421429005,275.13769230769225,281.3786496003484,268.8967350150361,264.95730000000043,270.6724000000001,269.54999999999995,274.22549999999995,278.43666666666667,79070610,67398913.75,63.66412586309725,1.5,2.75,2.3056657892344754,1.1731733584504542,0.38426280752876,2.4886953566296484,2.1044325491008884,8.737123478838987,2.6168155311138905,9486380673.0,2018-06-13,2018,2,164,6,0.6,278.64,279.33,278.0599,4640
2018-06-14 13:30:00,279.01,279.33,278.0599,278.73,264.5726086956522,279.68974358974356,265.1281000000004,270.6328000000001,269.8534,274.55,271.87643770209826,274.9738286054814,275.6438461538461,281.90075391041887,269.38693839727324,265.1281000000004,270.6328000000001,269.8534,274.55,278.70663333333334,77097620,68556663.2,65.14556050743089,1.5,2.75,2.23383251857487,1.124582446130488,0.3245450549982962,2.5101138678487587,2.1855688128504625,7.048522482758107,1.8749999999999984,9563478293.0,2018-06-14,2018,3,165,6,0.46,278.69,277.51,275.35,4641
2018-06-15 13:30:00,276.6,277.51,275.35,277.13,264.7630434782609,279.8994871794872,265.28950000000043,270.5712000000001,270.0832,274.806,272.0824597529964,275.1791782621022,276.26769230769224,281.24480394360853,271.290580671776,265.28950000000043,270.5712000000001,270.0832,274.806,276.66333333333336,120143175,71737001.95,59.203949820740796,1.5,2.75,2.3157016243909507,1.674772735606356,0.1480682607823498,2.3706541388283995,2.2225858780460497,7.090064815724706,0.8112040742088099,9443335118.0,2018-06-15,2018,4,166,6,0.78,276.43,276.7,274.95,4642
2018-06-18 13:30:00,275.49,276.7,274.95,276.56,264.9534782608696,280.1092307692308,265.4422500000004,270.50500000000017,270.42,275.0675,272.2580495666044,275.3106850942829,276.5715384615384,281.07843468945646,272.0646422336202,265.4422500000004,270.50500000000017,270.42,275.0675,276.07,52917581,71164483.05,57.202369856677436,1.5,2.75,2.3060086512201687,0.7435953825845996,-0.02694491738187921,2.1889047313187007,2.21584964870058,6.94912724938512,0.5307161032351797,9390417537.0,2018-06-18,2018,0,169,6,0.64,275.82,275.75,273.53,4643
2018-06-19 13:30:00,274.0,275.75,273.53,275.5,265.14391304347834,280.3189743589744,265.58230000000043,270.4270000000002,270.71,275.17400000000004,272.3851848777179,275.3287150853036,276.9223076923076,280.1495394552583,273.69507592935685,265.58230000000043,270.4270000000002,270.71,275.17400000000004,274.9266666666667,97531510,73139764.8,53.57493510117346,1.5,2.75,2.357722318990159,1.3334949909491642,-0.22307549171848384,1.9370052840524752,2.160080775770959,7.397690145563187,-0.6849315068493069,9292886027.0,2018-06-19,2018,1,170,6,0.81,274.64,276.72,275.59,4644
2018-06-20 13:30:00,276.27,276.72,275.59,275.97,265.334347826087,280.52871794871794,265.7229500000004,270.32090000000017,270.92639999999994,275.34200000000004,272.5257658629054,275.3897898390842,277.10461538461533,279.7813483574874,274.42788241174327,265.7229500000004,270.32090000000017,270.92639999999994,275.34200000000004,276.0933333333333,53785486,73180721.2,54.93939044466298,1.5,2.75,2.2764564390622923,0.7349679685856936,-0.3240110922566668,1.7550669104501253,2.079078002706792,5.439367864451525,-0.5047409597288738,9346671513.0,2018-06-20,2018,2,171,6,0.41,276.15,275.98,273.68,4645
2018-06-21 13:30:00,275.96,275.98,273.68,274.24,265.52478260869566,280.7384615384616,265.8638500000004,270.21650000000017,271.136,275.3860000000001,272.5929907310268,275.28028604488566,277.0538461538461,279.91462107259923,274.193071235093,265.8638500000004,270.21650000000017,271.136,275.3860000000001,274.6333333333334,71061404,73499082.2,49.20663515599182,1.5,2.75,2.278138121986415,0.96683389605646,-0.4996494900616071,1.4545161401297833,1.9541656301913903,6.3474888379775685,-1.4198928789676082,9275610109.0,2018-06-21,2018,3,172,6,0.84,274.83,275.785,274.49,4646
2018-06-22 13:30:00,275.66,275.785,274.49,274.74,265.7152173913044,280.94820512820513,266.0030500000004,270.14630000000017,271.3122,275.48300000000006,272.6771871729473,275.2288302310871,277.0261538461538,279.9678701265344,274.0844375657732,266.0030500000004,270.14630000000017,271.3122,275.48300000000006,275.00500000000005,56612003,72527491.0,50.80440553119718,1.5,2.75,2.2257711132731006,0.7805592364969581,-0.569450706348124,1.2423522472562354,1.8118029536043596,6.1104743243572965,-1.3713383113153337,9332222112.0,2018-06-22,2018,4,173,6,0.47,275.14,273.6162,269.1,4647
2018-06-25 13:30:00,273.44,273.6162,269.1,271.0,265.9056521739131,281.15794871794867,266.12370000000044,270.0373000000002,271.4291999999999,275.42550000000006,272.6114151269493,274.82608449479307,276.53384615384607,280.8714636385305,272.19622866916177,266.12370000000044,270.0373000000002,271.4291999999999,275.42550000000006,271.23873333333336,137854162,76601461.35,40.53351824518429,1.5,2.75,2.469644605182164,1.7996283565678999,-0.8385451338061238,0.7636215363467045,1.6021666701528283,9.127718909390794,-2.8395238778144325,9194367950.0,2018-06-25,2018,0,176,6,1.68,271.36,272.56,270.79,4648
2018-06-26 13:30:00,271.64,272.56,270.79,271.6,266.0960869565218,281.3676923076923,266.2488000000004,269.93750000000017,271.5146,275.5545000000001,272.5717517886376,274.5188383524318,276.09,281.12010016719813,271.0598998328019,266.2488000000004,269.93750000000017,271.5146,275.5545000000001,271.65000000000003,68683211,74240191.55,42.54045239594361,1.5,2.75,2.4196699905262937,0.925148623219036,-0.9395664355817206,0.4277086256756775,1.3672750612573978,9.290249758301098,-2.3127000683379317,9263051161.0,2018-06-26,2018,1,177,6,0.65,271.68,273.865,269.18,4649
2018-06-27 13:30:00,272.26,273.865,269.18,269.35,266.28652173913054,281.57743589743586,266.34950000000043,269.87650000000014,271.4977999999999,275.39150000000006,272.44540858124003,274.02656803315256,275.41,281.416089217786,269.40391078221387,266.34950000000043,269.87650000000014,271.4977999999999,275.39150000000006,270.79833333333335,105110674,76011802.8,37.437891352954615,1.5,2.75,2.5814792769172734,1.382820432197406,-1.1096859346470604,-0.01983235705142761,1.0898535775956328,9.845600943428902,-3.365263875435007,9157940487.0,2018-06-27,2018,2,178,6,1.74,271.52,271.75,268.49,4650
2018-06-28 13:30:00,269.29,271.75,268.49,270.89,268.49,281.7871794871795,266.4537000000004,269.9461000000002,271.5078,275.3890000000002,272.38441216628945,273.72784726809044,274.81999999999994,280.97742703505844,268.66257296494143,266.4537000000004,269.9461000000002,271.5078,275.3890000000002,270.37666666666667,76650517,75168331.6,42.519804383138606,1.5,2.75,2.629945042851753,1.01971821601532,-1.0697987552885817,-0.24739486651509426,0.8224038887734875,10.653607357698931,-2.2516508497816936,9234591004.0,2018-06-28,2018,3,179,6,1.21,270.12,273.66,271.1495,4651
2018-06-29 13:30:00,272.12,273.66,271.1495,271.28,268.7320512820513,281.99692307692317,266.5592500000004,269.96760000000006,271.5556,275.27300000000014,272.34110188525847,273.49471895684366,274.23230769230764,280.1666103412109,268.2980050434044,266.5592500000004,269.96760000000006,271.5556,275.27300000000014,272.02983333333333,97592499,76485036.0,43.765599121785726,1.5,2.75,2.6399489683623445,1.275968530628658,-0.9713264358809008,-0.3917541560776385,0.5795722798032623,10.735679096185958,-1.9091698004049864,9332183503.0,2018-06-29,2018,4,180,6,0.93,272.4,272.04,269.24,4652
2018-07-02 13:30:00,269.51,272.04,269.24,271.86,268.97410256410257,282.2066666666667,266.66810000000044,270.0095000000002,271.6606,275.1210000000001,272.3222351446601,273.33903143714434,273.75769230769225,279.37986902189357,268.1355155934909,266.66810000000044,270.0095000000002,271.6606,275.1210000000001,271.0466666666667,63554774,77393157.15,45.652108735265806,1.5,2.75,2.651381184907892,0.8211937119559671,-0.8269569618224212,-0.4541239224747642,0.37283303934765705,11.011958496273312,-1.3212341197822093,9395738277.0,2018-07-02,2018,0,183,7,1.04,270.64,272.98,270.42,4653
2018-07-03 13:30:00,272.87,272.98,270.42,270.9,269.21615384615393,282.4164102564103,266.7766500000004,270.1422000000002,271.7472,274.91100000000006,272.26646121741857,273.10674272884484,273.1553846153846,278.1616982622761,268.1490709684931,266.7766500000004,270.1422000000002,271.7472,274.91100000000006,271.43333333333334,42187071,76945758.8,43.07624597088632,1.5,2.75,2.6448539574144707,0.5482702576194493,-0.7577825268808762,-0.5743951192534382,0.18338740762743794,10.99197601626627,-1.8371562126318255,9353551206.0,2018-07-03,2018,1,184,7,0.95,271.7,273.18,270.96,4654
2018-07-05 13:30:00,272.17,273.18,270.96,273.11,269.4582051282051,282.62615384615384,266.89360000000045,270.2583000000002,271.9498,274.69650000000007,272.29954116967673,273.1070529451453,272.8461538461538,277.2981787161958,268.3941289761118,266.89360000000045,270.2583000000002,271.9498,274.69650000000007,272.4166666666667,56925919,76655444.0,50.0617947861455,1.5,2.75,2.6187929604562967,0.7426206937109385,-0.5353359899083917,-0.4857825797580517,0.04955341015033998,12.257456856601872,-0.4120478413068828,9410477125.0,2018-07-05,2018,3,186,7,0.82,272.07,275.84,272.715,4655
2018-07-06 13:30:00,273.14,275.84,272.715,275.42,269.70025641025643,282.83589743589744,267.0208500000004,270.35910000000007,272.1856,274.5990000000001,272.4219121041992,273.32733361703623,272.7584615384615,276.9518177940234,268.56510528289965,267.0208500000004,270.35910000000007,272.1856,274.5990000000001,274.6583333333333,66493696,76331658.7,56.122869109578026,1.5,2.75,2.6549506061379904,0.8711155650545296,-0.2208805784104258,-0.22654731286269225,-0.005666734452266467,12.844933629320217,0.2475067336390794,9476970821.0,2018-07-06,2018,4,187,7,1.15,274.28,277.96,276.5,4656
2018-07-09 13:30:00,276.55,277.96,276.5,277.9,269.9423076923077,283.04564102564103,267.16005000000035,270.4781000000001,272.41740000000004,274.58450000000005,272.6367390805051,273.76282565350897,272.9430769230769,277.766898482545,268.11925536360883,267.16005000000035,270.4781000000001,272.41740000000004,274.58450000000005,277.4533333333333,50550399,75252192.7,61.52232378508031,1.5,2.75,2.6467398485567024,0.6717465257327977,0.14611237521506035,0.17697373456655896,0.03086135935149862,13.748099396275926,2.5461254612546043,9527521220.0,2018-07-09,2018,0,190,7,0.53,277.23,279.01,278.08,4657
2018-07-10 13:30:00,278.41,279.01,278.08,278.9,270.18435897435904,283.2553846153846,267.30760000000043,270.5712000000001,272.6642,274.6015000000001,272.8823571557794,274.25208035317485,273.1684615384615,278.7510545182913,267.5858685586317,267.30760000000043,270.5712000000001,272.6642,274.6015000000001,278.6633333333333,51966829,74905908.4,63.47416649168294,1.5,2.75,2.536972716516939,0.6937614149540171,0.4320133032598669,0.5708779884263322,0.13886468516646536,9.989274964060986,2.687776141384372,9579488049.0,2018-07-10,2018,1,191,7,0.33,278.54,278.04,276.52,4658
2018-07-11 13:30:00,277.15,278.04,276.52,276.86,270.4264102564103,283.46512820512817,267.4447000000004,270.6095000000002,272.9112,274.49850000000004,273.0383431496704,274.5004536528724,273.36999999999995,279.2727659748278,267.4672340251721,267.4447000000004,270.6095000000002,272.9112,274.49850000000004,277.14,77054739,75142193.95,57.109717065659154,1.5,2.75,2.525760379622872,1.025452345073563,0.4571095778961665,0.7102516575366735,0.253142079640507,11.592218144489314,2.7881937998886173,9502433310.0,2018-07-11,2018,2,192,7,0.55,277.28,279.43,277.6,4659
2018-07-12 13:30:00,278.28,279.43,277.6,279.37,270.66846153846154,283.6748717948718,267.5969000000004,270.67210000000017,273.19900000000007,274.56550000000004,273.2866434183108,274.96421997164646,273.7261538461538,280.4220241622351,267.0302835300725,267.5969000000004,270.67210000000017,273.19900000000007,274.56550000000004,278.8,60124687,74194897.8,62.13979824937204,1.5,2.75,2.5289203525069515,0.8103614774438035,0.6067514853943443,1.0115814363834374,0.4048299509890931,10.177710293757052,3.130421942485887,9562557997.0,2018-07-12,2018,3,193,7,0.66,278.52,279.93,278.66,4660
2018-07-13 13:30:00,279.17,279.93,278.66,279.59,270.91051282051285,283.88461538461536,267.7494500000004,270.75400000000013,273.52680000000004,274.60850000000005,273.5338338724947,275.4047704505373,274.38692307692304,281.5550035392622,267.2188426145839,267.7494500000004,270.75400000000013,273.52680000000004,274.60850000000005,279.3933333333334,48234964,72751765.0,62.55432389318953,1.5,2.75,2.438997470185025,0.6630074748014705,0.6790863471469522,1.2536878849227833,0.5746015377758311,10.20633565824823,3.063255676791508,9610792961.0,2018-07-13,2018,4,194,7,0.46,279.3,279.803,278.84,4661
2018-07-16 13:30:00,279.64,279.803,278.84,279.34,271.1525641025641,284.094358974359,267.8959000000003,270.8469000000002,273.86120000000005,274.71900000000005,273.7615266618086,275.77955421715285,274.9823076923077,282.4067420042173,267.5578733803981,267.8959000000003,270.8469000000002,273.86120000000005,274.71900000000005,279.32766666666663,48201038,69154658.15,61.72724416196589,1.5,2.75,2.3335690794575252,0.6970034888387341,0.6676326601873848,1.409142363010062,0.7415097028226774,10.435106724192464,2.7514161700875306,9562591923.0,2018-07-16,2018,0,197,7,0.35,279.32,280.91,278.41,4662
2018-07-17 13:30:00,278.47,280.91,278.41,280.47,271.3946153846154,284.3041025641026,268.0465000000003,270.9476000000002,274.1502,274.9145000000001,274.0246040476201,276.22626333932874,275.8376923076923,283.02801124291886,268.6473733724657,268.0465000000003,270.9476000000002,274.1502,274.9145000000001,279.93,52315500,69124554.1,64.04151682531702,1.5,2.75,2.3454570023534163,0.7568294751575114,0.6908090615332567,1.6050210297392482,0.9142119682059916,10.439330577971807,3.5326688815061096,9614907423.0,2018-07-17,2018,1,198,7,0.9,279.66,281.18,280.06,4663
2018-07-18 13:30:00,280.56,281.18,280.06,281.06,271.63666666666666,284.51384615384615,268.1956500000004,271.01110000000017,274.433,275.19250000000005,274.3005019281056,276.68661921177363,276.62,283.69898297778235,269.54101702221766,268.1956500000004,271.01110000000017,274.433,275.19250000000005,280.76666666666665,44593465,66477651.85,65.22391494785793,1.5,2.75,2.2579243593281726,0.6708038530094381,0.6984399540279116,1.787261910740881,1.088821956712969,9.593154810266343,2.910915015927644,9659500888.0,2018-07-18,2018,2,199,7,0.4,280.62,280.74,279.46,4664
2018-07-19 13:30:00,280.31,280.74,279.46,280.0,271.878717948718,284.72358974358974,268.3340500000004,271.0321000000002,274.6946,275.39400000000006,274.52401165641515,277.0021792868428,277.29076923076923,283.85228154018614,270.7292569213523,268.3340500000004,271.0321000000002,274.6946,275.39400000000006,280.0666666666666,61412117,66858983.4,61.3225117144533,1.5,2.75,2.2109297622333046,0.9185320188401188,0.5890361675129214,1.8251171661041208,1.2360809985911998,9.998326948511485,1.6629148210006477,9598088771.0,2018-07-19,2018,3,200,7,0.46,280.1,280.48,279.5,4665
2018-07-20 13:30:00,279.77,280.48,279.5,279.68,272.1207692307692,284.93333333333334,268.4681500000003,271.0846000000002,274.8982,275.66600000000005,274.7262072777322,277.257209830953,277.8923076923077,283.7478725870411,272.0367427975742,268.4681500000003,271.0846000000002,274.8982,275.66600000000005,279.88666666666666,82372729,67424549.65,60.15274773660482,1.5,2.75,2.12300620778807,1.221702323969471,0.4578949774530021,1.8084497204074523,1.3505547429544502,9.413260976594596,0.6405181720043288,9515716042.0,2018-07-20,2018,4,201,7,0.35,279.99,280.43,279.06,4666
2018-07-23 13:30:00,279.45,280.43,279.06,280.2,272.3628205128205,285.14307692307693,268.60335000000026,271.17010000000016,275.0618,275.93900000000014,274.9408658158604,277.5374755613384,278.60769230769216,282.94766149469933,274.2677231206851,268.60335000000026,271.17010000000016,275.0618,275.93900000000014,279.8966666666667,47047565,66946327.75,61.439970509892255,1.5,2.75,2.0692200500889224,0.7027654328657332,0.3725670441886853,1.8162635481903069,1.4436965040016214,8.16446060072914,0.4661168877733996,9562763607.0,2018-07-23,2018,0,204,7,0.49,279.74,282.56,280.63,4667
2018-07-24 13:30:00,281.79,282.56,280.63,281.61,272.6048717948718,285.35282051282053,268.73810000000026,271.3092000000001,275.237,276.4695000000001,275.2024004897482,277.92533503168715,279.2615384615384,282.51713100975684,276.00594591332003,268.73810000000026,271.3092000000001,275.237,276.4695000000001,281.6,68026935,63454966.4,64.76384278360709,1.5,2.75,2.089990046511143,1.0720506031187498,0.37637556913452985,1.914165965419784,1.5377903962852542,8.379267751239611,1.7156685689518167,9630790542.0,2018-07-24,2018,1,205,7,0.69,281.6,284.37,281.28,4668
2018-07-25 13:30:00,281.33,284.37,281.28,284.01,272.8469230769231,285.5625641025641,268.8863000000003,271.45850000000013,275.4576,277.0900000000001,275.54779654897374,278.5048269334312,279.9223076923076,283.2763330932825,276.5682822913327,268.8863000000003,271.45850000000013,275.4576,277.0900000000001,283.22,78882927,63964952.2,69.57179473787886,1.5,2.75,2.1614193289032064,1.2332210732114015,0.4981751011798044,2.160509272760009,1.6623341715802051,7.5173341468622175,1.6608798367755973,9709673469.0,2018-07-25,2018,2,206,7,1.1,282.82,284.11,283.09,4669
2018-07-26 13:30:00,283.2,284.11,283.09,283.34,273.08897435897444,285.7723076923077,269.0332500000003,271.57000000000016,275.7024,277.7895000000001,275.8533731548964,278.9653196064378,280.34076923076907,283.93029640369616,276.75124205784215,269.0332500000003,271.57000000000016,275.7024,277.7895000000001,283.5133333333333,57919495,61605393.25,66.83026471779576,1.5,2.75,2.0798893768386946,0.9401692277972756,0.490488508129096,2.275444806741575,1.7849562986124792,6.728914982580353,1.34124968704174,9651753974.0,2018-07-26,2018,3,207,7,0.36,283.6,283.82,280.38,4670
2018-07-27 13:30:00,283.71,283.82,280.38,281.42,273.33102564102563,285.9820512820513,269.16725000000025,271.6554000000001,275.88599999999997,278.3160000000001,276.07167224686117,279.19909869153895,280.53461538461534,284.0636476370761,277.0055831321545,269.16725000000025,271.6554000000001,275.88599999999997,278.3160000000001,281.87333333333333,76783177,61612026.25,59.5842027912339,1.5,2.75,2.1770401356359304,1.2462368416263538,0.32115546204277523,2.1864006261659483,1.865245164123173,8.224384503441717,0.7446123004224391,9574970797.0,2018-07-27,2018,4,208,7,1.23,282.1,281.69,279.36,4671
2018-07-30 13:30:00,281.51,281.69,279.36,279.95,273.5730769230769,286.1917948717949,269.29190000000017,271.72710000000006,276.0448,278.74950000000007,276.2237635312981,279.2706131018685,280.7723076923076,283.6321210680775,277.91249431653773,269.29190000000017,271.72710000000006,276.0448,278.74950000000007,280.3333333333333,63742508,59919526.7,54.6945946322211,1.5,2.75,2.1879658402333626,1.063801927527575,0.0873682393482742,1.974455463308516,1.8870872239602416,8.873531923519346,-0.18540307341249995,9511228289.0,2018-07-30,2018,0,211,7,0.83,280.52,282.02,280.38,4672
2018-07-31 13:30:00,280.81,282.02,280.38,281.33,273.8151282051282,286.4015384615385,269.42535000000026,271.79940000000016,276.24480000000005,279.22300000000007,276.4240080986981,279.46674518740485,280.92307692307685,283.67593708173695,278.17021676441664,269.42535000000026,271.79940000000016,276.24480000000005,279.22300000000007,281.24333333333334,68570493,60170312.65,58.165361033194856,1.5,2.75,2.179539708788122,1.1396067259756877,0.007119111959441594,1.895986113909544,1.8888670019501024,9.024860406665196,0.09606489717497396,9579798782.0,2018-07-31,2018,1,212,7,0.58,281.2,282.13,280.1315,4673
2018-08-01 13:30:00,281.56,282.13,280.1315,280.86,274.0571794871795,286.6112820512821,269.55490000000026,271.81930000000017,276.3946,279.72100000000006,276.5979685654159,279.5994361219377,281.02076923076913,283.6654790335071,278.37605942803117,269.55490000000026,271.81930000000017,276.3946,279.72100000000006,281.0405,53853326,60753625.4,56.57568495291213,1.5,2.75,2.1666083010175403,0.8864216027509694,-0.09076742391473447,1.7754077220566842,1.8661751459714184,9.010014684542703,0.307142857142862,9525945456.0,2018-08-01,2018,2,213,8,0.71,281.13,282.58,279.16,4674
2018-08-02 13:30:00,279.39,282.58,279.16,282.39,274.2992307692308,286.82102564102564,269.6904000000003,271.8580000000002,276.5902,280.18500000000006,276.8251070530466,279.8652041103246,281.25538461538446,283.8013511434445,278.70941808732454,269.6904000000003,271.8580000000002,276.5902,280.18500000000006,281.37666666666667,63426363,61078647.6,60.37249760863994,1.5,2.75,2.2561362795162845,1.0384375799440588,-0.0667351668189613,1.782756187447717,1.8494913542666784,9.17189782520083,0.9689645308924412,9589371819.0,2018-08-02,2018,3,214,8,1.23,280.87,283.6577,282.33,4675
2018-08-03 13:30:00,282.53,283.6577,282.33,283.6,274.54128205128205,287.03076923076924,269.8310500000003,271.92680000000007,276.795,280.59400000000016,277.09078912939776,280.22089895696035,281.4961538461537,284.2803459091477,278.71196178315967,269.8310500000003,271.92680000000007,276.795,280.59400000000016,283.1959,53935386,60450732.1,63.11892655343723,1.5,2.75,2.189819402407978,0.8922205592279336,0.012184067645089058,1.8647214388230395,1.8525373711779505,9.267409191114597,1.2134189864382705,9643307205.0,2018-08-03,2018,4,215,8,0.47,282.99,284.99,283.2015,4676
2018-08-06 13:30:00,283.64,284.99,283.2015,284.64,274.78333333333336,287.24051282051283,269.97565000000026,272.02020000000016,277.0318,280.9310000000001,277.38683661451944,280.6417657229641,281.77153846153834,285.0012452465304,278.54183167654617,269.97565000000026,272.02020000000016,277.0318,280.9310000000001,284.2771666666667,39400887,59893256.5,65.34225979331165,1.5,2.75,2.161153730807408,0.6578518067388772,0.11049154670395887,1.9906518045578991,1.8801602578539405,9.357644183287524,1.075956109513147,9682708092.0,2018-08-06,2018,0,218,8,0.63,284.1,286.01,285.24,4677
2018-08-07 13:30:00,285.39,286.01,285.24,285.58,275.0253846153846,287.45025641025643,270.12460000000027,272.1260000000001,277.3004,281.2650000000002,277.70813713944017,281.1120737493485,282.20076923076914,285.83275077542663,278.5687876861116,270.12460000000027,272.1260000000001,277.3004,281.2650000000002,285.61,43196646,59454747.35,67.26321079613955,1.5,2.75,2.1046427500354503,0.7265466245396466,0.209164162397534,2.1416154608508577,1.932451298453324,9.17634771549119,0.5527974367099726,9725904738.0,2018-08-07,2018,1,219,8,0.27,285.62,285.91,284.94,4678
2018-08-08 13:30:00,285.39,285.91,284.94,285.46,275.2674358974359,287.66,270.2663500000002,272.23860000000013,277.6292,281.69500000000016,278.0121317614229,281.52616196369627,282.64538461538444,286.3486107796285,278.9421584511404,270.2663500000002,272.23860000000013,277.6292,281.69500000000016,285.43666666666667,42114551,57707737.95,66.7545421801605,1.5,2.75,2.0235968393186345,0.7297903625418399,0.2347696060141451,2.225913305971005,1.99114369995686,8.011861089224737,0.7482176889955547,9683790187.0,2018-08-08,2018,2,220,8,0.34,285.42,285.97,284.915,4679
2018-08-09 13:30:00,285.53,285.97,284.915,285.07,275.50948717948717,287.8697435897436,270.41115000000025,272.38440000000014,277.87839999999994,281.9800000000002,278.2889109080338,281.8636703481061,283.01999999999987,286.6423494288025,279.39765057119723,270.41115000000025,272.38440000000014,277.87839999999994,281.9800000000002,285.3183333333333,35716976,56487352.4,65.03322584583205,1.5,2.75,1.954411350795876,0.6323004085424262,0.19546982540201,2.2354809817093724,2.0400111563073624,7.901274195484892,1.2969938170705626,9648073211.0,2018-08-09,2018,3,221,8,0.37,285.44,284.055,282.36,4680
2018-08-10 13:30:00,283.45,284.055,282.36,283.16,275.75153846153853,288.0794871794872,270.5441500000003,272.50650000000013,278.1227999999999,282.1585000000002,278.47993400967954,281.9871303149532,283.1392307692306,286.6689416881909,279.6095198502703,270.5441500000003,272.50650000000013,278.1227999999999,282.1585000000002,283.19166666666666,77076044,57929406.4,57.24764628119088,1.5,2.75,2.008381968596169,1.3305167235409476,0.02010050283145892,2.065136784846686,2.0450362820152272,7.875098493721856,1.1466333273799023,9570997167.0,2018-08-10,2018,4,222,8,0.6,283.21,284.16,281.77,4681
2018-08-13 13:30:00,283.47,284.16,281.77,282.1,275.9935897435897,288.2892307692308,270.6782000000003,272.62320000000005,278.29279999999994,282.2965000000002,278.6218973818489,281.9978798087672,282.9923076923075,286.5238112190796,279.46080416553554,270.6782000000003,272.62320000000005,278.29279999999994,282.2965000000002,282.6766666666667,65732909,58805999.95,53.42505545275389,1.5,2.75,2.0356403994107315,1.1177925561318507,-0.1771622217271518,1.823583504856288,2.0007457265834394,7.509352588723138,0.27369992535457954,9505264258.0,2018-08-13,2018,0,225,8,0.85,282.97,284.17,282.4833,4682
2018-08-14 13:30:00,282.92,284.17,282.4833,283.9,276.23564102564103,288.4989743589744,270.81960000000026,272.8255000000001,278.47279999999995,282.4680000000002,278.82888179824704,282.17903411269407,283.03538461538443,286.5963405404719,279.47442869029703,270.81960000000026,272.8255000000001,278.47279999999995,282.4680000000002,283.51776666666666,43842031,58382326.5,58.49342631554635,1.5,2.75,2.038094656595679,0.7509469668016742,-0.19488416146551255,1.7571405247515486,1.9520246862170607,7.8389272067579645,1.0823898027486871,9549106289.0,2018-08-14,2018,1,226,8,0.6,283.33,282.54,280.16,4683
2018-08-15 13:30:00,282.38,282.54,280.16,281.78,276.4776923076924,288.708717948718,270.9399500000003,273.0628000000001,278.60639999999995,282.50400000000013,278.94461192380595,282.1410308638661,283.06307692307684,286.5786631822284,279.54749066392515,270.9399500000003,273.0628000000001,278.60639999999995,282.50400000000013,281.49333333333334,102887320,61297019.25,51.39897896384357,1.5,2.75,2.1596593239816984,1.678504456805214,-0.3488654639366953,1.5159428562961919,1.8648083202328876,9.141261373083776,-0.2160133149190884,9446218969.0,2018-08-15,2018,2,227,8,0.85,281.35,285.04,283.36,4684
2018-08-16 13:30:00,283.4,285.04,283.36,284.06,276.7197435897436,288.91846153846154,271.0765000000003,273.25230000000016,278.73959999999994,282.70700000000016,279.1452153777743,282.3237898292121,283.3792307692306,286.42610014906137,280.3323613893998,271.0765000000003,273.25230000000016,278.73959999999994,282.70700000000016,284.15333333333336,69967919,61724809.35,57.38523485607757,1.5,2.75,2.238255086554437,1.1335461338286013,-0.2985866851103693,1.4915749638449256,1.7901616489552947,9.778345547473172,0.1622002820874399,9516186888.0,2018-08-16,2018,3,228,8,0.59,284.2,285.5601,283.37,4685
2018-08-17 13:30:00,283.83,285.5601,283.37,285.06,276.9617948717949,289.1282051282052,271.21605000000017,273.4969000000001,278.8934,282.97600000000017,279.37716771590084,282.58438127404906,283.6661538461537,286.5869813206821,280.74532637162525,271.21605000000017,273.4969000000001,278.8934,282.97600000000017,284.66336666666666,65618481,60887096.95,59.728174174125186,1.5,2.75,2.234815437514833,1.077707499404765,-0.20392341140336945,1.535257384701083,1.7391807961044523,9.682844158234552,0.1475548060708319,9581805369.0,2018-08-17,2018,4,229,8,0.77,284.47,285.97,285.06,4686
2018-08-20 13:30:00,285.57,285.97,285.06,285.67,277.20384615384614,289.33794871794873,271.3569500000002,273.7553000000001,279.04299999999995,283.2495000000002,279.6239454525321,282.8782497241396,284.0361538461537,286.6431094943216,281.4291981979858,271.3569500000002,273.7553000000001,279.04299999999995,283.2495000000002,285.56666666666666,39807490,60525093.2,61.131982610281575,1.5,2.75,2.1401857634066324,0.6577022503453163,-0.11082730759190128,1.6006466616145758,1.7114739692064769,9.540489460611832,0.03151481196163311,9621612859.0,2018-08-20,2018,0,232,8,0.32,285.52,287.31,285.7135,4687
2018-08-21 13:30:00,286.25,287.31,285.7135,286.34,277.44589743589745,289.5476923076924,271.50070000000017,273.9872000000001,279.19859999999994,283.4860000000002,279.8873201406681,283.2079402266025,284.3399999999998,287.02817352917737,281.6518264708223,271.50070000000017,273.9872000000001,279.19859999999994,283.4860000000002,286.4545,67271983,60487345.6,62.67113276509267,1.5,2.75,2.1044582088775856,1.1121662280382825,-0.019512069424465484,1.6870838824258954,1.7065959518503608,9.448536421687956,0.3082743641841223,9688884842.0,2018-08-21,2018,1,233,8,0.56,286.51,286.76,285.575,4688
2018-08-22 13:30:00,285.88,286.76,285.575,286.17,277.6879487179487,289.75743589743587,271.6393000000002,274.27420000000006,279.3435999999999,283.59400000000016,280.13369974299485,283.4900411574023,284.53769230769217,287.3540527942733,281.72133182111105,271.6393000000002,274.27420000000006,279.3435999999999,283.59400000000016,286.1683333333333,44993333,58792865.9,62.00025884887893,1.5,2.75,2.0387826225291867,0.7652855888421659,0.012337695328608069,1.7220180710111208,1.7096803756825127,9.453659462047844,0.3858701371593022,9643891509.0,2018-08-22,2018,2,234,8,0.41,286.17,286.94,285.43,4689
2018-08-23 13:30:00,285.97,286.94,285.43,285.79,277.93,289.96717948717946,271.77400000000017,274.52440000000007,279.4988,283.71650000000017,280.355515439348,283.70908485669725,284.62615384615367,287.52096127654363,281.7313464157639,271.77400000000017,274.52440000000007,279.4988,283.71650000000017,286.05333333333334,49204851,58357133.7,60.442727576948386,1.5,2.75,2.001012435205673,0.8431677137014698,-0.008183793419439311,1.6994506339082136,1.7076344273276531,9.451290428957947,0.9288035033196762,9594686658.0,2018-08-23,2018,3,235,8,0.53,286.18,287.67,286.38,4690
2018-08-24 13:30:00,286.44,287.67,286.38,287.51,278.1720512820513,290.1769230769231,271.91820000000024,274.7639000000001,279.67439999999993,284.0210000000002,280.6360834613344,284.0710767751071,284.77461538461534,288.02588368513585,281.5233470840947,271.91820000000024,274.7639000000001,279.67439999999993,284.0210000000002,287.18666666666667,57487399,57392344.8,64.75822250919498,1.5,2.75,1.9923686898338389,1.0016562173985266,0.07358094762585797,1.7996106118599755,1.7260296642341175,8.815971068940662,1.9177596596951318,9652174057.0,2018-08-24,2018,4,236,8,0.45,287.02,289.9,288.68,4691
2018-08-27 13:30:00,288.86,289.9,288.68,289.78,278.41410256410256,290.38666666666666,272.0715500000003,275.00530000000003,279.9274,284.5125000000002,280.9946684236349,284.61478374890635,285.10692307692295,289.31327274315413,280.90057341069183,272.0715500000003,275.00530000000003,279.9274,284.5125000000002,289.4533333333333,57072377,57058838.25,69.48909701068445,1.5,2.75,2.0207709262742783,1.0002372770006407,0.2501024822928468,2.038657767100176,1.7885552848073292,8.792686950490168,2.0711518140190197,9709246434.0,2018-08-27,2018,0,239,8,0.42,289.29,290.4175,289.4,4692
2018-08-28 13:30:00,290.3,290.4175,289.4,289.92,278.65615384615387,290.5964102564103,272.23030000000017,275.30730000000005,280.1946,284.9420000000002,281.3446814266297,285.12004243948667,285.4799999999999,290.40586267334857,280.55413732665124,272.23030000000017,275.30730000000005,280.1946,284.9420000000002,289.9125,46943472,55977487.2,69.75872845146236,1.5,2.75,1.9491087172546897,0.8386134202894338,0.3402605308431257,2.2138809483612363,1.8736204175181104,8.537797741793664,2.8887784796650027,9756189906.0,2018-08-28,2018,1,240,8,0.35,289.91,291.74,289.8854,4693
2018-08-29 13:30:00,290.16,291.74,289.8854,291.48,278.8982051282051,291.74,272.39725000000027,275.61210000000005,280.5142,285.4730000000002,281.7421449000952,285.7257526833452,286.1199999999999,291.7809648538718,280.45903514612803,272.39725000000027,275.61210000000005,280.5142,285.4730000000002,291.03513333333336,61485514,56359096.6,72.65822998806969,1.5,2.75,1.9423580945936407,1.0909598930654256,0.4614069455938086,2.450379099510372,1.9889721539165628,6.095879040115357,2.6121241991128694,9817675420.0,2018-08-29,2018,2,241,8,0.64,290.81,291.36,289.63,4694
2018-08-30 13:30:00,290.94,291.36,289.63,290.3,279.1402564102564,291.96703703703713,272.55710000000033,275.8636,280.8008,285.8685000000001,282.07774706087577,286.1613952849313,286.7507692307692,292.30583323530016,281.1957052262381,272.55710000000033,275.8636,280.8008,285.8685000000001,290.43,61229501,56249253.5,67.39454227049487,1.5,2.75,1.9357610878369536,1.0885389083430237,0.4197135340658864,2.513614071498921,2.0939005374330346,6.635998465626893,1.8382094997544407,9756445919.0,2018-08-30,2018,3,242,8,0.6,290.5,290.81,289.29,4695
2018-08-31 13:30:00,289.84,290.81,289.29,290.31,279.3823076923077,292.19407407407414,272.72000000000025,276.12910000000005,281.1222,286.2040000000002,282.4005805094688,286.55650049589025,287.24384615384605,292.83701527593325,281.6506770317588,272.72000000000025,276.12910000000005,281.1222,286.2040000000002,290.13666666666666,66140838,56859526.1,67.41608552117873,1.5,2.75,1.90606386727717,1.163232311920377,0.35312731958512833,2.5353096869144447,2.1821823673293173,6.678853084237231,1.6242517590226435,9822586757.0,2018-08-31,2018,4,243,8,0.53,290.05,290.21,288.68,4696
2018-09-04 13:30:00,289.84,290.21,288.68,289.81,279.62435897435904,292.4211111111112,272.8868500000002,276.3679,281.4236,286.4625000000002,282.69114597968576,286.86635759151983,287.8615384615384,292.61525665746035,283.1078202656164,272.8868500000002,276.3679,281.4236,286.4625000000002,289.56666666666666,57594367,57769200.1,65.09998960613224,1.5,2.75,1.8863450196145144,0.9969735932002284,0.24107748072021984,2.483529218229592,2.242451737509372,6.9730790644549865,1.2118460571348844,9764992390.0,2018-09-04,2018,1,247,9,0.53,289.44,289.64,287.89,4697
2018-09-05 13:30:00,289.41,289.64,287.89,289.03,279.8664102564103,292.6481481481481,273.03890000000024,276.60670000000005,281.7842,286.6350000000002,282.9397284902863,287.07241877327976,288.24384615384605,292.48490943460024,284.0027828730918,273.03890000000024,276.60670000000005,281.7842,286.6350000000002,288.8533333333333,72452437,59231989.65,61.547655506244574,1.5,2.75,1.888748946784908,1.223197758983266,0.08798735036249195,2.352435925462487,2.264448575099995,7.323716828115576,0.9994059475137004,9692539953.0,2018-09-05,2018,2,248,9,0.61,288.76,289.49,287.0,4698
2018-09-06 13:30:00,289.15,289.49,287.0,288.16,280.1084615384616,292.8751851851852,273.1904000000003,276.815,282.1154,286.7700000000001,283.144445020079,287.1759979377293,288.48230769230764,292.3088317534463,284.65578363116884,273.1904000000003,276.815,282.1154,286.7700000000001,288.2166666666667,65909863,60421755.25,57.76164535100754,1.5,2.75,1.9316954505859865,1.0908299953765412,-0.08874493273064354,2.1535174091866907,2.2422623419173338,7.633062870077429,0.8292802407362064,9626630090.0,2018-09-06,2018,3,249,9,0.87,288.24,288.7,286.71,4699
2018-09-07 13:30:00,286.98,288.7,286.71,287.6,280.35051282051285,293.10222222222217,273.3369000000002,276.9891,282.4804,286.8965000000002,283.31917266635037,287.216379086517,288.63076923076915,292.14646118838334,285.11507727315484,273.3369000000002,276.9891,282.4804,286.8965000000002,287.67,73524824,62312147.65,55.39938030012208,1.5,2.75,1.9358600612584165,1.1799436670515722,-0.2510453173813252,1.9284556951906782,2.179501012572003,7.700543077679098,0.03130325901708874,9553105266.0,2018-09-07,2018,4,250,9,0.69,287.7,289.04,287.88,4700
2018-09-10 13:30:00,288.74,289.04,287.88,288.1,280.5925641025641,293.3292592592593,273.4774500000002,277.1662,282.8246,287.14350000000024,283.50665609119943,287.3005334592296,288.76615384615366,292.04621518199923,285.4860925103082,273.4774500000002,277.1662,282.8246,287.14350000000024,288.3400000000001,50210903,60968890.6,57.08688791292285,1.5,2.75,1.9004414854542435,0.8235495595519332,-0.32757310662226397,1.770034629294173,2.097607735916437,6.968463548863918,-0.5797501552902029,9603316169.0,2018-09-10,2018,0,253,9,0.4,288.46,289.55,286.975,4701
2018-09-11 13:30:00,287.37,289.55,286.975,289.05,280.8346153846154,293.5562962962963,273.62390000000016,277.3678,283.17999999999995,287.4910000000002,283.7240421268387,287.46714932025543,288.98769230769216,291.90546968988707,286.06991492549724,273.62390000000016,277.3678,283.17999999999995,287.4910000000002,288.5250000000001,50530492,60208769.75,60.1704225491362,1.5,2.75,1.9486242364932251,0.8392546834923496,-0.3168640274942476,1.7015277015486276,2.0183917290428752,5.464586929549774,-0.3000827814569552,9653846661.0,2018-09-11,2018,1,254,9,0.9,288.26,289.8,288.23,4702
2018-09-12 13:30:00,289.06,289.8,288.23,289.12,281.07666666666665,293.78333333333336,273.7677000000002,277.5929,283.5252,287.7520000000003,283.9356483179431,287.62456367070735,289.243846153846,291.5044048113109,286.983287496381,273.7677000000002,277.5929,283.5252,287.7520000000003,289.05,59810758,61007206.1,60.39623837533572,1.5,2.75,1.92157964817228,0.9803884134926808,-0.3074753039013445,1.634047599166195,1.9415229030675392,5.454492635117179,-0.8096610402085953,9713657419.0,2018-09-12,2018,2,255,9,0.54,289.02,291.0384,289.995,4703
2018-09-13 13:30:00,290.32,291.0384,289.995,290.83,281.318717948718,294.01037037037037,273.9207000000003,277.8355,283.9238,288.20450000000017,284.2060150505727,287.92984332111615,289.4992307692306,291.66680242060175,287.3316591178595,273.9207000000003,277.8355,283.9238,288.20450000000017,290.6211333333333,51034222,58414551.2,65.53655755147493,1.5,2.75,1.9213525304456904,0.8736559804297529,-0.19404455890875405,1.6989672044315969,1.8930117633403507,5.6595125039739775,0.18256975542541254,9764691641.0,2018-09-13,2018,3,256,9,0.36,290.52,291.27,290.0,4704
2018-09-14 13:30:00,291.06,291.27,290.0,290.88,281.5607692307692,294.23740740740743,274.0607500000002,278.1145,284.27919999999995,288.5455000000003,284.46773995055025,288.2108106238669,289.583846153846,291.87122340180656,287.2964689058855,274.0607500000002,278.1145,284.27919999999995,288.5455000000003,290.71666666666664,55079875,57670149.0,65.67683876246377,1.5,2.75,1.874827349699568,0.9550846660722171,-0.1268435727559991,1.7344572973953518,1.8613008701513507,5.1059932442786975,0.1963418414797951,9819771516.0,2018-09-14,2018,4,257,9,0.44,290.64,290.86,289.03,4705
2018-09-17 13:30:00,290.82,290.86,289.03,289.34,281.8028205128205,294.46444444444444,274.19390000000016,278.3716,284.55759999999987,288.7595000000003,284.65880897209735,288.318352469213,289.53923076923064,291.8212603859414,287.2572011525199,274.19390000000016,278.3716,284.55759999999987,288.7595000000003,289.74333333333334,68244043,57801427.1,57.86438290471895,1.5,2.75,1.8730539675781719,1.1806636345143111,-0.19332227387330714,1.6196480278097167,1.812970301683024,6.007699052750034,-0.16217521824644673,9751527473.0,2018-09-17,2018,0,260,9,0.63,289.94,291.58,289.55,4706
2018-09-18 13:30:00,289.58,291.58,289.55,290.91,282.0448717948718,294.6914814814815,274.32340000000016,278.6176,284.8178,289.0215000000002,284.9039537182896,288.5651760435737,289.49538461538447,291.6446115301902,287.3461577005787,274.32340000000016,278.6176,284.8178,289.0215000000002,290.68,61930407,58907572.95,62.731589900586435,1.5,2.75,1.8992643984654465,1.0513148632445906,-0.14119033476198473,1.6364823832305433,1.777672717992528,6.751411626382258,0.6504515102238704,9813457880.0,2018-09-18,2018,1,261,9,0.7,290.56,291.69,290.825,4707
2018-09-19 13:30:00,290.97,291.69,290.825,291.22,282.28692307692313,294.9185185185185,274.45720000000017,278.8642,285.0642,289.2655000000002,285.1516418077684,288.8180164203762,289.56615384615367,291.8716060922916,287.2607016000158,274.45720000000017,278.8642,285.0642,289.2655000000002,291.245,49080562,57998001.9,63.6250588859096,1.5,2.75,1.8253883700036293,0.8462457393726179,-0.09753684169491916,1.6557516658738791,1.7532885075687985,6.464408503737989,1.0619100499722385,9862538442.0,2018-09-19,2018,2,262,9,0.3,291.26,293.94,291.2363,4708
2018-09-20 13:30:00,292.64,293.94,291.2363,293.58,282.5289743589744,293.94,274.60440000000017,279.1549,285.39859999999993,289.6360000000002,285.48216565844416,289.2715386660546,289.8176923076921,292.9560030129741,286.6793816024102,274.60440000000017,279.1549,285.39859999999993,289.6360000000002,292.91876666666667,100360646,60766367.55,69.60015594208964,1.5,2.75,1.8892892007176536,1.6515821176479062,0.06956265442396359,1.8402418255987527,1.7706791711747891,7.1871181290656105,2.079276773296231,9962899088.0,2018-09-20,2018,3,263,9,0.93,292.59,293.22,291.81,4709
2018-09-21 13:30:00,293.09,293.22,291.81,291.99,282.77102564102563,294.08666666666664,274.7484000000002,279.425,285.6509999999999,289.9460000000002,285.7373748483091,289.53043974547796,289.9853846153845,293.3303014512862,286.6404677794828,274.7484000000002,279.425,285.6509999999999,289.9460000000002,292.34,105597145,63585982.25,62.188388670195685,1.5,2.75,1.8807685435235344,1.6606984945962675,0.05303776256349857,1.8369763743791625,1.7839386118156637,8.08305034788132,1.3502256161055142,9857301943.0,2018-09-21,2018,4,264,9,0.48,292.52,291.5,290.37,4710
2018-09-24 13:30:00,291.34,291.5,290.37,291.02,283.01307692307694,294.23333333333335,274.8873000000001,279.70320000000004,285.87959999999987,290.1215000000002,285.94453661896364,289.6723026268611,290.1384615384614,293.4766125343137,286.8003105426091,274.8873000000001,279.70320000000004,285.87959999999987,290.1215000000002,290.9633333333333,53409645,63382094.55,58.12197796322932,1.5,2.75,1.8621422189861392,0.8426614074400292,-0.038267008371775324,1.7361048513509445,1.7743718597227198,8.540520489367045,0.6815429856426122,9803892298.0,2018-09-24,2018,0,267,9,0.39,290.94,291.65,290.4833,4711
2018-09-25 13:30:00,291.53,291.65,290.4833,290.75,283.2551282051282,294.38,275.0207000000002,279.9845,286.10779999999994,290.1700000000002,286.132986163318,289.77494047192187,290.3376923076922,293.4833477130226,287.19203690236174,275.0207000000002,279.9845,286.10779999999994,290.1700000000002,290.9611,44370037,62746977.55,57.004629145220825,1.5,2.75,1.812467774772843,0.707126282929623,-0.1268964288926553,1.6157513236069008,1.7426477524995558,8.470887857077694,0.5637797454344201,9759522261.0,2018-09-25,2018,1,268,9,0.4,291.07,292.24,289.41,4712
2018-09-26 13:30:00,290.91,292.24,289.41,289.88,283.4971794871795,294.52666666666664,275.14255000000014,280.22310000000004,286.29599999999994,290.1680000000003,286.2799278824036,289.78494614126265,290.5130769230768,293.2572386655076,287.76891518064605,275.14255000000014,280.22310000000004,286.29599999999994,290.1680000000003,290.5100000000001,79739674,64386787.65,53.43968715465395,1.5,2.75,1.8851486480033528,1.2384477764826027,-0.2472042665877141,1.433642419264913,1.6808466858526274,8.71871686928246,-0.32665130832444683,9679782587.0,2018-09-26,2018,2,269,9,0.98,290.83,291.91,290.1,4713
2018-09-27 13:30:00,290.41,291.91,290.1,290.69,283.7392307692308,294.67333333333335,275.2644500000002,280.46080000000006,286.4885999999999,290.1285000000001,286.4528718870152,289.87114174685667,290.7123076923076,293.07654318552017,288.348072199095,275.2644500000002,280.46080000000006,286.4885999999999,290.1285000000001,290.9000000000001,59249455,64274984.7,56.18692658764918,1.5,2.75,1.8954951731459728,0.9218120436207586,-0.273283683061867,1.3392420820252935,1.6125257650871607,8.149109309605286,-0.06531903190318954,9739032042.0,2018-09-27,2018,3,270,9,0.62,291.0,291.28,289.95,4714
2018-09-28 13:30:00,289.99,291.28,289.95,290.72,283.98128205128205,294.82,275.3841500000002,280.69880000000006,286.70299999999986,290.1495000000002,286.6202102443871,289.9519853900132,290.8407692307691,293.00256992656,288.67896853497825,275.3841500000002,280.69880000000006,286.70299999999986,290.1495000000002,290.6500000000001,70091385,64718078.9,56.289795554687565,1.5,2.75,1.8551026607784018,1.0830263535526548,-0.2880903335013309,1.252412848210497,1.5405031817118282,8.14852721616881,0.4769475357710833,9809123427.0,2018-09-28,2018,4,271,9,0.46,290.62,292.93,290.98,4715
2018-10-01 13:30:00,292.11,292.93,290.98,291.73,284.22333333333336,294.96666666666664,275.5090500000003,280.9211000000001,286.9439999999999,290.22050000000013,286.82059415637195,290.1213201147738,291.0415384615384,293.0022423563827,289.0808345666941,275.5090500000003,280.9211000000001,286.9439999999999,290.22050000000013,291.88,62078937,64514983.85,59.71879864571039,1.5,2.75,1.8804524707228003,0.9622406035834418,-0.23185731681111355,1.250681535697936,1.4825388525090497,7.6186965863105796,0.2818741191433753,9871202364.0,2018-10-01,2018,0,274,10,0.67,291.96,292.355,291.14,4716
2018-10-02 13:30:00,291.56,292.355,291.14,291.56,284.4653846153846,295.11333333333334,275.6385500000002,281.1165000000001,287.1711999999999,290.3080000000001,287.00645320906324,290.25833724670014,291.09769230769217,293.0727078495063,289.12267676587817,275.6385500000002,281.1165000000001,287.1711999999999,290.3080000000001,291.685,47258227,63998176.85,58.881508086338435,1.5,2.75,1.8329201513854598,0.7384308323464374,-0.20882223426652716,1.2215110596758905,1.4303332939424176,7.05464804679166,0.11675022319894753,9823944137.0,2018-10-02,2018,1,275,10,0.42,291.75,293.21,291.32,4717
2018-10-03 13:30:00,292.74,293.21,291.32,291.72,284.70743589743586,295.26,275.7646000000002,281.30520000000007,287.37339999999983,290.44250000000017,287.19129818125685,290.3975432232049,291.16230769230765,293.1594464740396,289.16516891057563,275.7646000000002,281.30520000000007,287.37339999999983,290.44250000000017,292.0833333333333,64694594,63610284.7,59.45765042430714,1.5,2.75,1.8369972834293549,1.0170461318498076,-0.18626673361210888,1.1974998769272815,1.3837666105393904,7.038344310010753,-0.6335581442877434,9888638731.0,2018-10-03,2018,2,276,10,0.65,292.26,291.24,287.66,4718
2018-10-04 13:30:00,291.18,291.24,287.66,289.44,284.94948717948716,295.40666666666664,275.8708000000002,281.4698000000001,287.4819999999998,290.50650000000013,287.2794825663056,290.3063486305187,291.1699999999999,293.1395841028973,289.2004158971025,275.8708000000002,281.4698000000001,287.4819999999998,290.50650000000013,289.44666666666666,111545910,65892087.05,48.93526700392979,1.5,2.75,1.9957831917558295,1.6928574430395131,-0.32048478236224104,0.9831606325865891,1.30364541494883,6.401386930747084,-0.8733175793691603,9777092821.0,2018-10-04,2018,3,277,10,1.24,289.45,290.27,286.22,4719
2018-10-05 13:30:00,289.69,290.27,286.22,287.82,285.1915384615385,295.55333333333334,275.9740500000002,281.6370000000001,287.5715999999999,290.5175000000001,287.30067932841126,290.06955352285024,290.93230769230763,293.5941769469508,288.27043843766444,275.9740500000002,281.6370000000001,287.5715999999999,290.5175000000001,288.1033333333333,105961360,67513913.85,43.09896127575711,1.5,2.75,2.142512963773267,1.5694744084222576,-0.5030794150044,0.6747961461933301,1.17787556119773,6.443742403110215,-1.0995807848257813,9671131461.0,2018-10-05,2018,4,278,10,1.41,288.24,288.22,285.5,4720
2018-10-08 13:30:00,287.05,288.22,285.5,287.82,285.43358974358983,295.7,276.0780000000002,281.7928000000001,287.6995999999998,290.5035000000001,287.32104484494414,289.8553103301978,290.67076923076917,293.7959765374809,287.54556192405744,276.0780000000002,281.7928000000001,287.6995999999998,290.5035000000001,287.18,87742172,69390477.3,43.09896127575711,1.5,2.75,2.183762037789464,1.264469930371844,-0.6018924057195987,0.4255100540482317,1.0274024597678304,6.369478175763542,-1.0077386070507333,9671131461.0,2018-10-08,2018,0,281,10,0.95,286.86,288.86,286.77,4721
2018-10-09 13:30:00,287.39,288.86,286.77,287.4,285.67564102564097,295.84666666666664,276.17710000000017,281.94670000000013,287.8485999999998,290.42100000000005,287.32414112553454,289.62147125113137,290.19538461538457,293.2857628882859,287.10500634248325,276.17710000000017,281.94670000000013,287.8485999999998,290.42100000000005,287.6766666666667,74338982,70580901.8,41.6069052596384,1.5,2.75,2.1770647493759334,1.0532450011852923,-0.6684443304015211,0.19184704676592898,0.8602913771674501,6.3713678123625295,-0.8555264247274798,9596792479.0,2018-10-09,2018,1,282,10,0.73,287.82,286.91,277.88,4722
2018-10-10 13:30:00,286.83,286.91,277.88,278.3,285.9176923076924,295.99333333333334,276.2310500000002,282.0164000000001,287.7879999999998,289.88000000000005,286.9702532382587,288.5432358938808,289.1423076923077,296.0460821508877,282.2385332337276,276.2310500000002,282.0164000000001,287.7879999999998,289.88000000000005,281.03,214756170,78328172.4,23.015421705209533,1.5,2.75,2.7015601244205083,2.741748765735277,-1.2637006841268266,-0.7193344779910831,0.5443662061357435,18.95844236794708,-4.262272523994628,9382036309.0,2018-10-10,2018,2,283,10,3.25,282.4,278.9,270.36,4723
2018-10-11 13:30:00,277.08,278.9,270.36,272.17,286.15974358974364,296.14,276.2559500000002,282.0044000000001,287.6141999999998,288.94700000000006,286.3898511504838,286.9838800944636,287.6923076923077,298.9528969755367,276.43171840907866,276.2559500000002,282.0044000000001,287.6141999999998,288.94700000000006,273.81,274840490,89518485.8,17.3812174109527,1.5,2.75,3.118591544104755,3.0702093265299624,-1.9667157185748647,-1.9140284420828382,0.0526872764920272,20.97933626961152,-6.380709961474963,9107195819.0,2018-10-11,2018,3,284,10,3.16,274.63,277.09,272.37,4724
2018-10-12 13:30:00,276.77,277.09,272.37,275.95,286.4017948717949,296.28666666666663,276.2991000000002,282.0378000000001,287.4853999999998,288.2005000000001,285.9804452230139,285.9330343711813,286.5538461538461,299.24891979185384,273.8587725158384,276.2991000000002,282.0378000000001,287.4853999999998,288.2005000000001,275.13666666666666,183186492,95923816.65,28.934112882546007,1.5,2.75,3.2472635766686984,1.9097081246089052,-2.063503005302952,-2.5266914801366624,-0.4631884748337107,23.843528956831694,-5.409111164432876,9290382311.0,2018-10-12,2018,4,285,10,1.73,274.73,277.04,274.3,4725
2018-10-15 13:30:00,275.55,277.04,274.3,274.4,286.64384615384614,296.43333333333334,276.33175000000017,282.0482000000001,287.30139999999983,287.4535,285.52631011622896,284.8346501453545,285.36307692307685,299.417974530155,271.3081793159987,276.33175000000017,282.0482000000001,287.30139999999983,287.4535,275.24666666666667,102263717,97624800.35,27.251343679383922,1.5,2.75,3.211030464049506,1.047517809341159,-2.1106897422349933,-3.101550652627451,-0.990860910392459,23.19570548310695,-5.885581012484574,9188118594.0,2018-10-15,2018,0,288,10,1.0,275.67,280.82,276.07,4726
2018-10-16 13:30:00,276.6,280.82,276.07,280.4,286.88589743589745,296.58,276.3994500000002,282.1242000000001,287.2165999999998,286.928,285.3252783469652,284.41230251246355,284.5715384615384,298.49569090617933,270.6473860168975,276.3994500000002,282.1242000000001,287.2165999999998,286.928,279.09666666666664,118255834,100441071.7,41.447323445757796,1.5,2.75,3.4402425737602567,1.1773653147908416,-1.6376801580602411,-3.0379611079677598,-1.4002809499075193,28.10668841656943,-3.880433292198015,9306374428.0,2018-10-16,2018,1,289,10,1.72,278.44,281.15,277.56,4727
2018-10-17 13:30:00,280.44,281.15,277.56,280.45,287.1279487179487,296.72666666666663,276.4578500000002,282.2072000000001,287.1139999999998,286.3895,285.13409096080966,284.03494036841937,283.7815384615384,297.38229374860146,270.1807831744753,276.4578500000002,282.2072000000001,287.1139999999998,286.3895,279.72,110625987,103518342.95,41.54968354530218,1.5,2.75,3.45093953277738,1.0686607208679242,-1.239400037073181,-2.9495309962489955,-1.7101309591758145,28.086074736134787,-3.1059977888336134,9417000415.0,2018-10-17,2018,2,290,10,1.29,279.36,280.07,274.97,4728
2018-10-18 13:30:00,279.4,280.07,274.97,276.4,287.37,296.87333333333333,276.4875000000002,282.2810000000001,286.9327999999998,285.5305,284.7915775897975,283.3078031904747,282.60230769230765,295.8968205079646,269.3077948766506,276.4875000000002,282.2810000000001,286.9327999999998,285.5305,277.14666666666665,134557525,105228186.9,36.05196403509342,1.5,2.75,3.5958724232932786,1.2787213099839123,-1.1676649761938047,-3.1697121794180703,-2.002047203224265,28.682405054461288,-3.9677576262942167,9282442890.0,2018-10-18,2018,3,291,10,1.85,277.52,279.3,275.47,4729
2018-10-19 13:30:00,277.13,279.3,275.47,276.25,287.6120512820513,297.02,276.51070000000016,282.31740000000013,286.75639999999987,284.7435,284.4566137627466,282.63563145804864,281.4246153846153,294.031076769115,268.8181540001157,276.51070000000016,282.31740000000013,286.75639999999987,284.7435,277.00666666666666,139901634,106943411.35,35.862695376253725,1.5,2.75,3.612595821629472,1.3081837603079227,-1.0528122696247006,-3.3180625402551414,-2.2652502706304407,28.764779300344657,-4.019873532068652,9142541256.0,2018-10-19,2018,4,292,10,1.39,277.38,277.36,274.41,4730
2018-10-22 13:30:00,277.0,277.36,274.41,275.01,287.85410256410256,297.16666666666663,276.5186500000002,282.3581000000001,286.5933999999998,283.9430000000001,284.08615832107034,281.9093808429963,280.1392307692306,291.64405106076595,268.6344104776954,276.5186500000002,282.3581000000001,286.5933999999998,283.9430000000001,275.5933333333333,82415812,108393719.7,34.26140514037876,1.5,2.75,3.565267548655937,0.7603375198129675,-0.984116708165156,-3.495396155836886,-2.51127944767173,28.64588388126824,-4.311064718162835,9060125444.0,2018-10-22,2018,0,295,10,1.08,275.88,274.87,268.61,4731
2018-10-23 13:30:00,270.95,274.87,268.61,273.61,288.09615384615387,297.31333333333333,276.5171000000002,282.3582000000001,286.4235999999998,283.086,283.6753285829891,281.11896361985384,278.9215384615384,289.5484038251038,268.2946730979729,276.5171000000002,282.3582000000001,286.4235999999998,283.086,272.36333333333334,146352719,113492853.8,32.49714211774051,1.5,2.75,3.767748438037655,1.2895324604129392,-0.9559205110600796,-3.7061800864968286,-2.7502595754367496,28.578353757558173,-1.6852317642831467,8913772725.0,2018-10-23,2018,1,296,10,2.33,271.74,273.76,264.7,4732
2018-10-24 13:30:00,273.33,273.76,264.7,265.32,288.3382051282051,297.46,276.4710000000003,282.2624000000001,286.0519999999998,281.858,282.95551177581314,279.61430041796297,277.19076923076915,288.7453260049711,265.6362124565672,276.4710000000003,282.2624000000001,286.0519999999998,281.858,267.9266666666667,177806697,118396204.95,24.463841851993752,1.5,2.75,4.145766406749251,1.5017938883690545,-1.3921115896696912,-4.490399062523864,-3.0982874728541723,28.09541626295515,-2.5168093470992483,8735966028.0,2018-10-24,2018,2,297,10,3.42,269.23,271.81,266.23,4733
2018-10-25 13:30:00,267.38,271.81,266.23,270.08,288.58025641025637,297.6066666666666,276.4508000000002,282.21220000000017,285.81799999999987,280.8275,282.45058974538904,278.7062718067284,275.82615384615366,286.1631599250107,265.48914776729674,276.4508000000002,282.21220000000017,285.81799999999987,280.8275,269.37333333333333,138061545,122336809.45,34.47917286042528,1.5,2.75,4.31321166341002,1.1285364202376622,-1.260512342179796,-4.673927900578917,-3.4134155583991213,28.368821924546975,-2.1271969559702857,8874027573.0,2018-10-25,2018,3,298,10,2.1,269.02,271.0,262.29,4734
2018-10-26 13:30:00,265.92,271.0,262.29,265.33,288.8223076923077,297.75333333333333,276.3968500000002,282.09150000000017,285.4433999999999,279.558,281.77919406909933,277.4323411584685,274.1284615384614,283.5096500678875,264.7472730090353,276.3968500000002,282.09150000000017,285.4433999999999,279.558,266.20666666666665,201574596,128910970.0,30.17899405087093,1.5,2.75,4.627267973166446,1.5636729442032746,-1.3839647885309447,-5.143371544062801,-3.759406755531857,28.217406001263548,-3.3053935860058288,8672452977.0,2018-10-26,2018,4,299,10,3.32,266.64,270.25,259.85,4735
2018-10-29 13:30:00,268.8,270.25,259.85,263.86,259.85,297.9,276.32655000000017,281.9564000000002,285.0193999999999,278.1645,281.07648057619343,276.1397372386144,273.0176923076922,283.5134325537826,262.52195206160184,276.32655000000017,281.9564000000002,285.0193999999999,278.1645,264.65333333333336,160749101,133844478.2,28.974634793658144,1.5,2.75,5.039605975083126,1.2010140661895456,-1.448330841153676,-5.569820306973952,-4.121489465820276,28.21573648320348,-5.898716119828802,8511703876.0,2018-10-29,2018,0,302,10,4.0,265.05,268.12,263.12,4736
2018-10-30 13:30:00,263.67,268.12,263.12,267.77,259.7483529411765,298.0466666666666,276.2805500000002,281.8522000000002,284.6613999999999,276.975,280.5546578084996,275.3426194063654,272.67923076923057,283.539919121222,261.81854241723926,276.2805500000002,281.8522000000002,284.6613999999999,276.975,266.33666666666664,157115995,139337366.6,36.260845104762105,1.5,2.75,5.036776976862903,1.1275941180303604,-1.1256484417495347,-5.528550018007195,-4.40290157625766,26.13039515476459,-4.521305045462652,8668819871.0,2018-10-30,2018,1,303,10,1.9,265.62,273.23,270.12,4737
2018-10-31 13:30:00,270.65,273.23,270.12,270.63,259.646705882353,298.1933333333333,276.2356500000002,281.77290000000016,284.3471999999999,275.92049999999995,280.16545554149957,274.89379851052104,272.26999999999987,283.00709028052114,261.5329097194786,276.2356500000002,281.77290000000016,284.3471999999999,275.92049999999995,271.32666666666665,128296325,142517453.15,41.026464464071346,1.5,2.75,5.067007192801269,0.9002148309861233,-0.6417300820882144,-5.205064178867929,-4.563334096779713,27.47993389167596,-2.0875542691751017,8797116196.0,2018-10-31,2018,2,304,10,1.15,271.68,273.73,270.38,4738
2018-11-01 13:30:00,271.6,273.73,270.38,273.51,259.5450588235294,298.34,276.2075000000002,281.7188000000002,284.0939999999999,275.124,279.90445728497025,274.7620081761857,272.2015384615384,282.8946903927858,261.50838653029086,276.2075000000002,281.7188000000002,284.0939999999999,275.124,272.54,99495037,141914909.5,45.44952350770776,1.5,2.75,4.944363821886896,0.7010893876516899,-0.07938096030585308,-4.662560297162032,-4.583179336856177,27.58897880542021,-0.9918552036199128,8896611233.0,2018-11-01,2018,3,305,11,1.24,272.06,275.23,269.59,4739
2018-11-02 13:30:00,274.75,275.23,269.59,271.89,259.4434117647059,298.4866666666666,276.16490000000016,281.65740000000017,283.8159999999998,274.3275,279.5901648424224,274.4884835879776,271.5469230769229,281.13742923061125,261.95641692323466,276.16490000000016,281.65740000000017,283.8159999999998,274.3275,272.2366666666666,122634107,142748546.85,43.47434727038875,1.5,2.75,4.994052120323549,0.8590918065797459,0.21564921160211448,-4.313617822353535,-4.529267033955651,27.72580402044981,-1.13450419984728,8773977126.0,2018-11-02,2018,4,306,11,2.09,272.41,274.01,271.35,4740
2018-11-05 14:30:00,272.44,274.01,271.35,273.39,259.34176470588244,298.6333333333333,276.11840000000007,281.6040000000002,283.5335999999998,273.60600000000005,279.3470211231117,274.38386610340825,271.00384615384604,279.21689220532096,262.7908001023711,276.11840000000007,281.6040000000002,283.5335999999998,273.60600000000005,272.9166666666667,65622482,141642562.35,45.822137610019006,1.5,2.75,4.827334111729008,0.4632963490016954,0.5262826783682629,-3.8714136859953214,-4.3976963643635845,27.934653785234666,-0.08040641789409278,8839599608.0,2018-11-05,2018,0,309,11,0.98,272.68,275.3,273.25,4741
2018-11-06 14:30:00,273.32,275.3,273.25,275.12,259.24011764705887,298.78,276.0775500000001,281.5839000000002,283.2403999999998,272.9920000000001,279.18125558887203,274.45397409355985,270.9053846153845,278.88466785052606,262.92610138024287,276.0775500000001,281.5839000000002,283.2403999999998,272.9920000000001,274.5566666666667,60085894,140929907.95,48.4799803022069,1.5,2.75,4.628953103748365,0.4263530351649535,0.8438906264382258,-3.3428330813158027,-4.1867237077540285,28.02730073878537,3.6936529473842947,8899685502.0,2018-11-06,2018,1,310,11,0.75,274.27,281.1,277.08,4742
2018-11-07 14:30:00,277.56,281.1,277.08,281.01,259.1384705882353,298.9266666666666,276.06670000000014,281.62840000000017,283.0621999999998,273.12750000000005,279.2529710559751,275.07835751322085,271.27153846153834,280.53220082745565,262.01087609562086,276.06670000000014,281.62840000000017,283.0621999999998,273.12750000000005,279.73,102752099,135329704.4,56.33419476485703,1.5,2.75,4.725456453480626,0.7592723227732108,1.4127785948533995,-2.4207504641872792,-3.8335290590406794,22.009510274458545,4.046949052132704,9002437601.0,2018-11-07,2018,2,311,11,1.45,279.09,281.22,279.22,4743
2018-11-08 14:30:00,280.11,281.22,279.22,280.5,259.03682352941183,281.22,276.05270000000013,281.6784000000001,282.84259999999983,273.54400000000004,279.30187415181916,275.5947044167236,271.69384615384604,282.03553933008163,261.3521529776104,276.05270000000013,281.6784000000001,282.84259999999983,273.54400000000004,280.31333333333333,65584886,124866924.2,55.544593038614245,1.5,2.75,4.530780992517723,0.5252382600131348,1.6976889079444677,-1.7114179241100942,-3.4091068320545617,20.937843528673014,5.717408510157169,8936852715.0,2018-11-08,2018,3,312,11,0.72,280.22,279.24,276.18,4744
2018-11-09 14:30:00,279.03,279.24,276.18,277.76,258.93517647058826,280.85657142857144,276.0086000000002,281.6963000000001,282.5917999999998,273.63450000000006,279.24140849880666,275.80092304370226,272.0130769230768,282.81751015739104,261.2086436887625,276.0086000000002,281.6963000000001,282.5917999999998,273.63450000000006,277.7266666666667,98812561,120648227.65,51.37802503627046,1.5,2.75,4.515725207337887,0.8190137801829532,1.6434892920938409,-1.3547452169372605,-2.9982345090311013,18.28782825162493,5.2679451224133915,8838040154.0,2018-11-09,2018,4,313,11,1.11,277.71,277.46,271.99,4745
2018-11-12 14:30:00,277.19,277.46,271.99,272.57,258.83352941176474,280.4931428571429,275.94805000000014,281.6796000000001,282.2369999999998,273.54300000000006,278.97978463610843,275.49321608715917,272.5707692307691,282.66053391976413,262.48100454177404,275.94805000000014,281.6796000000001,282.2369999999998,273.54300000000006,274.00666666666666,99673574,120518720.5,44.55966294723471,1.5,2.75,4.605316263956608,0.8270381031799952,1.2194842549634541,-1.4738791903267838,-2.6933634452902377,22.159545762086253,1.7925831870635291,8738366580.0,2018-11-12,2018,0,316,11,2.01,274.73,275.325,271.25,4746
2018-11-13 14:30:00,273.09,275.325,271.25,272.06,258.73188235294117,280.1297142857144,275.8995500000001,281.65280000000007,281.88199999999983,273.1260000000001,278.70842053273157,275.1662431264773,272.72307692307675,282.7171717475653,262.7289820985882,275.8995500000001,281.65280000000007,281.88199999999983,273.1260000000001,272.87833333333333,98176610,119514759.3,43.94253493091218,1.5,2.75,4.56743653081685,0.8214601324139553,0.8818066041512846,-1.5911051901011317,-2.4729117942524166,21.038666888513703,0.5283967039869958,8640189970.0,2018-11-13,2018,1,317,11,1.5,273.29,274.61,268.45,4747
2018-11-14 14:30:00,274.16,274.61,268.45,270.2,258.6302352941176,279.76628571428574,275.84105000000005,281.6448000000001,281.5053999999998,272.6135000000001,278.37475698242844,274.6932675906224,273.0976923076921,282.2879920561986,263.9073925591856,275.84105000000005,281.6448000000001,281.5053999999998,272.6135000000001,271.08666666666664,125335931,120250256.5,41.67558206016531,1.5,2.75,4.6811910643299335,1.042292421222403,0.5277752453095261,-1.813192737615509,-2.340967982925035,20.681711867225715,-1.210193411575446,8514854039.0,2018-11-14,2018,2,318,11,2.29,271.53,273.54,267.0102,4748
2018-11-15 14:30:00,268.78,273.54,267.0102,273.02,258.52858823529414,279.40285714285716,275.79825000000005,281.6590000000001,281.20259999999985,272.4445000000002,278.1647665125293,274.5339087724679,273.8023076923075,281.3003490933704,266.3042662912447,275.79825000000005,281.6590000000001,281.20259999999985,272.4445000000002,271.19006666666667,135101437,120277452.1,46.2067101327177,1.5,2.75,4.8132345597349415,1.1232482451297288,0.4795163680629901,-1.7415725228462977,-2.221088890909288,20.64351299966597,0.4156092537423206,8649955476.0,2018-11-15,2018,3,319,11,2.45,270.28,274.75,271.21,4749
2018-11-16 14:30:00,271.79,274.75,271.21,273.73,258.4269411764706,279.03942857142863,275.78965000000005,281.70280000000014,280.92519999999985,272.31850000000014,277.99085410027317,274.45734603223286,274.26076923076903,280.90794543418906,267.613593027349,275.78965000000005,281.70280000000014,280.92519999999985,272.31850000000014,273.23,126668040,119615772.4,47.31645923788296,1.5,2.75,4.7222892340395894,1.0589576730434591,0.489691383118033,-1.6089746620117469,-2.09866604512978,20.351718675431755,0.12436446102638425,8776623516.0,2018-11-16,2018,4,320,11,1.31,272.98,273.38,268.07,4750
2018-11-19 14:30:00,273.05,273.38,268.07,269.1,258.3252941176471,278.67600000000004,275.8155000000001,281.68490000000014,280.54519999999985,272.02300000000014,277.6421931551645,273.94712260059157,274.1430769230767,281.09061831272993,267.1955355334235,275.8155000000001,281.68490000000014,280.54519999999985,272.02300000000014,270.18333333333334,103061706,120648067.1,41.328803096526535,1.5,2.75,4.789268574465335,0.85423420761956,0.19405580820961527,-1.8560962848677605,-2.050152093077376,22.40299720975241,-2.188136086071526,8673561810.0,2018-11-19,2018,0,323,11,1.98,270.73,267.0,263.15,4751
2018-11-20 14:30:00,265.36,267.0,263.15,264.12,258.22364705882353,278.31257142857146,275.79045000000013,281.6133000000001,280.0465999999999,271.54850000000016,277.1119110706482,273.01120616244003,273.42076923076905,282.19399585075,264.6475426107881,275.79045000000013,281.6133000000001,280.0465999999999,271.54850000000016,264.75666666666666,136021311,120131496.7,36.04525409088847,1.5,2.75,4.872177962003528,1.1322701767354242,-0.30053668937743794,-2.4258229547991736,-2.1252862654217357,23.7294706213026,-6.010462261129493,8537540499.0,2018-11-20,2018,1,324,11,1.46,265.08,267.15,265.01,4752
2018-11-21 14:30:00,265.86,267.15,265.01,265.02,258.122,277.94914285714293,275.77720000000005,281.5449000000001,279.56459999999987,271.5335000000002,276.6377184796424,272.2501389088743,272.8923076923075,282.73335252066084,263.0512628639541,275.77720000000005,281.5449000000001,279.56459999999987,271.5335000000002,265.72666666666663,75563743,115019349.0,37.597891431503854,1.5,2.75,4.740593821860418,0.656965490215042,-0.5179713285092361,-2.7727504260582805,-2.2547790975490445,18.412662389130688,-5.518716577540113,8613104242.0,2018-11-21,2018,2,325,11,0.81,266.08,264.8234,263.07,4753
2018-11-23 14:30:00,263.18,264.8234,263.07,263.25,258.0203529411765,277.5857142857144,275.80530000000016,281.4684000000001,279.01299999999986,271.1920000000002,276.11270991181334,271.3929828223148,272.1123076923075,283.2003085632355,261.0243068213796,275.80530000000016,281.4684000000001,279.01299999999986,271.1920000000002,263.7144666666666,42807878,110256665.65,35.759233698537045,1.5,2.75,4.541265691727529,0.3882565987972991,-0.7195031092849056,-3.154157984155177,-2.434654874870271,18.23324588780573,-5.223934331797231,8570296364.0,2018-11-23,2018,4,327,11,0.67,263.95,267.75,265.34,4754
2018-11-26 14:30:00,265.78,267.75,265.34,267.5,257.918705882353,277.22228571428576,275.83530000000013,281.41230000000013,278.5453999999999,271.30050000000017,275.77495658193817,271.0222225535229,271.5261538461537,282.721316368661,260.3309913236464,275.83530000000013,281.41230000000013,278.5453999999999,271.30050000000017,266.86333333333334,79981362,104177003.95,42.97088002934128,1.5,2.75,4.53831814231842,0.7677448857944431,-0.5146804282599002,-3.0780054101951464,-2.563324981935246,22.050624187091323,-1.8600726418901543,8650277726.0,2018-11-26,2018,0,330,11,0.91,266.54,268.4,265.66,4755
2018-11-27 14:30:00,266.34,268.4,265.66,268.4,257.8170588235294,276.8588571428572,275.85060000000016,281.34210000000013,278.12659999999994,271.5275000000002,275.4857425983328,270.77248707223504,270.5561538461537,280.39994466836185,260.7123630239455,275.85060000000016,281.34210000000013,278.12659999999994,271.5275000000002,267.4866666666666,75502441,99914670.95,44.39445413127749,1.5,2.75,4.409866846438528,0.7556692153626113,-0.2785158993491619,-2.9114698561216983,-2.6329539567725364,20.087834855812147,-1.345291479820637,8725780167.0,2018-11-27,2018,1,331,11,1.03,267.03,274.58,268.3272,4756
2018-11-28 14:30:00,269.6,274.58,268.3272,274.58,257.71541176470595,276.4954285714286,275.8935000000002,281.30890000000016,277.7999999999999,271.86800000000017,275.45022328075106,271.1351073510698,270.10076923076906,278.5048175648957,261.69672089664243,275.8935000000002,281.30890000000016,277.7999999999999,271.86800000000017,272.49573333333336,127629633,98440352.85,53.059346780906296,1.5,2.75,4.541504928835776,1.296517427101035,0.3025050168048757,-2.2548226857664417,-2.557327702571317,24.43277831252193,1.6210214655810495,8853409800.0,2018-11-28,2018,2,332,11,2.33,271.45,275.55,272.43,4757
2018-11-29 14:30:00,273.71,275.55,272.43,273.98,257.61376470588243,276.13200000000006,275.9154500000002,281.25970000000007,277.45519999999993,272.0355000000002,275.3925674658197,271.40604950811075,269.80999999999983,277.3512016997832,262.2687983002165,275.9154500000002,281.25970000000007,277.45519999999993,272.0355000000002,273.9866666666667,82346420,96142857.6,52.208726686181926,1.5,2.75,4.439968862490363,0.8565006497164903,0.6358439281806825,-1.7625227923454645,-2.398366720526147,24.03305251701583,0.3516225917515334,8771063380.0,2018-11-29,2018,3,333,11,1.15,273.99,276.28,273.45,4758
2018-11-30 14:30:00,273.81,276.28,273.45,275.65,257.51211764705886,275.76857142857153,275.9285500000002,281.2476000000001,277.0965999999999,272.1425000000001,275.4026628593169,271.81023526924304,270.0469230769229,278.09647876314085,261.997367390705,275.9285500000002,281.2476000000001,277.0965999999999,272.1425000000001,275.12666666666667,98204190,96078315.25,54.39996117878256,1.5,2.75,4.324971086598194,1.0221264782221502,0.9398832607443116,-1.2235126445957576,-2.163395905340069,23.567133273400334,0.7014211083914657,8869267570.0,2018-11-30,2018,4,334,11,1.03,274.86,280.4,277.505,4759
2018-12-03 14:30:00,280.28,280.4,277.505,279.3,257.41047058823534,280.4,275.9595000000002,281.2469000000001,276.8427999999999,272.5130000000001,275.5554996099319,272.52354619598185,270.603846153846,280.01937682138816,261.18831548630385,275.9595000000002,281.2469000000001,276.8427999999999,272.5130000000001,279.0683333333333,103017719,95097495.85,58.84175299680653,1.5,2.75,4.355330294698323,1.083285296623297,1.333836731010355,-0.4960999915771254,-1.8299367225874803,24.589656805009135,3.790412486064656,8972285289.0,2018-12-03,2018,0,337,12,1.04,278.95,278.85,269.9,4760
2018-12-04 14:30:00,278.37,278.85,269.9,270.25,257.3088235294117,280.34875,275.95375000000024,281.15350000000007,276.42739999999986,272.35600000000005,275.3474408016993,272.3070179868406,270.60769230769216,280.0226007923787,261.19278382300564,275.95375000000024,281.15350000000007,276.42739999999986,272.35600000000005,273.0,177986013,100715672.4,46.69625254292156,1.5,2.75,4.7156638450770165,1.7672126766241,0.9499705347717202,-0.6424735541228301,-1.5924440888945504,30.142920048920413,2.3209147357261832,8794299276.0,2018-12-04,2018,1,338,12,3.32,274.38,269.97,262.44,4761
2018-12-06 14:30:00,265.92,269.97,262.44,269.84,257.20717647058825,280.2975,275.95270000000016,281.0585000000001,276.00919999999985,272.09200000000016,275.1314627310444,272.07206389285585,270.36307692307685,279.67929730099803,261.04685654515555,275.95270000000016,281.0585000000001,276.00919999999985,272.09200000000016,267.4166666666667,204185411,107920648.25,46.23068775366802,1.5,2.75,4.936687856142943,1.8919957794082285,0.6479243811311544,-0.7825386124806073,-1.4304629936117617,27.676484667489163,1.8187306618368402,8590113865.0,2018-12-06,2018,3,340,12,2.87,266.21,271.22,262.63,4762
2018-12-07 14:30:00,269.46,271.22,262.63,263.57,257.10552941176473,280.24625,275.9185500000001,280.88950000000006,275.48299999999995,271.22000000000014,274.6780720357093,271.2623435221077,269.5815384615384,279.3313813672585,259.83169555581816,275.9185500000001,280.88950000000006,275.48299999999995,271.22000000000014,265.8066666666667,161018923,110833989.45,39.71034886989203,1.5,2.75,5.197638723561306,1.4527937124616424,0.037546942857141774,-1.3835293150403345,-1.4210762578974765,31.29165033230425,0.12155745489078565,8429094942.0,2018-12-07,2018,4,341,12,3.27,266.92,265.1613,258.62,4763
2018-12-10 14:30:00,263.37,265.1613,258.62,264.07,257.00388235294116,280.19499999999994,275.8653500000002,280.71960000000007,274.95059999999995,270.39850000000007,274.26206921077954,270.5773584247641,269.1946153846153,279.37970438126075,259.00952638796986,275.8653500000002,280.71960000000007,274.95059999999995,270.39850000000007,262.6171,151445885,115127039.4,40.43185666005908,1.5,2.75,5.2936145290212115,1.3154675547054846,-0.3021295703724312,-1.7987382208630152,-1.496608650490584,31.061770200887647,-1.282242990654208,8580540827.0,2018-12-10,2018,0,344,12,2.53,261.89,267.87,262.48,4764
2018-12-11 14:30:00,267.66,267.87,262.48,264.13,256.9022352941177,280.14374999999995,275.7965000000001,280.56090000000006,274.41879999999986,269.7170000000001,273.864733163298,269.96332428907226,269.19538461538457,279.3789418460168,259.0118273847524,275.7965000000001,280.56090000000006,274.41879999999986,269.7170000000001,264.82666666666665,121504431,116261632.9,40.52383956212717,1.5,2.75,5.300499205519697,1.0450948259475203,-0.4817207416946661,-2.0987595776089165,-1.6170388359142505,29.42309402265929,-1.5909090909090842,8702045258.0,2018-12-11,2018,1,345,12,2.05,265.18,269.0,265.37,4765
2018-12-12 14:30:00,267.47,269.0,265.37,265.46,256.80058823529413,280.0925,275.7516500000001,280.41870000000006,273.89339999999993,269.3615000000001,273.5351357843452,269.53443626154154,269.2292307692307,279.3598407790629,259.09862075939844,275.7516500000001,280.41870000000006,273.89339999999993,269.3615000000001,266.61,97976706,116176789.5,42.63830266494353,1.5,2.75,5.2697492622682915,0.8433414834552645,-0.4694126840558341,-2.2038046909840427,-1.734392006928209,29.533841607614765,-3.3214363755553955,8800021964.0,2018-12-12,2018,2,346,12,1.37,267.18,267.49,264.12,4766
2018-12-13 14:30:00,266.52,267.49,264.12,265.37,256.6989411764706,280.04124999999993,275.72025000000014,280.27040000000005,273.36959999999993,269.0270000000001,273.2149343810375,269.13782328425185,269.3923076923076,279.1956325720567,259.5889828125585,275.72025000000014,280.27040000000005,273.36959999999993,269.0270000000001,265.66,96662717,116101094.85,42.52812110047548,1.5,2.75,5.134052886391983,0.8325736904108102,-0.4270223122913603,-2.2681698972924096,-1.8411475850010488,25.398509575460945,-3.1425651507409347,8703359247.0,2018-12-13,2018,3,347,12,1.28,265.8,264.03,259.85,4767
2018-12-14 14:30:00,262.96,264.03,259.85,260.47,256.5972941176471,279.98999999999995,275.68410000000017,280.0590000000001,272.74459999999993,268.54050000000007,272.7151330327615,268.3123163047993,268.8515384615384,279.7294196074484,257.97365731562843,275.68410000000017,280.0590000000001,272.74459999999993,268.54050000000007,261.45,116961071,115682351.85,36.932413979260886,1.5,2.75,5.1616205373639845,1.0110537098317127,-0.6739887948943449,-2.6836335786189807,-2.009644783724636,26.819296928591992,-5.506983493560657,8586398176.0,2018-12-14,2018,4,348,12,1.61,261.94,260.65,253.525,4768
2018-12-17 14:30:00,259.4,260.65,253.525,255.36,256.4956470588236,279.93875,275.61550000000017,279.7725000000001,272.06299999999993,267.6575000000001,272.0345395804964,267.0787623710089,267.84846153846144,280.89635637874,254.8005666981829,275.61550000000017,279.7725000000001,272.06299999999993,267.6575000000001,256.51166666666666,165492257,117201892.85,32.17751986546091,1.5,2.75,5.3018619275522685,1.4120271693205848,-1.1012377095344643,-3.3861919206427165,-2.284954211108252,27.000856882642182,-8.571428571428571,8420905919.0,2018-12-17,2018,0,351,12,2.81,257.09,257.95,253.28,4769
2018-12-18 14:30:00,257.2,257.95,253.28,255.08,256.394,279.8875,275.52995000000016,279.4899000000001,271.4081999999999,266.7250000000001,271.36965567537885,265.9360230975795,266.34846153846144,280.400831382176,252.2960916947469,275.52995000000016,279.4899000000001,271.4081999999999,266.7250000000001,255.43666666666672,134515094,117594245.55,31.93490323085261,1.5,2.75,5.256728932727106,1.1438918067024413,-1.3083378060867217,-3.9203764687166536,-2.6120386626299323,24.07006110562436,-5.613320999074927,8286390825.0,2018-12-18,2018,1,352,12,1.84,255.62,259.4,249.35,4770
2018-12-19 14:30:00,255.17,259.4,249.35,251.26,256.2923529411765,279.83624999999995,275.4218500000002,279.18830000000014,270.6769999999999,265.8330000000001,270.5810417273248,264.53830661209565,264.6007692307692,280.0079433070701,249.19359515446823,275.4218500000002,279.18830000000014,270.6769999999999,265.8330000000001,253.33666666666667,214992763,123190798.4,28.75000244475956,1.5,2.75,5.599105437532312,1.745201474398432,-1.589528922579833,-4.598949815854724,-3.0094208932748905,19.31377380636805,-6.8855618144085335,8071398062.0,2018-12-19,2018,2,353,12,4.03,254.38,251.62,244.65,4771
2018-12-20 14:30:00,249.86,251.62,244.65,247.17,256.190705882353,279.785,275.2938000000002,278.86050000000006,269.8723999999999,264.98550000000006,269.66296165958653,262.8841821728485,262.4099999999999,278.96611808829385,245.853881911706,275.2938000000002,278.86050000000006,269.8723999999999,264.98550000000006,247.81333333333333,252053377,128992401.7,25.784895832837318,1.5,2.75,5.697026477708576,1.954017241931856,-1.9160262633049812,-5.404453722406116,-3.4884274591011364,19.575031912144095,-6.222255947186707,7819344685.0,2018-12-20,2018,3,354,12,2.85,248.14,249.71,239.98,4772
2018-12-21 14:30:00,246.74,249.71,239.98,240.7,256.08905882352946,279.73375,275.1268000000002,278.45420000000007,269.1204,263.76950000000005,268.5271592415636,260.7714029182915,259.44076923076915,276.6479331441102,242.2336053174281,275.1268000000002,278.45420000000007,269.1204,263.76950000000005,243.4633333333333,255345633,137981496.2,21.931554365882544,1.5,2.75,5.985096015015108,1.8505788097114435,-2.4013241659990143,-6.490082666599902,-4.088758500600889,20.45962917796311,-8.849926155943502,7563999052.0,2018-12-21,2018,4,355,12,4.05,244.84,240.8355,234.27,4773
2018-12-24 14:30:00,239.04,240.8355,234.27,234.34,255.9874117647059,279.68249999999995,274.90415000000013,277.9890000000001,268.3637999999999,262.32400000000007,267.1864863301297,258.2541264498828,256.6784615384614,277.2569848407192,236.09993823620368,274.90415000000013,277.9890000000001,268.3637999999999,262.32400000000007,236.48183333333336,147311588,143206681.7,18.93587688678987,1.5,2.75,6.026553442514027,1.0286642093181049,-2.9482220199488323,-7.77403602553693,-4.825814005588097,21.424690530345586,-11.278537084011658,7416687464.0,2018-12-24,2018,0,358,12,2.8,237.55,246.18,233.76,4774
2018-12-26 14:30:00,235.97,246.18,233.76,246.18,233.76,279.6312499999999,274.7424500000002,277.6269000000001,267.7684,261.2580000000001,266.36270255247763,257.10420964513213,254.85846153846146,274.6281054730789,235.088817603844,274.7424500000002,277.6269000000001,267.7684,261.2580000000001,242.04,218485360,150131881.6,36.3626506700542,1.5,2.75,6.483228196620169,1.455289560561932,-2.3368591649175547,-7.746887961735041,-5.410028796817486,41.057177011273886,-7.262864461689134,7635172824.0,2018-12-26,2018,2,360,12,5.31,239.97,248.29,238.96,4775
2018-12-27 14:30:00,242.57,248.29,238.96,248.07,233.0910256410256,279.5799999999999,274.59920000000017,277.2716000000001,267.2418,260.2415000000001,265.6453416680667,256.2438087265481,253.6661538461537,273.0563790417489,234.27592865055854,274.59920000000017,277.2716000000001,267.2418,260.2415000000001,245.10666666666665,186267342,155670126.65,38.630608155686424,1.5,2.75,6.686569039718727,1.1965516185311076,-1.6612291680765674,-7.486565256913196,-5.825336088836628,41.36506809716752,-6.519199608094362,7821440166.0,2018-12-27,2018,3,361,12,3.9,243.62,251.4,246.45,4776
2018-12-28 14:30:00,249.58,251.4,246.45,247.75,232.42205128205129,279.52874999999995,274.46145000000007,276.9027000000001,266.58879999999994,258.9000000000001,264.9435635634366,255.4348745621149,252.4107692307691,271.0425096615274,233.7790288000108,274.46145000000007,276.9027000000001,266.58879999999994,258.9000000000001,248.53333333333333,153100189,156943654.45,38.381197955635685,1.5,2.75,6.562528394024532,0.9755105393494934,-1.1179861724016238,-7.222818804338656,-6.104832631937034,41.314584368123505,-4.883479863324001,7668339977.0,2018-12-28,2018,4,362,12,2.01,248.92,250.19,247.47,4777
2018-12-31 14:30:00,249.56,250.19,247.47,249.92,231.75307692307686,279.4774999999999,274.33605000000006,276.5461000000001,265.9781999999999,257.69700000000006,264.35440420800774,254.9096484133421,251.31769230769214,268.6962080517731,233.93917656361126,274.33605000000006,276.5461000000001,265.9781999999999,257.69700000000006,249.19333333333333,144299370,160041301.95,41.155678379576095,1.5,2.75,6.288062080165638,0.9016383161209344,-0.5247443802566707,-6.760763107257872,-6.236018727001202,41.44591787474436,-2.130325814536351,7812639347.0,2018-12-31,2018,0,365,12,1.1,248.83,251.21,245.95,4778
2019-01-02 14:30:00,245.98,251.21,245.95,250.18,231.08410256410252,279.4262499999999,274.21595000000013,276.1933000000001,265.45379999999994,256.42350000000016,263.7985452194584,254.4592057073095,250.14230769230755,265.48326574852933,234.80134963608575,274.21595000000013,276.1933000000001,265.45379999999994,256.42350000000016,249.1133333333333,126925199,161477352.4,41.49558167671941,1.5,2.75,6.2146290744395225,0.7860247713598256,-0.05195876545606648,-6.300967183821284,-6.249008418365219,40.273316490271824,-1.9209659714599363,7939564546.0,2019-01-02,2019,2,2,1,2.14,248.58,248.57,243.67,4779
2019-01-03 14:30:00,248.23,248.57,243.67,244.21,230.41512820512818,279.37499999999994,274.0845500000001,275.7847000000001,264.813,254.66900000000012,263.0303669755581,253.48309087804196,248.51461538461524,261.32973773856185,235.69949303066863,274.0845500000001,275.7847000000001,264.813,254.66900000000012,245.48333333333335,144140692,163533501.05,36.309318189304406,1.5,2.75,6.235726997693844,0.8814138453253643,-0.07692257320737994,-6.345161634874443,-6.268239061667063,42.19623825774094,-2.8058584732945886,7795423854.0,2019-01-03,2019,3,3,1,2.01,246.12,253.11,247.17,4780
2019-01-04 14:30:00,247.59,253.11,247.17,252.39,229.74615384615385,279.3237499999999,273.9917500000002,275.4770000000001,264.3605999999999,253.77600000000012,262.6130976823989,253.3789869848951,247.89307692307682,258.99822856091345,236.7879252852401,273.9917500000002,275.4770000000001,264.3605999999999,253.77600000000012,250.89,142628834,161765642.1,46.226430706811286,1.5,2.75,6.4260322121442845,0.8817004164075211,0.4906378331716983,-5.654941770202441,-6.145579603374139,46.498566546325435,2.1119067848039808,7938052688.0,2019-01-04,2019,4,4,1,2.4,250.14,255.95,251.69,4781
2019-01-07 14:30:00,252.69,255.95,251.69,254.38,229.07717948717945,279.2724999999999,273.91150000000016,275.1998000000001,263.97599999999994,253.00300000000016,262.2902311066186,253.47432155776218,247.8176923076921,258.73071389828146,236.90467071710282,273.91150000000016,275.1998000000001,263.97599999999994,253.00300000000016,254.00666666666663,103139100,156713326.55,48.33407822204882,1.5,2.75,6.271315625562549,0.6581386680416937,1.003678881615686,-4.8909810013545325,-5.894659882970219,45.352801671740245,5.6834233485666825,8041191788.0,2019-01-07,2019,0,7,1,1.69,253.82,257.31,254.0,4782
2019-01-08 14:30:00,256.82,257.31,254.0,256.77,228.4082051282051,279.22124999999994,273.8770000000002,274.9285000000001,263.80499999999995,252.66300000000015,262.07375145537867,253.7881956951182,247.9476923076921,259.2374239358847,236.65796067949955,273.8770000000002,274.9285000000001,263.80499999999995,252.66300000000015,256.02666666666664,102512587,153788009.75,50.82687258967292,1.5,2.75,6.059793080879508,0.6665837419096973,1.4788932715343677,-4.046043293552259,-5.524936565086627,41.34860838152007,9.571562686694538,8143704375.0,2019-01-08,2019,1,8,1,1.3,255.66,258.91,256.19,4783
2019-01-09 14:30:00,257.56,258.91,256.19,257.97,227.73923076923077,279.1699999999999,273.87660000000017,274.69040000000007,263.56279999999987,252.35800000000026,261.912820025756,254.1864627717736,248.46384615384602,260.8704263891893,236.05726591850268,273.87660000000017,274.69040000000007,263.56279999999987,252.35800000000026,257.69,95006554,150966043.2,52.07711227678177,1.5,2.75,5.821236432245259,0.629323998868641,1.8261734042812403,-3.2422198097350763,-5.068393214016316,35.6579830664744,4.78917864976847,8238710929.0,2019-01-09,2019,2,9,1,1.06,257.55,259.16,255.5,4784
2019-01-10 14:30:00,256.26,259.16,255.5,258.88,227.07025641025643,279.1187499999999,273.84545000000014,274.43860000000006,263.43379999999985,252.0955000000002,261.7938859070989,254.63346631731895,249.36461538461526,262.9125328865393,235.81669788269116,273.84545000000014,274.43860000000006,263.43379999999985,252.0955000000002,257.8466666666667,96823923,149732017.8,53.05194013088433,1.5,2.75,5.666862401370599,0.6466480878480487,2.0523924836270715,-2.5029026094824762,-4.555295093109548,25.174859230822374,4.357640988430686,8335534852.0,2019-01-10,2019,3,10,1,1.43,257.33,259.0098,257.03,4785
2019-01-11 14:30:00,257.68,259.0098,257.03,258.98,226.40128205128204,279.06749999999994,273.83735000000013,274.1778000000001,263.33619999999985,251.77150000000026,261.68353744015394,255.0474219061457,250.77076923076908,264.2238248437268,237.3177136178114,273.83735000000013,274.1778000000001,263.33619999999985,251.77150000000026,258.33993333333336,73858110,148526088.0,53.16468626900568,1.5,2.75,5.403500801272701,0.497273650673409,2.134503936776058,-1.8871651721394755,-4.021669108915534,25.24320001696465,4.532795156407675,8409392962.0,2019-01-11,2019,4,11,1,0.77,258.02,258.3,256.41,4786
2019-01-14 14:30:00,256.86,258.3,256.41,257.4,225.7323076923077,279.0162499999999,273.82520000000017,273.89510000000007,263.12879999999984,251.37300000000027,261.51555557975564,255.27147696270328,252.54461538461524,262.4870949248593,242.6021358443712,273.82520000000017,273.89510000000007,263.12879999999984,251.37300000000027,257.37,70908227,147238363.5,51.077526692009,1.5,2.75,5.2011078868960805,0.4815879864081754,2.009908462145394,-1.509283531233791,-3.5191919933791853,25.779842239658734,2.992957746478869,8338484735.0,2019-01-14,2019,0,14,1,0.74,257.36,260.7,257.81,4787
2019-01-15 14:30:00,257.82,260.7,257.81,260.35,225.06333333333333,278.9649999999999,273.81120000000016,273.63520000000005,262.92319999999984,251.36700000000027,261.4698475178045,255.75514582339818,253.63461538461524,263.65370981746184,243.61552095176862,273.81120000000016,273.63520000000005,262.92319999999984,251.36700000000027,259.62,85208271,145650723.5,54.65679477923806,1.5,2.75,5.065314466403504,0.5850178354932786,2.0467976195715814,-0.9606949689147086,-3.00749258848629,26.009958950409924,4.0650731473339246,8423693006.0,2019-01-15,2019,1,15,1,1.12,259.26,261.9666,260.6,4788
2019-01-16 14:30:00,260.83,261.9666,260.6,260.98,224.39435897435897,278.91374999999994,273.82875000000007,273.38330000000013,262.6725999999998,251.64800000000028,261.450637811224,256.25275098307463,254.62769230769212,264.80173818273107,244.4536464326532,273.82875000000007,273.38330000000013,262.6725999999998,251.64800000000028,261.1822,77636710,141257946.15,55.40712852498928,1.5,2.75,4.818977718803255,0.5496095059853028,2.030246379448502,-0.4696846141756623,-2.4999309936241643,25.962973862117003,6.867040661725568,8501329716.0,2019-01-16,2019,2,16,1,0.52,261.28,263.92,259.96,4789
2019-01-17 14:30:00,260.01,263.92,259.96,262.96,223.7253846153846,278.8624999999999,273.83970000000016,273.1550000000001,262.49399999999986,252.04200000000031,261.50982848529355,256.89153660373415,255.79769230769216,266.036989620856,245.55839499452838,273.83970000000016,273.1550000000001,262.49399999999986,252.04200000000031,262.28,96118435,139338113.2,57.77222976989764,1.5,2.75,4.757622167460168,0.6898215627624847,2.062593880789429,0.0783113573626224,-1.9842825234268069,18.64075150959953,4.187963073021908,8597448151.0,2019-01-17,2019,3,17,1,1.52,261.94,266.98,262.998,4790
2019-01-18 14:30:00,264.98,266.98,262.998,266.46,223.05641025641026,278.81124999999986,273.85420000000016,272.94450000000006,262.3553999999998,252.80200000000028,261.70395285841937,257.80281883194993,257.0699999999998,268.14782261304526,245.9921773869544,273.85420000000016,272.94450000000006,262.3553999999998,252.80200000000028,265.4793333333334,127900303,134983490.2,61.64477395669121,1.5,2.75,4.704934869784443,0.9475255293109912,2.2161962368106582,0.7859627725865153,-1.4302334642241423,10.363119615226967,4.748801006368419,8725348454.0,2019-01-18,2019,4,18,1,1.51,264.99,265.06,261.06,4791
2019-01-22 14:30:00,264.82,265.06,261.06,262.86,222.38743589743584,278.75999999999993,273.8403000000002,272.67530000000005,262.11019999999985,253.58650000000026,261.74928804044214,258.28445513366904,258.0453846153845,268.75150253676946,247.33926669399943,273.8403000000002,272.67530000000005,262.11019999999985,253.58650000000026,262.99333333333334,115531183,128157380.5,55.96021534246708,1.5,2.75,4.754582379085554,0.9014789671048248,1.9795901247105443,1.044254191664038,-0.9353359330465064,14.85204337188785,2.3717724033181566,8609817271.0,2019-01-22,2019,1,22,1,1.53,263.06,264.79,260.66,4792
2019-01-23 14:30:00,264.01,264.79,260.66,263.41,221.71846153846158,278.7087499999999,273.85875000000016,272.4102000000001,261.7581999999998,254.72200000000026,261.81441399964046,258.77260226379576,259.52230769230755,266.9957978823865,252.0488175022286,273.85875000000016,272.4102000000001,261.7581999999998,254.72200000000026,262.9533333333334,86030287,119691613.2,56.61840472893819,1.5,2.75,4.709969352008015,0.7187662084247018,1.7711436062748165,1.2785935747970143,-0.4925500314778022,14.34280818817999,2.1087723378687437,8695847558.0,2019-01-23,2019,2,23,1,1.58,262.73,264.2,262.08,4793
2019-01-24 14:30:00,263.21,264.2,262.08,263.55,221.0494871794872,278.65749999999986,273.8715000000002,272.13090000000017,261.4191999999998,256.1825000000003,261.882476195733,259.22759252438664,260.3807692307691,266.8803429992119,253.88119546232625,273.8715000000002,272.13090000000017,261.4191999999998,256.1825000000003,263.27666666666664,59204139,115286240.75,56.79540975904913,1.5,2.75,4.5249715411503,0.5135403723362365,1.5610720498343862,1.4587900308151802,-0.10228201901920576,14.316457592593885,1.8039245982694747,8755051697.0,2019-01-24,2019,3,24,1,0.81,263.14,266.7,263.6595,4794
2019-01-25 14:30:00,265.61,266.7,263.6595,265.78,220.38051282051282,278.60624999999993,273.8746500000002,271.88570000000016,261.1795999999998,257.16250000000025,262.03532026648855,259.8516313315879,261.2576923076922,267.34525922771525,255.17012538766915,273.8746500000002,271.88570000000016,261.1795999999998,257.16250000000025,265.3798333333333,96883358,109206140.65,59.62153501174463,1.5,2.75,4.426759288210991,0.8871603503552618,1.4908151675751635,1.7612369404497483,0.27042177287458513,14.758326905417983,2.6256853811104928,8851935055.0,2019-01-25,2019,4,25,1,1.15,265.18,263.83,261.79,4795
2019-01-28 14:30:00,263.39,263.83,261.79,263.76,219.7115384615384,278.55499999999984,273.8746500000002,271.62020000000007,261.00339999999983,257.9470000000003,262.102954765842,260.22385691905566,261.79538461538453,267.41961032145423,256.17115890931484,273.8746500000002,271.62020000000007,261.00339999999983,257.9470000000003,263.12666666666667,85613655,104173456.3,56.045254698073215,1.5,2.75,4.395562196195916,0.8218375202359491,1.237251455741511,1.816986092551474,0.579734636809963,15.87593909542279,2.4708624708624765,8766321400.0,2019-01-28,2019,0,28,1,0.78,262.81,264.55,262.48,4796
2019-01-29 14:30:00,263.92,264.55,262.48,263.41,219.04256410256409,278.50374999999985,273.8620500000002,271.35620000000006,260.8303999999998,258.73000000000025,262.1542114416913,260.5272991172409,262.2138461538461,267.4321779737129,256.99551433397926,273.8620500000002,271.35620000000006,260.8303999999998,258.73000000000025,263.48,66136334,99825263.55,55.42490762831984,1.5,2.75,4.229450610753351,0.6625210056858397,0.9858423553801544,1.8120375810351559,0.8261952256550016,15.224481331072466,1.1753408872671411,8700185066.0,2019-01-29,2019,1,29,1,0.79,263.52,268.52,264.25,4797
2019-01-30 14:30:00,265.1,268.52,264.25,267.58,218.37358974358972,278.45249999999993,273.8742000000002,271.14170000000007,260.7779999999998,259.61300000000017,262.36698746358576,261.1989849155989,262.8830769230768,268.4400400373382,257.3261138088155,273.8742000000002,271.14170000000007,260.7779999999998,259.61300000000017,266.7833333333333,92473671,97233978.6,60.96819303059828,1.5,2.75,4.292346995699537,0.9510427561584938,1.035171910535153,2.1201601138239425,1.08498820328879,16.324552850346933,2.5289294198789047,8792658737.0,2019-01-30,2019,2,30,1,1.62,266.38,270.47,267.27,4798
2019-01-31 14:30:00,267.51,270.47,267.27,269.93,217.70461538461532,278.40124999999983,273.8872000000002,270.95940000000013,260.7161999999998,260.6005000000003,262.663576190504,262.0305101617323,263.7253846153845,269.94103045909617,257.50973877167274,273.8872000000002,270.95940000000013,260.7161999999998,260.6005000000003,269.22333333333336,104012073,96088322.3,63.707310344918525,1.5,2.75,4.214322210292431,1.0824632016704492,1.1519051775714142,2.5248696752530577,1.3729644976816435,16.67793184509398,2.650593246121093,8896670810.0,2019-01-31,2019,3,31,1,1.2,268.87,271.2,269.18,4799
2019-02-01 14:30:00,270.15,271.2,269.18,270.06,217.03564102564098,278.34999999999985,273.88655000000017,270.78400000000016,260.6427999999998,261.89300000000026,262.9536320261705,262.7952234796626,264.69923076923067,270.6048810573445,258.7935804811168,273.88655000000017,270.78400000000016,260.6427999999998,261.89300000000026,270.1466666666667,85782524,93170413.9,63.85840859025488,1.5,2.75,4.0575849095572565,0.9207056232686758,1.160465796056013,2.82354674275166,1.6630809466956469,16.522055671245564,1.35104706147265,8982453334.0,2019-02-01,2019,4,32,2,0.75,270.19,272.03,269.36,4800
2019-02-04 14:30:00,270.11,272.03,269.36,271.96,216.36666666666665,278.29874999999987,273.8944000000002,270.6226000000001,260.69999999999976,262.87150000000025,263.306822927105,263.66805933874235,265.5923076923076,272.0797780009799,259.10483738363536,273.8944000000002,270.6226000000001,260.69999999999976,262.87150000000025,271.1166666666666,60744844,89076214.4,66.08108936820051,1.5,2.75,3.9584717017317343,0.6819423614840999,1.2110894609840532,3.176942772925713,1.9658533119416601,15.420089008092447,3.4619188921859414,9043198178.0,2019-02-04,2019,0,35,2,0.99,270.7,273.44,271.88,4801
2019-02-05 14:30:00,272.44,273.44,271.88,273.1,215.6976923076923,278.24749999999983,273.9154500000002,270.46310000000017,260.87959999999975,263.8075000000003,263.69086908682635,264.56633940171935,266.52461538461523,273.5537005220881,259.4955302471424,273.9154500000002,270.46310000000017,260.87959999999975,263.8075000000003,272.8066666666667,79552774,87896898.1,67.3774437623976,1.5,2.75,3.7871522944651823,0.905069185826024,1.2341619099978725,3.5085556994390004,2.274393789441128,11.771049186751348,3.678675828556242,9122750952.0,2019-02-05,2019,1,36,2,0.57,272.66,273.34,271.92,4802
2019-02-06 14:30:00,272.79,273.34,271.92,272.74,215.0287179487179,278.19624999999985,273.9461000000002,270.2993000000002,261.0339999999997,264.60600000000017,264.0457369657743,265.3447832682222,267.27692307692297,274.7012713140078,259.85257483983816,273.9461000000002,270.2993000000002,261.0339999999997,264.60600000000017,272.6666666666667,58347791,85688658.3,66.51293324314365,1.5,2.75,3.6180699877176665,0.6809278165579586,1.1402168943650106,3.6996649073973913,2.5594480130323807,12.111355631111376,3.4870043634983863,9064403161.0,2019-02-06,2019,2,37,2,0.52,272.63,271.55,268.29,4803
2019-02-07 14:30:00,270.94,271.55,268.29,270.14,214.35974358974357,278.14499999999987,273.96395000000007,270.09240000000017,261.17179999999973,265.2145000000002,264.28472767299894,265.80147057601056,267.55999999999995,275.1175983161059,260.0024016838939,273.96395000000007,270.09240000000017,261.17179999999973,265.2145000000002,269.99333333333334,95481961,85712428.65,60.47754217991466,1.5,2.75,3.6774935600235463,1.1139803468863672,0.8323019999568939,3.5998255129784984,2.767523513021604,14.213675187624974,1.6404545112499112,8968921200.0,2019-02-07,2019,3,38,2,1.22,269.92,270.58,267.83,4804
2019-02-08 14:30:00,268.75,270.58,267.83,270.47,213.6907692307692,278.09374999999983,274.00140000000016,269.8883000000002,261.2311999999997,265.7940000000002,264.52728737209696,266.2460924259143,268.14538461538444,275.3255822359052,260.9651869948637,274.00140000000016,269.8883000000002,261.2311999999997,265.7940000000002,269.62666666666667,75788861,84660675.55,60.9617314238681,1.5,2.75,3.6112440200218647,0.8952073735253817,0.5915051087584375,3.5069048989696516,2.9153997902112136,13.702364470133462,2.54397937518958,9044710061.0,2019-02-08,2019,4,39,2,1.03,269.2,271.49,270.03,4805
2019-02-11 14:30:00,271.2,271.49,270.03,270.62,213.02179487179487,278.04249999999985,274.03635000000014,269.70110000000017,261.2755999999997,266.3760000000002,264.76621727907354,266.66265505201767,268.69999999999993,275.43122688553456,261.9687731144652,274.03635000000014,269.70110000000017,261.2755999999997,266.3760000000002,270.7133333333333,68021423,84368841.2,61.194447862759226,1.5,2.75,3.4575837328774486,0.8062386780772804,0.3925641133353999,3.4061049318804635,3.013540818545064,12.39867219370996,2.737177783683224,9112731484.0,2019-02-11,2019,0,42,2,0.54,270.76,274.52,272.34,4806
2019-02-12 14:30:00,272.42,274.52,272.34,274.1,212.35282051282047,277.9912499999998,274.0753000000002,269.53300000000013,261.2659999999998,267.21100000000024,265.1322479740118,267.37097361849226,269.5115384615383,276.10597362672826,262.9171032963484,274.0753000000002,269.53300000000013,261.2659999999998,267.21100000000024,273.6533333333333,72270221,84436940.9,66.22488795804281,1.5,2.75,3.4891848948147723,0.8559076185101347,0.4419044857063712,3.5659214256780274,3.124016939971656,13.37811172164562,2.4366544584797216,9185001705.0,2019-02-12,2019,1,43,2,0.8,273.43,275.93,274.56,4807
2019-02-13 14:30:00,275.03,275.93,274.56,274.99,211.6838461538461,277.9399999999998,274.1174500000002,269.37070000000017,261.28619999999984,267.9430000000002,265.5188264848349,268.0965951786359,270.21999999999986,277.0339133678566,263.4060866321431,274.1174500000002,269.37070000000017,261.28619999999984,267.9430000000002,275.16,65277204,83440387.55,67.38919902754583,1.5,2.75,3.370671688042288,0.7823214382949016,0.4779813665517145,3.7214936481613,3.2435122816095845,11.103608820423126,1.8745600711295534,9250278909.0,2019-02-13,2019,2,44,2,0.5,275.24,275.64,272.87,4808
2019-02-14 14:30:00,273.78,275.64,272.87,274.38,211.01487179487174,277.88874999999985,274.16680000000014,269.17870000000016,261.2607999999998,268.61300000000017,265.86632348542963,268.69501468543245,271.0369230769229,277.0572444821761,265.0166016716697,274.16680000000014,269.17870000000016,261.2607999999998,268.61300000000017,274.2966666666667,83234396,83720271.85,65.71705067890787,1.5,2.75,3.3277665674678367,0.9941964372634798,0.4070378262105789,3.752309564372808,3.345271738162229,10.707897452701452,1.5996445234392331,9167044513.0,2019-02-14,2019,3,45,2,1.02,274.26,277.41,276.13,4809
2019-02-15 14:30:00,276.36,277.41,276.13,277.37,210.3458974358974,277.8374999999998,274.22875000000016,269.0325000000001,261.2221999999998,269.3335000000002,266.31744805462847,269.5212037630103,272.11076923076905,277.21705170533704,267.004486756201,274.22875000000016,269.0325000000001,261.2221999999998,269.3335000000002,276.97,97088659,83768783.05,69.68744054947389,1.5,2.75,3.3064975269344217,1.1590076334527821,0.5015508050155937,3.9722102444317215,3.470659439416128,11.881638196381841,1.9892631269304404,9264133172.0,2019-02-15,2019,4,46,2,0.46,276.77,278.58,276.47,4810
2019-02-19 14:30:00,276.4813,278.58,276.47,277.85,209.67692307692303,277.7862499999998,274.30200000000013,268.90080000000006,261.3741999999998,269.9030000000002,266.76970499366263,270.3144224522474,272.9007692307691,278.1349319309213,267.66660653061683,274.30200000000013,268.90080000000006,261.3741999999998,269.9030000000002,277.6333333333333,59120804,80329808.1,70.28244845312473,1.5,2.75,3.2210334178676736,0.7359759147737838,0.5334887261514241,4.137520347105409,3.604031620953984,11.558708727691426,1.7392896374954228,9323253976.0,2019-02-19,2019,1,50,2,0.76,277.52,278.92,277.25,4811
2019-02-20 14:30:00,277.81,278.92,277.25,278.41,209.0079487179487,277.7349999999998,274.3809500000001,268.77740000000006,261.5455999999998,270.68050000000017,267.2261871507739,271.0854298377476,273.55307692307673,279.23795773295257,267.8681961132009,274.3809500000001,268.77740000000006,261.5455999999998,270.68050000000017,278.1933333333334,76610767,78383787.3,70.99770841382433,1.5,2.75,3.110245316591413,0.9773802675135602,0.5284210592045544,4.264557944959677,3.736136885755122,11.485576323671644,2.0789029845273945,9399864743.0,2019-02-20,2019,2,51,2,0.6,278.09,278.1,276.345,4812
2019-02-21 14:30:00,277.7,278.1,276.345,277.42,208.33897435897438,277.6837499999998,274.43795000000017,268.65280000000007,261.8225999999998,271.3810000000002,267.62594451741023,271.68872223415264,274.11923076923057,279.76567804729433,268.472783491167,274.43795000000017,268.65280000000007,261.8225999999998,271.3810000000002,277.28833333333336,64214727,77293009.3,67.88693114064068,1.5,2.75,3.0355849368348835,0.8307960523410493,0.400302904640188,4.236515516555357,3.8362126119151694,11.78493785845649,2.6948989412897126,9335650016.0,2019-02-21,2019,3,52,2,0.64,277.22,279.36,277.4029,4813
2019-02-22 14:30:00,278.11,279.36,277.4029,279.14,207.67,277.6324999999998,274.4990500000002,268.5373000000001,262.1239999999998,272.16050000000024,268.0774761049628,272.3983677356619,274.67153846153826,280.7529848793436,268.59009204373297,274.4990500000002,268.5373000000001,262.1239999999998,272.16050000000024,278.6343,78114616,78238533.15,70.32006222940572,1.5,2.75,2.9585502984895364,0.9984161621516799,0.3738087513420081,4.3034735510926785,3.9296647997506713,9.523745556202881,3.2055311125078414,9413764632.0,2019-02-22,2019,4,53,2,0.71,278.38,281.31,279.43,4814
2019-02-25 14:30:00,280.73,281.31,279.43,279.52,207.0010256410256,277.5812499999998,274.56205000000017,268.42530000000005,262.43179999999984,272.84750000000025,268.52620253221914,273.0766184275036,275.1653846153844,281.68317855734404,268.6475906734248,274.56205000000017,268.42530000000005,262.43179999999984,272.84750000000025,280.08666666666664,69030699,76845900.2,70.84562817697697,1.5,2.75,2.9022252771688564,0.8983003494049772,0.3260317652750677,4.337204506344506,4.011172741069438,9.513076484583973,3.2887443647919508,9482795331.0,2019-02-25,2019,0,56,2,0.67,280.37,280.3,278.9,4815
2019-02-26 14:30:00,279.13,280.3,278.9,279.32,206.33205128205122,277.5299999999998,274.6111500000002,268.30120000000005,262.70899999999983,273.6255000000002,268.9494887074262,273.67122619631283,275.67153846153826,282.3766035786627,268.96647334441377,274.6111500000002,268.30120000000005,262.70899999999983,273.6255000000002,279.50666666666666,56844101,75407422.5,70.14163058635134,1.5,2.75,2.794923471656797,0.7538263358623616,0.2296623231462656,4.29825064500227,4.068588321856004,9.672970418358265,1.9044144472820028,9425951230.0,2019-02-26,2019,1,57,2,0.5,279.6,279.59,277.48,4816
2019-02-27 14:30:00,278.52,279.59,277.48,279.2,205.6630769230769,277.4787499999998,274.6470500000001,268.17760000000004,262.9855999999998,274.41500000000025,269.3514695424292,274.1977760823782,276.36846153846136,282.4865600170817,270.25036305984105,274.6470500000001,268.17760000000004,262.9855999999998,274.41500000000025,278.75666666666666,56921570,74946684.3,69.69413343648253,1.5,2.75,2.746000366538452,0.7594941728462831,0.11246988256456893,4.209175675061715,4.096705792497147,7.627828874033098,1.5309647623549871,9369029660.0,2019-02-27,2019,2,58,2,0.76,278.53,279.45,278.32,4817
2019-02-28 14:30:00,278.96,279.45,278.32,278.68,204.9941025641025,277.4274999999998,274.67620000000016,268.04720000000003,263.34979999999985,274.97000000000025,269.71729426625546,274.62465455072305,276.99999999999983,282.17442230147117,271.8255776985284,274.67620000000016,268.04720000000003,263.34979999999985,274.97000000000025,278.81666666666666,69268293,73786415.4,67.67912922048751,1.5,2.75,2.6305717689285624,0.9387675580185454,-0.037413995791961696,4.049938297757194,4.087352293549156,7.84451496693212,1.5671696187768829,9299761367.0,2019-02-28,2019,3,59,2,0.41,278.88,280.88,278.82,4818
2019-03-01 14:30:00,280.44,280.88,278.82,280.42,204.32512820512812,277.3762499999998,274.7134000000001,267.95700000000005,263.85099999999983,275.49450000000024,270.1370082165984,275.176592212559,277.75384615384604,281.7004866996453,273.8072056080466,274.7134000000001,267.95700000000005,263.85099999999983,275.49450000000024,280.04,78880548,72529839.15,70.72878660158645,1.5,2.75,2.599816642576521,1.0875599466981585,-0.05561787914017202,4.017829944623942,4.073447823764114,7.940821621746973,1.0996142336950685,9378641915.0,2019-03-01,2019,4,60,3,0.74,279.85,281.87,276.84,4819
2019-03-04 14:30:00,281.6,281.87,276.84,279.4,203.65615384615384,277.3249999999998,274.75490000000013,267.87280000000004,264.33739999999983,275.96150000000017,270.5002627963396,275.57882152564855,278.16153846153827,281.5728485744527,274.75022834862386,274.75490000000013,267.87280000000004,264.33739999999983,275.96150000000017,279.37,106494637,73565444.8,66.75255651065079,1.5,2.75,2.7734011681067723,1.4476176592083898,-0.16634300277681824,3.8655190702930895,4.031862073069908,6.355453275558153,0.5578549577109787,9272147278.0,2019-03-04,2019,0,63,3,1.82,279.36,279.76,278.41,4820
2019-03-05 14:30:00,279.54,279.76,278.41,279.02,202.98717948717945,277.27374999999984,274.7888000000001,267.7848000000001,264.89259999999985,276.3145000000002,270.8343701376596,275.90655280892014,278.47153846153833,281.3671249827614,275.5759519403151,274.7888000000001,267.7848000000001,264.89259999999985,276.3145000000002,279.06333333333333,59114559,73483930.55,65.28016053409914,1.5,2.75,2.671729656099143,0.8044555939992516,-0.2880318192520277,3.671822299004873,3.9598541182569007,6.424410023178103,0.2191013253834118,9213032719.0,2019-03-05,2019,1,64,3,0.48,279.09,279.16,276.97,4821
2019-03-06 14:30:00,279.15,279.16,276.97,277.33,202.3182051282051,277.2224999999998,274.8154000000002,267.68410000000006,265.49579999999986,276.5260000000002,271.0891007204965,276.04211920807063,278.6984615384613,280.55006119872365,276.846861878199,274.8154000000002,267.68410000000006,265.49579999999986,276.5260000000002,277.82,75039771,73258280.4,59.042662212981924,1.5,2.75,2.637320394949204,1.0243179418118036,-0.4931579939777873,3.343406625784666,3.8365646197624534,7.3046881914172115,-0.032441785019116084,9137992948.0,2019-03-06,2019,2,65,3,0.79,278.07,276.99,274.07,4822
2019-03-07 14:30:00,276.83,276.99,274.07,275.01,201.64923076923068,277.17124999999976,274.83380000000017,267.6512000000001,266.18199999999985,276.63950000000017,271.24286147655545,275.9438221406353,278.51692307692286,281.1512454637885,275.88260069005725,274.83380000000017,267.6512000000001,266.18199999999985,276.63950000000017,275.3566666666666,94885089,75085145.3,51.73468770930315,1.5,2.75,2.6817975095956887,1.2636998785963591,-0.7789091567518982,2.8629281738225814,3.64183733057448,8.500470986133225,-1.4795443146808038,9043107859.0,2019-03-07,2019,3,66,3,1.07,275.53,274.65,272.42,4823
2019-03-08 14:30:00,272.94,274.65,272.42,274.46,272.42,277.11999999999983,274.83925000000016,267.67410000000007,266.9843999999998,276.8555000000002,271.3690237715925,275.802505746289,278.25615384615367,281.66129510347236,274.8510125888349,274.83925000000016,267.67410000000007,266.9843999999998,276.8555000000002,273.8433333333333,85795799,74600837.2,50.14993729362946,1.5,2.75,2.675240544624566,1.150064827958794,-0.9854823954524624,2.4099843362589013,3.395466731711364,7.219482669950464,-1.810246136233544,8957312060.0,2019-03-08,2019,4,67,3,0.82,273.53,278.62,275.23,4824
2019-03-11 13:30:00,275.26,278.62,275.23,278.44,273.20897959183674,277.0687499999998,274.86840000000007,267.69900000000007,267.6295999999998,277.25400000000013,271.64631695702025,276.053695675214,278.2584615384613,281.66405735127705,274.85286572564564,274.86840000000007,267.69900000000007,267.6295999999998,277.25400000000013,277.43,65098897,74066339.0,59.75671127119779,1.5,2.75,2.7812947914370985,0.8789268901221107,-0.8402594039404656,2.3451424767857816,3.1854018807262467,11.704209092946213,-0.3150508377488169,9022410957.0,2019-03-11,2019,0,70,3,1.23,276.92,280.07,278.85,4825
2019-03-12 13:30:00,279.06,280.07,278.85,279.49,273.99795918367346,277.01749999999976,274.89905000000016,267.7499,268.2579999999998,277.6975000000001,271.95391237047045,276.380962753765,278.4176923076921,281.8450856105099,274.9902990048743,274.89905000000016,267.7499,268.2579999999998,277.6975000000001,279.47,79667530,74648644.35,61.84574636977904,1.5,2.75,2.6990594491915907,1.0672334466848226,-0.6672208137785569,2.3513758635030517,3.018596677281608,11.937587376107926,0.1038681948424142,9102078487.0,2019-03-12,2019,1,71,3,0.44,279.46,282.38,280.3,4826
2019-03-13 13:30:00,280.48,282.38,280.3,281.34,274.78693877551024,276.96624999999983,274.94175000000007,267.75930000000005,268.92979999999983,278.05950000000007,272.3219942382952,276.8532520153112,278.5869230769229,282.3418655397817,274.83198061406415,274.94175000000007,267.75930000000005,268.92979999999983,278.05950000000007,281.34,80639153,75067090.95,65.26683083195303,1.5,2.75,2.712698059963619,1.074227760520404,-0.4332440518360281,2.4770416124865733,2.9102856643226014,12.498437080638421,0.9544997846992852,9182717640.0,2019-03-13,2019,2,72,3,0.74,281.34,281.84,280.6662,4827
2019-03-14 13:30:00,281.37,281.84,280.6662,281.16,275.57591836734696,276.91499999999974,274.98680000000013,267.76640000000003,269.5545999999998,278.36800000000005,272.6685826995385,277.2634184900434,278.7130769230768,282.68865146010694,274.73750238604663,274.98680000000013,267.76640000000003,269.5545999999998,278.36800000000005,281.2220666666667,67518366,75179149.05,64.65934300238709,1.5,2.75,2.602776769966216,0.8980996307246709,-0.3019002795986587,2.5329103148242784,2.8348105944229367,12.423964988936087,0.26388987946651776,9115199274.0,2019-03-14,2019,3,73,3,0.42,281.25,282.21,280.33,4828
2019-03-15 13:30:00,280.54,282.21,280.33,281.31,276.3648979591837,276.86374999999975,275.04825000000005,267.81550000000004,270.1771999999998,278.71450000000016,273.0074618093605,277.64880720527736,278.8661538461537,283.0701046506778,274.66220304162954,275.04825000000005,267.81550000000004,270.1771999999998,278.71450000000016,281.2833333333333,81308979,75082878.2,64.95210214615946,1.5,2.75,2.551149857825771,1.0829230438318491,-0.22002221368788089,2.559782827313086,2.7798050410009667,11.950584044075244,0.6836077308518343,9196508253.0,2019-03-15,2019,4,74,3,0.67,281.27,282.66,281.3,4829
2019-03-18 13:30:00,281.55,282.66,281.3,282.33,277.1538775510204,276.81249999999983,275.09685000000013,267.87630000000007,270.9395999999998,278.9625000000001,273.37305154232683,278.094635090489,279.1069230769229,283.7002653131818,274.51358084066396,275.09685000000013,267.87630000000007,270.9395999999998,278.9625000000001,282.09666666666664,62199806,73338435.55,66.95663732575117,1.5,2.75,2.466067725123932,0.8481201641885856,-0.1174176350524454,2.6330329971854103,2.7504506322378552,11.795982349634631,1.1862948892552514,9258708059.0,2019-03-18,2019,0,77,3,0.48,281.98,284.36,281.41,4830
2019-03-19 13:30:00,283.51,284.36,281.41,282.4,277.9428571428572,276.76124999999973,275.15415000000013,267.95020000000005,271.5397999999998,279.19000000000005,273.7270495210591,278.50466984377584,279.3930769230768,284.2973506299269,274.48880321622664,275.15415000000013,267.95020000000005,271.5397999999998,279.19000000000005,282.7233333333333,90268121,74895801.4,67.09572434327596,1.5,2.75,2.5006343161865066,1.2052494173591952,-0.0675599434240195,2.666000702957831,2.7335606463818505,11.712037623325768,1.8281469729203448,9348976180.0,2019-03-19,2019,1,78,3,1.05,282.88,283.5,280.32,4831
2019-03-20 13:30:00,282.16,283.5,280.32,281.55,278.7318367346939,276.70999999999975,275.19390000000016,268.0296000000001,272.0831999999998,279.3470000000001,274.03383189278225,278.79470128722573,279.47999999999985,284.49285117702976,274.46714882297,275.19390000000016,268.0296000000001,272.0831999999998,279.3470000000001,281.79,84609210,75295723.55,63.59520640334888,1.5,2.75,2.5491604364589,1.1236921037595902,-0.1119348692108164,2.59364205986833,2.7055769290791463,11.134813352741077,2.378095341987572,9264366970.0,2019-03-20,2019,2,79,3,1.13,281.91,285.18,280.59,4832
2019-03-21 13:30:00,280.64,285.18,280.59,284.73,279.5208163265306,276.6587499999997,275.2430500000001,268.22370000000006,272.6423999999998,279.7125000000001,274.4532894656143,279.35996783129946,279.8899999999998,285.62890903596735,274.15109096403233,275.2430500000001,268.22370000000006,272.6423999999998,279.7125000000001,283.5,79550375,76062505.95,69.91833735486112,1.5,2.75,2.6949346909975525,1.045855300274918,0.04439354032574317,2.7610688544863256,2.716675314160582,10.419058473657794,3.7418931720469435,9343917345.0,2019-03-21,2019,3,80,3,1.64,282.88,283.8034,279.18,4833
2019-03-22 13:30:00,283.22,283.8034,279.18,279.25,280.3097959183673,276.60749999999973,275.2638000000002,268.31540000000007,273.0679999999998,279.7180000000001,274.64139576108045,279.349494704509,279.9076923076922,285.63717424881236,274.178210366572,275.2638000000002,268.31540000000007,273.0679999999998,279.7180000000001,280.74446666666665,122659286,78289739.45,52.874778461408845,1.5,2.75,2.898867927354871,1.5667351413059274,-0.23443823189437565,2.4236275242926126,2.6580657561869883,16.674979324936732,0.2909064789541741,9221258059.0,2019-03-22,2019,4,81,3,1.66,281.49,280.1853,277.64,4834
2019-03-25 13:30:00,278.87,280.1853,277.64,279.04,281.09877551020406,276.55624999999975,275.27200000000016,268.45250000000004,273.47119999999984,279.6940000000001,274.81389004495963,279.3200190183653,280.0392307692306,285.6020494323963,274.47641210606486,275.27200000000016,268.45250000000004,273.47119999999984,279.6940000000001,278.9551,85575197,79116964.35,52.34816245597454,1.5,2.75,2.8736130754009515,1.081628923746744,-0.4345497328669259,2.1148785901033307,2.549428322970257,14.606961531549336,-0.16100754946509307,9135682862.0,2019-03-25,2019,0,84,3,0.92,278.91,282.18,279.56,4835
2019-03-26 13:30:00,280.99,282.18,279.56,281.12,281.88775510204084,276.5049999999997,275.2907500000002,268.62510000000003,273.91399999999993,279.78400000000005,275.061188474569,279.491445778521,280.50923076923056,285.2671971191527,275.75126441930854,275.2907500000002,268.62510000000003,273.91399999999993,279.78400000000005,280.9533333333333,68125920,79681055.3,56.9243713575531,1.5,2.75,2.892640712872311,0.8549826523193651,-0.4276978404530034,2.0148060224040023,2.4425038628570057,15.075076072220812,-0.07819719911849381,9203808782.0,2019-03-26,2019,1,85,3,0.94,280.87,281.76,277.93,4836
2019-03-27 13:30:00,281.11,281.76,277.93,279.65,282.6767346938776,276.45374999999973,275.29805000000016,268.74390000000005,274.35899999999987,279.8065,275.24114186772323,279.5065461805666,280.90846153846144,284.22032223929796,277.59660083762475,275.29805000000016,268.74390000000005,274.35899999999987,279.8065,279.78000000000003,72224722,80446212.9,53.047097321166646,1.5,2.75,2.9595949476671453,0.8978013929602893,-0.5170623867941315,1.7961758793643412,2.3132382661584727,14.876595892244756,-0.5370607483283709,9131584060.0,2019-03-27,2019,2,86,3,1.38,279.85,281.21,279.07,4837
2019-03-28 13:30:00,280.35,281.21,279.07,280.71,283.4657142857143,276.40249999999975,275.30880000000013,268.8447,274.76619999999986,279.908,275.4556068925184,279.62116083003644,281.0830769230768,284.0803616903782,278.0857921557753,275.30880000000013,268.8447,274.76619999999986,279.908,280.33,56238545,79794725.5,55.40583427529155,1.5,2.75,2.901052451405205,0.7047902558421609,-0.499411716508491,1.6889736205228587,2.1883853370313497,15.087057344942751,-0.2132878319291965,9187822605.0,2019-03-28,2019,3,87,3,0.77,280.14,282.84,281.14,4838
2019-03-29 13:30:00,282.39,282.84,281.14,282.48,284.25469387755106,276.3512499999997,275.32660000000016,268.93440000000004,275.19619999999986,280.0110000000001,275.7310732888903,279.8934312271758,281.31307692307684,284.24422933087965,278.38192451527385,275.32660000000016,268.93440000000004,275.19619999999986,280.0110000000001,282.15333333333336,82186806,79960038.4,59.10059360485881,1.5,2.75,2.845977276304833,1.0278485058856601,-0.3691624573401677,1.7269322653561403,2.096094722696308,15.537092624160467,0.053129316756998585,9270009411.0,2019-03-29,2019,4,88,3,0.6,281.99,286.16,284.4,4839
2019-04-01 13:30:00,284.7,286.16,284.4,285.83,285.04367346938784,276.29999999999967,275.3656000000002,269.07380000000006,275.65359999999987,280.3325000000001,276.1271096305024,280.4588187293496,281.6584615384614,285.45213924387025,277.86478383305246,275.3656000000002,269.07380000000006,275.65359999999987,280.3325000000001,285.4633333333333,77617945,78516203.8,65.00958582495963,1.5,2.75,2.9055503279973456,0.988559574246762,-0.07349316070349321,2.0042282718169417,2.077721432520435,16.80595243148065,1.2145892351274812,9347627356.0,2019-04-01,2019,0,91,4,0.62,285.28,286.23,285.09,4840
2019-04-02 13:30:00,286.04,286.23,285.09,285.97,285.8326530612245,276.24874999999975,275.4018000000002,269.1996000000001,276.04379999999986,280.68000000000006,276.513105331267,280.98369313607816,282.0284615384614,286.4429540776648,277.613968999258,275.4018000000002,269.1996000000001,276.04379999999986,280.68000000000006,285.7633333333333,40070351,77563993.4,65.23563277633511,1.5,2.75,2.7794395902832525,0.5166102110467148,0.10567154252425937,2.209810860675759,2.1041393181515,16.8013552963678,1.5698810158053689,9387697707.0,2019-04-02,2019,1,92,4,0.4,285.66,287.76,285.75,4841
2019-04-03 13:30:00,287.32,287.76,285.75,286.42,286.62163265306117,276.1974999999997,275.4482500000002,269.31260000000003,276.51499999999993,281.13450000000006,276.9016110045506,281.5014366469278,282.4215384615383,287.38590283267695,277.4571740903997,275.4482500000002,269.31260000000003,276.51499999999993,281.13450000000006,286.6433333333334,68243202,77224164.95,65.99604341707176,1.5,2.75,2.7244796195487337,0.8837026861240278,0.22196394283642729,2.381594246697034,2.159630303860607,16.580015795273393,0.5935447617040697,9455940909.0,2019-04-03,2019,2,93,4,0.7,286.76,287.459,286.01,4842
2019-04-04 13:30:00,286.78,287.459,286.01,287.18,287.410612244898,276.14624999999967,275.5013500000003,269.37430000000006,276.99039999999985,281.7430000000001,277.3046850828036,282.0422522043633,282.79461538461516,288.3671061431914,277.22212462603903,275.5013500000003,269.37430000000006,276.99039999999985,281.7430000000001,286.8830000000001,48997505,74929785.75,67.29707032567754,1.5,2.75,2.633373932438111,0.6539122527785954,0.3120305369906213,2.5496684750988834,2.2376379381082616,15.4749200106716,2.839749328558641,9504938414.0,2019-04-04,2019,3,94,4,0.51,286.73,288.63,287.6,4843
2019-04-05 13:30:00,287.92,288.63,287.6,288.57,288.19959183673467,276.0949999999997,275.5667000000002,269.4550000000001,277.49079999999987,282.44850000000014,277.7464621383799,282.66394247061436,283.2692307692306,289.62271781439875,276.91574372406245,275.5667000000002,269.4550000000001,277.49079999999987,282.44850000000014,288.26666666666665,58621729,73571082.25,69.58886323629645,1.5,2.75,2.548847222978245,0.7968039507805392,0.4204318117238035,2.7631777027630164,2.342745891039213,8.571427982204117,3.4152809633027417,9563560143.0,2019-04-05,2019,4,95,4,0.36,288.12,288.91,287.37,4844
2019-04-08 13:30:00,288.1,288.91,287.37,288.79,288.98857142857145,276.0437499999997,275.6308000000002,269.5653000000001,277.95099999999985,282.9660000000001,278.1795420545219,283.24737652103215,283.82615384615366,290.725052480491,276.92725521181643,275.6308000000002,269.5653000000001,277.95099999999985,282.9660000000001,288.3566666666666,53566335,72994454.15,69.94783234618441,1.5,2.75,2.476786707051229,0.7338411612740308,0.4590174192858298,2.9165176651465003,2.4575002458606705,8.352346395013774,2.728372225384183,9617126478.0,2019-04-08,2019,0,98,4,0.54,288.14,288.08,286.7,4845
2019-04-09 13:30:00,287.72,288.08,286.7,287.31,289.77755102040817,275.9924999999997,275.6961500000002,269.7127000000001,278.42199999999985,283.35700000000014,278.5375992288544,283.63429304283864,284.02461538461523,291.16046901965,276.8887617495804,275.6961500000002,269.7127000000001,278.42199999999985,283.35700000000014,287.36333333333334,66142316,72318193.45,64.43739443983765,1.5,2.75,2.4491590851190006,0.9146013312090002,0.34228497587282725,2.885356465701705,2.5430714898288773,9.21985360130825,2.7391382084748885,9550984162.0,2019-04-09,2019,1,99,4,0.48,287.39,288.3899,287.31,4846
2019-04-10 13:30:00,287.77,288.3899,287.31,288.29,290.56653061224495,275.9412499999997,275.7639000000002,269.87500000000006,278.91959999999995,283.70450000000017,278.9200463179189,284.07769370542536,284.7199999999998,291.61708076485144,277.82291923514833,275.7639000000002,269.87500000000006,278.91959999999995,283.70450000000017,287.99663333333336,52601499,70916310.75,66.32894362308103,1.5,2.75,2.351354864753358,0.741740488805673,0.29053281098859873,2.906237503564625,2.615704692576027,7.91994904320874,2.7002956788144497,9603585661.0,2019-04-10,2019,2,100,4,0.38,287.85,288.84,287.578,4847
2019-04-11 13:30:00,288.83,288.84,287.578,288.21,291.35551020408167,275.8899999999997,275.8499500000002,270.0551000000001,279.33219999999994,284.05700000000013,279.28435822702016,284.47124668586105,285.4253846153845,291.70234917029063,279.1484200604783,275.8499500000002,270.0551000000001,279.33219999999994,284.05700000000013,288.20933333333335,55093100,70295047.45,66.02023431716225,1.5,2.75,2.2735438029852606,0.7837408465964409,0.21391305311683828,2.8830960089720747,2.6691829558552365,8.120811625970939,2.0284621920135804,9548492561.0,2019-04-11,2019,3,101,4,0.44,288.21,290.47,288.26099999999997,4848
2019-04-12 13:30:00,290.0,290.47,288.26099999999997,290.16,292.1444897959184,275.8387499999997,275.9427500000002,270.2265000000001,279.73679999999985,284.4995000000001,279.7108539828233,285.01303271577905,286.1207692307691,292.3384831887978,279.90305527274023,275.9427500000002,270.2265000000001,279.73679999999985,284.4995000000001,289.63033333333334,69727782,69715987.6,69.7196781303074,1.5,2.75,2.2725763884863173,1.000169177837194,0.25478561047336656,2.987664968946945,2.732879358473578,8.199688843595343,1.5148864709792678,9618220343.0,2019-04-12,2019,4,102,4,0.77,289.37,290.35,289.075,4849
2019-04-15 13:30:00,290.24,290.35,289.075,289.97,292.9334693877551,275.7874999999997,276.04585000000026,270.3889000000001,280.13499999999993,284.88150000000013,280.1131734344773,285.4851248380858,286.91461538461516,292.1885898916343,281.6406408775961,276.04585000000026,270.3889000000001,280.13499999999993,284.88150000000013,289.79833333333335,49596685,69085831.55,68.93219396409738,1.5,2.75,2.2013209321658684,0.7178995155338765,0.23000695930129836,3.0203880576002007,2.7903810982989024,5.947757231317409,1.398748120432213,9568623658.0,2019-04-15,2019,0,105,4,0.44,289.71,291.01,289.5,4850
2019-04-16 13:30:00,290.95,291.01,289.5,290.16,293.7224489795919,275.7362499999997,276.1422000000003,270.5995000000001,280.49899999999985,285.26950000000016,280.50716663312517,285.9303510439824,287.6415384615383,291.7763426790565,283.5067342440201,276.1422000000003,270.5995000000001,280.49899999999985,285.26950000000016,290.22333333333336,52153197,67180085.35,69.30555664135757,1.5,2.75,2.151940865582592,0.776319302488055,0.18910482020286776,3.026762123552487,2.8376573033496197,5.938882966944313,1.3057747364010923,9620776855.0,2019-04-16,2019,1,106,4,0.52,290.26,291.425,288.99,4851
2019-04-17 13:30:00,291.4,291.425,288.99,289.45,294.51142857142867,275.6849999999997,276.23305000000033,270.85280000000006,280.82599999999985,285.6645000000001,280.8578659808458,286.26555570646025,288.1776923076921,291.13669581821955,285.2186887971648,276.23305000000033,270.85280000000006,280.82599999999985,285.6645000000001,289.955,58268295,65863039.6,66.10838258700572,1.5,2.75,2.1721593751838357,0.8846888232592289,0.08237404338204612,2.9406248575771765,2.8582508141951313,6.343434615185617,0.7904450170624632,9562508560.0,2019-04-17,2019,2,107,4,0.84,290.21,290.32,288.66,4852
2019-04-18 13:30:00,290.1,290.32,288.66,290.02,295.30040816326533,275.6337499999997,276.32385000000016,271.10280000000006,281.1715999999999,285.9290000000002,281.217165354146,286.6231218296545,288.49999999999983,291.2728352610178,285.7271647389818,276.32385000000016,271.10280000000006,281.1715999999999,285.9290000000002,289.6666666666667,68708513,65320946.5,67.4082731363971,1.5,2.75,2.135576562670702,1.051860340082488,0.021477018013854376,2.885097086712449,2.8636200686985944,6.292545729198036,0.5024777350382883,9631217073.0,2019-04-18,2019,3,108,4,0.58,289.49,290.435,289.07,4853
2019-04-22 13:30:00,289.17,290.435,289.07,290.27,296.0893877551021,275.5824999999997,276.4207000000003,271.37300000000016,281.5741999999999,286.4800000000002,281.5721784775128,286.97044356016363,288.830769230769,291.32985782207453,286.3316806394636,276.4207000000003,271.37300000000016,281.5741999999999,286.4800000000002,289.925,40160140,61195989.2,67.98820156809572,1.5,2.75,2.0805353796227952,0.6562544461655666,-0.027970580083819918,2.8286568435938197,2.8566274236776388,5.7993694001565395,0.5124831192215663,9671377213.0,2019-04-22,2019,0,112,4,0.47,289.75,293.14,290.42,4854
2019-04-23 13:30:00,290.68,293.14,290.42,292.88,296.87836734693883,275.5312499999997,276.5195500000002,271.6268000000002,282.0223999999999,287.1720000000002,282.0156224587868,287.5332584591956,289.32769230769213,292.24564895679714,286.4097356585872,276.5195500000002,271.6268000000002,282.0223999999999,287.1720000000002,292.14666666666665,52246633,59529561.0,73.32475260253638,1.5,2.75,2.1369257096497387,0.8776586308103297,0.08302366303947561,2.9604070024769835,2.8773833394375083,7.530481204962289,1.9386725140092558,9723623846.0,2019-04-23,2019,1,113,4,0.94,291.78,293.16,292.07,4855
2019-04-24 13:30:00,292.79,293.16,292.07,292.23,297.66734693877555,275.4799999999997,276.6036000000002,271.8651000000001,282.4545999999998,287.7275000000002,282.4161862839325,287.98056717736745,289.71615384615365,292.7300247378133,286.702282954494,276.6036000000002,271.8651000000001,282.4545999999998,287.7275000000002,292.4866666666667,50392914,58642910.7,70.18668111644004,1.5,2.75,2.062145301817617,0.8593180897482293,0.08052643056368458,2.9780413776421137,2.8975149470784296,6.750558693198733,1.3666793853411487,9673230932.0,2019-04-24,2019,2,114,4,0.37,292.62,292.78,290.73,4856
2019-04-25 13:30:00,292.12,292.78,290.73,292.05,298.4563265306123,275.4287499999997,276.6743500000003,272.03980000000007,282.81359999999984,288.3475000000002,282.79398290024886,288.3681322080944,289.983846153846,293.1569401398321,286.8107521678599,276.6743500000003,272.03980000000007,282.81359999999984,288.3475000000002,291.8533333333333,57770862,57920217.7,69.3021708119103,1.5,2.75,2.0612777802592124,0.997421354650744,0.03683661490072554,2.9435607157043364,2.9067241008036113,6.772781087174027,1.332361819506621,9615460070.0,2019-04-25,2019,3,115,4,0.71,291.76,293.49,291.2401,4857
2019-04-26 13:30:00,292.1,293.49,291.2401,293.41,299.245306122449,275.3774999999997,276.74690000000027,272.23410000000007,283.1819999999998,288.9825000000002,283.21029729631755,288.84831009303775,290.3392307692306,293.9080742495485,286.7703872889127,276.74690000000027,272.23410000000007,283.1819999999998,288.9825000000002,292.7133666666667,50916423,57654111.6,72.15720973105155,1.5,2.75,2.0747507959549845,0.8831360259829241,0.06781362264260071,2.991491129106862,2.9236775064642613,6.9410918813344304,1.1200716845878136,9666376493.0,2019-04-26,2019,4,116,4,0.77,292.37,294.45,293.41,4858
2019-04-29 13:30:00,293.51,294.45,293.41,293.87,300.03428571428583,275.3262499999997,276.8319500000003,272.4163000000001,283.5717999999999,289.55200000000025,283.6283248533247,289.3265662746532,290.843846153846,294.4118194071405,287.27587290055146,276.8319500000003,272.4163000000001,283.5717999999999,289.55200000000025,293.91,57197747,56404658.65,73.06953931319703,1.5,2.75,2.00084002481534,1.01406068876192,0.0863760244258378,3.0316475369965588,2.945271512570721,6.185245540089853,1.3449667206952365,9723574240.0,2019-04-29,2019,0,119,4,0.35,293.93,294.34,291.92,4859
2019-04-30 13:30:00,293.49,294.34,291.92,294.02,300.8232653061225,275.27499999999964,276.9052000000002,272.5635000000001,283.9047999999999,289.96150000000017,284.03584152574336,289.77355996278146,291.28461538461517,294.8971628802819,287.67206788894856,276.9052000000002,272.5635000000001,283.9047999999999,289.96150000000017,293.4266666666667,81112081,56579365.45,73.37589931176247,1.5,2.75,2.030780023042813,1.4335982801305878,0.07620377571540128,3.0405262322149724,2.964322456499571,6.088131041701358,1.330300523848896,9804686321.0,2019-04-30,2019,1,120,4,0.83,293.13,294.95,291.8,4860
2019-05-01 13:30:00,294.72,294.95,291.8,291.81,301.61224489795916,294.95,276.9663000000002,272.7791000000001,284.1839999999998,290.25350000000026,284.3407104855181,289.96750663299275,291.56153846153825,294.7111401082044,288.41193681487215,276.9663000000002,272.7791000000001,284.1839999999998,290.25350000000026,292.8533333333333,71671870,58159441.4,62.15669869483986,1.5,2.75,2.1107243071111816,1.2323342225222955,-0.10222891958445456,2.836536307019003,2.9387652266034574,7.970881519524709,0.8153394368630208,9733014451.0,2019-05-01,2019,2,121,5,1.08,293.38,292.7,289.52,4861
2019-05-02 13:30:00,291.68,292.7,289.52,291.18,302.40122448979594,295.09405940594064,277.02550000000025,272.99250000000006,284.4393999999998,290.49150000000026,284.6089179174586,290.0829821917553,291.6399999999998,294.6954465870525,288.5845534129472,277.02550000000025,272.99250000000006,284.4393999999998,290.49150000000026,291.1333333333334,65030170,57998789.8,59.369886791963786,1.5,2.75,2.1871011423175264,1.1212332226973467,-0.2757053571079435,2.594133530218528,2.8698388873264715,7.932628879680678,0.3999724156954779,9667984281.0,2019-05-02,2019,3,122,5,1.1,291.11,294.34,291.2998,4862
2019-05-03 13:30:00,292.82,294.34,291.2998,294.03,303.1902040816327,295.2381188118812,277.09330000000017,273.29710000000006,284.7715999999998,290.8340000000003,284.97837211677387,290.4588886496834,291.9523076923075,295.08999085374734,288.8146245308677,277.09330000000017,273.29710000000006,284.7715999999998,290.8340000000003,293.22326666666663,56543653,58376097.2,66.65366646805813,1.5,2.75,2.256593917866272,0.9686096829371456,-0.21426752840089147,2.602004476825357,2.8162720052262484,9.51605503022238,1.2953457126123924,9724527934.0,2019-05-03,2019,4,123,5,1.04,292.82,293.31,288.9,4863
2019-05-06 13:30:00,289.25,293.31,288.9,292.82,303.97918367346944,295.38217821782183,277.15210000000025,273.5846000000001,285.0451999999999,291.04650000000026,285.28588693572397,290.6837563973326,292.15692307692285,295.1436978707144,289.17014828313137,277.15210000000025,273.5846000000001,285.0451999999999,291.04650000000026,291.6766666666667,107198069,60804914.2,61.60421298740592,1.5,2.75,2.4618372094472525,1.7629836405558157,-0.267422017228804,2.481994483690244,2.749416500919048,10.02903124137266,-0.02048620595465797,9617329865.0,2019-05-06,2019,0,126,5,1.53,291.1,290.81,285.81,4864
2019-05-07 13:30:00,290.15,290.81,285.81,287.93,304.7681632653062,295.52623762376237,277.19175000000024,273.8226000000001,285.21339999999987,291.00350000000026,285.38957764412703,290.42149388330085,292.0399999999998,295.51980547646184,288.5601945235378,277.19175000000024,273.8226000000001,285.21339999999987,291.00350000000026,288.18333333333334,144729908,65363092.85,46.32915459581661,1.5,2.75,2.7867059802010195,2.214245099021504,-0.6238537985053947,1.9695992527873043,2.593453051292699,12.924358965042279,-1.4714437258323958,9472599957.0,2019-05-07,2019,1,127,5,1.75,288.31,289.43,286.87,4865
2019-05-08 13:30:00,287.53,289.43,286.87,287.53,305.5571428571429,295.67029702970297,277.23100000000017,274.0433000000001,285.37759999999986,291.01450000000017,285.4735157757298,290.14611351346275,291.8484615384613,295.967354938437,287.72956813848566,277.23100000000017,274.0433000000001,285.37759999999986,291.01450000000017,287.9433333333333,91568287,66634391.4,45.33882771431391,1.5,2.75,2.7705126959009467,1.374189590032033,-0.8637259687403693,1.5137955903672378,2.377521559107607,12.920999540662244,-1.5476801917480016,9381031670.0,2019-05-08,2019,2,128,5,0.89,288.15,287.33,283.3,4866
2019-05-09 13:30:00,285.23,287.33,283.3,286.66,306.3461224489796,295.8143564356436,277.2633000000003,274.2562000000001,285.52679999999987,290.93300000000016,285.52004456883844,289.81410270265684,291.5707692307691,296.4874063650562,286.6541320964819,277.2633000000003,274.2562000000001,285.52679999999987,290.93300000000016,285.7633333333333,103471104,69177871.65,43.17700227287639,1.5,2.75,2.8747617890508765,1.4957254615103497,-1.04599203317348,1.070031517640757,2.1160235508142367,12.92653220828851,-2.300535087420333,9277560566.0,2019-05-09,2019,3,129,5,1.42,285.32,288.94,282.3,4867
2019-05-10 13:30:00,285.62,288.94,282.3,288.1,307.1351020408164,295.9584158415842,277.2957500000003,274.5325000000001,285.71519999999987,290.9275000000003,285.62121929162913,289.6508548262133,291.2030769230767,296.3810740685076,286.0250797776458,277.2957500000003,274.5325000000001,285.71519999999987,290.9275000000003,286.44666666666666,112429293,72044681.3,47.62818936110387,1.5,2.75,3.143707375547241,1.5605495224808497,-1.0327941873828792,0.8250308165856381,1.8578250039685171,12.995099255636196,-1.963453227617648,9389989859.0,2019-05-10,2019,4,130,5,2.35,285.62,283.49,279.93,4868
2019-05-13 13:30:00,282.42,283.49,279.93,280.86,307.9240816326531,296.10247524752475,277.28000000000026,274.7875000000001,285.72399999999993,290.4625000000002,285.4345048096044,288.81363055705015,290.3284615384613,297.834729057756,282.82219401916666,277.28000000000026,274.7875000000001,285.72399999999993,290.4625000000002,281.4266666666667,127290527,74922818.55,33.44340007397767,1.5,2.75,3.502728277293868,1.6989553978812508,-1.4493585773854671,0.04612678223668354,1.495485359622151,18.486434365832558,-4.475885994150048,9262699332.0,2019-05-13,2019,0,133,5,1.27,281.71,285.1,281.85,4869
2019-05-14 13:30:00,281.99,285.1,281.85,283.4,308.7130612244898,296.2465346534653,277.2803000000003,275.07070000000004,285.80399999999986,290.1340000000002,285.354720307267,288.2980466944739,289.6630769230767,297.9354122258305,281.39074162032284,277.2803000000003,275.07070000000004,285.80399999999986,290.1340000000002,283.45,77003230,76293145.8,40.1750426508406,1.5,2.75,3.5553905432014496,1.0093073131610206,-1.4860124837315762,-0.3620302450423196,1.1239822386892566,19.916781475155148,-2.8820122682567515,9339702562.0,2019-05-14,2019,1,134,5,1.15,283.48,285.77,281.36,4870
2019-05-15 13:30:00,281.59,285.77,281.36,285.06,309.50204081632666,296.39059405940594,277.29850000000033,275.40870000000007,285.9247999999999,289.87900000000025,285.34316264815845,287.9896612950002,289.020769230769,297.32624642834185,280.7152920331961,277.29850000000033,275.40870000000007,285.9247999999999,289.87900000000025,284.06333333333333,73956407,77383306.3,44.150680884041854,1.5,2.75,3.6164340758299147,0.955715263874684,-1.3353970217921685,-0.5452640385509541,0.7901329832412145,20.43912536106762,-2.1017927055429646,9413658969.0,2019-05-15,2019,2,135,5,1.57,283.56,289.21,285.76,4871
2019-05-16 13:30:00,285.84,289.21,285.76,287.7,310.2910204081633,296.5346534653465,277.33725000000027,275.81400000000014,286.1321999999999,289.7915000000002,285.4355876423483,287.9620745050001,288.54615384615363,296.3807734224634,280.71153426984387,277.33725000000027,275.81400000000014,286.1321999999999,289.7915000000002,287.5566666666667,76749643,78307373.7,49.85769889955597,1.5,2.75,3.654545927556348,0.9801074837988084,-1.0097153087401185,-0.4720111526839332,0.5377041560561849,21.489215945427087,-2.152841546780936,9490408612.0,2019-05-16,2019,3,136,5,1.21,287.48,288.6,285.1207,4872
2019-05-17 13:30:00,285.14,288.6,285.1207,285.84,311.0800000000001,296.6787128712872,277.3598000000003,276.26540000000006,286.34879999999987,289.58250000000027,285.45144695049146,287.75997217119067,287.9169230769229,295.1854490500908,280.648397103755,277.3598000000003,276.26540000000006,286.34879999999987,289.58250000000027,286.5202333333333,100353024,79889599.25,46.27024092465625,1.5,2.75,3.642028361302325,1.2561462936616246,-0.8762563763957177,-0.5576163144384623,0.3186400619572555,20.46122500428902,-2.383716959224103,9390055588.0,2019-05-17,2019,4,137,5,1.22,286.86,285.43,283.12,4873
2019-05-20 13:30:00,284.06,285.43,283.12,283.95,311.8689795918368,296.82277227722767,277.37525000000016,276.76150000000007,286.53859999999986,289.2665000000003,285.39256667792324,287.39711767869625,287.31230769230746,294.49198908164107,280.13262630297385,277.37525000000016,276.76150000000007,286.53859999999986,289.2665000000003,284.1666666666667,62877610,81025472.75,42.89290978605914,1.5,2.75,3.5761691926378707,0.7760227477352176,-0.8701924611729409,-0.7691005145089207,0.10109194666402023,20.569683612695282,-1.3822804153787442,9327177978.0,2019-05-20,2019,0,140,5,0.82,284.27,286.93,285.55,4874
2019-05-21 13:30:00,285.83,286.93,285.55,286.51,312.65795918367354,296.9668316831683,277.39585000000017,277.16480000000007,286.69999999999993,288.94800000000026,285.4363875925145,287.31263028072516,286.9530769230767,293.78146736127394,280.1246864848795,277.39585000000017,277.16480000000007,286.69999999999993,288.94800000000026,286.33,46847085,80755495.35,48.38812109904264,1.5,2.75,3.533585678878025,0.5801101806999195,-0.6583232064570722,-0.7218120614073199,-0.06348885495024784,19.561200370594708,-0.3547455917643313,9374025063.0,2019-05-21,2019,1,141,5,0.48,286.24,286.69,285.1,4875
2019-05-22 13:30:00,285.45,286.69,285.1,285.63,313.44693877551026,297.11089108910886,277.4060000000003,277.5404000000001,286.82279999999986,288.6180000000003,285.44398023594533,287.1523797777989,286.30692307692277,291.79193697981185,280.82190917403375,277.4060000000003,277.5404000000001,286.82279999999986,288.6180000000003,285.8066666666667,49482472,80709973.25,46.72371565404606,1.5,2.75,3.3947581303867365,0.6130899318567176,-0.5465980002686728,-0.7467363552860888,-0.2001383550174161,19.613180432398856,-0.35931068164376945,9324542591.0,2019-05-22,2019,2,142,5,0.56,285.9,283.21,280.57,4876
2019-05-23 13:30:00,283.16,283.21,280.57,282.14,314.235918367347,297.2549504950495,277.39350000000024,277.88430000000005,286.8387999999999,288.1225000000003,285.3144123835553,286.67501027515135,285.48538461538436,289.92113181902687,281.04963741174186,277.39350000000024,277.88430000000005,286.8387999999999,288.1225000000003,281.9733333333333,98733847,82758122.5,40.738823967866296,1.5,2.75,3.5137039782162547,1.193041166442605,-0.668816258666231,-1.0361586783502048,-0.36734241968397385,20.709303379247686,-2.0687261367580825,9225808744.0,2019-05-23,2019,3,143,5,0.94,281.89,284.2,282.09,4877
2019-05-24 13:30:00,283.74,284.2,282.09,282.78,315.0248979591837,297.39900990099017,277.3795000000003,278.2129000000001,286.87119999999993,287.5910000000003,285.21502366263155,286.30405691561316,285.0892307692305,289.500729461294,280.6777320771671,277.3795000000003,278.2129000000001,286.87119999999993,287.5910000000003,283.0233333333333,55268095,82975706.1,42.200930442743775,1.5,2.75,3.4134394083436663,0.6660756213799789,-0.666167546258866,-1.2000518525075563,-0.5338843062486903,20.448101153532747,0.6836146122623225,9281076839.0,2019-05-24,2019,4,144,5,0.75,283.14,284.15,280.13,4878
2019-05-28 13:30:00,283.09,284.15,280.13,280.15,315.81387755102037,297.5430693069307,277.35295000000025,278.51260000000013,286.8479999999999,286.9050000000003,285.0163952837048,285.7179562569833,284.5215384615382,289.4047394681588,279.63833745491763,277.35295000000025,278.51260000000013,286.8479999999999,286.9050000000003,281.47666666666663,70029356,83617286.55,38.046737923244976,1.5,2.75,3.4567651648905464,0.8374985471230889,-0.7925589156014244,-1.5245829507504711,-0.7320240351490465,15.033409466003432,-1.1467889908256879,9211047483.0,2019-05-28,2019,1,148,5,1.44,282.14,279.36,276.71,4879
2019-05-29 13:30:00,278.91,279.36,276.71,278.27,316.60285714285715,297.6871287128713,277.3189500000002,278.85320000000013,286.76679999999993,286.1175000000003,284.75183076277517,285.00862708965155,283.8761538461536,289.6030756315596,278.1492320607477,277.3189500000002,278.85320000000013,286.76679999999993,286.1175000000003,278.11333333333334,104972927,84810328.85,35.366671454763825,1.5,2.75,3.4555676531126496,1.237737530597961,-0.9435348138800626,-1.9114425524991248,-0.9679077386190622,14.178174280494598,-2.3819546762085246,9106074556.0,2019-05-29,2019,2,149,5,0.96,278.03,280.04,277.805,4880
2019-05-30 13:30:00,279.11,280.04,277.805,279.03,317.39183673469387,297.8311881188119,277.2983000000002,279.11960000000016,286.6994,285.4785000000003,284.5274452426664,284.43923403349424,283.17846153846136,288.88698604756274,277.46993702936,277.2983000000002,279.11960000000016,286.6994,285.4785000000003,278.9583333333333,62523780,84352924.35,37.28979328172062,1.5,2.75,3.36838424931889,0.7412165076882721,-0.9313762733738932,-2.132128080336429,-1.2007518069625356,13.666781380311429,-3.0135557872784213,9168598336.0,2019-05-30,2019,3,150,5,0.8,278.92,277.12,275.24,4881
2019-05-31 13:30:00,276.2,277.12,275.24,275.27,318.1808163265306,297.9752475247525,277.2641500000002,279.32850000000013,286.57379999999995,284.6830000000003,284.1644081743265,283.56597364935186,282.74846153846136,289.7796747882068,275.7172482887159,277.2641500000002,279.32850000000013,286.57379999999995,284.6830000000003,275.87666666666667,86862782,85444554.95,32.18718522861577,1.5,2.75,3.3984996600818236,1.0165982144892662,-1.1039386433917746,-2.580675111202254,-1.4767364678104793,12.978115119776358,-3.6978729359081983,9081735554.0,2019-05-31,2019,4,151,5,0.68,276.18,276.5521,273.09,4882
2019-06-03 13:30:00,275.31,276.5521,273.09,274.57,273.09,298.11930693069314,277.2175000000002,279.50650000000013,286.3706,283.71000000000026,283.7881568733725,282.70921425417555,282.06923076923056,290.3180254095268,273.8204361289343,277.2175000000002,279.50650000000013,286.3706,283.71000000000026,274.7373666666667,96427952,87438769.9,31.3277246417246,1.5,2.75,3.403042541504552,1.102805450148493,-1.1854363461511324,-2.9585319004993953,-1.7730955543482625,12.945215531721475,-3.3033984856488803,8985307602.0,2019-06-03,2019,0,154,6,1.27,274.82,280.68,276.62,4883
2019-06-04 13:30:00,277.12,280.68,276.62,280.53,273.10135593220343,298.2633663366337,277.2112500000002,279.73210000000006,286.3962,283.09550000000024,283.66038601559325,282.5016700394922,281.72076923076906,289.8160573628132,273.6254810987249,277.2112500000002,279.73210000000006,286.3962,283.09550000000024,279.27666666666664,77231889,85940460.9,44.83429392314118,1.5,2.75,3.5963966456827987,0.8986673819432588,-0.7778567451937963,-2.7454164858405083,-1.967559740646712,19.327111779504317,-2.08718718369342,9062539491.0,2019-06-04,2019,1,155,6,1.47,278.65,282.99,280.32,4884
2019-06-05 13:30:00,282.33,282.99,280.32,282.96,273.11271186440683,298.40742574257433,277.2057500000002,279.9729000000001,286.4745999999999,282.84700000000026,283.63291989733466,282.5453205119215,281.3561538461537,288.7368085532408,273.9754991390666,277.2057500000002,279.9729000000001,286.4745999999999,282.84700000000026,282.09,71169717,82262451.35,49.2196419870958,1.5,2.75,3.5302254567054576,0.865154342376645,-0.308602421854046,-2.353312767964269,-2.0447103461102234,19.260628962382256,-0.9347757588488659,9133709208.0,2019-06-05,2019,2,156,6,0.95,281.65,285.55,282.57,4885
2019-06-06 13:30:00,283.29,285.55,282.57,284.8,273.1240677966101,298.55148514851487,277.2044500000003,280.2311000000001,286.54819999999995,282.71050000000025,283.678687744498,282.7600518917385,281.2761538461537,288.4811245169359,274.07118317537146,277.2044500000003,280.2311000000001,286.54819999999995,282.71050000000025,284.3066666666667,69430381,81155556.05,52.31100021553222,1.5,2.75,3.490923638369355,0.8555222141195594,0.1377602812924703,-1.8725099944946348,-2.0102702757871054,19.70322014235238,0.9427943574112232,9203139589.0,2019-06-06,2019,3,157,6,1.05,284.06,288.85,285.74,4886
2019-06-07 13:30:00,285.93,288.85,285.74,287.65,273.1354237288135,298.69554455445535,277.21435000000025,280.5336000000001,286.70819999999986,282.76000000000033,283.83442548000784,283.22576123538244,281.5607692307691,289.4276636880648,273.69387477347334,277.21435000000025,280.5336000000001,286.70819999999986,282.76000000000033,287.41333333333336,74272199,79695610.8,56.70723262917759,1.5,2.75,3.5308576642001164,0.9319484254457838,0.6105177468166048,-1.2471230922663494,-1.8576408390829544,18.865186110454605,1.7221868590423668,9277411788.0,2019-06-07,2019,4,158,6,1.09,287.3,290.82,288.8734,4887
2019-06-10 13:30:00,289.37,290.82,288.8734,288.97,273.1467796610169,298.839603960396,277.22750000000025,280.8198000000001,286.87339999999995,282.80350000000027,284.03582055922334,283.77283159391743,281.7499999999999,290.18203415551443,273.31796584448534,277.22750000000025,280.8198000000001,286.87339999999995,282.80350000000027,289.55446666666666,60799053,77114098.8,58.610359909844114,1.5,2.75,3.505082116757252,0.7884297935930751,0.97600369142894,-0.6376362247967791,-1.6136399162257191,18.926491789690964,3.148313403533839,9338210841.0,2019-06-10,2019,0,161,6,0.67,289.85,291.4,288.1805,4888
2019-06-11 13:30:00,290.99,291.4,288.1805,288.9,273.1581355932203,298.98366336633666,277.2411500000003,281.0990000000001,287.00179999999995,283.20550000000026,284.2265726941557,284.26113334687767,282.0015384615383,291.0538304659011,272.9492464571755,277.2411500000003,281.0990000000001,287.00179999999995,283.20550000000026,289.4935,58641325,73681638.7,58.46358671936263,1.5,2.75,3.484683394131733,0.7958743322574882,1.1641634852305152,-0.15843555968757528,-1.3225990449180904,17.57708544507166,3.820030905235921,9279569516.0,2019-06-11,2019,1,162,6,1.12,289.79,289.26,287.815,4889
2019-06-12 13:30:00,288.64,289.26,287.815,288.39,273.1694915254237,299.1277227722772,277.25415000000027,281.3533000000001,287.05299999999994,283.45500000000027,284.38984435320845,284.6543587424132,282.48230769230753,292.15552894829,272.80908643632506,277.25415000000027,281.3533000000001,287.05299999999994,283.45500000000027,288.48833333333334,47096312,72186292.8,57.33700126023189,1.5,2.75,3.3389917231223225,0.6524273539089405,1.2005818996232374,0.17812832961095634,-1.022453570012281,16.77780036424428,3.3544780131168745,9232473204.0,2019-06-12,2019,2,163,6,0.5,288.54,289.98,288.62,4890
2019-06-13 13:30:00,289.4,289.98,288.62,289.58,273.1808474576271,299.2717821782178,277.2645000000003,281.5845000000002,287.12519999999995,283.68100000000027,284.59337986876886,285.1234674336119,283.00538461538446,293.3952927822448,272.61547644852413,277.2645000000003,281.5845000000002,287.12519999999995,283.68100000000027,289.3933333333334,48945156,70935730.25,59.30740637374436,1.5,2.75,3.2140637428993015,0.6899929813579384,1.2457363031485496,0.534716808923406,-0.7110194942251435,16.771172899153733,5.1985323500563085,9281418360.0,2019-06-13,2019,3,164,6,0.47,289.3,289.93,288.41,4891
2019-06-14 13:30:00,289.26,289.93,288.41,289.26,273.19220338983047,299.4158415841584,277.26190000000025,281.8485000000001,287.182,283.7590000000003,284.77638457979765,285.51742291612504,283.70615384615365,294.453906494132,272.95840119817547,277.26190000000025,281.8485000000001,287.182,283.7590000000003,289.2,52324716,69714483.9,58.52464277827937,1.5,2.75,3.0930591898350652,0.7505573171144138,1.1947952295848745,0.7824745427559492,-0.41232068682892503,13.232872472533087,5.350183923953818,9229093644.0,2019-06-14,2019,4,165,6,0.53,289.17,290.22,289.18,4892
2019-06-17 13:30:00,289.52,290.22,289.18,289.37,273.20355932203387,299.559900990099,277.2591500000003,282.1081000000001,287.22579999999994,283.93550000000033,284.956526360982,285.88433501935117,284.55999999999983,295.2077993392587,273.9122006607409,277.2591500000003,282.1081000000001,287.22579999999994,283.93550000000033,289.5900000000001,39205709,66657118.15,58.72630402071572,1.5,2.75,2.9464121048468472,0.5881698772481361,1.1110122033440728,0.976444567351166,-0.13456763599290678,12.723698064818645,3.151178127116541,9268299353.0,2019-06-17,2019,0,168,6,0.36,289.7,293.57,290.99,4893
2019-06-18 13:30:00,291.39,293.57,290.99,292.4,273.21491525423727,299.70396039603963,277.2637500000003,282.3966000000001,287.30239999999986,284.3580000000003,285.24842728800235,286.50487454131775,285.5884615384614,296.48101325236763,274.6959098245552,277.2637500000003,282.3966000000001,287.30239999999986,284.3580000000003,292.32,85434823,67784978.8,63.92896507328439,1.5,2.75,3.0359540973577857,1.2603798734241105,1.194851878901521,1.3589972126339944,0.16414533373247348,8.431650155527107,3.3361605880689846,9353734176.0,2019-06-18,2019,1,169,6,0.89,292.28,293.65,291.47,4894
2019-06-19 13:30:00,292.55,293.65,291.47,293.06,273.22627118644067,299.8480198019802,277.27755000000025,282.66940000000017,287.3877999999999,284.68550000000033,285.55476347278665,287.1291722040494,286.95692307692286,296.7330836717673,277.18076248207853,277.27755000000025,282.66940000000017,287.3877999999999,284.68550000000033,292.7266666666667,78674377,69376343.4,64.96492096374315,1.5,2.75,2.974814518975083,1.1340231142824977,1.2253880298499813,1.6958803710449502,0.4704923411949689,7.974139232640423,2.9002808988764013,9432408553.0,2019-06-19,2019,2,170,6,0.75,292.56,296.3093,293.1255,4895
2019-06-20 13:30:00,296.04,296.3093,293.1255,295.86,273.237627118644,299.9920792079208,277.30530000000033,282.9904000000002,287.5588,285.1970000000003,285.95889039542243,287.96067961318755,288.59461538461517,296.4701026335581,280.7191281356724,277.30530000000033,282.9904000000002,287.5588,285.1970000000003,295.0982666666667,116570017,72730720.65,69.02878925145437,1.5,2.75,2.994420624762578,1.602761748518437,1.354690702122355,2.1638557188479126,0.8091650167255576,8.554008647565817,2.8541630453676468,9548978570.0,2019-06-20,2019,3,171,6,1.09,294.72,295.52,293.76,4896
2019-06-21 13:30:00,294.13,295.52,293.76,294.0,273.2489830508474,300.13613861386136,277.3262500000003,283.2963000000002,287.67299999999994,285.79000000000025,286.27422802697447,288.53585298336014,289.63076923076915,296.4650469160355,282.7964915455027,277.3262500000003,283.2963000000002,287.67299999999994,285.79000000000025,294.4266666666667,83309466,71959501.6,63.73964109736523,1.5,2.75,2.9305334372795384,1.1577271124401451,1.2386421292657817,2.3574676783077853,1.1188255490420032,9.331585027703758,1.7406651209468016,9465669104.0,2019-06-21,2019,4,172,6,0.6,294.64,294.58,293.47,4897
2019-06-24 13:30:00,294.23,294.58,293.47,293.64,273.2603389830508,300.280198019802,277.3493000000003,283.5569000000002,287.7815999999999,286.33300000000025,286.56308182983815,289.02196222304013,290.4523076923075,296.3904408039957,284.51417458061934,277.3493000000003,283.5569000000002,287.7815999999999,286.33300000000025,293.89666666666665,47582730,71575233.35,62.737663397628566,1.5,2.75,2.8004953346167114,0.6647932220817553,1.0677989869185789,2.4535742826902265,1.3857752957716478,9.380662242218897,1.6407061266874383,9418086374.0,2019-06-24,2019,0,175,6,0.38,294.02,293.73,290.64,4898
2019-06-25 13:30:00,293.7,293.73,290.64,290.76,273.27169491525416,300.4242574257425,277.3623000000003,283.76520000000016,287.7935999999999,286.86350000000033,286.72766685611913,289.18748963036967,290.910769230769,295.8725707741902,285.9489676873478,277.3623000000003,283.76520000000016,287.7935999999999,286.86350000000033,291.71,82028656,72175198.35,55.254415965620545,1.5,2.75,2.8211742392869485,1.1365213795771991,0.7083133070834067,2.2711669296259056,1.5628536225424994,11.459143765807388,0.821803807344223,9336057718.0,2019-06-25,2019,1,176,6,1.06,292.18,292.31,290.345,4899
2019-06-26 13:30:00,291.75,292.31,290.345,290.47,273.28305084745756,300.5683168316832,277.3766500000003,283.9693000000001,287.8036,287.4735000000004,286.8744250186242,289.30963347509635,291.1276923076921,295.73415034196273,286.5212342734216,277.3766500000003,283.9693000000001,287.8036,287.4735000000004,291.0416666666667,51584902,69505797.1,54.5488501047658,1.5,2.75,2.7600189364807366,0.7421669004929663,0.41310833270671776,2.0792390384258965,1.6661307057191788,11.408510498007946,0.3073416672422278,9284472816.0,2019-06-26,2019,2,177,6,0.68,291.33,292.06,290.89,4900
2019-06-27 13:30:00,291.31,292.06,290.89,291.5,273.29440677966096,300.71237623762374,277.3936500000003,284.1647000000001,287.83039999999994,288.0970000000003,287.0558201159331,289.51823981080145,291.3223076923075,295.75830834327803,286.88630704133703,277.3936500000003,284.1647000000001,287.83039999999994,288.0970000000003,291.48333333333335,40355239,68397370.05,56.66540352064763,1.5,2.75,2.67644615530354,0.5900115599547091,0.2569661505329841,1.9873383938854092,1.7303722433524251,11.350297632777094,0.7743898223051957,9324828055.0,2019-06-27,2019,3,178,6,0.4,291.48,293.55,292.01,4901
2019-06-28 13:30:00,292.58,293.55,292.01,293.0,273.3057627118644,300.8564356435644,277.4134000000003,284.36370000000016,287.9013999999999,288.9835000000004,287.2889252094259,289.84983601929656,291.63769230769213,295.92031662066614,287.3550679947182,277.4134000000003,284.36370000000016,287.9013999999999,288.9835000000004,292.8533333333333,59350929,67021777.4,59.614876938751316,1.5,2.75,2.631700001353288,0.8855469267217614,0.2255796877786753,2.012346853075769,1.7867671652970938,11.557188855571738,1.2544493209385892,9384178984.0,2019-06-28,2019,4,179,6,0.53,292.78,296.92,294.33,4902
2019-07-01 13:30:00,296.68,296.92,294.33,295.66,273.31711864406776,301.00049504950493,277.4461000000003,284.5929000000002,288.0141999999999,290.0380000000004,287.6172026521935,290.40318496983974,292.1969230769229,296.5354331694294,287.85841298441636,277.4461000000003,284.5929000000002,288.0141999999999,290.0380000000004,295.63666666666666,79107474,66155753.5,64.26039865344002,1.5,2.75,2.7237214298280543,1.1957761768974486,0.3475473715678041,2.2212013797568493,1.8736540081890447,12.348013030346547,1.114911080711371,9463286458.0,2019-07-01,2019,0,182,7,0.88,295.62,296.49,294.68,4903
2019-07-02 13:30:00,295.61,296.49,294.68,296.43,273.32847457627116,301.14455445544553,277.4741000000003,284.8558000000002,288.1373999999999,290.83300000000037,287.9628025481859,290.9771673536645,292.72384615384595,297.3193257954414,288.1283665122505,277.4741000000003,284.8558000000002,288.1373999999999,290.83300000000037,295.86666666666673,61504544,65369386.25,65.49764339133263,1.5,2.75,2.6584556134117645,0.9408768772094752,0.4378332005437453,2.4209455088687264,1.983112308324981,11.197213615553984,1.1499351668600302,9524791002.0,2019-07-02,2019,1,183,7,0.61,295.59,298.82,297.02,4904
2019-07-03 13:30:00,297.18,298.82,297.02,298.8,273.33983050847456,301.2886138613861,277.5137000000003,285.1391000000002,288.2557999999999,291.6250000000004,288.3877906835512,291.72219903426793,293.45769230769207,298.61835507877714,288.29702953660706,277.5137000000003,285.1391000000002,288.2557999999999,291.6250000000004,298.2133333333333,40898896,63855845.2,69.04920992764697,1.5,2.75,2.6392802124537798,0.6404878969482343,0.6046388760368093,2.7389109033709933,2.1342720273341835,11.822633345562506,0.9937132427499484,9565689898.0,2019-07-03,2019,2,184,7,0.61,297.92,298.64,296.01,4905
2019-07-05 13:30:00,297.44,298.64,296.01,298.46,273.3511864406779,301.4326732673267,277.5593000000004,285.41750000000013,288.3803999999999,292.3080000000004,288.7827792841962,292.3638943643376,294.1569230769228,299.3756254480158,288.9382207058299,277.5593000000004,285.41750000000013,288.3803999999999,292.3080000000004,297.7033333333333,51677326,62968192.45,67.96829178765154,1.5,2.75,2.6500459115642263,0.820689366953553,0.6363375164981395,2.9296939229568575,2.2933564064587184,10.871193417402349,1.5170068027210817,9514012572.0,2019-07-05,2019,4,186,7,0.89,297.32,298.2579,296.22,4906
2019-07-08 13:30:00,297.01,298.2579,296.22,296.82,273.3625423728813,301.5767326732673,277.5888500000003,285.64470000000017,288.47579999999994,292.7665000000004,289.09796441030613,292.7882853772578,294.4969230769228,299.7888814732825,289.2049646805632,277.5888500000003,285.64470000000017,288.47579999999994,292.7665000000004,297.0993,45841772,61546671.1,62.85692728039111,1.5,2.75,2.620756917881064,0.7448294307504797,0.4972786848663828,2.914954762541697,2.4176760776753143,10.687151683954033,1.0829587249693526,9468170800.0,2019-07-08,2019,0,189,7,0.69,297.24,297.52,295.48,4907
2019-07-09 13:30:00,295.54,297.52,295.48,297.19,273.3738983050847,301.72079207920785,277.6187000000004,285.8667000000001,288.55139999999994,293.1775000000004,289.41529913931373,293.2074962937095,294.8146153846152,300.21807647136376,289.4111542978665,277.6187000000004,285.8667000000001,288.55139999999994,293.1775000000004,296.73,41101279,60561782.4,63.52340758150538,1.5,2.75,2.579274280889557,0.6786669310446187,0.38562217714820335,2.8997037991105685,2.514081621962365,10.596645522547217,2.2114458660063305,9509272079.0,2019-07-09,2019,1,190,7,0.69,296.5,299.66,297.78,4908
2019-07-10 13:30:00,298.37,299.66,297.78,298.61,273.3852542372881,301.8648514851485,277.6438500000003,286.1090000000001,288.6461999999999,293.6630000000004,289.7758756436544,293.72202045621333,295.02615384615365,300.7806679990762,289.271639693231,277.6438500000003,286.1090000000001,288.6461999999999,293.6630000000004,298.68333333333334,58595558,60559494.05,66.04181107406369,1.5,2.75,2.571468975111733,0.9675701377495244,0.3631237698894863,2.967986334324223,2.6048625644347365,8.030591544624876,2.8023548042827087,9567867637.0,2019-07-10,2019,2,191,7,0.63,298.72,299.58,298.2,4909
2019-07-11 13:30:00,299.32,299.58,298.2,299.31,273.3966101694915,302.00891089108916,277.6804500000003,286.3284000000002,288.7519999999999,294.2090000000004,290.149762873315,294.254208984193,295.4346153846152,301.58031614775194,289.2889146214784,277.6804500000003,286.3284000000002,288.7519999999999,294.2090000000004,299.03,50889481,60749152.5,67.24246179954291,1.5,2.75,2.486364048318038,0.8376986164539497,0.3509109859320025,3.0435012968497404,2.6925903109177383,7.695900341527588,2.6792452830188687,9618757118.0,2019-07-11,2019,3,192,7,0.46,298.89,300.73,299.51,4910
2019-07-12 13:30:00,299.85,300.73,299.51,300.65,273.40796610169485,302.1529702970297,277.7286000000003,286.55640000000017,288.9287999999999,294.7625000000004,290.5615368782831,294.8633319380793,295.97384615384584,302.60595703008124,289.3417352776105,277.7286000000003,286.55640000000017,288.9287999999999,294.7625000000004,300.2966666666667,40354410,60319615.2,69.46792267090552,1.5,2.75,2.4101951877238936,0.6690097386430276,0.38582875343419065,3.174876252710476,2.7890474992762853,7.737961559119669,2.610921501706477,9659111528.0,2019-07-12,2019,4,193,7,0.41,300.12,301.13,300.19,4911
2019-07-15 13:30:00,301.13,301.13,300.19,300.75,273.41932203389825,302.2970297029703,277.7786000000003,286.7798000000002,289.1201999999999,295.3370000000004,290.9610844516837,295.4239669915956,296.74230769230735,303.08875262736444,290.39586275725037,277.7786000000003,286.7798000000002,289.1201999999999,295.3370000000004,300.69,33910261,59398892.45,69.63372100765173,1.5,2.75,2.3051812457436154,0.5708904594230358,0.3684433055413314,3.2496016312029496,2.8811583256616182,7.764654754450637,1.7215720760332733,9693021789.0,2019-07-15,2019,0,196,7,0.31,300.66,300.88,299.44,4912
2019-07-16 13:30:00,300.65,300.88,299.44,299.71,273.4306779661016,302.4410891089109,277.8277500000003,287.0027000000002,289.2337999999998,295.8540000000004,291.3041791790686,295.8321606114436,297.45307692307665,302.8253498104566,292.0808040356965,277.8277500000003,287.0027000000002,289.2337999999998,295.8540000000004,300.01,40567964,59467005.2,65.64145009047294,1.5,2.75,2.243382585333357,0.6821928204314549,0.24559469585327465,3.1881516954782114,2.9425569996249368,7.27862178009844,1.106500691562923,9652453825.0,2019-07-16,2019,1,197,7,0.48,300.16,299.93,297.74,4913
2019-07-17 13:30:00,299.75,299.93,297.74,297.74,273.442033898305,302.5851485148515,277.8630000000004,287.1887000000002,289.3321999999999,296.1210000000004,291.55656430930117,296.01385960083,297.93307692307656,302.06353701753875,293.80261682861436,277.8630000000004,287.1887000000002,289.3321999999999,296.1210000000004,298.47,44102443,57400386.2,58.76822529661915,1.5,2.75,2.239569543523831,0.7683300744063635,0.003173559289533223,2.946523948736853,2.9433503894473203,8.510556779844778,-0.3547523427041507,9608351382.0,2019-07-17,2019,2,198,7,0.74,298.84,299.25,296.7,4914
2019-07-18 13:30:00,297.19,299.25,296.7,298.83,273.4533898305084,302.72920792079213,277.9035500000004,287.38180000000017,289.5501999999998,296.4095000000003,291.8417970814855,296.28206344837,298.3815384615381,301.38420236760857,295.3788745554677,277.9035500000004,287.38180000000017,289.5501999999998,296.4095000000003,298.26,51701687,56051751.7,61.1896706106141,1.5,2.75,2.2617431475578442,0.9223919936832232,-0.10621038595602617,2.8105874070022883,2.916797792958314,7.407188141082196,0.1239697111840798,9660053069.0,2019-07-18,2019,3,199,7,0.86,297.98,300.07,296.96,4915
2019-07-19 13:30:00,300.04,300.07,296.96,297.17,273.46474576271186,302.8732673267327,277.93075000000033,287.5603000000002,289.7429999999998,296.47500000000036,292.0507462155448,296.3666288342395,298.497692307692,301.1687699219568,295.8266146934272,277.93075000000033,287.5603000000002,289.7429999999998,296.47500000000036,298.06666666666666,71081238,53777312.75,55.813780860056646,1.5,2.75,2.322332922732284,1.3217699874748765,-0.3017316104286527,2.5396332799224983,2.8413648903511506,8.064421944343907,0.117916582440544,9588971831.0,2019-07-19,2019,4,200,7,1.05,298.52,298.5,297.04,4916
2019-07-22 13:30:00,297.61,298.5,297.04,297.9,273.4761016949152,303.01732673267327,277.9624500000004,287.74730000000017,289.9677999999998,296.67000000000036,292.280128716896,296.5126641833596,298.6107692307689,301.0352147539041,296.18632370763373,277.9624500000004,287.74730000000017,289.9677999999998,296.67000000000036,297.81333333333333,43687404,51796209.65,57.578820382827104,1.5,2.75,2.2607377139656912,0.8434478950333772,-0.3877805431956451,2.3566392113565944,2.744419754552239,7.506921797885642,0.2389044045896496,9632659235.0,2019-07-22,2019,0,203,7,0.49,297.77,300.03,298.22,4917
2019-07-23 13:30:00,299.14,300.03,298.22,300.03,273.4874576271186,303.1613861386138,278.0040000000003,287.9608000000002,290.2063999999998,296.9895000000003,292.58404523780206,296.8476485468492,298.70538461538433,301.24524064262386,296.1655285881446,278.0040000000003,287.9608000000002,290.2063999999998,296.9895000000003,299.4266666666667,44657973,51649971.8,62.30966821980793,1.5,2.75,2.2513993058252844,0.8646272484508889,-0.3104749774648772,2.3563260327211424,2.66680101018602,8.455453571523218,0.475536653159626,9677317208.0,2019-07-23,2019,1,204,7,0.61,299.12,301.44,299.09,4918
2019-07-24 13:30:00,299.19,301.44,299.09,301.44,273.498813559322,303.30544554455446,278.0640000000003,288.17100000000016,290.6179999999998,297.5235000000003,292.9313375814177,297.2850153519111,298.9346153846151,301.8540527949738,296.01517797425623,278.0640000000003,288.17100000000016,290.6179999999998,297.5235000000003,300.6566666666667,47213232,49909200.6,65.08545923335345,1.5,2.75,2.258442212552052,0.9459825329280068,-0.18007554494770295,2.4417065790013908,2.6217821239490937,8.442684352010259,0.7116367645584829,9724530440.0,2019-07-24,2019,2,205,7,0.79,300.26,301.0,299.11,4919
2019-07-25 13:30:00,300.94,301.0,299.11,300.0,273.5101694915253,303.44950495049505,278.1249000000003,288.3770000000002,290.9499999999999,298.0000000000003,293.20854002920515,297.54358531839574,299.1792307692304,301.87313798642435,296.48532355203645,278.1249000000003,288.3770000000002,290.9499999999999,298.0000000000003,300.0366666666667,55394092,50099660.1,60.208567002996176,1.5,2.75,2.263553483084047,1.1056780003982505,-0.2047035723432411,2.3659026585200422,2.5706062308632838,8.983389475111352,-0.21619823715282802,9669136348.0,2019-07-25,2019,3,206,7,0.63,300.06,302.23,300.62,4920
2019-07-26 13:30:00,300.76,302.23,300.62,302.01,273.52152542372875,302.23,278.1958500000003,288.60690000000017,291.2889999999999,298.5255000000003,293.55369532217753,297.9689581452152,299.5499999999996,302.37051822846365,296.72948177153563,278.1958500000003,288.60690000000017,291.2889999999999,298.5255000000003,301.62,45084077,50336102.0,64.23679351954021,1.5,2.75,2.2611568057209017,0.8956608717933701,-0.10457126531950367,2.4398921492139043,2.5444634145334075,9.441604539974463,0.4189526184538624,9714220425.0,2019-07-26,2019,4,207,7,0.54,301.42,301.93,300.85,4921
2019-07-29 13:30:00,301.88,301.93,300.85,301.46,273.53288135593215,302.35133333333334,278.2661500000003,288.84820000000013,291.5641999999998,298.9485000000003,293.86374648601367,298.3014383218614,299.7692307692303,302.7041396163676,296.834321922093,278.2661500000003,288.84820000000013,291.5641999999998,298.9485000000003,301.41333333333336,38126462,49274878.65,62.376020984837076,1.5,2.75,2.182502748169407,0.77375050014456,-0.09462557899299552,2.426181440792164,2.5208070197851593,9.531885212823333,0.5838977678422476,9676093963.0,2019-07-29,2019,0,210,7,0.36,301.39,301.17,299.49,4922
2019-07-30 13:30:00,299.91,301.17,299.49,300.72,273.54423728813555,302.47266666666667,278.3782500000003,289.10530000000017,291.8617999999998,299.2015000000003,294.1326191728367,298.53177752930316,299.8776923076918,302.84077961498883,296.91460500039483,278.3782500000003,289.10530000000017,291.8617999999998,299.2015000000003,300.4600000000001,45849045,47611957.2,59.86341364091405,1.5,2.75,2.1673239804430184,0.9629733305733544,-0.15363817391609524,2.3287593023900404,2.4823974763061347,9.405937358945689,1.000873245113192,9630244918.0,2019-07-30,2019,1,211,7,0.56,300.33,301.2,295.2,4923
2019-07-31 13:30:00,300.99,301.2,295.2,297.43,273.5555932203389,302.594,278.5045500000004,289.3350000000002,292.1313999999998,299.2515000000003,294.2619282248824,298.4268463360362,299.6299999999996,302.82286705018385,296.4371329498152,278.5045500000004,289.3350000000002,292.1313999999998,299.2515000000003,297.9433333333333,104245162,49748988.1,50.18452231368956,1.5,2.75,2.441086553268517,2.0954227609706897,-0.4151638161018712,1.963442706178796,2.378606522280667,10.823206192454846,-0.4684937924572424,9525999756.0,2019-07-31,2019,2,212,7,2.03,298.2,300.87,293.96,4924
2019-08-01 13:30:00,297.6,300.87,293.96,294.84,273.5669491525423,302.7153333333334,278.5990000000004,289.4990000000002,292.29799999999983,299.0535000000003,294.2845977062595,298.0852419230804,299.17538461538413,303.18056292033725,295.170206310431,278.5990000000004,289.4990000000002,292.29799999999983,299.0535000000003,296.5566666666666,142646576,54836372.1,44.13481951470757,1.5,2.75,2.7602946566064817,2.601313152880877,-0.7442924996799243,1.448240897680762,2.192533397360686,11.559952925323982,-0.7840629942457317,9383353180.0,2019-08-01,2019,3,213,8,2.35,297.41,294.12,290.9,4925
2019-08-02 13:30:00,293.85,294.12,290.9,292.62,273.5783050847457,302.8366666666667,278.6901000000003,289.6303000000001,292.43779999999987,298.7615000000003,294.2193193648376,297.5647426923108,298.6299999999995,303.92019993806196,293.33980006193696,278.6901000000003,289.6303000000001,292.43779999999987,298.7615000000003,292.5466666666667,116749695,58089990.55,39.715437994360606,1.5,2.75,2.8445593239917333,2.0098074366100933,-1.0732310616873597,0.8509945702514871,1.9242256319388464,11.876952636010078,-1.7724068479355397,9266603485.0,2019-08-02,2019,4,214,8,1.11,292.51,288.21,281.72,4926
2019-08-05 13:30:00,288.09,288.21,281.72,283.82,281.72,302.95799999999997,278.7072000000003,289.6551000000002,292.4713999999998,298.1115000000003,293.81150291915765,296.25571957875735,297.55923076923017,307.07996267884056,288.0384988596199,278.7072000000003,289.6551000000002,292.4713999999998,298.1115000000003,284.5833333333333,178745449,64735174.4,27.822470879406662,1.5,2.75,3.419947943706607,2.7611796933692987,-1.8022810734502916,-0.328625709874018,1.4736553635762737,20.057438411304734,-5.402793054027923,9087858036.0,2019-08-05,2019,0,217,8,2.3,284.97,288.04,284.28,4927
2019-08-06 13:30:00,285.91,288.04,284.28,287.8,281.9161363636364,303.0793333333333,278.7439500000003,289.72150000000016,292.5717999999998,297.6420000000004,293.57575770664164,295.45041295220915,296.71076923076873,307.50768178529563,285.9138566762418,278.7439500000003,289.72150000000016,292.5717999999998,297.6420000000004,286.70666666666665,120711682,68715694.55,37.00979367917282,1.5,2.75,3.4770945191561364,1.7566828479360834,-1.9241976774383742,-0.931591733221694,0.99260594421668,21.838138501253685,-4.524946921443731,9208569718.0,2019-08-06,2019,1,218,8,1.32,286.16,288.82,282.04,4928
2019-08-07 13:30:00,284.4,288.82,282.04,287.97,282.11227272727274,303.2006666666667,278.8018000000004,289.7881000000002,292.7281999999998,297.11000000000035,293.3559240710871,294.7379926710463,296.00307692307643,307.75097594209456,284.2551779040583,278.8018000000004,289.7881000000002,292.7281999999998,297.11000000000035,286.2766666666667,140572265,72814529.9,37.37646343374714,1.5,2.75,3.7130163392164106,1.930552393774364,-1.8979434171363685,-1.3798233272037803,0.5181200899325877,21.352874895003115,-4.009999999999991,9349141983.0,2019-08-07,2019,2,219,8,2.4,285.43,293.62,289.01,4929
2019-08-08 13:30:00,289.62,293.62,289.01,293.62,282.3084090909091,303.322,278.8886500000003,289.9010000000001,293.0351999999998,296.8255000000003,293.366279989868,294.6315171785657,295.67384615384566,307.4305373117498,283.91715499594153,278.8886500000003,289.9010000000001,293.0351999999998,296.8255000000003,292.0833333333333,87713904,74655751.05,48.174190819465686,1.5,2.75,3.851372314986665,1.1749115475545135,-1.4261482266692669,-1.2645651934039959,0.16158303326527096,25.39265419397785,-2.778053706830895,9436855887.0,2019-08-08,2019,3,220,8,1.6,291.32,293.24,289.65,4930
2019-08-09 13:30:00,292.58,293.24,289.65,291.62,282.5045454545455,303.4433333333334,278.9717000000004,289.9932000000001,293.2869999999998,296.37400000000036,293.2977984216378,294.34470601870225,295.0269230769226,306.6786813057328,283.37516484811243,278.9717000000004,289.9932000000001,293.2869999999998,296.37400000000036,291.50333333333333,93729958,77324528.45,45.20301467592603,1.5,2.75,3.859845721059048,1.2121633313368108,-1.1847835441420878,-1.3193963969123388,-0.13461285277025106,24.853444223361826,-3.2641146420752256,9343125929.0,2019-08-09,2019,4,221,8,1.24,291.44,291.6052,287.02,4931
2019-08-12 13:30:00,289.96,291.6052,287.02,288.07,282.7006818181818,303.56466666666665,279.0440000000003,290.0584000000001,293.54299999999984,295.7400000000004,293.0927867188285,293.74711496930206,293.99846153846113,305.56435262762903,282.43257044929317,279.0440000000003,290.0584000000001,293.54299999999984,295.7400000000004,288.8984,65527632,78905397.0,40.43581628086246,1.5,2.75,3.912713883840546,0.8304581751233062,-1.1967179928684422,-1.6305103438558035,-0.4337923509873615,25.31059882772481,-4.206570896515042,9277598297.0,2019-08-12,2019,0,224,8,1.6,289.31,294.15,287.36,4932
2019-08-13 13:30:00,287.74,294.15,287.36,292.55,282.8968181818182,303.6860000000001,279.1801500000004,290.1366000000001,293.90259999999984,295.3820000000004,293.0715009651489,293.6331040198447,293.42538461538413,304.4716108847028,282.37915834606537,279.1801500000004,290.1366000000001,293.90259999999984,295.3820000000004,291.3533333333333,94792972,81616647.4,47.9027902084212,1.5,2.75,4.118234320709076,1.1614416301054775,-0.8516064034890738,-1.4983003553487038,-0.64669395185963,27.802861217849703,-1.6407221867330113,9372391269.0,2019-08-13,2019,1,225,8,2.36,290.76,288.74,283.76,4933
2019-08-14 13:30:00,288.07,288.74,283.76,283.9,283.09295454545463,303.80733333333336,279.2492500000004,290.18310000000014,293.9699999999998,294.6900000000004,292.71183426063334,292.70614173224044,292.0323076923072,302.96385457094465,281.1007608136697,279.2492500000004,290.18310000000014,293.9699999999998,294.6900000000004,285.46666666666664,135622053,86192627.9,37.99804207215037,1.5,2.75,4.451931869229859,1.573476250861589,-1.1367815370116108,-2.0676708731241438,-0.9308893361125328,31.72067469779293,-3.7104870438203768,9236769216.0,2019-08-14,2019,2,226,8,1.76,286.25,285.64,282.39,4934
2019-08-15 13:30:00,284.88,285.64,282.39,284.65,283.28909090909093,303.9286666666667,279.34585000000044,290.2392000000001,294.0037999999998,293.9810000000004,292.39568389747126,291.93889013869375,290.73923076923023,300.85017369578213,280.6282878426784,279.34585000000044,290.2392000000001,294.0037999999998,293.9810000000004,284.22666666666663,101929845,88704035.8,39.17243359234741,1.5,2.75,4.3660795928562965,1.1491004223282475,-1.1995818310810331,-2.430366624963824,-1.230784793882791,31.85565149205101,-2.7236689221516053,9338699061.0,2019-08-15,2019,3,227,8,1.15,284.02,289.33,284.7138,4935
2019-08-16 13:30:00,286.48,289.33,284.7138,288.85,283.48522727272734,304.05,279.4708000000004,290.31650000000013,294.0847999999998,293.5650000000004,292.25663747011953,291.64471012548483,289.82615384615326,298.15343076172167,281.49887693058486,279.4708000000004,290.31650000000013,294.0847999999998,293.5650000000004,287.63126666666665,85825286,89441238.2,45.40842924039054,1.5,2.75,4.388502479080847,0.9595717560180198,-0.8968047588957571,-2.3517907425024878,-1.4549859836067305,33.335509397451546,1.7722500176168101,9424524347.0,2019-08-16,2019,4,228,8,1.62,287.02,293.08,291.44,4936
2019-08-19 13:30:00,292.19,293.08,291.44,292.33,283.6813636363637,304.17133333333334,279.59360000000044,290.44330000000014,294.1783999999998,293.2865000000004,292.2595144320756,291.7099758278196,289.43384615384565,296.7047895418483,282.16290276584283,279.59360000000044,290.44330000000014,294.1783999999998,293.2865000000004,292.2833333333333,53640153,89938875.65,49.98384246435359,1.5,2.75,4.377180873432212,0.5964067552805792,-0.4246676688900968,-1.9858205697193512,-1.5611529008292544,28.241328802660462,1.5740097289784478,9478164500.0,2019-08-19,2019,0,231,8,0.56,292.26,292.36,289.95,4937
2019-08-20 13:30:00,291.77,292.36,289.95,290.09,283.87750000000005,304.29266666666666,279.6909000000004,290.5371000000001,294.2007999999998,292.7895000000004,292.17443543473917,291.5556924156463,289.0684615384609,295.66181411700836,282.4751089599135,279.6909000000004,290.5371000000001,294.2007999999998,292.7895000000004,290.7999999999999,51652752,90288614.6,47.239349635957154,1.5,2.75,4.236667953901342,0.5720848883199057,-0.23519834070925905,-1.8551508267158283,-1.6199524860065693,27.891791887330804,0.7361877973399825,9426511748.0,2019-08-20,2019,1,232,8,0.83,291.15,292.86,291.72,4938
2019-08-21 13:30:00,292.48,292.86,291.72,292.45,284.07363636363635,304.4140000000001,279.7856000000004,290.63680000000016,294.27179999999987,292.3400000000004,292.1852418882789,291.6408645665371,289.055384615384,295.62112607747065,282.4896431532974,279.7856000000004,290.63680000000016,294.27179999999987,292.3400000000004,292.3433333333333,49723430,90414124.5,50.333521934874284,1.5,2.75,4.131905957194107,0.5499520155172215,0.061265333433346836,-1.5433708192148856,-1.6046361526482324,28.202506564869328,-0.3984742183775001,9476235178.0,2019-08-21,2019,2,233,8,0.39,292.29,293.93,290.4,4939
2019-08-22 13:30:00,293.23,293.93,290.4,292.36,284.2697727272728,304.53533333333337,279.8879500000004,290.7021000000001,294.3511999999999,291.95800000000037,292.19209514756204,291.7093536554384,289.71230769230715,295.7380277136191,283.68658767099515,279.8879500000004,290.7021000000001,294.3511999999999,291.95800000000037,292.23,51739292,90231384.5,50.21258412052543,1.5,2.75,4.0889126745373865,0.5734068283081704,0.252756962677432,-1.2886899493014423,-1.5414469119788743,25.80002441066143,0.2537548864961282,9424495886.0,2019-08-22,2019,3,234,8,1.22,292.16,292.76,283.47,4940
2019-08-23 13:30:00,290.92,292.76,283.47,284.85,284.4659090909091,304.6566666666667,279.9452500000003,290.6909000000001,294.2565999999999,291.10000000000036,291.9041698476577,291.05608187872986,289.48538461538396,295.98558397511016,282.9851852556579,279.9452500000003,290.6909000000001,294.2565999999999,291.10000000000036,287.0266666666667,149318151,95443088.2,41.29606107992074,1.5,2.75,4.460418912070427,1.5644731726105232,-0.1056873095768016,-1.6735560489498766,-1.567868739373075,29.60249582854892,-1.1177838719755513,9275177735.0,2019-08-23,2019,4,235,8,3.28,288.12,288.0,285.58,4941
2019-08-26 13:30:00,287.27,288.0,285.58,288.0,284.66204545454553,304.778,280.0096500000003,290.7067000000001,294.2313999999999,290.42700000000036,291.7510651477495,290.7650264617081,289.4876923076917,295.9857590206575,282.98962559472585,280.0096500000003,290.7067000000001,294.2313999999999,290.42700000000036,287.1933333333333,72620598,97167795.0,45.655158643099746,1.5,2.75,4.366817561208252,0.7473731188404553,-0.1094933307554986,-1.7047354028174482,-1.5952420720619496,29.76297962004043,-1.5552896940693937,9347798333.0,2019-08-26,2019,0,238,8,0.85,286.79,289.95,286.03,4942
2019-08-27 13:30:00,289.54,289.95,286.03,286.87,284.8581818181819,304.89933333333335,280.0389500000004,290.7036000000001,294.1813999999999,289.73450000000037,291.55965082822985,290.394071560593,288.96846153846093,295.1329346703792,282.8039884065426,280.0389500000004,290.7036000000001,294.1813999999999,289.73450000000037,287.6166666666667,68262998,98288492.65,44.38198214238325,1.5,2.75,4.334902021121949,0.6945166840952667,-0.16370949241593324,-1.799878937581866,-1.6361694451659328,28.116236735551315,1.0461430081014538,9279535335.0,2019-08-27,2019,1,239,8,1.37,287.99,289.07,285.25,4943
2019-08-28 13:30:00,286.14,289.07,285.25,288.89,285.05431818181825,305.02066666666667,280.0809000000003,290.7068000000001,294.1111999999999,289.3075000000004,291.45495863888755,290.2508266500604,288.7584615384609,294.73030751595513,282.7866155609667,280.0809000000003,290.7068000000001,294.1111999999999,289.3075000000004,287.7366666666667,59852324,96068850.75,47.21572803189046,1.5,2.75,4.298123305327524,0.6230148849782092,-0.04528088466754565,-1.6927705510003648,-1.6474896663328191,21.969239528550897,1.4895485684173582,9339387659.0,2019-08-28,2019,2,240,8,1.34,287.16,293.16,290.61,4944
2019-08-29 13:30:00,291.72,293.16,290.61,292.58,285.25045454545466,305.14200000000005,280.1550000000003,290.74470000000014,294.1015999999999,289.1945000000004,291.49907790795083,290.47265268338793,289.10538461538397,295.39261521710523,282.8181540136627,280.1550000000003,290.74470000000014,294.1015999999999,289.1945000000004,292.1166666666666,57998913,91836467.6,52.02440341158458,1.5,2.75,4.296114497804132,0.6315455560923601,0.2818285994202048,-1.2952039170575629,-1.577032516477768,22.856673090171128,1.2913276787259689,9397386572.0,2019-08-29,2019,3,241,8,0.88,291.88,294.2399,291.42,4945
2019-08-30 13:30:00,294.22,294.2399,291.42,292.45,285.4465909090909,305.2633333333334,280.2544000000003,290.79610000000014,294.03339999999986,289.1860000000003,291.53636897038416,290.6609714754462,289.0976923076917,295.3682690391153,282.827115576268,280.2544000000003,290.79610000000014,294.03339999999986,289.1860000000003,292.7033,62961780,89147071.85,51.84520621961846,1.5,2.75,4.1906706051038345,0.7062686265897807,0.4781617741287589,-0.9793302988168192,-1.4574920729455785,21.590541143102552,0.04104949885403638,9334424792.0,2019-08-30,2019,4,242,8,0.97,292.83,291.58,289.27,4946
2019-09-03 13:30:00,290.57,291.58,289.27,290.74,285.6427272727273,305.3846666666667,280.3478000000003,290.8206000000001,293.9681999999999,289.5320000000003,291.5051388146828,290.6684980015942,289.6238461538455,295.1673165385044,284.08037576918656,280.3478000000003,290.8206000000001,293.9681999999999,289.5320000000003,290.53,69252354,83672417.1,49.43319028638129,1.5,2.75,4.118479847596419,0.8276604931495399,0.4803130459958152,-0.8571007654508094,-1.3374138114466243,20.757405891437227,0.2240683925678356,9265172438.0,2019-09-03,2019,1,246,9,0.8,290.42,294.055,292.31,4947
2019-09-04 13:30:00,293.14,294.055,292.31,294.04,285.83886363636367,305.5060000000001,280.4670000000003,290.8789000000002,293.9761999999999,289.8440000000004,291.6045451356756,290.9895934300137,290.3461538461532,295.5453699910186,285.14693770128764,280.4670000000003,290.8789000000002,293.9761999999999,289.8440000000004,293.4683333333333,47003957,79987030.85,53.891358075407766,1.5,2.75,4.061088429910959,0.5876447281578274,0.6792738550016801,-0.4883214926945243,-1.1675953476962044,21.217391619534908,0.5436826808001477,9312176395.0,2019-09-04,2019,2,247,9,0.6,293.18,298.83,296.64,4948
2019-09-05 13:30:00,296.79,298.83,296.64,297.82,286.03500000000014,305.6273333333333,280.5910000000004,290.95550000000014,294.11739999999986,290.3365000000003,291.8482884636884,291.640108341441,291.0361538461532,297.4879659396789,284.5843417526275,280.5910000000004,290.95550000000014,294.11739999999986,290.3365000000003,297.7633333333333,83356779,77126256.55,58.41407836378386,1.5,2.75,4.113153542060173,1.0807834157743779,1.0202454907905218,0.10771151579194793,-0.912533974998574,21.91714497061729,1.8675605417977763,9395533174.0,2019-09-05,2019,3,248,9,0.74,297.74,298.76,297.42,4949
2019-09-06 13:30:00,298.17,298.76,297.42,298.05,286.23113636363644,305.7486666666667,280.7126000000004,291.0363000000001,294.2689999999999,290.5580000000004,292.09149283766135,292.2505742136848,291.4761538461532,298.92417490893143,284.02813278337493,280.7126000000004,291.0363000000001,294.2689999999999,290.5580000000004,298.07666666666665,49584290,75219775.85,58.67966240753191,1.5,2.75,3.91507114619873,0.6591922063006255,1.2034744126223982,0.5918090407794239,-0.6116653718429743,21.88760827319005,4.63401790416008,9445117464.0,2019-09-06,2019,4,249,9,0.45,298.09,299.24,297.16,4950
2019-09-09 13:30:00,299.14,299.24,297.16,298.2,286.4272727272728,305.87,280.8581000000003,291.1167000000001,294.4029999999999,290.8870000000003,292.33104213814516,292.81718619333384,292.09999999999934,300.29974858903364,283.9002514109651,280.8581000000003,291.1167000000001,294.4029999999999,290.8870000000003,298.2000000000001,51260290,73096292.45,58.8641741352717,1.5,2.75,3.783994635755963,0.7012707249832614,1.270379719746802,0.9763092778405279,-0.29407044190627385,12.998887676141365,3.5416666666666625,9496377754.0,2019-09-09,2019,0,252,9,0.7,298.2,298.2,295.97,4951
2019-09-10 13:30:00,297.36,298.2,295.97,298.13,286.6234090909092,305.9913333333334,281.0281500000003,291.20350000000013,294.5055999999999,291.3900000000003,292.5584522503748,293.3231684606353,292.5369230769224,301.34728894592894,283.7265572079158,281.0281500000003,291.20350000000013,294.5055999999999,291.3900000000003,297.43333333333334,57947101,72717265.9,58.73236997920946,1.5,2.75,3.672995018916249,0.7968822848714943,1.2439330135876296,1.2608458250782633,0.016912811490633617,12.561657304246433,3.9251228779586538,9438430653.0,2019-09-10,2019,1,253,9,0.75,297.09,300.34,297.75,4952
2019-09-11 13:30:00,298.47,300.34,297.75,300.25,286.8195454545455,306.11266666666666,281.2043000000004,291.3058000000001,294.5973999999999,291.7750000000003,292.8600815738896,293.98286670247955,293.14384615384546,302.8621066454428,283.42558566224807,281.2043000000004,291.3058000000001,294.5973999999999,291.7750000000003,299.44666666666666,68821066,71418670.6,61.54102415481309,1.5,2.75,3.5956382318508004,0.9636284940873712,1.2972869628702772,1.6385215150784802,0.341234552208203,11.757877788289314,3.932292568105512,9507251719.0,2019-09-11,2019,2,254,9,0.87,299.04,302.46,300.41,4953
2019-09-12 13:30:00,301.25,302.46,300.41,301.29,287.0156818181818,306.2340000000001,281.3945000000004,291.4160000000001,294.69459999999987,292.6445000000004,293.19066661020764,294.67878415938634,294.40846153846087,303.7519342783149,285.064988798607,281.3945000000004,291.4160000000001,294.69459999999987,292.6445000000004,301.38666666666666,72908745,68283005.2,62.87585834844889,1.5,2.75,3.496664072432885,1.067743646994611,1.325981658477954,1.9987116253056456,0.6727299668276916,11.662849203252781,2.9769635655205535,9580160464.0,2019-09-12,2019,3,255,9,0.68,301.44,302.17,300.68,4954
2019-09-13 13:30:00,301.78,302.17,300.68,301.09,287.2118181818182,306.35533333333336,281.5624500000003,291.49810000000014,294.7403999999999,293.4665000000004,293.50044439019945,295.28937614420664,295.41538461538397,304.59932583533765,286.23144339543035,281.5624500000003,291.49810000000014,294.7403999999999,293.4665000000004,301.31333333333333,62104838,66291754.85,62.427129168683464,1.5,2.75,3.3533309244019653,0.9368410617659187,1.2555601046996998,2.2421800977023167,0.9866199930026168,10.5759375768923,2.9543511711403614,9518055626.0,2019-09-13,2019,4,256,9,0.5,301.42,301.1378,299.45,4955
2019-09-16 13:30:00,299.84,301.1378,299.45,300.16,287.40795454545463,306.4766666666667,281.7212500000004,291.5774000000001,294.7744,294.0320000000003,293.76160343372106,295.7532450828536,296.43769230769163,304.4764796400729,288.3989049753103,281.7212500000004,291.5774000000001,294.7744,294.0320000000003,300.2492666666667,58191175,64910049.3,60.27305225665555,1.5,2.75,3.234364429801828,0.8964894592985619,1.0772574501832222,2.3331918057316443,1.255934355548422,10.979977678639429,3.2400082547981066,9459864451.0,2019-09-16,2019,0,259,9,0.56,300.29,301.02,299.75,4956
2019-09-17 13:30:00,299.94,301.02,299.75,300.92,287.604090909091,306.598,281.8529500000003,291.66610000000014,294.85639999999995,294.4615000000004,294.0423248676928,296.24531697972475,297.36307692307633,304.42353837941687,290.3026154667357,281.8529500000003,291.66610000000014,294.85639999999995,294.4615000000004,300.56333333333333,42904427,64373263.0,61.44388912632699,1.5,2.75,3.0940526848159817,0.666494519626883,0.9460804957252296,2.4385349752049588,1.4924544794797296,9.582630744469904,2.3398177118759333,9502768878.0,2019-09-17,2019,1,260,9,0.42,300.38,301.22,298.24,4957
2019-09-18 13:30:00,300.49,301.22,298.24,301.1,287.80022727272734,306.71933333333334,281.98855000000026,291.7430000000001,294.93459999999993,295.0120000000004,294.31909644150875,296.7076677435605,298.0184615384609,304.7556321208107,291.2812909561111,281.98855000000026,291.7430000000001,294.93459999999993,295.0120000000004,300.18666666666667,74192091,65500229.95,61.731559772126865,1.5,2.75,3.085906064471984,1.1326997028351653,0.8121469759632671,2.507638199433813,1.6954912234705464,8.255007425343205,1.101336377677802,9576960969.0,2019-09-18,2019,2,261,9,1.0,299.73,302.63,300.7103,4958
2019-09-19 13:30:00,301.53,302.63,300.7103,301.08,287.9963636363637,302.63,282.1157000000003,291.8151000000001,294.98399999999987,295.44350000000037,294.58422991439073,297.1240803394119,298.68230769230706,304.76259186505746,292.60202351955667,282.1157000000003,291.8151000000001,294.98399999999987,295.44350000000037,301.47343333333333,78099215,66919019.2,61.67649622360328,1.5,2.75,3.0026056312954124,1.1670705269392232,0.6688921308907831,2.5316063870840253,1.8627142561932424,4.981425875509652,1.0166079516859496,9498861754.0,2019-09-19,2019,3,262,9,0.64,301.67,300.67,297.41,4959
2019-09-20 13:30:00,300.36,300.67,297.41,298.28,288.19250000000005,302.6405263157895,282.2106000000003,291.85770000000014,294.9634,295.73950000000036,294.72916207461066,297.2341679261345,299.26230769230705,303.295265407091,295.2293499775231,282.2106000000003,291.85770000000014,294.9634,295.73950000000036,298.7866666666667,97455979,69204853.55,54.36525528639201,1.5,2.75,3.0502766576314517,1.4082246258868067,0.3483668695114155,2.2981728430825115,1.949805973571096,7.795212315858194,0.026827632461429943,9401405775.0,2019-09-20,2019,4,263,9,1.1,299.04,299.0,297.27,4960
2019-09-23 13:30:00,297.55,299.0,297.27,298.21,288.38863636363635,302.65105263157886,282.35040000000026,291.9217000000001,294.91459999999995,296.40750000000037,294.86566552266515,297.32710431412175,299.5830769230763,302.37634778896063,296.789806057192,282.35040000000026,291.9217000000001,294.91459999999995,296.40750000000037,298.16,47541321,64116012.05,54.19230006477197,1.5,2.75,2.955971182086349,0.7414890521095658,0.1069626329931732,2.0835092648125624,1.9765466318193887,7.791964973423182,0.02683393150638449,9353864454.0,2019-09-23,2019,0,266,9,0.58,298.14,299.84,294.81,4961
2019-09-24 13:30:00,299.41,299.84,294.81,295.87,288.5847727272728,302.6615789473684,282.4805500000003,291.9686000000001,294.81699999999995,296.8010000000004,294.90505118844305,297.1883324746816,299.43307692307627,302.7494083959598,296.11674545019275,282.4805500000003,291.9686000000001,294.81699999999995,296.8010000000004,296.84,97367568,65353360.55,48.62350761319969,1.5,2.75,3.104116097651608,1.4898632171410198,-0.21730515533420247,1.7049151876516362,1.9222203429858389,9.01292205472203,-1.4587843463780168,9256496886.0,2019-09-24,2019,1,267,9,1.71,297.32,298.11,294.33,4962
2019-09-25 13:30:00,295.96,298.11,294.33,297.62,288.7809090909092,302.6721052631579,282.6508000000003,292.00450000000006,294.7752,297.3385000000004,295.01151976928844,297.22944366756906,299.3999999999993,302.7788391270434,296.02116087295525,282.6508000000003,292.00450000000006,294.7752,297.3385000000004,296.68666666666667,73434081,65611914.7,52.550515898810566,1.5,2.75,3.1523935192479238,1.1192186866633234,-0.3150020318909814,1.528467803122112,1.8434698350130931,8.653838541836535,-1.2180955225862178,9329930967.0,2019-09-25,2019,2,268,9,1.28,296.22,297.86,295.45,4963
2019-09-26 13:30:00,297.63,297.86,295.45,297.0,288.97704545454553,302.6826315789473,282.8154500000003,292.0463000000001,294.7604,297.7440000000003,295.0894993861791,297.2075918897053,299.3076923076917,302.87303966459496,295.74234495078844,282.8154500000003,292.0463000000001,294.7604,297.7440000000003,296.77,58722357,65555416.35,51.06140030341413,1.5,2.75,3.0993654107302167,0.8957666699343599,-0.4160971285512097,1.3233484243240812,1.7394455528752908,8.211609307394653,-1.3583978212494523,9271208610.0,2019-09-26,2019,3,269,9,0.82,296.65,297.9465,293.69,4964
2019-09-27 13:30:00,297.83,297.9465,293.69,295.4,289.1731818181819,302.6931578947368,282.9718000000003,292.1210000000001,294.6918,297.8850000000004,295.10167588083874,297.035440281162,299.0976923076917,303.197329468748,294.9980551466353,282.9718000000003,292.1210000000001,294.6918,297.8850000000004,295.67883333333333,84781110,66894526.2,47.33374877886185,1.5,2.75,3.1820178813923445,1.2673848641445344,-0.5756155327367272,1.0199261369543822,1.595541669691109,8.493569949216166,-1.5858208955224038,9186427500.0,2019-09-27,2019,4,270,9,1.45,295.82,297.55,295.92,4965
2019-09-30 13:30:00,295.97,297.55,295.92,296.77,289.36931818181824,302.7036842105263,283.1283500000003,292.2134000000001,294.6838,298.1010000000004,295.1671003561,297.01016025438463,298.8299999999994,303.0465096758295,294.6134903241692,283.1283500000003,292.2134000000001,294.6838,298.1010000000004,296.74666666666667,52562761,66374575.25,50.655496435399286,1.5,2.75,3.1083023184357508,0.7919110714007921,-0.5725399101198096,0.879866782041347,1.4524066921611567,9.221682037040786,-1.3791040808188335,9238990261.0,2019-09-30,2019,0,273,9,0.55,296.74,298.455,293.0,4966
2019-10-01 13:30:00,297.74,298.455,293.0,293.24,289.56545454545466,302.71421052631575,283.26770000000033,292.2792000000001,294.5906,298.2260000000004,295.0915277931157,296.6510973730147,298.21076923076856,303.1095380653716,293.3120003961655,283.26770000000033,292.2792000000001,294.5906,298.2260000000004,294.8983333333333,89900420,67406978.55,43.11054327043106,1.5,2.75,3.2759235814046233,1.33369603465189,-0.7791163491311592,0.4785112557472075,1.2576276048783668,10.73690984914752,-2.6104284290933286,9149089841.0,2019-10-01,2019,1,274,10,1.86,295.73,291.51,286.64,4967
2019-10-02 13:30:00,291.5,291.51,286.64,288.06,289.761590909091,302.72473684210524,283.40565000000026,292.2788000000002,294.3512,297.92700000000036,294.8157816051504,295.8328976232038,297.20846153846094,304.21793576940723,290.1989873075146,283.40565000000026,292.2788000000002,294.3512,297.92700000000036,288.7366666666666,124523974,71282979.4,34.896582754873144,1.5,2.75,3.513357611304296,1.7468963144938354,-1.2097929419918056,-0.2546135726113903,0.9551793693804154,13.562496723899065,-4.324432044639293,9024565867.0,2019-10-02,2019,2,275,10,1.7,289.08,290.45,284.82,4968
2019-10-03 13:30:00,287.81,290.45,284.82,290.42,284.82,302.73526315789474,283.58095000000026,292.3744000000001,294.1308,297.55700000000036,294.64339801279164,295.317383563851,296.45923076923015,304.1003239714928,288.8181375669675,283.58095000000026,292.3744000000001,294.1308,297.55700000000036,288.56333333333333,85906799,71410480.4,40.46238152419378,1.5,2.75,3.664546353353989,1.2029998750715587,-1.2744118430707758,-0.6378354344580544,0.6365764086127215,15.243210103280408,-2.635107952259608,9110472666.0,2019-10-03,2019,3,276,10,1.98,287.64,294.63,290.82,4969
2019-10-04 13:30:00,291.14,294.63,290.82,294.35,284.8938095238095,302.74578947368417,283.77730000000025,292.4839000000001,294.0178,297.37200000000036,294.63189220836836,295.22525179586523,295.95384615384563,303.2071850707934,288.7005072368977,283.77730000000025,292.4839000000001,294.0178,297.37200000000036,293.26666666666665,66700681,72266299.95,48.3770347786837,1.5,2.75,3.703507328114416,0.9229845868150054,-1.003107070513587,-0.6173074295292622,0.3857996409843247,17.53412343678751,-1.2943898594949723,9177173347.0,2019-10-04,2019,4,277,10,1.31,292.73,295.26,292.77,4970
2019-10-07 13:30:00,293.47,295.26,292.77,293.08,284.96761904761905,302.75631578947366,283.9864000000003,292.5641000000001,293.8392,297.1160000000004,294.57103369039316,295.02094210102086,295.3369230769225,302.08089763942587,288.59294851441916,283.9864000000003,292.5641000000001,293.8392,297.1160000000004,293.7033333333334,60656561,72736113.5,46.23791769700338,1.5,2.75,3.616828233249101,0.8339263411427668,-0.8650396596620858,-0.6954999335932825,0.16953972606880327,17.59772678155629,-0.9429817149423804,9116516786.0,2019-10-07,2019,0,280,10,0.85,294.02,291.85,288.49,4971
2019-10-08 13:30:00,291.04,291.85,288.49,288.53,285.04142857142864,302.76684210526315,284.19320000000033,292.57240000000013,293.5806,296.63600000000037,294.33413040841685,294.40275713901895,294.37153846153785,301.1436434457644,287.59943347731144,284.19320000000033,292.57240000000013,293.5806,296.63600000000037,289.62333333333333,101575470,74917531.95,39.49921714778152,1.5,2.75,3.686340502302735,1.3558304358957196,-1.025070904671507,-1.1117989047705803,-0.08672800009907347,19.087739827597375,-3.0542302264632863,9014941316.0,2019-10-08,2019,1,281,10,1.16,290.17,292.3,288.6559,4972
2019-10-09 13:30:00,290.75,292.3,288.6559,291.27,285.1152380952381,302.77736842105264,284.44605000000024,292.62670000000014,293.3916000000001,296.1870000000004,294.21396843161625,294.10439931625524,293.8323076923072,300.38653195010664,287.27808343450766,284.44605000000024,292.62670000000014,293.3916000000001,296.1870000000004,290.74196666666666,65707329,74761845.1,44.72367138953693,1.5,2.75,3.692316180709685,0.8788885415028368,-0.8959883965683717,-1.206713495809538,-0.3107250992411664,19.75628972512412,-1.9292929292929355,9080648645.0,2019-10-09,2019,2,282,10,1.26,290.48,294.21,291.0,4973
2019-10-10 13:30:00,291.18,294.21,291.0,293.24,285.18904761904764,302.78789473684213,284.74055000000027,292.7196000000001,293.3078000000001,295.7845000000003,294.1757735911607,294.02207557185,293.4499999999995,299.4985115778883,287.4014884221107,284.74055000000027,292.7196000000001,293.3078000000001,295.7845000000003,292.81666666666666,57255974,73979206.55,48.18793688426178,1.5,2.75,3.657865024944706,0.773946851691396,-0.6395591697959742,-1.1101740614861342,-0.47061489169016,20.404914432678147,-0.7312119160460285,9137904619.0,2019-10-10,2019,3,283,10,1.1,292.6,298.74,296.1448,4974
2019-10-11 13:30:00,296.27,298.74,296.1448,296.28,285.2628571428571,302.7984210526316,284.99105000000026,292.8173000000001,293.3366000000001,295.5440000000003,294.25829227386026,294.23711599357864,293.48153846153787,299.5842281392107,287.3788487838651,284.99105000000026,292.8173000000001,293.3366000000001,295.5440000000003,297.05493333333334,101228577,75935393.5,53.07520742420546,1.5,2.75,3.7894460945915127,1.3330881995100217,-0.24701134567180905,-0.7793790737799213,-0.5323677281081123,21.216433617449475,-0.16511102874280054,9239133196.0,2019-10-11,2019,4,284,10,0.88,297.44,296.67,295.57,4975
2019-10-14 13:30:00,295.93,296.67,295.57,295.95,285.33666666666664,302.80894736842106,285.23045000000025,292.9205000000001,293.4032,295.3335000000003,294.3246337533168,294.40024780371397,293.35307692307634,299.16529421278295,287.54085963336985,285.23045000000025,292.9205000000001,293.4032,295.3335000000003,296.06333333333333,40546668,75053168.15,52.49632622333816,1.5,2.75,3.5973428021206924,0.5402392597067203,-0.004227565621568674,-0.5376521851350731,-0.5334246195135044,21.043273608776293,0.9241576865366182,9198586528.0,2019-10-14,2019,0,287,10,0.37,296.12,299.7,296.97,4976
2019-10-15 13:30:00,297.1,299.7,296.97,298.88,285.4104761904762,302.8194736842105,285.48610000000025,293.0879000000001,293.7044,295.2315000000003,294.5032755669122,294.82689087002694,293.49769230769175,299.743085213239,287.2522994021445,285.48610000000025,293.0879000000001,293.7044,295.2315000000003,298.51666666666665,47832356,75299564.6,56.982548500154316,1.5,2.75,3.608246887683499,0.6352275242770793,0.34001510560612525,-0.1084057375058478,-0.44842084311197306,20.32274110113154,3.7561619107130433,9246418884.0,2019-10-15,2019,1,288,10,0.92,298.34,299.16,297.92,4977
2019-10-16 13:30:00,298.37,299.16,297.92,298.4,285.4842857142857,302.83,285.72850000000017,293.2441000000001,293.9164,295.09650000000033,294.6560882897784,295.16718697764344,293.728461538461,300.44211168015386,287.0148113967681,285.72850000000017,293.2441000000001,293.9164,295.09650000000033,298.49333333333334,50563596,74118139.85,56.04869786696922,1.5,2.75,3.439086395706107,0.6822027118102317,0.5114112777568475,0.1908432540840863,-0.3205680236727612,16.305473200995092,2.747744645685545,9195855288.0,2019-10-16,2019,2,289,10,0.42,298.54,300.24,298.515,4978
2019-10-17 13:30:00,299.68,300.24,298.515,299.28,285.55809523809523,302.8405263157895,285.9740000000002,293.43540000000013,294.14260000000013,295.0065000000003,294.8374181607675,295.55888345596316,293.92153846153786,301.1021013113711,286.7409756117048,285.9740000000002,293.43540000000013,294.14260000000013,295.0065000000003,299.345,46784885,72552423.35,57.426236262615355,1.5,2.75,3.324865938869958,0.6448424854715761,0.6511121553585311,0.4933221705254027,-0.15778998483312834,16.036388190662286,1.6748768472906232,9242640173.0,2019-10-17,2019,3,290,10,0.58,299.38,299.395,296.99,4979
2019-10-18 13:30:00,298.69,299.395,296.99,297.97,285.6319047619048,302.85105263157885,286.2428000000002,293.63240000000013,294.2296,294.9910000000003,294.96026450740396,295.78851360301417,294.2853846153841,301.7640953861652,286.80667384460287,286.2428000000002,293.63240000000013,294.2296,294.9910000000003,298.11833333333334,64338028,70896525.8,54.67882034786633,1.5,2.75,3.2591612289506737,0.9074919719126772,0.6223789854589074,0.6201837469905058,-0.002195238468401528,15.025120265849544,1.6684864200900926,9178302145.0,2019-10-18,2019,4,291,10,0.81,298.19,300.21,298.935,4980
2019-10-21 13:30:00,299.42,300.21,298.935,299.99,285.7057142857143,302.8615789473684,286.4808000000002,293.8420000000002,294.397,295.08000000000027,295.15750903652537,296.18865516463194,295.20307692307637,302.3200182912417,288.0861355549111,286.4808000000002,293.8420000000002,294.397,295.08000000000027,299.71166666666664,39460901,70492504.8,58.014455935958225,1.5,2.75,3.1863639983113368,0.5597886060646834,0.7006751508513379,0.8736487000957709,0.17297354924443298,14.873584385618,3.971857345856596,9217763046.0,2019-10-21,2019,0,294,10,0.43,299.57,300.9,298.91,4981
2019-10-22 13:30:00,300.58,300.9,298.91,299.01,285.7795238095237,302.8721052631579,286.70395000000025,294.07940000000013,294.6158000000001,295.2370000000003,295.30858711352437,296.45735467276216,295.86384615384554,302.67004486005897,289.0576474476321,286.70395000000025,294.07940000000013,294.6158000000001,295.2370000000003,299.6066666666666,49126038,68080428.3,55.86620050412267,1.5,2.75,3.1009094270033812,0.7215882629810072,0.648900843880073,0.9840996040945242,0.3351987602144513,10.446737487389736,2.657328252137196,9168637008.0,2019-10-22,2019,1,295,10,0.67,299.9,299.94,298.495,4982
2019-10-23 13:30:00,298.73,299.94,298.495,299.88,285.8533333333333,302.88263157894727,286.91950000000026,294.3325000000001,294.7624,295.3500000000003,295.4878582071117,296.78332089440386,296.2892307692302,303.35027214606976,289.2281893923906,286.91950000000026,294.3325000000001,294.7624,295.3500000000003,299.43833333333333,34991829,66158315.7,57.3752027339109,1.5,2.75,2.9826301822174246,0.5289105175934822,0.6348986812197739,1.1288221117391686,0.4939234305193948,9.75163219211814,2.2643568408129813,9203628837.0,2019-10-23,2019,2,296,10,0.48,299.22,301.07,299.4601,4983
2019-10-24 13:30:00,300.91,301.07,299.4601,300.37,285.9271428571428,302.8931578947368,287.13150000000024,294.5309000000001,295.0918000000001,295.5185000000003,295.6793147480093,297.12490938065116,296.84999999999945,303.96023098185776,289.73976901814115,287.13150000000024,294.5309000000001,295.0918000000001,295.5185000000003,300.3000333333333,35857459,65015070.8,58.2412225903547,1.5,2.75,2.8845780263447502,0.5515253395678837,0.619607608577718,1.2684329412415425,0.6488253326638243,9.454796896610533,1.380450924800875,9239486296.0,2019-10-24,2019,3,297,10,0.54,300.27,302.2,299.6806,4984
2019-10-25 13:30:00,299.74,302.2,299.6806,301.6,286.00095238095236,302.9036842105263,287.3451000000003,294.71730000000014,295.4308000000001,295.82850000000036,295.9114984833815,297.5511084872558,297.85538461538414,303.52594890903936,292.18482032172886,287.3451000000003,294.71730000000014,295.4308000000001,295.82850000000036,301.1602,45205412,63036285.9,60.41535501231432,1.5,2.75,2.858493881605837,0.7171331774164696,0.6501231155760208,1.46147922713385,0.8113561115578294,8.134430386368473,1.9091062679506792,9284691708.0,2019-10-25,2019,4,298,10,0.84,300.94,303.85,302.91,4985
2019-10-28 13:30:00,302.94,303.85,302.91,303.3,286.0747619047619,302.91421052631574,287.56670000000025,294.90230000000014,295.7198,296.15500000000037,296.20124364089594,298.09862196465997,298.7807692307687,303.7312592549298,293.8302792066077,287.56670000000025,294.90230000000014,295.7198,296.15500000000037,303.3533333333333,42146965,62515496.1,63.262297559513165,1.5,2.75,2.8150300329197058,0.6741842843665764,0.7362621658780755,1.7316838189054238,0.9954216530273484,8.17565224618019,1.4788543897216329,9326838673.0,2019-10-28,2019,0,301,10,0.31,303.38,304.23,302.86,4986
2019-10-29 13:30:00,303.0,304.23,302.86,303.21,286.14857142857136,302.92473684210523,287.7957500000003,295.05790000000013,295.9374,296.6535000000004,296.476096831449,298.5854198727877,299.5476923076918,303.87721993405734,295.21816468132636,287.7957500000003,295.05790000000013,295.9374,296.6535000000004,303.43333333333334,44284921,60234721.15,63.003953770915615,1.5,2.75,2.71181360199687,0.7352058771836781,0.7368377155208591,1.916468797428422,1.179631081907563,6.7722519224676025,1.6119302949061671,9282553752.0,2019-10-29,2019,1,302,10,0.45,303.54,304.55,301.99,4987
2019-10-30 13:30:00,303.43,304.55,301.99,304.14,286.22238095238095,302.93526315789467,288.0147000000003,295.20960000000014,296.2184,297.4575000000004,296.7766420537452,299.1144275039508,300.15230769230726,304.6784651989722,295.62615018564236,288.0147000000003,295.20960000000014,296.2184,297.4575000000004,303.56,49643928,56490718.85,64.61212635494407,1.5,2.75,2.700969773282808,0.8787979514266705,0.7471681642209398,2.1135912871837377,1.366423122962798,6.5302798830209365,1.6238973536487618,9332197680.0,2019-10-30,2019,2,303,10,0.85,303.27,304.13,301.73,4988
2019-10-31 13:30:00,304.13,304.13,301.73,303.33,286.2961904761905,302.9457894736842,288.2264500000003,295.3539000000001,296.436,298.1030000000004,297.03363648301007,299.51591059881264,300.71999999999963,304.8273517576992,296.61264824229994,288.2264500000003,295.3539000000001,296.436,298.1030000000004,303.06333333333333,69053791,55648068.45,62.08094975613717,1.5,2.75,2.68018621804832,1.2409018484090801,0.6503255730496011,2.1793300892747998,1.5290045162251982,6.9807560398643735,1.798838809276087,9263143889.0,2019-10-31,2019,3,304,10,0.8,302.93,306.19,304.74,4989
2019-11-01 13:30:00,304.92,306.19,304.74,306.14,286.37,302.9563157894736,288.44235000000026,295.53140000000013,296.7116,298.6925000000004,297.390748777794,300.1467762560685,301.2784615384611,306.13850171653183,296.41842136039037,288.44235000000026,295.53140000000013,296.7116,298.6925000000004,305.69,71141515,55870110.15,66.92213662310763,1.5,2.75,2.693030059616297,1.2733376542304884,0.7209233649193281,2.4301587223743577,1.70923535745503,7.254744190360425,2.0500683356111797,9334285404.0,2019-11-01,2019,4,305,11,0.48,305.47,308.0,306.96,4990
2019-11-04 14:30:00,307.85,308.0,306.96,307.37,286.44380952380953,302.9668421052632,288.6469000000003,295.7093000000001,297.16200000000003,299.4070000000004,297.78209196297854,300.8347023269191,301.9684615384611,307.4987131457721,296.43820993115014,288.6469000000003,295.7093000000001,297.16200000000003,299.4070000000004,307.4433333333333,60606916,55867627.9,68.79987141894635,1.5,2.75,2.6335279125008486,1.084830666311501,0.7902936531044464,2.697102423835588,1.9068087707311416,6.854662155063683,2.7958931139426824,9394892320.0,2019-11-04,2019,0,308,11,0.34,307.48,307.9195,306.71,4991
2019-11-05 14:30:00,307.59,307.9195,306.71,307.03,286.517619047619,302.97736842105263,288.8677500000003,295.88700000000006,297.5426,300.3320000000004,298.1447550232539,301.4247306767363,302.56461538461497,308.46554420529975,296.6636865639302,288.8677500000003,295.88700000000006,297.5426,300.3320000000004,307.2198333333333,43033885,52940548.65,67.65655827774212,1.5,2.75,2.5318116330365057,0.8128719119347473,0.753263089335932,2.8483876324010566,2.0951245430651246,6.285918574981233,2.384287048152587,9351858435.0,2019-11-05,2019,1,309,11,0.39,307.31,307.4,306.06,4992
2019-11-06 14:30:00,307.03,307.4,306.06,307.1,286.5914285714285,302.98789473684207,289.08620000000025,296.06430000000006,297.9471999999999,301.12350000000043,298.49594110077334,301.9652325170471,303.2669230769227,308.98370745878975,297.55013869505564,289.08620000000025,296.06430000000006,297.9471999999999,301.12350000000043,306.8533333333333,46487108,51979537.6,67.77529098747513,1.5,2.75,2.4466822306767533,0.8943347737668216,0.675932139448026,2.9400397173751567,2.2641075779271307,6.431355371431838,2.2405699637114287,9398345543.0,2019-11-06,2019,2,310,11,0.44,306.73,309.65,307.66,4993
2019-11-07 14:30:00,308.57,309.65,307.66,308.18,286.66523809523807,302.9984210526316,289.30935000000017,296.22210000000007,298.333,301.87050000000045,298.87570811642934,302.5571151344712,303.8969230769227,309.8313254361392,297.9625207177062,289.30935000000017,296.22210000000007,298.333,301.87050000000045,308.49666666666667,54272274,51830352.6,69.62784208434515,1.5,2.75,2.4540620713426966,1.0471137331216998,0.6403107588481731,3.0644960264873475,2.4241852676391744,6.441858335590693,2.18169761273209,9452617817.0,2019-11-07,2019,3,311,11,0.65,308.65,309.0036,307.03,4994
2019-11-08 14:30:00,307.8,309.0036,307.03,308.94,286.7390476190476,303.00894736842105,289.52515000000017,296.38090000000005,298.6602000000001,302.50350000000043,299.2703862295105,303.1650089311882,304.66076923076884,310.4366152842349,298.8849231773028,289.52515000000017,296.38090000000005,298.6602000000001,302.50350000000043,308.32453333333336,49068797,49222363.6,70.89581829183194,1.5,2.75,2.419743351961078,0.9968801457555362,0.6108184096994251,3.187708279763456,2.5768898700640306,6.368854977162907,1.8595450049455942,9501686614.0,2019-11-08,2019,4,312,11,0.64,308.02,308.54,307.27,4995
2019-11-11 14:30:00,307.42,308.54,307.27,308.35,286.8128571428571,303.01947368421054,289.74810000000025,296.5058,298.9782,303.1235000000005,299.62644951462767,303.6588176044084,305.31230769230734,310.68051698462614,299.9440983999885,289.74810000000025,296.5058,298.9782,303.1235000000005,308.05333333333334,35934909,48991775.65,68.50481775715608,1.5,2.75,2.366190255392431,0.7334886013669113,0.4991676315358564,3.200849409483851,2.7016817779479947,6.4432430442267385,1.6951947495135529,9465751705.0,2019-11-11,2019,0,315,11,0.41,307.9,309.99,308.15,4996
2019-11-12 14:30:00,308.75,309.99,308.15,309.0,286.88666666666666,303.03,289.9760500000002,296.6558,299.3434,303.6295000000005,299.9940397297404,304.16750164208383,305.97615384615347,310.8468229738674,301.10548471843947,289.9760500000002,296.6558,299.3434,303.6295000000005,309.0466666666667,46484624,48924389.05,69.71656010854177,1.5,2.75,2.3286052371501174,0.9501319260725648,0.4198706591550163,3.226520101891765,2.8066494427367488,6.324151099438224,1.5979483132767849,9512236329.0,2019-11-12,2019,1,316,11,0.6,309.07,309.54,307.66,4997
2019-11-13 14:30:00,307.91,309.54,307.66,309.1,286.9604761904762,303.04052631578946,290.18365000000017,296.8104,299.6446,304.1645000000005,300.351136210927,304.63726339045684,306.55307692307656,310.96919693689125,302.13695690926187,290.18365000000017,296.8104,299.6446,304.1645000000005,308.76666666666665,54459018,49119160.15,69.90837535495507,1.5,2.75,2.2965620059251086,1.1087123198705586,0.3289526185026093,3.21784021586501,2.8888875973624013,6.3338794124173585,1.9022187057000757,9566695347.0,2019-11-13,2019,2,317,11,0.61,308.6,309.64,308.09,4998
2019-11-14 14:30:00,308.79,309.64,308.09,309.55,287.0342857142857,303.05105263157884,290.3817500000003,296.9983000000001,299.8792,304.6780000000005,300.7118759673612,305.1051430675561,307.03384615384584,311.28648724065874,302.78120506703283,290.3817500000003,296.9983000000001,299.8792,304.6780000000005,309.0933333333333,52001874,49380009.6,70.80454526952707,1.5,2.75,2.2432361483590304,1.0530956640397249,0.2571032240993967,3.2102666274866465,2.95316340338725,5.7277809282728676,1.1138694714836432,9618697221.0,2019-11-14,2019,3,318,11,0.5,308.86,311.84,310.26,4999
2019-11-15 14:30:00,311.02,311.84,310.26,311.79,287.1080952380952,303.0615789473684,290.5904000000002,297.2115,300.154,305.3690000000005,301.14631220393534,305.74179610874126,307.69384615384575,312.03018660645216,303.35750570123935,290.5904000000002,297.2115,300.154,305.3690000000005,311.2966666666666,62706192,49298417.8,74.82387629902081,1.5,2.75,2.2465764234762404,1.2719716939881185,0.31461977970342403,3.34643812801653,3.0318183483131063,4.85582943441852,1.438006311611418,9681403413.0,2019-11-15,2019,4,319,11,0.51,311.05,312.28,311.03,5000
2019-11-18 14:30:00,311.53,312.28,311.03,312.02,287.18190476190466,303.0721052631579,290.79070000000024,297.4167,300.4304,305.97050000000047,301.57273133319273,306.3397202888612,308.29999999999967,312.6825458003913,303.917454199608,290.79070000000024,297.4167,300.4304,305.97050000000047,311.77666666666664,49327980,49791771.75,75.20138799102325,1.5,2.75,2.1753923932279373,0.990685373633044,0.3212147072582328,3.4333367323858965,3.112122025127664,4.678329070877645,1.625248347067065,9730731393.0,2019-11-18,2019,0,322,11,0.4,311.65,312.69,311.22,5001
2019-11-19 14:30:00,312.68,312.69,311.22,311.93,287.25571428571425,303.0826315789473,290.98485000000016,297.606,300.7064000000001,306.6165000000005,301.97889873189104,306.8721278803982,308.9615384615381,312.69119380676966,305.23188311630656,290.98485000000016,297.606,300.7064000000001,306.6165000000005,311.94666666666666,67927818,50731860.75,74.72918239391234,1.5,2.75,2.1250072222830823,1.3389577475728602,0.2743934621531232,3.455113852819068,3.1807203906659445,4.533064386167234,1.5727775968739772,9662803575.0,2019-11-19,2019,1,323,11,0.47,311.96,311.85,309.06,5002
2019-11-20 14:30:00,311.28,311.85,309.06,310.77,287.32952380952383,303.0931578947368,291.17500000000024,297.7571000000001,300.9168,307.16100000000057,302.3236478012286,307.24335379655065,309.31769230769186,312.7759724836294,305.85941213175437,291.17500000000024,297.7571000000001,300.9168,307.16100000000057,310.56,79696276,52967083.1,68.73812958521768,1.5,2.75,2.1782209921200053,1.5046378115543235,0.1276361434155735,3.340265569935412,3.212629426519838,5.440174262131611,0.8404179375689451,9583107299.0,2019-11-20,2019,2,324,11,0.9,310.46,311.01,309.39,5003
2019-11-21 14:30:00,310.89,311.01,309.39,310.27,287.4033333333333,303.1036842105263,291.3756500000002,297.8955,301.0964,307.6560000000005,302.63526945608237,307.5316058159268,309.5407692307689,312.83811045842964,306.2434280031082,291.3756500000002,297.8955,301.0964,307.6560000000005,310.2233333333333,54664690,53907444.65,66.27186970081826,1.5,2.75,2.1383480641114336,1.0140471386636205,-0.03223715950737027,3.172332977135625,3.204570136642995,5.433892563323297,0.4305043050430453,9528442609.0,2019-11-21,2019,3,325,11,0.52,310.2,311.24,309.85,5004
2019-11-22 14:30:00,311.09,311.24,309.85,310.96,287.47714285714284,303.1142105263158,291.5781000000002,298.0171,301.2938000000001,308.1240000000005,302.9617294774125,307.8581195477433,309.84307692307664,312.87407964739447,306.8120741987587,291.5781000000002,298.0171,301.2938000000001,308.1240000000005,310.68333333333334,44850228,53889685.45,67.97927288729268,1.5,2.75,2.084894630960616,0.8322599700755907,-0.11593398955120282,3.059652649703992,3.1755866392551946,5.406579373675354,0.8464407329333409,9573292837.0,2019-11-22,2019,4,326,11,0.45,310.54,313.37,311.98,5005
2019-11-25 14:30:00,311.98,313.37,311.98,313.37,287.55095238095237,303.12473684210516,291.7918500000002,298.1662,301.55800000000005,308.6275000000005,303.3698969488865,308.3830605431963,310.32538461538434,313.4508789431523,307.19989028761626,291.7918500000002,298.1662,301.55800000000005,308.6275000000005,312.9066666666667,48762676,54220471.0,73.10116005130118,1.5,2.75,2.1081164430348602,0.8993406936653132,-0.03746673726491912,3.1287532176740456,3.1662199549389647,6.456304274046923,1.4142394822006488,9622055513.0,2019-11-25,2019,0,329,11,0.45,312.68,314.28,313.06,5006
2019-11-26 14:30:00,313.41,314.28,313.06,314.08,287.6247619047618,303.13526315789466,291.9917500000002,298.33880000000005,301.8212000000001,309.1710000000005,303.7899009901066,308.92562620574904,310.7792307692305,314.2239633058106,307.3344982326504,291.9917500000002,298.33880000000005,301.8212000000001,309.1710000000005,313.8066666666666,37727953,53892622.6,74.40031066176928,1.5,2.75,2.0446795542466534,0.7000578405698148,0.03012380294263917,3.2038747086172634,3.1737509056746243,6.461298909304363,1.6111290844386803,9659783466.0,2019-11-26,2019,1,330,11,0.39,313.67,315.48,314.37,5007
2019-11-27 14:30:00,314.61,315.48,314.37,315.48,287.69857142857137,303.1457894736842,292.19420000000025,298.52170000000007,302.1088000000001,309.7380000000005,304.24833624539656,309.54985228139196,311.28230769230737,315.35810608578566,307.20650929882913,292.19420000000025,298.52170000000007,302.1088000000001,309.7380000000005,315.11,44793179,53650085.15,76.78160220086207,1.5,2.75,1.9986310146576087,0.8349134745035908,0.1313193527242782,3.337900096579972,3.2065807438556937,6.587891304569032,1.9156840575028289,9704576645.0,2019-11-27,2019,2,331,11,0.35,314.92,315.13,314.06,5008
2019-11-29 14:30:00,314.86,315.13,314.06,314.31,287.77238095238084,303.15631578947364,292.3938500000002,298.67870000000005,302.3734,310.2870000000005,304.6429112945967,310.00319968316415,311.74076923076893,315.734051755889,307.7474867056488,292.3938500000002,298.67870000000005,302.3734,310.2870000000005,314.5,36592740,52027032.6,70.8501484573333,1.5,2.75,1.9573002278963525,0.7033409012836915,0.0839623341530471,3.311533661547003,3.227571327393956,7.3757781179038915,0.8082363129029095,9667983905.0,2019-11-29,2019,4,333,11,0.34,314.6,314.66,311.17,5009
2019-12-02 14:30:00,314.59,314.66,311.17,311.64,287.84619047619043,303.1668421052632,292.5652000000003,298.802,302.64059999999995,310.5620000000005,304.9173069301027,310.1590854276247,311.9438461538458,315.61442387789845,308.2732684297932,292.5652000000003,298.802,302.64059999999995,310.5620000000005,312.49,76110027,52275458.2,59.54536993400278,1.5,2.75,2.066778783046614,1.4559418438536038,-0.14993988602282915,3.0401464698654195,3.1900863558882486,8.395380311267568,-0.12178706493173368,9591873878.0,2019-12-02,2019,0,336,12,1.12,312.92,309.64,307.13,5010
2019-12-03 14:30:00,308.65,309.64,307.13,309.55,307.13,303.1773684210526,292.7237000000003,298.89099999999996,302.8674,310.67100000000056,305.09898116813787,310.10107729166043,311.97846153846126,315.5482134897654,308.40870958715715,292.7237000000003,298.89099999999996,302.8674,310.67100000000056,308.7733333333333,75172709,53003747.85,52.48573440264187,1.5,2.75,2.2412945842575693,1.418252709463827,-0.4511474953525587,2.6261519866975505,3.0772994820501087,9.193153726214721,-0.7629916968550622,9516701169.0,2019-12-03,2019,1,337,12,0.82,308.38,312.12,310.32,5011
2019-12-04 14:30:00,310.7,312.12,310.32,311.46,307.6611904761905,303.18789473684205,292.88895000000025,298.9981,303.17919999999987,310.8925000000005,305.34843288703445,310.2304985019785,312.12538461538435,315.43066817479763,308.82010105597095,292.88895000000025,298.9981,303.17919999999987,310.8925000000005,311.3,49190402,53311573.7,57.45051800972578,1.5,2.75,2.2647735425248854,0.9226964913249222,-0.5224521064084238,2.42423434903958,2.9466864554480034,10.02582870725432,0.222029153393184,9565891571.0,2019-12-04,2019,2,338,12,0.58,311.22,312.25,310.58,5012
2019-12-05 14:30:00,312.23,312.25,310.58,312.02,308.192380952381,303.19842105263155,293.0619500000002,299.1212000000001,303.46719999999993,311.1385000000006,305.6100629698958,310.40092721607584,312.14307692307665,315.44344878661263,308.8427050595405,293.0619500000002,299.1212000000001,303.46719999999993,311.1385000000006,311.6166666666666,40781669,53026301.75,58.80949699753356,1.5,2.75,2.2222897180588235,0.7690837877450127,-0.5308831386927984,2.2830825320820054,2.813965670774804,9.804252388647065,0.5640248815547749,9606673240.0,2019-12-05,2019,3,339,12,0.54,311.41,315.31,314.11,5013
2019-12-06 14:30:00,314.12,315.31,314.11,314.87,308.72357142857135,303.20894736842104,293.24060000000026,299.2925,303.8246,311.47300000000047,305.9731977553901,310.8265531954971,312.3623076923073,315.96558102332335,308.7590343612914,293.24060000000026,299.2925,303.8246,311.47300000000047,314.7633333333334,48956767,52760526.4,64.9457187728971,1.5,2.75,2.29855473819748,0.9279052037661248,-0.3521118210206717,2.373825894498964,2.725937715519636,10.864435145964977,1.2573964497041499,9655630007.0,2019-12-06,2019,4,340,12,0.38,314.71,315.18,313.8,5014
2019-12-09 14:30:00,314.44,315.18,313.8,313.88,309.2547619047619,303.2194736842105,293.4124000000002,299.443,304.1942,311.7200000000006,306.28326843164933,311.11735765306884,312.51230769230733,316.1926350510024,308.83198033361236,293.4124000000002,299.443,304.1942,311.7200000000006,314.2866666666667,34904315,52052302.3,61.51743181445593,1.5,2.75,2.2329436854690887,0.6705623662682832,-0.309634479980867,2.338894615543552,2.648529095524419,11.161159235262561,0.1627469125953317,9620725692.0,2019-12-09,2019,0,343,12,0.44,314.49,314.55,312.81,5015
2019-12-10 14:30:00,313.82,314.55,312.81,313.53,309.7859523809524,303.23,293.58345000000025,299.6066,304.5293999999999,311.9790000000005,306.56745398334937,311.3471331146813,312.72461538461505,316.29520995162284,309.1540208176072,293.58345000000025,299.6066,304.5293999999999,311.9790000000005,313.63,53109165,52911015.1,60.3054373302171,1.5,2.75,2.1977334222212974,1.0037449650063508,-0.31326127099302603,2.2569525067831364,2.5702137777761624,10.317442909642445,-0.17511462047886253,9567616527.0,2019-12-10,2019,1,344,12,0.56,313.68,314.7,313.4393,5016
2019-12-11 14:30:00,314.03,314.7,313.4393,314.42,310.31714285714287,303.24052631578945,293.7595500000002,299.7718,304.953,312.25000000000057,306.8753969643945,311.6397871037592,313.04384615384583,316.4160906787825,309.6716016289092,293.7595500000002,299.7718,304.953,312.25000000000057,314.1864333333333,53521450,53262856.4,62.3374162710134,1.5,2.75,2.130802463491204,1.0048550456636796,-0.26574722747534585,2.23802974343198,2.503776970907326,10.367245392407057,-0.33599594269050403,9621137977.0,2019-12-11,2019,2,345,12,0.4,314.07,317.99,314.17,5017
2019-12-12 14:30:00,314.43,317.99,314.17,317.13,310.84833333333336,303.2510526315789,293.9518000000002,299.9428,305.53439999999995,312.6515000000005,307.27753825990845,312.1626645224488,313.51846153846117,317.2963310736196,309.7405920033028,293.9518000000002,299.9428,305.53439999999995,312.6515000000005,316.43,96585802,55369195.6,67.75082434693229,1.5,2.75,2.251459430384689,1.7443959760181165,-0.0719160244766508,2.4138819403115117,2.485797964788163,11.233543982434602,0.8972033979192495,9717723779.0,2019-12-12,2019,3,346,12,1.22,316.08,318.67,316.02,5018
2019-12-13 14:30:00,316.87,318.67,316.02,317.32,311.3795238095238,303.2615789473684,294.1363000000003,300.1016,306.0724,313.0400000000005,307.6713602889316,312.6538393298347,313.82230769230733,318.10516909269995,309.53944629191466,294.1363000000003,300.1016,306.0724,313.0400000000005,317.33666666666664,81546487,56846426.25,68.09705098572469,1.5,2.75,2.2799266139286423,1.4345050758577809,0.04280638584459595,2.5393059470939083,2.496499561249312,10.90697772006407,1.822615838788348,9799270266.0,2019-12-13,2019,4,347,12,0.84,317.35,320.15,319.17,5019
2019-12-16 14:30:00,319.22,320.15,319.17,319.5,311.9107142857143,303.27210526315787,294.3368000000002,300.2966,306.57539999999995,313.4255000000005,308.13522851289514,313.30585463175515,314.2392307692304,319.48765887990874,308.99080265855207,294.3368000000002,300.2966,306.57539999999995,313.4255000000005,319.6066666666666,82836128,57852923.05,71.83352477632178,1.5,2.75,2.319217570076596,1.4318399768393382,0.2288305857737756,2.782537793466531,2.553707207692756,9.496144599576613,3.214343401712159,9882106394.0,2019-12-16,2019,0,350,12,0.31,319.66,320.25,319.48,5020
2019-12-17 14:30:00,319.92,320.25,319.48,319.57,312.4419047619048,303.2826315789473,294.53955000000025,300.4722,307.1051999999999,313.8030000000005,308.58365092415414,313.9024399049214,314.55384615384577,320.50532451424806,308.6023677934435,294.53955000000025,300.4722,307.1051999999999,313.8030000000005,319.76666666666665,61131769,58443112.5,71.94713946762369,1.5,2.75,2.20855917221398,1.0460046767700812,0.31461684828532066,2.9469782680494063,2.6323614197640857,7.698767911444702,2.603865664932901,9943238163.0,2019-12-17,2019,1,351,12,0.24,319.86,320.25,319.53,5021
2019-12-18 14:30:00,320.0,320.25,319.53,319.59,312.97309523809525,303.29315789473685,294.7508500000002,300.6535,307.7263999999999,314.1860000000005,309.0152724565402,314.4441122949289,314.95999999999964,321.48272241414935,308.43727758584976,294.7508500000002,300.6535,307.7263999999999,314.1860000000005,319.79,48199955,57456719.35,71.98191366370321,1.5,2.75,2.102233517055841,0.8388915264442435,0.3291708972905853,3.0438250413773176,2.714654144086732,7.6333378686986615,2.4261265303506163,9991438118.0,2019-12-18,2019,2,352,12,0.23,319.89,320.98,319.5246,5022
2019-12-19 14:30:00,319.8,320.98,319.5246,320.9,313.5042857142857,303.30368421052634,294.98030000000017,300.8553,308.3189999999999,314.6925000000004,309.48134020334254,315.05895874303087,315.67230769230724,322.59916580501346,308.7454495796011,294.98030000000017,300.8553,308.3189999999999,314.6925000000004,320.4682,85388424,57741326.75,74.23480079353315,1.5,2.75,2.056031122980424,1.478809525276452,0.3798895668345872,3.189516102629966,2.8096265357953785,7.660931411925879,1.915076063137159,10076826542.0,2019-12-19,2019,3,353,12,0.46,320.25,321.9742,319.3873,5023
2019-12-20 14:30:00,320.46,321.9742,319.3873,320.73,314.0354761904762,303.31421052631566,295.21165000000025,301.0883,308.8687999999999,315.21550000000036,309.92246411693696,315.59905791036124,316.5323076923072,322.963535132724,310.10108025189044,295.21165000000025,301.0883,308.8687999999999,315.21550000000036,320.69716666666665,149338215,62475003.0,73.40986959922245,1.5,2.75,2.093950328481823,2.3903674722512616,0.3553007758242832,3.2537525055757333,2.8984517297514496,6.704365846105193,2.1823626863769667,9927488327.0,2019-12-20,2019,4,354,12,0.81,320.68,321.65,321.06,5024
2019-12-23 14:30:00,321.59,321.65,321.06,321.22,314.56666666666666,303.32473684210515,295.4255500000002,301.3521,309.36759999999987,315.7285000000004,310.3655047398022,316.1343857284221,317.2830769230765,323.4435183888253,311.1226354573276,295.4255500000002,301.3521,309.36759999999987,315.7285000000004,321.31,53015641,62883273.65,74.2964835557236,1.5,2.75,2.0100967335902613,0.8430801693798269,0.3261095683238695,3.3060886901562867,2.979979121832417,5.923472847735523,2.452715848563153,9980503968.0,2019-12-23,2019,0,357,12,0.18,321.36,321.52,320.9,5025
2019-12-24 14:30:00,321.47,321.52,320.9,321.23,315.09785714285715,303.33526315789464,295.6342500000003,301.6382000000001,309.8731999999998,316.12150000000037,310.791563377457,316.61968232571525,317.991538461538,323.66724022715687,312.315836695919,295.6342500000003,301.6382000000001,309.8731999999998,316.12150000000037,321.21666666666664,20270007,61458640.2,74.31530604657925,1.5,2.75,1.9108041097623856,0.3298154162545236,0.2641881583605801,3.3102143197831424,3.0460261614225623,5.714047468835315,2.16589275491381,10000773975.0,2019-12-24,2019,1,358,12,0.19,321.21,322.95,321.64,5026
2019-12-26 14:30:00,321.65,322.95,321.64,322.94,315.62904761904764,303.3457894736842,295.84225000000026,302.0294,310.3543999999999,316.5645000000004,311.26797265677243,317.2216173423138,318.6123076923072,324.54598811117836,312.67862727343595,295.84225000000026,302.0294,310.3543999999999,316.5645000000004,322.51,31024188,61123451.95,77.3674117394576,1.5,2.75,1.897175244779356,0.5075660325169183,0.2928860044508821,3.412133666986165,3.1192476625352827,5.94975576784471,1.8320562545328425,10031798163.0,2019-12-26,2019,3,360,12,0.41,322.29,323.8,322.28,5027
2019-12-27 14:30:00,323.74,323.8,322.28,322.86,316.16023809523807,303.3563157894736,296.0507500000003,302.38000000000005,310.84359999999987,316.9335000000004,311.72256196435,317.7586061668553,319.3030769230764,324.95647282350086,313.64968102265186,296.0507500000003,302.38000000000005,310.84359999999987,316.9335000000004,322.98,42554820,61011534.0,76.90697553398856,1.5,2.75,1.870234155866548,0.6974881175746213,0.2619766914533361,3.4467185268519533,3.1847418353986168,4.788221233362688,1.7458716752804804,9989243343.0,2019-12-27,2019,4,361,12,0.47,323.04,323.1,320.55,5028
2019-12-30 14:30:00,322.95,323.1,320.55,321.08,316.69142857142856,303.3668421052631,296.24960000000027,302.7111000000001,311.2795999999999,317.2720000000004,312.0895203186892,318.07492938905955,319.88384615384564,324.50210782120337,315.2655844864879,296.24960000000027,302.7111000000001,311.2795999999999,317.2720000000004,321.57666666666665,49782730,61671033.5,67.30862095661502,1.5,2.75,1.918788859018938,0.8072303506961659,0.08623995682231245,3.2925417814265074,3.2063018246041946,6.3711420275968935,0.4945226917057853,9939460613.0,2019-12-30,2019,0,364,12,0.8,321.83,322.13,320.15,5029
2019-12-31 14:30:00,320.53,322.13,320.15,321.86,317.22261904761905,303.3773684210526,296.4472500000003,302.9935000000001,311.7573999999999,317.7830000000003,312.47267638462296,318.43541230438717,320.4561538461533,323.92516867824946,316.9871390140572,296.4472500000003,302.9935000000001,311.7573999999999,317.7830000000003,321.37999999999994,57106998,60720882.05,69.12693972488779,1.5,2.75,1.9231610833747297,0.9404836700655274,-0.007882728827484087,3.1964484135698394,3.204331142397324,5.358979459947498,0.7165879150108022,9996567611.0,2019-12-31,2019,1,365,12,0.62,321.14,324.89,322.53,5030
2020-01-02 14:30:00,323.54,324.89,322.53,324.87,317.75380952380954,303.3878947368421,296.6596000000003,303.32600000000014,312.25499999999994,318.5490000000003,312.9588459381672,319.0482301801598,321.05153846153786,324.6856151818877,317.4174617411882,296.6596000000003,303.32600000000014,312.25499999999994,318.5490000000003,324.09666666666664,59253833,59924938.25,74.92339073381692,1.5,2.75,2.0022210059908185,0.9888009021018892,0.09641411365629304,3.32484878446769,3.2284346708113967,7.2407624379555715,1.652116774617488,10055821444.0,2020-01-02,2020,3,2,1,0.73,323.71,323.64,321.1,5031
2020-01-03 14:30:00,321.16,323.64,321.1,322.41,318.285,303.3984210526316,296.8639000000003,303.66940000000005,312.7229999999999,319.09650000000033,313.32947943078807,319.3683987344304,321.4430769230764,324.42245615231946,318.4636976938333,296.8639000000003,303.66940000000005,312.7229999999999,319.09650000000033,322.3833333333334,77783566,61354596.45,64.29824484669976,1.5,2.75,2.12849093413433,1.2677708028507455,-0.02969330882647325,3.191318034778305,3.2210113436047787,8.976306507564425,0.4705515736989866,9978037878.0,2020-01-03,2020,4,3,1,0.79,322.37,323.73,320.36,5032
2020-01-06 14:30:00,320.49,323.73,320.36,323.64,318.8161904761905,303.40894736842097,297.0584500000003,303.98030000000006,313.19819999999993,319.6775000000004,313.7338135707572,319.7752179025798,321.76153846153795,324.7270722300799,318.796004692996,297.0584500000003,303.98030000000006,313.19819999999993,319.6775000000004,322.57666666666665,55761948,62103610.4,66.83106142401883,1.5,2.75,2.2171701531247354,0.8978857692949845,-0.058048044904381424,3.1484512874743023,3.2064993323786832,8.940754440605412,0.9073052099897009,10033799826.0,2020-01-06,2020,0,6,1,1.05,322.04,323.54,322.24,5033
2020-01-07 14:30:00,323.02,323.54,322.24,322.73,319.34738095238095,303.4194736842105,297.27585000000033,304.3686,313.6453999999999,320.0705000000003,314.0866051954333,320.05662572138175,322.00461538461485,324.71917573017134,319.29005503905836,297.27585000000033,304.3686,313.6453999999999,320.0705000000003,322.83666666666664,42854811,61798512.6,63.255584261161864,1.5,2.75,2.1588008564729666,0.6934602338632985,-0.16008438614228426,3.006393849700828,3.1664782358431123,9.162775322573472,0.4700828092895806,9990945015.0,2020-01-07,2020,1,7,1,0.4,322.89,325.78,322.67,5034
2020-01-08 14:30:00,322.94,325.78,322.67,324.45,319.87857142857143,303.42999999999995,297.5029000000003,304.7666000000001,314.10239999999993,320.59900000000033,314.4930128348281,320.47504231934533,322.37846153846107,324.9968209326465,319.7601021442756,297.5029000000003,304.7666000000001,314.10239999999993,320.59900000000033,324.3,68434153,63475004.5,66.86408167804878,1.5,2.75,2.2267436524391804,1.0781275801248664,-0.13474869589163951,2.998042365978563,3.1327910618702024,9.548558382792317,1.0023970363913617,10059379168.0,2020-01-08,2020,2,8,1,0.96,324.23,326.73,325.52,5035
2020-01-09 14:30:00,326.16,326.73,325.52,326.65,320.40976190476187,303.44052631578944,297.7305500000003,305.14460000000014,314.56939999999986,321.2550000000003,314.96975742954066,321.0631335270268,322.82076923076875,326.13963336951684,319.5019050920207,297.7305500000003,305.14460000000014,314.56939999999986,321.2550000000003,326.3,48569601,63248026.3,70.81240157379695,1.5,2.75,2.2305476772649557,0.7679227928729849,3.277550880920188e-05,3.1328320312562137,3.1327992557474045,10.06374103682664,1.1488202142812842,10107948769.0,2020-01-09,2020,3,9,1,0.37,326.12,327.46,325.2,5036
2020-01-10 14:30:00,327.2899,327.46,325.2,325.71,320.94095238095235,303.4510526315789,297.96085000000016,305.4784,315.0193999999999,321.8195000000003,315.390943412696,321.5056922387385,323.2038461538457,326.6172544524568,319.7904378552345,297.96085000000016,305.4784,315.0193999999999,321.8195000000003,326.12333333333333,53057389,63224823.25,67.13169826752011,1.5,2.75,2.2326514146031724,0.8391860391638185,-0.004040264319261411,3.127748925348328,3.1317891896675896,10.078576823511767,0.8827355510128123,10054891380.0,2020-01-10,2020,4,10,1,0.69,326.33,327.96,325.92,5037
2020-01-13 14:30:00,326.39,327.96,325.92,327.95,321.47214285714284,303.46157894736837,298.1970500000002,305.857,315.4956,322.3605000000003,315.8834554357275,322.11943583504916,323.721538461538,327.7587945453779,319.68428237769814,298.1970500000002,305.857,315.4956,322.3605000000003,327.27666666666664,47262010,60758633.65,71.00003136844556,1.5,2.75,2.2338905992743743,0.7778649248805153,0.10801827327154268,3.2668120312570177,3.1587937579854755,10.603411397696359,2.1396536688675734,10102153390.0,2020-01-13,2020,0,13,1,0.63,326.94,328.62,326.844,5038
2020-01-14 14:30:00,327.47,328.62,326.844,327.45,322.00333333333333,303.4721052631578,298.42190000000016,306.20700000000005,315.97799999999995,322.8670000000003,316.3370454186402,322.62710861266345,324.1999999999995,328.413195388856,319.986804611143,298.42190000000016,306.20700000000005,315.97799999999995,322.8670000000003,327.638,63036384,59833128.5,69.04661133496768,1.5,2.75,2.2011841278976343,1.0535364868978896,0.11188494568243844,3.298649940088524,3.186764994406085,9.847372123439172,1.7367799664450303,10039117006.0,2020-01-14,2020,1,14,1,0.54,327.73,329.02,327.26,5039
2020-01-15 14:30:00,327.35,329.02,327.26,328.19,322.5345238095238,303.4826315789473,298.6337000000002,306.5653000000001,316.41900000000004,323.30150000000026,316.80186716692884,323.1569077924098,324.6038461538456,329.2415879018089,319.9661044058824,298.6337000000002,306.5653000000001,316.41900000000004,323.30150000000026,328.1566666666667,72056598,59294152.0,70.34693964267122,1.5,2.75,2.1696709759049453,1.2152395399802665,0.12661525037682786,3.3450340573771205,3.218418807000292,9.844954933820565,1.0219472404346333,10111173604.0,2020-01-15,2020,2,15,1,0.54,328.14,330.92,329.45,5040
2020-01-16 14:30:00,329.7,330.92,329.45,330.92,323.0657142857143,303.49315789473684,298.8584500000002,307.026,316.89,323.86900000000026,317.3555194348924,323.8962499074184,325.22384615384567,330.81941329202044,319.6282790156709,298.8584500000002,307.026,316.89,323.86900000000026,330.43,54050328,58940079.95,74.58820771820855,1.5,2.75,2.209694477626022,0.9170385931924748,0.2740910516402195,3.5610326215505665,3.286941569910347,9.57929699164147,2.6394962935392794,10165223932.0,2020-01-16,2020,3,16,1,0.45,330.18,332.18,330.8539,5041
2020-01-17 14:30:00,331.7,332.18,330.8539,331.95,323.59690476190474,303.50368421052633,299.0861000000002,307.4655,317.3884,324.48700000000025,317.92785200607307,324.6632737257595,326.0599999999995,332.155127940871,319.964872059128,299.0861000000002,307.4655,317.3884,324.48700000000025,331.6613,95846017,61322383.05,75.98389474388378,1.5,2.75,2.1465805863670204,1.5629858500745268,0.3879234958112816,3.771845939674449,3.383922443863168,7.455843076466907,2.5676677790137203,10261069949.0,2020-01-17,2020,4,17,1,0.4,331.52,332.18,330.82,5042
2020-01-21 14:30:00,330.9,332.18,330.82,331.3,324.12809523809517,303.5142105263157,299.3067000000002,307.9098,317.8724,325.0070000000003,318.4522499666192,325.2953428947348,326.7861538461533,332.95560981751265,320.61669787479406,299.3067000000002,307.9098,317.8724,325.0070000000003,331.43333333333334,77742415,60940082.6,73.2497608965148,1.5,2.75,2.0903962587693767,1.2757188976964071,0.3666038193849226,3.8421772180943217,3.4755733987093977,7.922334384542393,2.655470517150557,10183327534.0,2020-01-21,2020,1,21,1,0.41,331.5,332.95,331.17,5043
2020-01-22 14:30:00,332.24,332.95,331.17,331.34,324.6592857142857,303.5247368421052,299.5205500000002,308.3343000000001,318.33559999999994,325.53750000000025,318.9576519287125,325.87102452380765,327.28384615384573,333.78941554754437,320.77827676014704,299.5205500000002,308.3343000000001,318.33559999999994,325.53750000000025,331.82,48914899,55918916.8,73.31339981462807,1.5,2.75,2.068225097428705,0.8747468978154456,0.3048896485405765,3.8566854593851185,3.5517958108445424,7.385505035875641,2.123593774079207,10232242433.0,2020-01-22,2020,2,22,1,0.54,332.06,332.1682,329.41,5044
2020-01-23 14:30:00,330.63,332.1682,329.41,331.72,325.1904761904762,303.5352631578947,299.7352000000002,308.7257,318.7911999999999,326.0625000000003,319.45813616680226,326.4280698072545,327.9999999999996,334.24636755982897,321.75363244017024,299.7352000000002,308.7257,318.7911999999999,326.0625000000003,331.0994,52004140,55868341.75,73.9474927772028,1.5,2.75,2.11750901904094,0.930833784770424,0.2420952504961602,3.854414873964743,3.6123196234685824,7.217447692710903,1.552120006122777,10284246573.0,2020-01-23,2020,3,23,1,0.84,330.79,332.53,327.36,5045
2020-01-24 14:30:00,332.44,332.53,327.36,328.77,325.7216666666667,303.5457894736842,299.94250000000017,309.0889,319.19959999999986,326.4395000000003,319.8233072975159,326.6511107779922,328.39461538461495,334.11541476601775,322.67381600321215,299.94250000000017,309.0889,319.19959999999986,326.4395000000003,329.55333333333334,87578442,59233763.5,61.69245063392661,1.5,2.75,2.335544089109441,1.4785223295831946,-0.031149031481029432,3.573383334117296,3.6045323655983252,8.99688891478325,0.9394860458690254,10196668131.0,2020-01-24,2020,4,24,1,1.58,329.94,325.12,322.66,5046
2020-01-27 14:30:00,323.03,325.12,322.66,323.5,326.2528571428571,303.5563157894736,300.1185500000002,309.4165000000001,319.48959999999994,326.4675000000003,319.9674913250643,326.351004989612,328.4538461538457,333.950371145368,322.95732116232335,300.1185500000002,309.4165000000001,319.48959999999994,326.4675000000003,323.76,84062463,61885677.25,46.7780253467035,1.5,2.75,2.6051480827444777,1.3583508613861053,-0.5699612919529793,2.8920807506571014,3.46204204261008,13.155160531448162,-1.3569141637444695,10112605668.0,2020-01-27,2020,0,27,1,0.76,323.89,327.85,323.6038,5047
2020-01-28 14:30:00,325.06,327.85,323.6038,326.89,326.7840476190476,303.56684210526316,300.3119500000002,309.745,319.84539999999987,326.6690000000004,320.2389622534932,326.40233784774415,328.64153846153806,333.72984086036445,323.5532360627117,300.3119500000002,309.745,319.84539999999987,326.6690000000004,326.11460000000005,63833953,62949633.9,54.41272414380146,1.5,2.75,2.7297803625484454,1.0140480419855151,-0.6930209616630925,2.5957658405312145,3.288786802194307,14.031663984728867,-0.17101847610322254,10176439621.0,2020-01-28,2020,1,28,1,1.31,325.73,328.63,326.4,5048
2020-01-29 14:30:00,328.38,328.63,326.4,326.62,327.3152380952381,303.57736842105265,300.4942500000002,310.033,320.18679999999995,326.94600000000037,320.489199027866,326.4230675765304,328.6392307692304,333.7311698681405,323.5472916703203,300.4942500000002,310.033,320.18679999999995,326.94600000000037,327.21666666666664,54040889,63162541.85,53.75136227917004,1.5,2.75,2.6940817652235576,0.8555844558684428,-0.7810370853344564,2.3124904455262367,3.0935275308606935,14.015510448487936,-0.4783814253938247,10122398732.0,2020-01-29,2020,2,29,1,0.68,327.52,327.91,323.54,5049
2020-01-30 14:30:00,324.36,327.91,323.54,327.68,327.84642857142865,303.5878947368421,300.6828000000002,310.3293,320.50459999999987,327.23700000000036,320.77119122285166,326.5427754263846,328.7907692307689,333.63628078772905,323.94525767380867,300.6828000000002,310.3293,320.50459999999987,327.23700000000036,326.37666666666667,75491844,64081784.15,56.01184509623863,1.5,2.75,2.8137902105647323,1.1780546531490417,-0.7558170082298679,2.148756270573358,2.9045732788032264,14.09089604846838,-0.9790886014746794,10197890576.0,2020-01-30,2020,3,30,1,1.35,325.73,327.17,320.73,5050
2020-01-31 14:30:00,327.0,327.17,320.73,321.73,320.73,303.59842105263147,300.8406500000001,310.5646,320.6987999999999,327.08000000000044,320.8087915670536,326.08441586196705,328.31230769230734,334.45116829240123,322.17344709221334,300.8406500000001,310.5646,320.6987999999999,327.08000000000044,323.2100000000001,113845576,66811371.3,43.237046340161534,1.5,2.75,3.109233766952965,1.7039850220826107,-1.1065839158587432,1.5213433839797972,2.6279272998385403,16.346519841275867,-3.0787769242355685,10084045000.0,2020-01-31,2020,4,31,1,2.01,323.95,326.16,323.22,5051
2020-02-03 14:30:00,323.35,326.16,323.22,324.12,321.07,303.60894736842096,301.0140000000002,310.82449999999994,320.9425999999999,327.1655000000004,320.9386428781495,325.89732863701784,328.05615384615345,334.5831889297203,321.5291187625866,301.0140000000002,310.82449999999994,320.9425999999999,327.1655000000004,324.50000000000006,69242293,66384307.65,48.334362798156356,1.5,2.75,3.2035742121706114,1.0430521225749352,-1.1398629557050022,1.2030986052072876,2.34296156091229,17.08307571570123,-2.1672200422577745,10153287293.0,2020-02-03,2020,0,34,2,0.91,324.69,330.01,327.72,5052
2020-02-04 14:30:00,328.07,330.01,327.72,329.06,321.41,303.61947368421045,301.2092000000002,311.1126,321.3083999999999,327.43650000000036,321.25712747116324,326.19853543349234,328.1230769230766,334.67203284509867,321.5741210010545,301.2092000000002,311.1126,321.3083999999999,327.43650000000036,328.93,62573190,66724869.75,56.94134330340659,1.5,2.75,3.395461768444138,0.9377791254511966,-0.8070691875457809,1.3341250764800634,2.1411942640258443,19.825760000389078,-0.6881149272650368,10215860483.0,2020-02-04,2020,1,35,2,0.7,328.86,333.09,330.67,5053
2020-02-05 14:30:00,332.27,333.09,330.67,332.86,321.75,303.62999999999994,301.4221500000002,311.4283,321.7601999999999,327.9430000000004,321.71214208013726,326.8329606303025,328.2723076923073,335.14957975366326,321.3950356309514,301.4221500000002,311.4283,321.7601999999999,327.9430000000004,332.20666666666665,65951146,67879686.5,62.16298668862167,1.5,2.75,3.440785927840984,0.9715888419726276,-0.3331863374005044,1.7247113422752136,2.057897679675718,21.02593568693877,0.3436633305197113,10281811629.0,2020-02-05,2020,2,36,2,0.73,331.88,334.19,332.8,5054
2020-02-06 14:30:00,333.91,334.19,332.8,333.98,322.0900000000001,303.64052631578943,301.62765000000024,311.7571999999999,322.2205999999999,328.41950000000037,322.1932345475828,327.5136310464642,328.4284615384612,335.71280025466353,321.1441228222588,301.62765000000024,311.7571999999999,322.2205999999999,328.41950000000037,333.6566666666667,50359688,66975963.25,63.56541188202159,1.5,2.75,3.294301218709484,0.7519068865351481,0.034014753953204746,2.100416122117224,2.066401368164019,21.09054038226406,1.5846944672567558,10332171317.0,2020-02-06,2020,3,37,2,0.42,333.5,333.9941,331.6,5055
2020-02-07 14:30:00,332.82,333.9941,331.6,332.2,322.43,303.65105263157886,301.8275000000002,312.0776,322.59719999999993,328.6970000000004,322.58565672218737,327.9599518991819,328.49769230769186,335.9059336804168,321.0894509349671,301.8275000000002,312.0776,322.59719999999993,328.6970000000004,332.5980333333334,64139443,67754455.35,59.773500245656926,1.5,2.75,3.2300011316588053,0.9466453928184372,0.12995174610977367,2.2288410508012357,2.0988893046914625,20.587861864822536,2.6893353941267355,10268031874.0,2020-02-07,2020,4,38,2,0.72,332.8,334.75,331.19,5056
2020-02-10 14:30:00,331.23,334.75,331.19,334.68,322.7700000000001,303.6615789473684,302.0406500000002,312.4152,323.0091999999998,329.14550000000037,323.0599446938663,328.5999564802122,328.75461538461497,336.747895698568,320.761335070662,302.0406500000002,312.4152,323.0091999999998,329.14550000000037,333.54,42070006,67205086.2,63.07823186293388,1.5,2.75,3.2535724793974623,0.6259943760030472,0.3224035420385851,2.5018937322396937,2.179490190201109,17.622127836536997,2.3830646394811774,10310101880.0,2020-02-10,2020,0,41,2,1.07,332.97,337.02,334.684,5057
2020-02-11 14:30:00,336.16,337.02,334.684,335.26,323.11,303.6721052631578,302.2499000000002,312.7568,323.4047999999999,329.51100000000037,323.5383782352833,329.23424633923963,329.0269230769227,337.6241189869083,320.42972716693714,302.2499000000002,312.7568,323.4047999999999,329.51100000000037,335.6546666666666,54864533,67585212.35,63.826699595128915,1.5,2.75,3.1883173022976417,0.811783097105265,0.44327192187386055,2.7335800925434337,2.2903081706695736,17.05200372629739,2.6452758557344884,10364966413.0,2020-02-11,2020,1,42,2,0.7,335.85,337.65,336.43,5058
2020-02-12 14:30:00,336.83,337.65,336.43,337.42,323.4500000000001,303.6826315789473,302.46765000000016,313.1201999999999,323.8669999999998,330.0095000000005,324.08275555938985,330.01384192597874,329.69230769230734,339.37711626861596,320.0074991159986,302.46765000000016,313.1201999999999,323.8669999999998,330.0095000000005,337.1666666666667,43992662,66633026.25,66.5465322000503,1.5,2.75,3.1312946378478093,0.6602230826939216,0.6127586855637577,3.0562565276242717,2.443497842060513,17.037601172439658,2.9724121093750027,10408959075.0,2020-02-12,2020,2,43,2,0.36,337.04,338.12,335.56,5059
2020-02-13 14:30:00,335.8621,338.12,335.56,337.06,323.79,303.6931578947368,302.6828500000002,313.508,324.3753999999998,330.4530000000005,324.59166710608054,330.68490459969513,330.73538461538425,340.44865108768414,321.02211814308436,302.6828500000002,313.508,324.3753999999998,330.4530000000005,336.91333333333336,54501922,65755292.45,65.66041514001608,1.5,2.75,3.090487878001537,0.8288598524817298,0.6416166203295428,3.2455186174724417,2.603901997142899,17.21674080440847,4.764864948870166,10354457153.0,2020-02-13,2020,3,44,2,0.76,336.84,337.73,336.2,5060
2020-02-14 14:30:00,337.51,337.73,336.2,337.6,324.13,303.70368421052626,302.9118000000002,313.9019,324.9363999999998,330.7870000000005,325.1017978078028,331.3434851140098,331.5592307692304,341.6380294202808,321.48043211818003,302.9118000000002,313.9019,324.9363999999998,330.7870000000005,337.1766666666667,64582210,66281886.55,66.38350788511737,1.5,2.75,2.979024458144287,0.974356847119645,0.6367918723054911,3.399891837524762,2.763099965219272,10.919705146041503,4.158953474021973,10419039363.0,2020-02-14,2020,4,45,2,0.46,336.96,337.6677,335.21,5061
2020-02-18 14:30:00,336.51,337.6677,335.21,336.73,324.47,303.7142105263157,303.1395500000002,314.3105,325.44179999999983,331.0260000000005,325.5578057369086,331.8564865317232,332.3369230769227,342.3310825547626,322.3427635990828,303.1395500000002,314.3105,325.44179999999983,331.0260000000005,336.5359,57342526,64356712.0,64.04367217075131,1.5,2.75,2.9417869968482693,0.8910108086317399,0.5196741090450447,3.4126926015255776,2.8930184924805333,11.537932516104954,2.3308819060353785,10361696837.0,2020-02-18,2020,1,49,2,0.73,336.44,339.08,337.48,5062
2020-02-19 14:30:00,337.79,339.08,337.48,338.34,324.81,339.08,303.3611000000002,314.7177,325.9681999999998,331.3780000000005,326.0590682570298,332.47396400489237,333.1569230769227,343.2370524552531,323.0767936985923,303.3611000000002,314.7177,325.9681999999998,331.3780000000005,338.2999999999999,48814692,62910325.85,66.40365329208636,1.5,2.75,2.8995164970733898,0.7759408545489198,0.4953961298437459,3.5122636547852157,3.0168675249414694,9.102482560929758,1.6463377996755275,10410511529.0,2020-02-19,2020,2,50,2,0.47,338.28,338.64,333.6817,5063
2020-02-20 14:30:00,337.7423,338.64,333.6817,336.95,325.1500000000001,339.4304807692308,303.58175000000017,315.1172,326.4097999999998,331.6585000000005,326.4861636194992,332.90025314728365,334.3276923076919,342.09791219902576,326.55747241635805,303.58175000000017,315.1172,326.4097999999998,331.6585000000005,336.4239,74163362,64172749.0,62.58444611322069,1.5,2.75,3.046572461568149,1.155683107793933,0.3379989210311507,3.439366176230408,3.1013672551992566,7.9818173125665295,0.8892748068746542,10336348167.0,2020-02-20,2020,3,51,2,1.49,336.16,335.81,332.58,5064
2020-02-21 14:30:00,335.47,335.81,332.58,333.48,325.49,339.7809615384615,303.8095000000002,315.498,326.8017999999999,331.7465000000005,326.76043171285215,332.9554671332566,335.0476923076919,340.1919327246452,329.9034518907385,303.8095000000002,315.498,326.8017999999999,331.7465000000005,333.95666666666665,113788208,67261952.4,54.20325121958781,1.5,2.75,3.141103000027567,1.6917172924644392,-0.02809492883321241,3.066248594157741,3.0943435229909535,10.20122581260925,0.3853100541842353,10222559959.0,2020-02-21,2020,4,52,2,0.97,334.2,325.85,321.24,5065
2020-02-24 14:30:00,323.14,325.85,321.24,322.42,325.8300000000001,340.1314423076923,303.98395000000016,315.75449999999995,326.9795999999999,331.4290000000005,326.5902187045051,331.9520893110417,334.5369230769226,342.5026202442115,326.57122590963377,303.98395000000016,315.75449999999995,326.9795999999999,331.4290000000005,323.17,161088409,70937450.75,37.13380814635929,1.5,2.75,3.791024214311313,2.270851395093304,-0.9901165799818727,1.856697798013613,2.8468143779954858,21.825291097199504,-3.663200669296041,10061471550.0,2020-02-24,2020,0,55,2,1.44,323.54,324.61,311.69,5066
2020-02-25 14:30:00,323.94,324.61,311.69,312.65,326.17,340.48192307692307,304.11390000000017,315.94859999999994,326.9441999999998,330.8865000000005,326.0435434611911,330.1137950909425,332.98230769230724,347.1356071800814,318.82900820453307,304.11390000000017,315.94859999999994,326.9441999999998,330.8865000000005,316.31666666666666,218913168,77679986.0,28.573618649630546,1.5,2.75,4.443093913289077,2.8181411876155584,-2.190642005026439,0.10851187171243737,2.299153876738876,25.789800232283522,-6.744019566903304,9842558382.0,2020-02-25,2020,1,56,2,4.15,318.15,318.11,310.7,5067
2020-02-26 14:30:00,314.18,318.11,310.7,311.5,326.5100000000001,340.83240384615385,304.2309000000002,316.18299999999994,326.83159999999987,330.1170000000005,325.47320842349734,328.34105270132886,331.25307692307643,349.4202296733896,313.08592417276327,304.2309000000002,316.18299999999994,326.83159999999987,330.1170000000005,313.43666666666667,194773819,84226979.3,27.762362013319287,1.5,2.75,4.655015776625573,2.3124872887374224,-2.922622270048878,-1.3541239608222213,1.568498309226657,25.31761702901243,-7.681820876059517,9647784563.0,2020-02-26,2020,2,57,2,2.38,314.4,311.5637,297.51,5068
2020-02-27 14:30:00,305.46,311.5637,297.51,297.51,326.85,341.18288461538464,304.3141500000002,316.25389999999993,326.4353999999998,328.6615000000005,324.3766120147328,325.4047619678691,328.58461538461495,354.1115382645045,303.05769250472537,304.3141500000002,316.25389999999993,326.4353999999998,328.6615000000005,302.1945666666666,284353460,95742607.85,20.235530807446853,1.5,2.75,5.3263503640094605,2.9699782195769804,-4.135313447044759,-3.6006434995792915,0.534669947465467,31.866652946520514,-11.733815937815228,9363431103.0,2020-02-27,2020,3,58,2,4.72,304.54,297.892,285.54,5069
2020-02-28 14:30:00,288.7,297.892,285.54,296.26,327.19000000000005,341.53336538461537,304.3784500000002,316.273,325.9705999999998,327.0905000000005,323.2739997788609,322.62907035188147,325.62923076923033,356.0719057366401,295.1865558018205,304.3784500000002,316.273,325.9705999999998,327.0905000000005,293.23066666666665,385764020,111256216.65,19.721057386883015,1.5,2.75,5.8281824808659275,3.4673479974028933,-4.763271382501653,-5.419419280661599,-0.6561478981599465,31.500739367584647,-12.245260663507118,8977667083.0,2020-02-28,2020,4,59,2,4.33,291.72,309.16,294.46,5070
2020-03-02 14:30:00,298.21,309.16,294.46,309.09,327.5300000000001,341.88384615384615,304.4986000000002,316.4331,325.7609999999998,326.45850000000047,322.71776449341536,321.33963508027375,323.6161538461534,354.69951921039,292.5327884819168,304.4986000000002,316.4331,325.7609999999998,326.45850000000047,304.2366666666667,238703625,117499119.1,37.332408388006016,1.5,2.75,6.461883732232651,2.0315354432304,-4.08240209215513,-5.759150513353858,-1.6767484211987291,44.394567211802865,-8.208356843762077,9216370708.0,2020-03-02,2020,0,62,3,4.99,301.81,313.84,297.57,5071
2020-03-03 14:30:00,309.5,313.84,297.57,300.24,327.87,342.2343269230769,304.5613000000002,316.5502,325.3739999999998,325.26450000000057,321.83628353288924,319.33014602500964,320.7561538461533,353.05111324180575,288.4611944505009,304.5613000000002,316.5502,325.3739999999998,325.26450000000057,303.8833333333333,300139150,129043961.95,32.10108012565517,1.5,2.75,7.162463465644603,2.3258674444317933,-3.9911398775690095,-6.665673268159993,-2.6745333905909816,45.611606024749534,-11.26086185493881,8916231558.0,2020-03-03,2020,1,63,3,5.47,305.7,313.1,303.33,5072
2020-03-04 14:30:00,306.12,313.1,303.33,312.86,328.2100000000001,342.5848076923077,304.6964000000002,316.7661,325.21319999999986,324.4545000000005,321.4842724139524,318.7139416416753,318.89461538461484,349.9831684255252,287.80606234370447,304.6964000000002,316.7661,325.21319999999986,324.4545000000005,309.7633333333334,176613448,134745974.85,44.12495887046377,1.5,2.75,7.569430360955702,1.3107140914346949,-2.8949542143037763,-6.293226158470702,-3.3982719441669262,54.28928963447913,-7.149428698619965,9092845006.0,2020-03-04,2020,2,64,3,3.22,308.22,308.47,300.01,5073
2020-03-05 14:30:00,304.98,308.47,300.01,302.46,328.55,342.93528846153845,304.78895000000017,316.85829999999993,324.8477999999999,322.93450000000047,320.73822251536603,317.165947199611,316.19153846153785,346.4027843005951,285.9802926224807,304.78895000000017,316.85829999999993,324.8477999999999,322.93450000000047,303.6466666666667,186366809,140766758.0,38.13213502362525,1.5,2.75,7.9466139066017245,1.3239404789019862,-2.6888503006773217,-6.759334820013577,-4.070484519336256,56.18210272016712,-9.301907160849236,8906478197.0,2020-03-05,2020,3,65,3,2.82,304.24,298.78,290.23,5074
2020-03-06 14:30:00,293.15,298.78,290.23,297.46,328.8900000000001,343.28576923076923,304.8437000000002,316.87009999999987,324.37259999999986,321.10850000000056,319.8253510441752,315.28919032345766,313.1707692307686,342.4006511606199,283.94088730091744,304.8437000000002,316.87009999999987,324.37259999999986,321.10850000000056,295.49,228667168,149682132.0,35.62691020109047,1.5,2.75,8.252570056130171,1.5276851347895015,-2.7006928733492415,-7.446350611022807,-4.745657737673566,56.2803592917851,-7.7414552447118785,8677811029.0,2020-03-06,2020,4,66,3,2.95,294.5,284.19,273.45,5075
2020-03-09 13:30:00,275.3,284.19,273.45,274.23,329.23,343.63625,304.78670000000017,316.65289999999993,323.43259999999987,318.2100000000005,318.0372980620507,311.3787912450331,308.2392307692302,340.3136005624633,276.16486097599704,304.78670000000017,316.65289999999993,323.43259999999987,318.2100000000005,277.29,309417350,161946027.35,26.813057131143648,1.5,2.75,9.378100766406586,1.9106201928083293,-4.005759860123146,-9.7528575628275,-5.7470977027043535,68.45327133221289,-12.28850151927074,8368393679.0,2020-03-09,2020,0,69,3,3.93,278.82,288.52,273.5,5076
2020-03-10 13:30:00,284.64,288.52,273.5,288.42,329.57000000000005,343.98673076923075,304.81810000000024,316.54829999999987,322.7421999999999,315.8970000000005,316.87583539295065,309.1922396978871,304.50615384615327,333.4932295215809,275.51907817072566,304.81810000000024,316.54829999999987,322.7421999999999,315.8970000000005,283.48,276444060,173664730.05,37.05671208545861,1.5,2.75,9.781093568806114,1.5918261579101791,-3.6557941707081785,-10.316840416089576,-6.661046245381397,77.38441077042717,-7.409309791332258,8644837739.0,2020-03-10,2020,1,70,3,5.49,281.01,281.94,270.88,5077
2020-03-11 13:30:00,280.7,281.94,270.88,274.36,329.91,344.33721153846153,304.7760000000003,316.3078999999999,321.7721999999999,312.8520000000005,315.208547730482,305.87488353618363,299.95846153846094,327.8663405981337,272.05058247878816,304.7760000000003,316.3078999999999,321.7721999999999,312.8520000000005,275.72666666666663,256416563,183742331.55,32.24141547597195,1.5,2.75,10.335301171034251,1.3955225278624694,-4.0813485513419785,-11.762731934558873,-7.681383383216892,80.8963904138155,-7.781251050384854,8388421176.0,2020-03-11,2020,2,71,3,4.08,276.41,266.66,247.68,5078
2020-03-12 13:30:00,256.0,266.66,247.68,248.11,330.25000000000006,344.6876923076923,304.61580000000026,315.79619999999994,320.31279999999987,308.3865000000005,312.5772321332082,300.37346605654704,294.2423076923071,330.575113088104,257.90950229651025,304.61580000000026,315.79619999999994,320.31279999999987,308.3865000000005,254.15,392220670,201153731.95,25.562716924846875,1.5,2.75,11.502779658817518,1.9498552982228181,-5.7393107267506736,-14.855521791655235,-9.116211064904562,94.07491431357454,-16.25261594545331,7996200506.0,2020-03-12,2020,3,72,3,7.66,257.17,271.4754,248.5237,5079
2020-03-13 13:30:00,263.09,271.4754,248.5237,269.32,330.5900000000001,345.03817307692304,304.57105000000024,315.5096999999999,319.2619999999999,304.9995000000005,310.8808700887687,297.41599309878063,290.9092307692302,327.8211529304097,253.9973086080507,304.57105000000024,315.5096999999999,319.2619999999999,304.9995000000005,263.10636666666664,329566100,214906940.85,36.930885813860066,1.5,2.75,12.350109683187695,1.5335293438941529,-5.04094174045432,-15.417388240472462,-10.376446500018142,110.32315687289841,-12.866802549419258,8325766606.0,2020-03-13,2020,4,73,3,9.24,260.0,256.9,237.36,5080
2020-03-16 13:30:00,241.18,256.9,237.36,239.85,330.93000000000006,345.3886538461538,304.37515000000025,314.9082999999999,317.5615999999998,300.11200000000036,308.0953457715621,291.9335175655634,285.39769230769167,329.1320513782603,241.6633332371231,304.37515000000025,314.9082999999999,317.5615999999998,300.11200000000036,244.70333333333332,297240030,226539831.85,30.061282500389733,1.5,2.75,13.75081613438857,1.3120872721262242,-6.125069564358572,-18.032783455466358,-11.907713891107786,120.00412830562284,-20.113908872901682,8028526576.0,2020-03-16,2020,0,76,3,8.23,247.13,256.17,237.07,5081
2020-03-17 13:30:00,245.04,256.17,237.07,252.8,331.2700000000001,345.7391346153846,304.26280000000025,314.4461999999998,316.1693999999998,295.9155000000004,305.92690083934394,288.20651589265265,281.958461538461,328.29631637154887,235.62060670537312,304.26280000000025,314.4461999999998,316.1693999999998,295.9155000000004,248.68,262070471,236776229.1,35.719689910383636,1.5,2.75,14.13290069621796,1.1068276236856414,-5.548494512572782,-18.843332031823767,-13.29483751925098,127.94690270464935,-19.197084958128237,8290597047.0,2020-03-17,2020,1,77,3,8.06,246.62,248.37,228.02,5082
2020-03-18 13:30:00,236.25,248.37,228.02,240.0,331.61,346.08961538461534,304.08995000000033,313.8473999999999,314.49659999999983,290.99850000000043,303.3415321789775,283.61541914097137,277.63076923076864,328.1386272402894,227.12291122124782,304.08995000000033,313.8473999999999,314.49659999999983,290.99850000000043,238.79666666666665,327597130,250715351.0,32.88744041267324,1.5,2.75,14.893407789345249,1.3066496674150598,-5.591906790391005,-20.28472100723974,-14.692814216848733,123.4957628798093,-20.650664550684386,7962999917.0,2020-03-18,2020,2,78,3,8.92,238.2,247.38,232.22,5083
2020-03-19 13:30:00,239.25,247.38,232.22,240.51,331.9500000000001,346.4400961538461,303.8898500000003,313.2487999999998,312.85219999999987,286.17650000000043,300.8775505249,279.5101411275456,272.35538461538397,322.94384338758374,221.7669258431843,303.8898500000003,313.2487999999998,312.85219999999987,286.17650000000043,240.0366666666667,289322040,261473284.9,33.115001207390264,1.5,2.75,14.912450090106304,1.1065070762798987,-5.159481179800956,-21.142165691599928,-15.982684511798974,124.43445905523592,-19.145431318496602,8252321957.0,2020-03-19,2020,3,79,3,6.53,239.8,244.47,228.5,5084
2020-03-20 13:30:00,242.53,244.47,228.5,228.8,332.29,346.79057692307686,303.6190500000003,312.5207999999999,310.9391999999998,280.9425000000004,298.05097991608034,274.6806038773032,266.85999999999945,319.61284607706483,214.107153922934,303.6190500000003,312.5207999999999,310.9391999999998,280.9425000000004,233.9233333333333,347158790,273141814.0,30.553328881898665,1.5,2.75,14.987989369384424,1.2709836876165728,-5.21957041491234,-22.5071475304394,-17.287577115527057,125.28096603982391,-16.566385880465305,7905163167.0,2020-03-20,2020,4,80,3,6.99,236.48,229.6833,218.26,5085
2020-03-23 13:30:00,228.19,229.6833,218.26,222.95,218.26,347.14105769230764,303.3098000000003,311.7172999999999,308.8651999999998,275.9690000000004,295.10584344878305,269.75387969851243,259.9438461538456,310.2798271910921,209.60786511659907,303.3098000000003,311.7172999999999,308.8651999999998,275.9690000000004,223.6311,326025170,281388652.05,29.332562771432023,1.5,2.75,14.733368700142679,1.1586294174438438,-5.199340469956315,-23.78675270297245,-18.587412233016135,120.3178128421414,-22.699535399764237,7579137997.0,2020-03-23,2020,0,83,3,5.23,223.97,244.1,233.8,5086
2020-03-24 13:30:00,234.42,244.1,233.8,243.15,215.3322857142857,347.49153846153837,303.0873000000003,311.11669999999987,307.2139999999999,272.4940000000005,293.0683593919681,267.22017687008264,255.3815384615379,299.89041456587023,210.87266235720557,303.0873000000003,311.11669999999987,307.2139999999999,272.4940000000005,240.35,235494475,282217717.4,38.473969137289465,1.5,2.75,15.191699507275347,0.8344425614718689,-3.45552801501848,-22.906822251789237,-19.45129423677076,129.5886764369425,-11.375564951159065,7814632472.0,2020-03-24,2020,1,84,3,4.41,238.95,256.35,239.75,5087
2020-03-25 13:30:00,244.87,256.35,239.75,246.79,212.40457142857144,347.8420192307692,302.87640000000033,310.5431999999999,305.5907999999999,269.2585000000005,291.2535217687536,265.2744457395986,251.4838461538456,288.8761600810178,214.09153222667342,302.87640000000033,310.5431999999999,305.5907999999999,269.2585000000005,247.63,299430255,287450539.2,39.98064454005071,1.5,2.75,15.292292399612824,1.0416757464896071,-1.7717656300602656,-21.666001274346083,-19.89423564428582,128.90634440337683,-0.5320220869775589,8114062727.0,2020-03-25,2020,2,85,3,6.92,248.05,262.8,249.05,5088
2020-03-26 13:30:00,249.52,262.8,249.05,261.2,209.47685714285717,348.1925,302.73790000000025,310.12189999999987,304.2657999999999,267.44300000000044,290.0749522876261,264.88640328820827,250.4815384615379,286.0345661124676,214.92851081060815,302.73790000000025,310.12189999999987,304.2657999999999,267.44300000000044,257.68333333333334,257632816,286114507.0,45.65442193197436,1.5,2.75,15.343557228211909,0.9004535236656139,0.4774473794714318,-19.29742641994653,-19.774873799417964,120.0563471358774,-3.015000742611022,8371695543.0,2020-03-26,2020,3,86,3,5.52,255.92,260.81,251.05,5089
2020-03-27 13:30:00,253.27,260.81,251.05,253.42,206.54914285714284,348.54298076923067,302.56305000000026,309.5946999999999,302.7703999999999,265.30100000000044,288.6375031783074,263.79436487980746,247.7892307692302,275.981617588299,219.59684395016131,302.56305000000026,309.5946999999999,302.7703999999999,265.30100000000044,255.09333333333333,224341217,278043366.85,43.275795063902386,1.5,2.75,14.9725888547682,0.8068569286208813,1.5459642640094131,-17.842418469406198,-19.388382733415607,110.69168785880849,5.65770273087346,8147354326.0,2020-03-27,2020,4,87,3,3.89,255.93,262.43,253.53,5090
2020-03-30 13:30:00,255.7,262.43,253.53,261.65,203.62142857142857,348.8934615384615,302.42340000000024,309.13749999999993,301.3849999999999,262.9290000000004,287.57916972033456,263.59013965315916,246.81153846153785,271.96842080005194,221.65465612302387,302.42340000000024,309.13749999999993,301.3849999999999,262.9290000000004,259.2033333333333,170961866,274656278.9,46.45395530123196,1.5,2.75,14.546689650856186,0.6224575192116608,2.8366275030051966,-15.842598354659117,-18.679225857664317,87.0778780895014,3.5007911392404933,8318316192.0,2020-03-30,2020,0,90,3,3.51,257.98,263.33,256.22,5091
2020-03-31 13:30:00,260.56,263.33,256.22,257.75,200.69371428571426,349.24394230769235,302.26585000000017,308.64469999999994,299.9009999999998,260.8045000000004,286.4093983587528,263.03393587666784,247.55307692307636,273.3787581006141,221.72739574553856,302.26585000000017,308.64469999999994,299.9009999999998,260.8045000000004,259.1,194881060,269393374.4,45.162628867014206,1.5,2.75,14.015497532937884,0.7234070267468315,3.4182955635986514,-14.406356403166,-17.824651966764648,83.17506345292439,7.395833333333332,8123435132.0,2020-03-31,2020,1,91,3,2.77,259.77,257.6591,243.9,5092
2020-04-01 13:30:00,247.98,257.6591,243.9,246.15,197.766,349.59442307692314,302.04975000000024,308.0352,298.19799999999987,257.4690000000004,284.83059842311536,261.4259419836518,245.77076923076862,268.3335874692714,223.20795099226586,302.04975000000024,308.0352,298.19799999999987,257.4690000000004,249.23636666666667,189554623,270040433.15,41.47007975836596,1.5,2.75,14.003676280585179,0.7019490407005371,3.0259001825558838,-14.042276738569797,-17.06817692112568,81.83522156714817,2.345016839216671,7933880509.0,2020-04-01,2020,2,92,4,5.64,250.78,252.68,244.59,5093
2020-04-02 13:30:00,245.19,252.68,244.59,251.83,194.8382857142857,349.9449038461538,301.8469000000003,307.4717,296.6077999999998,254.93750000000043,283.53645730848336,260.51204274711347,246.69230769230708,269.19106821043204,224.19354717418227,301.8469000000003,307.4717,296.6077999999998,254.93750000000043,249.7,177660430,269605114.2,43.88925928151192,1.5,2.75,13.581270831971947,0.658965355784041,3.139423313493669,-13.143897779258594,-16.283321092752267,82.65275267980033,10.06555944055944,8111540939.0,2020-04-02,2020,3,93,4,3.31,248.64,253.32,245.22,5094
2020-04-03 13:30:00,250.76,253.32,245.22,248.19,191.91057142857144,350.2953846153846,301.62255000000033,306.8642,294.9371999999998,252.47400000000042,282.15032172775864,259.33851486643607,246.3376923076917,268.58411384028386,224.09127077509956,301.62255000000033,306.8642,294.9371999999998,252.47400000000042,248.91,135561171,264949814.35,42.672033244607135,1.5,2.75,13.189751486831096,0.5116484845727163,2.962159288806585,-12.580621981744029,-15.542781270550616,76.38841529050815,11.320923973985202,7975979768.0,2020-04-03,2020,4,94,4,3.3,249.27,267.0,248.1698,5095
2020-04-06 13:30:00,257.84,267.0,248.1698,264.86,188.98285714285717,350.6458653846154,301.46755000000024,306.4293,293.6589999999999,252.0055000000004,281.47226989529753,259.8643705934422,248.2499999999994,272.1974116153858,224.302588384613,301.46755000000024,306.4293,293.6589999999999,252.0055000000004,260.0099333333333,188061238,258882008.75,49.56999654784236,1.5,2.75,13.59264066634316,0.7264361046487746,3.901313373480568,-10.666139553699908,-14.567452927180474,79.31772384372509,8.92864486942217,8164041006.0,2020-04-06,2020,0,97,4,7.59,257.58,275.03,264.89,5096
2020-04-07 13:30:00,274.21,275.03,264.89,265.13,186.05514285714284,350.9963461538462,301.32320000000027,305.9906000000001,292.49159999999983,250.8410000000004,280.8313965660701,260.36585910835237,250.1438461538456,275.2111740019355,225.07651830575563,301.32320000000027,305.9906000000001,292.49159999999983,250.8410000000004,268.35,201427189,255131165.2,49.67561642359456,1.5,2.75,13.348166333032935,0.7895044450649497,4.435483122549538,-9.023099023993552,-13.45858214654309,65.99767161321779,7.431419425422425,8365468195.0,2020-04-07,2020,1,98,4,3.83,269.96,276.0,265.2542,5097
2020-04-08 13:30:00,267.96,276.0,265.2542,274.03,183.12742857142854,351.34682692307683,301.22515000000027,305.6399,291.43439999999987,250.82450000000043,280.5646751321066,261.6672058599379,253.62307692307635,278.4289600771415,228.81719376901114,301.22515000000027,305.6399,291.43439999999987,250.82450000000043,271.76140000000004,153774487,249999061.4,53.158197074784546,1.5,2.75,13.17115445210201,0.6151002573324061,5.228451550495978,-6.923017708423117,-12.151469258919096,67.42592176713124,4.911944869831541,8519242682.0,2020-04-08,2020,2,99,4,4.05,270.63,281.2,275.47,5098
2020-04-09 13:30:00,277.58,281.2,275.47,278.2,180.19971428571426,351.6973076923077,301.1623500000003,305.3264000000001,290.4659999999999,252.3290000000004,280.47194277398467,263.2417576828009,257.8730769230763,278.83607345669503,236.9100803894576,301.1623500000003,305.3264000000001,290.4659999999999,252.3290000000004,278.29,190282705,239902163.15,54.738647852798955,1.5,2.75,12.742500562666152,0.7931679418873134,5.828287012739954,-4.866110492994154,-10.694397505734107,60.90203907461128,9.778233762134008,8709525387.0,2020-04-09,2020,3,100,4,2.08,278.34,277.51,271.41,5099
2020-04-13 13:30:00,277.14,277.51,271.41,275.66,177.27200000000002,352.04778846153846,301.0883000000003,304.9651,289.4255999999998,252.6460000000004,280.28323913578924,264.4244474272961,260.37384615384553,281.4707588531907,239.27693345450032,301.0883000000003,304.9651,289.4255999999998,252.6460000000004,274.86000000000007,115139268,229180821.55,53.55337973856836,1.5,2.75,12.317321951047141,0.502394865422368,5.8341257383171445,-3.4017403328376763,-9.23586607115482,57.38347337127228,5.354481177145059,8594386119.0,2020-04-13,2020,0,104,4,2.25,274.46,284.9,275.5106,5100
2020-04-14 13:30:00,280.98,284.9,275.5106,283.79,174.3442857142857,352.3982692307692,301.04975000000024,304.6828000000001,288.6667999999999,254.84300000000042,280.42075916967985,266.26878576755365,263.2199999999994,286.12446244730353,240.3155375526953,301.04975000000024,304.6828000000001,288.6667999999999,254.84300000000042,281.4002,134143350,221025987.55,56.779315320351046,1.5,2.75,12.108184668829484,0.606912116927673,6.134990061592501,-1.5671284941641943,-7.702118555756695,56.97261593005221,10.10281280310379,8728529469.0,2020-04-14,2020,1,105,4,3.41,280.21,279.26,275.46,5101
2020-04-15 13:30:00,277.57,279.26,275.46,277.76,171.41657142857142,352.74875,300.97355000000033,304.3411,287.7395999999999,256.0910000000004,280.3164156728297,267.36318712302466,264.49384615384554,288.61682025095774,240.37087205673333,300.97355000000033,304.3411,287.7395999999999,256.0910000000004,277.49333333333334,121775006,214011214.3,53.79493341971186,1.5,2.75,11.838314335341664,0.5690122660081556,5.687357905939255,-0.5929211733326271,-6.280279079271883,58.040519662058784,12.841763152549252,8606754463.0,2020-04-15,2020,2,106,4,1.38,277.36,280.03,275.76,5102
2020-04-16 13:30:00,279.15,280.03,275.76,279.1,168.48885714285709,353.0992307692308,300.89075000000025,304.0244,286.7403999999999,258.04600000000045,280.2687130974246,268.4809788255938,266.46923076923014,290.8458582403136,242.0926032981467,300.89075000000025,304.0244,286.7403999999999,258.04600000000045,278.2966666666667,131798325,204221274.05,54.36891402839007,1.5,2.75,11.297720454245832,0.6453702025565244,5.251421818590759,0.2839981939665677,-4.967423624624192,47.234975035598936,10.828733669538979,8738552788.0,2020-04-16,2020,3,107,4,1.55,277.9,287.3,282.4,5103
2020-04-17 13:30:00,285.38,287.3,282.4,286.64,165.56114285714284,353.44971153846154,300.8418000000002,303.7881,285.8159999999998,260.3525000000004,280.5185674857609,270.21040941363253,268.39153846153783,294.8013930863148,241.9816838367609,300.8418000000002,303.7881,285.8159999999998,260.3525000000004,285.44666666666666,146684784,197089411.25,57.56338937529597,1.5,2.75,11.076454707513989,0.7442550214630062,5.229369553405697,1.56928831713293,-3.660081236272768,47.589475035619536,15.492163262017,8885237572.0,2020-04-17,2020,4,108,4,1.74,284.85,286.7912,281.35,5104
2020-04-20 13:30:00,282.61,286.7912,281.35,281.59,162.63342857142857,353.80019230769227,300.7557500000002,303.4944,284.76819999999987,262.9920000000004,280.56058444710357,271.2941799456674,270.225384615384,296.73546701131517,243.7153022194528,300.7557500000002,303.4944,284.76819999999987,262.9920000000004,283.2437333333333,100224647,184742704.1,54.796472854327924,1.5,2.75,10.673936514120127,0.5425093645146012,4.6525044874020125,2.155549372979749,-2.4969551144222644,48.29821301100325,6.316544589594487,8785012925.0,2020-04-20,2020,0,111,4,1.93,284.07,278.04,272.02,5105
2020-04-21 13:30:00,276.73,278.04,272.02,273.04,159.7057142857143,354.15067307692306,300.62865000000016,303.0911,283.58499999999987,265.4965000000004,280.26565956682504,271.46044852227055,272.2938461538455,294.8717557640597,249.71593654363133,300.62865000000016,303.0911,283.58499999999987,265.4965000000004,274.3666666666666,126385698,174760730.5,50.38101230917797,1.5,2.75,10.595083905968693,0.7231927769951728,3.5241679041460214,1.9082547657602615,-1.6159131383857592,41.053130377136924,2.983442085014908,8658627227.0,2020-04-21,2020,1,112,4,2.21,275.03,281.0,276.91,5106
2020-04-22 13:30:00,278.35,281.0,276.91,279.1,156.77799999999996,354.5011538461538,300.5400500000002,302.7413,282.4733999999999,267.29400000000044,280.2199474269496,272.1880248534829,274.39153846153783,293.8224984459884,254.96057847708732,300.5400500000002,302.7413,282.4733999999999,267.29400000000044,279.0033333333334,93524584,167662235.95,53.25602794058161,1.5,2.75,10.406863626970924,0.5578154404900743,3.0336727026936576,2.1761777399813127,-0.8574949627123448,42.40747337344251,1.8501623909791085,8752151811.0,2020-04-22,2020,2,113,4,1.48,278.96,283.94,278.75,5107
2020-04-23 13:30:00,280.49,283.94,278.75,279.08,153.8502857142857,354.8516346153846,300.44950000000017,302.3773,281.3497999999999,268.90850000000046,280.1752436062849,272.84440343886547,276.7676923076916,289.0357098990306,264.49967471635256,300.44950000000017,302.3773,281.3497999999999,268.90850000000046,280.59,104709693,157926207.85,53.24506281249502,1.5,2.75,10.034230510758716,0.6630292364105544,2.5737509415301307,2.3596937142003185,-0.21405722732981214,38.530061191431216,0.3163191948238661,8647442118.0,2020-04-23,2020,3,114,4,1.86,281.35,283.7,278.5,5108
2020-04-24 13:30:00,280.73,283.7,278.5,282.97,150.92257142857142,355.20211538461535,300.3713000000002,302.0639,280.26079999999985,269.99700000000047,280.28484189623447,273.8087459684973,278.16076923076855,288.6940234186804,267.62751504285666,300.3713000000002,302.0639,280.26079999999985,269.99700000000047,281.72333333333336,85165953,149302864.7,55.17809692656513,1.5,2.75,9.688928331418811,0.5704241051980298,2.4007628456535213,2.7868963297370897,0.3861334840835683,38.378025034714646,2.6518174562867305,8732608071.0,2020-04-24,2020,4,115,4,1.87,281.1,288.27,284.62,5109
2020-04-27 13:30:00,285.12,288.27,284.62,287.05,147.99485714285714,355.55259615384614,300.3100000000003,301.818,279.26059999999984,271.6785000000005,280.5501422140292,275.0698177810214,279.84692307692245,288.3111950829382,271.38265107090666,300.3100000000003,301.818,279.26059999999984,271.6785000000005,286.6466666666667,77896608,141980634.25,57.177847277954534,1.5,2.75,9.375433450603177,0.5486424850225656,2.423341066160825,3.4153098167846,0.9919687506237744,38.31034693136119,1.1487367419570778,8810504679.0,2020-04-27,2020,0,118,4,1.28,286.44,291.4,285.4,5110
2020-04-28 13:30:00,291.02,291.4,285.4,285.73,145.0671428571428,355.90307692307687,300.23540000000025,301.5798,278.22319999999985,272.8825000000005,280.75327389191045,276.0850732304479,280.7469230769224,289.0319731333765,272.4618730204683,300.23540000000025,301.5798,278.22319999999985,272.8825000000005,287.51,105283871,138696734.5,56.30263646807615,1.5,2.75,9.13433106127438,0.7590940866744055,2.217174208303989,3.7634365110037606,1.5462623026997715,35.00295008132805,2.8693836405530053,8705220808.0,2020-04-28,2020,1,119,4,2.1,288.4,294.88,290.41,5111
2020-04-29 13:30:00,291.53,294.88,290.41,293.21,142.13942857142854,356.25355769230765,300.19770000000017,301.3973,277.35279999999983,274.65550000000053,281.2417729549728,277.7160186370719,281.9015384615378,292.3469624759222,271.4561144471534,300.19770000000017,301.3973,277.35279999999983,274.65550000000053,292.8333333333333,118745579,134889960.45,60.03573185503191,1.5,2.75,9.13545027118335,0.8803144326224022,2.4349840273070424,4.589992336833576,2.1550083095265324,34.57355857084283,5.0555356503045354,8823966387.0,2020-04-29,2020,2,120,4,1.54,292.64,293.3239,288.59,5112
2020-04-30 13:30:00,291.71,293.3239,288.59,290.48,139.2117142857143,356.6040384615385,300.15155000000027,301.1819,276.39559999999983,276.8720000000006,281.60405636850317,278.93163590973165,283.04153846153787,293.74503565035667,272.338041272719,300.15155000000027,301.1819,276.39559999999983,276.8720000000006,290.7979666666667,122901701,131557314.35,58.085321550662954,1.5,2.75,8.821053823241682,0.9342065213723331,2.2499880942236734,4.967493427306124,2.7175053330824506,35.60158140508008,1.339659503209612,8701064686.0,2020-04-30,2020,3,121,4,1.64,290.96,290.6572,281.52,5113
2020-05-01 13:30:00,285.31,290.6572,281.52,282.79,136.284,356.9545192307692,300.07680000000033,300.8611,275.31239999999985,278.4200000000006,281.6505639618953,279.29909915642395,282.96461538461483,293.659861245451,272.26936952377855,300.07680000000033,300.8611,275.31239999999985,278.4200000000006,284.9890666666667,125180028,128933294.25,52.874449511514385,1.5,2.75,8.843635693010132,0.9708898599711376,1.500555321352106,4.593199484772583,3.092644163420477,36.36587266156897,0.4261514968571489,8575884658.0,2020-05-01,2020,4,122,5,3.25,286.09,283.9,279.13,5114
2020-05-04 13:30:00,280.74,283.9,279.13,283.57,133.3562857142857,357.30499999999995,300.00050000000033,300.558,274.31419999999986,280.1890000000006,281.7258359633896,279.7058516177169,283.4115384615379,293.67639664903936,273.1466802740364,300.00050000000033,300.558,274.31419999999986,280.1890000000006,282.2,80873213,126198896.35,53.33176752626219,1.5,2.75,8.55266171493798,0.640839304772573,0.9737465200199806,4.309827313445453,3.3360807934254724,34.85407779789832,3.856577790799872,8656757871.0,2020-05-04,2020,0,125,5,1.71,281.52,289.25,283.7134,5115
2020-05-05 13:30:00,286.64,289.25,283.7134,286.19,130.42857142857142,357.65548076923073,299.94560000000024,300.2846,273.58959999999985,281.25550000000055,281.90090121972725,280.32338955888673,283.95692307692246,293.99849017685847,273.9153559769864,299.94560000000024,300.2846,273.58959999999985,281.25550000000055,286.38446666666664,79569938,120774331.35,54.91443881856312,1.5,2.75,8.34747159244241,0.6588315340733203,0.7292954351185541,4.247700087323665,3.5184046522051107,28.63040166987782,2.5403081332855515,8736327809.0,2020-05-05,2020,1,126,5,1.95,286.48,288.46,283.78,5116
2020-05-06 13:30:00,288.04,288.46,283.78,284.25,127.50085714285713,358.0059615384615,299.87735000000026,299.9829000000001,273.02159999999986,282.21150000000057,281.99302274052224,280.69735245804037,283.77307692307636,293.6982597646128,273.8478940815399,299.87735000000026,299.9829000000001,273.02159999999986,282.21150000000057,285.49666666666667,73632628,114384603.3,53.468491643933966,1.5,2.75,8.085509335839381,0.6437284903360766,0.38196446767824105,3.9958602368029124,3.6138957691246714,27.00471425176168,1.852515407768388,8662695181.0,2020-05-06,2020,2,127,5,1.65,286.12,289.78,287.13,5117
2020-05-07 13:30:00,287.75,289.78,287.13,287.68,124.57314285714286,358.35644230769236,299.81560000000025,299.6884,272.54519999999985,282.89400000000063,282.21604145658023,281.3623665096556,284.2415384615378,294.28452865724466,274.198548265831,299.81560000000025,299.6884,272.54519999999985,282.89400000000063,288.19666666666666,75250412,110458399.55,55.68998416704625,1.5,2.75,7.902972954707995,0.6812556791205111,0.3301883266430621,4.026631177428499,3.696442850785437,27.574374379285764,1.664487401491317,8737945593.0,2020-05-07,2020,3,128,5,0.92,288.46,292.95,289.86,5118
2020-05-08 13:30:00,291.09,292.95,289.86,292.44,121.64542857142855,358.7069230769231,299.7706000000003,299.4396,272.44379999999984,283.60600000000056,282.6169810073025,282.4173792230217,285.73384615384555,294.33777920248133,277.1299131052098,299.7706000000003,299.4396,272.44379999999984,283.60600000000056,291.75,76622128,104775370.7,58.640960240592385,1.5,2.75,7.714903457943138,0.7312990399183574,0.5504993427100611,4.384567029173013,3.834067686462952,27.97813165293828,1.8777216512802601,8814567721.0,2020-05-08,2020,4,129,5,1.07,291.4,294.0,289.88,5119
2020-05-11 13:30:00,290.34,294.0,289.88,292.5,118.71771428571422,359.0574038461538,299.73310000000026,299.1696,272.36859999999984,284.4480000000006,283.0045503795652,283.3776288208292,286.76461538461484,295.15051055864194,278.37872021058763,299.73310000000026,299.1696,272.36859999999984,284.4480000000006,292.12666666666667,79514231,102994118.85,58.67831713495811,1.5,2.75,7.458124639518628,0.7720269068547889,0.6286025308359564,4.6198208500078985,3.991218319171941,27.104076845544945,2.369369684667337,8894081952.0,2020-05-11,2020,0,132,5,1.42,291.94,294.24,286.52,5120
2020-05-12 13:30:00,293.79,294.24,286.52,286.67,115.78999999999996,359.4078846153846,299.65640000000025,298.8406,271.92019999999985,284.5920000000006,283.1482935019352,283.6911879807502,287.348461538461,294.47532878054403,280.221594296378,299.65640000000025,298.8406,271.92019999999985,284.5920000000006,289.1433333333334,95870786,101080490.65,53.61123315819163,1.5,2.75,7.476830022410157,0.9484598401086214,0.2361595570438517,4.286417765476756,4.050258208432904,29.78829403081178,-2.2304832713754523,8798211166.0,2020-05-12,2020,1,133,5,2.69,290.38,287.19,278.965,5121
2020-05-13 13:30:00,286.06,287.19,278.965,281.6,112.86228571428568,359.75836538461533,299.5571000000002,298.4607,271.54739999999987,284.7840000000006,283.08757610970235,283.49202722067884,287.2430769230764,294.6604012783718,279.82575256778085,299.5571000000002,298.4607,271.54739999999987,284.7840000000006,282.585,144721099,102227795.3,49.599928991860686,1.5,2.75,7.530270735095147,1.4156727001232707,-0.38267695677621694,3.5719120124626333,3.95458896923885,26.469465539362478,-3.057009088405396,8653490067.0,2020-05-13,2020,2,134,5,2.95,283.08,285.11,276.37,5122
2020-05-14 13:30:00,278.95,285.11,276.37,284.97,276.37,360.1088461538461,299.47835000000026,298.1014,270.9895999999998,285.0775000000006,283.16139665441995,283.6327865329951,287.08307692307636,294.5992354534243,279.56691839272844,299.47835000000026,298.1014,270.9895999999998,285.0775000000006,282.1500000000001,121977890,101736773.55,52.1621023324705,1.5,2.75,7.616679968302636,1.1989557535953528,-0.5714788420677062,3.2402404166542165,3.811719258721923,27.686471725071932,0.7708900597616629,8775467957.0,2020-05-14,2020,3,135,5,3.16,280.74,286.33,281.34,5123
2020-05-15 13:30:00,282.37,286.33,281.34,286.28,277.94054054054055,360.45932692307684,299.4226000000002,297.7569,270.66599999999994,285.0595000000006,283.28369482483487,283.88490210128134,287.125384615384,294.6167524288094,279.63401680195864,299.4226000000002,297.7569,270.66599999999994,285.0595000000006,284.65,111146276,99959848.15,53.15895283773903,1.5,2.75,7.429059970566733,1.1119092121189862,-0.6110079181303498,3.0479593610589863,3.658967279189336,22.789600497823,0.955672320767352,8886614233.0,2020-05-15,2020,4,136,5,1.77,283.83,296.75,292.7,5124
2020-05-18 13:30:00,293.05,296.75,292.7,295.0,279.5110810810811,360.8098076923077,299.42340000000024,297.4947,270.6167999999999,285.7300000000006,283.74315777288064,284.9434828535402,287.2630769230763,295.2463763551637,279.2797774909889,299.42340000000024,297.4947,270.6167999999999,285.7300000000006,294.81666666666666,120320229,100964627.25,59.2466267663418,1.5,2.75,7.646269972669113,1.1917067618352446,-0.08062201024883553,3.558189766378291,3.638811776627127,28.17270625082045,3.078374506446767,9006934462.0,2020-05-18,2020,0,139,5,1.38,294.73,296.205,291.95,5125
2020-05-19 13:30:00,294.35,296.205,291.95,291.97,281.08162162162165,361.1602884615384,299.42015000000026,297.2021,270.9715999999999,286.6765000000006,284.0657790366892,285.6126749627269,287.3776923076917,295.5821607106499,279.1732239047335,299.42015000000026,297.2021,270.9715999999999,286.6765000000006,293.375,95189316,99404808.15,56.49888755860852,1.5,2.75,7.404036403192746,0.9575926735491616,0.029498066780509813,3.6756843601027636,3.6461862933222537,29.054046525877926,2.7159190853122346,8911745146.0,2020-05-19,2020,1,140,5,1.46,294.08,297.87,295.57,5126
2020-05-20 13:30:00,295.82,297.87,295.57,296.93,282.65216216216214,361.5107692307692,299.4857000000003,296.94199999999995,271.14179999999993,287.5680000000005,284.57025829015237,286.6905154424672,288.465384615384,297.6403995695024,279.29036966126563,299.4857000000003,296.94199999999995,271.14179999999993,287.5680000000005,296.79,85861691,99021663.5,59.78668805232536,1.5,2.75,7.2966052315361205,0.8671000664415217,0.3802668883732774,4.121519903788851,3.7412530154155736,29.59559086249909,3.215378197997776,8997606837.0,2020-05-20,2020,2,141,5,0.78,296.72,297.67,293.6886,5127
2020-05-21 13:30:00,296.79,297.67,293.6886,294.88,284.2227027027027,361.86125,299.5211000000002,296.6622,271.55219999999986,288.35800000000063,284.97456188661704,287.47046635270834,289.335384615384,298.63270801974204,280.038061211026,299.5211000000002,296.6622,271.55219999999986,288.35800000000063,295.4128666666667,78293925,97700875.1,57.84089362543596,1.5,2.75,7.059804857854968,0.8013636000687163,0.4152532711510899,4.260319604354436,3.8450663332033463,29.801351205385753,0.8343591847900417,8919312912.0,2020-05-21,2020,3,142,5,1.36,295.68,295.63,293.22,5128
2020-05-22 13:30:00,294.57,295.63,293.22,295.44,285.79324324324324,362.2117307692308,299.55845000000016,296.40579999999994,272.49879999999985,288.9815000000005,285.38497122439674,288.2294695572124,290.04692307692244,299.682144952511,280.41170120133387,299.55845000000016,296.40579999999994,272.49879999999985,288.9815000000005,294.7633333333333,63958200,96640487.45,58.24071349974737,1.5,2.75,6.727675939436756,0.6618157843325323,0.4160969513667303,4.365187522411759,3.9490905710450286,28.454118404375482,1.0051282051282044,8983271112.0,2020-05-22,2020,4,143,5,0.82,294.42,302.19,298.69,5129
2020-05-26 13:30:00,301.93,302.19,298.69,299.08,287.3637837837838,362.56221153846155,299.58575000000025,296.17799999999994,273.09399999999994,289.5830000000005,285.9220311763812,289.26285340890644,291.1876923076917,301.30692655614797,281.0684580592354,299.58575000000025,296.17799999999994,273.09399999999994,289.5830000000005,299.9866666666667,88951442,97193229.15,60.840334266109956,1.5,2.75,6.729270515191272,0.9152020441950712,0.5911064553978953,4.687973640292398,4.096867184894503,29.15631402419263,4.329019430006617,9072222554.0,2020-05-26,2020,1,147,5,1.17,300.44,303.57,296.87,5130
2020-05-27 13:30:00,302.12,303.57,296.87,303.53,288.9343243243244,362.91269230769234,299.6453000000002,295.9646,274.36759999999987,290.47300000000047,286.61253975769955,290.6216292747248,292.40692307692245,304.2195665890897,280.5942795647552,299.6453000000002,295.9646,274.36759999999987,290.47300000000047,301.3233333333333,104817449,97169908.05,63.80672351859082,1.5,2.75,6.7271797641061815,1.078702770265717,0.9164504927650824,5.242430300850856,4.3259798080857745,26.088656554492808,7.787642045454527,9177040003.0,2020-05-27,2020,2,148,5,2.26,300.22,306.84,302.24,5131
2020-05-28 13:30:00,304.65,306.84,302.24,302.97,290.5048648648649,363.2631730769231,299.7198000000002,295.7702,275.37099999999987,290.9610000000005,287.2540087868094,291.79766458189386,293.2169230769225,306.30301054442526,280.13083560941965,299.7198000000002,295.7702,275.37099999999987,290.9610000000005,304.01666666666665,90767807,95771019.45,63.15833910988592,1.5,2.75,6.575238352384307,0.9477585967160758,0.9971509593406632,5.5724185072616015,4.575267547920939,22.126053806394125,6.316454363617222,9086272196.0,2020-05-28,2020,3,149,5,1.52,304.54,304.96,299.47,5132
2020-05-29 13:30:00,302.46,304.96,299.47,304.32,292.07540540540543,363.6136538461538,299.7786500000002,295.577,276.65739999999994,291.6530000000005,287.92326334418937,292.9902679550469,294.12615384615316,308.46883579353715,279.78347189876916,299.7786500000002,295.577,276.65739999999994,291.6530000000005,302.9166666666667,119265702,95589219.5,64.10528901460074,1.5,2.75,6.497721327213997,1.2476898820164548,1.0399021526210088,5.8751452386972005,4.835243086076192,21.974482369780254,6.301522984490715,9205537898.0,2020-05-29,2020,4,150,5,1.83,302.22,306.205,303.06,5133
2020-06-01 13:30:00,303.62,306.205,303.06,305.55,293.645945945946,363.9641346153846,299.8869000000002,295.4052,277.95819999999986,292.7910000000005,288.61450791892713,294.18643291170906,295.57846153846094,310.4218093801024,280.73511369681955,299.8869000000002,295.4052,277.95819999999986,292.7910000000005,304.93833333333333,56779836,92169209.9,64.98828199710206,1.5,2.75,6.258241232412996,0.6160390879080324,1.0465981213902733,6.143490737814035,5.0968926164237605,21.99496597263257,3.5762711864406818,9262317734.0,2020-06-01,2020,0,153,6,1.04,304.63,308.13,305.1,5134
2020-06-02 13:30:00,306.55,308.13,305.1,308.08,295.21648648648653,364.3146153846154,300.0040500000003,295.2415,279.54379999999986,294.0165000000005,289.3778605495574,295.50962977726056,297.61538461538396,311.460789552397,283.76997967837104,300.0040500000003,295.2415,279.54379999999986,294.0165000000005,307.1033333333333,74267162,91838907.35,66.797526742204,1.5,2.75,6.027652572954923,0.8086677438023766,1.1109219143335831,6.485545009340741,5.3746230950071565,16.315038956618707,5.517690173647963,9336584896.0,2020-06-02,2020,1,154,6,0.99,306.62,313.22,309.94,5135
2020-06-03 13:30:00,310.24,313.22,309.94,312.18,296.787027027027,364.6650961538462,300.12070000000017,295.0968,281.32839999999993,295.3160000000006,290.2720620966336,297.0972840841881,299.70846153846094,313.5012039916077,285.91571908531415,300.12070000000017,295.0968,281.32839999999993,295.3160000000006,311.7800000000001,92567574,92488789.15,69.54417058590599,1.5,2.75,5.964248817743861,1.0008518313486858,1.3056554679511994,7.006692429946157,5.701036961994957,14.009582110422544,5.1358906139494165,9429152470.0,2020-06-03,2020,2,155,6,1.06,311.58,313.0,309.08,5136
2020-06-04 13:30:00,311.11,313.0,309.08,311.36,298.3575675675676,365.0155769230769,300.2158500000002,294.9533,282.6925999999998,296.6715000000005,291.0990400536284,298.4556379809321,301.6376923076917,314.3514502193714,288.923934396012,300.2158500000002,294.9533,282.6925999999998,296.6715000000005,311.14666666666665,75794363,92596875.9,68.32675904919661,1.5,2.75,5.818231045047871,0.8185412549107394,1.2549603195386014,7.269737361418207,6.014777041879608,13.286383193992439,5.588714053174178,9353358107.0,2020-06-04,2020,3,156,6,1.27,311.04,321.275,317.16,5137
2020-06-05 13:30:00,317.23,321.275,317.16,319.34,299.9281081081081,365.36605769230766,300.36210000000017,294.8672,284.1435999999999,298.25450000000063,292.20652867897627,300.444624839891,303.50999999999937,318.6916650551354,288.32833494486334,300.36210000000017,294.8672,284.1435999999999,298.25450000000063,319.25833333333327,150524674,96360589.0,73.23683180003351,1.5,2.75,6.110857398973019,1.5620979029092483,1.611827872061978,8.029561881957079,6.417734009895102,15.594048257077286,8.089629027890597,9503882781.0,2020-06-05,2020,4,157,6,1.3,319.22,323.41,319.63,5138
2020-06-08 13:30:00,320.22,323.41,319.63,323.2,301.49864864864867,323.41,300.51585000000017,294.82469999999995,285.3835999999999,299.7925000000006,293.42195892685953,302.6118034265681,305.912307692307,322.8153800645553,289.00923532005874,300.51585000000017,294.82469999999995,285.3835999999999,299.7925000000006,322.08,73641217,96211543.45,75.23657926736236,1.5,2.75,5.965081870474951,0.7654093714676812,1.9388377862430148,8.84128124269887,6.9024434564558526,15.230182145684864,8.064731844322589,9577523998.0,2020-06-08,2020,0,160,6,1.18,321.52,323.2849,319.36,5139
2020-06-09 13:30:00,320.3,323.2849,319.36,320.79,303.06918918918916,323.2038157894737,300.6580000000002,294.7507,286.7309999999999,301.20700000000056,294.49521543953165,304.34306024308535,307.74769230769164,325.51058908088885,289.98479553449437,300.6580000000002,294.7507,286.7309999999999,301.20700000000056,321.1449666666667,77479228,96109793.3,71.63749161348194,1.5,2.75,5.819354594012452,0.8061533100810446,1.8254353554518181,9.184237650770628,7.3588022953188075,17.686489155611987,5.6864230883273645,9500044770.0,2020-06-09,2020,1,161,6,1.23,321.32,322.39,318.2209,5140
2020-06-10 13:30:00,321.42,322.39,318.2209,319.0,304.63972972972977,322.9976315789474,300.82875000000024,294.6315,287.8779999999999,302.8235000000005,295.4561873830795,305.73895926755335,309.60307692307634,326.62547553308264,292.58067831306994,300.82875000000024,294.6315,287.8779999999999,302.8235000000005,319.8703,95000766,96066292.3,68.99741298513769,1.5,2.75,5.701479265868708,0.9889084269363438,1.4773421569919734,9.205479991558775,7.728137834566803,18.26639224019036,5.290952899627017,9405044004.0,2020-06-10,2020,2,162,6,1.31,320.31,312.15,300.01,5141
2020-06-11 13:30:00,311.46,312.15,300.01,300.61,306.21027027027026,322.79144736842113,300.8918000000002,294.3181,288.7351999999999,303.7740000000005,295.6582976817823,305.2504869563578,310.00076923076864,325.88451314428744,294.11702531724967,300.8918000000002,294.3181,288.7351999999999,303.7740000000005,304.25666666666666,209243560,99292415.35,49.01268089265277,1.5,2.75,6.650659318306657,2.107346862924309,-0.0623434282514328,7.650208549252511,7.712551977503943,41.3188946506039,-1.2191114616193413,9195800444.0,2020-06-11,2020,3,163,6,4.05,306.08,309.08,298.6,5142
2020-06-12 13:30:00,308.24,309.08,298.6,304.21,307.7808108108108,322.5852631578948,300.97850000000017,294.0472000000001,289.8963999999998,304.7360000000005,295.9936585570065,305.1513929605143,310.39538461538393,325.4051119544491,295.38565727631874,300.97850000000017,294.0472000000001,289.8963999999998,304.7360000000005,303.96333333333337,194678879,102927464.8,51.94689902807394,1.5,2.75,6.924183652713323,1.891418188316244,-0.8646906533275756,6.631688660844475,7.496379314172049,41.88066752288329,-0.43855342824416027,9390479323.0,2020-06-12,2020,4,164,6,3.51,303.84,308.28,296.74,5143
2020-06-15 13:30:00,298.02,308.28,296.74,307.05,296.74,322.37907894736844,301.06930000000017,293.8043,291.0007999999998,305.77450000000056,296.4272405743789,305.3322126785605,310.6661538461532,325.2928281902069,296.0394795020995,301.06930000000017,293.8043,291.0007999999998,305.77450000000056,304.0233333333333,135782724,104159287.2,54.18676337593787,1.5,2.75,7.253884820376654,1.3036065016389629,-1.209358731107856,5.984680900287231,7.194039631395087,42.1746129485962,-0.334328745780308,9526262047.0,2020-06-15,2020,0,167,6,3.89,302.51,315.64,307.67,5144
2020-06-16 13:30:00,315.48,315.64,307.67,312.96,297.7100000000001,322.1728947368421,301.17120000000017,293.6167,292.2961999999998,306.67250000000047,297.07558408126596,306.0586686139357,311.43461538461474,325.39783876250493,297.47139200672456,301.17120000000017,293.6167,292.2961999999998,306.67250000000047,312.09,137627502,105024650.85,58.519823526107686,1.5,2.75,7.349321618921176,1.3104304645255578,-1.0504177148108402,5.881017487881537,6.931435202692376,43.34056128292638,0.24985585239284155,9663889549.0,2020-06-16,2020,1,168,6,2.59,311.65,314.39,310.86,5145
2020-06-17 13:30:00,314.07,314.39,310.86,311.66,298.68,321.9667105263158,301.2672500000002,293.4456,293.2321999999998,307.6570000000005,297.647521960432,306.5921287459418,311.9992307692301,325.3460424577527,298.65241908070755,301.2672500000002,293.4456,293.2321999999998,307.6570000000005,312.30333333333334,83398944,104435132.25,57.237421029167976,1.5,2.75,7.076512931855376,0.7985717277626179,-1.0418874672631144,5.629075868613484,6.670963335876597,42.77671467515117,0.09635149023638596,9580490605.0,2020-06-17,2020,2,169,6,1.14,312.62,312.3,309.51,5146
2020-06-18 13:30:00,310.005,312.3,309.51,311.78,299.6500000000001,321.7605263157895,301.37245000000024,293.3284,294.1651999999998,308.3995000000005,298.2017367855131,307.0862117225188,312.47846153846086,325.30171408675636,299.6552089901653,301.37245000000024,293.3284,294.1651999999998,308.3995000000005,311.19666666666666,80828658,104183480.6,57.33037389020917,1.5,2.75,6.770333436722852,0.7758298871807898,-1.0350831903875175,5.377109347892201,6.412192538279718,42.74823478338235,-2.3673827268741787,9661319263.0,2020-06-18,2020,3,170,6,0.9,310.9,314.38,306.53,5147
2020-06-19 13:30:00,314.17,314.38,306.53,308.64,300.62,321.5543421052632,301.44545000000016,293.1459,294.8573999999998,309.0875000000005,298.6110804409832,307.2341915584694,312.52153846153783,325.2890401053637,299.7540368177119,301.44545000000016,293.1459,294.8573999999998,309.0875000000005,309.85,135549624,107046265.55,54.02136803308715,1.5,2.75,6.847452476956934,1.2662713949295732,-1.2354038300078116,4.867937750769954,6.103341580777767,39.8588370817793,-4.5049504950495045,9525769639.0,2020-06-19,2020,4,171,6,2.56,310.46,311.05,306.75,5148
2020-06-22 13:30:00,307.99,311.05,306.75,310.62,301.5900000000001,321.34815789473686,301.50945000000024,292.9859,295.5057999999998,309.8465000000005,299.0820184629054,307.5566495052818,312.4015384615378,325.20888694387884,299.5941899791968,301.50945000000024,292.9859,295.5057999999998,309.8465000000005,309.4733333333333,74649389,107580825.0,55.75553894236255,1.5,2.75,6.665491585745724,0.6938912115611681,-1.225483041696748,4.571487778656831,5.79697082035358,39.189618626050034,-3.170298326007673,9600419028.0,2020-06-22,2020,0,174,6,1.4,308.9,314.5,311.6101,5149
2020-06-23 13:30:00,313.49,314.5,311.6101,312.05,302.56,321.1419736842105,301.5794500000003,292.8296,296.2335999999998,310.4950000000005,299.59056675847773,307.98458764763586,312.45461538461467,325.24997179084124,299.65925897838815,301.5794500000003,292.8296,296.2335999999998,310.4950000000005,312.72003333333333,68471246,106556815.2,57.01647597683654,1.5,2.75,6.466527901049602,0.6425796967700663,-1.1166136548861232,4.401203751745925,5.517817406632048,39.4050570769796,-2.1786833855799337,9668890274.0,2020-06-23,2020,1,175,6,0.93,313.06,310.51,302.1,5150
2020-06-24 13:30:00,309.84,310.51,302.1,304.09,303.5300000000001,320.9357894736842,301.6089000000003,292.6532,296.6395999999998,310.5230000000005,299.7670151208904,307.61367453833725,311.28153846153776,324.1329085678606,298.4301683552149,301.6089000000003,292.6532,296.6395999999998,310.5230000000005,305.56666666666666,132813492,107956617.35,48.696960081387395,1.5,2.75,6.7153473366889145,1.2302487356510343,-1.5481351915042982,3.582648417251676,5.130783608755974,41.58433055610457,1.157646119556888,9536076782.0,2020-06-24,2020,2,176,6,2.78,306.3,307.64,301.28,5151
2020-06-25 13:30:00,303.47,307.64,301.28,307.35,304.5,320.7296052631579,301.65500000000026,292.48549999999994,297.23139999999984,310.7420000000005,300.0643870769339,307.58856267754317,310.062307692307,321.0286201749788,299.09599520963525,301.65500000000026,292.48549999999994,297.23139999999984,310.7420000000005,305.42333333333335,89467968,107891625.4,51.79897024704334,1.5,2.75,6.6899653840682785,0.829239226569294,-1.576179516519515,3.1605592131065805,4.7367387296260945,23.443057727709093,1.0321817165773786,9625544750.0,2020-06-25,2020,3,177,6,2.11,304.46,306.39,299.42,5152
2020-06-26 13:30:00,306.16,306.39,299.42,300.05,305.47,320.5234210526316,301.6540000000003,292.19539999999995,297.6503999999997,310.52850000000063,300.06382287783845,306.870604327301,308.4669230769224,318.7389115283231,298.1949346255217,301.6540000000003,292.19539999999995,297.6503999999997,310.52850000000063,301.9533333333333,127961017,108326391.15,45.207258183674895,1.5,2.75,6.77853928520626,1.1812543152371044,-2.0201841100642453,2.2115085920457886,4.231692702110034,26.82876564346901,-2.279758996906041,9497583733.0,2020-06-26,2020,4,178,6,2.33,302.9,304.61,298.93,5153
2020-06-29 13:30:00,301.41,304.61,298.93,304.46,306.44,320.31723684210533,301.6698500000003,291.9113999999999,298.0067999999997,310.47400000000056,300.2362219806683,306.64102296279617,307.34846153846087,315.793158904826,298.90376417209575,301.6698500000003,291.9113999999999,298.0067999999997,310.47400000000056,302.6666666666667,79773260,109476062.35,49.396701703557405,1.5,2.75,6.700072193405813,0.7286822186293221,-1.949719835424374,1.794542907829566,3.7442627432539397,27.753734232579287,-2.716002044989775,9577356993.0,2020-06-29,2020,0,181,6,1.9,301.77,310.2,303.82,5154
2020-06-30 13:30:00,303.99,310.2,303.82,308.36,307.41,320.11105263157896,301.7062000000003,291.65519999999987,298.5421999999998,310.48800000000057,300.5548015108382,306.8047350615775,307.9446153846147,315.4436024562578,300.4456283129716,301.7062000000003,291.65519999999987,298.5421999999998,310.48800000000057,307.46,113394772,111432442.85,52.83146191957942,1.5,2.75,6.677209893876827,1.0176100343832677,-1.5885934974922629,1.7585208713886118,3.3471143688808747,26.293600995261308,-1.0588461785278864,9690751765.0,2020-06-30,2020,1,182,6,2.1,307.01,311.89,309.07,5155
2020-07-01 13:30:00,309.57,311.89,309.07,310.52,308.38,319.90486842105264,301.75800000000027,291.43839999999994,299.2917999999998,310.4050000000005,300.9455936084523,307.15856981761766,308.4299999999993,315.71297487823887,301.14702512175967,301.75800000000027,291.43839999999994,299.2917999999998,310.4050000000005,310.49333333333334,72396542,110423891.25,54.666766399807386,1.5,2.75,6.452409187171337,0.6556238978763574,-1.1716386578383842,1.8825660465828944,3.0542047044212786,26.651959573025426,-0.40413111809609054,9763148307.0,2020-07-01,2020,2,183,7,0.91,310.48,315.7,311.51,5156
2020-07-02 13:30:00,314.24,315.7,311.51,312.23,309.35,319.6986842105263,301.8145500000003,291.2138999999999,299.9543999999998,310.4485000000005,301.3881193492973,307.64156316832083,308.82846153846083,316.32937777441964,301.32754530250213,301.8145500000003,291.2138999999999,299.9543999999998,310.4485000000005,313.1466666666667,69344217,110101383.95,56.12231417708055,1.5,2.75,6.361522816659101,0.6298214837289517,-0.7675966037815991,2.0947089496942795,2.8623055534758786,26.864388547471666,1.1631674442716535,9832492524.0,2020-07-02,2020,3,184,7,1.35,313.6,317.68,315.56,5157
2020-07-06 13:30:00,316.37,317.68,315.56,317.05,310.32,319.49250000000006,301.89430000000027,291.03179999999986,300.7137999999997,310.33400000000063,302.0023107473641,308.53760477133784,309.1430769230762,317.59373874374177,300.6924151024106,301.89430000000027,291.03179999999986,300.7137999999997,310.33400000000063,316.7633333333333,61713828,105660841.65,60.019029754485246,1.5,2.75,6.296414044040594,0.5840747341803897,-0.19260614329458647,2.621547874357645,2.814154017652232,27.269996270224482,2.0700534415040908,9894206352.0,2020-07-06,2020,0,188,7,0.67,316.62,317.52,313.37,5158
2020-07-07 13:30:00,315.38,317.52,313.37,313.78,311.29,319.28631578947375,301.9578000000003,290.79539999999986,301.32999999999976,309.86300000000057,302.46418091413415,309.03688050740084,309.3061538461531,318.022449948953,300.5898577433532,301.9578000000003,290.79539999999986,301.32999999999976,309.86300000000057,314.89,82909963,106124278.95,56.362013497945036,1.5,2.75,6.143098755180549,0.7812534871408895,-0.05645639546759451,2.7435835233177386,2.800039918785333,28.11758844068595,0.5543983336003722,9811296389.0,2020-07-07,2020,1,189,7,1.32,315.44,316.3,312.7,5159
2020-07-08 13:30:00,314.61,316.3,312.7,316.18,312.26,319.08013157894743,302.0473000000003,290.58659999999986,301.9125999999998,309.63250000000056,303.0020561724034,309.7171776019342,309.64461538461467,319.03455309355235,300.254677675677,302.0473000000003,290.58659999999986,301.9125999999998,309.63250000000056,315.05999999999995,54638596,104982247.35,58.36705437964178,1.5,2.75,5.9614488440962266,0.5204555758636081,0.159474130055012,2.9993825813540984,2.8399084512990864,28.311111035424513,3.9757966391528927,9865934985.0,2020-07-08,2020,2,190,7,1.15,314.5,317.1,310.68,5160
2020-07-09 13:30:00,316.84,317.1,310.68,314.38,313.23,318.8739473684211,302.1281500000003,290.35439999999994,302.4855999999998,309.40150000000057,303.44825004799543,310.1612559255595,310.0861538461532,319.78049331574863,300.3918143765577,302.1281500000003,290.35439999999994,302.4855999999998,309.40150000000057,314.05333333333334,83354158,104399916.95,56.27849442934468,1.5,2.75,5.994202498089355,0.7984121102310896,0.1456926046356406,3.0220242070936365,2.876331602457996,23.142950749863466,2.2872946152594666,9782580827.0,2020-07-09,2020,3,191,7,2.07,313.89,317.88,312.76,5161
2020-07-10 13:30:00,314.31,317.88,312.76,317.59,314.2,318.6677631578948,302.23675000000026,290.1629999999999,302.9731999999998,310.2505000000006,304.0028284774858,310.8687553612205,310.622307692307,321.1136437628262,300.1309716217878,302.23675000000026,290.1629999999999,302.9731999999998,310.2505000000006,316.07666666666665,57550365,96815257.2,59.089920717661656,1.5,2.75,5.931759462511544,0.594434871779693,0.3080488990931252,3.2613927263244022,2.9533438272312766,23.08630358508369,5.845692384602554,9840131192.0,2020-07-10,2020,4,192,7,1.64,315.32,322.71,314.13,5162
2020-07-13 13:30:00,320.13,322.71,314.13,314.84,315.17,318.4615789473685,302.32285000000024,289.92799999999994,303.4603999999998,310.7820000000006,304.42781559601576,311.2469691363424,310.8369230769224,321.54814331802885,300.1257028358159,302.32285000000024,289.92799999999994,303.4603999999998,310.7820000000006,317.22666666666663,102997484,92231187.45,55.780684442081935,1.5,2.75,6.120919500903575,1.1167316267703544,0.19123859935006227,3.192392076418855,3.0011534770687933,17.446527137692446,3.409314852525782,9737133708.0,2020-07-13,2020,0,195,7,2.73,318.42,319.76,312.0,5163
2020-07-14 13:30:00,313.3,319.76,312.0,318.92,316.14,318.2553947368422,302.4324500000002,289.74769999999995,304.1829999999998,311.3755000000006,304.99613655303483,311.97773398050026,311.9776923076916,322.7304498183482,301.22493479703496,302.4324500000002,289.74769999999995,304.1829999999998,311.3755000000006,316.8933333333334,93656951,90124898.8,59.412461918161924,1.5,2.75,6.237996679410462,1.0391906370717612,0.3410142480733533,3.427421287160485,3.0864070390871317,17.12032086230587,3.4245686859514857,9830790659.0,2020-07-14,2020,1,196,7,2.49,315.88,323.04,319.265,5164
2020-07-15 13:30:00,322.41,323.04,319.265,321.85,317.11,318.0492105263158,302.5647000000002,289.63139999999987,304.94859999999983,311.8200000000006,305.65707237448436,312.9179497918812,313.09307692307624,324.6708364635299,301.51531738262264,302.5647000000002,289.63139999999987,304.94859999999983,311.8200000000006,321.3850000000001,87196524,87603349.9,61.83654258585203,1.5,2.75,6.086711202309715,0.9953560463102792,0.5758617638268815,3.806234243870733,3.2303724800438522,16.618293015199285,3.6487182790158577,9917987183.0,2020-07-15,2020,2,197,7,1.18,321.15,321.28,319.09,5165
2020-07-16 13:30:00,319.79,321.28,319.09,320.79,318.0800000000001,317.8430263157896,302.68480000000017,289.61509999999987,305.64059999999984,312.2765000000006,306.2505205166615,313.6676688593211,314.6884615384609,324.1619414324653,305.2149816444565,302.68480000000017,289.61509999999987,305.64059999999984,312.2765000000006,320.38666666666666,54622520,86164528.7,60.43038925825893,1.5,2.75,5.849088973573309,0.6339327890967736,0.5957745987990188,3.9750907285426247,3.3793161297436063,17.04781732820935,2.7415687153700805,9863364663.0,2020-07-16,2020,3,198,7,0.69,320.18,322.57,319.735,5166
2020-07-17 13:30:00,321.88,322.57,319.735,321.72,319.05,317.63684210526316,302.8272000000003,289.7057999999999,306.3899999999998,312.77350000000064,306.85716677091006,314.43455753938576,316.0161538461532,324.12279514426893,307.90951254803747,302.8272000000003,289.7057999999999,306.3899999999998,312.77350000000064,321.3416666666667,62774911,85261841.35,61.262687042806505,1.5,2.75,5.633796904032358,0.7362603247367001,0.6055659362941532,4.136273550111299,3.5307076138171447,16.988257333640686,1.4729537927771694,9926139574.0,2020-07-17,2020,4,199,7,0.89,321.15,325.13,320.62,5167
2020-07-20 13:30:00,321.43,325.13,320.62,324.32,320.0200000000001,317.43065789473684,303.00850000000025,289.83399999999995,307.1227999999998,313.55750000000063,307.54198376028614,315.3760282499205,317.24384615384554,325.1728679713501,309.31482433634096,303.00850000000025,289.83399999999995,307.1227999999998,313.55750000000063,323.3566666666666,56308749,81299797.6,63.569723766348254,1.5,2.75,5.553525696601474,0.6926062630197741,0.7136953284790577,4.422826774415967,3.709131445936909,15.509688556814568,3.3590413665625665,9982448323.0,2020-07-20,2020,0,202,7,1.41,322.88,326.93,323.94,5168
2020-07-21 13:30:00,326.45,326.93,323.94,325.01,320.99,317.22447368421064,303.18145000000027,290.10899999999987,307.77419999999984,314.2770000000006,308.2270040049808,316.2935493689757,318.358461538461,326.2671280453677,310.4497950315542,303.18145000000027,290.10899999999987,307.77419999999984,314.2770000000006,325.2933333333333,57498967,80442276.5,64.17942627103184,1.5,2.75,5.370416718272799,0.7147854275357312,0.7542743928940658,4.651974437054491,3.8977000441604255,13.288947964978625,2.7927130115756795,10039947290.0,2020-07-21,2020,1,203,7,0.92,325.44,327.2,324.5,5169
2020-07-22 13:30:00,324.62,327.2,324.5,326.86,321.9600000000001,317.01828947368426,303.3440000000003,290.415,308.4613999999998,315.0175000000006,308.95770973027567,317.29987800050185,319.48384615384555,327.73996756941847,311.2277247382726,303.3440000000003,290.415,308.4613999999998,315.0175000000006,326.18666666666667,57792915,79908359.95,65.83062690515587,1.5,2.75,5.179672666967599,0.7232399092680916,0.8226963450329245,4.9260704754515805,4.103374130418657,13.115464354326114,3.9697181754564603,10097740205.0,2020-07-22,2020,2,204,7,0.83,325.85,327.23,321.48,5170
2020-07-23 13:30:00,326.47,327.23,321.48,322.96,322.93,316.81210526315795,303.4934000000003,290.55369999999994,309.1871999999998,315.96100000000064,309.5068191526178,317.83893723854925,319.9384615384609,328.259052664498,311.6178704124238,303.4934000000003,290.55369999999994,309.1871999999998,315.96100000000064,323.8900000000001,75737989,77054584.8,59.59403062975347,1.5,2.75,5.22041033361277,0.9829134657799103,0.5361562296614135,4.773569417495423,4.23741318783401,15.050797975959187,1.6908592839824947,10022002216.0,2020-07-23,2020,3,205,7,1.79,324.36,321.99,319.246,5171
2020-07-24 13:30:00,320.95,321.99,319.246,320.88,323.9000000000001,316.60592105263163,303.65515000000033,290.7601,309.97279999999984,316.6375000000006,309.95282624467205,318.12856226344934,320.4846153846148,328.0107119942631,312.95851877496654,303.65515000000033,290.7601,309.97279999999984,316.6375000000006,320.70533333333333,73766597,76269516.25,56.51867715520861,1.5,2.75,5.1128095954975725,0.9671832289876364,0.15707981311276065,4.43376295422496,4.2766831411122,15.055968028303216,1.9184347605132832,9948235619.0,2020-07-24,2020,4,206,7,0.86,320.62,323.41,320.775,5172
2020-07-27 13:30:00,321.63,323.41,320.775,323.22,324.87,316.3997368421053,303.81490000000025,290.86369999999994,310.7377999999997,317.7960000000006,310.4731075684104,318.6134610955018,321.02615384615325,328.24210002736766,313.8102076649389,303.81490000000025,290.86369999999994,310.7377999999997,317.7960000000006,322.4683333333333,48292970,72286113.9,59.07723064992133,1.5,2.75,4.935823195819177,0.6680808718920495,0.02159130526792019,4.303672272697099,4.282080967429179,14.036978235636074,1.3483005142355484,9996528589.0,2020-07-27,2020,0,209,7,0.82,322.09,323.64,320.85,5173
2020-07-28 13:30:00,322.43,323.64,320.85,321.17,325.8400000000001,316.193552631579,303.95455000000027,291.05079999999987,311.43559999999974,318.6315000000006,310.89259354611977,318.8569409911683,321.54846153846086,327.6635115535204,315.43341152340145,303.95455000000027,291.05079999999987,311.43559999999974,318.6315000000006,321.88666666666666,57494979,71172199.85,55.97002538350247,1.5,2.75,4.782550110403519,0.8078291681467537,-0.2343272441296893,3.989171912267069,4.223499156396756,13.21682204947625,-0.21127854590648024,9939033610.0,2020-07-28,2020,1,210,7,0.87,322.24,325.73,322.075,5174
