time,open,high,low,close,Plot,Plot,Plot,Plot,MA,MA,MA,MA,EMA,EMA,Basis,Upper,Lower,MA,MA,MA,MA,VWAP,Volume,Volume MA,RSI,EMA Divergence,Min,Max,-Min,-Max,ATR,Plot,Plot,Histogram,MACD,Signal,HV,ROC,Plot,Plot,Plot,OnBalanceVolume
728317800,43.9688,43.96899,43.75,43.938,NaN,NaN,NaN,NaN,NaN,NaN,NaN,NaN,NaN,NaN,NaN,NaN,NaN,NaN,NaN,NaN,NaN,43.88566333333333,1003200,NaN,NaN,NaN,1.5,2.75,NaN,NaN,NaN,NaN,NaN,NaN,NaN,NaN,NaN,NaN,NaN,NaN,NaN,NaN
728577000,43.96875,44.25,43.96875,44.25,NaN,NaN,NaN,NaN,NaN,NaN,NaN,NaN,NaN,NaN,NaN,NaN,NaN,NaN,NaN,NaN,NaN,44.15625,480500,NaN,NaN,NaN,1.5,2.75,NaN,NaN,NaN,NaN,NaN,NaN,NaN,NaN,NaN,NaN,NaN,NaN,NaN,480500
728663400,44.21875,44.375,44.125,44.34375,NaN,NaN,NaN,NaN,NaN,NaN,NaN,NaN,NaN,NaN,NaN,NaN,NaN,NaN,NaN,NaN,NaN,44.28125,201300,NaN,NaN,NaN,1.5,2.75,NaN,NaN,NaN,NaN,NaN,NaN,NaN,NaN,NaN,NaN,NaN,NaN,NaN,681800
728749800,44.40625,44.84375,44.375,44.8125,NaN,NaN,NaN,NaN,NaN,NaN,NaN,NaN,NaN,NaN,NaN,NaN,NaN,NaN,NaN,NaN,NaN,44.677083333333336,529400,NaN,NaN,NaN,1.5,2.75,NaN,NaN,NaN,NaN,NaN,NaN,NaN,NaN,NaN,NaN,NaN,NaN,NaN,1211200
728836200,44.96875,45.09375,44.875,45,NaN,NaN,NaN,NaN,NaN,NaN,NaN,NaN,NaN,NaN,NaN,NaN,NaN,NaN,NaN,NaN,NaN,44.989583333333336,531500,NaN,NaN,NaN,1.5,2.75,NaN,NaN,NaN,NaN,NaN,NaN,NaN,NaN,NaN,NaN,NaN,NaN,NaN,1742700
728922600,44.96875,45.0625,44.71875,44.96875,NaN,NaN,NaN,NaN,NaN,NaN,NaN,NaN,NaN,NaN,NaN,NaN,NaN,NaN,NaN,NaN,NaN,44.916666666666664,492100,NaN,NaN,NaN,1.5,2.75,NaN,NaN,NaN,NaN,NaN,NaN,NaN,NaN,NaN,NaN,NaN,NaN,NaN,1250600
729181800,44.96875,45.125,44.90625,44.96875,NaN,NaN,NaN,NaN,NaN,NaN,NaN,NaN,NaN,NaN,NaN,NaN,NaN,NaN,NaN,NaN,NaN,45,596100,NaN,NaN,NaN,1.5,2.75,NaN,NaN,NaN,NaN,NaN,NaN,NaN,NaN,NaN,NaN,NaN,NaN,NaN,1250600
729268200,44.8125,44.8125,44.5625,44.65625,NaN,NaN,NaN,NaN,NaN,NaN,NaN,NaN,NaN,NaN,NaN,NaN,NaN,NaN,NaN,NaN,NaN,44.677083333333336,122100,NaN,NaN,NaN,1.5,2.75,NaN,NaN,NaN,NaN,NaN,NaN,NaN,NaN,NaN,NaN,NaN,NaN,NaN,1128500
729354600,44.65625,44.75,44.53125,44.71875,NaN,NaN,NaN,NaN,NaN,NaN,NaN,NaN,NaN,NaN,NaN,NaN,NaN,NaN,NaN,NaN,NaN,44.66666666666666,379600,NaN,NaN,NaN,1.5,2.75,NaN,NaN,NaN,NaN,NaN,NaN,NaN,NaN,NaN,NaN,NaN,NaN,NaN,1508100
729441000,44.78125,45.125,44.78125,44.9375,NaN,NaN,NaN,NaN,NaN,NaN,NaN,NaN,NaN,NaN,NaN,NaN,NaN,NaN,NaN,NaN,NaN,44.947916666666664,19500,NaN,NaN,NaN,1.5,2.75,NaN,NaN,NaN,NaN,NaN,NaN,NaN,NaN,NaN,2.2747963038827383,NaN,NaN,NaN,1527600
729527400,44.875,44.875,44.59375,44.59375,NaN,NaN,NaN,NaN,NaN,NaN,NaN,NaN,NaN,NaN,NaN,NaN,NaN,NaN,NaN,NaN,NaN,44.6875,42500,NaN,NaN,NaN,1.5,2.75,NaN,NaN,NaN,NaN,NaN,NaN,NaN,NaN,10.367037049441187,0.7768361581920904,NaN,NaN,NaN,1485100
729873000,44.46875,44.46875,43.40625,43.46875,NaN,NaN,NaN,NaN,NaN,NaN,NaN,NaN,NaN,NaN,NaN,NaN,NaN,NaN,NaN,NaN,NaN,43.78125,374800,NaN,NaN,NaN,1.5,2.75,NaN,NaN,NaN,NaN,NaN,NaN,NaN,NaN,17.99802810708158,-1.9732205778717407,NaN,NaN,NaN,1110300
729959400,43.46875,43.53125,43.28125,43.4375,NaN,NaN,NaN,45.75,NaN,NaN,NaN,NaN,NaN,NaN,44.46878846153846,45.527386533848826,43.41019038922809,NaN,NaN,NaN,NaN,43.416666666666664,210900,NaN,NaN,NaN,1.5,2.75,NaN,NaN,NaN,NaN,NaN,NaN,NaN,NaN,17.846629297646174,-3.0683403068340307,NaN,NaN,NaN,899400
730045800,43.9375,43.9375,42.8125,43.40625,NaN,NaN,NaN,45.80625,NaN,NaN,NaN,NaN,NaN,NaN,44.42788461538461,45.600330851898434,43.25543837887079,NaN,NaN,NaN,NaN,43.385416666666664,378100,NaN,NaN,NaN,1.5,2.75,NaN,NaN,0.43301714285714255,NaN,NaN,NaN,NaN,NaN,16.024665375797916,-3.5416666666666665,NaN,NaN,NaN,521300
730132200,43.40625,43.5625,43.34375,43.5625,NaN,NaN,NaN,45.8625,NaN,NaN,NaN,NaN,NaN,NaN,44.375,45.63362409614021,43.11637590385979,NaN,NaN,NaN,NaN,43.489583333333336,34900,NaN,44.43621277226252,NaN,1.5,2.75,NaN,NaN,0.41771234693877524,NaN,NaN,NaN,NaN,NaN,15.930222836046168,-3.1271716469770676,NaN,NaN,NaN,556200
730391400,43.6875,43.78125,43.5625,43.71875,NaN,NaN,NaN,45.91875,NaN,NaN,NaN,NaN,NaN,NaN,44.32692307692308,45.63348367318947,43.02036248065669,NaN,NaN,NaN,NaN,43.6875,513600,NaN,47.07529963522664,NaN,1.5,2.75,NaN,NaN,0.4035007507288627,NaN,NaN,NaN,NaN,NaN,16.362753113939927,-2.779708130646282,NaN,NaN,NaN,1069800
730477800,43.84375,43.875,43.46875,43.6875,NaN,NaN,NaN,45.975,NaN,NaN,NaN,NaN,NaN,NaN,44.24038461538461,45.55583108266636,42.92493814810287,NaN,NaN,NaN,NaN,43.677083333333336,373700,NaN,46.598595030528045,NaN,1.5,2.75,NaN,NaN,0.4036971256768011,NaN,NaN,NaN,NaN,NaN,16.322871353771525,-2.1693491952414274,NaN,NaN,NaN,696100
730564200,43.71875,44.25,43.71875,44.25,NaN,NaN,NaN,46.03125,NaN,NaN,NaN,NaN,NaN,NaN,44.18269230769231,45.423486813610765,42.94189780177385,NaN,NaN,NaN,NaN,44.072916666666664,26300,NaN,55.361077219383105,NaN,1.5,2.75,NaN,NaN,0.41504018812845817,NaN,NaN,NaN,NaN,NaN,18.32688019390691,-1.0482180293501049,NaN,NaN,NaN,722400
730650600,44.21875,44.375,44.125,44.34375,NaN,NaN,NaN,46.0875,NaN,NaN,NaN,NaN,NaN,NaN,44.13461538461539,45.295730309944936,42.97350045928584,NaN,NaN,NaN,NaN,44.28125,44500,NaN,56.6381501490259,NaN,1.5,2.75,NaN,NaN,0.4032516032621397,NaN,NaN,NaN,NaN,NaN,18.364518170585303,-1.321279554937413,NaN,NaN,NaN,766900
730737000,44.4375,44.4375,44.1875,44.40625,NaN,NaN,NaN,46.14375,NaN,NaN,NaN,44.2734625,NaN,44.2734625,44.09134615384615,45.1634076392111,43.019284668481205,NaN,NaN,NaN,44.2734625,44.34375,66200,321040,57.51086685307007,NaN,1.5,2.75,NaN,NaN,0.39230506017198685,0.20620483428856218,NaN,NaN,NaN,NaN,18.07524319270878,-0.4204625087596356,NaN,NaN,NaN,833100
730996200,44.5625,44.5625,44.21875,44.28125,NaN,NaN,NaN,46.2,NaN,NaN,NaN,44.290625,NaN,44.27420416666667,44.0625,45.091525864966236,43.033474135033764,NaN,NaN,NaN,44.290625,44.354166666666664,66500,274205,55.121403187911675,NaN,1.5,2.75,NaN,NaN,0.38883684158827353,0.24251928301817982,NaN,NaN,NaN,NaN,17.64792676479045,1.8691588785046729,NaN,NaN,NaN,766600
731082600,44.3125,44.9375,44.25,44.9375,NaN,NaN,NaN,46.25625,NaN,NaN,NaN,44.325,NaN,44.3373751984127,44.07932692307692,45.156743533889134,43.001910312264705,NaN,NaN,NaN,44.325,44.708333333333336,182400,259300,63.658295398737685,NaN,1.5,2.75,NaN,NaN,0.41016992433196825,0.7034323177786348,NaN,NaN,NaN,NaN,10.660379973517577,3.4532374100719423,NaN,NaN,NaN,949000
731169000,45,45.15625,44.9375,45.125,NaN,NaN,NaN,46.3125,NaN,NaN,NaN,44.3640625,NaN,44.41238708427816,44.09375,45.22061810708686,42.96688189291314,NaN,NaN,NaN,44.3640625,45.072916666666664,280100,263240,65.6677553973071,NaN,1.5,2.75,NaN,NaN,0.3964970725939705,1.0640480170186901,NaN,NaN,NaN,NaN,10.34734517278331,3.9596832253419727,NaN,NaN,NaN,1229100
731255400,45.1875,45.1875,44.875,44.875,NaN,NaN,NaN,46.36875,NaN,NaN,NaN,44.3671875,NaN,44.45644545720405,44.11538461538461,45.28962347877014,42.94114575199909,NaN,NaN,NaN,44.3671875,44.979166666666664,89500,241245,60.83751281687735,NaN,1.5,2.75,NaN,NaN,0.3904972816944011,0.3709921449149205,NaN,NaN,NaN,NaN,11.43438475775513,3.012912482065997,NaN,NaN,NaN,1139600
731341800,44.9375,45.125,44.71875,44.75,NaN,NaN,NaN,46.425,NaN,NaN,NaN,44.3546875,NaN,44.48440303270842,44.21394230769231,45.369469928669105,43.05841468671551,NaN,NaN,NaN,44.3546875,44.864583333333336,40000,216670,58.51972469808197,NaN,1.5,2.75,NaN,NaN,0.39162247585908677,0.1846125444223935,NaN,NaN,NaN,NaN,11.953684493914361,2.3588277340957826,NaN,NaN,NaN,1099600
731601000,44.84375,45.75,44.84375,45.75,NaN,NaN,NaN,46.48125,NaN,NaN,NaN,44.39375,NaN,44.60493607721238,44.39182692307692,45.714388036753085,43.069265809400754,NaN,NaN,NaN,44.39375,45.447916666666664,50800,194605,68.77023822887872,NaN,1.5,2.75,NaN,NaN,0.4350780132977234,0.2610415970812672,NaN,NaN,0.2817531754335363,NaN,16.35870317590811,4.721030042918455,NaN,NaN,NaN,1150400
731687400,45.65625,45.6875,45.5,45.59375,NaN,NaN,NaN,46.5375,NaN,NaN,NaN,44.425,NaN,44.69910883176358,44.56009615384615,45.89483484245299,43.22535746523932,NaN,NaN,NaN,44.425,45.59375,169300,173265,66.02477499386558,NaN,1.5,2.75,NaN,NaN,0.42185815520502884,0.9771159784145673,NaN,NaN,0.33121674563858505,NaN,16.74505152142331,3.036723163841808,NaN,NaN,NaN,981100
731773800,45.59375,45.6875,45.40625,45.6875,NaN,NaN,NaN,46.59375,NaN,NaN,NaN,44.4765625,NaN,44.793241323976574,44.72355769230769,46.050027793363334,43.39708759125205,NaN,NaN,NaN,44.4765625,45.59375,194400,176880,66.8791576254194,NaN,1.5,2.75,NaN,NaN,0.41181471554752674,1.0990502035278156,NaN,NaN,0.37367433772929104,NaN,15.857799401731736,3.0303030303030303,NaN,NaN,NaN,1175500
731860200,45.71875,45.84375,45.5,45.5625,NaN,NaN,NaN,45.84375,NaN,NaN,NaN,44.51875,NaN,44.866504055026425,44.86538461538461,46.124339227742546,43.60643000302668,NaN,NaN,NaN,44.51875,45.635416666666664,70900,161445,64.54839037913911,NaN,1.5,2.75,NaN,NaN,0.40695295015127486,0.43915884666604726,NaN,NaN,0.39270892597437523,NaN,16.218722385472006,2.6038001407459537,NaN,NaN,NaN,1104600
731946600,45.1875,45.21875,44.8125,45.09375,NaN,NaN,NaN,45.849609375,NaN,NaN,NaN,44.5265625,NaN,44.88814652597629,44.97355769230769,46.03530690494346,43.911808479671926,NaN,NaN,NaN,44.5265625,45.041666666666664,643600,192650,56.58455992093022,NaN,1.5,2.75,NaN,NaN,0.4314563108547552,3.3407734233065143,NaN,NaN,0.36575358712394745,NaN,17.876637930490357,1.834862385321101,NaN,NaN,NaN,461000
732205800,45.0625,45.3125,45.0625,45.3125,NaN,NaN,NaN,45.85546875,NaN,NaN,NaN,44.5625,NaN,44.928561142549974,45.05528846153846,46.042634434845866,44.067942488231054,NaN,NaN,NaN,44.5625,45.229166666666664,310800,206065,59.11937114234976,NaN,1.5,2.75,NaN,NaN,0.4184951457937013,1.5082619561788757,NaN,NaN,0.35791674230240034,NaN,17.733926111470822,0.8344923504867872,NaN,NaN,NaN,771800
732292200,45.3125,45.4375,45.3125,45.3125,NaN,NaN,NaN,45.861328125,NaN,NaN,NaN,44.6546875,NaN,44.965126748021405,45.12980769230769,46.033807270121166,44.22580811449422,NaN,NaN,NaN,44.6546875,45.354166666666664,30800,188865,59.11937114234976,NaN,1.5,2.75,NaN,NaN,0.3975312068084369,0.16307944828316523,NaN,NaN,0.34769794089176287,NaN,15.884647994181341,0.4155124653739612,NaN,NaN,NaN,771800
732378600,45.25,45.25,44.96875,45.03125,NaN,NaN,NaN,45.8671875,NaN,NaN,NaN,44.734375,NaN,44.971424200590796,45.17788461538461,45.984030112258885,44.37173911851034,NaN,NaN,NaN,44.734375,45.083333333333336,21800,179410,54.384678263665045,NaN,1.5,2.75,NaN,NaN,0.3936896920364057,0.12150939189565799,NaN,NaN,0.3132934903177045,NaN,16.202051635743715,0.34818941504178275,NaN,NaN,NaN,750000
732465000,45.21875,45.5,45.21875,45.3125,NaN,NaN,NaN,45.873046875,NaN,NaN,NaN,44.8296875,NaN,45.00390761005834,45.25721153846154,45.876004682914925,44.638418394008156,NaN,NaN,NaN,44.8296875,45.34375,59300,163470,58.006512997584224,NaN,1.5,2.75,NaN,NaN,0.39905114260523383,0.36275769254297424,NaN,-0.035820293757658495,0.30520403769908455,0.34102433145674305,16.18989522973471,1.2569832402234637,NaN,NaN,NaN,809300
732551400,45.28125,45.28125,45.03125,45.03125,NaN,NaN,NaN,45.87890625,NaN,NaN,NaN,44.903125,NaN,45.006511647195644,45.26442307692308,45.870192307691326,44.658653846154834,NaN,NaN,NaN,44.903125,45.114583333333336,66900,165070,53.43724501112028,NaN,1.5,2.75,NaN,NaN,0.3906367752762886,0.4052826073786878,NaN,-0.05445775209083703,0.2729521413431968,0.3274098934340338,16.595943927607003,-1.5710382513661203,NaN,NaN,NaN,742400
732810600,44.59375,44.875,44.5625,44.78125,NaN,NaN,NaN,45.884765625,NaN,NaN,NaN,44.95625,NaN,44.98505815698653,45.23798076923077,45.89373308121689,44.582228457244646,NaN,NaN,NaN,44.95625,44.739583333333336,183400,148560,49.69032943447083,NaN,1.5,2.75,NaN,NaN,0.39621629132798225,1.2345180398492193,NaN,-0.0822239340105484,0.22462997592084832,0.3068539099313967,9.652789711322725,-1.7820424948594928,NaN,NaN,NaN,559000
732897000,44.90625,44.9375,44.8125,44.875,NaN,NaN,NaN,45.890625,NaN,NaN,NaN,45.015625,NaN,44.97457642774972,45.23798076923077,45.89373308121689,44.582228457244646,NaN,NaN,NaN,45.015625,44.875,55200,132635,51.07571384707228,NaN,1.5,2.75,NaN,NaN,0.37907584194741206,0.41617974139555924,NaN,-0.09213154696872616,0.19168947622048904,0.2838210231892152,9.899698390674232,-1.7783857729138166,NaN,NaN,NaN,614200
732983400,44.8125,45.0625,44.59375,44.875,NaN,NaN,NaN,45.896484375,NaN,NaN,NaN,45.046875,NaN,44.96509295844022,45.24759615384615,45.87760566349625,44.61758664419606,NaN,NaN,NaN,45.046875,44.84375,37200,133180,51.07571384707228,NaN,1.5,2.75,NaN,NaN,0.3854811389511683,0.27932121940231264,NaN,-0.09609930098804653,0.163696896954157,0.25979619794220354,9.691611185011734,-1.5089163237311385,NaN,NaN,NaN,614200
733069800,44.90625,45.25,44.84375,45.15625,NaN,NaN,NaN,45.90234375,NaN,NaN,NaN,45.0875,NaN,44.98329839096973,45.20192307692308,45.76180769362788,44.64203846021828,NaN,NaN,NaN,45.0875,45.083333333333336,110100,136460,55.35330039355918,NaN,1.5,2.75,NaN,NaN,0.38696462902608486,0.806829840246226,NaN,-0.07796832258201994,0.16233579471467863,0.24030411729669857,10.68925290316737,0.1386001386001386,NaN,NaN,NaN,724300
733156200,45.125,45.15625,44.875,44.90625,NaN,NaN,NaN,45.908203125,NaN,NaN,NaN,45.1125,NaN,44.975960448972614,45.14903846153846,45.680021904933554,44.618055018143366,NaN,NaN,NaN,45.1125,44.97916666666666,101500,138225,51.078238742056904,NaN,1.5,2.75,NaN,NaN,0.37941358409565024,0.7343100018086454,NaN,-0.08066217098804879,0.1394764035616376,0.22013857454968638,9.421770441812551,-0.896551724137931,NaN,NaN,NaN,622800
733415400,44.9375,45.3125,44.9375,45.09375,NaN,NaN,NaN,45.9140625,NaN,NaN,NaN,45.153125,NaN,44.98717850145141,45.10336538461539,45.533861950107124,44.67286881912365,NaN,NaN,NaN,45.153125,45.114583333333336,87100,139255,53.95078505364795,NaN,1.5,2.75,NaN,NaN,0.38133047094596095,0.6254712577645327,NaN,-0.06816332808691636,0.13493441444104093,0.2030977425279573,9.291808073713772,-0.4827586206896552,NaN,NaN,NaN,709900
733501800,45.15625,45.21875,45.09375,45.21875,NaN,NaN,NaN,45.919921875,NaN,NaN,NaN,45.1671875,NaN,45.00923292988461,45.07692307692308,45.42587014060765,44.72797601323851,NaN,NaN,NaN,45.1671875,45.177083333333336,56000,132935,55.813506514215035,NaN,1.5,2.75,NaN,NaN,0.36302115159267806,0.4212585097980216,NaN,-0.05063045657991433,0.13980967180306436,0.1904401283829787,9.478017441825019,0.4163775156141568,NaN,NaN,NaN,765900
733588200,45.34375,45.46875,45.1875,45.1875,NaN,NaN,NaN,45.92578125,NaN,NaN,NaN,45.1703125,NaN,45.02621074608608,45.08413461538461,45.43801473499357,44.730254495775654,NaN,NaN,NaN,45.1703125,45.28125,111600,124510,55.21221434927015,NaN,1.5,2.75,NaN,NaN,0.3571803550503439,0.896313549112521,NaN,-0.04071756848365812,0.13954316777840603,0.18026073626206415,8.693462413643736,-0.27586206896551724,NaN,NaN,NaN,654300
733674600,45.25,45.25,44.9375,45.03125,NaN,NaN,NaN,45.931640625,NaN,NaN,NaN,45.178125,NaN,45.02669067503026,45.0625,45.39139675723982,44.73360324276018,NaN,NaN,NaN,45.178125,45.072916666666664,129500,126510,52.184977343666766,NaN,1.5,2.75,NaN,NaN,0.35398890111817644,1.0236344952968144,NaN,-0.043984792742248285,0.1252797453342538,0.16926453807650207,8.051639366026354,0,NaN,NaN,NaN,524800
733761000,44.65625,44.65625,44.09375,44.09375,NaN,NaN,NaN,45.9375,NaN,NaN,NaN,45.1453125,NaN,44.93783918217024,44.96875,45.55402606898187,44.38347393101813,NaN,NaN,NaN,45.1453125,44.28125,59400,127480,38.53336080053536,NaN,1.5,2.75,NaN,NaN,0.395668265324021,0.4659554439912143,NaN,-0.10509908240684743,0.0378906850679428,0.14298976747479022,14.05334161460427,-1.5352407536636428,NaN,NaN,NaN,465400
734016600,44.4375,44.4375,44.1875,44.3125,NaN,NaN,NaN,45.943359375,NaN,NaN,NaN,45.0734375,NaN,44.878283069582594,44.91346153846154,45.592895801036384,44.234027275886696,NaN,NaN,NaN,45.0734375,44.3125,172200,133550,42.32467764931084,NaN,1.5,2.75,NaN,NaN,0.39195981780087663,1.2894047173343317,NaN,-0.12523836407592254,-0.01355818762011296,0.11168017645580958,14.39572802705878,-1.2534818941504178,NaN,NaN,NaN,637600
734103000,44.40625,44.40625,44.0625,44.1875,NaN,NaN,NaN,45.94921875,NaN,NaN,NaN,45.003125,NaN,44.812494205812825,44.82692307692308,45.56505651765803,44.08878963618813,NaN,NaN,NaN,45.003125,44.21875,129700,131570,40.7768901015041,NaN,1.5,2.75,NaN,NaN,0.3885162593865283,0.9857870335182792,NaN,-0.14029144850001943,-0.0636841341692147,0.07660731433080473,14.279169496222579,-1.532033426183844,NaN,NaN,NaN,507900
734189400,44.25,44.34375,44.15625,44.34375,NaN,NaN,NaN,45.955078125,NaN,NaN,NaN,44.9359375,NaN,44.76785190049732,44.77403846153846,45.54386995774036,44.00420696533656,NaN,NaN,NaN,44.9359375,44.28125,28000,123250,43.55553925426715,NaN,1.5,2.75,NaN,NaN,0.3741579551446334,0.22718052738336714,NaN,-0.13309902492953588,-0.08976646683111511,0.04333255809842076,14.559050610409026,-1.7993079584775087,NaN,NaN,NaN,535900
734275800,44.53125,44.53125,44.09375,44.28125,NaN,NaN,NaN,45.9609375,NaN,NaN,NaN,44.871875,NaN,44.72150886235472,44.73557692307692,45.54885886360689,43.92229498254695,NaN,NaN,NaN,44.871875,44.302083333333336,180800,128745,42.69267876089121,NaN,1.5,2.75,NaN,NaN,0.37868238692001677,1.4043263816070528,NaN,-0.12599734100276727,-0.11416411815503835,0.011833222847728933,13.771184512777833,-1.3917884481558802,NaN,NaN,NaN,355100
734621400,44.71875,44.9375,44.65625,44.90625,NaN,NaN,NaN,45.966796875,NaN,NaN,44.68751,44.8625,44.68751,44.73910325641617,44.73798076923077,45.55307959432815,43.92288194413338,NaN,NaN,44.68751,44.8625,44.833333333333336,348500,113990,52.769134036775114,NaN,1.5,2.75,NaN,NaN,0.39850864499715843,3.057285726818142,NaN,-0.07516299563174728,-0.08212052169195516,-0.006957526060207886,16.25025653298511,-0.4158004158004158,NaN,NaN,NaN,703600
734707800,44.875,45.15625,44.84375,45,NaN,NaN,NaN,45.97265625,NaN,NaN,44.70875,44.846875,44.69976450980393,44.76395056532892,44.74759615384615,45.57183149968238,43.923360808009924,NaN,NaN,44.70875,44.846875,45,146100,105755,54.07360954469501,NaN,1.5,2.75,NaN,NaN,0.39236517035450424,1.3814949647770791,NaN,-0.0333145079262215,-0.048600660967984766,-0.015286153041763261,16.09855368950293,-0.4837595024187975,NaN,NaN,NaN,849700
734794200,45.03125,45.0625,44.90625,44.9375,NaN,NaN,NaN,45.978515625,NaN,NaN,44.7225,44.828125,44.70908747020378,44.78047908291664,44.73076923076923,45.52948306374245,43.93205539779602,NaN,NaN,44.7225,44.828125,44.96875,119600,110195,53.02222546253415,NaN,1.5,2.75,NaN,NaN,0.3754998010434682,1.0853487000317619,NaN,-0.009187528066411696,-0.02677056312477788,-0.017583035058366184,15.994024903792614,-0.5532503457814661,NaN,NaN,NaN,730100
734880600,44.90625,45.03125,44.75,44.9375,NaN,NaN,NaN,45.984375,NaN,NaN,44.734375,44.8234375,44.71804482431343,44.7954334559722,44.73317307692308,45.5341698210011,43.93217633284506,NaN,NaN,44.734375,44.8234375,44.90625,148600,116535,53.02222546253415,NaN,1.5,2.75,NaN,NaN,0.3687676723975062,1.275153387394345,NaN,0.006576722069673534,-0.009362132471274265,-0.0159388545409478,15.99786908111762,-0.2081887578070784,NaN,NaN,NaN,730100
734967000,44.96875,45.03125,44.875,44.9375,NaN,NaN,NaN,45.990234375,NaN,NaN,44.736875,44.8046875,44.72665090963447,44.80896360302247,44.72115384615385,45.504645452767086,43.93766223954061,NaN,NaN,44.736875,44.8046875,44.94791666666666,47900,115965,53.02222546253415,NaN,1.5,2.75,NaN,NaN,0.3535878386548272,0.4130556633466994,NaN,0.01625799750667004,0.004383642342389749,-0.01187435516428029,15.89079786242485,1.9135364989369241,NaN,NaN,NaN,730100
735226200,44.9375,45.0625,44.71875,44.75,NaN,NaN,NaN,45.99609375,NaN,NaN,44.731875,44.790625,44.727566560237044,44.803348021782234,44.68509615384615,45.41497921978276,43.95521308790955,NaN,NaN,44.731875,44.790625,44.84375,157000,120470,49.42167577248834,NaN,1.5,2.75,NaN,NaN,0.3528851358937681,1.3032290196729477,NaN,0.009616206562349853,0.0001459030386570248,-0.009470303523692828,9.462179699746601,0.9873060648801129,NaN,NaN,NaN,573100
735312600,44.6875,44.75,44.25,44.53125,NaN,NaN,NaN,46.001953125,NaN,NaN,44.723125,44.778125,44.7198678716003,44.77743392446964,44.63461538461539,45.30703951860851,43.96219125062226,NaN,NaN,44.723125,44.778125,44.510416666666664,279500,125275,45.53657166974976,NaN,1.5,2.75,NaN,NaN,0.3633933404727846,2.231091598483337,NaN,-0.008924611777307852,-0.020626068245327644,-0.011701456468019792,9.820367820538586,0.7779349363507779,NaN,NaN,NaN,293600
735399000,44.625,44.625,44.375,44.5,NaN,NaN,NaN,46.0078125,NaN,NaN,44.71375,44.759375,44.71124560212578,44.75101164594872,44.59375,45.22829253661162,43.95920746338838,NaN,NaN,44.71375,44.759375,44.5,67900,125910,44.99243086508984,NaN,1.5,2.75,NaN,NaN,0.3552938161533,0.5392740846636487,NaN,-0.021965416669972267,-0.03915822730548513,-0.01719281063551286,9.632198230100512,0.3523608174770965,NaN,NaN,NaN,225700
735485400,44.3125,44.6875,43.9375,43.9375,NaN,NaN,NaN,46.013671875,NaN,NaN,44.699375,44.7125,44.68090263733653,44.673534346334556,44.58173076923077,45.258233042282185,43.90522849617935,NaN,NaN,44.699375,44.7125,44.1875,97700,128935,36.53059023391249,NaN,1.5,2.75,NaN,NaN,0.38348711499949284,0.757746151161438,NaN,-0.06472836942103953,-0.09810327241181227,-0.03337490299077274,12.083802256057913,-0.776287932251235,NaN,NaN,NaN,128000
735571800,43.84375,43.96875,43.6875,43.75,NaN,NaN,NaN,46.01953125,NaN,NaN,44.68,44.6421875,44.64439665155863,44.58557869430269,44.53846153846154,45.33890982262643,43.73801325429665,NaN,NaN,44.68,44.6421875,43.802083333333336,106000,128730,34.22026968891166,NaN,1.5,2.75,NaN,NaN,0.3761844639281005,0.8234288821564515,NaN,-0.09979973101168821,-0.158124566755383,-0.05832483574369479,12.23691783518104,-2.5748086290883787,NaN,NaN,NaN,22000
735831000,43.78125,43.9375,43.28125,43.40625,NaN,NaN,NaN,46.025390625,NaN,NaN,44.649375,44.5671875,44.59584188090927,44.47326167579767,44.47836538461539,45.46972972452191,43.48700104470886,NaN,NaN,44.649375,44.5671875,43.541666666666664,62600,126785,30.421660733572693,NaN,1.5,2.75,NaN,NaN,0.3961891450760934,0.4937492605592144,NaN,-0.1379556997437381,-0.23076946042336743,-0.09281376067962932,7.996408706458668,-3.5416666666666665,NaN,NaN,NaN,-40600
735917400,43.34375,43.875,43.34375,43.875,NaN,NaN,NaN,46.03125,NaN,NaN,44.635,44.50625,44.567573571854005,44.41628437334075,44.44230769230769,45.4834811455628,43.40113423905259,NaN,NaN,44.635,44.50625,43.697916666666664,156800,130270,40.17410779004019,NaN,1.5,2.75,NaN,NaN,0.40583634899922955,1.2036539494895218,NaN,-0.12387856074542167,-0.2476619616114064,-0.12378340086598474,11.099496780754382,-2.364394993045897,NaN,NaN,NaN,116200
736003800,43.8125,43.90625,43.71875,43.78125,NaN,NaN,NaN,46.037109375,NaN,NaN,44.64125,44.434375,44.53673735334993,44.35580490921306,44.40384615384615,45.50139081805851,43.306301489633796,NaN,NaN,44.64125,44.434375,43.802083333333336,85900,131765,38.99681795855249,NaN,1.5,2.75,NaN,NaN,0.39024089549928453,0.6519181876826168,NaN,-0.11341576023226921,-0.26555310115632125,-0.15213734092405204,11.079651783488995,-2.5730180806675937,NaN,NaN,NaN,30300
736090200,43.875,43.96875,43.625,43.96875,NaN,NaN,NaN,46.04296875,NaN,NaN,44.651875,44.3734375,44.51446333949307,44.31894253690706,44.33173076923077,45.410798002852076,43.25266353560946,NaN,NaN,44.651875,44.3734375,43.854166666666664,85000,130435,42.61860518165225,NaN,1.5,2.75,NaN,NaN,0.3869201172493356,0.6516655805573658,NaN,-0.08755961894416181,-0.2615868646042543,-0.17402724566009248,11.7000028686131,-2.1557719054242,NaN,NaN,NaN,115300
736176600,44.125,44.28125,44.03125,44.03125,NaN,NaN,NaN,46.048828125,NaN,NaN,44.664375,44.3234375,44.49551379676785,44.291543247677815,44.25721153846154,45.27335344720246,43.24106962972062,NaN,NaN,44.664375,44.3234375,44.114583333333336,88500,128385,43.81602470861403,NaN,1.5,2.75,NaN,NaN,0.3816043945886688,0.6893328659890174,NaN,-0.061188293422599876,-0.25051261243834233,-0.18932431901574245,11.824242667713866,-1.606145251396648,NaN,NaN,NaN,203800
736435800,44.09375,44.3125,43.90625,44.3125,NaN,NaN,NaN,46.0546875,NaN,NaN,44.679375,44.334375,44.488336785129896,44.29353912885136,44.20913461538461,45.148198892192816,43.27007033857641,NaN,NaN,44.679375,44.334375,44.177083333333336,80500,129440,48.97599258046857,NaN,1.5,2.75,NaN,NaN,0.3833647949751925,0.6219097651421508,NaN,-0.0217769144067321,-0.2165454620241576,-0.19476854761742549,12.64340820043749,-0.49122807017543857,NaN,NaN,NaN,284300
736522200,44.40625,44.625,44.34375,44.46875,NaN,NaN,NaN,46.060546875,NaN,NaN,44.694375,44.3421875,44.48756867590912,44.31022587848456,44.17307692307692,45.02989887712949,43.31625496902435,NaN,NaN,44.694375,44.3421875,44.479166666666664,149100,128285,51.63359795276737,NaN,1.5,2.75,NaN,NaN,0.3783030239055359,1.1622559145652258,NaN,0.015814133915066392,-0.1750008802235925,-0.1908150141386589,12.6120789390479,-0.0702247191011236,NaN,NaN,NaN,433400
736608600,44.46875,44.75,44.46875,44.59375,NaN,NaN,NaN,46.06640625,NaN,NaN,44.7125,44.3625,44.49173264940288,44.33722817577174,44.14663461538461,44.92509487116075,43.368174359608474,NaN,NaN,44.7125,44.3625,44.604166666666664,109000,127250,53.710761235498985,NaN,1.5,2.75,NaN,NaN,0.3713706650551405,0.8565815324165029,NaN,0.048263303749827485,-0.13048588445137455,-0.17874918820120203,12.714989874978993,1.4935988620199145,NaN,NaN,NaN,542400
736695000,44.53125,44.5625,44.40625,44.4375,NaN,NaN,NaN,46.072265625,NaN,NaN,44.71625,44.3671875,44.489605878838056,44.34677787331729,44.12259615384615,44.84211352784009,43.403078779852216,NaN,NaN,44.71625,44.3671875,44.46875,54700,128585,50.7753146945026,NaN,1.5,2.75,NaN,NaN,0.35823704612263046,0.42539954115954426,NaN,0.05772988488058106,-0.1065868321004757,-0.16431671698105677,10.128676451735942,1.5714285714285714,NaN,NaN,NaN,487700
736781400,44.46875,44.46875,44.28125,44.34375,NaN,NaN,NaN,46.078125,NaN,NaN,44.71625,44.3703125,44.48388604045225,44.34648950442993,44.10817307692308,44.80138162542422,43.41496452842194,NaN,NaN,44.71625,44.3703125,44.364583333333336,68000,122945,49.04338892458942,NaN,1.5,2.75,NaN,NaN,0.34604154282815686,0.5530928463947293,NaN,0.0561521967361398,-0.09412647106088201,-0.15027866779702181,9.776683613213905,2.159827213822894,NaN,NaN,NaN,419700
737040600,44.40625,44.6875,44.40625,44.4375,NaN,NaN,NaN,46.083984375,NaN,NaN,44.716875,44.346875,44.482066980042354,44.3551571706747,44.10336538461539,44.78643001764748,43.42030075158329,NaN,NaN,44.716875,44.346875,44.510416666666664,113900,111215,50.848877619491745,NaN,1.5,2.75,NaN,NaN,0.34587786119757424,1.0241424268309132,NaN,0.059572709343629876,-0.07581278111748446,-0.13538549046111434,7.8108478705676925,1.2820512820512822,NaN,NaN,NaN,533600
737127000,44.4375,44.625,44.3125,44.625,NaN,NaN,NaN,46.08984375,NaN,NaN,44.72375,44.328125,44.487672196511284,44.3808564877533,44.15625,44.88470661398733,43.42779338601267,NaN,NaN,44.72375,44.328125,44.520833333333336,42600,106040,54.333879626215825,NaN,1.5,2.75,NaN,NaN,0.34349372825489033,0.4017351942663146,NaN,0.07179381615617017,-0.04564322026590162,-0.11743703642207179,5.916583515280622,1.9271948608137044,NaN,NaN,NaN,576200
737213400,44.4375,44.59375,44.4375,44.5625,NaN,NaN,NaN,46.095703125,NaN,NaN,44.71625,44.309375,44.49060662017751,44.398155869872035,44.21875,44.93640175291494,43.50109824708506,NaN,NaN,44.71625,44.309375,44.53125,31000,101610,52.98526419164441,NaN,1.5,2.75,NaN,NaN,0.3323513190938267,0.30508808188170455,NaN,0.07277226572321956,-0.026471704268047347,-0.0992439699912669,5.7550426273022195,1.3503909026297085,NaN,NaN,NaN,545200
737299800,44.375,44.375,44,44.03125,NaN,NaN,NaN,46.1015625,NaN,NaN,44.694375,44.2640625,44.47259263507251,44.36321245369375,44.26682692307692,44.826711539782536,43.7069423063713,NaN,NaN,44.694375,44.2640625,44.135416666666664,129100,100635,43.17550319557861,NaN,1.5,2.75,NaN,NaN,0.3487905105871248,1.2828538778754905,NaN,0.036572350963726005,-0.05352853128660939,-0.0901008822503354,9.502565737564456,0,NaN,NaN,NaN,416100
737386200,44.03125,44.15625,43.96875,44,NaN,NaN,NaN,46.107421875,NaN,NaN,44.676875,44.2171875,44.454059590559865,44.3286207914372,44.27644230769231,44.81288253856735,43.74000207681726,NaN,NaN,44.676875,44.2171875,44.041666666666664,63500,101415,42.67499343949531,NaN,1.5,2.75,NaN,NaN,0.3372697598309016,0.626140117339644,NaN,0.01079289318132827,-0.07660976577367506,-0.08740265895500333,9.476366873178462,-0.7052186177715092,NaN,NaN,NaN,352600
737645400,44.125,44.15625,43.9375,44.15625,NaN,NaN,NaN,46.11328125,NaN,NaN,44.665,44.1875,44.44238078308693,44.31220452558604,44.30528846153846,44.767277424366526,43.843299498710394,NaN,NaN,44.665,44.1875,44.083333333333336,34000,95265,46.043034259321736,NaN,1.5,2.75,NaN,NaN,0.3288040627001229,0.35689917598278487,NaN,0.004837390508939082,-0.08135592081882947,-0.08619331132776856,8.896827649947408,-0.7027406886858749,NaN,NaN,NaN,386600
737731800,44.1875,44.21875,43.96875,44.125,NaN,NaN,NaN,46.119140625,NaN,NaN,44.6325,44.1671875,44.42993447786784,44.29437552314928,44.31730769230769,44.75090716868817,43.883708215927214,NaN,NaN,44.6325,44.1671875,44.104166666666664,105200,86550,45.46765988585676,NaN,1.5,2.75,NaN,NaN,0.3231752010786856,1.2154823801270942,NaN,-0.0003574812205159317,-0.08664016285341347,-0.08628268163289754,8.548195542720569,-1.051156271899089,NaN,NaN,NaN,281400
737818200,44.125,45.03125,43.84375,45.03125,NaN,NaN,NaN,46.125,NaN,NaN,44.62125,44.19375,44.45351547873577,44.36455404475411,44.39423076923077,44.93828653070931,43.85017500775222,NaN,NaN,44.62125,44.19375,44.635416666666664,50200,85665,60.77582348159519,NaN,1.5,2.75,NaN,NaN,0.3849126867159223,0.5860036187474464,NaN,0.05502659415042439,-0.017499438944867052,-0.07252603309529145,14.824813332632608,1.3361462728551337,NaN,NaN,NaN,331600
737904600,45.03125,45.15625,44.9375,45.15625,NaN,NaN,NaN,46.130859375,NaN,NaN,44.610625,44.2546875,44.48107369525593,44.439953659539434,44.45913461538461,45.13423459702275,43.78403463374648,NaN,NaN,44.610625,44.2546875,45.08333333333334,98200,85690,62.345924606479635,NaN,1.5,2.75,NaN,NaN,0.3730439233790707,1.1459913642198623,NaN,0.09549408860952277,0.04684157766661201,-0.04865251094291075,14.565895146831354,1.832276250880902,NaN,NaN,NaN,429800
737991000,45.1875,45.25,44.71875,44.75,NaN,NaN,NaN,46.13671875,NaN,NaN,44.594375,44.3046875,44.491619824853736,44.46948188244044,44.48076923076923,45.17351081488744,43.788027646651024,NaN,NaN,44.594375,44.3046875,44.90625,221400,91460,54.684553416793094,NaN,1.5,2.75,NaN,NaN,0.3843443574234228,2.42073037393396,NaN,0.09037000195882211,0.06430999150561689,-0.02606001045320522,15.70695836391671,0.7032348804500703,NaN,NaN,NaN,208400
738250200,44.84375,45.09375,44.84375,44.9375,NaN,NaN,NaN,46.142578125,NaN,NaN,44.59125,44.38125,44.5091053219183,44.51405503649373,44.50721153846154,45.240254559714224,43.77416851720886,NaN,NaN,44.59125,44.38125,44.958333333333336,30500,89855,57.293046037554305,NaN,1.5,2.75,NaN,NaN,0.3814447604646069,0.33943575760948197,NaN,0.09462437499088705,0.0922204582854036,-0.002403916705483459,15.809103063607568,0.7002801120448179,NaN,NaN,NaN,238900
738336600,45.125,45.125,45.03125,45.03125,NaN,NaN,NaN,46.1484375,NaN,NaN,44.585625,44.4390625,44.529581583803854,44.5633116996848,44.55288461538461,45.33519528590356,43.77057394486567,NaN,NaN,44.585625,44.4390625,45.0625,191800,91605,58.57697170575796,NaN,1.5,2.75,NaN,NaN,0.3675915632885635,2.093772174007969,NaN,0.0983353895227376,0.12051532019793854,0.02217993067520094,15.703946878639481,1.0518934081346423,NaN,NaN,NaN,430700
738423000,45.15625,45.625,45.125,45.59375,NaN,NaN,NaN,46.154296875,NaN,NaN,44.59125,44.5296875,44.57131367855664,44.661448680667206,44.64903846153846,45.59504278837328,43.70303413470364,NaN,NaN,44.59125,44.5296875,45.44791666666666,102400,92430,65.31481925266732,NaN,1.5,2.75,NaN,NaN,0.3837457373393804,1.10786541166288,NaN,0.1312017036299376,0.18618206021262296,0.05498035658268535,16.91269631169311,3.5486160397444997,NaN,NaN,NaN,533100
738509400,45.65625,45.65625,45.375,45.4375,NaN,NaN,NaN,46.16015625,NaN,NaN,44.599375,44.603125,44.60528176959364,44.735358330127475,44.72596153846154,45.75005642675937,43.70186665016371,NaN,NaN,44.599375,44.603125,45.489583333333336,53800,90870,62.28414656352285,NaN,1.5,2.75,NaN,NaN,0.3764246132437104,0.5920545834708925,NaN,0.1344511070935513,0.22304424044962445,0.08859313335607318,14.861706952418066,3.2670454545454546,NaN,NaN,NaN,479300
738595800,45.40625,45.40625,45,45.21875,NaN,NaN,NaN,46.166015625,NaN,NaN,44.5975,44.6625,44.62933934725663,44.7813956320201,44.77163461538461,45.82615345599762,43.71711577477161,NaN,NaN,44.5975,44.6625,45.208333333333336,79100,90400,58.21174458141686,NaN,1.5,2.75,NaN,NaN,0.38078714086915966,0.875,NaN,0.11467182038339632,0.23193290883531859,0.11726108845192226,15.427727174017003,2.4062278839348905,NaN,NaN,NaN,400200
738941400,45.375,45.8125,45.3125,45.65625,NaN,NaN,NaN,45.8125,NaN,NaN,44.61,44.7296875,44.66961035324657,44.86471509563723,44.85576923076923,46.000767357431016,43.71077110410745,NaN,NaN,44.61,44.7296875,45.59375,28300,87790,63.370227768287194,NaN,1.5,2.75,NaN,NaN,0.3959987736642197,0.3223601776967764,NaN,0.12311444131121621,0.2711541400909425,0.1480396987797263,15.93055585167639,3.4702549575070822,NaN,NaN,NaN,428500
739027800,45.53125,45.75,45.34375,45.59375,NaN,NaN,NaN,45.811941964285715,NaN,NaN,44.62625,44.7859375,44.70585112370749,44.934146991290824,44.97596153846154,46.07670261480993,43.87522046211315,NaN,NaN,44.62625,44.7859375,45.5625,20300,81350,62.18917522470101,NaN,1.5,2.75,NaN,NaN,0.3967310041167754,0.24953902888752305,NaN,0.11661399643343204,0.29380719432151636,0.17719319788808433,15.996335200668996,1.2491325468424705,NaN,NaN,NaN,408200
739114200,45.5,45.5,45.34375,45.4375,NaN,NaN,NaN,45.81138392857143,NaN,NaN,44.6375,44.828125,44.73454323650328,44.98208537307265,45.08653846153846,46.05358996454459,44.11948695853233,NaN,NaN,44.6375,44.828125,45.427083333333336,21600,76980,59.2177777564779,NaN,1.5,2.75,NaN,NaN,0.38625021810843435,0.2805923616523772,NaN,0.09483959859660104,0.29574269613383564,0.2009030975372346,12.062927024303649,0.6228373702422145,NaN,NaN,NaN,386600
739200600,45.3125,45.3125,45.09375,45.28125,NaN,NaN,NaN,45.810825892857146,NaN,NaN,44.645625,44.8703125,44.755982717424715,45.010577242303825,45.17307692307692,45.97968104351012,44.36647280264372,NaN,NaN,44.645625,44.8703125,45.229166666666664,32000,75845,56.319820996901676,NaN,1.5,2.75,NaN,NaN,0.3832144882435462,0.4219131122684422,NaN,0.06441707423648563,0.28142444033284164,0.217007366096356,12.235432661565628,1.187150837988827,NaN,NaN,NaN,354600
739459800,45.375,45.375,45.125,45.125,NaN,NaN,NaN,45.810267857142854,NaN,NaN,44.645,44.909375,44.77045398340806,45.0214746477987,45.25,45.78820392189031,44.71179607810969,NaN,NaN,44.645,44.909375,45.208333333333336,121400,78515,53.50026692597122,NaN,1.5,2.75,NaN,NaN,0.37369916765472144,1.5462013627969178,NaN,0.030022051169008218,0.2545349300576163,0.22451287888860808,11.045079096591234,0.4172461752433936,NaN,NaN,NaN,233200
739546200,45,45,44.71875,44.71875,NaN,NaN,NaN,45.80970982142857,NaN,NaN,44.64125,44.9234375,44.76842637621559,44.99264372896073,45.22596153846154,45.82551758723563,44.62640548968745,NaN,NaN,44.64125,44.9234375,44.8125,104500,78045,46.92276759236016,NaN,1.5,2.75,NaN,NaN,0.37602422710795563,1.3389711064129668,NaN,-0.021082655465748112,0.19815955955642295,0.21924221502217106,12.130009438066217,-0.6939625260235948,NaN,NaN,NaN,128700
739632600,44.875,45.0625,44.8125,44.875,NaN,NaN,NaN,45.809151785714285,NaN,NaN,44.636875,44.9359375,44.77260573401105,44.9814395642978,45.20432692307692,45.83202082154803,44.57663302460581,NaN,NaN,44.636875,44.9359375,44.916666666666664,43300,78080,49.494663956081276,NaN,1.5,2.75,NaN,NaN,0.3737189251716731,0.5545594262295082,NaN,-0.044036187337963606,0.16419698084971657,0.20823316818768017,12.264605848782978,-1.5764222069910898,NaN,NaN,NaN,172000
739719000,44.84375,44.9375,44.75,44.90625,NaN,NaN,NaN,45.80859375,NaN,NaN,44.630625,44.953125,44.777846685618464,44.9742786534123,45.21634615384615,45.814048856458854,44.61864345123345,NaN,NaN,44.630625,44.953125,44.864583333333336,17900,77425,50.01632458617507,NaN,1.5,2.75,NaN,NaN,0.36041757337369645,0.23119147562156925,NaN,-0.05601868677690444,0.13820980971654961,0.19422849649345406,9.293207963243294,-1.169188445667125,NaN,NaN,NaN,189900
739805400,45.0625,45.15625,44.90625,45.09375,NaN,NaN,NaN,45.808035714285715,NaN,NaN,44.62875,45.00625,44.79023505088833,44.98565687689684,45.22836538461539,45.809201473482695,44.64752929574808,NaN,NaN,44.62875,45.00625,45.052083333333336,647400,103340,53.14352924590989,NaN,1.5,2.75,NaN,NaN,0.35253060384700385,6.264757112444358,NaN,-0.05039742532007013,0.13123171484336638,0.1816291401634365,9.732423695267634,-0.27643400138217,NaN,NaN,NaN,837300
740064600,45.15625,45.1875,45.03125,45.03125,NaN,NaN,NaN,45.80747767857143,NaN,NaN,44.62875,45.0578125,44.79968661752016,44.98999907909714,45.22836538461539,45.809201473482695,44.64752929574808,NaN,NaN,44.62875,45.0578125,45.083333333333336,64200,103375,51.97619289129311,NaN,1.5,2.75,NaN,NaN,0.338510560715075,0.6210399032648126,NaN,-0.04987669341730841,0.119283273391801,0.1691599668091094,9.40193015993723,-1.3689253935660506,NaN,NaN,NaN,773100
740151000,45.09375,45.125,44.9375,44.9375,NaN,NaN,NaN,45.806919642857146,NaN,NaN,44.645625,45.096875,44.805091063891915,44.984999166802176,45.17788461538461,45.73657073255187,44.61919849821736,NaN,NaN,44.645625,45.096875,45,142400,108795,50.19511459634074,NaN,1.5,2.75,NaN,NaN,0.32772409209256964,1.308883680316191,NaN,-0.05446079517315472,0.10108397284266601,0.15554476801582073,6.897951250812671,-1.4393420150788212,NaN,NaN,NaN,630700
740237400,44.9375,45.03125,44.8125,45.03125,NaN,NaN,NaN,45.806361607142854,NaN,NaN,44.66,45.1421875,44.81396004177851,44.98940400805911,45.14663461538461,45.68894571739348,44.604323513375746,NaN,NaN,44.66,45.1421875,44.958333333333336,330900,120080,51.96765844667056,NaN,1.5,2.75,NaN,NaN,0.3199402283716718,2.7556628914057297,NaN,-0.049914262445950985,0.093151939958382,0.143066202404333,7.214398066777529,-0.8940852819807428,NaN,NaN,NaN,961600
740323800,45.125,45.1875,45.03125,45.1875,NaN,NaN,NaN,45.80580357142857,NaN,NaN,44.68,45.15,44.82860866759111,45.008270293005864,45.14423076923077,45.685517997887175,44.60294354057436,NaN,NaN,44.68,45.15,45.135416666666664,37400,119440,54.851689790695886,NaN,1.5,2.75,NaN,NaN,0.3082480692022667,0.3131279303415941,NaN,-0.03578079298356904,0.09834021117487168,0.13412100415844072,7.52590047103731,-0.2070393374741201,NaN,NaN,NaN,999000
740410200,44.84375,44.84375,44.5,44.5,NaN,NaN,NaN,45.805245535714285,NaN,NaN,44.683125,45.1171875,44.815722053175776,44.95986359843388,45.05528846153846,45.610613343793965,44.499963579282955,NaN,NaN,44.683125,45.1171875,44.614583333333336,58500,117455,42.702291754914675,NaN,1.5,2.75,NaN,NaN,0.33533749283067626,0.49806308799114557,NaN,-0.07014391931030814,0.04644110502055554,0.11658502433086368,11.320618964715248,-1.3850415512465375,NaN,NaN,NaN,940500
740669400,44.625,44.625,44.53125,44.59375,NaN,NaN,NaN,45.8046875,NaN,NaN,44.689375,45.109375,44.807017266776725,44.92499563667827,44.97836538461539,45.48929438824016,44.46743638099061,NaN,NaN,44.689375,45.109375,44.583333333333336,29300,107850,44.507318808033425,NaN,1.5,2.75,NaN,NaN,0.32031338619991373,0.2716736207695874,NaN,-0.08308497843974327,0.012728801281184587,0.09581377972092786,11.460733913313584,-0.27952480782669464,NaN,NaN,NaN,969800
740755800,44.65625,44.65625,44.5625,44.625,NaN,NaN,NaN,45.804129464285715,NaN,44.68563,44.68375,45.09375,44.799879334746265,44.89642462366129,44.91586538461539,45.38381959076448,44.44791117846629,NaN,44.68563,44.68375,45.09375,44.614583333333336,137500,113200,45.12784753102146,NaN,1.5,2.75,NaN,NaN,0.3041302871856342,1.2146643109540636,NaN,-0.08571994567703908,-0.011336152375371,0.07438379330166808,10.32638103775657,-0.5571030640668524,NaN,NaN,NaN,1107300
740842200,44.625,44.625,44.21875,44.21875,NaN,NaN,NaN,45.80357142857143,NaN,44.6884375,44.668125,45.053125,44.77708994906994,44.831884183312596,44.83413461538461,45.382506668178095,44.28576256259113,NaN,44.6884375,44.668125,45.053125,44.354166666666664,227600,114990,39.01935190196646,NaN,1.5,2.75,NaN,NaN,0.3114245523866603,1.9793025480476563,NaN,-0.10948197966653558,-0.062468681281501404,0.04701329838503418,11.17856361929022,-1.5309672929714684,NaN,NaN,NaN,879700
740928600,44.34375,44.8125,44.34375,44.8125,NaN,NaN,NaN,45.803013392857146,NaN,44.6940625,44.665625,45.0140625,44.778478578518175,44.830038070616155,44.81009615384615,45.33212387704451,44.2880684306478,NaN,44.6940625,44.665625,45.0140625,44.65625,243700,122055,49.72954693465516,NaN,1.5,2.75,NaN,NaN,0.3315906557876131,1.9966408586293065,NaN,-0.08117320931513239,-0.054453213258881306,0.026719996056251083,14.052827446411802,-0.6237006237006237,NaN,NaN,NaN,1123400
741015000,44.78125,44.90625,44.75,44.78125,NaN,NaN,NaN,45.802455357142854,NaN,44.6984375,44.6625,44.98125,44.77858726171354,44.82539158770033,44.81490384615385,45.334624057068716,44.29518363523898,NaN,44.6984375,44.6625,44.98125,44.8125,44800,121605,49.23937442305329,NaN,1.5,2.75,NaN,NaN,0.319066323231355,0.3684059043624851,NaN,-0.061412489824170094,-0.05004561622396153,0.01136687360020856,13.77378070781772,-0.5551700208188758,NaN,NaN,NaN,1078600
741274200,45,45.28125,44.9375,45.28125,NaN,NaN,NaN,45.28125,NaN,44.703125,44.669375,44.984375,44.79829952596007,44.86880667458601,44.84615384615385,45.42235531794586,44.269952374361836,NaN,44.703125,44.669375,44.984375,45.166666666666664,439900,139645,56.60890356483834,NaN,1.5,2.75,NaN,NaN,0.3319901572862582,3.150130688531634,NaN,-0.014002307188115067,-0.006136010384935275,0.007866296803179792,15.318661850036532,0.7649513212795549,NaN,NaN,NaN,1518500
741360600,45.21875,45.21875,45,45.0625,NaN,NaN,NaN,45.25328947368421,NaN,44.70375,44.675625,44.9546875,44.808660328863596,44.88725365795877,44.85817307692308,45.44530235061295,44.27104380323321,NaN,44.70375,44.675625,44.9546875,45.09375,207500,148605,52.98459524017849,NaN,1.5,2.75,NaN,NaN,0.32836586033723975,1.3963191009723763,NaN,0.002415671394288268,0.010885886046040127,0.00847021465175186,15.571539648985338,0.06939625260235947,NaN,NaN,NaN,1311000
741447000,45.125,45.21875,45,45.0625,NaN,NaN,NaN,45.22532894736842,NaN,44.7046875,44.68625,44.928125,44.81861482577091,44.90394378577222,44.85576923076923,45.439265439363375,44.27227302217509,NaN,44.7046875,44.68625,44.928125,45.09375,437600,169470,52.98459524017849,NaN,1.5,2.75,NaN,NaN,0.3205361560274369,2.5821679353277864,NaN,0.012502287484283807,0.024098074007106618,0.011595786522822811,15.529057097262971,-0.2766251728907331,NaN,NaN,NaN,1311000
741533400,45.125,45.125,44.875,44.9375,NaN,NaN,NaN,45.19736842105263,NaN,44.704375,44.695,44.903125,44.823276989466166,44.907139615698675,44.84855769230769,45.42548076923124,44.271634615384144,NaN,44.704375,44.695,44.903125,44.979166666666664,605700,198675,50.8279709881338,NaN,1.5,2.75,NaN,NaN,0.3154978591683343,3.0486976217440542,NaN,0.01008606792079465,0.024203371423816122,0.014117303503021473,15.442890309381188,0.9831460674157303,NaN,NaN,NaN,705300
741619800,44.78125,44.8125,44.53125,44.6875,NaN,NaN,NaN,45.16940789473684,NaN,44.7046875,44.71,44.8734375,44.817952401643964,44.88622155706071,44.82932692307692,45.409764933567864,44.248888912585976,NaN,44.7046875,44.71,44.8734375,44.677083333333336,285400,211345,46.73115846801854,NaN,1.5,2.75,NaN,NaN,0.32198015494202464,1.3503986372992027,NaN,-0.008040220754191498,0.004067027560282099,0.012107248314473597,12.826848741891416,0.2102312543798178,NaN,NaN,NaN,419900
741965400,44.625,44.75,44.15625,44.21875,NaN,NaN,44.15625,45.141447368421055,NaN,44.6996875,44.719375,44.828125,44.79445426824616,44.82265283734064,44.76682692307692,45.41755478137231,44.11609906478153,NaN,44.6996875,44.719375,44.828125,44.375,246400,217595,40.190095754128336,NaN,1.5,2.75,NaN,NaN,0.34139228673188,1.1323789609136239,NaN,-0.049004855059679886,-0.049148820510126257,-0.00014396545044637402,14.196478116167743,-0.9103641456582633,NaN,NaN,NaN,173500
742051800,44.1875,44.40625,44.1875,44.34375,NaN,NaN,44.166015625,45.11348684210526,NaN,44.69375,44.738125,44.809375,44.77677959106004,44.7770430433082,44.70192307692308,45.340061607355686,44.063784546490474,NaN,44.69375,44.738125,44.809375,44.3125,343700,229555,42.50137613092283,NaN,1.5,2.75,NaN,NaN,0.3326321233938886,1.497244669033565,NaN,-0.06413325826386104,-0.08031053828027268,-0.016177280016411638,14.33224885532387,0.2826855123674912,NaN,NaN,NaN,517200
742138200,44.375,44.9375,44.3125,44.84375,NaN,NaN,44.17578125,45.08552631578947,NaN,44.69625,44.7575,44.8078125,44.779405881606706,44.783396086802654,44.72836538461539,45.35929143219507,44.0974393370357,NaN,44.69625,44.7575,44.8078125,44.697916666666664,248200,239800,50.706965080962334,NaN,1.5,2.75,NaN,NaN,0.353515543151468,1.0350291909924938,NaN,-0.03819715985022405,-0.0639237298291917,-0.02572656997896765,14.664315947997656,0.0697350069735007,NaN,NaN,NaN,765400
742224600,44.84375,44.96875,44.75,44.96875,NaN,NaN,44.185546875,45.057565789473685,NaN,44.71125,44.78125,44.8109375,44.786831141151545,44.801048840440494,44.75721153846154,45.39513270691468,44.1192903700084,NaN,44.71125,44.78125,44.8109375,44.895833333333336,378200,257815,52.53081369017637,NaN,1.5,2.75,NaN,NaN,0.34388943292636315,1.4669433508523553,NaN,-0.011726805388181612,-0.04038507671419467,-0.028658271326013056,12.636528716130726,0.418702023726448,NaN,NaN,NaN,1143600
742483800,44.90625,44.96875,44.84375,44.9375,NaN,NaN,44.1953125,45.0296052631579,NaN,44.72625,44.800625,44.803125,44.79273972385148,44.81404418896997,44.78125,45.420980261666884,44.141519738333116,NaN,44.72625,44.800625,44.803125,44.916666666666664,373700,244130,52.0126855281746,NaN,1.5,2.75,NaN,NaN,0.32825447343162295,1.5307418178839143,NaN,0.003746008483714109,-0.02397576072137042,-0.02772176920508453,12.636455557309603,-0.759144237405107,NaN,NaN,NaN,769900
742570200,44.96875,45.09375,44.65625,44.90625,NaN,NaN,44.205078125,45.0016447368421,NaN,44.74125,44.818125,44.796875,44.79719110722986,44.82282569478236,44.83413461538461,45.386872890332675,44.28139634043655,NaN,44.74125,44.818125,44.796875,44.885416666666664,389600,260400,51.466011718191886,NaN,1.5,2.75,NaN,NaN,0.3360577253293641,1.4961597542242704,NaN,0.011506128589619916,-0.013339108468059635,-0.02484523705767955,10.619562563098473,-0.34674063800277394,NaN,NaN,NaN,380300
742656600,44.9375,45.1875,44.90625,45.0625,NaN,NaN,44.21484375,44.973684210526315,NaN,44.75625,44.833125,44.803125,44.80759537753457,44.8456518190888,44.85336538461539,45.41900014089767,44.2877306283331,NaN,44.75625,44.833125,44.803125,45.052083333333336,617300,284145,54.065640536465835,NaN,1.5,2.75,NaN,NaN,0.33214288780583806,2.172482359358778,NaN,0.025964870515079723,0.007610851086170101,-0.018354019428909622,10.542454098121341,0,NaN,NaN,NaN,997600
742743000,45.03125,45.03125,44.78125,44.875,NaN,NaN,44.224609375,44.94572368421053,NaN,44.7678125,44.84125,44.7953125,44.810238696062626,44.848446883937484,44.86057692307692,45.42473866968086,44.296415176472976,NaN,44.7678125,44.84125,44.7953125,44.895833333333336,443800,289790,50.56549913459523,NaN,1.5,2.75,NaN,NaN,0.32850768153399246,1.531453811380655,NaN,0.02186772655011073,0.008980638758728787,-0.012887087791381941,10.809921795494503,-0.13908205841446453,NaN,NaN,NaN,553800
742829400,44.90625,44.9375,44.6875,44.75,NaN,NaN,44.234375,44.91776315789474,NaN,44.7784375,44.844375,44.7734375,44.80787639425625,44.83907099022915,44.81971153846154,45.33050480712703,44.30891826979605,NaN,44.7784375,44.844375,44.7734375,44.791666666666664,216400,298740,48.319645739397004,NaN,1.5,2.75,NaN,NaN,0.3228999899958501,0.7243757113208811,NaN,0.010293654869529437,-0.00002001920447014527,-0.010313674073999583,10.810850284032817,0.13986013986013987,NaN,NaN,NaN,337400
743088600,44.75,44.75,44.59375,44.71875,NaN,NaN,44.244140625,44.889802631578945,NaN,44.783125,44.85,44.784375,44.80438124154032,44.82761184830257,44.79326923076923,45.28633317815756,44.300205283380905,NaN,44.783125,44.85,44.784375,44.6875,188200,305225,47.748675950144914,NaN,1.5,2.75,NaN,NaN,0.3109964192818608,0.616594315668769,NaN,0.0005993663729734894,-0.009564466107782721,-0.01016383248075621,10.310815311561115,1.1307420494699647,NaN,NaN,NaN,149200
743175000,44.6875,44.84375,44.46875,44.84375,NaN,NaN,44.25390625,44.86184210526316,NaN,44.788125,44.86,44.796875,44.80592511442109,44.82914881513089,44.77644230769231,45.24597444609568,44.30691016928893,NaN,44.788125,44.86,44.796875,44.71875,68500,307185,50.27954212965071,NaN,1.5,2.75,NaN,NaN,0.3155681036188707,0.22299265914676825,NaN,0.0025616240750646942,-0.006961802386925342,-0.009523426461990036,7.83570716105466,1.127554615926709,NaN,NaN,NaN,217700
743261400,44.78125,44.8125,44.65625,44.8125,NaN,NaN,44.263671875,44.83388157894737,NaN,44.7921875,44.8675,44.80625,44.80618295307124,44.82756321368986,44.76682692307692,45.227814174052156,44.30583967210168,NaN,44.7921875,44.8675,44.80625,44.760416666666664,142700,307445,49.63230853642926,NaN,1.5,2.75,NaN,NaN,0.30642038193180854,0.4641480590024232,NaN,0.0017497658874853252,-0.007336219102633379,-0.009085984990118704,7.8626583393283775,-0.06968641114982578,NaN,NaN,NaN,75000
743347800,44.75,44.8125,44.5,44.5,NaN,NaN,44.2734375,44.80592105263158,NaN,44.794375,44.865,44.8203125,44.794175778441,44.79636671714797,44.75240384615385,45.233701632531904,44.27110605977579,NaN,44.794375,44.865,44.8203125,44.604166666666664,632400,327685,43.58953088144189,NaN,1.5,2.75,NaN,NaN,0.30685464036525073,1.929902192654531,NaN,-0.01871100146758797,-0.03247473682460367,-0.013763735357015697,5.973521461245177,-1.0423905489923557,NaN,NaN,NaN,-557400
743434200,44.59375,44.71875,44.5625,44.71875,NaN,NaN,44.283203125,44.77796052631579,NaN,44.7921875,44.868125,44.815625,44.79121790477665,44.78897464884816,44.79086538461539,45.16295716482462,44.418773604406155,NaN,44.7921875,44.868125,44.815625,44.666666666666664,286200,329810,48.3317199685854,NaN,1.5,2.75,NaN,NaN,0.3005614517677328,0.8677723537794487,NaN,-0.016468957131321457,-0.03434993177116752,-0.017880974639846062,6.5313515712401715,-0.48678720445062584,NaN,NaN,NaN,-271200
743693400,44.84375,45.0625,44.84375,44.96875,NaN,NaN,44.29296875,44.75,NaN,44.790625,44.886875,44.825,44.79817994772659,44.80609611086262,44.83894230769231,45.11720761785399,44.56067699753062,NaN,44.790625,44.886875,44.825,44.958333333333336,121300,333635,53.17635438289854,NaN,1.5,2.75,NaN,NaN,0.3036463480700376,0.36357096827371227,NaN,0.001917076156554745,-0.015484629444152631,-0.017401705600707376,7.412359295235047,0.13917884481558804,NaN,NaN,NaN,-149900
743779800,45,45.03125,44.78125,44.9375,NaN,NaN,44.302734375,44.72203947368421,NaN,44.79125,44.905625,44.8078125,44.80364347918829,44.81861076697094,44.84615384615385,45.12935916298254,44.562948529325155,NaN,44.79125,44.905625,44.8078125,44.916666666666664,92800,316280,52.513523310612754,NaN,1.5,2.75,NaN,NaN,0.2998144660650349,0.29341090173264195,NaN,0.011504935358757396,-0.003020536402260632,-0.014525471761018028,7.412341079230014,-0.27739251040221913,NaN,NaN,NaN,-242700
743866200,44.84375,44.9375,44.78125,44.84375,NaN,NaN,44.3125,44.69407894736842,NaN,44.7921875,44.919375,44.796875,44.805216283926,44.82100497964038,44.83653846153846,45.11078770571102,44.5622892173659,NaN,44.7921875,44.919375,44.796875,44.854166666666664,30800,307445,50.480628125062516,NaN,1.5,2.75,NaN,NaN,0.28955986134610384,0.10018052009302476,NaN,0.011060832006961166,-0.0006994317523165705,-0.011760263759277736,7.1613167027844264,-0.06963788300835655,NaN,NaN,NaN,-273500
743952600,44.9375,45.21875,44.875,45.09375,NaN,NaN,44.322265625,44.66611842105263,NaN,44.785625,44.93875,44.7984375,44.816531331615174,44.846980695865106,44.84855769230769,45.151633029085794,44.54548235552959,NaN,44.785625,44.93875,44.7984375,45.0625,331000,302115,55.43502622780336,NaN,1.5,2.75,NaN,NaN,0.29566272839281066,1.095609287853963,NaN,0.026264281573071094,0.021070088207061133,-0.005194193366009962,7.498078158845655,0.7681564245810056,NaN,NaN,NaN,57500
744039000,45.09375,45.09375,44.78125,44.84375,NaN,NaN,44.33203125,44.63815789473684,NaN,44.778125,44.935,44.79375,44.817598730375366,44.84667301054462,44.84375,45.14498942688105,44.54251057311895,NaN,44.778125,44.935,44.79375,44.90625,75300,275595,50.04309192866799,NaN,1.5,2.75,NaN,NaN,0.296865390650467,0.27322701790671095,NaN,0.018509630696633785,0.01794284500478227,-0.0005667856918515147,8.084899647817457,0.27952480782669464,NaN,NaN,NaN,-17800
744298200,44.90625,45.125,44.90625,44.96875,NaN,NaN,44.341796875,44.610197368421055,NaN,44.7709375,44.93125,44.8078125,44.82352623114496,44.85829939049275,44.83653846153846,45.12047736654261,44.55259955653431,NaN,44.7709375,44.93125,44.8078125,45,41300,263390,52.52931733044606,NaN,1.5,2.75,NaN,NaN,0.2957500056040051,0.15680170089980638,NaN,0.02066123558718072,0.025259758792124387,0.0045985232049436655,8.18786074343456,0.2787456445993031,NaN,NaN,NaN,23500
744384600,45.0625,45.1875,44.84375,45,NaN,NaN,44.3515625,44.58223684210526,NaN,44.7653125,44.93625,44.846875,44.83044677110006,44.8717946866363,44.84615384615385,45.14283170424245,44.54947598806525,NaN,44.7653125,44.93625,44.846875,45.010416666666664,81600,255150,53.1569632104438,NaN,1.5,2.75,NaN,NaN,0.29917857663229047,0.31981187536743094,NaN,0.022879101874528573,0.03319740054810438,0.01031829867357581,8.066355357825719,0.41841004184100417,NaN,NaN,NaN,105100
744471000,45,45.09375,44.875,45,NaN,NaN,44.361328125,44.55427631578947,NaN,44.764375,44.9375,44.8796875,44.837095917331425,44.88400471648046,44.86538461538461,45.16700744502798,44.56376178574125,NaN,44.764375,44.9375,44.8796875,44.989583333333336,434000,259665,53.1569632104438,NaN,1.5,2.75,NaN,NaN,0.2934336783014126,1.671384283596172,NaN,0.022975787210628075,0.0390380326868609,0.016062245476232827,8.043256292537423,1.1235955056179776,NaN,NaN,NaN,105100
744557400,45,45,44.84375,44.90625,NaN,NaN,44.37109375,44.526315789473685,NaN,44.7603125,44.935,44.8828125,44.83980784214196,44.8861233149109,44.87980769230769,45.16970795061056,44.58990743400483,NaN,44.7603125,44.935,44.8828125,44.916666666666664,36800,249095,50.81916330354547,NaN,1.5,2.75,NaN,NaN,0.28363484413702594,0.1477347999759128,NaN,0.015702616566018505,0.03569051618375596,0.019987899617737455,6.7844623329754254,0.4192872117400419,NaN,NaN,NaN,68300
744643800,45.03125,45.0625,44.90625,44.96875,NaN,NaN,44.380859375,44.4983552631579,NaN,44.756875,44.9225,44.8828125,44.844864397352076,44.893992523014624,44.88942307692308,45.18217956437718,44.59666658946898,NaN,44.756875,44.9225,44.8828125,44.979166666666664,402300,250300,52.324507414545984,NaN,1.5,2.75,NaN,NaN,0.27453592669866694,1.6072712744706352,NaN,0.014127155126113906,0.037646843525379836,0.02351968839926593,6.311749530797991,0,NaN,NaN,NaN,470600
744903000,45.09375,45.34375,45,45.21875,NaN,NaN,44.390625,44.4703947368421,NaN,44.75875,44.918125,44.896875,44.85952657784807,44.92492180653704,44.92067307692308,45.25734887307714,44.58399728076902,NaN,44.75875,44.918125,44.896875,45.1875,828200,273025,57.87830885755773,NaN,1.5,2.75,NaN,NaN,0.28171193193447647,3.033421847816134,NaN,0.02813910904640902,0.05869357470727721,0.030554465660868186,6.3028001624713985,0.6258692628650904,NaN,NaN,NaN,1298800
744989400,45.1875,45.21875,45.125,45.1875,NaN,NaN,44.400390625,44.442434210526315,NaN,44.7575,44.9175,44.9109375,44.87238828067756,44.94992925353351,44.97355769230769,45.23741197565418,44.709703408961204,NaN,44.7575,44.9175,44.9109375,45.177083333333336,604900,283790,56.984698667371276,NaN,1.5,2.75,NaN,NaN,0.2682860796534424,2.1315056908277246,NaN,0.03317357048770927,0.07202142877050477,0.0388478582827955,6.30252232571493,0.7665505226480837,NaN,NaN,NaN,693900
745075800,45.15625,45.3125,45.15625,45.1875,NaN,NaN,44.41015625,44.41447368421053,NaN,44.7590625,44.908125,44.9171875,44.884745603003935,44.972555038911274,45.00961538461539,45.25153356971942,44.76769719951135,NaN,44.7590625,44.908125,44.9171875,45.21875,542200,280035,56.98469866737127,NaN,1.5,2.75,NaN,NaN,0.2602835025353394,1.9361865481100577,NaN,0.03423589149513552,0.0816427226517149,0.047406831156579385,6.09301805610894,0.2079002079002079,NaN,NaN,NaN,693900
745162200,45.3125,45.3125,44.90625,45.0625,NaN,NaN,44.419921875,44.38651315789474,NaN,44.761875,44.8975,44.9265625,44.89171636367045,44.981121225681626,45.01682692307692,45.259031571494454,44.774622274659386,NaN,44.761875,44.8975,44.9265625,45.09375,303700,273030,53.17599435793221,NaN,1.5,2.75,NaN,NaN,0.27070968092567227,1.112331978170897,NaN,0.024697624710017338,0.07827886204410106,0.05358123733408372,5.545752253452683,0.4878048780487805,NaN,NaN,NaN,390200
745248600,45.09375,45.15625,45.09375,45.125,NaN,NaN,44.4296875,44.358552631578945,NaN,44.764375,44.89125,44.9453125,44.90086474156573,44.9948239660929,45.03125,45.275166363345356,44.787333636654644,NaN,44.764375,44.89125,44.9453125,45.125,103500,267385,54.802617596125195,NaN,1.5,2.75,NaN,NaN,0.2580697037166957,0.38708229706228847,NaN,0.020924647653432236,0.07973704690087402,0.058812399247441784,4.3319903460431215,0.34746351633078526,NaN,NaN,NaN,493700
745507800,45.15625,45.5,45.15625,45.375,NaN,NaN,44.439453125,44.33059210526316,NaN,44.769375,44.893125,44.978125,44.91945828111217,45.031031207417385,45.07211538461539,45.35203705053916,44.792193718691614,NaN,44.769375,44.893125,44.978125,45.34375,241800,270065,60.68580250709654,NaN,1.5,2.75,NaN,NaN,0.2664218677369317,0.8953400107381556,NaN,0.032881148659522866,0.09991383507184537,0.0670326864123225,5.0550882794295715,0.8333333333333334,NaN,NaN,NaN,735500
745594200,45.34375,45.53125,45.34375,45.53125,NaN,NaN,44.44921875,44.30263157894737,NaN,44.773125,44.90125,45.0125,44.94345011322542,45.07867109242525,45.10576923076923,45.47798522790232,44.733553233636144,NaN,44.773125,44.90125,45.0125,45.46875,369300,285105,63.85273870726606,NaN,1.5,2.75,NaN,NaN,0.26078459147000804,1.2953122533803336,NaN,0.048011953472868116,0.12704762825340765,0.07903567478053954,5.255057410462812,1.1805555555555556,NaN,NaN,NaN,1104800
745680600,45.6875,45.875,45.65625,45.78125,NaN,NaN,44.458984375,44.27467105263158,NaN,44.781875,44.9225,45.0609375,44.97630501074599,45.14558336933713,45.17788461538461,45.66472132847002,44.6910479022992,NaN,44.781875,44.9225,45.0609375,45.770833333333336,414300,298685,68.25850934069715,NaN,1.5,2.75,NaN,NaN,0.26671069207929315,1.3870800341496894,NaN,0.0702126456544552,0.16680148184860855,0.09658883619415334,5.724843253759662,1.9485038274182325,NaN,NaN,NaN,1519100
745767000,45.8125,45.8125,45.71875,45.78125,NaN,NaN,44.46875,44.24671052631579,NaN,44.78875,44.940625,45.125,45.00787148091281,45.20612304844788,45.24038461538461,45.8060193716677,44.674749859101524,NaN,44.78875,44.940625,45.125,45.770833333333336,28500,268490,68.25850934069715,NaN,1.5,2.75,NaN,NaN,0.2543563569307722,0.10614920481209729,NaN,0.07956636452649753,0.19604679185227525,0.11648042732577772,5.329837039681948,1.8068102849200833,NaN,NaN,NaN,1519100
745853400,45.6875,45.8125,45.65625,45.8125,NaN,NaN,44.478515625,44.21875,NaN,44.7946875,44.95875,45.1796875,45.03942554048486,45.26387323430998,45.30288461538461,45.925179055199045,44.68059017557018,NaN,44.7946875,44.95875,45.1796875,45.760416666666664,80700,258215,68.80962962654857,NaN,1.5,2.75,NaN,NaN,0.2473487600071456,0.31253025579458976,NaN,0.08219046617071357,0.2192185100391697,0.13702804386845613,5.371291288983372,1.3130615065653075,NaN,NaN,NaN,1599800
746112600,45.625,45.75,45.625,45.71875,NaN,NaN,44.48828125,44.19078947368421,NaN,44.8,44.97125,45.2171875,45.066065715367806,45.307194831042366,45.35817307692308,45.990635918173545,44.725710235672615,NaN,44.8,44.97125,45.2171875,45.697916666666664,15600,252930,65.15476576730671,NaN,1.5,2.75,NaN,NaN,0.24307384857806374,0.06167714387379907,NaN,0.07229447769153002,0.22739614098286864,0.15510166329133862,5.230939807893441,1.1756569847856155,NaN,NaN,NaN,1584200
746199000,45.71875,46.21875,45.71875,46.21875,NaN,NaN,44.498046875,44.16282894736842,NaN,44.811875,44.995,45.28125,45.1112690206475,45.394009609038335,45.45913461538461,46.183199253793,44.73506997697623,NaN,44.811875,44.995,45.28125,46.052083333333336,273400,261960,73.30018796098845,NaN,1.5,2.75,NaN,NaN,0.2614257165367735,1.0436707894335013,NaN,0.09279686749928956,0.2710977476654506,0.17830088016616102,7.496685841486958,2.2821576763485476,NaN,NaN,NaN,1857600
746285400,46.21875,46.4375,46.15625,46.25,NaN,NaN,44.5078125,44.13486842105263,NaN,44.8334375,45.02125,45.3515625,45.15592513748485,45.475532503415636,45.55769230769231,46.334785539249346,44.78059907613527,NaN,44.8334375,45.02125,45.3515625,46.28125,242300,272535,73.7137714491306,NaN,1.5,2.75,NaN,NaN,0.2628417367841468,0.8890601207184399,NaN,0.10115157000410124,0.3047403426712876,0.20358877266718634,7.4321591806670435,2.635228848821082,NaN,NaN,NaN,2099900
746371800,46.28125,46.53125,46.09375,46.28125,NaN,NaN,44.517578125,44.10690789473684,NaN,44.853125,45.04625,45.4109375,45.20005552425015,45.552267503090334,45.63942307692308,46.47781073245336,44.801035421392804,NaN,44.853125,45.04625,45.4109375,46.302083333333336,120000,261985,74.14507492156295,NaN,1.5,2.75,NaN,NaN,0.2753173270138506,0.458041490925053,NaN,0.10122382524754325,0.3301185542266154,0.22889472897907215,6.806156020976158,2.5623268698060944,NaN,NaN,NaN,2219900
746458200,46.15625,46.25,46.15625,46.25,NaN,NaN,44.52734375,44.078947368421055,NaN,44.87375,45.0675,45.48125,45.241229817416816,45.61871821708173,45.72115384615385,46.57440749539417,44.867900196913524,NaN,44.87375,45.0675,45.48125,46.21875,25700,259505,72.85767153892027,NaN,1.5,2.75,NaN,NaN,0.26458037508428983,0.09903470068014104,NaN,0.09188170170414695,0.3437468561092558,0.25186515440510887,7.04627187292143,1.9283746556473829,NaN,NaN,NaN,2194200
746717400,46.28125,46.5,46.28125,46.4375,NaN,NaN,44.537109375,44.05098684210526,NaN,44.8946875,45.10625,45.5546875,45.28814237359655,45.69669743450252,45.81730769230769,46.689847555929866,44.94476782868552,NaN,44.8946875,45.10625,45.5546875,46.40625,183500,266615,75.5956811135249,NaN,1.5,2.75,NaN,NaN,0.26353891972112625,0.6882583500553232,NaN,0.09087925445343842,0.3654642224719069,0.2745849680184685,6.860185810483794,1.990391214824983,NaN,NaN,NaN,2377700
746803800,46.40625,46.5625,46.34375,46.5625,NaN,NaN,44.546875,44.02302631578947,NaN,44.9175,45.145625,45.6328125,45.338117182475116,45.77915482169276,45.93269230769231,46.771520958798426,45.09386365658619,NaN,44.9175,45.145625,45.6328125,46.489583333333336,66500,265860,77.24377342817206,NaN,1.5,2.75,NaN,NaN,0.26033971116961724,0.25013164823591366,NaN,0.09096076848546591,0.38828592862530087,0.29732516013983495,6.828782322234207,1.7064846416382253,NaN,NaN,NaN,2444200
746890200,46.40625,46.59375,46.40625,46.5,NaN,NaN,44.556640625,46.59375,NaN,44.9334375,45.183125,45.7078125,45.38368121453492,45.8478067434363,46.03846153846154,46.78490899259006,45.29201408433302,NaN,44.9334375,45.183125,45.7078125,46.5,136500,250985,74.5334521929975,NaN,1.5,2.75,NaN,NaN,0.25513687465750173,0.5438572026216706,NaN,0.07954428539277358,0.3967555168808019,0.3172112314880283,6.767439005646748,1.5699658703071673,NaN,NaN,NaN,2307700
746976600,46.53125,46.59375,46.3125,46.34375,NaN,NaN,44.56640625,46.62228260869565,NaN,44.946875,45.225625,45.7796875,45.42133097082767,45.89503943453761,46.11298076923077,46.76735696841583,45.4586045700457,NaN,44.946875,45.225625,45.7796875,46.416666666666664,472400,272765,68.10020285355306,NaN,1.5,2.75,NaN,NaN,0.2570020978962516,1.7318937546972668,NaN,0.05535534786462426,0.38640541631880865,0.3310500684541844,7.303931586769794,1.159618008185539,NaN,NaN,NaN,1835300
747063000,46.3125,46.4375,46.25,46.375,NaN,NaN,44.576171875,46.650815217391305,NaN,44.96125,45.256875,45.85,45.45872975628541,45.94074996458165,46.17788461538461,46.75090829644365,45.60486093432558,NaN,44.96125,45.256875,45.85,46.354166666666664,630500,284175,68.68241609129953,NaN,1.5,2.75,NaN,NaN,0.2520376623322336,2.218703263833905,NaN,0.036268553346233634,0.37638576013697644,0.3401172067907428,7.304156060687801,1.4354066985645932,NaN,NaN,NaN,2465800
747408600,46.375,46.4375,46,46.0625,NaN,NaN,44.5859375,46.67934782608695,NaN,44.9725,45.2825,45.8921875,45.4824070207448,45.95234520605006,46.19951923076923,46.73072028142158,45.668318180116884,NaN,44.9725,45.2825,45.8921875,46.16666666666666,196400,252585,57.400247117959374,NaN,1.5,2.75,NaN,NaN,0.2652849721656455,0.7775600292970684,NaN,-0.0006397407772615882,0.3393175308191658,0.3399572715964274,8.47898223901961,-0.3380662609871535,NaN,NaN,NaN,2269400
747495000,46.0625,46.0625,45.59375,45.90625,NaN,NaN,44.595703125,46.70788043478261,NaN,44.9821875,45.295,45.928125,45.49902831404893,45.94795518642625,46.20913461538461,46.7135529634075,45.704716267361725,NaN,44.9821875,45.295,45.928125,45.854166666666664,269900,235835,52.735730056327476,NaN,1.5,2.75,NaN,NaN,0.279818188439528,1.144444208874849,NaN,-0.03681044375724857,0.2939442168998667,0.3307546606571153,5.769926420668894,-0.7432432432432432,NaN,NaN,NaN,1999500
747581400,45.71875,46.03125,45.71875,46,NaN,NaN,44.60546875,46.73641304347826,NaN,44.9946875,45.31375,45.96875,45.5186742625176,45.952911835338035,46.22355769230769,46.691166015990554,45.75594936862483,NaN,44.9946875,45.31375,45.96875,45.916666666666664,239200,220685,55.09368899162054,NaN,1.5,2.75,NaN,NaN,0.2821526035509903,1.0838978634705576,NaN,-0.054584396476810904,0.26252416506110166,0.31710856153791256,5.9373540327113,-0.6076975016880486,NaN,NaN,NaN,2238700
747667800,46.125,46.4375,46.0625,46.40625,NaN,NaN,44.615234375,46.764945652173914,NaN,45.0134375,45.340625,46.0359375,45.55348115418358,45.99608689863918,46.27644230769231,46.64971247968499,45.90317213569962,NaN,45.0134375,45.340625,46.0359375,46.302083333333336,106500,210825,63.574154712262946,NaN,1.5,2.75,NaN,NaN,0.29324884615449104,0.5051583066524369,NaN,-0.03982845374191457,0.2673229943605193,0.3071514481024339,8.006961439893479,0.33783783783783783,NaN,NaN,NaN,2345200
747927000,46.5625,46.5625,46.4375,46.4375,NaN,NaN,44.625,46.79347826086956,NaN,45.0328125,45.370625,46.1015625,45.58814855990187,46.038126241625925,46.29326923076923,46.67426178377342,45.91227667776505,NaN,45.0328125,45.370625,46.1015625,46.479166666666664,66900,208995,64.13523071670976,NaN,1.5,2.75,NaN,NaN,0.2834632142863131,0.3201033517548267,NaN,-0.02929778047524917,0.2705292225083724,0.2998270029836216,7.986137090607675,0,NaN,NaN,NaN,2412100
748013400,46.3125,46.3125,46.09375,46.25,NaN,NaN,44.634765625,46.82201086956522,NaN,45.0559375,45.401875,46.1453125,45.61410351833709,46.058304694804406,46.29326923076923,46.67426178377342,45.91227667776505,NaN,45.0559375,45.401875,46.1453125,46.21875,184500,206130,58.32975098602386,NaN,1.5,2.75,NaN,NaN,0.2877694132658622,0.8950662203463834,NaN,-0.035860797940025224,0.25500100555859007,0.2908618034986153,7.986137090607654,-0.6711409395973155,NaN,NaN,NaN,2227600
748099800,46.0625,46.40625,45.90625,46.375,NaN,NaN,44.64453125,46.85054347826087,NaN,45.0821875,45.445,46.1875,45.64394259604936,46.08846615244208,46.30048076923077,46.6838320572942,45.917129481167336,NaN,45.0821875,45.445,46.1875,46.229166666666664,101000,192715,60.87257411762846,NaN,1.5,2.75,NaN,NaN,0.30292874088972915,0.5240899774278079,NaN,-0.03276901141965183,0.24990053922405053,0.28266955064370236,7.987677756385876,-0.26881720430107525,NaN,NaN,NaN,2328600
748186200,46.3125,46.34375,46.15625,46.28125,NaN,NaN,44.654296875,46.87907608695652,NaN,45.1109375,45.48375,46.2125,45.668935043263104,46.10682651887617,46.30288461538461,46.68533041925777,45.92043881151146,NaN,45.1109375,45.48375,46.2125,46.260416666666664,54300,174715,58.01325117255754,NaN,1.5,2.75,NaN,NaN,0.2969159736833199,0.3107918610308216,NaN,-0.03767328411895993,0.23557794549500244,0.27325122961396237,8.026321510332489,-0.13486176668914363,NaN,NaN,NaN,2274300
748272600,45.875,45.90625,45.75,45.8125,NaN,NaN,44.6640625,46.90760869565217,NaN,45.1303125,45.503125,46.2140625,45.67456504156651,46.07879542184034,46.25480769230769,46.70805860574701,45.801556778868374,NaN,45.1303125,45.503125,46.2140625,45.82291666666666,200900,183335,46.30215743377038,NaN,1.5,2.75,NaN,NaN,0.31365411842022567,1.0958082199252734,NaN,-0.07117800064552332,0.1842787288070582,0.2554567294525815,9.699057867111575,-1.2129380053908356,NaN,NaN,NaN,2073400
748531800,45.875,45.96875,45.4375,45.4375,NaN,NaN,44.673828125,46.93614130434783,NaN,45.146875,45.5125,46.1953125,45.66526837326978,46.01771966737935,46.16826923076923,46.76146910827692,45.57506935326155,NaN,45.146875,45.5125,46.1953125,45.614583333333336,57800,182190,39.44240676985424,NaN,1.5,2.75,NaN,NaN,0.3291966813902096,0.3172512212525386,NaN,-0.11470741363188419,0.11207246241272628,0.22677987604461047,10.40152926669151,-1.3568521031207599,NaN,NaN,NaN,2015600
748618200,45.5,45.5625,44.8125,45.28125,NaN,NaN,44.8125,46.96467391304348,NaN,45.16,45.519375,46.1734375,45.650208829219984,45.94757969905751,46.07451923076923,46.799062547454426,45.34997591408404,NaN,45.16,45.519375,46.1734375,45.21875,318200,197320,36.983784056598665,NaN,1.5,2.75,NaN,NaN,0.35925406129090887,1.6126089600648692,NaN,-0.14801667303222016,0.04175903475433529,0.18977570778655545,10.018970829983557,-1.3614703880190606,NaN,NaN,NaN,1697400
748704600,45.4375,45.71875,45.375,45.65625,NaN,NaN,44.82465277777778,46.99320652173913,NaN,45.17625,45.534375,46.1453125,45.65044573787802,45.91983401343299,46.02163461538461,46.76008112965576,45.28318810111347,NaN,45.17625,45.534375,46.1453125,45.583333333333336,439700,205635,45.72764207940368,NaN,1.5,2.75,NaN,NaN,0.3648430569129868,2.138254674544703,NaN,-0.13893351790172503,0.016108810409399155,0.1550423283111242,11.427395194763887,-0.7472826086956522,NaN,NaN,NaN,2137100
748791000,45.78125,45.9375,45.71875,45.90625,NaN,NaN,44.83680555555556,47.02173913043478,NaN,45.1921875,45.55125,46.128125,45.66047727756908,45.91854029786794,45.98557692307692,46.696757966363585,45.274395879790255,NaN,45.1921875,45.55125,46.128125,45.854166666666664,88500,197945,50.644418641192935,NaN,1.5,2.75,NaN,NaN,0.3588721242763449,0.44709388971684055,NaN,-0.11141632300854543,0.015771924550442407,0.12718824755898783,11.869582385681491,-1.0774410774410774,NaN,NaN,NaN,2225600
748877400,45.84375,45.875,45.71875,45.78125,NaN,NaN,44.848958333333336,47.05027173913044,NaN,45.2053125,45.569375,46.103125,45.66521346276245,45.905465031404326,45.96394230769231,46.68152964233421,45.2463549730504,NaN,45.2053125,45.569375,46.103125,45.791666666666664,53500,194620,48.28881085736055,NaN,1.5,2.75,NaN,NaN,0.34663125825660596,0.2748946665296475,NaN,-0.09746520953940845,0.005356735634727272,0.10282194517413572,10.43180568673424,-1.4131897711978465,NaN,NaN,NaN,2172100
749136600,46.125,46.28125,46.125,46.28125,NaN,NaN,44.861111111111114,47.078804347826086,NaN,45.2221875,45.6,46.1046875,45.68937175834039,45.941254076032486,45.99278846153846,46.728695250320136,45.25688167275678,NaN,45.2221875,45.6,46.1046875,46.229166666666664,274600,207065,56.920349787771464,NaN,1.5,2.75,NaN,NaN,0.35758616838113405,1.326153623258397,NaN,-0.0526402106955976,0.03702168180463872,0.08966189250023632,12.57058436108773,0.06756756756756757,NaN,NaN,NaN,2446700
749223000,46.3125,46.3125,46.15625,46.1875,NaN,NaN,44.873263888888886,47.10733695652174,NaN,45.2396875,45.629375,46.0921875,45.70890619918979,45.964706068791294,46.00721153846154,46.750431633364954,45.263991443558126,NaN,45.2396875,45.629375,46.0921875,46.21875,158300,205805,55.0644233441947,NaN,1.5,2.75,NaN,NaN,0.34320501349676735,0.7691747042102961,NaN,-0.0285856193382283,0.05392986832745095,0.08251548766567925,12.405383546864108,-0.40431266846361186,NaN,NaN,NaN,2288400
749309400,46.1875,46.3125,45.96875,46.03125,NaN,NaN,44.885416666666664,47.13586956521739,NaN,45.2565625,45.653125,46.065625,45.721547132554896,45.97104358604927,45.97836538461539,46.68563558690913,45.271095182321645,NaN,45.2565625,45.653125,46.065625,46.104166666666664,221000,213530,52.020053397053886,NaN,1.5,2.75,NaN,NaN,0.3432439411041411,1.0349833747014472,NaN,-0.02273395001084136,0.05409805015212754,0.0768320001629689,12.388391609863216,-0.5401755570560433,NaN,NaN,NaN,2067400
749395800,46.03125,46.125,45.84375,45.9375,NaN,NaN,44.89756944444444,47.16440217391305,NaN,45.2715625,45.675625,46.0375,45.73001587245471,45.967848958806485,45.93990384615385,46.59562090927307,45.28418678303462,NaN,45.2715625,45.675625,46.0375,45.96875,99300,211670,50.22577865848448,NaN,1.5,2.75,NaN,NaN,0.3388158024538453,0.46912647044928424,NaN,-0.02455785447891909,0.04613468206432003,0.07069253654323912,12.38896494523658,0.2728512960436562,NaN,NaN,NaN,1968100
749482200,45.875,46.21875,45.8125,46.15625,NaN,NaN,44.90972222222222,47.192934782608695,NaN,45.286875,45.70875,46.028125,45.74673093628002,45.98579191511063,45.93269230769231,46.5765641939527,45.288820421431915,NaN,45.286875,45.70875,46.028125,46.0625,22700,189185,54.19573336511248,NaN,1.5,2.75,NaN,NaN,0.3436325308499992,0.11998837117107593,NaN,-0.011098055554428554,0.05681996710020343,0.06791802265463198,11.130475809565942,1.5818431911966988,NaN,NaN,NaN,1990800
749741400,46.21875,46.21875,46.09375,46.21875,NaN,NaN,44.921875,47.22146739130435,NaN,45.3034375,45.73875,46.0203125,45.76524148779845,46.00797839938581,45.92067307692308,46.5362830116357,45.30506314221046,NaN,45.3034375,45.73875,46.0203125,46.177083333333336,1038500,209585,55.29290400353807,NaN,1.5,2.75,NaN,NaN,0.3280159215035706,4.955030178686452,NaN,0.001289472403106104,0.06952986315851462,0.06824039075540851,9.556662588179822,2.070393374741201,NaN,NaN,NaN,3029300
749827800,46.3125,46.3125,46,46.15625,NaN,NaN,44.93402777777778,47.25,NaN,45.3246875,45.7625,46.025,45.780575154943605,46.02209950420621,45.91105769230769,46.50744412336462,45.314671261250766,NaN,45.3246875,45.7625,46.025,46.15625,436500,221590,53.902435004108995,NaN,1.5,2.75,NaN,NaN,0.32690764139617273,1.9698542352994268,NaN,0.004375400061295873,0.07370964083202836,0.06933424077073248,9.214362219639192,1.0951403148528405,NaN,NaN,NaN,2592800
749914200,46.1875,46.375,46.125,46.125,NaN,NaN,44.94618055555556,47.27853260869565,NaN,45.3459375,45.78625,46.0359375,45.79408201161248,46.031899551424665,45.93509615384615,46.53880142893692,45.331390878755386,NaN,45.3459375,45.78625,46.0359375,46.208333333333336,209200,218555,53.18230033930122,NaN,1.5,2.75,NaN,NaN,0.3214142384393033,0.9571961291208163,NaN,0.003453824999204075,0.07365152201973757,0.0701976970205335,8.355026232545605,0.4765146358066712,NaN,NaN,NaN,2383600
750000600,46.1875,46.1875,45.96875,46,NaN,NaN,44.958333333333336,47.307065217391305,NaN,45.364375,45.809375,46.0359375,45.80215722684336,46.02886149890803,45.97836538461539,46.509479403063075,45.4472513661677,NaN,45.364375,45.809375,46.0359375,46.052083333333336,59400,209565,50.2881841602467,NaN,1.5,2.75,NaN,NaN,0.3140810785507816,0.28344427743182304,NaN,-0.005922042590851648,0.06279514378196893,0.06871718637282058,8.078770477319056,0.4778156996587031,NaN,NaN,NaN,2324200
750087000,46.125,46.15625,45.71875,46.0625,NaN,NaN,44.970486111111114,47.33559782608695,NaN,45.38375,45.82875,46.01875,45.81236674735931,46.032065165678695,46.03846153846154,46.385282476863445,45.691640600059635,NaN,45.38375,45.82875,46.01875,45.979166666666664,54400,206960,51.70339179392619,NaN,1.5,2.75,NaN,NaN,0.32289671579715434,0.26285272516428293,NaN,-0.00812608897983716,0.05855957514802412,0.06668566412786128,7.874552621290952,-0.4726536124240378,NaN,NaN,NaN,2378600
750346200,46.15625,46.25,46.15625,46.15625,NaN,NaN,44.982638888888886,47.36413043478261,NaN,45.395,45.855,46.0046875,45.82585236510993,46.043892292756915,46.07692307692308,46.348376811795234,45.80546934205093,NaN,45.395,45.855,46.0046875,46.1875,467100,226970,53.82676709532775,NaN,1.5,2.75,NaN,NaN,0.3132255218116433,2.0579812309996917,NaN,-0.0037066140327066954,0.06205239658697792,0.06575901061968462,4.6425720942968836,-0.06765899864682003,NaN,NaN,NaN,2845700
750432600,46.21875,46.25,46.1875,46.21875,NaN,NaN,44.994791666666664,47.39266304347826,NaN,45.405625,45.88,46.003125,45.841260115497775,46.06054540773245,46.10096153846154,46.36288150907364,45.83904156784944,NaN,45.405625,45.88,46.003125,46.21875,26200,219055,55.23962116625159,NaN,1.5,2.75,NaN,NaN,0.2975486988250974,0.11960466549496701,NaN,0.00264682571825145,0.06906754276749894,0.06642071704924749,4.579450454196017,0.4073319755600815,NaN,NaN,NaN,2871900
750519000,46.25,46.25,46.15625,46.21875,NaN,NaN,45.00694444444444,47.421195652173914,NaN,45.4203125,45.904375,45.9953125,45.85606364038021,46.07561251175793,46.13461538461539,46.3266825418765,45.94254822735427,NaN,45.4203125,45.904375,45.9953125,46.208333333333336,139100,220960,55.23962116625158,NaN,1.5,2.75,NaN,NaN,0.282991648909019,0.6295257060101376,NaN,0.005884742691006278,0.07377664541300533,0.06789190272199905,4.024121390573558,0.6122448979591837,NaN,NaN,NaN,2871900
750605400,46.40625,46.8125,46.28125,46.8125,NaN,NaN,45.01909722222222,47.44972826086956,NaN,45.4390625,45.940625,46.021875,45.8935709486006,46.14579227254289,46.17548076923077,46.5816667564511,45.769294782010434,NaN,45.4390625,45.940625,46.021875,46.635416666666664,108100,223650,66.52508627056008,NaN,1.5,2.75,NaN,NaN,0.3051886739869462,0.4833445115135256,NaN,0.044878498758763485,0.1239900261704534,0.07911152741168992,7.858568759544634,1.4218009478672986,NaN,NaN,NaN,2980000
750691800,47.03125,47.15625,46.90625,47.0625,NaN,NaN,45.03125,47.15625,NaN,45.459375,45.98375,46.084375,45.939411303557435,46.23309777039595,46.24278846153846,46.86641861716392,45.619158305913,NaN,45.459375,45.98375,46.084375,47.04166666666666,1502500,288730,69.95950939128392,NaN,1.5,2.75,NaN,NaN,0.30794305441645003,5.203823641464344,NaN,0.08219959582436945,0.18186102219215172,0.09966142636778227,7.941621859504187,1.8255578093306288,NaN,NaN,NaN,4482500
750951000,47.03125,47.03125,46.875,46.9375,NaN,NaN,45.04340277777778,47.17439516129032,NaN,45.4728125,46.023125,46.159375,45.97855203675126,46.300183697024906,46.3125,47.02257515853571,45.60242484146429,NaN,45.4728125,46.023125,46.159375,46.947916666666664,722400,321960,66.29696683326266,NaN,1.5,2.75,NaN,NaN,0.2993399791009893,2.2437569884457695,NaN,0.09239689561607556,0.21515754588787672,0.12276065027180116,8.37202715850643,1.6926201760324984,NaN,NaN,NaN,3760100
751037400,46.875,46.96875,46.59375,46.59375,NaN,NaN,45.05555555555556,47.19254032258065,NaN,45.484375,46.050625,46.225,46.00267744707474,46.32814239254634,46.36298076923077,47.052243571113976,45.67371796734756,NaN,45.484375,46.050625,46.225,46.71875,880100,350055,57.39781419518999,NaN,1.5,2.75,NaN,NaN,0.30474426630806156,2.514176343717416,NaN,0.07088826027126,0.21137097561087614,0.14048271533961615,9.725563453678479,1.016260162601626,NaN,NaN,NaN,2880000
751123800,46.75,46.75,46.5625,46.65625,NaN,NaN,45.067708333333336,47.21068548387097,NaN,45.49875,46.08,46.275,46.02830774326789,46.359390736113355,46.40144230769231,47.09604986578698,45.70683474959763,NaN,45.49875,46.08,46.275,46.65625,230400,339590,58.48885673694258,NaN,1.5,2.75,NaN,NaN,0.29636967585748575,0.6784652080449954,NaN,0.05639883447656141,0.2109812584353179,0.1545824239587565,9.671443496164164,1.4266304347826086,NaN,NaN,NaN,3110400
751210200,46.6875,46.6875,46.53125,46.59375,NaN,NaN,45.079861111111114,47.22883064516129,NaN,45.508125,46.108125,46.309375,46.05048194941425,46.38171066600732,46.43028846153846,47.12329692097541,45.73728000210151,NaN,45.508125,46.108125,46.309375,46.604166666666664,56200,337975,56.9190291037783,NaN,1.5,2.75,NaN,NaN,0.28636112758195104,0.16628448849766994,NaN,0.038962720556708824,0.2032858246546425,0.1643231040979337,9.50199637032366,1.153324287652646,NaN,NaN,NaN,3054200
751296600,46.65625,46.84375,46.375,46.375,NaN,NaN,45.092013888888886,47.246975806451616,NaN,45.5159375,46.134375,46.3390625,46.06320814747644,46.38107155495901,46.44711538461539,47.123104961668865,45.77112580756191,NaN,45.5159375,46.134375,46.3390625,46.53125,390700,354835,51.68981370084479,NaN,1.5,2.75,NaN,NaN,0.2993889041832402,1.1010751476038159,NaN,0.010533395617322333,0.1774898486195866,0.16695645300226428,10.101140662877924,0.47393364928909953,NaN,NaN,NaN,2663500
751555800,46.40625,46.5625,46.28125,46.5,NaN,NaN,45.104166666666664,47.265120967741936,NaN,45.5265625,46.161875,46.35,46.080337239732266,46.39239807353434,46.47596153846154,47.12601416491552,45.82590891200756,NaN,45.5265625,46.161875,46.35,46.447916666666664,114500,346830,54.274929865008545,NaN,1.5,2.75,NaN,NaN,0.2980932681701516,0.3301329181443358,NaN,-0.0013826346266400669,0.1652281597189642,0.16661079434560427,10.140412059357033,0.6085192697768763,NaN,NaN,NaN,2778000
751642200,46.46875,46.5,46.3125,46.46875,NaN,NaN,45.11631944444444,47.283266129032256,NaN,45.5384375,46.18375,46.3640625,46.09556911268394,46.39966968557869,46.51201923076923,47.10166265174977,45.9223758097887,NaN,45.5384375,46.18375,46.3640625,46.42708333333334,186200,348225,53.50410949460972,NaN,1.5,2.75,NaN,NaN,0.2901937490151408,0.5347117524588987,NaN,-0.012292152343016088,0.15124560391683417,0.16353775625985026,10.162279381062138,0.5409060175794456,NaN,NaN,NaN,2591800
751728600,46.40625,46.53125,46.40625,46.5,NaN,NaN,45.12847222222222,47.301411290322584,NaN,45.5521875,46.203125,46.3875,46.11142914748065,46.40922495361881,46.54567307692308,47.075785198032726,46.015560955813434,NaN,45.5521875,46.203125,46.3875,46.479166666666664,118400,343095,54.204533596757024,NaN,1.5,2.75,NaN,NaN,0.2783941955140593,0.3450939244232647,NaN,-0.01798229227043263,0.14105989092180948,0.15904218319224211,10.156556927502923,-0.6675567423230975,NaN,NaN,NaN,2710200
751815000,46.5625,46.96875,46.5625,46.84375,NaN,NaN,45.140625,47.319556451612904,NaN,45.5734375,46.224375,46.4328125,46.14014761228533,46.4506082913694,46.59855769230769,47.099065939908584,46.0980494447068,NaN,45.5734375,46.224375,46.4328125,46.791666666666664,129600,344610,61.13933609067831,NaN,1.5,2.75,NaN,NaN,0.2919910386916265,0.3760773047793157,NaN,-0.00011873555382702072,0.15889376374995834,0.15901249930378536,8.050519672291799,-0.4648074369189907,NaN,NaN,NaN,2839800
751901400,46.8125,46.875,46.78125,46.84375,NaN,NaN,45.15277777777778,47.337701612903224,NaN,45.593125,46.245625,46.4671875,46.16773986278395,46.488050358858025,46.64663461538461,47.110720135329096,46.18254909544013,NaN,45.593125,46.245625,46.4671875,46.833333333333336,80700,347510,61.13933609067831,NaN,1.5,2.75,NaN,NaN,0.27783096449936745,0.2322235331357371,NaN,0.009634333432136988,0.17105541609395658,0.1614210826618196,7.326679496741752,-0.19973368841544606,NaN,NaN,NaN,2839800
752164200,46.78125,47,46.78125,46.96875,NaN,NaN,45.16493055555556,47.35584677419355,NaN,45.61375,46.26875,46.5046875,46.199152025027715,46.53383127706202,46.70432692307692,47.12581651527382,46.28283733088002,NaN,45.61375,46.26875,46.5046875,46.916666666666664,36400,297405,63.47211111148044,NaN,1.5,2.75,NaN,NaN,0.2736108956065555,0.12239202434390814,NaN,0.02174788322484872,0.1886059366928805,0.1668580534680318,7.380151992138713,0.8048289738430584,NaN,NaN,NaN,2876200
752250600,46.90625,47,46.65625,46.9375,NaN,NaN,45.177083333333336,47.37399193548387,NaN,45.6321875,46.293125,46.54375,46.228106847575646,46.57227591734183,46.71394230769231,47.15030494595408,46.27757966943053,NaN,45.6321875,46.293125,46.54375,46.864583333333336,262100,288685,62.46260849445589,NaN,1.5,2.75,NaN,NaN,0.27862083163465867,0.9079100057155723,NaN,0.024684846563770735,0.19771411167274522,0.17302926510897448,5.740331526567745,0.6028131279303416,NaN,NaN,NaN,2614100
752337000,46.90625,46.90625,46.125,46.34375,NaN,NaN,45.189236111111114,47.39213709677419,NaN,45.6453125,46.295625,46.5546875,46.232641873160915,46.55051154426165,46.65865384615385,47.08640339268449,46.230904299623205,NaN,45.6453125,46.295625,46.5546875,46.458333333333336,479100,302180,47.12615885290143,NaN,1.5,2.75,NaN,NaN,0.31675505794646874,1.5854788536633795,NaN,-0.014237554833836485,0.15523232156667888,0.16946987640051536,9.579822414087623,-0.5365526492287056,NaN,NaN,NaN,2135000
752423400,46.34375,46.34375,45.8125,45.84375,NaN,NaN,45.201388888888886,47.41028225806452,NaN,45.654375,46.2875,46.546875,46.21739121146833,46.48320092099864,46.57451923076923,47.15336219012617,45.9956762714123,NaN,45.654375,46.2875,46.546875,46,130400,305730,38.5437411566288,NaN,1.5,2.75,NaN,NaN,0.3320761252360067,0.4265201321427403,NaN,-0.07134086224982869,0.08029379858822949,0.15163466083805818,11.229577194267097,-1.1455525606469004,NaN,NaN,NaN,2004600
752509800,45.71875,46.0625,45.53125,46.0625,NaN,NaN,45.53125,47.42842741935484,NaN,45.6646875,46.283125,46.546875,46.21131704631271,46.44313416661782,46.53365384615385,47.17313114287215,45.89417654943554,NaN,45.6646875,46.283125,46.546875,45.885416666666664,363200,321170,43.400256943889055,NaN,1.5,2.75,NaN,NaN,0.34630283057629196,1.1308652738425133,NaN,-0.09081461347718872,0.038116393991572295,0.12893100746876102,11.58595702622505,-0.9408602150537635,NaN,NaN,NaN,2367800
752769000,46.09375,46.25,45.96875,46.125,NaN,NaN,45.553030303030305,47.44657258064516,NaN,45.6740625,46.280625,46.5453125,46.20793206410437,46.41283567455898,46.49278846153846,47.16287108693103,45.82270583614589,NaN,45.6740625,46.280625,46.5453125,46.11458333333334,367600,316195,44.743814349316395,NaN,1.5,2.75,NaN,NaN,0.34165619982084255,1.1625737282373219,NaN,-0.09544656677045657,0.009622799005690297,0.10506936577614687,11.468927126690948,-0.7397444519166106,NaN,NaN,NaN,2735400
752855400,46.4375,46.46875,46.125,46.15625,NaN,NaN,45.57481060606061,47.46471774193548,NaN,45.690625,46.275,46.5421875,46.205905316492434,46.388398943648596,46.45913461538461,47.149201769736585,45.76906746103264,NaN,45.690625,46.275,46.5421875,46.25,246900,327230,45.441181382328814,NaN,1.5,2.75,NaN,NaN,0.3418057569764966,0.7545151728142285,NaN,-0.09230991396825157,-0.010318026684167592,0.08199188728408398,11.500869178472811,-0.739247311827957,NaN,NaN,NaN,2982300
752941800,46.15625,46.5,46.03125,46.5,NaN,NaN,45.59659090909091,47.48286290322581,NaN,45.7096875,46.27375,46.55625,46.217438441335865,46.399027615682066,46.46875,47.15734179042865,45.78015820957135,NaN,45.7096875,46.27375,46.55625,46.34375,46500,322600,52.537150083478494,NaN,1.5,2.75,NaN,NaN,0.3508732029067469,0.14414135151890886,NaN,-0.06431506498195252,0.0015980560566433155,0.06591312103859584,12.404117640381536,-0.733822548365577,NaN,NaN,NaN,3028800
753028200,46.5,46.625,46.34375,46.375,NaN,NaN,45.61837121212121,47.50100806451613,45.20640875,45.7271875,46.27125,46.534375,46.22361732598936,46.39673927133139,46.45913461538461,47.149201769736585,45.76906746103264,45.20640875,45.7271875,46.27125,46.534375,46.447916666666664,88900,321640,49.99096347335813,NaN,1.5,2.75,NaN,NaN,0.3459001169848364,0.2763959706504166,NaN,-0.05197505932573965,0.0009442968814212804,0.05291935620716093,11.533202074096385,-1.0006671114076051,NaN,NaN,NaN,2939900
753114600,46.46875,46.75,46.4375,46.59375,NaN,NaN,45.640151515151516,47.51915322580645,45.2196875,45.7509375,46.27625,46.5109375,46.23813233281331,46.415502197871255,46.46875,47.16255846947016,45.77494153052984,45.2196875,45.7509375,46.27625,46.5109375,46.59375,108200,251925,54.17635493449088,NaN,1.5,2.75,NaN,NaN,0.3479786800573481,0.4294929046343158,NaN,-0.028038306060504767,0.017871473631529966,0.04590977969203473,11.989346297308963,-0.7984031936127745,NaN,NaN,NaN,3048100
753373800,46.6875,46.6875,46.4375,46.5625,NaN,NaN,45.66193181818182,47.537298387096776,45.23125,45.7684375,46.28,46.4921875,46.2508526334873,46.429501988550186,46.47355769230769,47.16902989365027,45.77808549096512,45.23125,45.7684375,46.28,46.4921875,46.5625,243300,227970,53.487658513064964,NaN,1.5,2.75,NaN,NaN,0.3409802029103947,1.0672456902223977,NaN,-0.013978251203379907,0.028436965687809845,0.04241521689118975,11.815556459320984,-0.7989347536617842,NaN,NaN,NaN,2804800
753460200,46.65625,46.8125,46.46875,46.78125,NaN,NaN,45.683712121212125,47.555443548387096,45.2434375,45.7884375,46.294375,46.5015625,46.27165253021329,46.46300179916445,46.46875,47.15471857407263,45.78278142592737,45.2434375,45.7884375,46.294375,46.5015625,46.6875,492600,208595,57.555142465944904,NaN,1.5,2.75,NaN,NaN,0.34117804555965225,2.3615139384932524,NaN,0.009140504342653177,0.053840847319506224,0.04470034297685305,12.239793823261733,0.9440323668240054,NaN,NaN,NaN,3297400
753546600,46.8125,46.8125,46.40625,46.53125,NaN,NaN,45.70549242424242,47.573588709677416,45.25203125,45.8009375,46.306875,46.4953125,46.2818328231461,46.469501627815454,46.44471153846154,47.09753171767646,45.79189135924662,45.25203125,45.8009375,46.306875,46.4953125,46.583333333333336,39600,199055,51.962415627057894,NaN,1.5,2.75,NaN,NaN,0.3458260423053914,0.19893999145964683,NaN,0.0067897916437856115,0.053187582531585065,0.04639779088779945,10.047353581059658,1.499659168370825,NaN,NaN,NaN,3257800
753633000,46.46875,46.5625,46.28125,46.40625,NaN,NaN,45.72727272727273,47.591733870967744,45.2590625,45.814375,46.315,46.4859375,46.28671192812076,46.4634776632616,46.40144230769231,46.97992577444072,45.82295884094389,45.2590625,45.814375,46.315,46.4859375,46.416666666666664,240800,208285,49.37876160765986,NaN,1.5,2.75,NaN,NaN,0.34121346785500634,1.1561082171063686,NaN,-0.0034397294127394354,0.04209812912187516,0.045537858534614596,7.470451139021698,0.746268656716418,NaN,NaN,NaN,3017000
753719400,46.25,46.375,46.21875,46.3125,NaN,NaN,45.74905303030303,47.609879032258064,45.26578125,45.826875,46.313125,46.4828125,46.2877232250572,46.449098838189066,46.35336538461539,46.842664711572986,45.86406605765779,45.26578125,45.826875,46.313125,46.4828125,46.302083333333336,106000,194050,47.47228657810394,NaN,1.5,2.75,NaN,NaN,0.3302339344367916,0.5462509662458129,NaN,-0.01606914467926058,0.025451427685538874,0.04152057236479945,7.306732313009092,0.4065040650406504,NaN,NaN,NaN,2911000
753978600,46.1875,46.21875,45.875,46.03125,NaN,NaN,45.770833333333336,47.628024193548384,45.27109375,45.8378125,46.305,46.459375,46.27766545152554,46.409303710742485,46.32932692307692,46.84797866574828,45.81067518040556,45.27109375,45.8378125,46.305,46.459375,46.041666666666664,165300,196590,42.207438303802064,NaN,1.5,2.75,NaN,NaN,0.337895796262735,0.8408362582023501,NaN,-0.04146989946018787,-0.010316801960435384,0.031153097499752487,8.196271779220192,-0.2708192281651997,NaN,NaN,NaN,2745700
754065000,46.28125,46.3125,46.03125,46.28125,NaN,NaN,45.79261363636363,47.64616935483871,45.27921875,45.85375,46.305625,46.45,46.27780602205395,46.3971081192432,46.36298076923077,46.80187857850059,45.92408295996094,45.27921875,45.85375,46.305625,46.45,46.208333333333336,89700,191765,47.754081606601964,NaN,1.5,2.75,NaN,NaN,0.33384966795825394,0.46776001877297735,NaN,-0.03954628069590065,-0.01827975337012333,0.021266527325777322,8.809296046858426,-0.47043010752688175,NaN,NaN,NaN,2835400
754151400,46.40625,46.5,46.34375,46.46875,NaN,NaN,45.81439393939394,47.66431451612903,45.28796875,45.87625,46.3075,46.4484375,46.28529402118909,46.40393115550575,46.39423076923077,46.7996763200451,45.98878521841643,45.28796875,45.87625,46.3075,46.4484375,46.4375,77200,189705,51.512732174889585,NaN,1.5,2.75,NaN,NaN,0.32562826310409293,0.4069476292137793,NaN,-0.024495583244321613,-0.009352951729624692,0.015142631514696919,7.98283048091951,0.20215633423180593,NaN,NaN,NaN,2912600
754324200,46.59375,46.59375,46.46875,46.5,NaN,NaN,45.83617424242424,47.68245967741935,45.29578125,45.8978125,46.311875,46.43125,46.2937138634954,46.41308056926711,46.42307692307692,46.80016676059925,46.04598708555459,45.29578125,45.8978125,46.311875,46.43125,46.520833333333336,1019800,234215,52.13084643901389,NaN,1.5,2.75,NaN,NaN,0.31129767288237203,4.354119078624341,NaN,-0.01192174919817535,0.00024044501697773057,0.01216219421515308,7.810113510726166,-0.2012072434607646,NaN,NaN,NaN,3932400
754583400,46.625,46.71875,46.3125,46.3125,NaN,NaN,45.85795454545455,47.70060483870968,45.304375,45.9125,46.321875,46.4046875,46.294450574730874,46.40350146743214,46.43509615384615,46.78648551374289,46.08370679394942,45.304375,45.9125,46.321875,46.4046875,46.447916666666664,517500,256055,48.16354304426621,NaN,1.5,2.75,NaN,NaN,0.3180799819622026,2.0210501650036123,NaN,-0.015492448189885091,-0.007203366022203284,0.008289082167681807,7.602622991226025,-0.5369127516778524,NaN,NaN,NaN,3414900
754669800,46.28125,46.5625,46.25,46.34375,NaN,NaN,45.87973484848485,47.71875,45.31875,45.92625,46.34,46.3734375,46.29638388552574,46.39781085148623,46.42307692307692,46.7754515808041,46.07070226534974,45.31875,45.92625,46.34,46.3734375,46.385416666666664,230000,265735,48.86206055059889,NaN,1.5,2.75,NaN,NaN,0.3176814118220453,0.8655239242102094,NaN,-0.014999621393357502,-0.010460444574015071,0.004539176819342431,7.637423799022836,-0.9352037408149633,NaN,NaN,NaN,3644900
754756200,46.59375,46.625,46.40625,46.40625,NaN,NaN,45.90151515151515,47.73689516129032,45.33359375,45.9409375,46.3625,46.346875,46.300692360603165,46.398614579916114,46.42548076923077,46.77693590158751,46.074025636874026,45.33359375,45.9409375,46.3625,46.346875,46.479166666666664,379200,271590,50.30442298170287,NaN,1.5,2.75,NaN,NaN,0.31507916812047065,1.3962222467690268,NaN,-0.009957200985803525,-0.007907324412911976,0.0020498765728915497,7.029937663272931,-0.2686366689053056,NaN,NaN,NaN,4024100
754842600,46.5,46.5625,46.40625,46.53125,NaN,NaN,45.92329545454545,47.75504032258065,45.34921875,45.9571875,46.38,46.35625,46.30973383665794,46.41124652468601,46.42067307692308,46.76441467176373,46.07693148208243,45.34921875,45.9571875,46.38,46.35625,46.5,352000,265235,53.15052575097776,NaN,1.5,2.75,NaN,NaN,0.30373422754043705,1.327125002356401,NaN,0.0016837830106897845,0.0041546053362537805,0.002470822325563996,6.629149251680419,0.26936026936026936,NaN,NaN,NaN,4376100
754929000,46.5,46.71875,46.5,46.71875,NaN,NaN,45.94507575757576,47.77318548387097,45.365,45.97375,46.39625,46.4,46.32577368620077,46.44053256995401,46.43269230769231,46.80515661439037,46.06022800099424,45.365,45.97375,46.39625,46.4,46.645833333333336,306000,274015,57.11774663255675,NaN,1.5,2.75,NaN,NaN,0.297663925573263,1.116727186467894,NaN,0.02083514551891797,0.028514754224211458,0.007679608705293489,6.7500524784152836,0.8771929824561403,NaN,NaN,NaN,4682100
755188200,46.78125,46.9375,46.78125,46.875,NaN,NaN,45.96685606060606,46.9375,45.38078125,45.99375,46.418125,46.440625,46.347311973016424,46.48191042043458,46.43990384615385,46.84156920335112,46.03823848895657,45.38078125,45.99375,46.418125,46.440625,46.864583333333336,99500,260830,60.146419987195316,NaN,1.5,2.75,NaN,NaN,0.29202721660374426,0.3814745236360848,NaN,0.041648132203831,0.05973977396008223,0.018091641756251237,6.668131227989827,1.8329938900203666,NaN,NaN,NaN,4781600
755274600,46.875,46.90625,46.78125,46.84375,NaN,NaN,45.98863636363637,46.93125,45.3965625,46.0146875,46.429375,46.4765625,46.36678013093735,46.51637133277414,46.46394230769231,46.918517178981936,46.00936743640268,45.3965625,46.0146875,46.429375,46.4765625,46.84375,88800,246890,59.24517573217495,NaN,1.5,2.75,NaN,NaN,0.2800967011320482,0.35967434890031996,NaN,0.05035080509417654,0.08103014812397191,0.030679343029795372,5.022782776304557,1.2153950033760972,NaN,NaN,NaN,4692800
755361000,46.84375,46.84375,46.78125,46.84375,NaN,NaN,46.010416666666664,46.925,45.40953125,46.0359375,46.4425,46.5109375,46.385484831684906,46.54755025346232,46.49759615384615,46.99304511646205,46.00214719123026,45.40953125,46.0359375,46.4425,46.5109375,46.822916666666664,146700,241880,59.24517573217495,NaN,1.5,2.75,NaN,NaN,0.2645540796226162,0.6064990904580784,NaN,0.05288630174502521,0.09678722021107689,0.043900918466051674,4.513057608962828,0.8069939475453934,NaN,NaN,NaN,4692800
755447400,46.84375,46.90625,46.625,46.6875,NaN,NaN,46.03219696969697,46.91875,45.42125,46.054375,46.455625,46.5203125,46.397328563775694,46.560878800751624,46.52644230769231,47.01908417143971,46.033800443944905,45.42125,46.054375,46.455625,46.5203125,46.73958333333334,416500,260380,54.508874533701466,NaN,1.5,2.75,NaN,NaN,0.2657466453638579,1.5995852215992012,NaN,0.041331368331878185,0.09556512888089941,0.05423376054902122,4.795568703730514,0.4032258064516129,NaN,NaN,NaN,4276300
755533800,46.71875,46.71875,46.5,46.59375,NaN,NaN,46.05397727272727,46.9125,45.4321875,46.0721875,46.46875,46.53125,46.40503136519626,46.56400939115623,46.56971153846154,46.97114664894544,46.16827642797764,45.4321875,46.0721875,46.46875,46.53125,46.60416666666666,412900,276580,51.831459528208015,NaN,1.5,2.75,NaN,NaN,0.2623897421235823,1.4928772868609443,NaN,0.025444956474453183,0.0860399561420877,0.06059499966763452,4.996420863802719,0.6072874493927125,NaN,NaN,NaN,3863400
755793000,46.59375,46.875,46.53125,46.875,NaN,NaN,46.07575757575758,46.90625,45.44515625,46.0959375,46.483125,46.5453125,46.423461507737585,46.59362754437945,46.61538461538461,47.0102012532248,46.22056797754443,45.44515625,46.0959375,46.483125,46.5453125,46.760416666666664,273200,284830,58.42851262262464,NaN,1.5,2.75,NaN,NaN,0.268201189114755,0.9591686269002563,NaN,0.03155007953229291,0.10003259908300066,0.06848251955070775,5.201268873879877,1.1463250168577208,NaN,NaN,NaN,4136600
755879400,46.90625,46.90625,46.53125,46.53125,NaN,NaN,46.097537878787875,46.9,45.453125,46.1140625,46.489375,46.54375,46.42768850743415,46.587686825867124,46.62019230769231,47.00922939084863,46.23115522453598,45.453125,46.1140625,46.489375,46.54375,46.65625,41900,274760,49.5043980850659,NaN,1.5,2.75,NaN,NaN,0.2758296756065582,0.15249672441403406,NaN,0.01116108109003873,0.08243387091325616,0.07127278982321743,7.168378292610164,0.26936026936026936,NaN,NaN,NaN,4094700
755965800,46.59375,46.625,46.46875,46.46875,NaN,NaN,46.11931818181818,46.89375,45.45984375,46.1290625,46.495625,46.528125,46.429298762044574,46.57635950911787,46.61778846153846,47.01013857236605,46.22543835071087,45.45984375,46.1290625,46.495625,46.528125,46.520833333333336,82600,254260,48.06689634362693,NaN,1.5,2.75,NaN,NaN,0.26728827020608975,0.3248643121214505,NaN,-0.006841814855225739,0.06272052125418526,0.069562336109411,7.204930811836822,-0.1343183344526528,NaN,NaN,NaN,4012100
756052200,46.65625,46.65625,46.5625,46.625,NaN,NaN,46.141098484848484,46.8875,45.46859375,46.1459375,46.505625,46.5328125,46.436973320395765,46.58099193682093,46.64182692307692,46.99249197170898,46.29116187444486,45.46859375,46.1459375,46.505625,46.5328125,46.614583333333336,78200,256190,51.83257065867029,NaN,1.5,2.75,NaN,NaN,0.26158910804851193,0.30524220305242206,NaN,-0.00842969858791004,0.05902521287452345,0.06745491146243349,7.3007589304722,-0.20066889632107024,NaN,NaN,NaN,4090300
756138600,46.40625,46.59375,46.375,46.5625,NaN,NaN,46.16287878787879,46.88125,45.47765625,46.163125,46.516875,46.540625,46.441895935282204,46.57923079998084,46.65865384615385,46.96918760119502,46.348120091112676,45.47765625,46.163125,46.516875,46.540625,46.510416666666664,104700,249385,50.262612033831495,NaN,1.5,2.75,NaN,NaN,0.2607613146164754,0.4198327886601039,NaN,-0.01358663216013789,0.050471621262261124,0.06405825342239901,6.913265570907099,-0.6666666666666666,NaN,NaN,NaN,3985600
756397800,46.53125,46.65625,46.5,46.625,NaN,NaN,46.18465909090909,46.875,45.48203125,46.1784375,46.528125,46.55625,46.449076486839765,46.58358977141124,46.67548076923077,46.95124289230551,46.399718646156025,45.48203125,46.1784375,46.528125,46.55625,46.59375,68800,247525,51.83374528486209,NaN,1.5,2.75,NaN,NaN,0.25329622071529856,0.27795172204827795,NaN,-0.01270206738833242,0.048180669186983494,0.06088273657531591,6.614130905352746,-0.466977985323549,NaN,NaN,NaN,4054400
756484200,46.5625,46.5625,46.40625,46.46875,NaN,NaN,46.20643939393939,46.86875,45.48640625,46.1946875,46.534375,46.578125,46.44984799715977,46.57265265032446,46.67067307692308,46.9582518543982,46.38309429944796,45.48640625,46.1946875,46.534375,46.578125,46.47916666666666,205700,249545,47.771004519836374,NaN,1.5,2.75,NaN,NaN,0.25082863352134865,0.82430022641207,NaN,-0.022008342223938514,0.03337230879539277,0.05538065101933128,6.810517235533036,-0.800533689126084,NaN,NaN,NaN,3848700
756570600,46.59375,46.8125,46.5,46.78125,NaN,NaN,46.228219696969695,46.8625,45.491875,46.2128125,46.545625,46.603125,46.4628441541339,46.59251906457927,46.67548076923077,46.968158293372845,46.38280324508869,45.491875,46.2128125,46.545625,46.603125,46.697916666666664,410300,265575,55.31472570745938,NaN,1.5,2.75,NaN,NaN,0.2574658739841095,1.5449496375788383,NaN,-0.00724949621303847,0.046318780753033195,0.053568276966071665,8.066773864534811,0.20080321285140562,NaN,NaN,NaN,4259000
756657000,46.75,46.84375,46.6875,46.75,NaN,NaN,46.25,46.85625,45.4978125,46.2303125,46.55625,46.6171875,46.474105167697275,46.607517248905054,46.66586538461539,46.93927052323232,46.39246024599846,45.4978125,46.2303125,46.55625,46.6171875,46.760416666666664,533800,288405,54.46750584752397,NaN,1.5,2.75,NaN,NaN,0.2502361686995302,1.8508694370763337,NaN,-0.00010158063917910937,0.05344130116709778,0.053542881806276886,7.820550212067683,0.335345405767941,NaN,NaN,NaN,3725200
757002600,46.75,47,46.75,47,NaN,NaN,46.271780303030305,46.85,45.50734375,46.2503125,46.56,46.6421875,46.49472849445424,46.64489655853315,46.67788461538461,46.99219152170864,46.363577709060586,45.50734375,46.2503125,46.56,46.6421875,46.916666666666664,447100,259770,59.775394765057946,NaN,1.5,2.75,NaN,NaN,0.2502192995067066,1.7211379297070486,NaN,0.019850195110765315,0.07835562569473353,0.05850543058396822,8.20872328596936,0.26666666666666666,NaN,NaN,NaN,4172300
757089000,46.96875,47.125,46.9375,47.09375,NaN,NaN,46.29356060606061,46.84375,45.51625,46.2721875,46.560625,46.68125,46.51821953388741,46.68764450533951,46.69711538461539,47.074021290818344,46.32020947841243,45.51625,46.2721875,46.560625,46.68125,47.052083333333336,880600,277925,61.58393913047901,NaN,1.5,2.75,NaN,NaN,0.24573934954194185,3.16848070522623,NaN,0.03676452473208271,0.1044610864990716,0.06769656176698889,7.587672317186671,1.2088650100738751,NaN,NaN,NaN,5052900
757175400,47.125,47.15625,47,47.03125,NaN,NaN,46.31534090909091,46.8375,45.52484375,46.2928125,46.5625,46.715625,46.538338375695744,46.72036883816432,46.72355769230769,47.14019353929467,46.306921845320716,45.52484375,46.2928125,46.5625,46.715625,47.0625,266700,279760,59.658185003779856,NaN,1.5,2.75,NaN,NaN,0.23934725314608887,0.9533171289676866,NaN,0.040833061096655326,0.11873788813780806,0.07790482704115273,5.921508030205396,1.21049092131809,NaN,NaN,NaN,4786200
757261800,47,47,46.75,46.84375,NaN,NaN,46.33712121212121,46.83125,45.53390625,46.3090625,46.5675,46.7375,46.55031530213905,46.73211942500581,46.74278846153846,47.156752824837604,46.328824098239316,45.53390625,46.3090625,46.5675,46.7375,46.864583333333336,219900,271795,54.18410414564069,NaN,1.5,2.75,NaN,NaN,0.24234030649279684,0.8090656561011056,NaN,0.028566548929972707,0.1136130132036186,0.0850464642736459,6.483901721288094,0.4691689008042895,NaN,NaN,NaN,4566300
757348200,46.9375,47,46.5625,46.59375,NaN,NaN,46.358901515151516,46.825,45.5403125,46.323125,46.56625,46.740625,46.55201862362379,46.71894138452907,46.72115384615385,47.134615384616204,46.30769230769149,45.5403125,46.323125,46.56625,46.740625,46.71875,312900,269840,47.87621053800365,NaN,1.5,2.75,NaN,NaN,0.2562802846004542,1.1595760450637416,NaN,0.0026508627115785083,0.08836004266311903,0.08570917995154052,7.121899129420138,0.06711409395973154,NaN,NaN,NaN,4253400
757607400,46.59375,46.65625,46.40625,46.46875,NaN,NaN,46.38068181818182,46.81875,45.5475,46.3359375,46.56375,46.728125,46.54875318740325,46.69511363362154,46.71634615384615,47.13985991433887,46.292832393353436,45.5475,46.3359375,46.56375,46.728125,46.510416666666664,960900,302585,45.05209695200223,NaN,1.5,2.75,NaN,NaN,0.25583169284327895,3.175636597980733,NaN,-0.02249015215390754,0.0575964897591561,0.08008664191306364,7.250302989430311,-0.3351206434316354,NaN,NaN,NaN,3292500
757693800,46.53125,46.65625,46.46875,46.65625,NaN,NaN,46.402462121212125,46.8125,45.556875,46.351875,46.569375,46.7171875,46.55296874868155,46.69141233518139,46.73076923076923,47.131743451190985,46.32979501034748,45.556875,46.351875,46.569375,46.7171875,46.59375,164300,305825,49.832462606074095,NaN,1.5,2.75,NaN,NaN,0.2509508576401876,0.5372353470121801,NaN,-0.025833404931388013,0.04779488574882862,0.07362829068021663,7.613192133181231,0.4034969737726967,NaN,NaN,NaN,3456800
757780200,46.71875,46.78125,46.53125,46.75,NaN,NaN,46.42424242424242,46.80625,45.56625,46.368125,46.574375,46.7125,46.56069546441953,46.696992112783164,46.74038461538461,47.1367204585677,46.344048772201525,45.56625,46.368125,46.574375,46.7125,46.6875,710900,336930,52.07740404948229,NaN,1.5,2.75,NaN,NaN,0.250882939237317,2.1099338141453714,NaN,-0.021263010317384742,0.0470495277834857,0.06831253810087044,7.348869063287009,-0.06680026720106881,NaN,NaN,NaN,4167700
757866600,46.8125,46.84375,46.6875,46.75,NaN,NaN,46.44602272727273,46.8,45.575625,46.381875,46.58,46.7078125,46.5681191716972,46.70204048299429,46.75480769230769,47.13761594687396,46.37199943774143,45.575625,46.381875,46.58,46.7078125,46.760416666666664,201000,339645,52.077404049482276,NaN,1.5,2.75,NaN,NaN,0.24412344357750865,0.5917943735370754,NaN,-0.017906525750442798,0.04592938091281695,0.06383590666325975,6.238736226010243,0,NaN,NaN,NaN,4167700
757953000,46.84375,47.0625,46.71875,47.03125,NaN,NaN,46.46780303030303,46.79375,45.585,46.396875,46.590625,46.725,46.58628116496398,46.73339377032817,46.78605769230769,47.187262423942336,46.38485296067305,45.585,46.396875,46.590625,46.725,46.9375,775500,357595,58.53350334013004,NaN,1.5,2.75,NaN,NaN,0.25123962617911516,2.1686544834239854,NaN,0.0025026815920436707,0.06696425865331435,0.06446157706127068,7.112899321906929,0.06648936170212766,NaN,NaN,NaN,4943200
758212200,47.09375,47.59375,46.96875,47.59375,NaN,NaN,46.489583333333336,46.7875,45.5984375,46.415,46.605625,46.775,46.6257897467301,46.81533245886835,46.87259615384615,47.421010355061235,46.32418195263107,45.5984375,46.415,46.605625,46.775,47.385416666666664,593700,366635,67.8595319148957,NaN,1.5,2.75,NaN,NaN,0.27793679573774976,1.6193216686895686,NaN,0.050473334661724836,0.12755324538842672,0.07707991072670188,9.34695096388403,1.06171201061712,NaN,NaN,NaN,5536900
758298600,47.5625,47.5625,47.34375,47.5,NaN,NaN,46.51136363636363,46.78125,45.61046875,46.4321875,46.61875,46.80625,46.66007250176029,46.88053889135708,46.92788461538461,47.56591447408518,46.28985475668404,45.61046875,46.4321875,46.61875,46.80625,47.46875,295200,367735,65.22649544435947,NaN,1.5,2.75,NaN,NaN,0.2759413103279105,0.8027519817259712,NaN,0.0712088862378725,0.1660910185240425,0.09488213228617001,9.507609504785815,0.9966777408637874,NaN,NaN,NaN,5241700
758385000,47.53125,47.53125,47.1875,47.34375,NaN,NaN,46.53314393939394,46.775,45.62109375,46.4475,46.62625,46.846875,46.6868833840442,46.92465423503735,46.97355769230769,47.638550351430965,46.30856503318442,45.62109375,46.4475,46.62625,46.846875,47.354166666666664,158400,373560,60.97966902126846,NaN,1.5,2.75,NaN,NaN,0.2807847881616312,0.42402826855123676,NaN,0.06963610850756059,0.18192726792062075,0.11229115941306016,9.736814342927882,1.067378252168112,NaN,NaN,NaN,5083300
758471400,47.21875,47.3125,47.15625,47.21875,NaN,NaN,46.55492424242424,46.76875,45.63125,46.4625,46.631875,46.884375,46.70774089839541,46.95266335550998,46.99038461538461,47.668149880383645,46.31261935038558,45.63125,46.4625,46.631875,46.884375,47.229166666666664,244300,381645,57.7407678881222,NaN,1.5,2.75,NaN,NaN,0.274121589007229,0.6401236751431304,NaN,0.05599893697670477,0.1822898306339411,0.12629089365723634,9.529560183117837,1.341381623071764,NaN,NaN,NaN,4839000
758557800,47.375,47.5,47.375,47.40625,NaN,NaN,46.57670454545455,46.7625,45.643125,46.474375,46.653125,46.9234375,46.73513341218382,46.99586208355665,47.01442307692308,47.726448637846524,46.30239751599964,45.643125,46.474375,46.653125,46.9234375,47.427083333333336,137200,384595,61.08010476594947,NaN,1.5,2.75,NaN,NaN,0.27463076122099833,0.35673890716207957,NaN,0.05533030724205182,0.1954537777098011,0.14012347046774928,8.803704246043113,2.0174848688634834,NaN,NaN,NaN,4976200
758817000,47.40625,47.46875,47.3125,47.40625,NaN,NaN,46.59848484848485,46.75625,45.6596875,46.4859375,46.684375,46.965625,46.76145170974524,47.034946647027446,47.04326923076923,47.78543118338175,46.301107278156714,45.6596875,46.4859375,46.684375,46.965625,47.395833333333336,17700,380245,61.08010476594947,NaN,1.5,2.75,NaN,NaN,0.2661749925623556,0.04654893555470815,NaN,0.05073323801021837,0.20354001798052224,0.15280677997030387,8.43904960443894,1.607501674480911,NaN,NaN,NaN,4976200
758903400,47.46875,47.53125,47.375,47.46875,NaN,NaN,46.62026515151515,46.75,45.67546875,46.4978125,46.7125,47.0078125,46.789188897598365,47.07626125207245,47.09134615384615,47.85620754245578,46.32648476523653,45.67546875,46.4978125,46.7125,47.0078125,47.458333333333336,166400,385125,62.23379725351027,NaN,1.5,2.75,NaN,NaN,0.2583232073793302,0.4320675105485232,NaN,0.04778785765040078,0.21254160203330486,0.16475374438290408,8.343562650392935,1.5374331550802138,NaN,NaN,NaN,5142600
758989800,47.40625,47.46875,47.25,47.34375,NaN,NaN,46.64204545454545,46.74375,45.69125,46.50875,46.736875,47.0515625,46.810936391810195,47.101736370922694,47.14903846153846,47.866754626942075,46.431322296134844,45.69125,46.50875,46.736875,47.0515625,47.354166666666664,200800,384880,58.49888284612294,NaN,1.5,2.75,NaN,NaN,0.255496549709378,0.5217210559135315,NaN,0.03395739542261453,0.20720048866117224,0.17324309323855772,8.70332537245457,1.2700534759358288,NaN,NaN,NaN,4941800
759076200,47.40625,47.5,47.375,47.46875,NaN,NaN,46.66382575757576,46.7375,45.706875,46.5190625,46.763125,47.0859375,46.83673300389607,47.13669004988244,47.22596153846154,47.84280925829865,46.60911381862443,45.706875,46.5190625,46.763125,47.0859375,47.447916666666664,281100,378420,61.018298524132895,NaN,1.5,2.75,NaN,NaN,0.24840751044442247,0.7428254320596163,NaN,0.029906410624172847,0.21062610651877378,0.18071969589460093,8.694972149002844,0.9302325581395349,NaN,NaN,NaN,5222900
759162600,47.53125,47.53125,47.34375,47.375,NaN,NaN,46.68560606060606,46.73125,45.72234375,46.5271875,46.780625,47.1171875,46.85784151354721,47.15938623560792,47.28125,47.805883571757704,46.756616428242296,45.72234375,46.5271875,46.780625,47.1171875,47.416666666666664,85600,356010,58.16624910979227,NaN,1.5,2.75,NaN,NaN,0.24405697398410658,0.2404426841942642,NaN,0.01816909541618192,0.20343106516482834,0.18526196974864642,8.393970241394825,-0.4596191726854892,NaN,NaN,NaN,5137300
759421800,47.34375,47.5625,47.1875,47.1875,NaN,NaN,46.70738636363637,46.725,45.73375,46.5340625,46.796875,47.1265625,46.87076929732967,47.162063736978595,47.31490384615385,47.74684764317802,46.88296004912967,45.73375,46.5340625,46.796875,47.1265625,47.3125,373800,352345,52.846091439558954,NaN,1.5,2.75,NaN,NaN,0.2534100472709561,1.0608920234429324,NaN,-0.0037948903519421373,0.18051835680871875,0.1843132471606609,4.88452863390263,-0.6578947368421053,NaN,NaN,NaN,4763500
759508200,47.21875,47.25,47.09375,47.1875,NaN,NaN,46.729166666666664,46.71875,45.7446875,46.5425,46.80875,47.13125,46.8831901091991,47.16448623821873,47.34855769230769,47.64663461538424,47.05048076923115,45.7446875,46.5425,46.80875,47.13125,47.177083333333336,310400,323835,52.846091439558954,NaN,1.5,2.75,NaN,NaN,0.24647004389445923,0.9585128228881993,NaN,-0.019042905387341325,0.16050961542648423,0.17955252081382556,4.850935458718116,-0.33003300330033003,NaN,NaN,NaN,4763500
759594600,47.1875,47.34375,47.125,47.3125,NaN,NaN,46.75094696969697,46.7125,45.7565625,46.551875,46.82375,47.1453125,46.90002579119129,47.1785827869598,47.37019230769231,47.607674789136176,47.13270982624844,45.7565625,46.551875,46.82375,47.1453125,47.260416666666664,145100,317755,55.960488931086616,NaN,1.5,2.75,NaN,NaN,0.2444900407591407,0.45664112287768877,NaN,-0.02126154332256966,0.15297559166061347,0.17423713498318313,4.868047897270698,0.1985440105890139,NaN,NaN,NaN,4908600
759681000,47.40625,47.8125,47.34375,47.75,NaN,NaN,46.77272727272727,46.70625,45.770625,46.56875,46.843125,47.190625,46.933358113105356,47.23300347391601,47.38221153846154,47.67346406213209,47.09095901479099,45.770625,46.56875,46.843125,47.190625,47.635416666666664,344500,323985,64.73872220756435,NaN,1.5,2.75,NaN,NaN,0.2627407521334878,1.0633208327546029,NaN,0.004794163855317224,0.18022983980232965,0.17543567594701243,6.893327618683154,0.7251153592617007,NaN,NaN,NaN,5253100
759767400,47.9375,48.03125,47.875,47.875,NaN,NaN,46.79450757575758,46.7,45.7853125,46.5884375,46.87,47.2546875,46.97028524592476,47.29414600020972,47.41105769230769,47.80086638078167,47.02124900383372,45.7853125,46.5884375,46.87,47.2546875,47.92708333333334,356500,326165,66.77636660169871,NaN,1.5,2.75,NaN,NaN,0.2640628412668101,1.0930050741189274,NaN,0.027251852747532668,0.20950049188142827,0.1822486391338956,6.73166427952011,0.988793671720501,NaN,NaN,NaN,5609600
760026600,48.0625,48.3125,48,48.21875,NaN,NaN,46.816287878787875,48.3125,45.80265625,46.610625,46.90625,47.3421875,47.01924464804535,47.38220352399927,47.47836538461539,48.0555688421251,46.901161927105676,45.80265625,46.610625,46.90625,47.3421875,48.177083333333336,313800,293810,71.63133706704664,NaN,1.5,2.75,NaN,NaN,0.2764512097477522,1.068037166876553,NaN,0.06017510579740129,0.2574675213806472,0.19729241558324592,7.549258716018809,1.5799868334430547,NaN,NaN,NaN,5923400
760113000,48.15625,48.15625,47.90625,47.96875,NaN,NaN,46.83806818181818,48.34775641025641,45.81984375,46.62625,46.939375,47.4078125,47.05648015204357,47.4380650931422,47.53605769230769,48.14688062881554,46.92523475579985,45.81984375,46.62625,46.939375,47.4078125,48.010416666666664,303600,300775,64.2749708717216,NaN,1.5,2.75,NaN,NaN,0.2790261233371985,1.0093924029590224,NaN,0.0599031912516261,0.27217140464777856,0.21226821339615246,8.529592753721587,1.3201320132013201,NaN,NaN,NaN,5619800
760199400,48.125,48.28125,48.09375,48.28125,NaN,NaN,46.859848484848484,48.38301282051282,45.83875,46.6446875,46.984375,47.484375,47.10451034215951,47.51836841760485,47.60336538461539,48.324935777135174,46.8817949920956,45.83875,46.6446875,46.984375,47.484375,48.21875,307600,280610,68.61398581076125,NaN,1.5,2.75,NaN,NaN,0.2814171145273986,1.096183314921065,NaN,0.074600347371374,0.30551864761036995,0.23091830023899595,8.693689656801244,1.7116524028966424,NaN,NaN,NaN,5927400
760285800,48.1875,48.1875,47.90625,48.0625,NaN,NaN,46.88162878787879,48.41826923076923,45.859375,46.6628125,47.02,47.55,47.14207856403561,47.57019047307105,47.65384615384615,48.40443147771207,46.90326082998023,45.859375,46.6628125,47.02,47.55,48.052083333333336,466100,293865,62.85870271465224,NaN,1.5,2.75,NaN,NaN,0.28810160634687015,1.5861024620148707,NaN,0.06383621459059538,0.3107135684772402,0.2468773538866448,9.432028124042155,1.4511873350923483,NaN,NaN,NaN,5461300
760372200,48.0625,48.125,46.96875,46.96875,NaN,NaN,46.90340909090909,48.45352564102564,45.87546875,46.66875,47.03,47.546875,47.13528136544598,47.51291042801667,47.61538461538461,48.446851336477486,46.78391789429174,45.87546875,46.66875,47.03,47.546875,47.354166666666664,1403200,325250,43.301346944059645,NaN,1.5,2.75,NaN,NaN,0.35011220589352227,4.314219830899308,NaN,-0.018308238664894033,0.22399205555552726,0.2423002942204213,16.848928096484865,-0.46357615894039733,NaN,NaN,NaN,4058100
760631400,46.84375,47.3125,46.84375,47.1875,NaN,NaN,46.92518939393939,48.48878205128205,45.894375,46.6778125,47.04375,47.5265625,47.13732915503633,47.481918958681746,47.60336538461539,48.454476301534186,46.75225446769659,45.894375,46.6778125,47.04375,47.5265625,47.114583333333336,516400,321385,46.862268536964194,NaN,1.5,2.75,NaN,NaN,0.35858633404398493,1.6067955878463525,NaN,-0.05708393401041059,0.17094537670740806,0.22802931071781865,16.992173215782095,0,NaN,NaN,NaN,4574500
760717800,47.28125,47.28125,47.03125,47.21875,NaN,NaN,46.946969696969695,48.52403846153846,45.91109375,46.691875,47.061875,47.5125,47.14052212934863,47.4568552483311,47.58413461538461,48.457548223797694,46.71072100697153,45.91109375,46.691875,47.061875,47.5125,47.177083333333336,188200,316035,47.37078289786298,NaN,1.5,2.75,NaN,NaN,0.3508301673265574,0.5955036625690192,NaN,-0.07847995219992454,0.12992937046791297,0.20840932266783752,16.996409263991197,-0.19815059445178335,NaN,NaN,NaN,4762700
760804200,47.25,47.4375,47.1875,47.40625,NaN,NaN,46.96875,48.55929487179487,45.92921875,46.7115625,47.083125,47.515625,47.15094283015849,47.452035700871,47.58653846153846,48.45780585946915,46.71527106360777,45.92921875,46.7115625,47.083125,47.515625,47.34375,144600,315345,50.43560955120991,NaN,1.5,2.75,NaN,NaN,0.34362801251751757,0.4585454026542358,NaN,-0.0777107291621836,0.11127091121510801,0.18898164037729162,17.085926454441104,-0.7198952879581152,NaN,NaN,NaN,4907300
760890600,47.375,47.40625,47,47,NaN,NaN,46.990530303030305,48.594551282051285,45.944375,46.72875,47.095,47.5046875,47.14502350348561,47.40898468174043,47.57211538461539,48.474963647176,46.66926712205478,45.944375,46.72875,47.095,47.5046875,47.135416666666664,883900,347325,44.40223089759722,NaN,1.5,2.75,NaN,NaN,0.3481010116234092,2.5448787159000936,NaN,-0.10080370569870561,0.06297700825390962,0.16378071395261523,16.70436225826291,-1.8276762402088773,NaN,NaN,NaN,4023400
760977000,47.03125,47.28125,46.8125,47.15625,NaN,NaN,47.01231060606061,48.62980769230769,45.96,46.74375,47.1075,47.4921875,47.145463758250884,47.384914712050865,47.56971153846154,48.47679962777634,46.66262344914674,45.96,46.74375,47.1075,47.4921875,47.083333333333336,519400,366435,47.02698910289691,NaN,1.5,2.75,NaN,NaN,0.35671879650745136,1.4174410195532632,NaN,-0.10151528671815693,0.03688660555491907,0.138401892273076,16.773721852017225,-2.20349967595593,NaN,NaN,NaN,4542800
761236200,47.0625,47.375,47,47.21875,NaN,NaN,47.03409090909091,48.6650641025641,45.97453125,46.756875,47.1175,47.4828125,47.14833772851556,47.36908950137936,47.5625,48.47909381994944,46.64590618005056,45.97453125,46.756875,47.1175,47.4828125,47.197916666666664,2742100,502655,48.082804129458694,NaN,1.5,2.75,NaN,NaN,0.35802459675691917,5.455232714287136,NaN,-0.09391287248436353,0.021010801667621593,0.11492367415198512,15.988633553999717,-1.5635179153094463,NaN,NaN,NaN,7284900
761322600,47.3125,47.5,47.25,47.46875,NaN,NaN,47.05587121212121,48.70032051282051,45.98953125,46.77375,47.129375,47.4828125,47.1609029156326,47.37858097743847,47.54086538461539,48.45199601392695,46.62973475530382,45.98953125,46.77375,47.129375,47.4828125,47.40625,374700,513070,52.18783358384314,NaN,1.5,2.75,NaN,NaN,0.35254069698856777,0.730309704328844,NaN,-0.06931807981239624,0.028276074386489825,0.09759415419888606,16.369924941525188,-1.6828478964401294,NaN,NaN,NaN,7659600
761409000,47.53125,47.53125,47.34375,47.4375,NaN,NaN,47.077651515151516,48.73557692307692,46.00375,46.7853125,47.14125,47.4875,47.17174986011759,47.38419231292052,47.50721153846154,48.39859451421789,46.61582856270519,46.00375,46.7853125,47.14125,47.4875,47.4375,287600,517410,51.638203029775916,NaN,1.5,2.75,NaN,NaN,0.34075207577509864,0.5558454610463656,NaN,-0.053152821228512795,0.031153127663245073,0.08430594889175787,15.665390507763236,-1.3003901170351104,NaN,NaN,NaN,7372000
761495400,47.65625,47.6875,47.03125,47.15625,NaN,NaN,47.09943181818182,48.770833333333336,46.01734375,46.795,47.1475,47.471875,47.17114202246592,47.362483521213804,47.42548076923077,48.231683608318534,46.619277930143,46.01734375,46.795,47.1475,47.471875,47.291666666666664,342400,520475,46.855340589736436,NaN,1.5,2.75,NaN,NaN,0.363287641791163,0.6578606080983717,NaN,-0.05895171079373909,0.010616310399583995,0.06956802119332309,15.776677613813522,0.3992015968063872,NaN,NaN,NaN,7029600
761581800,47.1875,47.21875,46.75,46.875,NaN,NaN,47.121212121212125,48.806089743589745,46.03,46.8034375,47.15125,47.446875,47.1595286098202,47.31605651919344,47.34134615384615,48.13133061178672,46.551361695905584,46.03,46.8034375,47.15125,47.446875,46.947916666666664,313300,531860,42.60554912406866,NaN,1.5,2.75,NaN,NaN,0.3708206673775085,0.5890647914864814,NaN,-0.07807895265574712,-0.028030669626360805,0.05004828302938631,9.034853148744133,-0.6622516556291391,NaN,NaN,NaN,6716300
761927400,47,47.34375,47,47.34375,NaN,NaN,47.14299242424242,48.84134615384615,46.04453125,46.8175,47.16625,47.4546875,47.16675297806255,47.31869399355597,47.26923076923077,47.844950668459916,46.69351087000162,46.04453125,46.8175,47.16625,47.4546875,47.229166666666664,154500,520895,50.64096906643146,NaN,1.5,2.75,NaN,NaN,0.37781561970768646,0.2966048819819733,NaN,-0.0565162603095042,-0.020597042357493933,0.035919217952010266,10.47058942809157,0.26472534745201853,NaN,NaN,NaN,6870800
762013800,47.40625,47.4375,47.0625,47.21875,NaN,NaN,47.16477272727273,48.87660256410256,46.0575,46.828125,47.173125,47.45625,47.168792076962056,47.309175517979206,47.20432692307692,47.55327398676149,46.85537985939235,46.0575,46.828125,47.173125,47.45625,47.239583333333336,391700,524960,48.68359110068827,NaN,1.5,2.75,NaN,NaN,0.3776145040142803,0.7461520877781165,NaN,-0.04834318336243389,-0.024509761251032103,0.02383342211140179,10.602985234558133,-0.39551746868820037,NaN,NaN,NaN,6479100
762100200,47.0625,47.0625,46.5625,46.59375,NaN,NaN,47.18655303030303,48.91185897435897,46.06765625,46.831875,47.174375,47.4203125,47.14624140727727,47.24103975436214,47.17548076923077,47.64031276789464,46.71064877056689,46.06765625,46.831875,47.174375,47.4203125,46.739583333333336,770800,556245,40.296766284436345,NaN,1.5,2.75,NaN,NaN,0.3975170394418317,1.3857203210815379,NaN,-0.08078955216166733,-0.07715351809068238,0.003636034070984954,12.67227876251172,-0.8643617021276596,NaN,NaN,NaN,5708300
762186600,46.65625,46.8125,46.5625,46.8125,NaN,NaN,47.208333333333336,48.94711538461539,46.0815625,46.8384375,47.18125,47.3734375,47.133153508952674,47.20022644442289,47.14663461538461,47.64986015800533,46.643409072763895,46.0815625,46.8384375,47.18125,47.3734375,46.729166666666664,531300,565585,43.937116169323446,NaN,1.5,2.75,NaN,NaN,0.38698010805312943,0.9393813485152541,NaN,-0.08296422078014314,-0.10006924190419397,-0.017105021124050834,12.324098562840925,-0.7289595758780649,NaN,NaN,NaN,6239600
762445800,46.9375,47.0625,46.8125,46.8125,NaN,NaN,47.23011363636363,48.982371794871796,46.095625,46.8453125,47.185,47.3203125,47.12057886154277,47.163300116382615,47.11538461538461,47.646498633834014,46.58427059693521,46.095625,46.8453125,47.185,47.3203125,46.895833333333336,333000,564410,43.93711616932345,NaN,1.5,2.75,NaN,NaN,0.37719581462076307,0.589996633652841,NaN,-0.07982219618217673,-0.11688276635177175,-0.03706057016959502,12.103396588564953,-0.8603573792190602,NaN,NaN,NaN,6239600
762532200,46.8125,46.90625,46.375,46.625,NaN,NaN,47.25189393939394,49.017628205128204,46.10796875,46.8515625,47.18625,47.240625,47.10114439638423,47.11203343863189,47.05528846153846,47.61706890202402,46.4935080210529,46.10796875,46.8515625,47.18625,47.240625,46.635416666666664,423600,569900,41.42614148762813,NaN,1.5,2.75,NaN,NaN,0.3881996850049943,0.7432882961923144,NaN,-0.0852963624333245,-0.14368102321125065,-0.058384660777926145,12.158952482878293,-1.7774851876234365,NaN,NaN,NaN,5816000
762618600,46.0625,46.6875,45.9375,46.6875,NaN,NaN,45.9375,49.05288461538461,46.12078125,46.8578125,47.1875,47.1765625,47.084923047506415,47.07160168257171,47.03125,47.62620070901232,46.43629929098768,46.12078125,46.8578125,47.1875,47.1765625,46.4375,581500,583795,42.60363521174698,NaN,1.5,2.75,NaN,NaN,0.4140425646474947,0.9960688255295095,NaN,-0.07973520172674195,-0.1580536629363536,-0.07831846120961164,11.580589377667925,-1.5810276679841897,NaN,NaN,NaN,6397500
762705000,46.625,46.625,46.4375,46.5625,NaN,NaN,45.942578125,49.08814102564103,46.1284375,46.861875,47.189375,47.090625,47.06443586917283,47.02311580804107,46.98557692307692,47.624656501141985,46.346497345011855,46.1284375,46.861875,47.189375,47.090625,46.541666666666664,223200,579575,40.835531800425784,NaN,1.5,2.75,NaN,NaN,0.40232523860124514,0.38510977871716345,NaN,-0.0793329164187871,-0.17748460673309552,-0.09815169031430841,11.57479500152099,-1.259111994698476,NaN,NaN,NaN,6174300
762791400,46.5625,46.8125,46.40625,46.6875,NaN,NaN,45.94765625,49.12339743589744,46.13609375,46.8665625,47.1875,47.021875,47.04965407038174,46.99115239775144,46.94471153846154,47.5868579945021,46.30256508242098,46.13609375,46.8665625,47.1875,47.021875,46.635416666666664,595800,586060,43.36668075822642,NaN,1.5,2.75,NaN,NaN,0.4026055787011562,1.016619458758489,NaN,-0.06604997100892694,-0.1807141540754671,-0.11466418306654015,11.519603169715023,-0.4,NaN,NaN,NaN,6770100
763050600,46.875,47,46.875,46.9375,NaN,NaN,45.952734375,49.15865384615385,46.14703125,46.87375,47.19125,47.0203125,47.04525587154324,46.98604264558464,46.90384615384615,47.47058315493476,46.33710915275755,46.14703125,46.87375,47.19125,47.0203125,46.9375,539800,542890,48.14486797665242,NaN,1.5,2.75,NaN,NaN,0.39616946593678787,0.9943082392381514,NaN,-0.037262242112783533,-0.16124198570751958,-0.12397974359473604,11.559742560839943,-0.858085808580858,NaN,NaN,NaN,7309900
763137000,46.96875,46.96875,46.6875,46.75,NaN,NaN,45.9578125,49.193910256410255,46.15609375,46.873125,47.18625,46.9984375,47.033677209914096,46.963562393624194,46.85096153846154,47.33018983824566,46.37173323867742,46.15609375,46.873125,47.18625,46.9984375,46.802083333333336,880300,561085,45.07332438292223,NaN,1.5,2.75,NaN,NaN,0.38796093265558873,1.56892449450618,NaN,-0.028100815356283892,-0.15910576279009092,-0.13100494743380703,9.878677996552986,-0.9927200529450695,NaN,NaN,NaN,6429600
763223400,46.8125,47,46.59375,46.96875,NaN,NaN,45.962890625,49.229166666666664,46.16578125,46.8721875,47.18375,46.9859375,47.031131044819425,46.96405645137427,46.83653846153846,47.288666074827816,46.384410848249104,46.16578125,46.8721875,47.18375,46.9859375,46.854166666666664,2500100,676680,49.14933053947944,NaN,1.5,2.75,NaN,NaN,0.3892672946087609,3.6946562629307795,NaN,-0.005731058317043264,-0.1381687703301111,-0.13243771201306784,10.3815419449179,0.8048289738430584,NaN,NaN,NaN,8929700
763309800,46.96875,46.96875,46.46875,46.59375,NaN,NaN,45.96796875,49.26442307692308,46.17078125,46.86875,47.175,46.9453125,47.01397884698337,46.928789170291004,46.81490384615385,47.28418978238242,46.345617909925274,46.17078125,46.86875,47.175,46.9453125,46.677083333333336,207400,679820,43.22721756487841,NaN,1.5,2.75,NaN,NaN,0.397176773565278,0.30508075667088347,NaN,-0.014133911023285373,-0.15010510079217454,-0.13597118976888917,8.21307587941083,-0.4672897196261682,NaN,NaN,NaN,8722300
763396200,46.6875,46.90625,46.4375,46.84375,NaN,NaN,45.973046875,49.29967948717949,46.1778125,46.87125,47.175,46.9375,47.0073032059252,46.92069020169186,46.77644230769231,47.13492984388845,46.41795477149616,46.1778125,46.87125,47.175,46.9375,46.729166666666664,576600,664455,47.747442603636095,NaN,1.5,2.75,NaN,NaN,0.40228914688204387,0.8677788563559609,NaN,-0.001465694001307527,-0.1378033072705236,-0.13633761326921606,8.359585098688598,0.06675567423230974,NaN,NaN,NaN,9298900
763655400,47.03125,47.03125,46.84375,46.90625,NaN,NaN,45.978125,49.3349358974359,46.18625,46.87375,47.18125,46.925,47.0033403351046,46.91931494438788,46.75240384615385,47.01921994087623,46.48558775143146,46.18625,46.87375,47.18125,46.925,46.927083333333336,345900,655780,48.844024173895804,NaN,1.5,2.75,NaN,NaN,0.38694706496189785,0.5274634786056299,NaN,0.011782901089637254,-0.12160898690716948,-0.13339188799680674,8.390572646755922,0.6032171581769437,NaN,NaN,NaN,9644800
763741800,47.03125,47.125,46.84375,46.875,NaN,NaN,45.983203125,49.37019230769231,46.19234375,46.8765625,47.189375,46.9078125,46.99830738078678,46.915094473493795,46.77403846153846,47.03132861846479,46.51674830461213,46.19234375,46.8765625,47.189375,46.9078125,46.947916666666664,748600,556105,48.29824193071531,NaN,1.5,2.75,NaN,NaN,0.3793972746074766,1.3461486589762726,NaN,0.018690991065556106,-0.11002814916486159,-0.1287191402304177,7.986675760198368,0.40160642570281124,NaN,NaN,NaN,8896200
763828200,46.96875,47.25,46.8125,47.25,NaN,NaN,45.98828125,49.405448717948715,46.200625,46.8853125,47.20125,46.896875,47.008177679579454,46.94699023792296,46.80769230769231,47.16951707157981,46.4458675438048,46.200625,46.8853125,47.20125,46.896875,47.104166666666664,455500,560145,54.82204000710801,NaN,1.5,2.75,NaN,NaN,0.3835474692783711,0.8131823010113453,NaN,0.04714616715625222,-0.06978643128510242,-0.11693259844135465,9.061738507548666,1.476510067114094,NaN,NaN,NaN,9351700
763914600,47.09375,47.3125,47.09375,47.25,NaN,NaN,45.993359375,47.3125,46.2096875,46.8928125,47.21125,46.8875,47.01766090783124,46.975848310501725,46.84134615384615,47.27328995087033,46.40940235682198,46.2096875,46.8928125,47.21125,46.8875,47.21875,133000,552415,54.82204000710801,NaN,1.5,2.75,NaN,NaN,0.3717762214727731,0.24076102205769212,NaN,0.06357589245337406,-0.037462732874637084,-0.10103862532801114,8.768433332146532,1.2048192771084338,NaN,NaN,NaN,9351700
764001000,46.75,47.03125,46.71875,46.96875,NaN,NaN,45.9984375,47.28125,46.218125,46.8978125,47.215625,46.878125,47.01574283301433,46.97517228093013,46.86778846153846,47.28536636058839,46.45021056248853,46.218125,46.8978125,47.215625,46.878125,46.90625,365500,553570,49.400111817119885,NaN,1.5,2.75,NaN,NaN,0.3831672056532893,0.6602597684123056,NaN,0.05351340454817158,-0.03414686964279667,-0.08766027419096825,9.684851564347573,0.06657789613848203,NaN,NaN,NaN,8986200
764260200,46.8125,46.9375,46.71875,46.84375,NaN,NaN,46.003515625,47.25,46.22671875,46.90125,47.211875,46.8765625,47.008998016033374,46.9626558732225,46.87980769230769,47.284739840176314,46.47487554443907,46.22671875,46.90125,47.211875,46.8765625,46.833333333333336,324800,554145,47.167350909295486,NaN,1.5,2.75,NaN,NaN,0.3736552623923401,0.5861281794476175,NaN,0.03722314498857175,-0.04113134295525356,-0.07835448794382531,9.335372253568373,0.20053475935828877,NaN,NaN,NaN,8661400
764346600,46.84375,47.0625,46.75,46.96875,NaN,NaN,46.00859375,47.21875,46.23796875,46.9025,47.199375,46.8578125,47.00741966246344,46.96323626624893,46.91105769230769,47.27371196472578,46.54840341988961,46.23796875,46.9025,47.199375,46.8578125,46.927083333333336,435700,568205,49.61957846386577,NaN,1.5,2.75,NaN,NaN,0.3692870293643158,0.7668007145308472,NaN,0.03375297800999308,-0.03616326543133397,-0.06991624344132705,9.12381209920337,0,NaN,NaN,NaN,9097100
764433000,46.9375,47.0625,46.90625,46.9375,NaN,NaN,46.013671875,47.1875,46.24828125,46.9034375,47.188125,46.84375,47.00467771491586,46.96078519327284,46.93028846153846,47.26922224484759,46.59135467822933,46.24828125,46.9034375,47.188125,46.84375,46.96875,698500,583545,49.00716789313592,NaN,1.5,2.75,NaN,NaN,0.35407009869543604,1.1969942335209796,NaN,0.028451668746010017,-0.034351657508814526,-0.06280332625482454,8.731017355350117,0.7377598926894702,NaN,NaN,NaN,8398600
764519400,46.75,46.84375,46.15625,46.375,NaN,NaN,46.01875,47.15625,46.255625,46.8975,47.16875,46.8328125,46.97998447119367,46.904996127246854,46.88701923076923,47.33673766668099,46.43730079485748,46.255625,46.8975,47.16875,46.8328125,46.458333333333336,1200500,605030,39.54591897472097,NaN,1.5,2.75,NaN,NaN,0.3845829487886192,1.984199130621622,NaN,-0.011687442647119989,-0.07741262956372452,-0.06572518691660453,10.248895224595435,-1.0006671114076051,NaN,NaN,NaN,7198100
764605800,46.40625,46.53125,45.9375,45.9375,NaN,NaN,46.023828125,47.125,46.25984375,46.8875,47.143125,46.7890625,46.93910272722529,46.81285363893763,46.82451923076923,47.501465526263694,46.14757293527477,46.25984375,46.8875,47.143125,46.7890625,46.13541666666666,100900,583510,34.041213247787184,NaN,1.5,2.75,NaN,NaN,0.399523452446575,0.17291905879933506,NaN,-0.06355420892532274,-0.14516794807325795,-0.08161373914793521,10.68925494540489,-2.0652898067954695,NaN,NaN,NaN,7097200
764865000,46,46.0625,45.59375,46,NaN,NaN,46.02890625,47.09375,46.2646875,46.8840625,47.115,46.7484375,46.90227516929489,46.735439006657856,46.75,47.54926348307974,45.95073651692026,46.2646875,46.8840625,47.115,46.7484375,45.885416666666664,1117200,622720,35.42410913376659,NaN,1.5,2.75,NaN,NaN,0.4044682058432482,1.794064748201439,NaN,-0.08799901568231513,-0.19161250875082914,-0.103613493068514,10.692215398417359,-1.8666666666666667,NaN,NaN,NaN,8214400
764951400,46,46.03125,45.09375,45.09375,NaN,NaN,46.033984375,47.0625,46.26546875,46.8765625,47.06875,46.671875,46.83135261363626,46.57908767269044,46.63461538461539,47.8271363022737,45.44209446695707,46.26546875,46.8765625,47.06875,46.671875,45.40625,338400,618460,26.686977162949887,NaN,1.5,2.75,NaN,NaN,0.44254190542587335,0.5471655402127866,NaN,-0.155597626565976,-0.298110526275984,-0.142512899710008,14.7574995171559,-4.563492063492063,NaN,NaN,NaN,7876000
765037800,45.125,45.25,44.46875,44.46875,NaN,NaN,46.0390625,47.03125,46.26265625,46.860625,47.00875,46.5609375,46.738701530748564,46.37810313243421,46.45192307692308,48.10071622979143,44.80312992405473,46.26265625,46.860625,47.00875,46.5609375,44.729166666666664,1123900,645580,22.555228696946713,NaN,1.5,2.75,NaN,NaN,0.4667353407525967,1.7409151460702004,NaN,-0.22839721855035988,-0.42800942289795785,-0.19961220434759797,13.64397775584338,-5.886243386243386,NaN,NaN,NaN,6752100
765124200,44.46875,44.6875,43.53125,44.59375,NaN,NaN,46.044140625,47,46.2596875,46.8453125,46.95375,46.4625,46.6545857844447,46.20816473886905,46.27403846153846,48.168989027629145,44.379087895447775,46.2596875,46.8453125,46.95375,46.4625,44.270833333333336,788800,673860,25.054396018274062,NaN,1.5,2.75,NaN,NaN,0.5159863878416969,1.1705695545068708,NaN,-0.25225659849715826,-0.5149329524690458,-0.26267635397188754,14.18371270726992,-5.056553559547572,NaN,NaN,NaN,7540900
765466200,43.34375,44.03125,43.34375,43.90625,NaN,NaN,43.34375,46.96875,46.25671875,46.8228125,46.8825,46.3234375,46.546807910544906,45.98893476373866,46.04567307692308,48.28088293098937,43.81046322285679,46.25671875,46.8228125,46.8825,46.3234375,43.760416666666664,2627300,775435,21.033971709682604,NaN,1.5,2.75,NaN,NaN,0.56841593156729,3.3881627731531334,NaN,-0.29546736158330567,-0.6320105559510196,-0.33654319436771396,15.248953733486122,-6.270847231487658,NaN,NaN,NaN,4913600
765552600,44.34375,44.8125,44.34375,44.8125,NaN,NaN,43.22585227272727,46.9375,46.2578125,46.8059375,46.83125,46.2171875,46.478795835621575,45.876893357668315,45.85817307692308,48.066605259966025,43.649740893880136,46.2578125,46.8059375,46.83125,46.2171875,44.65625,1179000,807395,35.68478348676638,NaN,1.5,2.75,NaN,NaN,0.5925469364553406,1.4602517974473461,NaN,-0.2461591855258744,-0.644242176275057,-0.3980829907491826,21.828852391057463,-4.590818363273453,NaN,NaN,NaN,6092600
765639000,44.875,44.90625,44.5,44.8125,NaN,NaN,43.10795454545455,46.90625,46.25875,46.7903125,46.78375,46.1203125,46.41345090089132,45.7755225616999,45.67067307692308,47.78654933098062,43.55479682286554,46.25875,46.7903125,46.78375,46.1203125,44.739583333333336,516500,789205,35.68478348676638,NaN,1.5,2.75,NaN,NaN,0.5792400124228162,0.6544560665479818,NaN,-0.19872045812784778,-0.6464835634089923,-0.4477631052811445,21.56440500528675,-4.527296937416778,NaN,NaN,NaN,6092600
765725400,44.78125,45.125,44.53125,45.03125,NaN,NaN,42.99005681818182,46.875,46.2628125,46.7746875,46.740625,46.0234375,46.35924694399362,45.704639460585625,45.52163461538461,47.52049014962062,43.522779081148606,46.2628125,46.7746875,46.740625,46.0234375,44.895833333333336,666100,697505,38.86029812718785,NaN,1.5,2.75,NaN,NaN,0.5802764401069008,0.9549752331524505,NaN,-0.1405272433300776,-0.6234221594437415,-0.48289491611366386,22.167271578589922,-2.8975741239892185,NaN,NaN,NaN,6758700
765811800,44.9375,44.9375,44.46875,44.6875,NaN,NaN,42.87215909090909,46.84375,46.2621875,46.7559375,46.688125,45.928125,46.293688240307596,45.607769035767944,45.35576923076923,47.2429951503658,43.46854331117267,46.2621875,46.7559375,46.688125,45.928125,44.697916666666664,242400,699255,35.863659875209066,NaN,1.5,2.75,NaN,NaN,0.5790066943849794,0.3466546538816312,NaN,-0.11422105454276532,-0.6256712342921205,-0.5114501797493551,21.733802880530742,-2.7210884353741496,NaN,NaN,NaN,6516300
766071000,44.8125,45.0625,44.70312,44.875,NaN,NaN,42.75426136363637,46.8125,46.26265625,46.736875,46.630625,45.8296875,46.23805340735436,45.53798150855195,45.19471153846154,46.84651595794883,43.54290711897425,46.26265625,46.736875,46.630625,45.8296875,44.88020666666667,203300,680590,38.64296240407349,NaN,1.5,2.75,NaN,NaN,0.5644347876431952,0.298711412157099,NaN,-0.0751165829986219,-0.6053459084976325,-0.5302293254990106,21.820274037570595,-2.4456521739130435,NaN,NaN,NaN,6719600
766157400,44.92187,45,44.71875,44.8125,NaN,NaN,42.63636363636363,46.78125,46.2603125,46.7196875,46.569375,45.725,46.18214935216399,45.468888031547,45.03125,46.3472937507339,43.7152062492661,46.2603125,46.7196875,46.569375,45.725,44.84375,1409200,733755,38.05104425355587,NaN,1.5,2.75,NaN,NaN,0.5442073028115384,1.9205320577031844,NaN,-0.04582352684909996,-0.5875087340603855,-0.5416852072112855,21.70664593812197,-0.6237006237006237,NaN,NaN,NaN,5310400
766243800,44.79687,44.90625,44.25,44.578,NaN,NaN,42.51846590909091,46.75,46.257889999999996,46.701405,46.49656,45.61015,46.11924153443207,45.38404155235205,44.89301923076923,45.971519194421866,43.81451926711659,46.257889999999996,46.701405,46.49656,45.61015,44.57808333333333,364100,714530,35.83323218885839,NaN,1.5,2.75,NaN,NaN,0.5522103526107143,0.5095657285208459,NaN,-0.0350878632878634,-0.5855450363211148,-0.5504571730332514,18.89055394219874,0.24567814476458852,NaN,NaN,NaN,4946300
766330200,44.5,44.82812,44.40625,44.59375,NaN,NaN,42.40056818181818,46.71875,46.255546249999995,46.6842175,46.42906,45.4773375,46.059418337003365,45.308775690223285,44.78965384615385,45.69093529580174,43.88837239650596,46.255546249999995,46.6842175,46.42906,45.4773375,44.609373333333345,419900,712750,36.102611146137995,NaN,1.5,2.75,NaN,NaN,0.5429003274242346,0.5891266222378113,NaN,-0.020496052399897824,-0.5760772385331236,-0.5555811861332258,17.039365291812423,0,NaN,NaN,NaN,5366200
766416600,44.57812,44.78125,44.51562,44.59375,NaN,NaN,42.28267045454545,46.6875,46.2538275,46.6698425,46.35531,45.344525,46.001941147316955,45.24067800544012,44.68148076923077,45.252936113120725,44.11002542534081,46.2538275,46.6698425,46.35531,45.344525,44.63020666666667,387300,725465,36.102611146138,NaN,1.5,2.75,NaN,NaN,0.5230953040367894,0.5338644869152888,NaN,-0.005210623467882036,-0.5620944654680784,-0.5568838420001964,16.96324262921868,1.5658362989323844,NaN,NaN,NaN,5366200
766675800,44.64062,44.76562,44.15625,44.29687,NaN,NaN,42.16477272727273,46.65625,46.25187435,46.649998700000005,46.2799974,45.210931,45.93507561212805,45.15079152873153,44.6201823076923,45.1722235379903,44.06814107739431,46.25187435,46.649998700000005,46.2799974,45.210931,44.40624666666667,369100,725645,33.06781993375566,NaN,1.5,2.75,NaN,NaN,0.5292577823198757,0.508650924350061,NaN,-0.009226047595365383,-0.5684164014944031,-0.5591903538990377,14.59667641856733,-1.1506387726638807,NaN,NaN,NaN,4997100
766762200,44.25,44.53125,43.98437,44.35937,NaN,NaN,42.046875,46.625,46.25257745,46.62890490000001,46.2278098,45.086712,45.87328323518185,45.07541804980472,44.61176846153846,45.175985263667926,44.047551659408995,46.25257745,46.62890490000001,46.2278098,45.086712,44.29166333333333,472200,733015,34.31954830061159,NaN,1.5,2.75,NaN,NaN,0.5305165121541704,0.6441887273793852,NaN,-0.0021725572814513816,-0.561906050500852,-0.5597334932194006,7.780099932724737,-1.0111687587168794,NaN,NaN,NaN,5469300
766848600,44.40625,44.51562,44.07812,44.3125,NaN,NaN,41.92897727272727,46.59375,46.2524212,46.60702990000001,46.170309800000005,44.9538995,45.81207604948845,45.00275918791856,44.59013384615385,45.176585801273134,44.00368189103456,46.2524212,46.60702990000001,46.170309800000005,44.9538995,44.30208,508000,736630,33.80891865654887,NaN,1.5,2.75,NaN,NaN,0.5238724755717297,0.6896270855110436,NaN,0.004474172352004535,-0.554140777779395,-0.5586149501313995,7.753242188089338,-1.5961138098542678,NaN,NaN,NaN,4961300
766935000,44.5,44.96875,44.34375,44.90625,NaN,NaN,41.81107954545455,46.5625,46.2527337,46.592967400000006,46.124059800000005,44.852337,45.77655345931243,44.993567836688214,44.66705692307692,45.12213709916537,44.21197674698847,46.2527337,46.592967400000006,46.124059800000005,44.852337,44.73958333333334,200300,711720,44.97750257464915,NaN,1.5,2.75,NaN,NaN,0.5333280130308918,0.28143089979205305,NaN,0.05139019397167299,-0.49437720766680826,-0.5457674016384813,10.974264397200487,0.48951048951048953,NaN,NaN,NaN,5161600
767021400,45.01562,45.04687,44.73437,44.85937,NaN,NaN,41.69318181818182,46.53125,46.2521868,46.578123600000005,46.07312220000001,44.7765555,45.74058548051587,44.98078709033695,44.67066230769231,45.131006673182846,44.210317942201776,46.2521868,46.578123600000005,46.07312220000001,44.7765555,44.88020333333333,301800,666785,44.3413284517633,NaN,1.5,2.75,NaN,NaN,0.5175545835286852,0.45261966001034815,NaN,0.08008617366538362,-0.44565968455675176,-0.5257458582221354,9.95711866038151,-0.034830083565463146,NaN,NaN,NaN,4859800
767280600,44.84375,45.35937,44.84375,45.32812,NaN,NaN,41.57528409090909,46.5,46.2541399,46.56734230000001,46.03968460000001,44.746086500000004,45.72441036363289,45.013866415066765,44.71032538461539,45.286896588763064,44.13375418046771,46.2541399,46.56734230000001,46.03968460000001,44.746086500000004,45.17708,394600,681470,51.698040730168934,NaN,1.5,2.75,NaN,NaN,0.5174163989909218,0.5790423643007029,NaN,0.1285816627921162,-0.36501877973199015,-0.49360044252410634,11.359586807107808,1.1506164574616422,NaN,NaN,NaN,5254400
767367000,45.26562,45.34375,45.1875,45.28125,NaN,NaN,41.45738636363637,46.46875,46.2560149,46.55484230000001,46.00218460000001,44.710149,45.70703152584337,45.03933151839374,44.729556153846154,45.361662830360515,44.09744947733179,46.2560149,46.55484230000001,46.00218460000001,44.710149,45.270833333333336,399000,645560,50.97256023864386,NaN,1.5,2.75,NaN,NaN,0.4916187990629988,0.6180680339550157,NaN,0.1537461597396439,-0.3014177428495515,-0.45516390258919537,11.333743048626191,1.5775718964511576,NaN,NaN,NaN,4855400
767539800,45.1875,45.25,44.8125,44.95312,NaN,NaN,41.33948863636363,46.4375,46.255468,46.53718600000001,45.95687200000001,44.703117500000005,45.677466367967156,45.031120897594334,44.749988461538464,45.392423997428985,44.107552925647944,46.255468,46.53718600000001,45.95687200000001,44.703117500000005,45.00520666666667,287000,642990,46.095624575109746,NaN,1.5,2.75,NaN,NaN,0.4899853134156418,0.44635219832345757,NaN,0.14466830355027882,-0.2743285231513468,-0.41899682670162564,11.794155690668461,0.8058752627890644,NaN,NaN,NaN,4568400
767626200,44.875,45.15625,44.8125,45.09375,NaN,NaN,41.22159090909091,46.40625,46.25656175,46.51937350000001,45.90937200000001,44.734367500000005,45.65457553000766,45.03708557401392,44.766815384615384,45.4325051550314,44.10112561419937,46.25656175,46.51937350000001,45.90937200000001,44.734367500000005,45.020833333333336,481900,610890,48.37535944001699,NaN,1.5,2.75,NaN,NaN,0.47953993388595306,0.788849056294914,NaN,0.14418931978520633,-0.23876017697011775,-0.3829494967553241,11.859293854491264,1.1212333566923616,NaN,NaN,NaN,5050300
767885400,45.09375,45.71875,44.9375,45.375,NaN,NaN,41.10369318181818,46.375,46.25968675,46.504686000000014,45.868122000000014,44.773430000000005,45.64361178373285,45.06926790029831,44.81008461538462,45.55091093758626,44.069258293182976,46.25968675,46.504686000000014,45.868122000000014,44.773430000000005,45.34375,275000,585200,52.685157845047186,NaN,1.5,2.75,NaN,NaN,0.5010906528940993,0.4699248120300752,NaN,0.1577704550480356,-0.18573642794527956,-0.34350688299331517,12.177089767385151,2.4338739960633826,NaN,NaN,NaN,5325300
767971800,45.39062,45.40625,45.0625,45.32812,NaN,NaN,40.98579545454545,46.34375,46.262733600000004,46.48952970000001,45.83155940000002,44.8445235,45.631239556919795,45.09392048122228,44.86778615384616,45.64335366653627,44.09221864115605,46.262733600000004,46.48952970000001,45.83155940000002,44.8445235,45.26562333333334,183400,463005,51.907286105723564,NaN,1.5,2.75,NaN,NaN,0.48985203483023504,0.39610803339056816,NaN,0.15815217416631933,-0.14581666528541604,-0.30396883945173536,11.138408729043206,2.1838678051559346,NaN,NaN,NaN,5141900
768058200,45.42187,45.42187,45.07812,45.25,NaN,NaN,40.86789772727273,46.3125,46.26476485,46.47515470000001,45.79905940000001,44.8663985,45.6162889860602,45.10878519729635,44.91826692307693,45.70130926355176,44.1352245826021,46.26476485,46.47515470000001,45.79905940000001,44.8663985,45.249996666666675,401900,424150,50.567454809451505,NaN,1.5,2.75,NaN,NaN,0.47941617519950397,0.9475421431097489,NaN,0.14788661999995822,-0.11911056445178758,-0.2669971844517458,11.372440151786664,2.1156558533145273,NaN,NaN,NaN,4740000
768144600,45.29687,45.375,45.1875,45.1875,NaN,NaN,40.75,46.28125,46.266639850000004,46.46109220000001,45.755934400000015,44.8851485,45.5994737317049,45.116281845172885,44.96394000000001,45.73511524190186,44.19276475809816,46.266639850000004,46.46109220000001,45.755934400000015,44.8851485,45.25,659800,431315,49.467328086443324,NaN,1.5,2.75,NaN,NaN,0.4585650198281108,1.529740444918447,NaN,0.1321454669106341,-0.10181535081345316,-0.23396081772408728,11.40568103619562,0.6263048016701461,NaN,NaN,NaN,4080200
768231000,44.96875,44.96875,44.59375,44.75,NaN,NaN,40.63210227272727,46.25,46.26788985,46.439842200000015,45.70655940000002,44.871086000000005,45.56616103634392,45.081397859918326,44.99879615384616,45.682182550754334,44.31540975693798,46.26788985,46.439842200000015,45.70655940000002,44.871086000000005,44.770833333333336,216300,408825,42.49755985185298,NaN,1.5,2.75,NaN,NaN,0.4682210898403886,0.5290772335351311,NaN,0.08956468157134481,-0.12200496575990627,-0.21156964733125108,10.653026354814264,-0.24380636642912823,NaN,NaN,NaN,3863900
768490200,44.625,44.75,44.28125,44.35937,NaN,NaN,40.51420454545455,46.21875,46.26609295,46.41812340000001,45.661871800000014,44.8546795,45.51883589766377,45.01263330183087,44.99879615384616,45.682182550754334,44.31540975693798,46.26609295,46.41812340000001,45.661871800000014,44.8546795,44.46354,499300,421670,37.42698758885888,NaN,1.5,2.75,NaN,NaN,0.46825886913750375,1.1841013114520833,NaN,0.03518048771352256,-0.16759403768934789,-0.20277452540287044,11.704861151855475,-2.137194306757042,NaN,NaN,NaN,3364600
768576600,44.57812,44.84375,44.54687,44.70312,NaN,NaN,40.39630681818182,46.1875,46.2647648,46.400467100000014,45.61968420000002,44.8460855,45.486847038931856,44.98315584451364,45.028843846153855,45.6165355214401,44.44115217086761,46.2647648,46.400467100000014,45.61968420000002,44.8460855,44.69791333333333,583400,440675,43.783495828334566,NaN,1.5,2.75,NaN,NaN,0.46941037848482503,1.3238781414874907,NaN,0.023035287880586786,-0.17398041555213695,-0.19701570343272373,10.810250074386037,-1.2767536231884093,NaN,NaN,NaN,3948000
768663000,44.65625,44.71875,44.17187,44.29687,NaN,NaN,44.17187,46.15625,46.261561650000004,46.377185800000014,45.569371600000025,44.82030400000001,45.440181272699235,44.91779528789329,44.98196846153847,45.686826642662545,44.2771102804144,46.261561650000004,46.377185800000014,45.569371600000025,44.82030400000001,44.39583,210600,380745,38.77079681711437,NaN,1.5,2.75,NaN,NaN,0.47494392287876624,0.5531261080250561,NaN,-0.009914407302501843,-0.20940871256085103,-0.19949430525834919,11.674554338821157,-1.4598541769737006,NaN,NaN,NaN,3737400
768749400,44.57812,44.625,44.40625,44.51562,NaN,NaN,44.20372076923077,46.125,46.259921000000006,46.35671700000002,45.52718400000003,44.81718500000001,45.4039239678875,44.8794928795225,44.95552615384616,45.70139526834955,44.209657039342765,46.259921000000006,46.35671700000002,45.52718400000003,44.81718500000001,44.51562333333334,305200,377800,42.58271209619743,NaN,1.5,2.75,NaN,NaN,0.46445721410171165,0.8078348332451032,NaN,-0.014268042826966115,-0.21732935879205684,-0.20306131596509072,11.831615817754088,-1.2820623700623737,NaN,NaN,NaN,4042600
768835800,44.64062,44.64062,44.29687,44.51562,NaN,NaN,44.235571538461535,46.09375,46.25703035000001,46.335623200000015,45.48374640000003,44.81327850000001,45.36908851816642,44.84483831956798,44.89302615384616,45.639701326123195,44.14635098156912,46.25703035000001,46.335623200000015,45.48374640000003,44.81327850000001,44.48436999999999,321300,372870,42.58271209619743,NaN,1.5,2.75,NaN,NaN,0.4558352702373037,0.8616944243301955,NaN,-0.01439759159128734,-0.2210583054541999,-0.20666071386291257,11.568925662057966,-1.893950413223144,NaN,NaN,NaN,4042600
769095000,44.60937,44.75,44.51562,44.53125,NaN,NaN,44.26742230769231,46.0625,46.25546785,46.31624820000002,45.443121400000024,44.810153500000006,45.336232105689305,44.81497276532341,44.83533384615385,45.56889153973886,44.101776152568846,46.25546785,46.31624820000002,45.443121400000024,44.810153500000006,44.59895666666667,450400,376025,42.877407136985234,NaN,1.5,2.75,NaN,NaN,0.44001703664892494,1.1977926999534605,NaN,-0.010842488339179501,-0.22021382428688696,-0.20937133594770746,10.629779000838624,-1.7580036410069477,NaN,NaN,NaN,4493000
769181400,44.5625,45.1875,44.5,45.1875,NaN,NaN,44.29927307692307,46.03125,46.256561600000005,46.30031070000002,45.41312140000003,44.854685,45.330399474093646,44.850451549578324,44.85336307692308,45.60880876761895,44.09791738622721,46.256561600000005,46.30031070000002,45.41312140000003,44.854685,44.958333333333336,470200,381080,53.637017418687485,NaN,1.5,2.75,NaN,NaN,0.45769439117400174,1.2338616563451243,NaN,0.03574330304525658,-0.16469220714113675,-0.20043551018639333,14.255717249882386,-0.13812154696132597,NaN,NaN,NaN,4963200
769267800,45.21875,45.6875,45.01562,45.51562,NaN,NaN,44.331123846153844,46,46.259139700000006,46.28796690000002,45.38468380000003,44.91249750000001,45.33766302412919,44.91380092580896,44.885814615384625,45.712648642357166,44.05898058841208,46.259139700000006,46.28796690000002,45.38468380000003,44.91249750000001,45.40624666666667,824800,398710,57.90629017176289,NaN,1.5,2.75,NaN,NaN,0.47299336323300173,2.0686714654761604,NaN,0.0858358356980759,-0.09314071556379844,-0.17897655126187434,14.844117687714498,0.7261300138312551,NaN,NaN,NaN,5788000
769354200,45.42187,45.85937,45.42187,45.73437,NaN,NaN,44.362974615384616,45.96875,46.26281155000001,46.27531060000002,45.36437120000003,44.983591000000004,45.35322016043785,44.9919503614462,44.91345846153847,45.82368864084106,44.003228282235874,46.26281155000001,46.27531060000002,45.36437120000003,44.983591000000004,45.67186999999999,531000,399860,60.516628538925694,NaN,1.5,2.75,NaN,NaN,0.47045812300207307,1.3279647876756866,NaN,0.12832501738130192,-0.018570279535246925,-0.14689529691654885,14.966942965955504,2.1997094972067,NaN,NaN,NaN,6319000
769440600,45.65625,45.6875,45.5,45.5625,NaN,NaN,44.39482538461538,45.9375,46.2660928,46.25999810000002,45.33624620000003,45.01640350000001,45.3614272129697,45.04628842226085,44.9314876923077,45.882239899583624,43.98073548503177,46.2660928,46.25999810000002,45.33624620000003,45.01640350000001,45.583333333333336,370400,408365,57.49958872841558,NaN,1.5,2.75,NaN,NaN,0.45359468564478206,0.9070316995824813,NaN,0.1386002783517554,0.026355051023145393,-0.11224522732861,13.71492190290614,2.7122341908823357,NaN,NaN,NaN,5948600
769699800,45.51562,45.53125,45.34375,45.48437,NaN,NaN,44.42667615384615,45.90625,46.268670900000004,46.244529300000025,45.31405860000004,45.04765350000001,45.366248498735594,45.088010477283625,44.94951615384616,45.93209911480723,43.966933192885094,46.268670900000004,46.244529300000025,45.31405860000004,45.04765350000001,45.45312333333334,262700,406410,56.129650192893244,NaN,1.5,2.75,NaN,NaN,0.43682006524158334,0.6463915750104574,NaN,0.13381220148359826,0.055020024525887834,-0.07879217695771043,12.249095183078232,1.7476408805470403,NaN,NaN,NaN,5685900
769786200,45.60937,45.84375,45.60937,45.67187,NaN,NaN,44.458526923076924,45.875,46.270936500000005,46.23281050000002,45.29062100000004,45.06484100000001,45.378233655647925,45.14361614611376,44.98677538461539,46.03703347139024,43.936517297840545,46.270936500000005,46.23281050000002,45.29062100000004,45.06484100000001,45.70833,549600,414160,58.67428162153575,NaN,1.5,2.75,NaN,NaN,0.4312886320100418,1.3270233726096194,NaN,0.1364806161501901,0.09180859323002721,-0.0446720229201629,11.85685891111085,3.1040567877594962,NaN,NaN,NaN,6235500
769872600,45.5,45.82812,45.34375,45.79687,NaN,NaN,44.49037769230769,45.84375,46.27398335000001,46.22484170000003,45.26843340000004,45.09062200000001,45.394650767191145,45.20583079886483,45.067303846153855,46.19059222358039,43.94401546872732,46.27398335000001,46.22484170000003,45.26843340000004,45.09062200000001,45.65624666666667,738200,431120,60.326427981405395,NaN,1.5,2.75,NaN,NaN,0.4350801582950387,1.712284282798293,NaN,0.1393830616283388,0.1295568041152606,-0.009826257513078203,9.44402208416995,2.878203201482985,NaN,NaN,NaN,6973700
769959000,45.78125,45.9375,45.73437,45.82812,NaN,NaN,44.52222846153846,45.8125,46.27718645000001,46.218435400000025,45.247495800000046,45.134372000000006,45.41164956063463,45.26509643706818,45.18028461538462,46.29141777446342,44.069151456305825,46.27718645000001,46.218435400000025,45.247495800000046,45.134372000000006,45.83333,369600,435250,60.7489064295034,NaN,1.5,2.75,NaN,NaN,0.4185122898453932,0.8491671453187823,NaN,0.13597945392256916,0.16014805989013325,0.024168605967564087,9.495361759070866,2.9484032795679362,NaN,NaN,NaN,7343300
770045400,45.75,45.875,45.67187,45.875,NaN,NaN,44.554079230769226,45.78125,46.281248950000005,46.210622900000025,45.21999580000004,45.173434500000006,45.42982016609994,45.323182490680736,45.27042923076924,46.40204613244188,44.138812329096595,46.281248950000005,46.210622900000025,45.21999580000004,45.173434500000006,45.80729,162000,419255,61.412755402657304,NaN,1.5,2.75,NaN,NaN,0.4031278405707224,0.3863996851558121,NaN,0.12948930239396328,0.18603023396001817,0.0565409315660549,9.398750088025702,3.017543859649123,NaN,NaN,NaN,7505300
770391000,45.73437,45.90625,45.65625,45.8125,NaN,NaN,44.58593,45.75,46.28468645000001,46.20124790000003,45.19124580000004,45.19530950000001,45.44482721840974,45.36978415823495,45.38701615384616,46.39942077716948,44.37461153052284,46.28468645000001,46.20124790000003,45.19124580000004,45.19530950000001,45.791666666666664,160000,413505,59.956849100910446,NaN,1.5,2.75,NaN,NaN,0.3921901376728136,0.386936070906035,NaN,0.11412928107956162,0.19920253291550694,0.08507325183594532,9.624301330007368,1.3831258644536653,NaN,NaN,NaN,7345300
770477400,45.70312,46.01562,45.5625,46.01562,NaN,NaN,44.61778076923077,45.71875,46.28788955000001,46.193904100000026,45.17218320000004,45.229684500000005,45.46721124906034,45.431292333641146,45.502400769230775,46.42957426717342,44.57522727128813,46.28788955000001,46.193904100000026,45.17218320000004,45.229684500000005,45.86458,200500,414360,63.024762972825094,NaN,1.5,2.75,NaN,NaN,0.3965422706961839,0.4838787527753644,NaN,0.11070611906558134,0.22345590066792198,0.11274978160234064,6.243827221421636,1.0985239792405332,NaN,NaN,NaN,7545800
770563800,46.04687,46.04687,45.89062,45.96875,NaN,NaN,44.649631538461534,45.6875,46.29007705000001,46.18327910000003,45.15468320000004,45.26562200000001,45.4868794353717,45.482478778056276,45.614180000000005,46.37377104879788,44.85458895120213,46.29007705000001,46.18327910000003,45.15468320000004,45.26562200000001,45.96874666666667,55100,397020,61.84725914820743,NaN,1.5,2.75,NaN,NaN,0.37937853707502794,0.1387839403556496,NaN,0.09873809759831606,0.23617240360023573,0.13743430600191966,5.358537488371881,0.5124810946340829,NaN,NaN,NaN,7490700
770650200,46,46.39062,45.85937,46.23437,NaN,NaN,44.681482307692306,45.65625,46.29234265000001,46.169685300000026,45.13999560000005,45.31796550000001,45.51619279084732,45.55408746586044,45.74518923076924,46.260778254548036,45.22960020699045,46.29234265000001,46.169685300000026,45.13999560000005,45.31796550000001,46.16145333333333,550400,391550,65.75236002417796,NaN,1.5,2.75,NaN,NaN,0.39022649871252596,1.4056953134976375,NaN,0.1017590448979902,0.26463311212440743,0.16287406722641723,5.63087029205375,1.474611796982164,NaN,NaN,NaN,8041100
770909400,46.32812,46.46875,46.1875,46.21875,NaN,NaN,44.71333307692307,45.625,46.29453015000001,46.15687280000003,45.12562060000005,45.39140300000001,45.54374405395135,45.617388659588016,45.82451615384616,46.287081166090644,45.36195114160168,46.29453015000001,46.15687280000003,45.12562060000005,45.39140300000001,46.291666666666664,99300,385700,65.32889575427632,NaN,1.5,2.75,NaN,NaN,0.3824424630902027,0.2574539797770288,NaN,0.09583641516773694,0.2826695861860884,0.18683317101835145,4.839951017532667,1.6145766117020015,NaN,NaN,NaN,7941800
770995800,46.14062,46.21875,46.03125,46.15625,NaN,NaN,44.74518384615384,45.59375,46.29624890000001,46.14499780000003,45.121245600000044,45.48124700000001,45.56776389497286,45.6687087872463,45.87379538461539,46.33069177971001,45.416898989520774,46.29624890000001,46.14499780000003,45.121245600000044,45.48124700000001,46.135416666666664,120600,366765,63.56486470497414,NaN,1.5,2.75,NaN,NaN,0.36851800144090247,0.32882090712036316,NaN,0.08140839600249455,0.28859366602146963,0.20718527001897508,4.75757367364137,1.060565288874753,NaN,NaN,NaN,7821200
771082200,46.26562,46.26562,45.78125,45.78125,NaN,NaN,44.777034615384615,45.5625,46.29656140000001,46.130622800000026,45.11812060000005,45.53515350000001,45.576135899091575,45.67942699798475,45.87740153846154,46.33056399204812,45.42423908487496,46.29656140000001,46.130622800000026,45.11812060000005,45.53515350000001,45.94270666666667,131900,344190,54.12187205558688,NaN,1.5,2.75,NaN,NaN,0.3767931441951236,0.3832185711380342,NaN,0.04227713797725419,0.2600316924905428,0.21775455451328862,6.9560968140476875,-0.03410713439586245,NaN,NaN,NaN,7689300
771168600,45.98437,46.03125,45.89062,46.03125,NaN,NaN,44.80888538461538,45.53125,46.29562390000001,46.11687280000003,45.11874560000005,45.62187250000001,45.5939835108919,45.71293395055763,45.913459230769234,46.33408587218856,45.49283258934991,46.29562390000001,46.11687280000003,45.11874560000005,45.62187250000001,45.98437333333334,80500,337685,58.54346675447386,NaN,1.5,2.75,NaN,NaN,0.36773649103832906,0.2383878466618298,NaN,0.029503375359652223,0.2546337737128539,0.22513039835320167,7.466152772617811,0.44324314416563804,NaN,NaN,NaN,7769800
771255000,46.07812,46.20312,46.07812,46.10937,NaN,NaN,44.84073615384615,45.5,46.29492075000001,46.10390400000003,45.13905800000005,45.70156000000001,45.61419474575889,45.75068976479023,45.96153615384616,46.31202038674024,45.611051920952086,46.29492075000001,46.10390400000003,45.13905800000005,45.70156000000001,46.13020333333333,83100,326580,59.84576805798985,NaN,1.5,2.75,NaN,NaN,0.35374602739273403,0.2544552636413742,NaN,0.022883377760740176,0.2537346205541269,0.2308512427933867,7.497192579928264,0.5108882833787431,NaN,NaN,NaN,7852900
771514200,46.04687,46.1875,46.03125,46.17187,NaN,NaN,44.87258692307692,45.46875,46.294373850000014,46.09093520000003,45.17312040000005,45.7843725,45.63606436357227,45.79080216814354,45.9999976923077,46.32359785814801,45.67639752646739,46.294373850000014,46.09093520000003,45.17312040000005,45.7843725,46.13020666666667,109700,316000,60.90393456781771,NaN,1.5,2.75,NaN,NaN,0.339639168293253,0.34715189873417723,NaN,0.019418484314876083,0.2551243481869818,0.23570586387210574,7.5062429229910395,0.7844365620736664,NaN,NaN,NaN,7962600
771600600,46.3125,46.54687,46.3125,46.53125,NaN,NaN,44.90443769230769,45.4375,46.29578010000001,46.08281020000003,45.21187040000005,45.884372500000005,45.671169682647864,45.86132100927273,46.056488461538464,46.464037583739014,45.648939339337915,46.29578010000001,46.08281020000003,45.21187040000005,45.884372500000005,46.46354,161000,301530,66.38879240656718,NaN,1.5,2.75,NaN,NaN,0.3421649419865921,0.5339435545385202,NaN,0.03701471384799784,0.28197425618210303,0.2449595423341052,8.383358617830611,1.1205542813505536,NaN,NaN,NaN,8123600
771687000,46.54687,46.5625,46.3125,46.34375,NaN,NaN,44.93628846153846,46.5625,46.29531135000001,46.07156020000003,45.26062040000005,45.94218500000001,45.697545381367554,45.90726662743723,46.096152307692314,46.507427286273135,45.684877329111494,46.29531135000001,46.07156020000003,45.26062040000005,45.94218500000001,46.40625,142800,285160,61.53805112135367,NaN,1.5,2.75,NaN,NaN,0.33558173184469264,0.500771496703605,NaN,0.03190425580530354,0.28483986209073464,0.2529356062854311,8.7229729732854,0.8157715839564922,NaN,NaN,NaN,7980800
771773400,46.34375,46.46875,46.29687,46.4375,NaN,NaN,44.968139230769225,46.55020491803279,46.29468635000001,46.06218520000003,45.29312040000005,45.988279000000006,45.72656320954922,45.95776504387178,46.13942153846154,46.56657636989907,45.712266707024014,46.29468635000001,46.06218520000003,45.29312040000005,45.988279000000006,46.40104,44000,246120,62.993980804926544,NaN,1.5,2.75,NaN,NaN,0.3238887509986433,0.17877458150495693,NaN,0.030705586243125915,0.29131758908933847,0.26061200284621255,8.676847583596718,0.4393484760363375,NaN,NaN,NaN,8024800
771859800,46.15625,46.20312,45.8125,45.875,NaN,NaN,44.99999,46.53790983606557,46.29156135000001,46.04906020000003,45.31437040000005,45.9953105,45.73238426015513,45.94988265874114,46.144229230769234,46.55774683879869,45.730711622739776,46.29156135000001,46.04906020000003,45.31437040000005,45.9953105,45.96354,403800,239760,50.614097628458,NaN,1.5,2.75,NaN,NaN,0.345396697355883,1.6841841841841843,NaN,-0.00992873996673066,0.24820107788779922,0.2581298178545299,10.904884763207427,-0.7437457741717377,NaN,NaN,NaN,7621000
772119000,45.54687,45.625,45.4375,45.48437,NaN,NaN,45.03184076923077,46.52561475409836,46.28726445000001,46.03202890000003,45.323432800000056,45.991404,45.72265821073728,45.90554811981341,46.10336384615385,46.64484437328395,45.56188331902374,46.28726445000001,46.03202890000003,45.323432800000056,45.991404,45.51562333333334,137400,228110,44.12831241738466,NaN,1.5,2.75,NaN,NaN,0.3519755046876057,0.602340975844987,NaN,-0.062159481755661744,0.1804304656599527,0.24258994741561443,11.765448333861155,-1.4556641841570785,NaN,NaN,NaN,7483600
772205400,45.45312,45.45312,44.90625,45.09375,NaN,NaN,45.06369153846153,46.513319672131146,46.28085820000001,46.009841400000035,45.331557800000056,45.971873,45.69799514364954,45.82823401316451,46.03605615384616,46.799692953158164,45.27241935453416,46.28085820000001,46.009841400000035,45.331557800000056,45.971873,45.15104,139200,221935,38.777232472376355,NaN,1.5,2.75,NaN,NaN,0.3681286829242052,0.6272106697907045,NaN,-0.11877829816873867,0.0941170747046911,0.21289537287342977,12.428915123029002,-1.5017064846416381,NaN,NaN,NaN,7344400
772291800,45.21875,45.42187,45.17187,45.26562,NaN,NaN,45.095542307692305,46.50102459016394,46.27687380000001,45.984997600000035,45.339370200000054,45.95156050000001,45.681039255663286,45.77465172619646,45.96153692307693,46.816794285129,45.106279561024856,46.27687380000001,45.984997600000035,45.339370200000054,45.95156050000001,45.28645333333333,279900,208450,42.1038588241145,NaN,1.5,2.75,NaN,NaN,0.3652709198581904,1.3427680498920604,NaN,-0.13901190534187172,0.039130491196090134,0.17814239653796185,12.271231154977249,-1.6632830957230178,NaN,NaN,NaN,7624300
772378200,45.34375,45.40625,44.9375,45,NaN,NaN,45.12739307692307,46.48872950819672,46.27234255000001,45.95624760000003,45.34312020000006,45.911717,45.65433183387257,45.700875371320606,45.86778692307693,46.847802406451315,44.88777143970254,46.27234255000001,45.95624760000003,45.34312020000006,45.911717,45.114583333333336,922500,217665,38.61198477210968,NaN,1.5,2.75,NaN,NaN,0.37266228272546253,4.238164151333471,NaN,-0.1629820426316691,-0.025585156751624538,0.13739688588004456,11.76200425039957,-2.405953497087465,NaN,NaN,NaN,6701800
772464600,44.78125,44.78125,44,44.0625,NaN,NaN,44,46.47643442622951,46.26265505000001,45.914685100000035,45.33281020000006,45.823436,45.591907056073644,45.544839621671024,45.706729230769234,47.06092885410464,44.35252960743383,46.26265505000001,45.914685100000035,45.33281020000006,45.823436,44.28125,353800,216875,29.357521357114308,NaN,1.5,2.75,NaN,NaN,0.4174721196736438,1.6313544668587896,NaN,-0.23054395332725391,-0.15078305577902285,0.07976089754823107,15.57442695610106,-4.568517584407992,NaN,NaN,NaN,6348000
772723800,44.23437,44.82812,44.01562,44.82812,NaN,NaN,43.99445580645161,46.46413934426229,46.25476440000001,45.883278800000035,45.33749760000006,45.771092,45.56195462250213,45.47658061008331,45.633411538461544,47.06455455209244,44.20226852483065,46.25476440000001,45.883278800000035,45.33749760000006,45.771092,44.55728666666666,371200,227335,41.656014096649194,NaN,1.5,2.75,NaN,NaN,0.4456883968398121,1.6328326038665406,NaN,-0.21267204017614563,-0.18607915267195096,0.02659288750419466,19.83996603343847,-3.660185359301548,NaN,NaN,NaN,6719200
772810200,44.84375,44.84375,44.25,44.60937,NaN,NaN,43.98891161290322,46.45184426229508,46.245623750000014,45.84656000000004,45.33781000000006,45.710935500000005,45.52459836279616,45.39398912340871,45.52403615384616,47.03210884306483,44.01596346462749,46.245623750000014,45.84656000000004,45.33781000000006,45.710935500000005,44.56770666666667,5382301,488450.05,39.53804033560262,NaN,1.5,2.75,NaN,NaN,0.45626422563696833,11.01914310378308,NaN,-0.20452420771895927,-0.22906237214450442,-0.024538164425545156,18.63642453578566,-3.7424248145650743,NaN,NaN,NaN,1336899
772896600,44.67187,45.01562,44.625,44.75,NaN,NaN,43.98336741935484,46.439549180327866,46.238123750000014,45.813435000000034,45.34687260000006,45.6476545,45.494221956412,45.332656825941214,45.41946923076924,46.93916470984875,43.89977375168973,46.238123750000014,45.813435000000034,45.34687260000006,45.6476545,44.79687333333334,311800,494015.05,41.594001538091575,NaN,1.5,2.75,NaN,NaN,0.45269178094861345,0.6311548605654828,NaN,-0.17949741943186107,-0.24890993871537148,-0.06941251928351042,19.110775190221762,-3.6339165545087484,NaN,NaN,NaN,1648699
772983000,44.82812,44.84375,44.3125,44.46875,NaN,NaN,43.97782322580645,46.427254098360656,46.22859250000001,45.788435000000035,45.34906020000006,45.572654500000006,45.454007369886035,45.25037998537538,45.28846,46.819716631437146,43.757203368562855,46.22859250000001,45.788435000000035,45.34906020000006,45.572654500000006,44.541666666666664,271900,504855.05,38.75564527735767,NaN,1.5,2.75,NaN,NaN,0.4583030823094268,0.5385704272939332,NaN,-0.17171745931101995,-0.28405934342228534,-0.1123418841112654,18.82659798868491,-3.0653950953678475,NaN,NaN,NaN,1376799
773069400,44.6875,44.6875,44.375,44.5625,NaN,NaN,43.972279032258065,46.41495901639344,46.219998750000016,45.76218500000004,45.354060200000056,45.48906100000001,45.41904629655717,45.184867605815825,45.137017692307694,46.529830698259296,43.74420468635609,46.219998750000016,45.76218500000004,45.354060200000056,45.48906100000001,44.54166666666666,406900,497680.05,40.22003044153721,NaN,1.5,2.75,NaN,NaN,0.44788857643018204,0.8175935523234255,NaN,-0.15083231256724716,-0.30088227482032437,-0.1500499622530772,18.428031828757558,-2.026784145850538,NaN,NaN,NaN,1783699
773415000,44.65625,44.85937,44.51562,44.79687,NaN,NaN,43.96673483870968,46.40266393442623,46.21492060000001,45.73796620000004,45.351872600000064,45.417967000000004,45.39464722610395,45.14791545288099,45.01802692307693,46.23080496416501,43.80524888198885,46.21492060000001,45.73796620000004,45.351872600000064,45.417967000000004,44.72395333333333,112000,498315.05,43.83551464078731,NaN,1.5,2.75,NaN,NaN,0.44045010668516904,0.22475740999594535,NaN,-0.1135101054046353,-0.2919375940088713,-0.17842748860423602,18.580412938540103,-0.6583617463617499,NaN,NaN,NaN,1895699
773501400,44.625,44.8125,44.46875,44.73437,NaN,NaN,43.96119064516129,46.39036885245902,46.211404950000016,45.71124740000004,45.34937260000006,45.346873,45.368754001550855,45.10853017165422,44.88701692307693,45.78532811597252,43.98870573018134,46.211404950000016,45.71124740000004,45.34937260000006,45.346873,44.67187333333334,174800,501025.05,43.08713650377565,NaN,1.5,2.75,NaN,NaN,0.433542956207657,0.3488847513712139,NaN,-0.08652879634835764,-0.28658848403968307,-0.20005968769132543,18.025536465435863,-1.1736280205595329,NaN,NaN,NaN,1720899
773587800,44.73437,44.92187,44.6875,44.92187,NaN,NaN,43.95564645161291,46.3780737704918,46.209608050000014,45.69046610000004,45.34124760000006,45.303904,45.35122913874494,45.090753012449056,44.81369923076924,45.510472592506034,44.11692586903244,46.209608050000014,45.69046610000004,45.34124760000006,45.303904,44.84374666666667,66700,497765.05,46.06218642742704,NaN,1.5,2.75,NaN,NaN,0.41931631647853856,0.1339989619600653,NaN,-0.05129173410960294,-0.2641743553283291,-0.21288262121872617,18.06209347196209,-0.17362222222222576,NaN,NaN,NaN,1787599
773674200,44.64062,44.98437,44.625,44.90625,NaN,NaN,43.95010225806452,46.36577868852459,46.20585805000002,45.66796610000004,45.33374760000006,45.247654000000004,45.33377897644122,45.073181296977715,44.76922846153847,45.35388077251129,44.18457615056565,46.20585805000002,45.66796610000004,45.33374760000006,45.247654000000004,44.83854,148400,501160.05,45.8471753450256,NaN,1.5,2.75,NaN,NaN,0.41503443673007145,0.2961129882559474,NaN,-0.02557305038298424,-0.24484893419745646,-0.21927588381447222,17.76522399910614,1.9148936170212767,NaN,NaN,NaN,1639199
773933400,44.9375,45.01562,44.53125,44.75,NaN,NaN,43.94455806451613,46.353483606557376,46.20007680000001,45.64327860000004,45.32968520000006,45.179685500000005,45.31088568324744,45.04240212583698,44.74278615384616,45.2966190964164,44.18895321127592,46.20007680000001,45.64327860000004,45.32968520000006,45.179685500000005,44.76562333333334,124000,503205.05,43.65212075914393,NaN,1.5,2.75,NaN,NaN,0.4199869769636377,0.24642042046279147,NaN,-0.016084909713160067,-0.23938202095592231,-0.22329711124276225,12.233655477174763,-0.17426561720633926,NaN,NaN,NaN,1515199
774019800,44.76562,44.82812,44.51562,44.8125,NaN,NaN,43.93901387096774,46.341188524590166,46.19523305000001,45.61671610000004,45.324060200000055,45.111717000000006,45.2913411466495,45.02050668528108,44.70793076923077,45.17618008963293,44.23968144882861,46.19523305000001,45.61671610000004,45.324060200000055,45.111717000000006,44.71874666666667,257300,510585.05,44.790767802655495,NaN,1.5,2.75,NaN,NaN,0.4123093357519493,0.5039317151961265,NaN,-0.0032703682827864566,-0.22738507159624533,-0.22411470331345887,7.1276195296659,0.4553527655736936,NaN,NaN,NaN,1772499
774106200,44.82812,45.03125,44.82812,44.89062,NaN,NaN,43.93346967741935,46.32889344262295,46.18827990000002,45.59124730000004,45.31437260000006,45.02968550000001,45.27562659187893,45.008136524778116,44.69951692307693,45.15006778169961,44.248966064454244,46.18827990000002,45.59124730000004,45.31437260000006,45.02968550000001,44.91666333333333,532700,529170.05,46.25272578948873,NaN,1.5,2.75,NaN,NaN,0.3984836689125243,1.006670729002898,NaN,0.011961623004075966,-0.2091626745583639,-0.22112429756243987,6.460569146721847,0.3142346368715048,NaN,NaN,NaN,2305199
774192600,45.10937,45.46875,45.07812,45.375,NaN,NaN,43.92792548387097,46.31659836065574,46.184217400000016,45.573434800000044,45.315310200000056,44.98124800000001,45.279523588275836,45.04307590337068,44.80047846153847,45.22209150153401,44.378865421542926,46.184217400000016,45.573434800000044,45.315310200000056,44.98124800000001,45.30729,494200,546740.05,54.328388505723765,NaN,1.5,2.75,NaN,NaN,0.41131554970448697,0.9039030522823414,NaN,0.05380964001841998,-0.1538622475394149,-0.2076718875578349,8.636297879287909,2.037947997189037,NaN,NaN,NaN,2799399
774279000,45.34375,45.48437,45.32812,45.39062,NaN,NaN,43.92238129032258,46.30430327868852,46.18101425000002,45.55859100000004,45.31812260000006,44.928904,45.283880310304234,45.076175341144896,44.8437476923077,45.370238569961685,44.31725681465372,46.18101425000002,45.55859100000004,45.31812260000006,44.928904,45.40103666666666,49100,546995.05,54.565464364252875,NaN,1.5,2.75,NaN,NaN,0.39309658186845214,0.08976315233565642,NaN,0.08010851297283791,-0.10753624634178749,-0.1876447593146254,7.195452647070135,1.8583338008415111,NaN,NaN,NaN,2848499
774538200,45.39062,45.57812,45.39062,45.46875,NaN,NaN,43.916837096774195,46.29200819672131,46.17867050000002,45.539841000000045,45.32374760000006,44.90859150000001,45.29113010205701,45.113563403893004,44.90985384615385,45.51235140932704,44.30735628298066,46.17867050000002,45.539841000000045,45.32374760000006,44.90859150000001,45.47916333333333,72300,530420.05,55.80133115972163,NaN,1.5,2.75,NaN,NaN,0.37841111173499126,0.13630706456137923,NaN,0.09908951195027055,-0.06378286937678723,-0.16287238132705778,7.197796601285935,1.4998369305712689,NaN,NaN,NaN,2920799
774624600,45.54687,45.5625,45.375,45.375,NaN,NaN,43.91129290322581,46.279713114754095,46.17476425000002,45.52140350000004,45.336247600000064,44.90312300000001,45.29441911766262,45.13846212733176,44.95793076923077,45.60016733831786,44.31569420014368,46.17476425000002,45.52140350000004,45.336247600000064,44.90312300000001,45.4375,609500,554025.05,53.906523927229216,NaN,1.5,2.75,NaN,NaN,0.36477460375392046,1.100130761235435,NaN,0.10129396886023492,-0.03625492025176413,-0.13754888911199906,7.21888845924661,1.4320756054013986,NaN,NaN,NaN,2311299
774711000,45.40625,45.40625,45.0625,45.17187,NaN,NaN,43.90574870967742,46.267418032786885,46.16952985000002,45.507184700000046,45.35249760000006,44.90702900000001,45.28961326991114,45.14164382949064,45.01201692307693,45.59615692148836,44.4278769246655,46.16952985000002,45.507184700000046,45.35249760000006,44.90702900000001,45.21354,185300,556330.05,49.94890544353337,NaN,1.5,2.75,NaN,NaN,0.36327284634292617,0.3330756625495962,NaN,0.08565640743095326,-0.030478379823307478,-0.11613478725426074,7.828986969496604,0.556521801073731,NaN,NaN,NaN,2125999
774797400,45.17187,45.29687,45.07812,45.26562,NaN,NaN,43.90020451612903,46.255122950819676,46.165076700000014,45.491715900000045,45.36374760000006,44.90702900000001,45.288672357365606,45.15345108382486,45.066103076923085,45.601951361325135,44.530254792521035,46.165076700000014,45.491715900000045,45.36374760000006,44.90702900000001,45.21353666666666,86300,546650.05,51.71097452153967,NaN,1.5,2.75,NaN,NaN,0.35294978588986003,0.1578706523487924,NaN,0.07840652112907956,-0.0181266358429113,-0.09653315697199086,7.603465443197527,0.8002672233820424,NaN,NaN,NaN,2212299
774883800,45.375,45.40625,45.25,45.34375,NaN,NaN,43.89466032258065,46.24282786885246,46.161170450000014,45.477028400000044,45.38468520000006,44.92421650000001,45.29083226491989,45.17157479012726,45.108170769230775,45.63870863339969,44.57763290506186,46.161170450000014,45.477028400000044,45.38468520000006,44.92421650000001,45.333333333333336,151600,508105.05,53.190011777391014,NaN,1.5,2.75,NaN,NaN,0.3388998011834415,0.29836349786328636,NaN,0.07561838189011276,-0.0020101796093499047,-0.07762856149946266,7.585783576377444,1.3268156424581006,NaN,NaN,NaN,2363899
775143000,45.35937,45.45312,45.3125,45.40625,NaN,NaN,43.88911612903226,46.23053278688525,46.15820170000002,45.46484090000004,45.402497800000056,44.991404,45.29535845060931,45.19392481011514,45.15985384615385,45.66495955307833,44.65474813922937,46.15820170000002,45.46484090000004,45.402497800000056,44.991404,45.39062333333334,120900,496460.05,54.39339862004106,NaN,1.5,2.75,NaN,NaN,0.32473695824176696,0.24352412646294502,NaN,0.07460311846403721,0.01562533658058385,-0.05897778188345336,7.035429158294649,1.3249651324965133,NaN,NaN,NaN,2484799
775229400,45.39062,45.42187,45.3125,45.35937,NaN,NaN,43.88357193548387,46.21823770491803,46.15468605000002,45.451559600000046,45.419372800000055,45.01796650000001,45.29786870744816,45.20968149486608,45.1935076923077,45.68890965690757,44.698105727707826,46.15468605000002,45.451559600000046,45.419372800000055,45.01796650000001,45.36458,489600,502380.05,53.28682867533332,NaN,1.5,2.75,NaN,NaN,0.3093536040816406,0.9745609922209292,NaN,0.06760186937159228,0.025524554831036994,-0.042077314540555286,7.179244127692231,1.0442047804196066,NaN,NaN,NaN,1995199
775315800,45.35937,45.35937,45.17187,45.35937,NaN,NaN,43.87802774193548,46.20594262295082,46.150701650000016,45.43952830000005,45.43593520000006,45.05546650000001,45.30028052284235,45.22393754297408,45.22836307692308,45.70126727852874,44.75545887531742,46.150701650000016,45.43952830000005,45.43593520000006,45.05546650000001,45.29686999999999,83200,237425,53.28682867533332,NaN,1.5,2.75,NaN,NaN,0.30064977521866626,0.3504264504580394,NaN,0.060053431222745944,0.032989474487877146,-0.027063956734868798,7.201789955643893,-0.034446280991739034,NaN,NaN,NaN,1995199
775402200,45.35937,45.57812,45.35937,45.45312,NaN,NaN,43.872483548387095,46.193647540983605,46.14687350000002,45.427184500000045,45.44124760000006,45.09062250000001,45.30627422782892,45.24576444364321,45.28244923076924,45.678770829892485,44.88612763164599,46.14687350000002,45.427184500000045,45.44124760000006,45.09062250000001,45.46353666666667,828200,263245,55.391588166726756,NaN,1.5,2.75,NaN,NaN,0.2947997912744758,3.146118634731904,NaN,0.05840375924071678,0.04594074231602718,-0.0124630169246896,3.8999858076542004,0.13769364683716592,NaN,NaN,NaN,2823399
775488600,45.76562,46.04687,45.75,45.90625,NaN,NaN,43.86693935483871,46.181352459016395,46.14531100000002,45.41687200000005,45.449060200000055,45.16249750000001,45.32980268948269,45.30866782996291,45.36658384615385,45.791475874753154,44.94169181755455,46.14531100000002,45.41687200000005,45.449060200000055,45.16249750000001,45.90104,459100,272605,63.866092023423704,NaN,1.5,2.75,NaN,NaN,0.31615337761201323,1.6841217145686982,NaN,0.0833394761868235,0.09171132830883977,0.008371852122016275,6.821611408168654,0.9621993127147767,NaN,NaN,NaN,3282499
775747800,45.9375,46.15625,45.89062,46.125,NaN,NaN,43.861395161290325,46.16905737704918,46.14187350000002,45.410622000000046,45.456872800000056,45.24062250000001,45.36098689773827,45.38641375091882,45.46153615384616,45.9632805775686,44.959791730123726,46.14187350000002,45.410622000000046,45.456872800000056,45.24062250000001,46.05729,486300,276575,67.11410063821853,NaN,1.5,2.75,NaN,NaN,0.31254456492544097,1.7582934104673236,NaN,0.10848369681222156,0.14397647313729323,0.03549277632507167,7.132010767955618,1.6528925619834711,NaN,NaN,NaN,3768799
775834200,46.28125,46.375,46.03125,46.1875,NaN,NaN,43.85585096774194,46.15676229508197,46.13749850000002,45.402809500000046,45.46937280000006,45.310154000000004,45.39339917625834,45.46270767940274,45.52403615384616,46.15330508666587,44.894767221026456,46.13749850000002,45.402809500000046,45.46937280000006,45.310154000000004,46.197916666666664,505500,296250,67.99917557814311,NaN,1.5,2.75,NaN,NaN,0.3147735245736238,1.7063291139240506,NaN,0.12222173564983316,0.18826994588736312,0.06604821023752996,6.78070099625699,2.2483682876090842,NaN,NaN,NaN,4274299
775920600,46.17187,46.23437,46.09375,46.20312,NaN,NaN,43.85030677419355,46.14446721311475,46.13382660000002,45.39890320000005,45.48374780000005,45.38359150000001,45.42515293405213,45.53322313850724,45.58653615384616,46.305404231375235,44.86766807631709,46.13382660000002,45.39890320000005,45.48374780000005,45.38359150000001,46.17708,144100,294715,68.22931056883283,NaN,1.5,2.75,NaN,NaN,0.30233398710407916,0.48894694874709466,NaN,0.12482008988219702,0.22207332259027623,0.09725323270807922,5.618814386860592,2.071108271575646,NaN,NaN,NaN,4418399
776007000,46.17187,46.21875,45.92187,45.9375,NaN,NaN,43.84476258064516,46.13217213114754,46.13054535000002,45.38984070000005,45.48906040000006,45.43437300000001,45.445244975854,45.57172569674464,45.622593846153855,46.360971853764504,44.884215838543206,46.13054535000002,45.38984070000005,45.48906040000006,45.43437300000001,46.02604,231700,302965,60.28921800056109,NaN,1.5,2.75,NaN,NaN,0.30194441659664506,0.7647748089713333,NaN,0.10206752558766935,0.2248376396926659,0.12277011410499655,7.267008766205092,1.3094417643004825,NaN,NaN,NaN,4186699
776093400,45.70312,45.84375,45.65625,45.78125,NaN,NaN,43.83921838709678,46.119877049180324,46.126170350000024,45.378590700000046,45.48874800000005,45.478123000000004,45.458421643467574,45.59168039229277,45.653843846153855,46.38197750186803,44.92571019043968,46.126170350000024,45.378590700000046,45.48874800000005,45.478123000000004,45.760416666666664,138400,302465,56.149733870691286,NaN,1.5,2.75,NaN,NaN,0.30046624398259897,0.45757360355743637,NaN,0.07136532906132378,0.21197677543165128,0.1406114463703275,7.779423113197144,0.8258774948382657,NaN,NaN,NaN,4048299
776352600,45.82812,45.9375,45.78125,45.89062,NaN,NaN,43.83367419354839,46.107581967213115,46.12265470000002,45.36874690000005,45.48999800000005,45.535154000000006,45.47537059862571,45.62015083112203,45.709132307692315,46.390105840174975,45.028158775209654,46.12265470000002,45.36874690000005,45.48999800000005,45.535154000000006,45.86979,328600,312695,58.30760868386337,NaN,1.5,2.75,NaN,NaN,0.2901650836981276,1.0508642607013223,NaN,0.05407850877953824,0.2082095823447503,0.15413107356521205,7.820541394458178,1.1712023337184798,NaN,NaN,NaN,4376899
776439000,45.71875,45.96875,45.71875,45.96875,NaN,NaN,43.82813,46.095286885245905,46.12062345000002,45.35593440000005,45.49187300000005,45.5929665,45.49471881044431,45.65335075196755,45.76321923076924,46.40527701266079,45.121161448877686,46.12062345000002,45.35593440000005,45.49187300000005,45.5929665,45.885416666666664,105900,305125,59.82842636377299,NaN,1.5,2.75,NaN,NaN,0.28729614914826135,0.3470708725931995,NaN,0.04398947043496132,0.2091179116089137,0.16512844117395237,7.709534393986605,1.3434489941108123,NaN,NaN,NaN,4482799
776525400,46,46.1875,45.9375,46.14062,NaN,NaN,43.82258580645161,46.08299180327869,46.11882655000002,45.344840600000055,45.498435400000055,45.6554665,45.52004826885826,45.69975734701826,45.82451692307693,46.446524775528225,45.20250907062563,46.11882655000002,45.344840600000055,45.498435400000055,45.6554665,46.08854,840300,320505,63.02371814267066,NaN,1.5,2.75,NaN,NaN,0.2846321384948141,2.621799971919315,NaN,0.04482275333078528,0.22115688283743395,0.17633412950664867,7.7702220437404845,1.5125474334875142,NaN,NaN,NaN,5323099
776611800,46.03125,46.23437,45.73437,45.96875,NaN,NaN,43.817041612903225,46.07069672131148,46.116326550000025,45.33484060000005,45.49749800000005,45.685154000000004,45.537644415177546,45.72537569492128,45.86778615384616,46.443959676560226,45.2916126311321,46.116326550000025,45.33484060000005,45.49749800000005,45.685154000000004,45.97916333333333,876200,339605,58.051082027583654,NaN,1.5,2.75,NaN,NaN,0.300015557173756,2.5800562418103383,NaN,0.030419409630992128,0.21435839154538883,0.1839389819143967,8.360822775039503,0.13614703880190607,NaN,NaN,NaN,4446899
776698200,46.04687,46.34375,46.04687,46.32812,NaN,NaN,43.81149741935484,46.05840163934426,46.11546715000002,45.329684300000054,45.50468540000006,45.732029000000004,45.5686434577196,45.78277991445259,45.94230538461539,46.485841251809575,45.3987695174212,46.11546715000002,45.329684300000054,45.50468540000006,45.732029000000004,46.23958,184100,346355,64.37967249644751,NaN,1.5,2.75,NaN,NaN,0.305371588804202,0.531535563222705,NaN,0.041054254379450345,0.23525679988870962,0.19420254550925928,7.596764267241302,0.44036856368563343,NaN,NaN,NaN,4630999
776957400,46.375,46.48437,46.3125,46.3125,NaN,NaN,43.805953225806455,46.04610655737705,46.11281090000002,45.32312180000005,45.50624800000005,45.77421650000001,45.59781430251491,45.83322944640948,46.015623076923085,46.475556391509265,45.555689762336904,46.11281090000002,45.32312180000005,45.50624800000005,45.77421650000001,46.36979,325900,359035,63.9282296240341,NaN,1.5,2.75,NaN,NaN,0.29583576103247317,0.9077109474006713,NaN,0.04280049773685485,0.24770316768032785,0.204902669943473,7.208152896919265,0.2706359945872801,NaN,NaN,NaN,4305099
777043800,46.34375,46.6875,46.15625,46.64062,NaN,NaN,43.80040903225807,46.033811475409834,46.11179525000002,45.320153000000055,45.514685400000054,45.837497500000005,45.63870864359276,45.910123784846675,46.10696923076924,46.555295523237724,45.65864293830075,46.11179525000002,45.320153000000055,45.514685400000054,45.837497500000005,46.49479,1089500,383035,68.86692669647276,NaN,1.5,2.75,NaN,NaN,0.31265106381586794,2.8443875886015637,NaN,0.06072312974953803,0.28080658213039555,0.22008345238085752,8.161047704927116,0.9469057500878729,NaN,NaN,NaN,5394599
777130200,46.70312,46.73437,46.57812,46.60937,NaN,NaN,43.79486483870968,46.021516393442624,46.109998350000026,45.32249670000006,45.52374780000005,45.9093725,45.67677379482441,45.97671866248032,46.16105538461539,46.665597149757424,45.65651361947335,46.109998350000026,45.32249670000006,45.52374780000005,45.9093725,46.64061999999999,133700,380455,67.91324940119671,NaN,1.5,2.75,NaN,NaN,0.3014795592575917,0.3514213244667569,NaN,0.06477272065489886,0.3010493531994811,0.23627663254458225,8.210143711668566,1.4625741496598605,NaN,NaN,NaN,5260899
777216600,46.45312,46.5625,46.40625,46.45312,NaN,NaN,43.78932064516129,46.00922131147541,46.107576450000025,45.32765290000006,45.53718520000006,45.968747500000006,45.70721874404698,46.02209021843458,46.18629538461539,46.71342046873885,45.65917030049193,46.107576450000025,45.32765290000006,45.53718520000006,45.968747500000006,46.47395666666667,620000,407140,63.20058486780342,NaN,1.5,2.75,NaN,NaN,0.2944538764534779,1.5228177039838877,NaN,0.051789833803006446,0.3010139247983403,0.24922409099533388,7.5920234194247715,1.4675658703071637,NaN,NaN,NaN,4640899
777303000,46.46875,46.51562,46.3125,46.42187,NaN,NaN,43.78377645161291,45.9969262295082,46.10796705000003,45.331871600000056,45.54499760000006,46.022653500000004,45.73524428349612,46.06016448334557,46.204323846153855,46.74620558014062,45.66244211216709,46.10796705000003,45.331871600000056,45.54499760000006,46.022653500000004,46.416663333333325,103200,404720,62.26989533316005,NaN,1.5,2.75,NaN,NaN,0.2879300281353722,0.25499110496145483,NaN,0.03667107271874098,0.2950629318937601,0.2583918591750191,7.146060424903504,1.1576439804038385,NaN,NaN,NaN,4537699
777562200,46.4375,46.4375,46.28125,46.375,NaN,NaN,43.77823225806452,45.98463114754098,46.11062330000002,45.34468410000006,45.550310200000055,46.07109100000001,45.76033274296686,46.090148818265035,46.21754538461539,46.76699903675318,45.668091732477606,46.11062330000002,45.34468410000006,45.550310200000055,46.07109100000001,46.364583333333336,79700,402660,60.82318199657295,NaN,1.5,2.75,NaN,NaN,0.2785243118399885,0.19793374062484478,NaN,0.019925724781638787,0.28329901515206757,0.2633732903704288,7.237727488889499,0.8837525492861998,NaN,NaN,NaN,4457999
777648600,46.57812,46.85937,46.51562,46.64062,NaN,NaN,43.77268806451613,45.97233606557377,46.11351390000002,45.36640280000006,45.55968520000006,46.13515350000001,45.79485381187012,46.142574645096936,46.27163153846155,46.838325169637066,45.70493790728603,46.11351390000002,45.36640280000006,45.55968520000006,46.13515350000001,46.67186999999999,268600,391610,65.68833639012387,NaN,1.5,2.75,NaN,NaN,0.2932275752799892,0.685886468680575,NaN,0.022935649535687386,0.292042852290038,0.2691072027543506,7.718400826165668,1.0836438695448827,NaN,NaN,NaN,4726599
777735000,46.6875,47.14062,46.67187,47.14062,NaN,NaN,43.76714387096774,45.96004098360656,46.11859200000003,45.391871500000065,45.57187260000006,46.224216000000006,45.84762895650266,46.23762658365913,46.37619846153847,47.03632250292335,45.716074420153596,46.11859200000003,45.391871500000065,45.57187260000006,46.224216000000006,46.98436999999999,254700,400185,72.58894168153105,NaN,1.5,2.75,NaN,NaN,0.30799703418856145,0.6364556392668391,NaN,0.05307532032092971,0.3354513531555128,0.28237603283458307,9.321852464223392,2.549275322909582,NaN,NaN,NaN,4981299
777821400,47.09375,47.20312,46.89062,47.01562,NaN,NaN,43.761599677419355,45.947745901639344,46.122888850000024,45.422965200000064,45.585310000000064,46.302341000000006,45.89343252683589,46.311721194739214,46.46273692307693,47.14027769786096,45.785196148292904,46.122888850000024,45.422965200000064,45.585310000000064,46.302341000000006,47.03645333333333,147400,366145,68.86039477032618,NaN,1.5,2.75,NaN,NaN,0.30831867460366424,0.40257275123243524,NaN,0.05863240970490524,0.3556665449657146,0.29703413526080935,9.091712409878872,1.4839799240720324,NaN,NaN,NaN,4833899
777907800,47.125,47.78125,47.125,47.6875,NaN,NaN,43.75605548387097,45.935450819672134,46.128826350000026,45.45171520000006,45.61031000000006,46.39140350000001,45.9637881140188,46.44274774762119,46.59494846153847,47.47563574779311,45.71426117528383,46.128826350000026,45.45171520000006,45.61031000000006,46.39140350000001,47.53125,339500,360165,75.9971188405671,NaN,1.5,2.75,NaN,NaN,0.34098376927483115,0.9426235197756584,NaN,0.09921168632334298,0.4210487431649881,0.3218370568416451,11.04508532122838,2.968960863697706,NaN,NaN,NaN,5173399
778167000,47.8125,47.98437,47.64062,47.65625,NaN,NaN,43.750511290322585,47.98437,46.13523260000002,45.48015270000006,45.645935000000065,46.467966000000004,46.030159168371,46.55831939070489,46.711535384615395,47.71368335141193,45.70938741781886,46.13523260000002,45.48015270000006,45.645935000000065,46.467966000000004,47.76041333333333,350300,353365,75.13459964065856,NaN,1.5,2.75,NaN,NaN,0.34118135718377174,0.991326249062584,NaN,0.11451672121169698,0.46498295835626635,0.35046623714456937,11.080503075197752,2.1775653925698277,NaN,NaN,NaN,4823099
778253400,47.64062,47.85937,47.57812,47.78125,NaN,NaN,43.7449670967742,48.01171365384615,46.141170100000025,45.507652700000065,45.69187260000006,46.54765350000001,46.09882939706233,46.674788972542515,46.85095846153847,47.903988037096774,45.79792888598016,46.141170100000025,45.507652700000065,45.69187260000006,46.54765350000001,47.73958,36000,329890,76.29359581613522,NaN,1.5,2.75,NaN,NaN,0.3369005459563595,0.1091272848525266,NaN,0.12288853900736596,0.5040769109037768,0.38118837189641086,10.753659581260369,2.5142583991158896,NaN,NaN,NaN,4859099
778339800,47.70312,47.89062,47.59375,47.65625,NaN,NaN,43.73942290322581,48.0390573076923,46.14663885000002,45.53734020000006,45.74312260000006,46.62031,46.15990471482459,46.76826145134799,46.95312230769231,48.04057228444572,45.8656723309389,46.14663885000002,45.53734020000006,45.74312260000006,46.62031,47.713539999999995,356200,340495,72.64698972440863,NaN,1.5,2.75,NaN,NaN,0.3340412212451908,1.046124025316084,NaN,0.11024138233284725,0.5189900998124699,0.40874871747962266,11.012775710423377,2.589987497072321,NaN,NaN,NaN,4502899
778426200,47.5,47.53125,47.32812,47.5,NaN,NaN,43.73387870967742,48.06640096153846,46.150232600000024,45.563590200000064,45.78781020000006,46.698435,46.21245747110598,46.83795083693389,47.04446846153847,48.100365299500446,45.9885716235765,46.150232600000024,45.563590200000064,45.78781020000006,46.698435,47.45312333333334,294600,343640,68.25529814013831,NaN,1.5,2.75,NaN,NaN,0.3336189911562487,0.8572925154231172,NaN,0.08283736011274728,0.5122954176205567,0.42945805750780947,10.999186169441648,2.322461374347913,NaN,NaN,NaN,4208299
778512600,47.71875,47.71875,47.21875,47.29687,NaN,NaN,43.72833451612903,48.093744615384615,46.15406070000003,45.58843390000006,45.83374760000006,46.77421600000001,46.25498345263124,46.88165742389257,47.09494923076924,48.13135854733764,46.058539914200836,46.15406070000003,45.58843390000006,45.83374760000006,46.77421600000001,47.41145666666667,99600,341700,62.929245429111056,NaN,1.5,2.75,NaN,NaN,0.34550334893080237,0.2914837576821773,NaN,0.04444000940471188,0.4850080692636993,0.44056805985898745,11.52915789540811,1.9878598382749293,NaN,NaN,NaN,4108699
778858200,47.26562,47.35937,47.125,47.3125,NaN,NaN,43.72279032258065,48.12108826923077,46.15859195000003,45.61577890000006,45.898747600000064,46.845310000000005,46.296454689782955,46.922690050188514,47.14903615384616,48.15126135376421,46.14681095392811,46.15859195000003,45.61577890000006,45.898747600000064,46.845310000000005,47.26562333333334,229800,336760,63.16740661478983,NaN,1.5,2.75,NaN,NaN,0.3375652525786021,0.6823850813635823,NaN,0.01502457031536042,0.459348772753188,0.44432420243782755,11.432228909744241,1.4405468880988324,NaN,NaN,NaN,4338499
778944600,47.42187,47.42187,47.21875,47.26562,NaN,NaN,43.71724612903226,48.14843192307692,46.16335755000003,45.64249760000006,45.94749760000006,46.91015350000001,46.334461172536564,46.95535004540866,47.21153615384616,48.13022939667928,46.29284291101304,46.16335755000003,45.64249760000006,45.94749760000006,46.91015350000001,47.30208,27900,332860,61.883226863852144,NaN,1.5,2.75,NaN,NaN,0.32796202025155896,0.083819023012678,NaN,-0.011242660856323472,0.4302708763674232,0.4415135372237467,11.282798919614738,0.26516409839327526,NaN,NaN,NaN,4310599
779031000,47.35937,47.5625,47.34375,47.5,NaN,NaN,43.71170193548387,48.17577557692307,46.170701300000026,45.67156010000006,46.00531020000006,46.978122500000005,46.38016857753513,47.007221469655455,47.29446923076924,48.10083186338958,46.488106598148896,46.170701300000026,45.67156010000006,46.00531020000006,46.978122500000005,47.46875,284800,305085,65.64381158144826,NaN,1.5,2.75,NaN,NaN,0.3257418759478763,0.9335103331858334,NaN,-0.016184704209966427,0.42128265696128864,0.43746736117125506,9.95452875943427,1.0302533498441615,NaN,NaN,NaN,4595399
779117400,47.03125,47.125,46.8125,47,NaN,NaN,43.706157741935485,48.20311923076923,46.174295050000026,45.69859140000006,46.050310200000055,47.02968500000001,46.404475692141595,47.00653371064065,47.34254615384616,47.98092333781565,46.70416896987666,46.174295050000026,45.69859140000006,46.050310200000055,47.02968500000001,46.979166666666664,488400,285695,53.514301759067386,NaN,1.5,2.75,NaN,NaN,0.35158174195159947,1.7095153922889794,NaN,-0.05433099063757013,0.3695536228742924,0.4238846135118625,11.81074769034469,-1.4416775884665793,NaN,NaN,NaN,4106999
779376600,47,47.0625,46.78125,46.85937,NaN,NaN,43.700613548387096,48.230462884615385,46.17624815000003,45.72359140000006,46.09812260000006,47.056247500000005,46.42231468460663,46.992518119151065,47.359373076923085,47.93088540939886,46.78786074444731,46.17624815000003,45.72359140000006,46.09812260000006,47.056247500000005,46.90104,129400,282960,50.67794341616572,NaN,1.5,2.75,NaN,NaN,0.3465580460979138,0.4573084534916596,NaN,-0.08823137681870585,0.31359539248848023,0.4018267693071861,7.621341465906366,-1.6721416393442656,NaN,NaN,NaN,3977599
779463000,46.95312,47.125,46.85937,47,NaN,NaN,43.695069354838715,48.25780653846154,46.178748150000025,45.75046640000006,46.14687260000006,47.09062250000001,46.44496901070049,46.993230679231914,47.34855615384616,47.94115425324824,46.75595805444408,46.178748150000025,45.75046640000006,46.14687260000006,47.09062250000001,46.994789999999995,389200,286125,53.3411795466885,NaN,1.5,2.75,NaN,NaN,0.34077747137663433,1.3602446483180428,NaN,-0.09954294744026793,0.27739808500685115,0.3769410324471191,8.08636108335058,-1.6350555918901242,NaN,NaN,NaN,4366799
779549400,46.84375,47.10937,46.84375,47.04687,NaN,NaN,43.68952516129033,48.28515019230769,46.18242000000003,45.77187260000006,46.19187260000006,47.110935000000005,46.46857297106518,46.99833918597173,47.35096,47.93836723177039,46.76355276822961,46.18242000000003,45.77187260000006,46.19187260000006,47.110935000000005,46.99999666666667,423500,252825,54.22826915640423,NaN,1.5,2.75,NaN,NaN,0.33540908056401747,1.6750716899040838,NaN,-0.1018599805105665,0.24961605680891097,0.35147603731947746,7.842737221733889,-1.278699016393446,NaN,NaN,NaN,4790299
779635800,47.17187,47.64062,47.17187,47.64062,NaN,NaN,43.68398096774194,48.31249384615384,46.18890435000003,45.79968510000006,46.24999760000006,47.16249750000001,46.514535599650856,47.059508787307756,47.34735384615385,47.926976606574165,46.76773108573354,46.18890435000003,45.79968510000006,46.24999760000006,47.16249750000001,47.48437,779800,285130,63.65518365523605,NaN,1.5,2.75,NaN,NaN,0.35386200338087337,2.734892855890296,NaN,-0.0632851855062756,0.272369555436633,0.3356547409429086,11.187783169823263,0.29604210526315455,NaN,NaN,NaN,5570099
779722200,47,47.14062,46.84375,47.01562,NaN,NaN,43.67843677419355,48.3398375,46.191951200000034,45.81656010000006,46.29187260000006,47.1906225,46.534185968292,47.05532890280225,47.29807461538462,47.87318370911813,46.72296552165111,46.191951200000034,45.81656010000006,46.29187260000006,47.1906225,46.99999666666667,571300,282695,51.60654240486843,NaN,1.5,2.75,NaN,NaN,0.38550543171081086,2.0209059233449476,NaN,-0.0787358774058659,0.2372348941855762,0.3159707715914421,13.455607870337845,-0.5946482293648607,NaN,NaN,NaN,4998799
779981400,47.125,47.32812,47.01562,47.0625,NaN,NaN,43.67289258064516,48.367181153846154,46.19460745000003,45.83437260000006,46.33499760000006,47.222654000000006,46.554904165613884,47.05601186444013,47.24278615384616,47.75636706407378,46.729205243618544,46.19460745000003,45.83437260000006,46.33499760000006,47.222654000000006,47.13541333333333,167300,285900,52.33531708452843,NaN,1.5,2.75,NaN,NaN,0.38029075801718154,0.5851696397341728,NaN,-0.08418148009172105,0.21074392147679077,0.2949254015685118,13.328396558827054,-0.5284015852047557,NaN,NaN,NaN,5166099
780067800,46.8125,46.85937,46.17187,46.17187,NaN,NaN,43.66734838709678,48.39452480769231,46.191873050000034,45.84656010000006,46.36343500000007,47.212497500000005,46.53988321794275,46.97180787735059,47.128603076923085,47.84407072875655,46.41313542508962,46.191873050000034,45.84656010000006,46.36343500000007,47.212497500000005,46.40103666666666,355600,299695,40.00844921746551,NaN,1.5,2.75,NaN,NaN,0.4167435610159544,1.1865396486427868,NaN,-0.1427084505823749,0.11653983834054316,0.25924828892291807,17.02955386053335,-2.3140498315689078,NaN,NaN,NaN,4810499
780154200,46.3125,46.3125,45.73437,46.17187,NaN,NaN,43.66180419354839,48.42186846153846,46.18835740000003,45.85734130000006,46.39062240000007,47.189060000000005,46.52545132704304,46.89562331760292,47.02643923076924,47.868665403512495,46.18421305802599,46.18835740000003,45.85734130000006,46.39062240000007,47.189060000000005,46.07291333333333,397500,306140,40.00844921746551,NaN,1.5,2.75,NaN,NaN,0.4282711638005292,1.2984255569347358,NaN,-0.17427452619999081,0.041405131172929543,0.21567965737292036,17.06977409315622,-2.79606315789474,NaN,NaN,NaN,4810499
780240600,46.28125,46.28125,46.01562,46.0625,NaN,NaN,43.65626,48.44921211538461,46.18445115000003,45.86421630000006,46.41406000000006,47.13515400000001,46.50729637304135,46.81627823973597,46.9314876923077,47.89931026327121,45.963665121344185,46.18445115000003,45.86421630000006,46.41406000000006,47.13515400000001,46.11979,266400,306725,38.70992379577693,NaN,1.5,2.75,NaN,NaN,0.4166539378147772,0.8685304425788573,NaN,-0.1938698203805786,-0.02665761810280287,0.16721220227777572,16.432803457803242,-1.9946808510638299,NaN,NaN,NaN,4544099
780327000,46.07812,46.17187,45.82812,45.90625,NaN,NaN,43.650715806451615,48.476555769230764,46.179763650000034,45.86999760000006,46.42468500000006,47.079685500000004,46.48372592703973,46.72960888357064,46.823314615384625,47.90434479022852,45.74228444054073,46.179763650000034,45.86999760000006,46.42468500000006,47.079685500000004,45.96874666666667,176600,308185,36.86887571704994,NaN,1.5,2.75,NaN,NaN,0.4114465136851503,0.5730324318185506,NaN,-0.2074847465116773,-0.09214373086182093,0.11534101564985638,15.735654312880133,-2.034000883921398,NaN,NaN,NaN,4367499
780586200,46.07812,46.17187,45.98437,46.14062,NaN,NaN,43.645171612903226,48.50389942307692,46.17702925000003,45.87890380000006,46.43968500000006,47.00234150000001,46.47027079264601,46.67351470418296,46.73677615384616,47.842163992763844,45.63138831492847,46.17702925000003,45.87890380000006,46.43968500000006,47.00234150000001,46.09895333333333,223000,302360,41.37296915266116,NaN,1.5,2.75,NaN,NaN,0.40103033413621086,0.7375314194999338,NaN,-0.19123622133534676,-0.12370426101932708,0.06753196031601968,16.28847668487543,-1.8284680851063864,NaN,NaN,NaN,4590499
780672600,46.14062,46.26562,46,46.10937,NaN,NaN,43.639627419354845,48.531243076923076,46.17460735000003,45.888122500000065,46.45249740000006,46.9249975,46.45611782038539,46.61978663711792,46.62980461538462,47.68715797367109,45.57245125709815,46.17460735000003,45.888122500000065,46.45249740000006,46.9249975,46.12499666666667,479500,308820,40.953416290077314,NaN,1.5,2.75,NaN,NaN,0.39135816741219565,1.552684411631371,NaN,-0.17363701980157936,-0.14951431443595453,0.024122705365624837,16.04885957783144,-1.9926936691006225,NaN,NaN,NaN,4110999
780759000,46.35937,46.53125,46.32812,46.46875,NaN,NaN,43.63408322580646,48.55858673076923,46.172576100000036,45.905310000000064,46.474372400000064,46.859372500000006,46.456613199978115,46.60540219548764,46.58893923076924,47.62678783906676,45.551090622471726,46.172576100000036,45.905310000000064,46.474372400000064,46.859372500000006,46.44270666666667,324000,323220,47.541706534662346,NaN,1.5,2.75,NaN,NaN,0.39353829831132464,1.0024132170038982,NaN,-0.13078897181124283,-0.13936350939842868,-0.008574537587185863,16.940602458052084,-2.4598126556707247,NaN,NaN,NaN,4434999
780845400,46.46875,46.46875,46.09375,46.23437,NaN,NaN,43.62853903225807,48.58593038461538,46.171091700000034,45.92406000000006,46.495622400000066,46.788278500000004,46.44789778037113,46.57006579591739,46.540862307692315,47.58204655891242,45.49967805647221,46.171091700000034,45.92406000000006,46.495622400000066,46.788278500000004,46.26562333333334,195900,315205,44.08678855629773,NaN,1.5,2.75,NaN,NaN,0.39221413414623,0.6215002934598118,NaN,-0.11195588303779747,-0.1485193913844327,-0.036563508346635236,14.550579290084267,-1.6616817985171737,NaN,NaN,NaN,4239099
780931800,46.21875,46.4375,46.17187,46.17187,NaN,NaN,43.62299483870968,48.61327403846153,46.16960730000003,45.93874750000006,46.513747400000064,46.721872000000005,46.43707316153304,46.5321423867824,46.47716000000001,47.4993453221681,45.45497467783193,46.16960730000003,45.93874750000006,46.513747400000064,46.721872000000005,46.26041333333333,5200,300735,43.185538175034765,NaN,1.5,2.75,NaN,NaN,0.3831724102786423,0.017290970455716828,NaN,-0.09793801692735818,-0.15898602950583296,-0.06104801257847478,13.020395195833556,-1.8924409030544522,NaN,NaN,NaN,4233899
781191000,46.20312,46.25,45.98437,46.0625,NaN,NaN,43.61745064516129,48.64061769230769,46.166794800000034,45.95640380000006,46.528122400000065,46.66015350000001,46.422384017943514,46.487414540422165,46.40143923076924,47.3888430347967,45.41403542674178,46.166794800000034,45.95640380000006,46.528122400000065,46.66015350000001,46.09895666666667,72600,299385,41.583542428790786,NaN,1.5,2.75,NaN,NaN,0.37477652383016796,0.24249711909414298,NaN,-0.0904409921524006,-0.17409925276897553,-0.08365826061657493,12.897841764152014,-0.23687582937402885,NaN,NaN,NaN,4161299
781277400,46.29687,46.29687,45.34375,45.375,NaN,NaN,43.61190645161291,48.667961346153845,46.16085730000003,45.96499760000006,46.527497400000065,46.56327850000001,46.3813101348869,46.3814702984772,46.22716076923078,47.06690434406203,45.387417194399525,46.16085730000003,45.96499760000006,46.527497400000065,46.56327850000001,45.67187333333334,84200,292105,33.23703981754208,NaN,1.5,2.75,NaN,NaN,0.416086772128013,0.28825251193919993,NaN,-0.1241128834912376,-0.23879936498062193,-0.11468648148938433,11.01963508087003,-1.7258776826669537,NaN,NaN,NaN,4077099
781363800,45.29687,45.39062,45,45.39062,NaN,NaN,45,48.695305,46.154685400000034,45.97374760000006,46.528122400000065,46.46952850000001,46.342459541361926,46.28710360338413,46.10216076923078,46.91868391078968,45.285637627671875,46.154685400000034,45.97374760000006,46.528122400000065,46.46952850000001,45.260413333333325,461900,313805,33.563314980346036,NaN,1.5,2.75,NaN,NaN,0.41426771697601195,1.4719332069278692,NaN,-0.13666916354120662,-0.2855229359158926,-0.148853772374686,11.04122687530123,-1.4586268656716452,NaN,NaN,NaN,4538999
781450200,45.42187,45.45312,45.17187,45.25,NaN,NaN,45.014084507042256,48.72264865384615,46.148591650000036,45.98093510000006,46.52593500000006,46.357028500000006,46.29961799072028,46.18833183163326,45.9627376923077,46.689803416523006,45.23567196809239,46.148591650000036,45.98093510000006,46.52593500000006,46.357028500000006,45.29166333333333,345200,316825,32.04500808795359,NaN,1.5,2.75,NaN,NaN,0.4047664514777254,1.0895604829164365,NaN,-0.14499174169002335,-0.3300934494872152,-0.18510170779719184,11.065231318634739,-1.4295439074200136,NaN,NaN,NaN,4193799
781536600,45.25,45.57812,45.20312,45.45312,NaN,NaN,45.028169014084504,48.7499923076923,46.141951000000034,45.983591300000064,46.52593500000006,46.27968450000001,46.26642199108419,46.118311657192,45.90744923076924,46.67089589552794,45.144002566010535,46.141951000000034,45.983591300000064,46.52593500000006,46.27968450000001,45.41145333333333,188700,301840,36.51259075681415,NaN,1.5,2.75,NaN,NaN,0.40264027637217353,0.6251656506758547,NaN,-0.12795728493986408,-0.34504831397202196,-0.21709102903215788,11.554883661319563,-1.4900103206242137,NaN,NaN,NaN,4382499
781795800,45.65625,46.01562,45.64062,45.9375,NaN,NaN,45.04225352112676,48.77733596153846,46.13788850000004,45.98781010000006,46.52656000000006,46.233591000000004,46.25352308947304,46.101091499364195,45.889420769230775,46.637962840867054,45.140878697594495,46.13788850000004,45.98781010000006,46.52656000000006,46.233591000000004,45.86458,213600,306050,45.68329788589437,NaN,1.5,2.75,NaN,NaN,0.41405882805987543,0.6979251756248979,NaN,-0.0776815076725399,-0.31419291362283275,-0.23651140595029285,12.959357021571568,-0.37274419494345384,NaN,NaN,NaN,4596099
781882200,46.14062,46.75,46.14062,46.625,NaN,NaN,45.056338028169016,48.804679615384615,46.13601350000003,45.99671640000006,46.536560000000065,46.21484100000001,46.26809081145449,46.1509875470438,45.93269000000001,46.7753608362903,45.09001916370972,46.13601350000003,45.99671640000006,46.536560000000065,46.21484100000001,46.50520666666667,461400,309660,55.50705386512432,NaN,1.5,2.75,NaN,NaN,0.44251891176988434,1.4900213136988956,NaN,0.003933441726397813,-0.23159460379229557,-0.23552804551869339,15.637133210024476,0.3362474781439139,NaN,NaN,NaN,5057499
781968600,46.6875,46.75,46.57812,46.6875,NaN,NaN,45.070422535211264,48.83202326923077,46.13398225000004,46.00796640000006,46.54656000000006,46.196872500000005,46.28453823061314,46.20208397113486,45.99278615384616,46.925918989948386,45.05965331774394,46.13398225000004,46.00796640000006,46.54656000000006,46.196872500000005,46.67187333333334,162400,296605,56.281167516727784,NaN,1.5,2.75,NaN,NaN,0.4231875609291785,0.5475295426577435,NaN,0.06101778157158305,-0.15925581855421456,-0.2202736001257976,15.062619869075114,0.9800717518158063,NaN,NaN,NaN,5219899
782055000,47.21875,47.32812,46.79687,46.84375,NaN,NaN,45.08450704225352,48.85936692307692,46.13304475000004,46.02156020000006,46.55937260000006,46.15702900000001,46.30646810392243,46.26319502150297,46.046873076923085,47.08375440312999,45.00999175071618,46.13304475000004,46.02156020000006,46.55937260000006,46.15702900000001,46.98958,1564500,335840,58.23742287845087,NaN,1.5,2.75,NaN,NaN,0.43871844943423705,4.6584683182467845,NaN,0.10557818927935397,-0.08830086352660516,-0.19387905280595913,14.70276426627151,1.4551717311861132,NaN,NaN,NaN,6784399
782141400,47,47.0625,46.6875,47.04687,NaN,NaN,45.098591549295776,48.88671057692307,46.134060350000034,46.035310200000055,46.58156000000006,46.15859150000001,46.335503472396056,46.33783073374079,46.118988461538464,47.2855256359606,44.952451287116325,46.134060350000034,46.035310200000055,46.58156000000006,46.15859150000001,46.93229,72800,310915,60.699344001093245,NaN,1.5,2.75,NaN,NaN,0.4341671316175058,0.23414759661000595,NaN,0.1427034086011457,-0.015499792054527006,-0.1582032006556727,14.687758157100752,2.137031207598368,NaN,NaN,NaN,6857199
782400600,47,47.0625,46.90625,46.95312,NaN,NaN,45.11267605633803,48.91405423076923,46.13585720000004,46.04687270000006,46.604997400000066,46.15312250000001,46.35972372838052,46.39642971147976,46.1562476923077,47.39386627637812,44.91862910823728,46.13585720000004,46.04687270000006,46.604997400000066,46.15312250000001,46.97395666666667,282300,316665,58.97139269384504,NaN,1.5,2.75,NaN,NaN,0.4143159079305411,0.89147837620198,NaN,0.1539514307510919,0.034236087783192204,-0.11971534296789971,14.649501882037569,3.477950413223137,NaN,NaN,NaN,6574899
782487000,46.90625,46.90625,46.6875,46.84375,NaN,NaN,45.12676056338028,48.941397884615384,46.13773220000004,46.05702900000006,46.624060000000064,46.1867165,46.378705150796975,46.43903164371979,46.203123076923085,47.49403993953371,44.91220621431246,46.13773220000004,46.05702900000006,46.624060000000064,46.1867165,46.8125,132100,305490,56.93510449772077,NaN,1.5,2.75,NaN,NaN,0.4036947716497881,0.43242004648269994,NaN,0.14704276877007988,0.06408811799470016,-0.08295465077537972,10.507028935374848,3.201388304455858,NaN,NaN,NaN,6442799
782573400,46.67187,47.23437,46.65625,47.0625,NaN,NaN,45.140845070422536,48.968741538461536,46.13976345000004,46.06890400000006,46.645935000000065,46.23124800000001,46.40552063507945,46.49840958241314,46.27163307692308,47.64080469676341,44.90246145708275,46.13976345000004,46.06890400000006,46.645935000000065,46.23124800000001,46.98437333333334,136700,292450,59.916362219585,NaN,1.5,2.75,NaN,NaN,0.41615371653194605,0.4674303299709352,NaN,0.14972072404441011,0.1041962542801329,-0.045524469764277195,10.371279989584675,4.005524861878453,NaN,NaN,NaN,6579499
782659800,47.0625,47.0625,46.60937,46.75,NaN,NaN,45.15492957746479,48.99608519230769,46.13976345000004,46.07827900000006,46.65812260000006,46.265623000000005,46.419029629782216,46.52237057456427,46.324517692307694,47.710301624963144,44.938733759652244,46.13976345000004,46.07827900000006,46.65812260000006,46.265623000000005,46.80729,290300,293645,54.14928827829508,NaN,1.5,2.75,NaN,NaN,0.41879487963680717,0.9886086941715336,NaN,0.12402262473153453,0.10950381115014096,-0.01451881358139356,11.36601945877104,2.853225477150967,NaN,NaN,NaN,6289199
782746200,46.625,46.6875,46.35937,46.5625,NaN,NaN,45.16901408450704,49.02342884615384,46.13882595000004,46.083747800000054,46.66999760000006,46.298435500000004,46.424655918810366,46.52619242460577,46.41586384615385,47.691417273446,45.140310418861695,46.13882595000004,46.083747800000054,46.66999760000006,46.298435500000004,46.53645666666667,87800,289205,50.97873489782623,NaN,1.5,2.75,NaN,NaN,0.41678310251989253,0.3035908784426272,NaN,0.0895806362972539,0.09745698179017381,0.007876345492919917,12.056268431778896,1.3605442176870748,NaN,NaN,NaN,6201399
783005400,46.57812,46.76562,46.15625,46.17187,NaN,NaN,45.183098591549296,49.050772499999994,46.13452905000004,46.08577900000006,46.66687260000006,46.299998,46.41474274552368,46.49244743178617,46.47596,47.61941316500102,45.33250683499898,46.13452905000004,46.08577900000006,46.66687260000006,46.299998,46.36458,149600,285535,45.05935404686836,NaN,1.5,2.75,NaN,NaN,0.43053930948275726,0.5239287653002259,NaN,0.03829619906366954,0.05574659432250684,0.0174503952588373,12.268872488836497,-0.9718605898123358,NaN,NaN,NaN,6051799
783091800,46.01562,46.3125,46,46.21875,NaN,NaN,45.19718309859155,49.07811615384615,46.12765405000004,46.08562280000005,46.66499760000006,46.30546700000001,46.40705675550315,46.46638100971129,46.550479230769234,47.468724256638104,45.632234204900364,46.12765405000004,46.08562280000005,46.66499760000006,46.30546700000001,46.177083333333336,91800,266150,45.871658147407054,NaN,1.5,2.75,NaN,NaN,0.4221079302339889,0.3449182791658839,NaN,0.00697723747111078,0.026171942097725776,0.019194704626614996,8.27677469718464,-1.0040160642570282,NaN,NaN,NaN,6143599
783178200,46.39062,46.4375,46.17187,46.39062,NaN,NaN,45.2112676056338,49.105459807692306,46.12210715000004,46.08734150000006,46.65999760000006,46.30156050000001,46.406412176855966,46.45916567545307,46.62259461538462,47.30061544186658,45.94457378890266,46.12210715000004,46.08734150000006,46.65999760000006,46.30156050000001,46.333330000000004,201000,260000,48.85709204595391,NaN,1.5,2.75,NaN,NaN,0.41093093521727553,0.7730769230769231,NaN,-0.002225291801358869,0.01641308987491641,0.018638381676275278,8.613281726788426,-0.9673222148098767,NaN,NaN,NaN,6344599
783264600,46.5625,46.67187,46.45312,46.67187,NaN,NaN,45.225352112676056,49.13280346153846,46.11874775000004,46.09249770000006,46.66124760000006,46.3234355,46.4168222875675,46.479423230171825,46.67908461538462,47.22979147693495,46.128377753834286,46.11874775000004,46.09249770000006,46.66124760000006,46.3234355,46.59895333333333,210300,260720,53.3877373078665,NaN,1.5,2.75,NaN,NaN,0.4016680112731844,0.8066124578091439,NaN,0.00990218998735514,0.031016119160469202,0.02111392917311406,9.189185216937352,-0.797077467640249,NaN,NaN,NaN,6554899
783351000,46.76562,47.70312,46.76562,47.65625,NaN,NaN,45.23943661971831,47.70312,46.12093525000004,46.11124770000006,46.68531020000006,46.3976545,46.46542729589819,46.59150197015546,46.758411538461544,47.514062008689756,46.00276106823333,46.12093525000004,46.11124770000006,46.68531020000006,46.3976545,47.37499666666666,192100,270065,65.05591930453113,NaN,1.5,2.75,NaN,NaN,0.4466381533250998,0.7113102401273768,NaN,0.07961271170927739,0.1206298188097108,0.04101710710043341,15.200894992342533,1.4975149681213977,NaN,NaN,NaN,6746999
783613800,47.54687,47.59375,47.46875,47.48437,NaN,NaN,45.25352112676056,47.69657930232558,46.12132585000004,46.12577890000006,46.706560200000055,46.468748000000005,46.505385833313944,46.67653702061685,46.819709230769234,47.66622530491084,45.97319315662763,46.12132585000004,46.12577890000006,46.706560200000055,46.468748000000005,47.51562333333334,36300,268250,62.13135560283209,NaN,1.5,2.75,NaN,NaN,0.4281282852304499,0.1353215284249767,NaN,0.10778956111284124,0.17575405849148495,0.06796449737864371,15.355943056839566,1.3675677118078686,NaN,NaN,NaN,6710699
783700200,47.28125,47.28125,46.9375,46.95312,NaN,NaN,45.267605633802816,47.690038604651164,46.11906020000004,46.13421640000006,46.71812260000006,46.54765400000001,46.522944035929086,46.702878256748576,46.82812230769231,47.6775956456747,45.97864896970992,46.11906020000004,46.13421640000006,46.71812260000006,46.54765400000001,47.057289999999995,435200,285800,54.04442932638274,NaN,1.5,2.75,NaN,NaN,0.4366098362854176,1.522743177046886,NaN,0.08527700428291729,0.17456075273229033,0.08928374844937303,16.86549213020496,-0.23241434262948543,NaN,NaN,NaN,6275499
783786600,46.8125,47.23437,46.6875,46.6875,NaN,NaN,45.28169014084507,47.68349790697674,46.11515395000004,46.13937270000006,46.71906020000006,46.612498,46.52939721099069,46.70141366086776,46.80047846153847,47.64303972255853,45.95791720051841,46.11515395000004,46.13937270000006,46.71906020000006,46.612498,46.86979,115600,268485,50.50484540701029,NaN,1.5,2.75,NaN,NaN,0.4444855622650305,0.4305640911037861,NaN,0.048930977569445575,0.15044747041118,0.10151649284173443,16.915448314494835,-0.13368983957219252,NaN,NaN,NaN,6159899
783873000,46.84375,47.01562,46.78125,46.9375,NaN,NaN,45.29577464788732,47.67695720930232,46.11312270000004,46.143435200000056,46.714997800000056,46.696873000000004,46.54540124193223,46.723898074118445,46.79927692307693,47.641008197583005,45.95754564857086,46.11312270000004,46.143435200000056,46.714997800000056,46.696873000000004,46.91145666666667,87000,255575,53.58600470116261,NaN,1.5,2.75,NaN,NaN,0.43617373638895673,0.3404088819328964,NaN,0.03861385893316459,0.14978381650819017,0.11116995757502558,16.79562188915329,0.8053691275167785,NaN,NaN,NaN,6246899
783959400,47.15625,47.15625,46.32812,46.32812,NaN,NaN,45.309859154929576,47.670416511627906,46.10741955000004,46.14327890000006,46.701247800000054,46.74062300000001,46.53688040891528,46.6862049242024,46.75961307692308,47.63706070808725,45.882165445758915,46.10741955000004,46.14327890000006,46.701247800000054,46.74062300000001,46.60416333333333,124400,252360,46.059347763515575,NaN,1.5,2.75,NaN,NaN,0.46417061236117424,0.49294658424472976,NaN,-0.009779636703851055,0.09894541169521176,0.10872504839906282,18.38976543490462,0.3384095121120284,NaN,NaN,NaN,6122499
784218600,46.3125,46.59375,46.3125,46.46875,NaN,NaN,45.32394366197183,47.66387581395349,46.10288830000004,46.14359140000006,46.676872800000055,46.767185500000004,46.5342086281735,46.66549493142122,46.71394000000001,47.58536042746992,45.842519572530094,46.10288830000004,46.14359140000006,46.676872800000055,46.767185500000004,46.458333333333336,115000,247430,47.878795766428254,NaN,1.5,2.75,NaN,NaN,0.4511048543353761,0.46477791698662246,NaN,-0.03161562496501674,0.06920551719279189,0.10082114215780863,17.749935770742418,0.5409060175794456,NaN,NaN,NaN,6237499
784305000,46.625,46.98437,46.54687,46.82812,NaN,NaN,45.33802816901409,47.65733511627907,46.101091400000044,46.15312260000006,46.660310200000055,46.777341500000006,46.54573456432356,46.68098303319063,46.71994923076924,47.59335659581462,45.84654186572386,46.101091400000044,46.15312260000006,46.660310200000055,46.777341500000006,46.78645333333333,308300,239775,52.306057569857884,NaN,1.5,2.75,NaN,NaN,0.4557130790257063,1.2857887602961109,NaN,-0.021629669332551546,0.0737840554921192,0.09541372482467074,18.209446948969155,0.9430785792472702,NaN,NaN,NaN,6545799
784391400,47.32812,47.32812,46.5,46.90625,NaN,NaN,45.352112676056336,47.65079441860465,46.09968515000004,46.16734140000006,46.642810200000056,46.788279,46.559872424546164,46.702437030029614,46.746391538461545,47.61994476969554,45.872838307227546,46.09968515000004,46.16734140000006,46.642810200000056,46.788279,46.91145666666667,318500,247580,53.2360777683874,NaN,1.5,2.75,NaN,NaN,0.4823135733810129,1.2864528637208175,NaN,-0.010120597436761997,0.08276297802871824,0.09288357546548023,18.148614916266055,0.5021868633076018,NaN,NaN,NaN,6864299
784477800,46.9375,47.03125,46.54687,46.57812,NaN,NaN,45.36619718309859,47.64425372093023,46.09601325000004,46.18218510000006,46.62124760000006,46.774997500000005,46.56058801574043,46.69059731288394,46.777641538461545,47.59393796941547,45.96134510750762,46.09601325000004,46.18218510000006,46.62124760000006,46.774997500000005,46.71874666666667,172100,177960,48.921468790368614,NaN,1.5,2.75,NaN,NaN,0.48246117528236926,0.967071251966734,NaN,-0.024163687555217472,0.0626789660214584,0.08684265357667587,18.393935662071954,-2.262305573770495,NaN,NaN,NaN,6692199
784564200,46.51562,46.5625,46.28125,46.40625,NaN,NaN,45.38028169014085,47.63771302325581,46.089294500000044,46.19359140000006,46.59937260000006,46.74296650000001,46.55453554453492,46.6635166164188,46.792064615384625,47.57426509165662,46.00986413911263,46.089294500000044,46.19359140000006,46.59937260000006,46.74296650000001,46.416666666666664,302200,189430,46.782720445054714,NaN,1.5,2.75,NaN,NaN,0.4692046627621999,1.595312252547115,NaN,-0.04345899372755868,0.032518911417227514,0.0759779051447862,12.596624776557665,-2.270473421043595,NaN,NaN,NaN,6389999
784823400,46.60937,46.85937,46.60937,46.84375,NaN,NaN,45.394366197183096,47.631172325581396,46.084138250000045,46.21202890000006,46.59031020000006,46.737498,46.565877287886494,46.680681700569394,46.826920769230775,47.574057124261756,46.07978441419979,46.084138250000045,46.21202890000006,46.59031020000006,46.737498,46.77083,181400,184385,52.47802958374021,NaN,1.5,2.75,NaN,NaN,0.4680557582791855,0.9838110475364048,NaN,-0.02604717369847301,0.04341893802169494,0.06946611172016795,14.321312666309055,-0.23293446740067203,NaN,NaN,NaN,6571399
784909800,46.79687,47.09375,46.32812,46.6875,NaN,NaN,45.40845070422535,47.62463162790697,46.07648200000004,46.23827890000006,46.57781020000006,46.7296855,46.57064680600859,46.68133106241993,46.828123076923085,47.5743072158936,46.08193893795257,46.07648200000004,46.23827890000006,46.57781020000006,46.7296855,46.70312333333334,316900,193625,50.40335158927424,NaN,1.5,2.75,NaN,NaN,0.4893110612592438,1.6366688185926404,NaN,-0.02437316559320976,0.03899965472865574,0.0633728203218655,12.98194458756985,0,NaN,NaN,NaN,6254499
784996200,46.76562,46.84375,46.60937,46.84375,NaN,NaN,45.42253521126761,47.618090930232555,46.07085700000004,46.25843520000006,46.56937280000005,46.718748000000005,46.58135673518473,46.69679953266565,46.765623076923085,47.34027715348859,46.190969000357576,46.07085700000004,46.25843520000006,46.56937280000005,46.718748000000005,46.76562333333334,106900,192135,52.42871404591128,NaN,1.5,2.75,NaN,NaN,0.4711016997407265,0.5563796289067583,NaN,-0.012652496063173202,0.047557200242899,0.0602096963060722,12.713188786758495,-0.19973368841544606,NaN,NaN,NaN,6361399
785082600,46.875,46.875,46.34375,46.53125,NaN,NaN,45.436619718309856,47.61155023255814,46.06210700000004,46.277654000000055,46.54999780000006,46.70781050000001,46.57939176517748,46.681032910507014,46.69230615384616,47.10056418842525,46.28404811926707,46.06210700000004,46.277654000000055,46.54999780000006,46.70781050000001,46.583333333333336,104700,182855,48.19010843459338,NaN,1.5,2.75,NaN,NaN,0.4753980069021032,0.5725848349785349,NaN,-0.02513488296918167,0.028791092594595113,0.05392597556377678,12.853692177012388,0.4384594065116426,NaN,NaN,NaN,6256699
785169000,46.54687,46.625,46.26562,46.46875,NaN,NaN,45.45070422535211,47.60500953488372,46.054138250000044,46.294841500000054,46.53937280000005,46.703123000000005,46.575052872425424,46.660815490458724,46.655046923076924,47.04946909520309,46.26062475095076,46.054138250000044,46.294841500000054,46.53937280000005,46.703123000000005,46.45312333333334,269300,191930,47.3653453945603,NaN,1.5,2.75,NaN,NaN,0.467111006409096,1.4031157192726516,NaN,-0.03612122597343578,0.008774443096982054,0.04489566907041784,10.294144806759366,0,NaN,NaN,NaN,5987399
785428200,46.4375,46.57812,46,46,NaN,NaN,45.46478873239437,47.5984688372093,46.049294500000045,46.310154000000054,46.522185400000055,46.6945295,46.55250177938913,46.597880681843606,46.60216230769231,47.12759951999015,46.07672509539447,46.049294500000045,46.310154000000054,46.522185400000055,46.6945295,46.19270666666667,283100,198605,41.612984808968676,NaN,1.5,2.75,NaN,NaN,0.4750402202370176,1.4254424611666372,NaN,-0.07143755373426523,-0.04440127309741371,0.02703628063685153,11.692684875909663,-1.7684246132452006,NaN,NaN,NaN,5704299
785514600,45.82812,46,45,45,NaN,NaN,45.478873239436616,47.59192813953488,46.03835700000004,46.31452900000006,46.482185400000056,46.63359200000001,46.49161935666799,46.445701569287074,46.45312384615385,47.423925977826,45.4823217144817,46.03835700000004,46.31452900000006,46.482185400000056,46.63359200000001,45.333333333333336,483600,218195,32.53516088837826,NaN,1.5,2.75,NaN,NaN,0.5125373473629449,2.2163660945484542,NaN,-0.15389241759953207,-0.16532924136256355,-0.011436823763031494,15.402927601637481,-4.063957361758828,NaN,NaN,NaN,5220699
785601000,45.03125,45.26562,44.60937,45.25,NaN,NaN,44.60937,47.58538744186046,46.02851325000004,46.319060300000054,46.446248000000054,46.576561000000005,46.44292840150454,46.33182522935497,46.37019153846154,47.53446147535602,45.20592160156706,46.02851325000004,46.319060300000054,46.446248000000054,46.576561000000005,45.04166333333333,601600,238225,36.277721764921765,NaN,1.5,2.75,NaN,NaN,0.5228025368370203,2.5253436876902087,NaN,-0.1814475507348187,-0.23824626218155487,-0.05679871144673618,16.06706192764827,-2.851381721718263,NaN,NaN,NaN,5822299
785773800,45.28125,45.53125,45.28125,45.46875,NaN,NaN,44.598209142857144,47.578846744186045,46.01882575000004,46.326404100000055,46.402810600000045,46.516405000000006,46.40472532693573,46.24962758846402,46.29326846153846,47.54981006198303,45.03672686109389,46.01882575000004,46.326404100000055,46.402810600000045,46.516405000000006,45.427083333333336,77300,231575,39.443253381868985,NaN,1.5,2.75,NaN,NaN,0.5055487842058045,0.3338011443376876,NaN,-0.1747288569445421,-0.2752097826274138,-0.1004809256828717,16.571380691040563,-2.0202020202020203,NaN,NaN,NaN,5899599
786033000,45.45312,45.6875,45.34375,45.67187,NaN,NaN,44.58704828571428,47.57230604651163,46.01218510000004,46.333904100000055,46.37593560000005,46.417186,46.37598590235002,46.194603056229354,46.204326153846154,47.460528601506184,44.948123706186124,46.01218510000004,46.333904100000055,46.37593560000005,46.417186,45.56770666666667,79900,225965,42.30909397588648,NaN,1.5,2.75,NaN,NaN,0.4939917281911042,0.35359458323191645,NaN,-0.14747942513877357,-0.28483020710633866,-0.1373507819675651,16.994003034799682,-2.5016784523015376,NaN,NaN,NaN,5979499
786119400,45.65625,45.75,45.5,45.65625,NaN,NaN,44.57588742857143,47.56576534883721,46.004685100000046,46.341404100000055,46.347810600000045,46.32578,46.347760965002955,46.14333133658846,46.10817230769231,47.32550141341407,44.89084320197055,46.004685100000046,46.341404100000055,46.347810600000045,46.32578,45.635416666666664,105500,229425,42.14392158114025,NaN,1.5,2.75,NaN,NaN,0.4765637476060253,0.45984526533725617,NaN,-0.12241352507576048,-0.29036768831226567,-0.1679541632365052,15.55389163806719,-2.208835341365462,NaN,NaN,NaN,5873999
786205800,45.89062,45.95312,45.59375,45.59375,NaN,NaN,44.56472657142857,47.559224651162786,45.99656010000004,46.349841600000055,46.33624820000004,46.2578115,46.318191907551856,46.09099025691337,46.03245153846154,47.245887247684784,44.81901582923829,45.99656010000004,46.349841600000055,46.33624820000004,46.2578115,45.71354,218800,218605,41.44668966232517,NaN,1.5,2.75,NaN,NaN,0.4681927656341663,1.00089201985316,NaN,-0.10274298320221359,-0.29638289223927217,-0.19363990903705858,15.559148005200942,-2.66844563042028,NaN,NaN,NaN,5655199
786292200,45.64062,45.64062,45.04687,45.14062,NaN,NaN,44.55356571428571,47.55268395348837,45.98491945000004,46.35312280000006,46.31562320000005,46.180467500000006,46.27201261705963,46.000478803874,45.93509538461539,47.21425454960958,44.655936219621196,45.98491945000004,46.35312280000006,46.31562320000005,46.180467500000006,45.27603666666666,439000,234775,36.70536838417078,NaN,1.5,2.75,NaN,NaN,0.4771611395174401,1.869875412629113,NaN,-0.11218023160102003,-0.33386519853833363,-0.2216849669373136,15.648464150366047,-2.9885936870382843,NaN,NaN,NaN,5216199
786378600,45.04687,45.5625,45.04687,45.5625,NaN,NaN,44.542404857142856,47.54614325581395,45.975544450000044,46.35984160000005,46.30562320000004,46.111717500000005,46.244188592861214,45.95876653683838,45.836537692307694,47.01384931275326,44.65922607186213,45.975544450000044,46.35984160000005,46.30562320000004,46.111717500000005,45.39062333333334,318500,246350,43.21819523370264,NaN,1.5,2.75,NaN,NaN,0.4799089152661945,1.2928759894459103,NaN,-0.08327018741891012,-0.32577270121095125,-0.24250251379204113,17.146841300985564,-1.9502353732347006,NaN,NaN,NaN,5534699
786637800,45.65625,45.8125,45.5,45.60937,NaN,NaN,44.531244,47.539602558139535,45.96781005000005,46.36218530000006,46.299685600000046,46.07578,46.21929374608234,45.92549067618711,45.75360461538462,46.826739389472664,44.68046984129657,45.96781005000005,46.36218530000006,46.299685600000046,46.07578,45.64062333333334,139200,247090,43.90873483702606,NaN,1.5,2.75,NaN,NaN,0.4679511356043235,0.5633574810797685,NaN,-0.05558278795251026,-0.3119809987326789,-0.25639821078016867,17.238870470858444,-0.8491956521739165,NaN,NaN,NaN,5673899
786724200,45.4375,45.65625,45.35937,45.64062,NaN,NaN,44.52008314285714,47.53306186046512,45.96163815000004,46.364685300000055,46.28968560000005,46.0343735,46.19660065800068,45.89836013559786,45.66105615384616,46.53031932973301,44.79179297795931,45.96163815000004,46.364685300000055,46.28968560000005,46.0343735,45.55208,249900,253835,44.39428996051577,NaN,1.5,2.75,NaN,NaN,0.45573176877544336,0.9844978036913743,NaN,-0.030983285230485547,-0.2951273173182756,-0.26414403208779,16.440920437358088,1.4235999999999964,NaN,NaN,NaN,5923799
786810600,45.35937,45.5,45.26562,45.3125,NaN,NaN,44.508922285714284,47.526521162790694,45.95148190000005,46.363122800000056,46.27374820000004,45.9585925,46.16193004396144,45.84256393220759,45.56730615384616,46.291770151803654,44.84284215588867,45.95148190000005,46.363122800000056,46.27374820000004,45.9585925,45.35937333333334,531900,265015,40.43623864215427,NaN,1.5,2.75,NaN,NaN,0.44996521386291166,2.0070562043657905,NaN,-0.0324722996186112,-0.304734406611054,-0.2722621069924428,10.652756116919257,0.13812154696132597,NaN,NaN,NaN,5391899
786897000,45.5,45.5625,44.75,44.875,NaN,NaN,44.49776142857143,47.51998046511628,45.93976315000005,46.358122800000054,46.24187320000004,45.85703,46.11146219910021,45.750414986283054,45.44471,46.04651637233301,44.84290362766699,45.93976315000005,46.358122800000054,46.24187320000004,45.85703,45.0625,261500,262165,35.84703261472889,NaN,1.5,2.75,NaN,NaN,0.47586055572984653,0.9974634295195773,NaN,-0.05714139964718479,-0.3436888565514238,-0.286547456904239,11.65572918156476,-1.3058419243986255,NaN,NaN,NaN,5130399
786983400,44.875,45.07812,44.6875,45.04687,NaN,NaN,44.48660057142857,47.51343976744186,45.93202875000004,46.356872800000055,46.21812320000004,45.7804675,46.069713485410006,45.68341070187515,45.37139230769231,45.91406485273651,44.82871976264811,45.93202875000004,46.356872800000055,46.21812320000004,45.7804675,44.93749666666667,235900,265355,38.78619049307367,NaN,1.5,2.75,NaN,NaN,0.46977194460628596,0.8889977577207892,NaN,-0.056027326686170276,-0.35658161526195187,-0.3005542885757816,11.49159256572317,-1.3684572144735918,NaN,NaN,NaN,5366299
787242600,44.95312,45.34375,44.95312,45.34375,NaN,NaN,44.47543971428571,47.50689906976744,45.924685000000046,46.357654100000055,46.201560800000046,45.727342500000006,46.041244329119415,45.65106206360132,45.39783461538462,45.89732548044736,44.89834375032188,45.924685000000046,46.357654100000055,46.201560800000046,45.727342500000006,45.21354,151100,257800,43.59348757789048,NaN,1.5,2.75,NaN,NaN,0.4641189485629799,0.5861132660977502,NaN,-0.030705718179359853,-0.3389364362999814,-0.3082307181206215,11.909192849159341,-0.6844626967830253,NaN,NaN,NaN,5517399
787329000,45.3125,45.53125,45.3125,45.51562,NaN,NaN,44.46427885714286,47.500358372093025,45.91820060000005,46.35937280000005,46.19062320000005,45.66093600000001,46.02063161033042,45.638162819448816,45.41826692307693,45.91361054822348,44.922923297930375,45.91820060000005,46.35937280000005,46.19062320000005,45.66093600000001,45.45312333333334,70900,252275,46.22633106209724,NaN,1.5,2.75,NaN,NaN,0.44659259509419563,0.2810425131305123,NaN,0.0005534424587742559,-0.3075389150471537,-0.30809235750592795,12.188538650047727,-0.17136120630569232,NaN,NaN,NaN,5588299
787415400,45.45312,45.95312,45.45312,45.75,NaN,NaN,44.453117999999996,47.4938176744186,45.913825600000045,46.362810300000056,46.19812320000005,45.61406100000001,46.01001860600373,45.64881397950131,45.43990153846154,45.96580027260178,44.9140028043213,45.913825600000045,46.362810300000056,46.19812320000005,45.61406100000001,45.71874666666667,203300,246595,49.67599022937394,NaN,1.5,2.75,NaN,NaN,0.4504074097303245,0.8244287191548896,NaN,0.03788346964728412,-0.2607380204468228,-0.29862149009410693,12.54690041862298,1.3499593049453056,NaN,NaN,NaN,5791599
787501800,45.8125,46.03125,45.8125,45.89062,NaN,NaN,44.44195714285714,47.487276976744184,45.909841200000045,46.36812280000006,46.208123200000045,45.566404500000004,46.005336307729074,45.67184312431071,45.45672846153847,46.02363848841422,44.889818434662715,45.909841200000045,46.36812280000006,46.208123200000045,45.566404500000004,45.91145666666667,130100,247755,51.67886976851223,NaN,1.5,2.75,NaN,NaN,0.4383247376067299,0.5251155375269924,NaN,0.07099180841726177,-0.2098817295725297,-0.2808735379897915,10.722185040405071,0.7201536351165946,NaN,NaN,NaN,5921699
787588200,45.67187,45.84375,45.625,45.75,NaN,NaN,44.43079628571429,47.48073627906977,45.90577870000005,46.372029100000056,46.21812320000004,45.527342000000004,45.99532311919068,45.67928663628112,45.46394000000001,46.043072228712816,44.8848077712872,45.90577870000005,46.372029100000056,46.21812320000004,45.527342000000004,45.739583333333336,266100,255825,49.55488804862317,NaN,1.5,2.75,NaN,NaN,0.4259886849205348,1.0401641747288186,NaN,0.08160859638331919,-0.17886279251064252,-0.2604713888939617,9.803696254530216,0.3083357652166684,NaN,NaN,NaN,5655599
787847400,45.75,45.84375,45.60937,45.8125,NaN,NaN,44.419635428571425,47.47419558139535,45.901403700000046,46.37562290000005,46.225310800000045,45.494529500000006,45.98815358510477,45.69197362330196,45.48076692307693,46.08612593865623,44.875407907497625,45.901403700000046,46.37562290000005,46.225310800000045,45.494529500000006,45.75520666666667,1120200,298370,50.5281143537307,NaN,1.5,2.75,NaN,NaN,0.4123023502833539,3.7543989006937695,NaN,0.09034820784639264,-0.1475361290859709,-0.23788433693236355,9.813342431901045,0.37659435827121013,NaN,NaN,NaN,6775799
787933800,45.85937,45.89062,45.67187,45.67187,NaN,NaN,44.40847457142857,47.467654883720925,45.895075550000044,46.373279100000055,46.21999820000005,45.478123000000004,45.97575030725752,45.6900589925113,45.521632307692315,46.10078400000955,44.94248061537508,45.895075550000044,46.373279100000055,46.21999820000005,45.478123000000004,45.74478666666666,675600,317995,48.27144619167691,NaN,1.5,2.75,NaN,NaN,0.39847718240597146,2.124561706945078,NaN,0.08428389267741315,-0.1325294710855971,-0.21681336376301025,10.014195375026732,0.7930924137930999,NaN,NaN,NaN,6100199
788020200,45.70312,46.26562,45.70312,46.15625,NaN,NaN,44.39731371428571,47.46111418604651,45.89210680000005,46.373591600000054,46.21062320000004,45.53593550000001,45.982828726580756,45.73445813608165,45.56730538461539,46.238482370675,44.896128398555774,45.89210680000005,46.373591600000054,46.21062320000004,45.53593550000001,46.04166333333333,544500,321040,55.62309176642895,NaN,1.5,2.75,NaN,NaN,0.41242524080554493,1.6960503364066783,NaN,0.10895324253952565,-0.08062181058860318,-0.18957505312812883,10.46421226094791,2.8551532033426184,NaN,NaN,NaN,6644699
788106600,46.15625,46.20312,45.96875,46.01562,NaN,NaN,44.386152857142854,47.45457348837209,45.88734115000005,46.371872800000055,46.19718560000005,45.574216500000006,45.984114658871704,45.76123545645483,45.59855538461539,46.311205158673204,44.88590561055757,45.88734115000005,46.371872800000055,46.19718560000005,45.574216500000006,46.06249666666667,222000,302060,53.25660458682636,NaN,1.5,2.75,NaN,NaN,0.3997070093194345,0.7349533205323445,NaN,0.11145764560775273,-0.05025299611843792,-0.16171064172619065,8.244349132297422,2.150537873108609,NaN,NaN,NaN,6422699
788193000,45.98437,46.17187,45.98437,46.0625,NaN,NaN,44.374992,47.448032790697674,45.884684900000046,46.37046660000006,46.18156060000005,45.60390400000001,45.98718859381791,45.78992731774484,45.6310076923077,46.38555508006815,44.876460304547244,45.884684900000046,46.37046660000006,46.18156060000005,45.60390400000001,46.07291333333333,125800,304485,53.959807197141075,NaN,1.5,2.75,NaN,NaN,0.38454936579661775,0.4131566415422763,NaN,0.11165062010732854,-0.022147366592029982,-0.13379798669935852,8.238055021143847,1.5851137146795313,NaN,NaN,NaN,6548499
788538600,46.21875,46.40625,46.1875,46.3125,NaN,NaN,44.36383114285714,47.44149209302326,45.882028650000045,46.374216600000054,46.16687320000005,45.6359355,45.999945903864266,45.83969614462629,45.70793076923077,46.51870860272532,44.89715293573622,45.882028650000045,46.374216600000054,46.16687320000005,45.6359355,46.30208333333334,95200,305250,57.62119719582633,NaN,1.5,2.75,NaN,NaN,0.38163512538257366,0.3118755118755119,NaN,0.12309288944456569,0.02006812510634859,-0.1030247643382171,8.04005170347837,1.7507835771543958,NaN,NaN,NaN,6643699
788625000,46.35937,46.35937,45.96875,46.07812,NaN,NaN,44.35267028571428,47.43495139534883,45.87788800000005,46.37718530000006,46.14937320000004,45.65702900000001,46.00301155469312,45.8624031784714,45.80047846153847,46.47263748126716,45.12831944180978,45.87788800000005,46.37718530000006,46.14937320000004,45.65702900000001,46.13541333333333,358200,317885,53.33852272082458,NaN,1.5,2.75,NaN,NaN,0.38227690214096116,1.1268225930761124,NaN,0.10979362259069625,0.03421726390015323,-0.07557635869054302,8.922939831027188,0.7172021857923463,NaN,NaN,NaN,6285499
788711400,46.25,46.25,46.0625,46.10937,NaN,NaN,44.34150942857143,47.428410697674416,45.87405985000005,46.379372800000056,46.13468560000005,45.68281,46.00718247411692,45.8859238281408,45.882209230769234,46.41106634606022,45.35335211547825,45.87405985000005,46.379372800000056,46.13468560000005,45.68281,46.14062333333334,220100,317950,53.831237036879315,NaN,1.5,2.75,NaN,NaN,0.3683642662737497,0.6922472086806102,NaN,0.09838565388497153,0.0474057086656714,-0.05097994521930013,8.5691054059828,0.47667693310746295,NaN,NaN,NaN,6505599
788797800,46.20312,46.25,45.5625,45.5625,NaN,NaN,44.330348571428566,47.42187,45.86562235000005,46.37531030000005,46.104685600000046,45.70390400000001,45.98974394572017,45.85512155879405,45.89903615384616,46.36892542620193,45.42914688149039,45.86562235000005,46.37531030000005,46.104685600000046,45.70390400000001,45.791666666666664,2209500,406475,44.89673731220949,NaN,1.5,2.75,NaN,NaN,0.3911596758256247,5.435758656743957,NaN,0.051642630175453584,0.01357334250001685,-0.038069287675436735,11.059194878358163,-0.4098360655737705,NaN,NaN,NaN,4296099
789143400,45.70312,45.84375,45.6875,45.78125,NaN,NaN,44.31918771428571,47.41532930232558,45.85827860000005,46.371716600000056,46.08531060000005,45.714841500000006,45.98156771255467,45.84808617224224,45.91946923076924,46.341561003393345,45.49737745814513,45.85827860000005,46.371716600000056,46.08531060000005,45.714841500000006,45.770833333333336,324300,406765,48.573546565306636,NaN,1.5,2.75,NaN,NaN,0.38330898469522295,0.7972662348038794,NaN,0.03394500085704754,0.004361963395872692,-0.029583037461174848,11.36238079831408,-0.06821282401091405,NaN,NaN,NaN,4620399
789229800,45.98437,46,45.75,46,NaN,NaN,44.308026857142856,47.408788604651164,45.85343485000005,46.372029100000056,46.074060600000045,45.734373000000005,45.98229054735645,45.86255415583822,45.938700000000004,46.35081740373233,45.52658259626768,45.85343485000005,46.372029100000056,46.074060600000045,45.734373000000005,45.916666666666664,351800,417395,52.02123145773371,NaN,1.5,2.75,NaN,NaN,0.3737869143598499,0.8428467039614753,NaN,0.035302833489688094,0.014545504400935272,-0.020757329088752823,11.66726762374077,0.718450985256355,NaN,NaN,NaN,4972199
789316200,46.03125,46.10937,45.95312,46,NaN,NaN,44.296865999999994,47.40224790697674,45.84921610000005,46.36874790000005,46.07062320000004,45.752342000000006,45.982985035695414,45.87564423623458,45.94711384615385,46.35942744938966,45.53480024291803,45.84921610000005,46.36874790000005,46.07062320000004,45.752342000000006,46.02083,89800,409390,52.02123145773371,NaN,1.5,2.75,NaN,NaN,0.3582485633341463,0.21935074134688196,NaN,0.03449250441861444,0.022358301434515226,-0.012134202984099212,11.463572339653368,-0.33852403520649965,NaN,NaN,NaN,4972199
789402600,46.09375,46.25,45.90625,46.04687,NaN,NaN,44.28570514285714,47.39570720930232,45.84460670000005,46.366091600000054,46.067185600000045,45.789060500000005,45.98549032841324,45.89195145183128,45.969950000000004,46.36872744014148,45.57117255985853,45.84460670000005,46.366091600000054,46.067185600000045,45.789060500000005,46.06770666666667,448400,405215,52.80742758562219,NaN,1.5,2.75,NaN,NaN,0.3572129516674215,1.10657305381094,NaN,0.03527821089328909,0.031963560632512156,-0.003314650260776937,9.635000122940765,0.06791172215000037,NaN,NaN,NaN,5420599
789661800,46.03125,46.09375,46,46.09375,NaN,NaN,44.274544285714285,47.389166511627906,45.84038795000005,46.36062290000005,46.061248200000044,45.84999800000001,45.98973580573037,45.91117036118069,45.99158461538462,46.38431760509058,45.598851625678655,45.84038795000005,46.36062290000005,46.061248200000044,45.84999800000001,46.0625,36800,393980,53.62595664114519,NaN,1.5,2.75,NaN,NaN,0.3383941694054628,0.09340575663739276,NaN,0.03694332549393425,0.04286450660664087,0.005921181112706625,9.48224075632243,0.06784260515603799,NaN,NaN,NaN,5457399
789748200,46.20312,46.39062,46.14062,46.14062,NaN,NaN,44.26338342857142,47.38262581395349,45.83921605000005,46.35593540000005,46.05062320000005,45.90468550000001,45.99565283295663,45.93302270773491,46.02764230769231,46.38037645086789,45.67490816451673,45.83921605000005,46.35593540000005,46.05062320000005,45.90468550000001,46.22395333333333,229800,393675,54.47609957223007,NaN,1.5,2.75,NaN,NaN,0.33542815730507247,0.5837302343303487,NaN,0.03898750852382968,0.054655566767493724,0.015668058243664046,9.482177389533028,-0.37113090418353917,NaN,NaN,NaN,5687199
789834600,46.29687,46.29687,45.8125,46.17187,NaN,NaN,44.25222257142857,47.37608511627907,45.84038790000005,46.35312290000005,46.02093560000005,45.94609150000001,46.00256331009559,45.95577006890301,46.028843846153855,46.38342372405906,45.67426396824865,45.84038790000005,46.35312290000005,46.02093560000005,45.94609150000001,46.09374666666667,222400,397240,55.06754796397162,NaN,1.5,2.75,NaN,NaN,0.34606686035471007,0.5598630550800524,NaN,0.0400764325220037,0.06576359889616867,0.025687166374164974,8.896773456336263,0.2034588216706758,NaN,NaN,NaN,5909599
789921000,46.125,46.21875,46.03125,46.1875,NaN,NaN,44.24106171428571,47.36954441860465,45.84132540000005,46.350779200000055,45.99499820000005,45.9796855,46.009815729307526,45.97783958615034,46.04206538461539,46.40637158672807,45.67775918250271,45.84132540000005,46.350779200000055,45.99499820000005,45.9796855,46.145833333333336,40300,395710,55.37979804643968,NaN,1.5,2.75,NaN,NaN,0.3347406560436594,0.1018422582194031,NaN,0.03942136126501387,0.0749638679554323,0.03554250669041844,8.362466429649116,0.16944495229494913,NaN,NaN,NaN,5949899
790007400,46.4375,46.73437,46.375,46.73437,NaN,NaN,44.22990085714285,47.36300372093023,45.84952850000005,46.35437290000005,45.990623200000044,46.028904000000004,46.03822962227586,46.04989010175507,46.0937476923077,46.612764838555144,45.57473054606026,45.84952850000005,46.35437290000005,45.990623200000044,46.028904000000004,46.61458,170600,394075,64.63905455659304,NaN,1.5,2.75,NaN,NaN,0.3498927520405407,0.4329125166529214,NaN,0.07152017395668547,0.12494272413627527,0.0534225501795898,10.673431522696072,2.5720054869684463,NaN,NaN,NaN,6120499
790266600,46.71875,47.03125,46.71875,47.01562,NaN,NaN,44.21874,47.35646302325581,45.86226285000005,46.358122900000055,45.99718560000005,46.085154,46.07655865669641,46.1418643777784,46.14783384615385,46.85807714507334,45.437590547234365,45.86226285000005,46.358122900000055,45.99718560000005,46.085154,46.92187333333334,105100,392825,68.28418876617596,NaN,1.5,2.75,NaN,NaN,0.3472218411805021,0.26754916311334564,NaN,0.10535155695038756,0.18511199636757425,0.07976043941718669,6.763431138079341,2.696234812286686,NaN,NaN,NaN,6225599
790353000,46.92187,47.0625,46.85937,47.03125,NaN,NaN,44.20757914285714,47.349922325581396,45.87445035000005,46.35702920000005,45.99906060000005,46.14921650000001,46.1139975329044,46.22656777037093,46.22115153846154,47.07060942990818,45.3716936470149,45.87445035000005,46.35702920000005,45.99906060000005,46.14921650000001,46.984373333333345,89500,383995,68.478655588401,NaN,1.5,2.75,NaN,NaN,0.3369295668104663,0.23307595150978527,NaN,0.12130401907173134,0.23139046325685086,0.11008644418511952,6.8484403040307615,2.2418478260869565,NaN,NaN,NaN,6315099
790439400,47,47.07812,46.875,46.98437,NaN,NaN,44.19641828571428,47.34338162790697,45.88984095000005,46.35671670000005,46.012185600000045,46.20781000000001,46.148129786515995,46.29873941128798,46.288459230769234,47.22592617497067,45.3509922865678,45.88984095000005,46.35671670000005,46.012185600000045,46.20781000000001,46.97916333333333,84500,332210,67.14874963058952,NaN,1.5,2.75,NaN,NaN,0.32737174060971863,0.25435718370909965,NaN,0.12094834697595772,0.2612718779050667,0.14032353092910896,7.006611002368315,2.1399347826086923,NaN,NaN,NaN,6230599
790525800,46.82812,46.875,46.6875,46.71875,NaN,NaN,44.185257428571425,47.336840930232555,45.89937220000005,46.34702920000005,46.01718560000005,46.26015400000001,46.170507049789876,46.338740419736745,46.37740153846154,47.23880248689083,45.51600059003225,45.89937220000005,46.34702920000005,46.01718560000005,46.26015400000001,46.760416666666664,139100,305385,60.034568001648886,NaN,1.5,2.75,NaN,NaN,0.32519304485188144,0.45549061021333725,NaN,0.09615455568136905,0.2605167255308203,0.16436216984945123,8.271297727093907,1.4591219772375443,NaN,NaN,NaN,6091499
790612200,46.65625,46.67187,46.45312,46.54687,NaN,NaN,44.17409657142857,47.33030023255814,45.90804405000005,46.335935400000054,46.011560600000045,46.27968500000001,46.18526638117066,46.35856228452372,46.43629538461539,47.2285211248826,45.644069644348185,45.90804405000005,46.335935400000054,46.011560600000045,46.27968500000001,46.55728666666666,78700,282095,55.906927193405814,NaN,1.5,2.75,NaN,NaN,0.3209385416481757,0.2789840302025913,NaN,0.06310626835126762,0.24324500528853576,0.18013873693726815,8.804031255717204,0.9830399999999966,NaN,NaN,NaN,6012799
790871400,46.23437,46.6875,46.20312,46.6875,NaN,NaN,44.16293571428571,47.32375953488372,45.916325300000054,46.32499790000006,46.00718560000005,46.31327900000001,46.204961817203184,46.38988968599765,46.489180000000005,47.24896988990139,45.72939011009862,45.916325300000054,46.32499790000006,46.00718560000005,46.31327900000001,46.52604,53700,273680,58.42555658142539,NaN,1.5,2.75,NaN,NaN,0.33261293153044896,0.19621455714703304,NaN,0.046416494822822923,0.2381593554657968,0.19174286064297388,8.873146098644341,1.1852463187534144,NaN,NaN,NaN,6066499
790957800,46.67187,46.75,46.64062,46.75,NaN,NaN,44.151774857142854,47.3172188372093,45.92663780000005,46.31593540000005,46.01062320000005,46.347654000000006,46.22633586358737,46.42418590637883,46.54687230769231,47.26190280060348,45.83184181478114,45.92663780000005,46.31593540000005,46.01062320000005,46.347654000000006,46.71354,32400,269010,59.531908636269,NaN,1.5,2.75,NaN,NaN,0.316667722135417,0.12044161927065908,NaN,0.0357629596802109,0.2364465602432375,0.20068360056302662,8.871573330994389,1.252126023918896,NaN,NaN,NaN,6098899
791044200,46.51562,47.04687,46.51562,46.875,NaN,NaN,44.140614,47.31067813953488,45.93663780000006,46.309685400000056,46.019998200000046,46.37577900000001,46.251773672858455,46.4671205819618,46.61057461538462,47.28231967955252,45.93882955121672,45.93663780000006,46.309685400000056,46.019998200000046,46.37577900000001,46.81249666666667,15700,265035,61.72566902359491,NaN,1.5,2.75,NaN,NaN,0.33199502769717293,0.05923745920350142,NaN,0.03335839070217472,0.24238158894074502,0.2090231982385703,8.893026294766287,1.4884979702300405,NaN,NaN,NaN,6114599
791130600,46.84375,46.98437,46.75,46.92187,NaN,NaN,44.12945314285714,47.30413744186046,45.947184650000054,46.30593540000005,46.02156060000005,46.417966500000006,46.27805196019734,46.51043005034639,46.67427615384616,47.29285498829554,46.05569731939678,45.947184650000054,46.30593540000005,46.02156060000005,46.417966500000006,46.88541333333333,9800,247615,62.54554761065146,NaN,1.5,2.75,NaN,NaN,0.32502181143308906,0.03957757001797145,NaN,0.03118806079205455,0.24800827422863847,0.21682021343658392,8.869245016145946,0.4012036537563254,NaN,NaN,NaN,6124399
791217000,47.23437,47.23437,46.92187,47.10937,NaN,NaN,44.11829228571428,47.297596744186045,45.95984150000006,46.303904100000054,46.02999800000005,46.4679665,46.31065266764058,46.567471950313404,46.74879538461539,47.32416323391082,46.173427535319966,45.95984150000006,46.303904100000054,46.02999800000005,46.4679665,47.08853666666666,91200,241170,65.7100123879005,NaN,1.5,2.75,NaN,NaN,0.3241273963307255,0.37815648712526434,NaN,0.038181913835370784,0.2645476057307974,0.2263656918954266,6.3757115190597,0.19940181582206085,NaN,NaN,NaN,6215599
791476200,47.01562,47.04687,46.84375,46.90625,NaN,NaN,44.10713142857143,47.29105604651163,45.97140400000006,46.30031040000005,46.03124800000005,46.535154000000006,46.33400942577232,46.59973652647403,46.80528615384616,47.278042357692264,46.33252995000006,45.97140400000006,46.30031040000005,46.03124800000005,46.535154000000006,46.93229,26600,132025,59.8142796229448,NaN,1.5,2.75,NaN,NaN,0.3199482965928165,0.20147699299375119,NaN,0.025537589735351002,0.25828767906461536,0.23275008932926436,6.038037712620951,-0.26578073089701,NaN,NaN,NaN,6188999
791562600,47,47.17187,46.92187,47.09375,NaN,NaN,44.095970571428566,47.28451534883721,45.98390400000006,46.296247900000054,46.04249800000005,46.600779,46.36380317378125,46.6467854287146,46.8749976923077,47.21000422212666,46.53999116248874,45.98390400000006,46.296247900000054,46.04249800000005,46.600779,47.06249666666667,127500,122185,63.10511160641557,NaN,1.5,2.75,NaN,NaN,0.31606770397904377,1.0434996112452428,NaN,0.02611752352741009,0.265396993738527,0.2392794702111169,6.508469202686454,0.23280082291196325,NaN,NaN,NaN,6316499
791649000,47.15625,47.32812,47,47.07812,NaN,NaN,44.08480971428571,47.277974651162786,45.99781025000006,46.29702910000005,46.054685400000054,46.65468500000001,46.391815598338844,46.68786491169416,46.90144000000001,47.24209026034521,46.56078973965481,45.99781025000006,46.29702910000005,46.054685400000054,46.65468500000001,47.13541333333333,380200,123605,62.64457957741227,NaN,1.5,2.75,NaN,NaN,0.3169285822662548,3.0759273492172645,NaN,0.02193295571165596,0.26669566485068685,0.2447627091390309,6.477400203903795,0.7692200668896287,NaN,NaN,NaN,5936299
791735400,47.0625,47.35937,47.0625,47.35937,NaN,NaN,44.07364885714286,47.27143395348837,46.01281025000006,46.302029100000055,46.081872800000056,46.72265350000001,46.42975890820791,46.7518177772471,46.927882307692315,47.34472454636873,46.5110400690159,46.01281025000006,46.302029100000055,46.081872800000056,46.72265350000001,47.26041333333333,131700,125700,67.27287799093895,NaN,1.5,2.75,NaN,NaN,0.3154958263900936,1.0477326968973748,NaN,0.03387765094298123,0.2871097728177574,0.2532321218747762,6.045599684377653,1.7455523862291922,NaN,NaN,NaN,6067999
791821800,47.65625,48.10937,47.57812,48.03125,NaN,NaN,44.062487999999995,47.26489325581395,46.03140400000006,46.31234160000005,46.14249780000006,46.821872500000005,46.49256248043505,46.873668465128326,47.00480538461539,47.72688017863392,46.282730590596856,46.03140400000006,46.31234160000005,46.14249780000006,46.821872500000005,47.90624666666667,405100,123535,75.18324430406948,NaN,1.5,2.75,NaN,NaN,0.34653183879080124,3.279232606144008,NaN,0.08015757511261479,0.35342909076554463,0.27327151565292984,8.650130465182775,2.8781793842034804,NaN,NaN,NaN,6473099
792081000,48.01562,48.375,47.96875,48.23437,NaN,NaN,44.05132714285714,47.258352558139535,46.048044600000054,46.32421660000006,46.20218520000006,46.928903500000004,46.56086865767289,47.00325908749706,47.100959230769234,48.07536133656443,46.12655712497404,46.048044600000054,46.32421660000006,46.20218520000006,46.928903500000004,48.19270666666667,405400,141965,76.99367416329919,NaN,1.5,2.75,NaN,NaN,0.35079742173431544,2.855633430775191,NaN,0.11543422207888032,0.4175642932515302,0.3021300711726499,8.671377527454714,3.175122994652403,NaN,NaN,NaN,6878499
792167400,48.3125,48.3125,48.14062,48.29687,NaN,NaN,44.040166285714285,47.25181186046512,46.06523210000006,46.33077910000006,46.25874760000006,47.036716000000006,46.62894714168572,47.12646012678305,47.222353076923085,48.35620802255833,46.08849813128784,46.06523210000006,46.33077910000006,46.25874760000006,47.036716000000006,48.24999666666666,702900,165620,77.53670216702093,NaN,1.5,2.75,NaN,NaN,0.3380176058961502,4.244052650646057,NaN,0.13272783010900618,0.46803985880890764,0.33531202869990145,8.67487984984413,3.0333226666666633,NaN,NaN,NaN,7581399
792253800,48.23437,48.46875,48.20312,48.29687,NaN,NaN,44.02900542857142,47.245271162790694,46.08007585000006,46.34359160000005,46.31124760000006,47.14296600000001,46.69435588122746,47.237927733756095,47.35696846153847,48.5519605993119,46.161976323765046,46.08007585000006,46.34359160000005,46.31124760000006,47.14296600000001,48.32291333333333,521500,180575,77.53670216702093,NaN,1.5,2.75,NaN,NaN,0.33284706261785385,2.887996677280908,NaN,0.13355234065254085,0.5022524545155775,0.3687001138630367,8.87333915821353,2.9304032426670124,NaN,NaN,NaN,7581399
792340200,48.21875,48.29687,48.125,48.29687,NaN,NaN,44.01784457142857,47.23873046511628,46.09515395000006,46.355935300000056,46.364060000000066,47.24843450000001,46.75719957215971,47.338779378160275,47.48076615384616,48.70576358169839,46.25576872599393,46.09515395000006,46.355935300000056,46.364060000000066,47.24843450000001,48.23958,390700,198095,77.53670216702095,NaN,1.5,2.75,NaN,NaN,0.32134870100229274,1.9722860243822409,NaN,0.12370672494658813,0.5233335200462719,0.39962679509968374,8.973027238454192,2.52072995244895,NaN,NaN,NaN,7581399
792426600,48.23437,48.35937,48.09375,48.35937,NaN,NaN,44.00668371428571,47.23218976744186,46.112185200000056,46.37781030000006,46.419372400000064,47.329684500000006,46.820029785016196,47.43597848500215,47.60456384615385,48.83441061886046,46.37471707344724,46.112185200000056,46.37781030000006,46.419372400000064,47.329684500000006,48.27083,148300,196980,78.17995923651684,NaN,1.5,2.75,NaN,NaN,0.31736807950212886,0.7528683115037059,NaN,0.11139605560571914,0.5388718646068327,0.42747580900111354,8.985395134116468,3.097924050632908,NaN,NaN,NaN,7729699
792685800,48.32812,48.46875,48.32812,48.375,NaN,NaN,43.99552285714285,47.22564906976744,46.12859145000006,46.39984160000005,46.48406000000006,47.397653500000004,46.88100900913321,47.52540910547814,47.71994846153847,48.935733306187196,46.50416361688975,46.12859145000006,46.39984160000005,46.48406000000006,47.397653500000004,48.39062333333334,79700,195710,78.34695050559458,NaN,1.5,2.75,NaN,NaN,0.3047439309662626,0.40723519493127586,NaN,0.09494065598480783,0.5461516289821233,0.4512109729973155,8.01841370492864,2.7206370272063705,NaN,NaN,NaN,7809399
792772200,48.53125,48.53125,48.25,48.4375,NaN,NaN,43.984362,47.219108372093025,46.14390395000006,46.42359160000005,46.54156000000006,47.467966000000004,46.94204787152014,47.612274904956415,47.836535384615395,49.01390924248743,46.65916152674336,46.14390395000006,46.42359160000005,46.54156000000006,47.467966000000004,48.40625,170200,199745,79.03779591365424,NaN,1.5,2.75,NaN,NaN,0.303065793040101,0.8520864101729705,NaN,0.07952478390414564,0.5506169528774976,0.47109216897335193,8.056160577788654,2.8874984812477678,NaN,NaN,NaN,7979599
792858600,48.4375,48.76562,48.39062,48.70312,NaN,NaN,43.973201142857135,47.2125676744186,46.16077895000006,46.451560300000054,46.60343500000006,47.553903500000004,47.011109523617385,47.71616491400818,47.95913153846155,49.14000366503157,46.778259411891526,46.16077895000006,46.451560300000054,46.60343500000006,47.553903500000004,48.61978666666666,431500,217095,81.70877258255905,NaN,1.5,2.75,NaN,NaN,0.3082039506800938,1.987609111218591,NaN,0.07834998384061959,0.5690296487741264,0.49067966493350684,7.914301772239409,2.8373477096506985,NaN,NaN,NaN,8411099
792945000,48.64062,48.6875,48.5,48.64062,NaN,NaN,43.96204028571428,47.206026976744184,46.17773205000006,46.47656030000005,46.663435000000064,47.649997000000006,47.07501189524023,47.804208255531215,48.092544615384625,49.153236847076386,47.031852383692865,46.17773205000006,46.47656030000005,46.663435000000064,47.649997000000006,48.609373333333345,99300,215105,79.15310118262879,NaN,1.5,2.75,NaN,NaN,0.30069795420294415,0.46163501545756724,NaN,0.06504436946902581,0.5719851267697891,0.5069407573007633,8.143181045131497,1.268694860117108,NaN,NaN,NaN,8311799
793031400,48.59375,48.625,48.4375,48.45312,NaN,NaN,43.950879428571426,47.19948627906977,46.19406015000006,46.49999780000005,46.72624740000006,47.745309500000005,47.12905535032885,47.86600937405205,48.19711153846155,49.099544117618734,47.29467895930436,46.19406015000006,46.49999780000005,46.72624740000006,47.745309500000005,48.50520666666667,49100,213625,71.88865330048333,NaN,1.5,2.75,NaN,NaN,0.2937281003313052,0.22984201287302516,NaN,0.03670744074155252,0.5528250582277039,0.5161176174861514,4.747707415655397,0.4535147862405998,NaN,NaN,NaN,8262699
793377000,48.45312,48.53125,48.42187,48.4375,NaN,NaN,43.939718571428564,47.19294558139535,46.21249765000006,46.519685300000056,46.79749740000007,47.83280950000001,47.180366905217916,47.92043705271376,48.30167923076924,48.93662250854408,47.666735952994394,46.21249765000006,46.519685300000056,46.79749740000007,47.83280950000001,48.46354,168000,219340,71.30157203282448,NaN,1.5,2.75,NaN,NaN,0.2805603788790692,0.765934166134768,NaN,0.011319960383588845,0.5302675679656375,0.5189476075820486,4.269106042323916,0.2911782896075907,NaN,NaN,NaN,8094699
793463400,48.48437,48.79687,48.45312,48.79687,NaN,NaN,43.92855771428571,47.186404883720925,46.23468515000006,46.545310300000054,46.872497400000064,47.93515300000001,47.243759183444666,48.00390685721721,48.412256153846165,48.80783169329956,48.01668061439277,46.23468515000006,46.545310300000054,46.872497400000064,47.93515300000001,48.68228666666667,386400,237040,76.13120237252562,NaN,1.5,2.75,NaN,NaN,0.28618963753056414,1.6301046236922039,NaN,0.013017176069991532,0.535219077669538,0.5222019015995465,5.859136174478231,1.0352637758927234,NaN,NaN,NaN,8481099
793549800,48.98437,49.15625,48.85937,48.875,NaN,NaN,43.917396857142855,47.17986418604651,46.25554455000006,46.57234160000005,46.943122400000064,48.03515300000001,47.30772941154488,48.08686810891081,48.47716000000001,48.87822150757345,48.076098492426574,46.25554455000006,46.57234160000005,46.943122400000064,48.03515300000001,48.96354,402800,256395,77.03602516847847,NaN,1.5,2.75,NaN,NaN,0.29141752056409537,1.5710134753017804,NaN,0.013623835119004113,0.5392316954983016,0.5256078603792975,5.828157432692061,1.1970340935137238,NaN,NaN,NaN,8883899
793636200,48.9375,49.01562,48.8125,49,NaN,NaN,43.90623599999999,47.17332348837209,46.27906020000006,46.60171660000005,47.012810000000066,48.13905950000001,47.37409296403331,48.1738330509193,48.53605461538462,48.997519433248485,48.07458979752076,46.27906020000006,46.60171660000005,47.012810000000066,48.13905950000001,48.94270666666667,307600,271285,78.4439487128061,NaN,1.5,2.75,NaN,NaN,0.285110554809517,1.1338629116980297,NaN,0.01647523475256063,0.5462019038199983,0.5297266690674377,5.82167510634117,1.324727762168948,NaN,NaN,NaN,9191499
793895400,48.85937,49,48.53125,48.60937,NaN,NaN,43.89507514285714,47.166782790697674,46.29952895000006,46.63406030000006,47.06999740000006,48.214059500000005,47.42253520073788,48.21531276035556,48.56009307692308,49.001329321011056,48.11885683283511,46.29952895000006,46.63406030000006,47.06999740000006,48.214059500000005,48.71354,280900,280770,65.02668673641995,NaN,1.5,2.75,NaN,NaN,0.2982276580374087,1.0004630124301028,NaN,-0.012359733170747011,0.514277002604004,0.526636735774751,7.957343913297419,0.4844857881136918,NaN,NaN,NaN,8910599
793981800,48.5625,49.01562,48.5625,49.01562,NaN,NaN,43.88391428571428,47.16024209302326,46.32202895000006,46.670310300000054,47.13249740000006,48.319528000000005,47.48500911443443,48.29153249746455,48.61538153846155,49.08971359766344,48.14104947925966,46.32202895000006,46.670310300000054,47.13249740000006,48.319528000000005,48.86458,493500,304115,70.64926921839609,NaN,1.5,2.75,NaN,NaN,0.30929139674902223,1.6227413971688343,NaN,-0.00866033547064815,0.5158113164364408,0.524471651907089,9.122334906706232,1.1935380645161258,NaN,NaN,NaN,9404099
794068200,48.96875,49.03125,48.65625,48.70312,NaN,NaN,43.87275342857142,47.15370139534883,46.342888300000055,46.70484150000006,47.19155980000007,48.39999650000001,47.532778168770335,48.33073130722983,48.64663153846155,49.085081099723915,48.20818197719918,46.342888300000055,46.70484150000006,47.19155980000007,48.39999650000001,48.79687333333334,237900,309635,62.34600229308596,NaN,1.5,2.75,NaN,NaN,0.31398486840980633,0.7683239943804803,NaN,-0.0306121634462021,0.4862064475993364,0.5168186110455385,10.13733574050899,0,NaN,NaN,NaN,9166199
794154600,48.6875,48.76562,48.54687,48.76562,NaN,NaN,43.86159257142857,47.147160697674416,46.36077890000006,46.737966500000056,47.25062220000007,48.48437150000001,47.58112490724993,48.37214927796985,48.67788153846155,49.086901871884955,48.26886120503814,46.36077890000006,46.737966500000056,47.25062220000007,48.48437150000001,48.69270333333333,488600,315055,63.27563271338264,NaN,1.5,2.75,NaN,NaN,0.30718237780910584,1.5508403294662836,NaN,-0.043489536387961936,0.462456690560586,0.505946226948548,9.66856802966713,0.2569868558418869,NaN,NaN,NaN,9654799
794241000,48.60937,48.78125,48.48437,48.78125,NaN,NaN,43.85043171428571,47.14062,46.377107050000056,46.76640400000006,47.31280980000007,48.55546550000001,47.62818863637738,48.41111125149653,48.70913153846155,49.08122325906101,48.337039817862085,46.377107050000056,46.76640400000006,47.31280980000007,48.55546550000001,48.68229,290000,322970,63.518203832264994,NaN,1.5,2.75,NaN,NaN,0.30644649367988414,0.8979162151283401,NaN,-0.052896176000168715,0.43982600694833707,0.4927221829485058,9.626662732492859,0.6772112920695336,NaN,NaN,NaN,9944799
794500200,48.45312,48.8125,48.39062,48.8125,NaN,NaN,43.83927085714285,47.13407930232558,46.39249770000006,46.78827900000006,47.36593480000007,48.59452800000001,47.674632219264545,48.449338751354,48.7379776923077,49.078137766036356,48.39781761857905,46.39249770000006,46.78827900000006,47.36593480000007,48.59452800000001,48.67187333333334,85700,307000,64.02977220229332,NaN,1.5,2.75,NaN,NaN,0.3146917441313211,0.2791530944625407,NaN,-0.058516922614752054,0.4195760296800657,0.47809295229481774,9.256817978897383,0.7741935483870968,NaN,NaN,NaN,10030499
794586600,48.64062,48.75,48.21875,48.4375,NaN,NaN,48.21875,47.127538604651164,46.40687270000006,46.80577900000006,47.41437240000007,48.604684500000005,47.7045486028228,48.44821125122505,48.71754538461539,49.09363800884817,48.341452760382616,46.40687270000006,46.80577900000006,47.41437240000007,48.604684500000005,48.46875,180900,295775,54.2067184935942,NaN,1.5,2.75,NaN,NaN,0.3346244766933696,0.6116135576029076,NaN,-0.08726265004050504,0.36901463974418647,0.4562772897846915,10.457195818338489,-0.7364611705627808,NaN,NaN,NaN,9849599
794673000,48.51562,48.625,48.34375,48.5625,NaN,NaN,48.27031257142857,47.12099790697674,46.42226335000006,46.82296650000006,47.464372400000066,48.61796600000001,47.73819375565328,48.45909589396552,48.71153615384616,49.09478161320994,48.328290694482384,46.42226335000006,46.82296650000006,47.464372400000066,48.61796600000001,48.510416666666664,155900,268425,56.59699315585256,NaN,1.5,2.75,NaN,NaN,0.3308120140724146,0.5807953804600913,NaN,-0.09688804776196003,0.3351672300822415,0.4320552778442015,9.538760315234864,-0.639386189258312,NaN,NaN,NaN,10005499
794759400,48.54687,48.59375,48.42187,48.54687,NaN,NaN,48.321875142857145,47.11445720930232,46.43663835000006,46.83796650000006,47.50905980000007,48.630466000000006,47.769906549549226,48.46745533263547,48.7187476923077,49.08544206046203,48.352053324153374,46.43663835000006,46.83796650000006,47.50905980000007,48.630466000000006,48.52083,63500,245525,56.201962164499996,NaN,1.5,2.75,NaN,NaN,0.3194597273529566,0.2586294674676713,NaN,-0.10277846459672058,0.3035821970983008,0.4063606616950214,9.448879731664327,-0.9247551020408196,NaN,NaN,NaN,9941999
794845800,48.59375,49.39062,48.53125,49.26562,NaN,NaN,48.373437714285714,47.107916511627906,46.453982100000054,46.86109150000006,47.572809800000066,48.678903500000004,47.82856197897867,48.543471015241614,48.78244923076924,49.21362901025749,48.351269451280984,46.453982100000054,46.86109150000006,47.572809800000066,48.678903500000004,49.06249666666666,192100,235595,67.45222517440456,NaN,1.5,2.75,NaN,NaN,0.35802474682774527,0.8153823298457098,NaN,-0.0589184135211977,0.33271264479352425,0.39163105831472195,12.896799870246376,1.3500483548747906,NaN,NaN,NaN,10134099
795105000,49.23437,49.39062,49.17187,49.21875,NaN,NaN,48.42500028571428,47.10137581395349,46.47093525000005,46.88484150000006,47.63499740000007,48.7218725,47.883079156273624,48.60778329950432,48.81490153846154,49.305015004243174,48.32478807267991,46.47093525000005,46.88484150000006,47.63499740000007,48.7218725,49.260413333333325,261300,241245,66.25702206896472,NaN,1.5,2.75,NaN,NaN,0.3480765506257635,1.0831312566063545,NaN,-0.03490074212861577,0.3480051306539522,0.382905872782568,11.776096098026155,0.4144189138074793,NaN,NaN,NaN,9872799
795191400,49.35937,49.64062,49.35937,49.57812,NaN,NaN,48.47656285714286,47.09483511627907,46.489450850000054,46.909997700000055,47.71530980000007,48.7820285,47.94955134622368,48.70019631859915,48.8689876923077,49.50666327146424,48.231312113151155,46.489450850000054,46.909997700000055,47.71530980000007,48.7820285,49.52603666666666,223300,248425,70.56385404555645,NaN,1.5,2.75,NaN,NaN,0.3533475112953517,0.8988628358659555,NaN,0.0014258976680516233,0.38468824486763253,0.3832623471995809,11.559595238941933,1.7965994786370976,NaN,NaN,NaN,10096099
795277800,49.5,49.57812,49.29687,49.48437,NaN,NaN,48.52812542857143,47.08829441860465,46.50781020000006,46.93734140000006,47.789372200000074,48.834371999999995,48.009740313038435,48.77487952635161,48.90624692307693,49.62201050137691,48.19048334477694,46.50781020000006,46.93734140000006,47.789372200000074,48.834371999999995,49.45311999999999,278500,253840,68.12115119233161,NaN,1.5,2.75,NaN,NaN,0.34819768905996945,1.0971478096438703,NaN,0.014642948172714276,0.40156603241547373,0.38692308424275945,10.747523524020929,1.4738867259351978,NaN,NaN,NaN,9817599
795364200,49.4375,49.8125,49.4375,49.78125,NaN,NaN,48.579688,47.08175372093023,46.526638350000056,46.96952890000006,47.86499720000007,48.8882785,48.07921128115458,48.87072433336574,48.996391538461545,49.8260138214436,48.16676925547949,46.526638350000056,46.96952890000006,47.86499720000007,48.8882785,49.677083333333336,20400,233285,71.48721493088374,NaN,1.5,2.75,NaN,NaN,0.35011213984140016,0.08744668538482972,NaN,0.03757821596493638,0.43389585419892995,0.3963176382339936,11.031922581011948,2.0499679692504804,NaN,NaN,NaN,9837999
795450600,49.4375,49.625,49.40625,49.5625,NaN,NaN,48.63125057142857,47.07521302325581,46.54460710000006,47.003435200000055,47.93624720000007,48.9343725,48.13737946620734,48.93660773018805,49.038459230769234,49.921459493384994,48.155458968153475,46.54460710000006,47.003435200000055,47.93624720000007,48.9343725,49.53125,89900,232815,65.96063639236776,NaN,1.5,2.75,NaN,NaN,0.351889844138443,0.38614350449928053,NaN,0.032410419093675036,0.43683066210108734,0.4044202430074123,11.620630773375089,1.5364916773367479,NaN,NaN,NaN,9748099
795709800,49.625,49.625,49.46875,49.5625,NaN,NaN,48.68281314285714,47.068672325581396,46.56124775000006,47.03687270000006,48.00655980000007,48.9898415,48.193266545963915,48.996216517789186,49.10456538461539,50.00573501415539,48.20339575507539,46.56124775000006,47.03687270000006,48.00655980000007,48.9898415,49.552083333333336,91700,234945,65.96063639236776,NaN,1.5,2.75,NaN,NaN,0.33791556955712565,0.390304113728745,NaN,0.023785314248586875,0.4341518858181459,0.410366571569559,11.645478939398512,2.3225806451612905,NaN,NaN,NaN,9748099
795796200,49.5625,49.875,49.35937,49.4375,NaN,NaN,48.73437571428571,47.06213162790697,46.57734150000006,47.067341500000055,48.073434800000065,49.03984149999999,48.24206001474965,49.03824351609498,49.15624846153847,50.05077600121992,48.26172092185701,46.57734150000006,47.067341500000055,48.073434800000065,49.03984149999999,49.55729,104400,231765,62.74590512013973,NaN,1.5,2.75,NaN,NaN,0.3506094574459025,0.4504562811468513,NaN,0.005413958473328151,0.4171340196612192,0.41172006118789106,10.463278067246932,1.8018018018018018,NaN,NaN,NaN,9643699
795882600,49.53125,49.53125,49.32812,49.48437,NaN,NaN,48.78593828571429,47.055590930232555,46.593982100000055,47.09546650000006,48.14030980000007,49.074216499999984,48.290778053386916,49.080731752657364,49.21033461538462,50.092568541962635,48.3281006888066,46.593982100000055,47.09546650000006,48.14030980000007,49.074216499999984,49.44791333333333,74900,216190,63.464922672999435,NaN,1.5,2.75,NaN,NaN,0.340075210485481,0.3464545076090476,NaN,-0.007147099367891485,0.4027861869780267,0.4099332863459182,10.474615853303849,1.931123468928069,NaN,NaN,NaN,9718599
795969000,49.42187,49.65625,49.35937,49.51562,NaN,NaN,48.83750085714286,47.04905023255814,46.61265395000006,47.11406020000006,48.20718480000007,49.10624749999998,48.33881107090115,49.12214968097571,49.264420769230775,50.12848843169646,48.40035310676509,46.61265395000006,47.11406020000006,48.20718480000007,49.10624749999998,49.51041333333334,220500,207075,63.96431062724243,NaN,1.5,2.75,NaN,NaN,0.33698983830794677,1.0648315827598696,NaN,-0.016388445843693922,0.38944772904130076,0.4058361748849947,10.415541376849683,0.5074532706581182,NaN,NaN,NaN,9939099
796055400,49.67187,50.21875,49.67187,50.21875,NaN,NaN,48.889063428571426,47.04250953488372,46.63359145000006,47.14140400000006,48.28780980000007,49.16718499999998,48.41253416615993,49.226587806597074,49.40144000000001,50.262454218517924,48.54042578148209,46.63359145000006,47.14140400000006,48.28780980000007,49.16718499999998,50.03645666666667,134000,198395,72.9300448035855,NaN,1.5,2.75,NaN,NaN,0.3631427070002364,0.6754202474860758,NaN,0.019850549652649097,0.43064936195080605,0.41079881229815696,10.151918585947987,2.0317460317460316,NaN,NaN,NaN,10073099
796314600,50.29687,50.42187,50.17187,50.42187,NaN,NaN,48.940626,47.0359688372093,46.655153950000056,47.176091500000055,48.361559800000066,49.25780999999998,48.491331649839935,49.34042420596878,49.54446846153847,50.41816741609182,48.670769506985124,46.655153950000056,47.176091500000055,48.361559800000066,49.25780999999998,50.33853666666666,132100,190955,74.87479731407637,NaN,1.5,2.75,NaN,NaN,0.3550610850716481,0.6917860228849729,NaN,0.05074132086698774,0.47422546338189164,0.4234841425149039,10.039514529254799,1.7018596106508275,NaN,NaN,NaN,10205199
796401000,50.29687,50.42187,50.23437,50.42187,NaN,NaN,48.99218857142857,47.02942813953488,46.67640395000006,47.213435200000056,48.42968480000007,49.32812249999998,48.567039036120725,49.44341904349556,49.68869923076924,50.470233251344546,48.90716521019393,46.67640395000006,47.213435200000056,48.42968480000007,49.32812249999998,50.35936999999999,121900,172375,74.87479731407637,NaN,1.5,2.75,NaN,NaN,0.3430924361379589,0.7071791153009427,NaN,0.06358228983323583,0.5029620048064487,0.4393797149732129,9.610829003733347,1.8945376085418488,NaN,NaN,NaN,10205199
796487400,50.375,50.89062,50.125,50.40625,NaN,NaN,49.04375114285714,47.02288744186046,46.69577895000006,47.24812270000006,48.49718480000007,49.413278999999974,48.63916495627285,49.53511722982932,49.77644000000001,50.603090042147095,48.94978995785292,46.69577895000006,47.24812270000006,48.49718480000007,49.413278999999974,50.47395666666667,246100,172785,74.39810692352705,NaN,1.5,2.75,NaN,NaN,0.37327297641381885,1.4243134531353996,NaN,0.06329509881251805,0.5184985884888604,0.4552034896763424,9.436843572472233,1.2554927809165097,NaN,NaN,NaN,9959099
796573800,50.51562,50.51562,50.10937,50.3125,NaN,NaN,49.095313714285716,47.016346744186045,46.71562270000006,47.28796650000006,48.56374740000007,49.490622999999964,48.7047859383798,49.609153684131286,49.86057461538462,50.66540778519907,49.05574144557017,46.71562270000006,47.28796650000006,48.56374740000007,49.490622999999964,50.31249666666667,298400,163275,71.45758772773667,NaN,1.5,2.75,NaN,NaN,0.37562847809854605,1.827591486755474,NaN,0.04966415006701419,0.5172836772601102,0.46761952719309596,9.25109185698026,1.5132408575031526,NaN,NaN,NaN,9660699
796660200,49.92187,50.17187,49.54687,50.10937,NaN,NaN,49.146876285714285,47.00980604651163,46.73398205000006,47.324372700000055,48.63155980000007,49.557028999999964,48.759867666286475,49.65679333326164,49.90144000000001,50.69866927878389,49.10421072121613,46.73398205000006,47.324372700000055,48.63155980000007,49.557028999999964,49.94270333333333,541300,175840,65.4238591795174,NaN,1.5,2.75,NaN,NaN,0.4034857296629357,3.07836669699727,NaN,0.021290578636073143,0.4942327504881874,0.47294217185211423,9.175787877998241,1.1033947036569955,NaN,NaN,NaN,9119399
796915800,50.09375,50.23437,50.0625,50.23437,NaN,NaN,49.19843885714286,47.00326534883721,46.75577890000006,47.35843520000006,48.705309800000066,49.62812249999996,48.81769128721642,49.71180063485577,49.959132307692315,50.735562594584785,49.182702020799844,46.75577890000006,47.35843520000006,48.705309800000066,49.62812249999996,50.17708,193300,181220,67.2561235534902,NaN,1.5,2.75,NaN,NaN,0.38694174897272593,1.066659309127028,NaN,0.006055970910606112,0.48051213549037186,0.47445616457976575,9.178145803204771,1.6118735777496807,NaN,NaN,NaN,9312699
797002200,50.25,50.5625,50.25,50.5625,NaN,NaN,49.25000142857143,46.996724651162786,46.78116955000006,47.39499770000006,48.78280980000007,49.734372499999964,48.88611515830597,49.79281962201237,50.01922846153847,50.85029881963736,49.18815810343958,46.78116955000006,47.39499770000006,48.78280980000007,49.734372499999964,50.458333333333336,66900,175520,71.52228568911174,NaN,1.5,2.75,NaN,NaN,0.3827409097603885,0.3811531449407475,NaN,0.012804713671253187,0.49046205666883225,0.47765734299757906,9.247756256086783,2.178728354023708,NaN,NaN,NaN,9379599
797088600,50.45312,50.60937,50.42187,50.5625,NaN,NaN,49.301564,46.99018395348837,46.80851330000006,47.434841500000054,48.85905980000007,49.83437249999996,48.95185574033319,49.866122515154046,50.09615153846154,50.92900082861578,49.263302248307305,46.80851330000006,47.434841500000054,48.85905980000007,49.83437249999996,50.53124666666667,107200,173085,71.52228568911175,NaN,1.5,2.75,NaN,NaN,0.3687951304917893,0.6193488748302857,NaN,0.012008739819966086,0.4926682677725367,0.4806595279525706,9.312195437145606,2.1142419301222555,NaN,NaN,NaN,9379599
797175000,50.6875,50.79687,50.59375,50.75,NaN,NaN,49.353126571428575,46.98364325581395,46.83593520000006,47.47827900000006,48.93655980000007,49.94452899999996,49.02237120149659,49.95030132323461,50.1874976923077,51.026651770728556,49.34834361388685,46.83593520000006,47.47827900000006,48.93655980000007,49.94452899999996,50.71354,352500,187535,73.78572961000081,NaN,1.5,2.75,NaN,NaN,0.3591933354566614,1.8796491321619964,NaN,0.01846405164498971,0.5037395925088077,0.485275540863818,9.295035317994003,1.057871810827629,NaN,NaN,NaN,9732099
797261400,50.85937,50.85937,50.46875,50.70312,NaN,NaN,49.404689142857144,46.977102558139535,46.86445080000006,47.51687270000006,49.01218480000007,50.01640399999996,49.08828291908496,50.02199834006941,50.284853076923085,51.043138287658685,49.526567866187484,46.86445080000006,47.51687270000006,49.01218480000007,50.01640399999996,50.67708,361400,196000,72.23972178037336,NaN,1.5,2.75,NaN,NaN,0.3614380972097569,1.8438775510204082,NaN,0.01412626338422407,0.5029333700940981,0.48880710670987404,5.736562114332076,0.5577936716746127,NaN,NaN,NaN,9370699
797520600,50.625,50.79687,50.59375,50.79687,NaN,NaN,49.45625171428571,46.97056186046512,46.89812265000006,47.55796640000006,49.08593480000007,50.09530999999996,49.155286334022804,50.09579564101518,50.385814615384625,51.03213310117778,49.73949612959147,46.89812265000006,47.55796640000006,49.08593480000007,50.09530999999996,50.72916333333333,285400,197205,73.43829248870668,NaN,1.5,2.75,NaN,NaN,0.3501296616947741,1.4472249689409498,NaN,0.012193444566250544,0.5040489124176872,0.4918554678514367,5.437428400186154,0.7437248955661502,NaN,NaN,NaN,9656099
797607000,50.92187,50.9375,50.59375,50.625,NaN,NaN,49.50781428571429,46.964021162790694,46.92710705000006,47.595778900000056,49.16030980000007,50.14765399999996,49.212922164061126,50.14619605615659,50.47115153846154,50.887329960020466,50.054973116902616,46.92710705000006,47.595778900000056,49.16030980000007,50.14765399999996,50.71875,250300,198555,67.66997268143842,NaN,1.5,2.75,NaN,NaN,0.3496739715737188,1.2606078920198434,NaN,-0.005109703630608808,0.4854683383131757,0.4905780419437845,5.930623070530364,0.4339739615623063,NaN,NaN,NaN,9405799
797693400,50.78125,50.79687,50.60937,50.79687,NaN,NaN,49.55937685714286,46.95748046511628,46.95804455000006,47.63843510000006,49.234372200000074,50.21327899999996,49.27503776547049,50.20816500318929,50.51562230769231,50.93792045020945,50.093324165175176,46.95804455000006,47.63843510000006,49.234372200000074,50.21327899999996,50.73436999999999,144400,191850,70.1914351628013,NaN,1.5,2.75,NaN,NaN,0.3380901164613103,0.7526713578316393,NaN,-0.009191287079971633,0.47908893309381995,0.4882802201737916,6.143682196630706,0.9627229813664565,NaN,NaN,NaN,9550199
797779800,50.89062,51.09375,50.85937,51.07812,NaN,NaN,49.61093942857143,46.95093976744186,46.98968515000006,47.68452880000006,49.31437220000007,50.27812249999996,49.34574687270695,50.29101786002841,50.566103076923085,51.07873647349373,50.05346968035244,46.98968515000006,47.68452880000006,49.31437220000007,50.27812249999996,51.01041333333333,243400,203000,73.79336199180705,NaN,1.5,2.75,NaN,NaN,0.33514653671407396,1.199014778325123,NaN,0.0022294383298743226,0.4910670180861345,0.4888375797562602,6.438738348391859,1.9332711626588002,NaN,NaN,NaN,9793599
798125400,51.26562,51.3125,50.625,50.78125,NaN,NaN,49.662502,46.94439906976744,47.021247650000056,47.73234130000006,49.38280980000007,50.33905999999996,49.40204111299295,50.3377066352638,50.5937476923077,51.11102677003269,50.076468614582716,47.021247650000056,47.73234130000006,49.38280980000007,50.33905999999996,50.90625,178900,207450,64.88141496296723,NaN,1.5,2.75,NaN,NaN,0.36031464123449725,0.8623764762593396,NaN,-0.014131331841988337,0.47117341495377474,0.4853047467957631,7.052350690636544,1.0886570290420714,NaN,NaN,NaN,9614699
798211800,50.82812,50.82812,50.48437,50.60937,NaN,NaN,49.71406457142857,46.93785837209302,47.05148200000006,47.788435000000064,49.43437220000007,50.39140349999995,49.44938734385597,50.36357933666725,50.60937230769231,51.11519755688065,50.10354705850397,47.05148200000006,47.788435000000064,49.43437220000007,50.39140349999995,50.64061999999999,329500,219340,60.3379268175029,NaN,1.5,2.75,NaN,NaN,0.35913145257489026,1.5022339746512263,NaN,-0.03903856865584948,0.43650653597595124,0.4755451046318007,7.491456980218398,0.09269715698392764,NaN,NaN,NaN,9285199
798298200,50.60937,50.71875,50.29687,50.5625,NaN,NaN,49.76562714285714,46.9313176744186,47.08031015000006,47.841560000000065,49.48093480000007,50.44765349999996,49.4930388205675,50.38252416174656,50.628603076923085,51.10603160485318,50.15117454899299,47.08031015000006,47.841560000000065,49.48093480000007,50.44765349999996,50.52604,223000,225270,59.122095852842065,NaN,1.5,2.75,NaN,NaN,0.3636134916766839,0.9899232032671905,NaN,-0.059930063728792726,0.4006325249708098,0.46056258869960254,6.556061763278622,0,NaN,NaN,NaN,9062199
798384600,50.70312,50.78125,50.4375,50.64062,NaN,NaN,49.81718971428572,46.924776976744184,47.10984140000006,47.89327870000007,49.52780980000007,50.50546599999995,49.538042004074654,50.40710471777069,50.66946846153847,51.04141973227318,50.29751719080377,47.10984140000006,47.89327870000007,49.52780980000007,50.50546599999995,50.61979,207900,231920,60.548993646285034,NaN,1.5,2.75,NaN,NaN,0.362194670842635,0.8964298033804761,NaN,-0.06909624044467949,0.37419228814375316,0.44328852858843265,6.615503953164979,-0.21552709359606223,NaN,NaN,NaN,9270099
798471000,50.65625,50.90625,50.65625,50.89062,NaN,NaN,49.86875228571429,46.91823627906977,47.13968515000006,47.94546620000006,49.57968480000007,50.57421599999995,49.59108427842467,50.45315379226872,50.71994923076924,51.01141740149172,50.42848106004676,47.13968515000006,47.94546620000006,49.57968480000007,50.57421599999995,50.81770666666667,145000,228145,64.78532905214976,NaN,1.5,2.75,NaN,NaN,0.35529719435387547,0.6355607179644525,NaN,-0.05930624427600162,0.3691557232434306,0.4284619675194322,6.8864802972686014,0.36979972830074365,NaN,NaN,NaN,9415099
798730200,50.85937,51.48437,50.85937,51.48437,NaN,NaN,49.920314857142856,46.91169558139535,47.17257575000006,48.003747400000066,49.643434800000065,50.637496999999954,49.665330777309975,50.5513648596717,50.790862307692315,51.2776968937911,50.30402772159353,47.17257575000006,48.003747400000066,49.643434800000065,50.637496999999954,51.276036666666656,169000,229895,72.37307933047593,NaN,1.5,2.75,NaN,NaN,0.3745616804714558,0.7351182061375845,NaN,-0.01607560109730466,0.4083674661478014,0.42444306724510605,9.37916116925609,1.3534298471539683,NaN,NaN,NaN,9584099
798816600,51.40625,51.48437,51.3125,51.34375,NaN,NaN,49.97187742857143,46.905154883720925,47.20554450000006,48.06124740000006,49.70312240000007,50.68359099999995,49.731151138984096,50.62683011113154,50.85095846153847,51.399203509992105,50.30271341308483,47.20554450000006,48.06124740000006,49.70312240000007,50.68359099999995,51.38020666666667,293200,237950,68.6029163294022,NaN,1.5,2.75,NaN,NaN,0.3600837032949232,1.2321916368985082,NaN,-0.0009803682075005815,0.4232176069857303,0.4241979751932309,9.6851441313353,1.4197530864197532,NaN,NaN,NaN,9290899
798903000,51.25,51.42187,51.125,51.39062,NaN,NaN,50.02344,46.89861418604651,47.23843510000006,48.12374740000006,49.76343480000007,50.73202849999995,49.796228349220016,50.69957200530949,50.90023692307693,51.51451179386189,50.28596205229197,47.23843510000006,48.12374740000006,49.76343480000007,50.73202849999995,51.31249666666667,204400,242075,69.17923023719263,NaN,1.5,2.75,NaN,NaN,0.35556843877385713,0.8443664153671383,NaN,0.007656225781545067,0.43376825742016223,0.42611203163861716,9.266883809495194,1.1688712316329728,NaN,NaN,NaN,9495299
798989400,51.3125,51.54687,51.28125,51.51562,NaN,NaN,50.07500257142857,46.89207348837209,47.27156010000006,48.183278600000065,49.82499720000007,50.78749699999995,49.86365547278002,50.77729086194668,50.96273692307693,51.645580357067615,50.27989348908625,47.27156010000006,48.183278600000065,49.82499720000007,50.78749699999995,51.44791333333334,502200,254880,70.72270820282552,NaN,1.5,2.75,NaN,NaN,0.3491435502900101,1.9703389830508475,NaN,0.01676054949085687,0.44706271850218826,0.4303021690113314,9.211664824149238,0.8565311330957365,NaN,NaN,NaN,9997499
799075800,51.5,51.67187,51.17187,51.59375,NaN,NaN,50.126565142857146,46.885532790697674,47.30265385000006,48.24312240000007,49.88280980000007,50.85155949999995,49.93150231698472,50.85504887509462,51.024035384615395,51.775897156672805,50.272173612557985,47.30265385000006,48.24312240000007,49.88280980000007,50.85155949999995,51.47916333333333,130800,246500,71.67744120371795,NaN,1.5,2.75,NaN,NaN,0.3599190109835808,0.5306288032454362,NaN,0.022651438848631467,0.4586164675721207,0.43596502872348925,8.836767968962345,1.6,NaN,NaN,NaN,10128299
799335000,51.54687,51.65625,51.45312,51.45312,NaN,NaN,50.178127714285715,46.87899209302326,47.33296635000006,48.301247400000065,49.93905980000007,50.91874699999995,49.991173598671594,50.91200802984751,51.08773692307693,51.8338745170829,50.34159932907097,47.33296635000006,48.301247400000065,49.93905980000007,50.91874699999995,51.52083,518700,245370,67.41597831884968,NaN,1.5,2.75,NaN,NaN,0.34871979591332514,2.1139503606797896,NaN,0.012207020307270666,0.45122380410757756,0.4390167838003069,8.11063619228614,1.6671813934850406,NaN,NaN,NaN,9609599
799421400,51.5,51.64062,51.39062,51.5625,NaN,NaN,50.229690285714284,46.87245139534883,47.36343510000006,48.363747400000065,50.00124740000007,50.98515349999994,50.052794241860944,50.97395964605251,51.14663153846155,51.912248269801275,50.38101480712182,47.36343510000006,48.363747400000065,50.00124740000007,50.98515349999994,51.53124666666667,228400,247125,68.96165752213693,NaN,1.5,2.75,NaN,NaN,0.3416683819195162,0.9242286292362165,NaN,0.007998692783290573,0.44901514977942014,0.44101645699612957,7.538710838584679,1.9777503090234858,NaN,NaN,NaN,9837999
799507800,51.73437,52.28125,51.73437,52.28125,NaN,NaN,50.28125285714286,46.865910697674416,47.39796635000006,48.43780990000007,50.07812240000007,51.07109099999993,50.14018466374875,51.098463489285606,51.239180000000005,52.212100516097166,50.26625948390284,47.39796635000006,48.43780990000007,50.07812240000007,51.07109099999993,52.09895666666667,724700,280015,76.76232779139858,NaN,1.5,2.75,NaN,NaN,0.36860278321097933,2.588075638805064,NaN,0.04678997294034393,0.49950392317155945,0.4527139502312155,9.918955248078676,3.2397510141068606,NaN,NaN,NaN,10562699
799594200,52.34375,52.6875,52.125,52.25,NaN,NaN,50.33281542857143,46.85937,47.43335700000006,48.50984120000007,50.147185000000064,51.15546599999993,50.22292252007232,51.208133633163165,51.35216076923078,52.42238479427245,50.2819367441891,47.43335700000006,48.50984120000007,50.147185000000064,51.15546599999993,52.354166666666664,311400,290225,75.86952078797238,NaN,1.5,2.75,NaN,NaN,0.3824525844101951,1.072960633990869,NaN,0.06252917946942926,0.5308754245680021,0.4683462450985728,10.134351562532105,2.6711798755841483,NaN,NaN,NaN,10251299
799680600,52.46875,52.46875,52.07812,52.1875,NaN,NaN,50.384378,46.85282930232558,47.46796640000006,48.57827870000006,50.21343500000006,51.22734099999993,50.29996477418713,51.30140662048096,51.47355538461539,52.53721528927119,50.40989547995959,47.46796640000006,48.57827870000006,50.21343500000006,51.22734099999993,52.24479,314900,288345,74.01536585278019,NaN,1.5,2.75,NaN,NaN,0.3830366855237527,1.0920945395273023,NaN,0.060857898984659264,0.5444186188293969,0.48356071984473764,10.343549346745949,1.3657154588858746,NaN,NaN,NaN,9936399
799939800,52.14062,52.73437,52.09375,52.5625,NaN,NaN,50.435940571428574,46.846288604651164,47.50406015000006,48.64874750000006,50.28468500000006,51.320309999999935,50.38869164578764,51.42151075186373,51.62740153846154,52.69799395970143,50.556809117221654,47.50406015000006,48.64874750000006,50.28468500000006,51.320309999999935,52.46354,183100,279430,77.55905596579095,NaN,1.5,2.75,NaN,NaN,0.40143549370062737,0.6552624986579824,NaN,0.07614319427961624,0.578739712694258,0.5025965184146417,9.166544201989083,2.373706634205721,NaN,NaN,NaN,10119499
800026200,52.78125,52.84375,52.4375,52.51562,NaN,NaN,50.48750314285714,46.83974790697674,47.53960700000006,48.716403700000065,50.36281000000006,51.406247499999935,50.47210060085479,51.52571163263861,51.771632307692315,52.77467505834351,50.76858955704112,47.53960700000006,48.716403700000065,50.36281000000006,51.406247499999935,52.59895666666667,180600,274190,76.16072106842633,NaN,1.5,2.75,NaN,NaN,0.4017793870077254,0.6586673474597906,NaN,0.07415832057938565,0.5952944191388738,0.5211360985594882,8.869830342361844,2.189115445581314,NaN,NaN,NaN,9938899
800112600,52.65625,52.67187,52.32812,52.57812,NaN,NaN,50.53906571428571,46.83320720930232,47.57570075000006,48.78327870000007,50.434060000000066,51.503903499999936,50.5546895968997,51.62594100095874,51.90144000000001,52.85012284391418,50.95275715608584,47.57570075000006,48.78327870000007,50.434060000000066,51.503903499999936,52.52603666666666,330300,278190,76.762241000685,NaN,1.5,2.75,NaN,NaN,0.3976344307928879,1.1873180200582336,NaN,0.06826424414604715,0.6064664037420471,0.5382021595959999,8.855918637495648,2.0624812435529263,NaN,NaN,NaN,10269199
800199000,52.65625,52.71875,52.48437,52.71875,NaN,NaN,50.59062828571429,46.826666511627906,47.61249765000006,48.85296620000006,50.51437260000006,51.59999749999994,50.63955471074677,51.73001804848648,51.99639230769231,53.004335868570486,50.988448746814136,47.61249765000006,48.85296620000006,50.51437260000006,51.59999749999994,52.64062333333334,351700,288555,78.1011784688196,NaN,1.5,2.75,NaN,NaN,0.38597340002196745,1.21883176517475,NaN,0.06505941845279939,0.6195264326619991,0.5544670142091997,8.85844608050231,2.180496668685645,NaN,NaN,NaN,10620899
800285400,52.51562,52.875,52.5,52.75,NaN,NaN,50.64219085714286,46.82012581395349,47.64898205000006,48.92234120000006,50.59406020000006,51.68359149999994,50.722317271109645,51.82715918672586,52.10456538461539,53.11096068910407,51.098170080126714,47.64898205000006,48.92234120000006,50.59406020000006,51.68359149999994,52.70833333333334,94600,281115,78.39902742695133,NaN,1.5,2.75,NaN,NaN,0.38518958573468404,0.33651708375575834,NaN,0.05657950563936687,0.6251913962584084,0.5686118906190415,8.904279621845394,2.520507988631208,NaN,NaN,NaN,10715499
800544600,52.89062,53,52.78125,53,NaN,NaN,50.693753428571426,46.81358511627907,47.68445080000006,48.99562250000006,50.67843520000006,51.79452899999994,50.811638162438676,51.938858311799585,52.22836384615385,53.24885373968621,51.20787395262148,47.68445080000006,48.99562250000006,50.67843520000006,51.79452899999994,52.927083333333336,147200,279530,80.66471764634424,NaN,1.5,2.75,NaN,NaN,0.3755331867536352,0.5265982184380925,NaN,0.05906895927839517,0.6424480897170355,0.5833791304386403,8.404224655338831,2.787878787878788,NaN,NaN,NaN,10862699
800631000,52.98437,53.15625,52.89062,53.03125,NaN,NaN,50.745316,46.80704441860465,47.71898205000006,49.06437250000006,50.76281020000006,51.91562299999995,50.89868176391167,52.04289561543772,52.34495076923077,53.35938028252356,51.33052125593798,47.71898205000006,49.06437250000006,50.76281020000006,51.91562299999995,53.02604,221600,274135,80.9339227377815,NaN,1.5,2.75,NaN,NaN,0.3676829591283756,0.808360844109654,NaN,0.05420855395776969,0.6511398228858525,0.5969312689280828,8.505479276240377,1.4345487148834428,NaN,NaN,NaN,11084299
800717400,53.03125,53.04687,52.78125,52.82812,NaN,NaN,50.79687857142857,46.80050372093023,47.75218515000006,49.13249750000006,50.85062260000006,52.02890399999994,50.97434600846415,52.11767889015794,52.439902307692314,53.38393834041598,51.49586627496865,47.75218515000006,49.13249750000006,50.85062260000006,52.02890399999994,52.88541333333333,189200,272445,73.74635364056276,NaN,1.5,2.75,NaN,NaN,0.360392747762063,0.6944520912477747,NaN,0.029915053604689712,0.6343250859339449,0.6044100323292552,5.710901074867102,1.1064497607655472,NaN,NaN,NaN,10895099
800803800,52.73437,52.76562,52.0625,52.0625,NaN,NaN,50.84844114285714,46.79396302325581,47.78148205000006,49.192497500000066,50.92062260000006,52.09999799999995,51.017018714014576,52.112423757761945,52.4867776923077,53.278376144947444,51.69517923966795,47.78148205000006,49.192497500000066,50.92062260000006,52.09999799999995,52.29687333333334,577800,290940,54.206321835787044,NaN,1.5,2.75,NaN,NaN,0.3893375514933441,1.9859764899979377,NaN,-0.04125020898065923,0.5528472711034311,0.5940974800840904,10.665554257570683,-0.23952095808383234,NaN,NaN,NaN,10317299
800890200,51.98437,52.1875,51.90625,52.09375,NaN,NaN,50.90000371428572,46.787422325581396,47.81226330000006,49.25031000000006,50.99156020000006,52.160154499999955,51.05924347032773,52.11064530464176,52.52764307692308,53.16374010315938,51.89154605068678,47.81226330000006,49.25031000000006,50.99156020000006,52.160154499999955,52.0625,363900,301885,54.73353078141538,NaN,1.5,2.75,NaN,NaN,0.3816170121009624,1.205425907216324,NaN,-0.08711478407980944,0.4852039999843285,0.5723187840641379,10.663785221297411,-0.89179548156956,NaN,NaN,NaN,10681199
801149400,52.26562,52.75,52.23437,52.67187,NaN,NaN,50.951566285714286,46.78088162790697,47.84671640000006,49.31624750000006,51.05968520000006,52.21952949999995,51.122483726393305,52.164095275628256,52.557690769230774,53.181171757649125,51.934209780812424,47.84671640000006,49.31624750000006,51.05968520000006,52.21952949999995,52.55208,216000,304235,63.179026804031786,NaN,1.5,2.75,NaN,NaN,0.4012336540937508,0.7099774845103292,NaN,-0.07961856357767427,0.4727955795920451,0.5524141431697194,11.80779616021499,0.2975305252037394,NaN,NaN,NaN,10897199
801235800,52.76562,53.15625,52.60937,53.15625,NaN,NaN,51.003128857142855,46.774340930232555,47.88304455000006,49.38671630000006,51.13843520000006,52.31015449999995,51.20223926653475,52.258586201758895,52.627402307692314,53.29851876578099,51.95628584960364,47.88304455000006,49.38671630000006,51.13843520000006,52.31015449999995,52.97395666666667,136800,296415,68.48451578887077,NaN,1.5,2.75,NaN,NaN,0.4116369645156258,0.46151510551085473,NaN,-0.04487059542337801,0.49632589889049683,0.5411964943138748,12.82620349687384,1.099563848992702,NaN,NaN,NaN,11033999
801322200,53.25,53.42187,52.79687,53.125,NaN,NaN,51.05469142857143,46.76780023255814,47.91882580000006,49.46234130000006,51.209372800000054,52.396873499999955,51.27764164823927,52.34110180159138,52.699517692307694,53.367527935441345,52.03150744917404,47.91882580000006,49.46234130000006,51.209372800000054,52.396873499999955,53.11458,370800,304735,67.80571094865557,NaN,1.5,2.75,NaN,NaN,0.42687718133593827,1.216794920176547,NaN,-0.027667338534685615,0.5066123211455178,0.5342796596802034,12.86776309006493,0.7705986959098993,NaN,NaN,NaN,10663199
801408600,52.96875,53.21875,52.71875,53.17187,NaN,NaN,51.106254,46.76125953488372,47.95398205000006,49.536247500000066,51.28312280000006,52.47968599999996,51.3519251130142,52.4202225823922,52.74639230769231,53.453727794674066,52.039056820710556,47.95398205000006,49.536247500000066,51.28312280000006,52.47968599999996,53.03645666666667,379900,298620,68.31300895691972,NaN,1.5,2.75,NaN,NaN,0.43210023981194273,1.2721853861094368,NaN,-0.01731409456439359,0.5126370414747115,0.529951136039105,12.825508045766684,0.7997535545023666,NaN,NaN,NaN,11043099
801495000,52.96875,52.98437,52.35937,52.5625,NaN,NaN,51.157816571428576,46.7547188372093,47.98695080000006,49.60187250000006,51.33874780000006,52.52812349999996,51.39939863799403,52.43377281264056,52.74999846153847,53.453056137816986,52.04694078525995,47.98695080000006,49.60187250000006,51.33874780000006,52.52812349999996,52.63541333333333,518600,318010,55.96558953695735,NaN,1.5,2.75,NaN,NaN,0.45927165125394687,1.63076632810289,NaN,-0.053637281521306424,0.462904534137472,0.5165418156587784,14.66528506986601,-0.8254716981132075,NaN,NaN,NaN,10524499
801840600,52.6875,52.82812,52.375,52.54687,NaN,NaN,51.209379142857145,46.74817813953488,48.018044550000056,49.66734120000007,51.39843520000006,52.58281099999996,51.444397514935446,52.44454397334146,52.74759461538462,53.453195648593145,52.0419935821761,48.018044550000056,49.66734120000007,51.39843520000006,52.58281099999996,52.58333,61500,295150,55.68755832444224,NaN,1.5,2.75,NaN,NaN,0.45883224759295055,0.2083686261223107,NaN,-0.07929887969975374,0.41741821603408624,0.49671709573384,14.307864470921901,-0.913385975250445,NaN,NaN,NaN,10462999
801927000,52.57812,53.64062,52.45312,53.64062,NaN,NaN,51.260941714285714,46.74163744186046,48.05468515000006,49.74327870000006,51.47999760000006,52.68671699999995,51.53052388689876,52.55845597588037,52.8185076923077,53.668734150145205,51.96828123447019,48.05468515000006,49.74327870000006,51.47999760000006,52.68671699999995,53.24478666666666,564500,311955,67.75830443016636,NaN,1.5,2.75,NaN,NaN,0.5108799441934541,1.8095558654293087,NaN,-0.025953999127481475,0.46427459682448813,0.4902285959519696,18.9056150191201,1.5380066525176366,NaN,NaN,NaN,11027499
802013400,53.40625,53.90625,53.25,53.5,NaN,NaN,51.31250428571429,46.735096744186045,48.088982050000055,49.817341200000065,51.56124760000006,52.74765449999995,51.60775824427528,52.64812683532033,52.876200000000004,53.79871255184012,51.95368744815989,48.088982050000055,49.817341200000065,51.56124760000006,52.74765449999995,53.552083333333336,810100,316225,65.29563404088279,NaN,1.5,2.75,NaN,NaN,0.5212635196082073,2.5617835402008065,NaN,-0.004601270344580355,0.48447700802124416,0.4890782783658245,18.801497018851915,2.7611044417767108,NaN,NaN,NaN,10217399
802099800,53.28125,53.92187,53.09375,53.54687,NaN,NaN,51.36406685714286,46.72855604651163,48.12366955000006,49.89140370000006,51.64249760000006,52.81249799999995,51.683801842539,52.73372142243268,52.91826692307693,53.90702095606236,51.929512890091495,48.12366955000006,49.89140370000006,51.64249760000006,52.81249799999995,53.52083,112900,306300,65.74255555778198,NaN,1.5,2.75,NaN,NaN,0.5431818396361924,0.36859288279464575,NaN,0.007555713176241763,0.49852291983612673,0.49096720665988497,15.90503387140144,2.7894325134972977,NaN,NaN,NaN,10330299
802359000,53.54687,54.04687,53.5,53.875,NaN,NaN,51.41562942857143,46.72201534883721,48.16077895000006,49.96843500000006,51.729685200000056,52.89687299999995,51.76973118204727,52.84241462029623,52.983170769230775,54.09604959078799,51.87029194767356,48.16077895000006,49.96843500000006,51.729685200000056,52.89687299999995,53.80729,257200,303415,68.77431534126995,NaN,1.5,2.75,NaN,NaN,0.5434452796621786,0.8476838653329598,NaN,0.0312438276800181,0.5300219912599076,0.49877816357988947,15.938871906280884,2.284198377615987,NaN,NaN,NaN,10587499
802445400,53.82812,54.01562,53.78125,53.78125,NaN,NaN,51.467192000000004,46.715474651162786,48.19757585000006,50.044372500000065,51.800935200000055,52.95781049999995,51.84861427294738,52.931827513601355,53.056488461538464,54.24205954207546,51.87091738100147,48.19757585000006,50.044372500000065,51.800935200000055,52.95781049999995,53.85937333333334,165800,302550,66.95122424654949,NaN,1.5,2.75,NaN,NaN,0.5213684739720229,0.5480085936208892,NaN,0.03392305456909195,0.5411819817912544,0.5072589272221625,15.365496198750556,1.1757789535567313,NaN,NaN,NaN,10421699
802531800,53.67187,53.70312,53.4375,53.5,NaN,NaN,51.51875457142857,46.70893395348837,48.23320085000006,50.11202880000006,51.86249780000006,53.00702949999995,51.91337449753768,52.98593917897266,53.16706538461539,54.222143384488454,52.11198738474233,48.23320085000006,50.11202880000006,51.86249780000006,53.00702949999995,53.54687333333334,41900,295615,61.669693390993004,NaN,1.5,2.75,NaN,NaN,0.5086814401168784,0.14173840975593255,NaN,0.011250738741209299,0.5213223506486742,0.5100716119074649,15.16202842808115,0.7058823529411765,NaN,NaN,NaN,10379799
802618200,53.48437,53.64062,53.375,53.375,NaN,NaN,51.57031714285714,46.70239325581395,48.266872750000054,50.17562260000006,51.921560400000054,53.04687349999996,51.970693144693065,53.02299259049907,53.265623076923085,54.12187968836361,52.409366465482556,48.266872750000054,50.17562260000006,51.921560400000054,53.04687349999996,53.46354,141100,286155,59.4259180862595,NaN,1.5,2.75,NaN,NaN,0.4913199086799584,0.493089409585714,NaN,-0.016177045398610645,0.4898503051592016,0.5060273505578122,15.246971989720741,0.382025307742612,NaN,NaN,NaN,10238699
802704600,53.26562,53.32812,52.75,53.0625,NaN,NaN,51.62187971428572,46.695852558139535,48.29648215000006,50.23593510000006,51.974685400000055,53.06406099999996,52.013509099803144,53.02675520092773,53.29567153846154,54.091777143662355,52.499565933260726,48.29648215000006,50.23593510000006,51.974685400000055,53.06406099999996,53.04687333333334,304900,283815,54.12412076863557,NaN,1.5,2.75,NaN,NaN,0.5008684866313899,1.0742913517608301,NaN,-0.0570765963878192,0.4346816050730382,0.4917582014608574,15.665932452952116,0.9512485136741974,NaN,NaN,NaN,9933799
802963800,53.23437,53.57812,53.20312,53.35937,NaN,NaN,51.67344228571429,46.68931186046512,48.328200900000056,50.29968510000006,52.035622800000056,53.09452949999995,52.06628795863439,53.05843280083938,53.31129615384616,54.103808011420924,52.51878429627139,48.328200900000056,50.29968510000006,52.035622800000056,53.09452949999995,53.380203333333334,378500,298010,57.961181693258794,NaN,1.5,2.75,NaN,NaN,0.5019221661577191,1.2700916076641724,NaN,-0.06525730889142356,0.41018656534657794,0.4754438742380015,14.148473030387942,1.5462386246792625,NaN,NaN,NaN,10312299
803050200,53.60937,53.96875,53.5625,53.9375,NaN,NaN,51.72500485714286,46.682771162790694,48.359450900000056,50.37187260000006,52.11218540000005,53.14140449999995,52.13966882300167,53.142153486473724,53.37379615384616,54.22375319245179,52.52383911524053,48.359450900000056,50.37187260000006,52.11218540000005,53.14140449999995,53.822916666666664,120000,296650,64.23480905655813,NaN,1.5,2.75,NaN,NaN,0.5095977257178822,0.4045171077026799,NaN,-0.03440355010153989,0.43243943661107664,0.46684298671261654,15.029806835476519,0.5534611643191327,NaN,NaN,NaN,10432299
803136600,53.85937,53.95312,53.6875,53.89062,NaN,NaN,51.77656742857143,46.67623046511628,48.390622750000055,50.44531010000006,52.185310400000056,53.18437299999995,52.20833357504082,53.21343601157147,53.42908461538462,54.312170425119426,52.54599880564981,48.390622750000055,50.44531010000006,52.185310400000056,53.18437299999995,53.84374666666667,389400,305040,63.40846249850972,NaN,1.5,2.75,NaN,NaN,0.4921707453094619,1.2765538945712038,NaN,-0.020509411360338903,0.4412062225121929,0.4617156338725318,9.766131502544527,0.7301308411214924,NaN,NaN,NaN,10042899
803223000,53.96875,54.23437,53.875,54.125,NaN,NaN,51.82813,46.66968976744186,48.42234150000006,50.51968510000006,52.256560400000055,53.24921699999995,52.2834969642549,53.30025162951704,53.54927692307693,54.349278966356124,52.74927487979774,48.42234150000006,50.51968510000006,52.256560400000055,53.24921699999995,54.07812333333334,274500,309305,65.77877173279624,NaN,1.5,2.75,NaN,NaN,0.48268497778735736,0.8874735293642197,NaN,0.00002251360747707043,0.4617437758818781,0.461721262274401,9.777623645964077,1.0796709499546875,NaN,NaN,NaN,10317399
803309400,53.70312,53.96875,53.70312,53.96875,NaN,NaN,51.87969257142857,46.66314906976744,48.45390400000006,50.59187260000006,52.32468540000005,53.34452949999995,52.349585318597846,53.36391814099161,53.658652307692314,54.23927000953929,53.07803460584534,48.45390400000006,50.59187260000006,52.32468540000005,53.34452949999995,53.880206666666666,325100,296670,62.85561186083673,NaN,1.5,2.75,NaN,NaN,0.47834176508826054,1.0958303839282704,NaN,-0.0012905883775252702,0.4601080268024944,0.4613986151800197,10.052286048624929,0.1740139211136891,NaN,NaN,NaN,9992299
803568600,54.125,54.60937,54.09375,54.57812,NaN,NaN,51.93125514285715,46.65660837209302,48.48929460000006,50.66890380000006,52.40124780000006,53.46874799999995,52.436978835515575,53.47955641327812,53.730767692307694,54.489940820636576,52.97159456397881,48.48929460000006,50.66890380000006,52.40124780000006,53.46874799999995,54.42708,134600,285205,68.69793443514791,NaN,1.5,2.75,NaN,NaN,0.4899330675819561,0.4719412352518364,NaN,0.03263612621184686,0.5021937729448283,0.4695576467329814,11.382045040199571,1.4816873910517112,NaN,NaN,NaN,10126899
803655000,54.42187,54.60937,54.39062,54.4375,NaN,NaN,51.982817714285716,46.6500676744186,48.524997750000054,50.74406010000006,52.475935400000054,53.557029499999956,52.51543064588751,53.57078913582306,53.80288307692308,54.63525247159553,52.97051368225063,48.524997750000054,50.74406010000006,52.475935400000054,53.557029499999956,54.47916333333333,287800,288795,66.11368520074305,NaN,1.5,2.75,NaN,NaN,0.47056284846895924,0.9965546494918541,NaN,0.038934986661472604,0.5182263800598221,0.47929139339834953,11.473479595363017,1.7523364485981308,NaN,NaN,NaN,9839099
803741400,54.60937,54.65625,54.40625,54.40625,NaN,NaN,52.034380285714285,46.643526976744184,48.560466500000054,50.81702890000006,52.548123000000054,53.619529499999956,52.58958042448016,53.65035683717325,53.86898923076923,54.74489311936383,52.99308534217463,48.560466500000054,50.81702890000006,52.548123000000054,53.619529499999956,54.489583333333336,158200,289865,65.52378666760592,NaN,1.5,2.75,NaN,NaN,0.454808359292605,0.5457713073327238,NaN,0.03447804388503556,0.522388948254644,0.48791090436960843,10.807273446218757,1.9320843091334894,NaN,NaN,NaN,9680899
803827800,54.64062,55.15625,54.64062,55.125,NaN,NaN,52.08594285714286,46.63698627906977,48.59976340000006,50.89921640000006,52.63812300000005,53.71952949999995,52.689008643128,53.790799043156746,53.96514307692308,55.06769387980762,52.86259227403853,48.59976340000006,50.89921640000006,52.63812300000005,53.71952949999995,54.97395666666667,297000,286175,71.76402596290762,NaN,1.5,2.75,NaN,NaN,0.47589347648599034,1.0378265047610729,NaN,0.07129787775317986,0.5770332515610832,0.5057353738079033,12.24666772910617,3.8869257950530036,NaN,NaN,NaN,9977899
803914200,55,55.03125,54.84375,55.01562,NaN,NaN,52.13750542857143,46.63044558139535,48.637341500000055,50.97843510000006,52.72249800000005,53.81171699999995,52.780248304181804,53.9074486580942,54.06009461538462,55.28838162252562,52.83180760824362,48.637341500000055,50.97843510000006,52.72249800000005,53.81171699999995,54.963539999999995,315400,282950,69.69656275502382,NaN,1.5,2.75,NaN,NaN,0.4619903710227053,1.1146845732461566,NaN,0.0790472148020328,0.6045443923104443,0.5254971775084115,11.363670137071855,3.10395343873063,NaN,NaN,NaN,9662499
804173400,54.85937,54.95312,54.35937,54.35937,NaN,NaN,52.189068,46.623904883720925,48.67413835000006,51.05124760000006,52.78812300000005,53.901560499999945,52.842174645194284,53.95048878589475,54.126200000000004,55.31877832537335,52.93362167462666,48.67413835000006,51.05124760000006,52.78812300000005,53.901560499999945,54.55728666666666,132900,263665,58.75898059313091,NaN,1.5,2.75,NaN,NaN,0.4758660588067977,0.5040486981586483,NaN,0.03308936417628394,0.5668588827287664,0.5337695185524824,14.333177092144021,0.7821460023174942,NaN,NaN,NaN,9529599
804259800,54.34375,54.70312,54.21875,54.25,NaN,NaN,52.240630571428575,46.61736418604651,48.71109150000006,51.12015390000006,52.85749800000005,53.986716999999956,52.89738348263764,53.97901366342858,54.1935076923077,55.30490607981729,53.0821093047981,48.71109150000006,51.12015390000006,52.85749800000005,53.986716999999956,54.39062333333334,127700,266975,57.1493189102123,NaN,1.5,2.75,NaN,NaN,0.4764734831777406,0.4783219402565783,NaN,-0.009296738096861823,0.5221485959314052,0.531445334028267,13.26265895037423,0.6668692993326141,NaN,NaN,NaN,9401899
804346200,54.25,54.75,54.07812,54.53125,NaN,NaN,52.292193142857144,46.61082348837209,48.74874775000006,51.18515390000006,52.93593560000005,54.03124849999996,52.96145667939695,54.031607600244904,54.306488461538464,55.21514286529193,53.397834057785,48.74874775000006,51.18515390000006,52.93593560000005,54.03124849999996,54.45312333333334,212600,249380,60.17093618164112,NaN,1.5,2.75,NaN,NaN,0.4904310915221878,0.8525142353035529,NaN,-0.02227254319088634,0.5036046550396591,0.5258771982305455,13.472288409023438,0.7505773672055427,NaN,NaN,NaN,9614499
804432600,54.53125,54.67187,54.0625,54.4375,NaN,NaN,52.34375571428571,46.604282790697674,48.78570090000006,51.24718520000006,53.01343560000005,54.07812349999996,53.01934073118531,54.070264019269196,54.38942153846154,55.11565305220575,53.66319002471733,48.78570090000006,51.24718520000006,53.01343560000005,54.07812349999996,54.390623333333345,89200,213335,58.685426725983554,NaN,1.5,2.75,NaN,NaN,0.4989267278420314,0.41812173342395764,NaN,-0.04001519094105621,0.4758582095542252,0.5158734004952814,13.40136606491025,0.8685581933989577,NaN,NaN,NaN,9525299
804519000,54.54687,54.73437,54.29687,54.40625,NaN,NaN,52.39531828571429,46.59774209302326,48.81952905000006,51.308279000000056,53.08874820000005,54.12109249999996,53.073729329962354,54.1022626841007,54.425479230769234,55.10331237667058,53.74764608486789,48.81952905000006,51.308279000000056,53.08874820000005,54.12109249999996,54.479163333333325,714100,243395,58.169900926159606,NaN,1.5,2.75,NaN,NaN,0.49453910442474347,2.933914008093839,NaN,-0.055735697702613884,0.4462037783670141,0.501939476069628,13.247517816783738,-0.3149064130461042,NaN,NaN,NaN,8811199
804778200,54.46875,54.60937,54.46875,54.60937,NaN,NaN,52.44688085714286,46.59120139534883,48.857497800000054,51.371404000000055,53.163123200000044,54.15781099999996,53.13395053270893,54.15055861894825,54.480767692307694,55.08872533278861,53.872810051826775,48.857497800000054,51.371404000000055,53.163123200000044,54.15781099999996,54.56249666666667,9500,231010,60.593050931393556,NaN,1.5,2.75,NaN,NaN,0.47372345410869027,0.04112376087615255,NaN,-0.054280691928367486,0.43408861115916864,0.4883693030875361,11.701225623943028,0.315719862227322,NaN,NaN,NaN,8820699
804951000,54.76562,55.0625,54.64062,54.8125,NaN,NaN,52.498443428571434,46.584660697674416,48.896247800000054,51.43656030000005,53.22968580000004,54.209373499999955,53.19977600201446,54.21360065523889,54.533652307692314,55.12807720131763,53.939227414067,48.896247800000054,51.43656030000005,53.22968580000004,54.209373499999955,54.83854,409300,243185,62.90717872178703,NaN,1.5,2.75,NaN,NaN,0.4722524931009268,1.6830807821206077,NaN,-0.04201232659520865,0.4358538948435253,0.477866221438734,11.739364164456074,0.7466973004020678,NaN,NaN,NaN,9229999
805037400,54.82812,55.51562,54.71875,55.51562,NaN,NaN,52.550006,46.57812,48.94296655000006,51.50812280000005,53.31312320000004,54.31015449999995,53.290593413700165,54.33760249759709,54.65264230769231,55.35635596694731,53.94892864843731,48.94296655000006,51.50812280000005,53.31312320000004,54.31015449999995,55.249996666666675,202500,251215,69.56872111037514,NaN,1.5,2.75,NaN,NaN,0.49543945787943194,0.8060824393447843,NaN,0.008394463359323867,0.4883593006378888,0.4799648372785649,13.558764639239055,0.708607709750564,NaN,NaN,NaN,9432499
805123800,55.40625,55.78125,55.375,55.76562,NaN,NaN,52.60156857142857,46.57157930232558,48.990935300000054,51.582029000000055,53.40062320000005,54.42968549999995,53.38765327982957,54.473604164492606,54.743988461538464,55.661197301568954,53.826779621507974,48.990935300000054,51.582029000000055,53.40062320000005,54.42968549999995,55.64062333333334,481700,268245,71.52674204967059,NaN,1.5,2.75,NaN,NaN,0.4890687823166154,1.7957464258420475,NaN,0.0511270792707027,0.5438736863669433,0.49274660709624063,11.761706734864068,1.3632492008633186,NaN,NaN,NaN,9914199
805383000,55.8125,55.95312,55.70312,55.79687,NaN,NaN,52.65313114285715,46.565038604651164,49.03960715000006,51.65562270000006,53.48624820000005,54.56640399999994,53.48213236689508,54.599629482159976,54.84855538461539,55.90199128701241,53.79511948221837,49.03960715000006,51.65562270000006,53.48624820000005,54.56640399999994,55.81770333333333,400400,273020,71.7712446899879,NaN,1.5,2.75,NaN,NaN,0.47199244072257146,1.4665592264302982,NaN,0.072732914311197,0.5836627499852369,0.5109298356740399,11.602927632857392,2.6444383001495417,NaN,NaN,NaN,10314599
805469400,55.75,55.79687,55.45312,55.53125,NaN,NaN,52.70469371428572,46.55849790697674,49.08773215000006,51.723904000000054,53.56499820000005,54.674997999999945,53.562489921134485,54.68835524576379,54.935093846153855,56.01351085082548,53.856676841482226,49.08773215000006,51.723904000000054,53.56499820000005,54.674997999999945,55.59374666666667,420500,275120,66.5408979371577,NaN,1.5,2.75,NaN,NaN,0.46283226638524494,1.5284239604536203,NaN,0.060852955939197706,0.5869960305980371,0.5261430746588394,9.00169033938062,2.3617511520737327,NaN,NaN,NaN,9894099
805555800,55.64062,56.3125,55.53125,56.21875,NaN,NaN,52.75625628571429,46.55195720930232,49.138122800000055,51.79968530000006,53.66031080000004,54.78906049999995,53.66665698305078,54.834107127119616,55.01922846153847,56.29616976557448,53.74228715750245,49.138122800000055,51.79968530000006,53.66031080000004,54.78906049999995,56.020833333333336,203400,279290,72.18998037790949,NaN,1.5,2.75,NaN,NaN,0.4855763902148703,0.7282752694332056,NaN,0.08929471357443575,0.637761466626884,0.5484667530524483,10.248574021034665,3.0945558739255015,NaN,NaN,NaN,10097499
805642200,56.14062,56.26562,56.03125,56.09375,NaN,NaN,52.80781885714286,46.545416511627906,49.188044700000056,51.87609160000005,53.75093580000004,54.89921699999995,53.76183710136251,54.95407311501299,55.102161538461544,56.501562831624604,53.702760245298485,49.188044700000056,51.87609160000005,53.75093580000004,54.89921699999995,56.13020666666667,215600,270600,69.87984434666816,NaN,1.5,2.75,NaN,NaN,0.4676330766280938,0.7967479674796748,NaN,0.089463005142008,0.6602955094799583,0.5708325043379503,10.692692454967428,3.04247990815155,NaN,NaN,NaN,9881899
805728600,55.79687,56.09375,55.75,56.04687,NaN,NaN,52.85938142857143,46.53887581395349,49.23593530000006,51.95218530000005,53.826248200000045,54.995310499999945,53.85144623464241,55.058149008821275,55.23196923076924,56.644684811014784,53.81925365052369,49.23593530000006,51.95218530000005,53.826248200000045,54.995310499999945,55.96354,543700,284060,68.98818772331215,NaN,1.5,2.75,NaN,NaN,0.4587842854403728,1.9140322467084419,NaN,0.07668274541656506,0.6666859361086566,0.5900031906920915,10.566708801832538,3.015499138426189,NaN,NaN,NaN,9338199
805987800,56.125,56.42187,56.07812,56.35937,NaN,NaN,52.910944,46.53233511627907,49.286560300000055,52.027810300000056,53.90843560000005,55.11484149999994,53.94979618622506,55.18207481750496,55.39422846153847,56.80307320707636,53.98538371600058,49.286560300000055,52.027810300000056,53.90843560000005,55.11484149999994,56.28645333333333,171500,276380,71.5904834927001,NaN,1.5,2.75,NaN,NaN,0.4527996936232033,0.6205224690643317,NaN,0.07921656346363992,0.6890238950216414,0.6098073315580015,10.411469284459695,3.204578261935635,NaN,NaN,NaN,9509699
806074200,56.26562,56.26562,55.82812,55.875,NaN,NaN,52.96250657142858,46.52579441860465,49.33507595000005,52.097810300000056,53.98218560000005,55.17968549999995,54.02529437500055,55.2480676920283,55.497593846153855,56.83328768968917,54.16190000261854,49.33507595000005,52.097810300000056,53.98218560000005,55.17968549999995,55.98958,221200,280710,62.79488000803685,NaN,1.5,2.75,NaN,NaN,0.45840328693583166,0.7880018524455844,NaN,0.0401811895081956,0.6600338184432459,0.6198526289350503,12.520652579754998,1.9384264538198404,NaN,NaN,NaN,9288499
806160600,55.65625,55.71875,54.20312,55.26562,NaN,NaN,53.014069142857146,46.51925372093023,49.38109155000006,52.160466500000055,54.03624800000005,55.22109149999994,54.07393459558876,55.249739340406556,55.56129538461539,56.76072012192173,54.361870647309054,49.38109155000006,52.160466500000055,54.03624800000005,55.22109149999994,55.06249666666667,486600,290650,53.833788111749946,NaN,1.5,2.75,NaN,NaN,0.5450801950118438,1.6741785652847068,NaN,-0.030932077072259867,0.5811875325947256,0.6121196096669854,14.57101243717345,-0.45032371069619687,NaN,NaN,NaN,8801899
806247000,55.32812,55.57812,55.03125,55.46875,NaN,NaN,53.065631714285715,46.51271302325581,49.43156030000006,52.22906030000006,54.09531060000005,55.274216499999945,54.128633238899006,55.270597498463076,55.64302615384616,56.64504103042606,54.64101127726626,49.43156030000006,52.22906030000006,54.09531060000005,55.274216499999945,55.35937333333333,318900,298685,56.08353976342387,NaN,1.5,2.75,NaN,NaN,0.5452080382252834,1.067679997321593,NaN,-0.06650027986572282,0.5289942598348318,0.5954945397005547,12.663950756925157,-0.5323530877985369,NaN,NaN,NaN,9120799
806333400,55.42187,55.625,55.1875,55.40625,NaN,NaN,53.11719428571429,46.506172325581396,49.481638450000055,52.29296660000006,54.15187320000005,55.288278999999946,54.1787358569814,55.28351678432374,55.70432461538462,56.52742948327132,54.88121974749792,49.481638450000055,52.29296660000006,54.15187320000005,55.288278999999946,55.40625,94000,288535,55.19233047662204,NaN,1.5,2.75,NaN,NaN,0.5375146069234774,0.325783700417627,NaN,-0.09472529978616095,0.4770879149678535,0.5718132147540145,12.327663456019668,-0.700075111740136,NaN,NaN,NaN,9026799
806592600,55.48437,55.875,55.48437,55.8125,NaN,NaN,53.16875685714286,46.49963162790697,49.53445095000006,52.36406040000006,54.21374820000005,55.32812299999995,54.242805039060556,55.333896138197666,55.7812476923077,56.423672897484444,55.13882248713096,49.53445095000006,52.36406040000006,54.21374820000005,55.32812299999995,55.72395666666667,108400,278185,59.677601440244516,NaN,1.5,2.75,NaN,NaN,0.5326028492860861,0.3896687456189227,NaN,-0.08673772472532038,0.463391058847364,0.5501287835726844,13.147601738875052,0.5064715813168261,NaN,NaN,NaN,9135199
806679000,55.875,56.3125,55.70312,56.23437,NaN,NaN,53.22031942857143,46.493090930232555,49.588357200000054,52.43874790000005,54.28343560000005,55.42187299999995,54.32090562576406,55.41965555360741,55.83653615384616,56.501327883379126,55.1717444243132,49.588357200000054,52.43874790000005,54.28343560000005,55.42187299999995,56.08333,107400,276910,63.737069915520536,NaN,1.5,2.75,NaN,NaN,0.5380869314799372,0.3878516485500704,NaN,-0.05527699383956941,0.4810325412732226,0.536309535112792,13.39664170933257,0.027784324624788727,NaN,NaN,NaN,9242599
806765400,56.20312,56.46875,56.17187,56.1875,NaN,NaN,53.271882000000005,46.48655023255814,49.63960720000006,52.512810400000056,54.347185600000046,55.518747999999945,54.394105405145865,55.492783596120994,55.868988461538464,56.557529099464745,55.180447823612184,49.63960720000006,52.512810400000056,54.347185600000046,55.518747999999945,56.27604,167800,278915,62.97846460684353,NaN,1.5,2.75,NaN,NaN,0.5208578649456561,0.601616980083538,NaN,-0.04054087142033003,0.48563344583737944,0.5261743172577095,11.411856439400745,0.1671309192200557,NaN,NaN,NaN,9074799
806851800,56.45312,56.70312,56.45312,56.65625,NaN,NaN,53.323444571428574,46.48000953488372,49.68976345000006,52.591247900000056,54.41968560000005,55.62499799999995,54.48281695788524,55.603589920299946,55.93509461538462,56.738655159981676,55.131534070787566,49.68976345000006,52.591247900000056,54.41968560000005,55.62499799999995,56.60416333333334,187700,277670,67.18502279342562,NaN,1.5,2.75,NaN,NaN,0.520483731735252,0.6759822811250765,NaN,-0.004061836801688257,0.5210970212555992,0.5251588580572875,12.247150082581209,1.0872685664694597,NaN,NaN,NaN,9262499
806938200,56.70312,56.70312,56.25,56.29687,NaN,NaN,53.37500714285714,46.4734688372093,49.737810300000056,52.669841600000055,54.489060600000045,55.717966499999946,54.55395629287013,55.66961659455709,55.993988461538464,56.78261076223555,55.20536616084138,49.737810300000056,52.669841600000055,54.489060600000045,55.717966499999946,56.41666333333334,415600,293990,61.42268663827073,NaN,1.5,2.75,NaN,NaN,0.5156720366113053,1.4136535256301235,NaN,-0.008707121509757165,0.514274956170091,0.5229820776798482,12.939404068643361,-0.11089549084739592,NaN,NaN,NaN,8846899
807197400,56.34375,56.39062,56.03125,56.15625,NaN,NaN,53.42656971428572,46.46692813953488,49.78437280000006,52.74577910000006,54.57093560000005,55.805466499999945,54.61679134020856,55.715962633170705,55.98918076923077,56.7730110608481,55.20535047761344,49.78437280000006,52.74577910000006,54.57093560000005,55.805466499999945,56.19270666666667,342500,275410,59.28022127367368,NaN,1.5,2.75,NaN,NaN,0.5045076054247833,1.2436004502378273,NaN,-0.024904221933035542,0.4918518002635537,0.5167560221965892,12.596589449756497,0.5033557046979866,NaN,NaN,NaN,8504399
807283800,56.23437,56.23437,55.75,56.0625,NaN,NaN,53.47813228571429,46.46038744186046,49.82945095000005,52.82093540000005,54.65031060000005,55.878122999999945,54.67348579745528,55.74896619191635,55.98677692307693,56.769500594734446,55.20405325141942,49.82945095000005,52.82093540000005,54.65031060000005,55.878122999999945,56.01562333333334,141000,281985,57.83191165287514,NaN,1.5,2.75,NaN,NaN,0.5030692050372987,0.5000265971594233,NaN,-0.044444802219596236,0.461200019422094,0.5056448216416902,11.513729624344505,1.4419090928501328,NaN,NaN,NaN,8363399
807370200,56.39062,56.79687,55.84375,55.9375,NaN,NaN,53.52969485714286,56.79687,49.87437285000006,52.88765420000005,54.715623200000046,55.93437299999995,54.7230549818688,55.766921792686226,55.97836384615385,56.760674039227,55.196053653080696,49.87437285000006,52.88765420000005,54.715623200000046,55.93437299999995,56.19270666666667,240400,273540,55.87185724166287,NaN,1.5,2.75,NaN,NaN,0.5352156903917773,0.8788477005191196,NaN,-0.06694966470237362,0.42195774076372317,0.4889074054660968,9.250496489560893,0.8450704225352113,NaN,NaN,NaN,8122999
807456600,55.54687,55.95312,55.45312,55.92187,NaN,NaN,53.58125742857143,56.8444812565445,49.919763450000055,52.95468540000005,54.77093560000005,55.95468549999995,54.770067335521006,55.781678764811346,55.94471,56.69557254642785,55.193847453572154,49.919763450000055,52.95468540000005,54.77093560000005,55.95468549999995,55.77603666666666,1193600,323095,55.61802325136752,NaN,1.5,2.75,NaN,NaN,0.5327002839352218,3.6942694873024964,NaN,-0.08300041003907055,0.38515689291725863,0.4681573029563292,9.143368118344721,0.9306170332769289,NaN,NaN,NaN,6929399
807543000,56.03125,56.07812,55.92187,55.98437,NaN,NaN,53.63282,56.892092513089004,49.964372800000056,53.01874790000005,54.82812300000005,55.96562299999995,54.81768704785352,55.80098269197217,55.953123076923085,56.703123205139995,55.203122948706174,49.964372800000056,53.01874790000005,54.82812300000005,55.96562299999995,55.994786666666656,240500,311035,56.46966011098162,NaN,1.5,2.75,NaN,NaN,0.5058109779398489,0.7732248782291382,NaN,-0.08898918439466652,0.35692082246299606,0.4459100068576626,9.059571510545062,0.3079417693169065,NaN,NaN,NaN,7169899
807802200,56.10937,56.28125,56.07812,56.10937,NaN,NaN,53.68438257142857,56.9397037696335,50.011169650000056,53.084997900000054,54.88687300000005,55.98124799999995,54.86834128127103,55.830352911784345,56.01802692307693,56.656562657890866,55.379491188262996,50.011169650000056,53.084997900000054,54.88687300000005,55.98124799999995,56.15624666666667,193100,300670,58.19735194680838,NaN,1.5,2.75,NaN,NaN,0.4908873366584312,0.6422323477566767,NaN,-0.08416594048387943,0.3407025812528133,0.4248685217366927,8.204695893445827,-0.22228398753289136,NaN,NaN,NaN,7362999
807888600,56.14062,56.3125,55.9375,56.10937,NaN,NaN,53.73594514285715,56.98731502617801,50.058904000000055,53.14827910000005,54.95781040000006,56.01015399999994,54.91700907416236,55.856925967804884,56.06730538461539,56.62205696492189,55.51255380430889,50.058904000000055,53.14827910000005,54.95781040000006,56.01015399999994,56.11979,951900,327240,58.19735194680838,NaN,1.5,2.75,NaN,NaN,0.48260966975425756,2.908874220755409,NaN,-0.08060415217698969,0.3241133315154556,0.4047174836924453,6.889567468930704,-0.13905228031146,NaN,NaN,NaN,7362999
807975000,56.29687,56.29687,56.04687,56.09375,NaN,NaN,53.78750771428572,57.03492628272251,50.10851340000006,53.21359160000006,55.02874800000005,56.00390399999994,54.963155777136386,55.87948063753775,56.12019000000001,56.523076584382856,55.71730341561716,50.10851340000006,53.21359160000006,55.02874800000005,56.00390399999994,56.14582999999999,107100,322425,57.86451850976641,NaN,1.5,2.75,NaN,NaN,0.4659946933432392,0.33217027215631545,NaN,-0.07883285337425816,0.3061764169746226,0.38500927034888077,6.8789264070220995,-0.9928295642581357,NaN,NaN,NaN,7255899
808061400,56.15625,56.28125,55.73437,55.96875,NaN,NaN,53.839070285714286,57.082537539267015,50.157263400000055,53.277654100000056,55.07531060000005,55.99765399999994,55.00259084469967,55.88798248158178,56.132209230769234,56.50592863694311,55.75848982459536,50.157263400000055,53.277654100000056,55.07531060000005,55.99765399999994,55.99479,280800,325685,55.146482484104276,NaN,1.5,2.75,NaN,NaN,0.4717722152472937,0.862182783978384,NaN,-0.08507735316466059,0.278662578893055,0.3637399320577156,4.3132537215878894,-0.5828387972546225,NaN,NaN,NaN,6975099
808147800,55.92187,55.98437,55.42187,55.65625,NaN,NaN,55.42187,57.130148795811515,50.203591550000056,53.33984160000006,55.11843560000005,55.97812299999995,55.02822453706439,55.86591272143114,56.087738461538464,56.53298897279471,55.64248795028222,50.203591550000056,53.33984160000006,55.11843560000005,55.97812299999995,55.68749666666667,257200,311360,48.95538012814448,NaN,1.5,2.75,NaN,NaN,0.4782527713010584,0.8260534429599178,NaN,-0.1077905566924161,0.22900173619219544,0.33679229288461154,3.990866839142334,-0.8903728436282693,NaN,NaN,NaN,6717899
808407000,55.79687,56.15625,55.67187,56.15625,NaN,NaN,55.48735290909091,57.17776005235602,50.25101345000005,53.40656040000005,55.170623200000044,55.96796699999995,55.072460829728534,55.89356389081865,56.08533461538462,56.52873837440407,55.641930856365164,50.25101345000005,53.40656040000005,55.170623200000044,55.96796699999995,55.99479,254800,315525,57.22913847502675,NaN,1.5,2.75,NaN,NaN,0.47980614477955424,0.807542983915696,NaN,-0.08753783267588477,0.22737000203975555,0.3149078347156403,6.9007503385873985,0.16722408026755853,NaN,NaN,NaN,6972699
808493400,56.14062,56.14062,55.65625,56.04687,NaN,NaN,55.55283581818182,57.22537130890052,50.29296655000005,53.47187290000005,55.214060600000046,55.97656049999995,55.11067295405291,55.908164472645446,56.038459230769234,56.335077416984745,55.74184104455372,50.29296655000005,53.47187290000005,55.214060600000046,55.97656049999995,55.94791333333333,44400,306685,55.12416101908328,NaN,1.5,2.75,NaN,NaN,0.4812485630095861,0.14477395373102694,NaN,-0.08010627047137281,0.2147749966264243,0.2948812670977971,6.927192443251705,0.19552178770949438,NaN,NaN,NaN,6928299
808579800,56,56.20312,55.9375,56.20312,NaN,NaN,55.61831872727272,57.27298256544503,50.33656030000006,53.53171660000005,55.26249800000005,56.02343549999995,55.15351401467829,55.93625547525064,56.0312476923077,56.306148286270705,55.7563470983447,50.33656030000006,53.53171660000005,55.26249800000005,56.02343549999995,56.11458,374900,301100,57.5274467122628,NaN,1.5,2.75,NaN,NaN,0.4658465227946155,1.2451012952507472,NaN,-0.06396587444016621,0.2149239240475893,0.2788897984877555,6.941183561230908,0.5029338253531221,NaN,NaN,NaN,7303199
808666200,56.23437,56.23437,55.90625,56.10937,NaN,NaN,55.68380163636363,57.320593821989526,50.382341550000056,53.58859160000006,55.31468540000005,56.055466499999945,55.19099856312228,55.952742572845814,56.027641538461545,56.29706374379866,55.75821933312443,50.382341550000056,53.58859160000006,55.31468540000005,56.055466499999945,56.08333,353800,302845,55.60333794937142,NaN,1.5,2.75,NaN,NaN,0.4560089140235714,1.1682543875579916,NaN,-0.05902168110283845,0.20511269710920743,0.2641343782120459,7.041233497138979,0.22327660380924177,NaN,NaN,NaN,6949399
808752600,56.39062,56.40625,56.125,56.17187,NaN,NaN,55.74928454545454,57.36820507853403,50.429763400000056,53.646091600000055,55.370622800000056,56.093747499999935,55.2294641096665,55.9736118516224,56.03605461538462,56.31593297022837,55.756176260540876,50.429763400000056,53.646091600000055,55.370622800000056,56.093747499999935,56.23437333333333,85400,302415,56.644438691941446,NaN,1.5,2.75,NaN,NaN,0.4446425630218878,0.2823933997982904,NaN,-0.05124820117056633,0.20007412674883795,0.2513223279194043,7.041082538856018,0.11138959499990822,NaN,NaN,NaN,7034799
809011800,56.40625,56.64062,56,56.01562,NaN,NaN,55.81476745454545,57.41581633507853,50.47515400000006,53.70218530000005,55.42968520000006,56.10390349999993,55.26029375242468,55.97761262765836,56.04206384615385,56.31652206721426,55.767605625093445,50.47515400000006,53.70218530000005,55.42968520000006,56.10390349999993,56.21874666666667,266700,310330,53.280592172242685,NaN,1.5,2.75,NaN,NaN,0.45864095137746713,0.8594077272580801,NaN,-0.05595218681929787,0.18138209439528197,0.23733428121457983,7.134377032543179,-0.16708439249986232,NaN,NaN,NaN,6768099
809098200,56.09375,56.21875,55.8125,56.125,NaN,NaN,55.880250363636364,57.46342759162304,50.524138400000055,53.76031030000006,55.48499780000006,56.09843499999994,55.294203801349205,55.99164952026233,56.05768923076924,56.32605845672916,55.789320004809326,50.524138400000055,53.76031030000006,55.48499780000006,56.09843499999994,56.052083333333336,220200,315970,55.28256578025318,NaN,1.5,2.75,NaN,NaN,0.4548987405647909,0.6969016045827136,NaN,-0.05115080307323336,0.17339577737303813,0.2245465804462715,7.237926154433404,0.055710306406685235,NaN,NaN,NaN,6988299
809184600,56.17187,56.20312,55.92187,55.92187,NaN,NaN,55.945733272727274,57.51103884816754,50.57140400000006,53.818435300000054,55.52468520000006,56.08515349999993,55.31881816208061,55.985003851665915,56.05288153846155,56.328474497938956,55.77728857898414,50.57140400000006,53.818435300000054,55.52468520000006,56.08515349999993,56.01561999999999,176500,316405,50.91881315010264,NaN,1.5,2.75,NaN,NaN,0.4424952590958773,0.5578293642641551,NaN,-0.06047040950271512,0.1489585685678776,0.20942897807059271,7.537693619728263,-0.08376102735902015,NaN,NaN,NaN,6811799
809271000,55.9375,56.09375,55.75,55.98437,NaN,NaN,56.01121618181818,57.558650104712044,50.617185250000055,53.87593530000006,55.566560200000055,56.051559499999925,55.344918234155884,55.98494348484059,56.04326615384616,56.31902706996714,55.76750523772518,50.617185250000055,53.87593530000006,55.566560200000055,56.051559499999925,55.94270666666667,167400,315390,52.16983373256313,NaN,1.5,2.75,NaN,NaN,0.43544202630331463,0.530771425853705,NaN,-0.06106251950117941,0.13310082869411843,0.19416334819529785,7.469710588177201,0.5895474452554716,NaN,NaN,NaN,6979199
809357400,56.07812,56.39062,56.07812,56.29687,NaN,NaN,56.07669909090909,57.60626136125654,50.66413835000006,53.933279000000056,55.609997600000064,56.051559499999925,55.382249675953695,56.01465077199863,56.05768923076924,56.363722981893325,55.75165547964516,50.66413835000006,53.933279000000056,55.609997600000064,56.051559499999925,56.25520333333333,195000,304360,57.942162110437,NaN,1.5,2.75,NaN,NaN,0.43335688156736357,0.640688658167959,NaN,-0.04005977464381219,0.14408862989053262,0.1841484045343448,7.133397332863728,0.25040845854201166,NaN,NaN,NaN,7174199
809616600,56.45312,56.45312,56,56.09375,NaN,NaN,56.142182,57.65387261780104,50.71171650000006,53.988591500000055,55.65249760000006,56.04843449999993,55.41015164944571,56.02218403180829,56.05768923076924,56.363722981893325,55.75165547964516,50.71171650000006,53.988591500000055,55.65249760000006,56.04843449999993,56.18229,293000,301885,53.42868759316917,NaN,1.5,2.75,NaN,NaN,0.4347685328839804,0.97056826274906,NaN,-0.039437151203478515,0.13485196552999668,0.1742891167334752,5.585144773902299,0.08364427844052949,NaN,NaN,NaN,6881199
809703000,56.15625,56.25,55.76562,56.23437,NaN,NaN,56.20766490909091,57.70148387434555,50.76085710000006,54.04343520000006,55.68562260000006,56.057027999999924,55.44247393770274,56.04239221925511,56.078121538461545,56.39301483543643,55.76322824148666,50.76085710000006,54.04343520000006,55.68562260000006,56.057027999999924,56.08333,1133100,351490,55.98490078734153,NaN,1.5,2.75,NaN,NaN,0.43831220910655333,3.2237047995675554,NaN,-0.029594462982770825,0.13729603800501167,0.1668905009877825,5.633168505794,0.05560189541078858,NaN,NaN,NaN,8014299
809789400,56.28125,56.42187,56.21875,56.35937,NaN,NaN,56.27314781818182,57.74909513089005,50.808435200000055,54.09999770000006,55.724060000000065,56.07812149999992,55.478430646028116,56.07258057932606,56.1322076923077,56.37102455694882,55.893390827666586,50.808435200000055,54.09999770000006,55.724060000000065,56.07812149999992,56.33333,437400,361340,58.182191248050145,NaN,1.5,2.75,NaN,NaN,0.4215127655989423,1.2104942713234073,NaN,-0.015418166902207375,0.14761779236002326,0.16303595926223063,5.552382499308786,0.4455583799996329,NaN,NaN,NaN,8451699
809875800,56.34375,56.5,56.29687,56.40625,NaN,NaN,56.33863072727272,57.796706387434554,50.85702895000006,54.15609150000006,55.764060000000065,56.102340499999926,55.5148157187329,56.10435861939024,56.15143846153847,56.43158804781728,55.87128887525966,50.85702895000006,54.15609150000006,55.764060000000065,56.102340499999926,56.40104,491900,326255,59.0086856238899,NaN,1.5,2.75,NaN,NaN,0.40591399662758937,1.5077163568374432,NaN,-0.00421908901307072,0.15776209799589225,0.16198118700896297,5.4156134242374465,0.41725511363606305,NaN,NaN,NaN,8943599
809962200,56.39062,56.75,56.34375,56.65625,NaN,NaN,56.40411363636363,57.84431764397905,50.906091450000055,54.216404000000054,55.794685000000065,56.13593449999993,55.55957784741004,56.156919703257834,56.19831384615385,56.57876197224034,55.81786572006736,50.906091450000055,54.216404000000054,55.794685000000065,56.13593449999993,56.58333333333334,629900,345725,63.18713666660116,NaN,1.5,2.75,NaN,NaN,0.40593799686847587,1.821968327427869,NaN,0.017499112055360616,0.18385507707816373,0.16635596502280312,5.860068619713187,1.143663142530604,NaN,NaN,NaN,9573499
810307800,56.82812,57.21875,56.73437,57.1875,NaN,NaN,56.46959654545454,57.89192890052356,50.95937270000006,54.28031030000005,55.83812260000006,56.18984099999993,55.62341793182533,56.25507020770947,56.274035384615395,56.924321689349306,55.623749079881485,50.95937270000006,54.28031030000005,55.83812260000006,56.18984099999993,57.04687333333334,272200,349680,70.15030623998913,NaN,1.5,2.75,NaN,NaN,0.41712099709215616,0.7784259894760924,NaN,0.06258082568830842,0.24458199713318862,0.1820011714448802,7.095467618100152,1.8930957683741647,NaN,NaN,NaN,9845699
810394200,57.23437,57.35937,57.21875,57.29687,NaN,NaN,56.53507945454545,57.93954015706806,51.01351330000006,54.342497800000054,55.89687260000006,56.24921599999993,55.6890435031263,56.354289235546666,56.36538153846155,57.203866859236136,55.52689621768696,51.01351330000006,54.342497800000054,55.89687260000006,56.24921599999993,57.29166333333333,214500,312810,71.35171276918445,NaN,1.5,2.75,NaN,NaN,0.3996030687284306,0.6857197659921358,NaN,0.09287704807566183,0.2980974815394575,0.20522043346379565,7.095751864162523,2.458787590615264,NaN,NaN,NaN,10060199
810480600,57.35937,57.39062,57.25,57.32812,NaN,NaN,56.600562363636364,57.987151413612565,51.07015390000006,54.40796650000006,55.958435000000065,56.31093449999993,55.75332101280762,56.44703502263746,56.454323846153855,57.42647710951978,55.48217058278793,51.07015390000006,54.40796650000006,55.958435000000065,56.31093449999993,57.32291333333333,258800,320395,71.70217375359081,NaN,1.5,2.75,NaN,NaN,0.38110427810497116,0.8077529299770596,NaN,0.10712071147606078,0.33912132280887164,0.23200061133281086,6.223551465275393,2.400223490949349,NaN,NaN,NaN,10318999
810567000,57.54687,57.54687,57.17187,57.54687,NaN,NaN,56.666045272727274,58.034762670157065,51.13288825000006,54.47734150000006,56.018747400000066,56.38984049999992,55.82365626720732,56.5517812109577,56.572112307692315,57.66648235426388,55.47774226112075,51.13288825000006,54.47734150000006,56.018747400000066,56.38984049999992,57.421869999999984,107300,311720,74.09145241787837,NaN,1.5,2.75,NaN,NaN,0.38066825824033035,0.34421917105094313,NaN,0.12227792771726942,0.38484802097939763,0.2625700932621282,6.198973504307909,2.2203721094973843,NaN,NaN,NaN,10426299
810826200,57.64062,57.8125,57.64062,57.70312,NaN,NaN,56.73152818181818,58.08237392670157,51.19515385000006,54.54874770000006,56.08405980000007,56.49218399999992,55.89736072731684,56.661432524199824,56.693506153846165,57.906264456112716,55.480747851579615,51.19515385000006,54.54874770000006,56.08405980000007,56.49218399999992,57.71874666666667,260700,311895,75.67155310491516,NaN,1.5,2.75,NaN,NaN,0.37245123979459255,0.8358582215168566,NaN,0.13294587473900404,0.42875243668588325,0.2958065619468792,5.936394922238517,2.8690718662952617,NaN,NaN,NaN,10686999
810912600,57.71875,57.96875,57.57812,57.96875,NaN,NaN,56.79701109090909,58.12998518324607,51.25765385000006,54.622029000000055,56.15530980000007,56.58280899999992,55.97859167918676,56.78593895046651,56.85095846153847,58.15049474661561,55.55142217646133,51.25765385000006,54.622029000000055,56.15530980000007,56.58280899999992,57.83854,139500,306130,78.1151372644826,NaN,1.5,2.75,NaN,NaN,0.37374972266640744,0.4556887596772613,NaN,0.14691816890240533,0.47945427307488586,0.33253610417248053,4.575002010704243,3.0841992183783717,NaN,NaN,NaN,10826499
810999000,57.90625,58.3125,57.89062,58.23437,NaN,NaN,56.862494,58.17759643979058,51.32046635000006,54.69546650000006,56.22780980000007,56.69218399999992,56.067053574120614,56.92388476470779,57.024035384615395,58.41211775347489,55.6359530157559,51.32046635000006,54.69546650000006,56.22780980000007,56.69218399999992,58.14583,239800,315900,80.25123532004714,NaN,1.5,2.75,NaN,NaN,0.37718759961880705,0.7591009813232036,NaN,0.16189361868814206,0.5349031275326581,0.37300950884451606,4.599081123913085,3.3268647254218777,NaN,NaN,NaN,11066299
811085400,58.4375,58.8125,58.28125,58.76562,NaN,NaN,56.92797690909091,58.225207696335076,51.386013200000065,54.76827900000006,56.30687220000007,56.82030899999992,56.17287970846883,57.099288120449906,57.21393923076924,58.81177753101811,55.616100930520375,51.386013200000065,54.76827900000006,56.30687220000007,56.82030899999992,58.619789999999995,457600,320035,83.6818447197077,NaN,1.5,2.75,NaN,NaN,0.3915406282174638,1.4298436108550627,NaN,0.19329568689525617,0.6146291174635863,0.4213334305683301,5.498356604373298,4.182816620498612,NaN,NaN,NaN,11523899
811171800,58.40625,58.57812,58.20312,58.4375,NaN,NaN,56.99345981818182,58.27281895287958,51.45023195000006,54.839216500000056,56.36530980000007,56.93671549999992,56.261688347352404,57.22673687088325,57.3942276923077,58.974613182886536,55.81384220172887,51.45023195000006,54.839216500000056,56.36530980000007,56.93671549999992,58.40624666666667,431200,323905,75.01434022843627,NaN,1.5,2.75,NaN,NaN,0.4037520119162164,1.3312545345085751,NaN,0.1780639472624173,0.6439133646463517,0.4658494173839344,7.716197555395186,3.1439602868174297,NaN,NaN,NaN,11092699
811431000,58.23437,58.26562,57.9375,58.21875,NaN,NaN,57.05894272727272,58.32043020942408,51.51562260000006,54.90749780000006,56.41437240000007,57.03905949999993,56.33843586314251,57.32121431175151,57.54687230769231,59.030000158273715,56.06374445711091,51.51562260000006,54.90749780000006,56.41437240000007,57.03905949999993,58.14062333333334,307500,335010,69.82208885891421,NaN,1.5,2.75,NaN,NaN,0.4106268682079152,0.9178830482672159,NaN,0.14097540742058756,0.6420686766596688,0.5010932692390813,8.729478280972291,1.8032786885245902,NaN,NaN,NaN,10785199
811517400,58.32812,58.53125,58.125,58.5,NaN,NaN,57.12442563636363,58.36804146596859,51.58031010000006,54.97734160000005,56.46843500000006,57.16327849999993,56.42320308419574,57.433479615394226,57.71153615384616,59.10323992613861,56.31983238155371,51.58031010000006,54.97734160000005,56.46843500000006,57.16327849999993,58.385416666666664,549600,349155,72.46135472160886,NaN,1.5,2.75,NaN,NaN,0.4103142347644927,1.5740860076470335,NaN,0.12371921162769328,0.6557422837736979,0.5320230721460046,7.817169191753469,2.099818017982486,NaN,NaN,NaN,11334799
811603800,58.59375,58.78125,58.54687,58.78125,NaN,NaN,57.18990854545454,58.41565272251309,51.64616950000006,55.04921660000005,56.53343500000006,57.29609099999993,56.5156755122665,57.561838699642394,57.89422846153847,59.17140678838585,56.617050134691084,51.64616950000006,55.04921660000005,56.53343500000006,57.29609099999993,58.703123333333345,290800,352685,74.83180434351262,NaN,1.5,2.75,NaN,NaN,0.40109536085274317,0.8245318060025235,NaN,0.11951616205717441,0.6814182747174726,0.5619021126602982,7.942806102416163,2.5347595560433547,NaN,NaN,NaN,11625599
811690200,58.70312,58.75,58.0625,58.29687,NaN,NaN,57.25539145454545,58.46326397905759,51.70945075000006,55.11765410000005,56.574997400000065,57.41484099999993,56.58552627649134,57.63184168062883,58.020430000000005,59.09084765027729,56.95001234972272,51.70945075000006,55.11765410000005,56.574997400000065,57.41484099999993,58.36979,508500,369285,64.52969560568499,NaN,1.5,2.75,NaN,NaN,0.42378497793469005,1.3769852552906292,NaN,0.0745817830033848,0.6551293414145292,0.5805475584111444,10.07961502853332,1.3032854784282795,NaN,NaN,NaN,11117099
811776600,57.82812,58.375,57.78125,58.3125,NaN,NaN,57.320874363636364,58.51087523560209,51.77445075000006,55.185154100000055,56.61937240000007,57.531247499999935,56.65325073623678,57.69666628247371,58.10696846153847,59.070616506984344,57.1433204160926,51.77445075000006,55.185154100000055,56.61937240000007,57.531247499999935,58.15625,449900,383410,64.69858000989834,NaN,1.5,2.75,NaN,NaN,0.43592533665364075,1.1734174904149606,NaN,0.03821281324266845,0.6283135749644799,0.5901007617218115,10.01019818780849,1.0560607468019088,NaN,NaN,NaN,11566999
812035800,58.375,58.375,58.01562,58.21875,NaN,NaN,57.386357272727274,58.55848649214659,51.84116950000006,55.24452910000005,56.662810000000064,57.62734149999994,56.71464286422749,57.74638854128573,58.177882307692315,59.020747128282515,57.335017487102114,51.84116950000006,55.24452910000005,56.662810000000064,57.62734149999994,58.20312333333334,130000,380160,62.76812032792836,NaN,1.5,2.75,NaN,NaN,0.4304578126069522,0.34196127946127947,NaN,0.002051526779606405,0.5926651701963195,0.5906136434167131,10.097160091895379,0.431266846361186,NaN,NaN,NaN,11436999
812122200,58.39062,58.53125,58.0625,58.20312,NaN,NaN,57.45184018181818,58.6060977486911,51.90695075000006,55.30406030000005,56.699685000000066,57.73280999999994,56.77301451661073,57.789886775449,58.24519000000001,58.930983268825145,57.55939673117487,51.90695075000006,55.30406030000005,56.699685000000066,57.73280999999994,58.26562333333334,466600,388840,62.433650382108546,NaN,1.5,2.75,NaN,NaN,0.43319296884931274,1.199979425984981,NaN,-0.027103193372957413,0.5567346517005163,0.5838378450734737,9.827212377042146,-0.053662467714512926,NaN,NaN,NaN,10970399
812208600,57.95312,58.1875,57.59375,58.15625,NaN,NaN,57.51732309090909,58.6537090052356,51.97101325000006,55.363747800000056,56.74531000000006,57.828903999999945,56.82725904537109,57.82477851112052,58.29206538461539,58.852342762048835,57.73178800718195,51.97101325000006,55.363747800000056,56.74531000000006,57.828903999999945,57.979166666666664,654400,364905,61.377447235514815,NaN,1.5,2.75,NaN,NaN,0.44577704250293315,1.7933434729587152,NaN,-0.05226988505311736,0.518500488757077,0.5707703738101944,9.471585332189953,-1.0369498356351867,NaN,NaN,NaN,10315999
812295000,58.20312,58.59375,58.15625,58.59375,NaN,NaN,57.582806,58.701320261780104,52.03640390000006,55.42406030000006,56.81187260000006,57.940622999999945,56.89653320045458,57.898013891013804,58.36057538461539,58.82577998268947,57.89537078654131,52.03640390000006,55.42406030000006,56.81187260000006,57.940622999999945,58.447916666666664,456200,365845,66.99090140222162,NaN,1.5,2.75,NaN,NaN,0.44518582518129507,1.246976178436223,NaN,-0.04258718271936135,0.5175363954109926,0.560123578130354,8.936690196726552,0.26737967914438504,NaN,NaN,NaN,10772199
812381400,58.54687,58.90625,58.40625,58.48437,NaN,NaN,57.64828890909091,58.7489315183246,52.10007575000006,55.48374780000005,56.872185000000066,58.04452899999994,56.95880131024067,57.95385732996487,58.400238461538464,58.809627004745685,57.99084991833124,52.10007575000006,55.48374780000005,56.872185000000066,58.04452899999994,58.59895666666668,606600,371580,64.46812483100709,NaN,1.5,2.75,NaN,NaN,0.44910112338263114,1.6324882932342968,NaN,-0.046372677803556916,0.5021577308759078,0.5485304086794647,8.365724856627969,0.45624476650563334,NaN,NaN,NaN,10165599
812640600,58.48437,58.625,58.04687,58.1875,NaN,NaN,57.71377181818182,58.79654277486911,52.16156015000006,55.53984160000005,56.927810000000065,58.12109149999994,57.00698557258418,57.976109012825354,58.39663307692308,58.812574272790584,57.98069188105558,52.16156015000006,55.53984160000005,56.927810000000065,58.12109149999994,58.28645666666667,293100,354740,58.07563545584593,NaN,1.5,2.75,NaN,NaN,0.4583174717124433,0.8262389355584372,NaN,-0.07026081727567812,0.46070438708486705,0.5309652043605452,8.620744291244973,-0.5341880341880342,NaN,NaN,NaN,9872499
812727000,58.1875,58.34375,57.95312,58.25,NaN,NaN,57.77925472727272,58.84415403141361,52.22406015000006,55.59515410000005,56.97656000000006,58.17421649999994,57.055731236404405,58.00219386874675,58.356970000000004,58.7195130856085,57.99442691439151,52.22406015000006,55.59515410000005,56.97656000000006,58.17421649999994,58.18229,839700,383115,58.99743064417797,NaN,1.5,2.75,NaN,NaN,0.4534826523044117,2.1917700951411456,NaN,-0.08240235659176609,0.4279622586208376,0.5103646152126037,8.099484018933179,-0.9037745879851143,NaN,NaN,NaN,10712199
812813400,58.28125,58.28125,58.10937,58.1875,NaN,NaN,57.84473763636363,58.891765287958115,52.28593515000006,55.64952910000005,57.01562260000006,58.21874799999995,57.10011432517286,58.019842071723254,58.33773923076923,58.70760371600675,57.96787474553171,52.28593515000006,55.64952910000005,57.01562260000006,58.21874799999995,58.19270666666667,248800,384830,57.63277780246351,NaN,1.5,2.75,NaN,NaN,0.43336817713981096,0.6465192422628173,NaN,-0.09433427128387428,0.3924467761077608,0.4867810473916351,7.384678697706227,-0.18760870008972766,NaN,NaN,NaN,10463399
812899800,58.25,58.35937,58.09375,58.35937,NaN,NaN,57.91022054545454,58.939376544502615,52.349372650000056,55.70312280000005,57.059060000000066,58.27031049999995,57.14949690065628,58.052178064892466,58.34855615384616,58.71203825544401,57.985074052248315,52.349372650000056,55.70312280000005,57.059060000000066,58.27031049999995,58.27083,268800,385330,60.34889861678294,NaN,1.5,2.75,NaN,NaN,0.4213861644869672,0.697583889133989,NaN,-0.09033735388300446,0.3738593550378795,0.46419670892088394,6.03638926188698,0.08037727759913983,NaN,NaN,NaN,10732199
812986200,58.39062,58.57812,58.39062,58.40625,NaN,NaN,57.97570345454545,58.98698780104712,52.41062265000006,55.75687280000005,57.09406000000006,58.31327949999995,57.198781335924664,58.085899201569376,58.34134461538462,58.69613806936968,57.98655116139956,52.41062265000006,55.75687280000005,57.09406000000006,58.31327949999995,58.45833,75300,383730,61.08179752676036,NaN,1.5,2.75,NaN,NaN,0.4069121527378981,0.19623172543194434,NaN,-0.08433675083146275,0.3587757703815555,0.44311252121301825,6.0493654386028135,0.322061191626409,NaN,NaN,NaN,10807499
813245400,58.1875,58.21875,57.8125,57.92187,NaN,NaN,58.04118636363636,59.03459905759162,52.47015390000006,55.80781030000006,57.12656000000006,58.324216999999955,57.227137754123696,58.07027737284848,58.275238461538464,58.59616820834794,57.95430871472899,52.47015390000006,55.80781030000006,57.12656000000006,58.324216999999955,57.98437333333334,358200,388605,50.662096425216546,NaN,1.5,2.75,NaN,NaN,0.4202577132566197,0.9217585980622998,NaN,-0.11110638952446372,0.3042295343074386,0.4153359238319023,7.7526811579851485,-0.4832215180217143,NaN,NaN,NaN,10449299
813331800,57.32812,57.89062,57.26562,57.89062,NaN,NaN,57.26562,59.08221031413613,52.52929450000006,55.86609150000006,57.161247400000065,58.32031049999995,57.253156665726685,58.05316714686291,58.243988461538464,58.62407137061737,57.863905552459556,52.52929450000006,55.86609150000006,57.161247400000065,58.32031049999995,57.68228666666666,360800,399670,50.06868198099505,NaN,1.5,2.75,NaN,NaN,0.4371143051668612,0.9027447644306553,NaN,-0.12784154024090383,0.2555339985307725,0.38337553877167635,7.751139913144267,-0.4567522837184337,NaN,NaN,NaN,10088499
813418200,58.09375,58.09375,57.875,58.07812,NaN,NaN,57.31058951219512,59.129821570680626,52.58812260000006,55.925935200000055,57.20155980000007,58.31249799999995,57.28550816903152,58.05554360906644,58.225959230769234,58.613494889586974,57.838423571951495,52.58812260000006,55.925935200000055,57.20155980000007,58.31249799999995,58.01562333333333,228100,399085,53.58184847171567,NaN,1.5,2.75,NaN,NaN,0.42151685479779966,0.5715574376385983,NaN,-0.12315849334989026,0.22942742208431355,0.3525859154342038,8.040633014826055,-0.8800085333333361,NaN,NaN,NaN,10316599
813504600,58.125,58.46875,58.125,58.4375,NaN,NaN,57.355559024390246,59.17743282722513,52.64991950000006,55.98359150000006,57.25155980000007,58.29609199999995,57.33068431926558,58.09192040820297,58.24278615384616,58.646276413721765,57.83929589397056,52.64991950000006,55.98359150000006,57.25155980000007,58.29609199999995,58.34375,199800,386195,59.46835047228349,NaN,1.5,2.75,NaN,NaN,0.4193106508836712,0.5173552221028237,NaN,-0.09404674501863564,0.23502748416090924,0.3290742291795449,7.605598256872437,-0.08014107016968536,NaN,NaN,NaN,10516399
813591000,58.70312,58.85937,58.625,58.625,NaN,NaN,57.40052853658536,59.22504408376963,52.71249765000006,56.03827900000006,57.30562240000007,58.30546699999995,57.38144179694144,58.142689893136016,58.275238461538464,58.7258576279689,57.82461929510803,52.71249765000006,56.03827900000006,57.30562240000007,58.30546699999995,58.70312333333334,488100,389040,62.1642508673944,NaN,1.5,2.75,NaN,NaN,0.41949346153483746,1.2546267735965453,NaN,-0.06190427434101331,0.25169388625327827,0.3135981605942916,7.769563321853713,0.7518796992481203,NaN,NaN,NaN,11004499
813850200,58.45312,58.5625,58.34375,58.34375,NaN,NaN,57.445498048780486,59.27265534031413,52.77640390000006,56.090466500000055,57.35281000000006,58.31171699999995,57.41917937353197,58.16183847474211,58.289661538461544,58.73610683453589,57.8432162423872,52.77640390000006,56.090466500000055,57.35281000000006,58.31171699999995,58.416666666666664,443600,395845,56.133045565061536,NaN,1.5,2.75,NaN,NaN,0.40961892856806337,1.1206406548017531,NaN,-0.059320604588733616,0.23944740485837457,0.2987680094471082,7.700817958643812,0.1609442060085837,NaN,NaN,NaN,10560899
813936600,58.40625,58.79687,58.29687,58.73437,NaN,NaN,57.49046756097561,59.32026659685864,52.84116950000006,56.146091500000054,57.405310000000064,58.323435499999945,57.47075547653071,58.21636528667143,58.30047846153847,58.781356922229705,57.81960000084723,52.84116950000006,56.146091500000054,57.405310000000064,58.323435499999945,58.60937,146000,375665,61.69207154048954,NaN,1.5,2.75,NaN,NaN,0.41607471938463025,0.38864413772909373,NaN,-0.03238688139870144,0.2582844076987314,0.29067128909743284,8.53778104073123,0.9398410311492991,NaN,NaN,NaN,10706899
814023000,59.01562,59.09375,58.71875,58.90625,NaN,NaN,57.53543707317073,59.367877853403144,52.90570075000006,56.20952900000006,57.461247600000064,58.32968549999995,57.527049379411864,58.28206859270273,58.33293076923077,58.906983938754145,57.7588775997074,52.90570075000006,56.20952900000006,57.461247600000064,58.32968549999995,58.90625,228100,372530,63.86216719240369,NaN,1.5,2.75,NaN,NaN,0.4131408108571567,0.6122996805626393,NaN,-0.005488586257872241,0.28381055627509255,0.2892991425329648,8.520067701917545,0.9370903078631616,NaN,NaN,NaN,10934999
814109400,58.875,59.1875,58.79687,59.1875,NaN,NaN,57.58040658536585,59.41548910994764,52.97163825000006,56.27593530000006,57.52312260000006,58.37421699999995,57.592165090023165,58.36830015530247,58.40985384615385,59.13377708247693,57.68593060983077,52.97163825000006,56.27593530000006,57.52312260000006,58.37421699999995,59.05729,500600,372135,67.14221629373222,NaN,1.5,2.75,NaN,NaN,0.41153289579593133,1.3452107434130087,NaN,0.02696969767951879,0.3230112646323633,0.2960415669528445,8.715041451215136,1.337613697164259,NaN,NaN,NaN,11435599
814195800,59.14062,59.1875,58.82812,58.82812,NaN,NaN,57.625376097560974,59.46310036649214,53.03554450000006,56.32781030000005,57.58031000000006,58.39999799999995,57.64063391002226,58.41209252146414,58.45432461538462,59.20407219372957,57.70457703703967,53.03554450000006,56.32781030000005,57.58031000000006,58.39999799999995,58.947913333333325,748400,387060,59.68724720732047,NaN,1.5,2.75,NaN,NaN,0.40780768895336494,1.9335503539502918,NaN,0.0202663786330049,0.3213745402441006,0.3011081616110957,9.726851944702519,1.5646076343874948,NaN,NaN,NaN,10687199
814455000,58.54687,58.8125,58.54687,58.70312,NaN,NaN,57.6703456097561,59.51071162303665,53.09859135000006,56.379841500000055,57.64124740000007,58.42421649999994,57.682300031197855,58.43980942418184,58.4939876923077,59.237606151922506,57.75036923269289,53.09859135000006,56.379841500000055,57.64124740000007,58.42421649999994,58.68749666666667,533000,407210,57.303964113050235,NaN,1.5,2.75,NaN,NaN,0.3987678540281246,1.3089069521868324,NaN,0.004280117452846066,0.30645830842715327,0.3021781909743072,8.141737292348884,1.4035088931505657,NaN,NaN,NaN,10154199
814541400,58.78125,58.84375,58.625,58.76562,NaN,NaN,57.71531512195122,59.55832287958115,53.16171635000006,56.43202900000006,57.69343480000007,58.452341499999946,57.72478316722931,58.470839002831184,58.5252376923077,59.2776930002191,57.772782384396294,53.16171635000006,56.43202900000006,57.69343480000007,58.452341499999946,58.744789999999995,172200,392490,58.20262892605997,NaN,1.5,2.75,NaN,NaN,0.38590943588325854,0.43873729266987693,NaN,-0.004730429076747922,0.29626515462837233,0.30099558370512025,8.058066847002596,1.1837504382028896,NaN,NaN,NaN,10326399
814627800,58.8125,58.89062,58.28125,58.28125,NaN,NaN,57.76028463414634,59.605934136125654,53.22226325000006,56.47609150000006,57.738122400000066,58.45859149999994,57.74660539596542,58.45278290732345,58.51562230769231,59.27705500966492,57.7541896057197,53.22226325000006,56.47609150000006,57.738122400000066,58.45859149999994,58.48437333333334,302700,374905,49.506017319897445,NaN,1.5,2.75,NaN,NaN,0.40187090474874,0.807404542484096,NaN,-0.04378556927433419,0.24626362211220254,0.29004919138653673,9.689594046291553,-0.26737967914438504,NaN,NaN,NaN,10023699
814714200,58.375,58.42187,57.28125,57.75,NaN,NaN,57.80525414634146,59.65354539267015,53.28007575000006,56.51577900000006,57.76906000000006,58.41640399999994,57.746738517692265,58.38585120186408,58.50240153846154,59.309227738479194,57.69557533844389,53.28007575000006,56.51577900000006,57.76906000000006,58.41640399999994,57.81770666666668,606800,382435,42.079511113299375,NaN,1.5,2.75,NaN,NaN,0.45463869726668704,1.5866748597800933,NaN,-0.10251671964828696,0.16190329182617802,0.264420011474465,10.292591222166346,-1.492537313432836,NaN,NaN,NaN,9416899
814800600,57.6875,58.1875,57.42187,58.1875,NaN,NaN,57.850223658536585,59.70115664921466,53.33734140000006,56.56265400000006,57.81062260000006,58.401560499999945,57.76402328170433,58.36696061121036,58.525238461538464,59.27639227816396,57.77408464491297,53.33734140000006,56.56265400000006,57.81062260000006,58.401560499999945,57.93229000000001,905800,397395,48.880567567872994,NaN,1.5,2.75,NaN,NaN,0.47685236174763806,2.2793442292932724,NaN,-0.10844460989746502,0.12886424910263372,0.23730885900009874,11.227035216578969,-0.2678093197643278,NaN,NaN,NaN,10322699
815063400,58.32812,58.59375,58.32812,58.5625,NaN,NaN,57.89519317073171,59.74876790575916,53.39507580000006,56.614529000000054,57.85843520000006,58.42031049999995,57.79533609418652,58.38558341014271,58.56249846153847,59.26790171501728,57.857095208059654,53.39507580000006,56.614529000000054,57.85843520000006,58.42031049999995,58.49479,488700,407175,53.87948748544287,NaN,1.5,2.75,NaN,NaN,0.47180933590852103,1.200221035181433,NaN,-0.08470712665389085,0.1314249506827352,0.21613207733662604,11.584679749816647,-0.29262253089630214,NaN,NaN,NaN,10811399
815149800,58.71875,58.84375,58.3125,58.3125,NaN,NaN,57.940162682926825,59.796379162303666,53.45148205000006,56.667029000000056,57.904372800000054,58.42343549999995,57.8156170316694,58.37862308536721,58.55288307692308,59.26817804133329,57.83758811251287,53.45148205000006,56.667029000000056,57.904372800000054,58.42343549999995,58.489583333333336,508200,390600,50.34489750909591,NaN,1.5,2.75,NaN,NaN,0.476055097629341,1.3010752688172043,NaN,-0.08331329532471304,0.11199045818073472,0.19530375350544776,11.10167894785454,-1.0079575596816976,NaN,NaN,NaN,10303199
815236200,58.28125,58.78125,58.23437,58.78125,NaN,NaN,57.98513219512195,59.843990418848165,53.51046645000006,56.72124780000006,57.957497800000056,58.45312299999995,57.85348499121177,58.41696850580843,58.564902307692314,59.28982670184508,57.83997791353955,53.51046645000006,56.72124780000006,57.957497800000056,58.45312299999995,58.59895666666667,415700,398945,56.153084484571636,NaN,1.5,2.75,NaN,NaN,0.48111401922724534,1.0419982704382809,NaN,-0.04993826536694318,0.1328809217967688,0.18281918716371198,12.052396410766146,-0.6863780359028511,NaN,NaN,NaN,10718899
815322600,58.6875,59.15625,58.6875,59.15625,NaN,NaN,58.03010170731707,59.89160167539267,53.57265395000006,56.77343530000005,58.022185400000055,58.49296699999995,57.90457381508582,58.48737626716,58.627402307692314,59.403571891862114,57.851232723522514,53.57265395000006,56.77343530000005,58.022185400000055,58.49296699999995,59,326000,401805,60.16721969759241,NaN,1.5,2.75,NaN,NaN,0.4802308749967278,0.8113388335137691,NaN,-0.004136700482220285,0.17764831156093663,0.18178501204315692,12.324556210589813,0.5577774710461623,NaN,NaN,NaN,11044899
815409000,59.23437,59.25,59.0625,59.23437,NaN,NaN,58.075071219512196,59.93921293193717,53.63609145000006,56.826872800000054,58.08718540000005,58.534372999999945,57.956722685082454,58.55851852743048,58.66586384615385,59.50631508010148,57.825412612206215,53.63609145000006,56.826872800000054,58.08718540000005,58.534372999999945,59.18229,615000,428790,60.968860529638164,NaN,1.5,2.75,NaN,NaN,0.4593215267826758,1.4342685230532428,NaN,0.028115822380948674,0.21692979001934276,0.1888139676383941,11.716352830867834,0.9049774526464692,NaN,NaN,NaN,11659899
815668200,59.21875,59.21875,59.01562,59.03125,NaN,NaN,58.12004073170731,59.98682418848168,53.697810200000056,56.87593530000006,58.141873000000054,58.589841999999955,57.99886101115765,58.6035405724371,58.675479230769234,59.52946247947451,57.82149598206396,53.697810200000056,56.87593530000006,58.141873000000054,58.589841999999955,59.08854000000001,311200,426440,57.71638904276367,NaN,1.5,2.75,NaN,NaN,0.4421378462981989,0.7297626864271645,NaN,0.032173176231783784,0.22903043792812383,0.19685726169634005,11.854230066676537,0.4520159916631554,NaN,NaN,NaN,11348699
815754600,59,59,58.625,58.8125,NaN,NaN,58.16501024390244,60.034435445026176,53.75812270000006,56.92437280000006,58.196248000000054,58.63593599999996,58.030768422484805,58.62344147030023,58.64663307692308,59.45352190347963,57.83974425036653,53.75812270000006,56.92437280000006,58.196248000000054,58.63593599999996,58.8125,358200,426310,54.353496692577494,NaN,1.5,2.75,NaN,NaN,0.4395744287054704,0.8402336328024208,NaN,0.017274851921499634,0.21845082659821458,0.20117597467671494,12.093433221799362,0.9115281501340483,NaN,NaN,NaN,10990499
815841000,58.89062,59.375,58.89062,59.34375,NaN,NaN,58.20997975609756,60.08204670157068,53.820466450000055,56.97202910000006,58.25843560000005,58.69921749999996,58.08225789611285,58.69204228265259,58.686296923076924,59.57183174836095,57.8007620977929,53.820466450000055,56.97202910000006,58.25843560000005,58.69921749999996,59.203123333333345,357200,432765,60.389623420664236,NaN,1.5,2.75,NaN,NaN,0.4483548266550797,0.8253902233313692,NaN,0.03910034553238159,0.25005140659219194,0.21095106105981035,11.784436783970158,2.75974025974026,NaN,NaN,NaN,11347699
815927400,59.57812,59.57812,59.28125,59.5625,NaN,NaN,58.254949268292684,60.12965795811518,53.883669600000054,57.02327910000005,58.32249820000005,58.755467499999966,58.14030660606921,58.77494301763805,58.75240307692308,59.753817042146565,57.750989111699596,53.883669600000054,57.02327910000005,58.32249820000005,58.755467499999966,59.47395666666667,503700,447960,62.58366990706681,NaN,1.5,2.75,NaN,NaN,0.43753448189400246,1.1244307527457809,NaN,0.0627673507779824,0.28941024953228833,0.22664289875430593,9.500771092593947,2.3630504833512354,NaN,NaN,NaN,11851399
816013800,59.23437,59.60937,59.21875,59.53125,NaN,NaN,58.2999187804878,60.17726921465969,53.94577900000006,57.074529100000056,58.38499820000005,58.80077999999996,58.1948534058312,58.846972254053476,58.81129769230769,59.895524978984646,57.727070405630734,53.94577900000006,57.074529100000056,58.38499820000005,58.80077999999996,59.45312333333334,795600,463335,62.05486034498183,NaN,1.5,2.75,NaN,NaN,0.4341834474730022,1.717116125481563,NaN,0.07025044087400309,0.3144559498468098,0.2442055089728067,9.24154251901329,1.6542155816435433,NaN,NaN,NaN,11055799
816273000,59.42187,59.65625,59.3125,59.46875,NaN,NaN,58.344888292682924,60.22488047120419,54.00859150000006,57.11796660000005,58.44124820000005,58.857029999999966,58.24481013501429,58.90618918223886,58.90264384615385,59.992930054577855,57.812357637729846,54.00859150000006,57.11796660000005,58.44124820000005,58.857029999999966,59.479166666666664,818500,482080,60.94569576744302,NaN,1.5,2.75,NaN,NaN,0.42772391551064487,1.6978509790906073,NaN,0.06504307358149886,0.32550935094968025,0.2604662773681814,9.009117032153384,1.9828510182207932,NaN,NaN,NaN,10237299
816359400,59.35937,59.48437,59.07812,59.07812,NaN,NaN,58.38985780487805,60.27249172774869,54.06851335000006,57.15859160000005,58.47906060000005,58.874217499999965,58.277488953249026,58.92256354583516,59.00480692307693,59.86947622788008,58.140137618273776,54.06851335000006,57.15859160000005,58.47906060000005,58.874217499999965,59.21353666666666,341800,491870,54.40089415696721,NaN,1.5,2.75,NaN,NaN,0.4261900644027417,0.6948990586943704,NaN,0.031065815901075322,0.29929854724452554,0.2682327313434502,9.629835255907356,0.5050419989367331,NaN,NaN,NaN,9895499
816445800,59.14062,59.6875,59.10937,59.67187,NaN,NaN,58.43482731707317,60.32010298429319,54.131482100000056,57.21171660000005,58.526560600000046,58.912498499999955,58.33217056292553,58.99392606527943,59.11898923076923,59.91074793948538,58.32723052205308,54.131482100000056,57.21171660000005,58.526560600000046,58.912498499999955,59.48958,584700,509700,61.218084435203885,NaN,1.5,2.75,NaN,NaN,0.439275059802546,1.1471453796350795,NaN,0.04358731891368478,0.3227168799855562,0.2791295610718714,10.187895318221443,0.8716238774432091,NaN,NaN,NaN,10480199
816532200,59.67187,60.0625,59.65625,60,NaN,NaN,58.47979682926829,60.36771424083769,54.194685250000056,57.26921660000006,58.57999820000005,58.95312349999996,58.397575638889236,59.08974263049092,59.22956615384616,60.07898430878428,58.380147998908036,54.194685250000056,57.26921660000006,58.57999820000005,58.95312349999996,59.90625,577700,513555,64.38682566257133,NaN,1.5,2.75,NaN,NaN,0.436916126959507,1.1249038564515972,NaN,0.06754635423941796,0.36356250387114386,0.2960161496317259,10.04698046021459,1.2925435013489661,NaN,NaN,NaN,11057899
816618600,60.09375,60.20312,60.01562,60.1875,NaN,NaN,58.52476634146341,60.4153254973822,54.255466500000054,57.325779100000055,58.632810800000044,59.021092499999966,58.46776875108966,59.194290951396546,59.373796923076924,60.187356175719295,58.56023767043455,54.255466500000054,57.325779100000055,58.632810800000044,59.021092499999966,60.13541333333333,267000,489485,66.09174178051794,NaN,1.5,2.75,NaN,NaN,0.42021640360525636,0.5454712606106418,NaN,0.08828961114778588,0.4063781635664583,0.3180885524186724,10.093551868067758,1.9587083112758072,NaN,NaN,NaN,11324899
816877800,60.28125,60.29687,59.85937,59.875,NaN,NaN,58.569735853658536,60.4629367539267,54.31366965000006,57.380154100000055,58.67624840000004,59.079686499999966,58.52295429026261,59.259120384596876,59.457931538461544,60.234348569497826,58.68151450742526,54.31366965000006,57.380154100000055,58.67624840000004,59.079686499999966,60.01041333333333,448800,485275,60.862091622969984,NaN,1.5,2.75,NaN,NaN,0.4214509462048809,0.924836432950389,NaN,0.07381982284858823,0.4103633309794077,0.33654350813081946,10.460066039914189,1.8065887353878853,NaN,NaN,NaN,10876099
816964200,59.9375,60.35937,59.92187,60.35937,NaN,NaN,58.61470536585366,60.510548010471204,54.37398215000005,57.43968530000006,58.724060800000046,59.15937399999997,58.59497059260525,59.363906062254316,59.550479230769234,60.43962915141325,58.66132931012522,54.37398215000005,57.43968530000006,58.724060800000046,59.15937399999997,60.21353666666666,119200,482625,65.42832180326064,NaN,1.5,2.75,NaN,NaN,0.4259451643331036,0.246982646982647,NaN,0.08872384167406472,0.44744831022340037,0.35872446854933565,10.52745131040916,1.7114186413902026,NaN,NaN,NaN,10995299
817050600,60.3125,60.375,60.17187,60.17187,NaN,NaN,58.659674878048776,60.558159267015704,54.433357150000056,57.49531030000006,58.76281080000004,59.25390499999996,58.656809785052104,59.440855008706286,59.62259461538462,60.548794944059445,58.6963942867098,54.433357150000056,57.49531030000006,58.76281080000004,59.25390499999996,60.23958,351600,485070,62.393666195087455,NaN,1.5,2.75,NaN,NaN,0.4100297954521678,0.7248438369719834,NaN,0.07817810707419226,0.456447102392076,0.3782689953178837,10.121118894913552,1.023076600209861,NaN,NaN,NaN,10643699
817223400,60.23437,60.32812,60.1875,60.32812,NaN,NaN,58.7046443902439,60.60577052356021,54.493513400000055,57.550466500000056,58.79406080000004,59.38281099999996,58.72235136210888,59.52535643644855,59.72235384615385,60.651655613703305,58.7930520786044,54.493513400000055,57.550466500000056,58.79406080000004,59.38281099999996,60.28124666666667,62400,457850,63.896451559014835,NaN,1.5,2.75,NaN,NaN,0.39190266720558437,0.13628917767827892,NaN,0.0739929231221863,0.4707601492206166,0.3967672260984303,10.050183205587217,1.3385742782152203,NaN,NaN,NaN,10706099
817482600,60.45312,60.64062,60.34375,60.34375,NaN,NaN,58.74961390243902,60.65338178010471,54.553435300000054,57.598747800000055,58.83218580000004,59.490623499999955,58.785935622418336,59.6032986805963,59.84014230769231,60.660018723562736,59.020265891821886,54.553435300000054,57.598747800000055,58.83218580000004,59.490623499999955,60.44270666666667,273000,426210,64.05120628383737,NaN,1.5,2.75,NaN,NaN,0.3862310481194712,0.6405293165341029,NaN,0.06487111862530454,0.477856124380061,0.41298500575475644,10.00884073167807,1.4713610089332632,NaN,NaN,NaN,10979099
817569000,60.29687,60.98437,60.15625,60.98437,NaN,NaN,58.79458341463415,60.700993036649216,54.61648215000005,57.65093530000006,58.887498200000046,59.611716999999956,58.87214873526467,59.734829282444274,59.966343846153855,60.93356735336038,58.99912033894733,54.61648215000005,57.65093530000006,58.887498200000046,59.611716999999956,60.70832999999999,479000,425725,69.77059734816144,NaN,1.5,2.75,NaN,NaN,0.417794544682366,1.1251394679664102,NaN,0.09287086338190365,0.529073584982136,0.4362027216002323,11.138587466678318,3.2266598869429157,NaN,NaN,NaN,11458099
817655400,61.09375,61.09375,60.84375,61.04687,NaN,NaN,58.83955292682926,60.748604293193715,54.67952900000006,57.70343530000005,58.93843560000005,59.74843549999995,58.95743192211704,59.85978554125911,60.08052615384616,61.172511275174266,58.98854103251805,54.67952900000006,57.70343530000005,58.93843560000005,59.74843549999995,60.99479,549200,427775,70.26760105700097,NaN,1.5,2.75,NaN,NaN,0.405809220062197,1.283852492548653,NaN,0.1055639438693784,0.5681576514369553,0.4625937075675769,9.617302774565957,2.304268326097372,NaN,NaN,NaN,12007299
817741800,61.04687,61.20312,60.84375,60.90625,NaN,NaN,58.88452243902439,60.79621554973822,54.740544650000054,57.75718530000005,58.980935600000045,59.854685499999945,59.03385616046539,59.95944882304396,60.18629538461539,61.31085824348272,59.06173252574806,54.740544650000054,57.75718530000005,58.980935600000045,59.854685499999945,60.98437333333334,286200,421300,67.57562081453862,NaN,1.5,2.75,NaN,NaN,0.4024921329148971,0.6793258960360788,NaN,0.09479446602274005,0.581086790096002,0.4862923240732619,9.047352781730655,1.5104166666666667,NaN,NaN,NaN,11721099
817828200,60.98437,61.07812,60.84375,60.98437,NaN,NaN,58.92949195121951,60.84382680628272,54.80226340000006,57.80484150000006,59.034685600000046,59.946091499999945,59.11034689927067,60.057060363706434,60.30288153846155,61.41994316237525,59.18581991454785,54.80226340000006,57.80484150000006,59.034685600000046,59.946091499999945,60.96874666666667,465200,428260,68.30213905330605,NaN,1.5,2.75,NaN,NaN,0.39048340913526147,1.0862560127025638,NaN,0.0836270850024784,0.5908261803263599,0.5071990953238815,8.781460199227055,1.323979231568014,NaN,NaN,NaN,12186299
818087400,61.125,61.73437,61.04687,61.73437,NaN,NaN,58.974461463414634,60.89143806282723,54.86866965000006,57.86124770000006,59.10312300000005,60.071091499999945,59.213249765965934,60.216804138591534,60.50720846153847,61.62514773094352,59.38926919213342,54.86866965000006,57.86124770000006,59.10312300000005,60.071091499999945,61.50520333333333,631700,429095,74.26419805638292,NaN,1.5,2.75,NaN,NaN,0.41616316562559996,1.47216816788823,NaN,0.11548292747102284,0.65155275466266,0.5360698271916372,10.689052685484604,3.105419624217116,NaN,NaN,NaN,12817999
818173800,61.67187,62.20312,61.625,62.14062,NaN,NaN,59.01943097560975,60.939049319371726,54.937185250000056,57.92218520000006,59.18156040000005,60.226559999999935,59.32804859867315,60.400024696820914,60.697112307692315,62.00545588421236,59.38876873117227,54.937185250000056,57.92218520000006,59.18156040000005,60.226559999999935,61.98958,567700,441920,76.8087285880313,NaN,1.5,2.75,NaN,NaN,0.42773151093805695,1.2846216509775525,NaN,0.15043442613370117,0.7241128598587636,0.5736784337250624,9.655159725264651,2.9510745390483697,NaN,NaN,NaN,13385699
818260200,62.29687,62.53125,62,62.28125,NaN,NaN,59.064400487804875,60.98666057591623,55.004607150000055,57.981404000000055,59.26312300000005,60.39999749999994,59.443860418333024,60.5791890114094,60.87259307692308,62.35960770362328,59.38557845022288,55.004607150000055,57.981404000000055,59.26312300000005,60.39999749999994,62.27083333333334,272800,437650,77.63314049663995,NaN,1.5,2.75,NaN,NaN,0.43512568872819574,0.6233291442933852,NaN,0.16819988846136325,0.7839282943017665,0.6157284058404032,9.267263417489207,3.5055915662916934,NaN,NaN,NaN,13658499
818346600,62.20312,62.28125,61.90625,61.95312,NaN,NaN,59.10937,61.03427183246073,55.069997750000056,58.042185200000056,59.33906040000005,60.53046599999993,59.542262754868986,60.71003958175136,61.00841000000001,62.5421159648787,59.47470403512133,55.069997750000056,58.042185200000056,59.33906040000005,60.53046599999993,62.04687333333333,289700,434275,71.26720720651551,NaN,1.5,2.75,NaN,NaN,0.43083099667618174,0.6670888262045939,NaN,0.14396365161152613,0.795682970354811,0.6517193187432848,9.865600488861736,2.6936029168487265,NaN,NaN,NaN,13368799
818433000,62.21875,62.23437,61.76562,62.15625,NaN,NaN,59.15433951219512,61.08188308900523,55.135779000000056,58.11109150000006,59.41031040000005,60.660153499999936,59.644772058599614,60.84777390729885,61.18389076923078,62.68028935758459,59.687492180876966,55.135779000000056,58.11109150000006,59.41031040000005,60.660153499999936,62.05207999999999,296900,423935,72.75653431853516,NaN,1.5,2.75,NaN,NaN,0.43353949691359733,0.7003432129925579,NaN,0.12824771680641134,0.812028964751299,0.6837812479448877,9.86514966462736,3.0036250647332987,NaN,NaN,NaN,13665699
818692200,62.28125,62.54687,62.15625,62.42187,NaN,NaN,59.199309024390246,61.12949434554974,55.20484150000006,58.18062270000006,59.48906040000006,60.80468449999993,59.753677860223156,60.99768782088944,61.342544615384625,62.89203216429147,59.79305706647778,55.20484150000006,58.18062270000006,59.48906040000006,60.80468449999993,62.37499666666667,186500,393480,74.60984804319068,NaN,1.5,2.75,NaN,NaN,0.43047381856262595,0.4739758056317983,NaN,0.12239166085260378,0.8367708240106424,0.7143791631580386,9.727275221174974,2.357161351342975,NaN,NaN,NaN,13852199
818778600,62.14062,62.35937,62.14062,62.23437,NaN,NaN,59.24427853658536,61.17710560209424,55.27093525000006,58.24890390000006,59.56999780000005,60.94296549999992,59.85095990492029,61.115467076042826,61.50119846153847,62.95834137861564,60.0440555444613,55.27093525000006,58.24890390000006,59.56999780000005,60.94296549999992,62.24478666666666,299400,367525,70.94116584503826,NaN,1.5,2.75,NaN,NaN,0.4198149743795812,0.8146384599687096,NaN,0.09382655489353953,0.831662356774963,0.7378358018814235,9.1671001616369,1.9452266758312098,NaN,NaN,NaN,13552799
818865000,62.3125,62.70312,62.3125,62.625,NaN,NaN,59.289248048780486,61.22471685863874,55.340544650000055,58.31702890000006,59.65749780000006,61.12030949999993,59.95974579100184,61.2592321164197,61.67788153846155,63.07915676072875,60.276606316194346,55.340544650000055,58.31702890000006,59.65749780000006,61.12030949999993,62.54687333333334,390700,369970,73.828467116552,NaN,1.5,2.75,NaN,NaN,0.42331033335246826,1.0560315701273075,NaN,0.08920634267970551,0.8493437302310554,0.7601373875513499,9.444209219949693,2.8219599794766546,NaN,NaN,NaN,13943499
818951400,62.6875,62.79687,62.01562,62.17187,NaN,NaN,59.33421756097561,62.79687,55.407575900000055,58.37640390000006,59.737185200000056,61.24530949999993,60.046495759982164,61.346150010094014,61.818506153846165,63.00673674194541,60.63027556574692,55.407575900000055,58.37640390000006,59.737185200000056,61.24530949999993,62.328119999999984,395000,360485,65.67644317670064,NaN,1.5,2.75,NaN,NaN,0.44887745239872057,1.0957460088491893,NaN,0.045786413812149096,0.8173704048165362,0.7715839910043871,10.716215697078807,1.9472202467615882,NaN,NaN,NaN,13548499
819037800,61.875,61.875,61.59375,61.8125,NaN,NaN,59.379187073170726,62.86069978723404,55.472732150000056,58.43265390000006,59.80624780000006,61.33593449999993,60.11575082821816,61.39056429484697,61.88220846153847,62.96921535172313,60.79520157135381,55.472732150000056,58.43265390000006,59.80624780000006,61.33593449999993,61.760416666666664,416700,352435,60.01645384168645,NaN,1.5,2.75,NaN,NaN,0.458109062941669,1.1823456807638288,NaN,-0.013797093698454055,0.7543376238813195,0.7681347175797736,11.63196678538109,0.12655834991108128,NaN,NaN,NaN,13131799
819297000,61.26562,61.26562,60.60937,60.625,NaN,NaN,59.42415658536585,62.92452957446808,55.53179465000006,58.47234140000006,59.85062280000005,61.35780949999993,60.135721383974314,61.317653409623446,61.84975692307693,63.053499851506984,60.64601399464688,55.53179465000006,58.47234140000006,59.85062280000005,61.35780949999993,60.83333,862300,382200,45.93056497368045,NaN,1.5,2.75,NaN,NaN,0.5113248441601213,2.2561486132914705,NaN,-0.13320602881109123,0.6016271815659096,0.7348332103770008,14.586091092180885,-2.43901654022763,NaN,NaN,NaN,12269499
819383400,60.65625,61.34375,60.57812,61.26562,NaN,NaN,60.57812,62.98835936170212,55.59593525000005,58.52202890000006,59.917497800000056,61.42734049999992,60.18003113362238,61.312697846802166,61.877400769230775,63.00745408787598,60.74734745058557,55.59593525000005,58.52202890000006,59.917497800000056,61.42734049999992,61.06249666666667,1022600,410890,52.418462163714544,NaN,1.5,2.75,NaN,NaN,0.5294894981486842,2.4887439460682907,NaN,-0.1668828181782228,0.5262296876542223,0.6931125058324451,15.557714564352834,-1.6307155042649297,NaN,NaN,NaN,13292099
819469800,61.45312,61.51562,60.67187,60.67187,NaN,NaN,60.645722040816324,63.05218914893617,55.656482100000055,58.56718510000006,59.973122800000056,61.44296549999992,60.199318932303854,61.2516666232972,61.853362307692315,63.06847295111531,60.63825166426932,55.656482100000055,58.56718510000006,59.973122800000056,61.44296549999992,60.95311999999999,1349800,472420,46.81190498864033,NaN,1.5,2.75,NaN,NaN,0.5519366768523496,2.8572033360145634,NaN,-0.22345321653991135,0.4137959851575559,0.6372492016974672,16.034883298402324,-2.0680960054957684,NaN,NaN,NaN,11942299
819556200,61.03125,61.17187,60.75,60.98437,NaN,NaN,60.71332408163265,63.116018936170214,55.718669600000055,58.616403800000064,60.03124780000005,61.48359049999992,60.2301052486841,61.226209802030795,61.79567000000001,63.09612250432231,60.49521749567771,55.718669600000055,58.616403800000064,60.03124780000005,61.48359049999992,60.96874666666667,857600,497720,49.852062850052604,NaN,1.5,2.75,NaN,NaN,0.5482269142200389,1.723057140560958,NaN,-0.2330633188210206,0.34592005317119146,0.5789833719922121,16.5080911886511,-1.885377576671697,NaN,NaN,NaN,12799899
819642600,61.3125,61.375,61.14062,61.20312,NaN,NaN,60.780926122448975,63.179848723404255,55.77835710000006,58.669060000000066,60.08656020000006,61.52734049999992,60.26826268991217,61.22401077326596,61.72355461538462,63.04332629189898,60.403782938870265,55.77835710000006,58.669060000000066,60.08656020000006,61.52734049999992,61.23958,332800,511240,51.92361662866737,NaN,1.5,2.75,NaN,NaN,0.5369699917757506,0.6509662780690086,NaN,-0.21818754738487478,0.3062489377611186,0.5244364851459934,16.541929922062774,-1.9524407070791054,NaN,NaN,NaN,13132699
819988200,61.45312,61.53125,61.32812,61.5,NaN,NaN,60.84852816326531,63.2436785106383,55.839763350000055,58.724841300000065,60.144060200000055,61.58515299999992,60.31656611383718,61.25029546152634,61.66345846153847,62.94682465518905,60.38009226788789,55.839763350000055,58.724841300000065,60.144060200000055,61.58515299999992,61.45312333333334,432200,519200,54.66098225519084,NaN,1.5,2.75,NaN,NaN,0.5220528495060542,0.8324345146379045,NaN,-0.18326094956331868,0.29536029819184506,0.47862124775516374,16.61870057295027,-1.1800071246804593,NaN,NaN,NaN,13564899
820074600,61.65625,61.65625,61.35937,61.46875,NaN,NaN,60.91613020408163,63.30750829787234,55.89921650000006,58.77968510000006,60.206560200000055,61.60937199999993,60.36174979564749,61.27110065566669,61.62619923076924,62.90186543768717,60.350533023851305,55.89921650000006,58.77968510000006,60.206560200000055,61.60937199999993,61.494789999999995,151800,502840,54.310441821741726,NaN,1.5,2.75,NaN,NaN,0.5059690745413362,0.30188529154402993,NaN,-0.15812059343827467,0.2809705059573204,0.4390910993955951,16.59697471866048,-1.8463073852295409,NaN,NaN,NaN,13413099
820161000,61.34375,61.65625,61.25,61.40625,NaN,NaN,60.98373224489796,63.37133808510638,55.95882590000006,58.83265390000006,60.25999780000006,61.62734099999993,60.40271058797504,61.28397202179367,61.56850692307693,62.81046053272494,60.326553313428924,55.95882590000006,58.83265390000006,60.25999780000006,61.62734099999993,61.4375,256200,488190,53.57049413127326,NaN,1.5,2.75,NaN,NaN,0.49884628350266935,0.5247956738155226,NaN,-0.1420658762054855,0.2615087541387382,0.4035746303442237,15.907294219900107,-1.231457249074217,NaN,NaN,NaN,13156899
820247400,61.46875,61.53125,61.25,61.48437,NaN,NaN,61.05133428571428,63.43516787234042,56.01734150000006,58.88640390000006,60.31156020000006,61.65624699999993,60.445128604132876,61.30305754352761,61.496391538461545,62.63645912152745,60.35632395539564,56.01734150000006,58.88640390000006,60.31156020000006,61.65624699999993,61.42187333333334,339200,490840,54.40664781618638,NaN,1.5,2.75,NaN,NaN,0.48330369182390726,0.6910602232906854,NaN,-0.12324963946390988,0.24951258101433638,0.37276222047824625,15.619480286642757,-0.5308473205257862,NaN,NaN,NaN,13496099
820593000,61.40625,62.14062,61.34375,62.14062,NaN,NaN,61.11893632653061,63.498997659574464,56.08023210000006,58.94687260000006,60.37062260000006,61.71405949999993,60.51161846279433,61.38282539652498,61.489180000000005,62.61153231334025,60.36682768665976,56.08023210000006,58.94687260000006,60.37062260000006,61.71405949999993,61.87499666666667,514400,493300,60.79419583256488,NaN,1.5,2.75,NaN,NaN,0.5057012852650566,1.0427731603486723,NaN,-0.06651309717401765,0.28962084901072416,0.3561339461847418,16.623305903178572,2.499991752577317,NaN,NaN,NaN,14010499
820679400,62.34375,62.5,62,62.3125,NaN,NaN,61.186538367346934,63.56282744680851,56.14398210000006,59.01031010000006,60.440310200000056,61.74296599999993,60.58224126817495,61.47136583495117,61.465141538461545,62.49905859440648,60.43122448251661,56.14398210000006,59.01031010000006,60.440310200000056,61.74296599999993,62.270833333333336,610300,492230,62.28456047507637,NaN,1.5,2.75,NaN,NaN,0.5052940506032668,1.2398675415964082,NaN,-0.019742830325049643,0.3314554082784298,0.35119823860347943,10.736998722233468,1.7087560690645123,NaN,NaN,NaN,14620799
820765800,62.39062,62.625,61.21875,61.71875,NaN,NaN,61.254140408163266,63.626657234042554,56.20538835000006,59.070935100000064,60.50062280000006,61.72187249999994,60.62681023805044,61.494926231622486,61.43028615384616,62.39477214958232,60.46580015811,56.20538835000006,59.070935100000064,60.50062280000006,61.72187249999994,61.854166666666664,1129700,520330,54.56769790890179,NaN,1.5,2.75,NaN,NaN,0.5696480469887477,2.1711221724674727,NaN,-0.030486726560888466,0.3130898304023688,0.3435765569632573,11.573348583321291,1.725478380672957,NaN,NaN,NaN,13491099
820852200,61.3125,61.75,61.17187,61.59375,NaN,NaN,61.32174244897959,63.690487021276596,56.265935250000055,59.125310100000064,60.55718540000005,61.687497499999935,60.6647294444014,61.50433801908701,61.413459230769234,62.358113849345116,60.46880461219335,56.265935250000055,59.125310100000064,60.55718540000005,61.687497499999935,61.50520666666668,302400,521810,53.07677241479092,NaN,1.5,2.75,NaN,NaN,0.5702539007752658,0.5795212816925701,NaN,-0.04673215785845236,0.28516135964019185,0.3318935174986442,9.721460087572863,0.999239641239225,NaN,NaN,NaN,13188699
821111400,61.8125,61.90625,61.73437,61.82812,NaN,NaN,61.38934448979592,63.75431680851064,56.327497750000056,59.18312260000006,60.62812280000006,61.68124749999994,60.710352603444484,61.53517439822158,61.50600692307693,62.3543790743014,60.657634771852464,56.327497750000056,59.18312260000006,60.62812280000006,61.68124749999994,61.82291333333333,179900,516320,55.53014074132308,NaN,1.5,2.75,NaN,NaN,0.5518429078627468,0.3484273318872017,NaN,-0.04253356651048701,0.2787265593605355,0.3212601258710225,9.56802580059888,1.0211897694104484,NaN,NaN,NaN,13368599
821197800,62.0625,62.0625,60.625,60.76562,NaN,NaN,61.45694653061224,63.81814659574468,56.38023210000006,59.22874760000006,60.68843520000006,61.61171599999993,60.71251995232901,61.461883503152855,61.46754538461539,62.39744130956268,60.5376494596681,56.38023210000006,59.22874760000006,60.68843520000006,61.61171599999993,61.15104,415500,522250,44.23788232576479,NaN,1.5,2.75,NaN,NaN,0.6151041287296934,0.7955959789372906,NaN,-0.10840742600462494,0.18575084336524128,0.2941582693698662,14.196921805158544,-1.194113821138214,NaN,NaN,NaN,12953099
821284200,60.6875,60.8125,59.64062,59.96875,NaN,NaN,59.64062,63.88197638297872,56.42796650000005,59.267341400000056,60.72406020000006,61.48905999999994,60.68335250321807,61.31968031237639,61.413459230769234,62.57509668676138,60.25182177477709,56.42796650000005,59.267341400000056,60.72406020000006,61.48905999999994,60.14062333333334,787700,552310,37.99701764188882,NaN,1.5,2.75,NaN,NaN,0.6548738338204297,1.4261918125690283,NaN,-0.197549155099233,0.04722182549582499,0.24477098059505797,15.338952607673933,-2.440264361972547,NaN,NaN,NaN,12165399
821370600,60.0625,60.32812,59.78125,60.32812,NaN,NaN,59.573655714285714,63.94580617021276,56.477497750000055,59.30890390000006,60.75937260000006,61.39374749999994,60.66942181681736,61.22524599691197,61.36297846153847,62.64555649099635,60.08040043208059,56.477497750000055,59.30890390000006,60.75937260000006,61.39374749999994,60.14583,513200,563000,41.97278694059755,NaN,1.5,2.75,NaN,NaN,0.6471592742618275,0.9115452930728242,NaN,-0.222362987249927,-0.03318275346735078,0.18918023378257623,16.08158069806083,-1.7557333333333358,NaN,NaN,NaN,12678599
821457000,60.48437,60.5,59.67187,60.23437,NaN,NaN,59.50669142857143,64.0096359574468,56.526638350000056,59.35109140000006,60.79781000000006,61.27421599999993,60.652360961255894,61.13087685434893,61.288459230769234,62.705094750071915,59.871823711466554,56.526638350000056,59.35109140000006,60.79781000000006,61.27421599999993,60.13541333333333,390400,562985,41.23004735702477,NaN,1.5,2.75,NaN,NaN,0.6600857546716971,0.6934465394282263,NaN,-0.2339668073520815,-0.10327827540752565,0.13068853194455585,16.074086284032006,-2.033037014122451,NaN,NaN,NaN,12288199
821716200,60.25,60.45312,59.85937,60.10937,NaN,NaN,59.439727142857144,64.07346574468085,56.57562270000006,59.390935100000064,60.824372400000065,61.17109099999993,60.63106719806939,61.03359048726808,61.1814876923077,62.722618817245746,59.64035656736965,56.57562270000006,59.390935100000064,60.824372400000065,61.17109099999993,60.14062,154100,550940,40.20838174101598,NaN,1.5,2.75,NaN,NaN,0.6553474864808616,0.27970377899589793,NaN,-0.2381436007122536,-0.16699096894576115,0.07115263176649245,15.94495998281378,-3.2687958375696926,NaN,NaN,NaN,12134099
821802600,60.40625,60.89062,59.89062,60.84375,NaN,NaN,59.37276285714285,64.13729553191489,56.62929460000006,59.44015390000006,60.85812240000006,61.122653499999934,60.639407700105885,61.0155104408616,61.13341076923078,62.67469153108324,59.592130007378316,56.62929460000006,59.44015390000006,60.85812240000006,61.122653499999934,60.54166333333333,454500,552830,48.31201949842228,NaN,1.5,2.75,NaN,NaN,0.6799655231608001,0.8221333863936472,NaN,-0.18205992181704955,-0.1564222705048195,0.02563765131223006,16.412136976816075,-2.3570712136409226,NaN,NaN,NaN,12588599
821889000,60.70312,61.125,60.45312,60.65625,NaN,NaN,59.30579857142857,64.20112531914893,56.68140400000006,59.486872700000056,60.88656000000006,61.12421599999993,60.64006818245468,60.98129516077954,61.07571846153847,62.6279374865623,59.52349943651464,56.68140400000006,59.486872700000056,60.88656000000006,61.12421599999993,60.744789999999995,407600,530095,46.576337492319766,NaN,1.5,2.75,NaN,NaN,0.6793879857921716,0.7689187787094766,NaN,-0.14956342200457548,-0.1613166261934893,-0.011753204188913811,16.11822812547237,-1.7215189873417722,NaN,NaN,NaN,12180999
821975400,60.89062,60.90625,60.375,60.85937,NaN,NaN,59.23883428571428,64.26495510638297,56.73288835000006,59.53249770000006,60.92312240000007,61.10390349999993,60.64866825373096,60.969683240705294,61.027641538461545,62.564897853644624,59.490385223278466,56.73288835000006,59.53249770000006,60.92312240000007,61.10390349999993,60.71354,425500,500240,48.72542043138709,NaN,1.5,2.75,NaN,NaN,0.6688067010927308,0.8505917159763313,NaN,-0.10828508816687162,-0.14710956439750333,-0.03882447623063172,15.802878229092952,-1.1922962962962989,NaN,NaN,NaN,12606499
822061800,60.85937,61.42187,60.79687,61.26562,NaN,NaN,59.17187,64.32878489361703,56.78640395000006,59.58421640000006,60.972184800000065,61.13359099999993,60.67286243985916,60.99786769397146,60.96033384615385,62.367926296118135,59.55274139618957,56.78640395000006,59.58421640000006,60.972184800000065,61.13359099999993,61.16145333333333,169800,441240,52.813875220427356,NaN,1.5,2.75,NaN,NaN,0.6656776510146786,0.3848245852597226,NaN,-0.0504562636925059,-0.10189480584626409,-0.05143854215375819,16.4475461581001,-0.9097802100403506,NaN,NaN,NaN,12776299
822321000,61.21875,61.42187,61.10937,61.28125,NaN,NaN,59.104905714285714,64.39261468085107,56.839060200000056,59.63468520000006,61.010934800000065,61.148434999999935,60.69672077555096,61.02485648502179,60.88100692307693,62.0748509565269,59.68716288962696,56.839060200000056,59.63468520000006,61.010934800000065,61.148434999999935,61.27083,288100,412765,52.96925312299654,NaN,1.5,2.75,NaN,NaN,0.6404506759422015,0.697975845820261,NaN,-0.010098850669160178,-0.06406210549020841,-0.05396325482104823,16.230873227965212,0.848555482524496,NaN,NaN,NaN,13064399
822407400,61.25,61.42187,61.125,61.42187,NaN,NaN,59.03794142857143,64.45644446808511,56.89265395000006,59.68531020000006,61.04812220000007,61.15937249999994,60.72515800003916,61.0626672959721,60.85817000000001,61.997136630426866,59.71920336957315,56.89265395000006,59.68531020000006,61.04812220000007,61.15937249999994,61.32291333333334,362100,414230,54.42333961825045,NaN,1.5,2.75,NaN,NaN,0.6159091990891871,0.8741520411365666,NaN,0.025191804980061495,-0.022473498595971364,-0.04766530357603286,12.424014356199828,2.4231287128712844,NaN,NaN,NaN,13426499
822493800,61.51562,62.04687,61.48437,61.92187,NaN,NaN,58.970977142857144,64.52027425531915,56.94827895000006,59.74046640000006,61.09593460000007,61.18046599999993,60.772087882390565,61.14449612492714,60.88341000000001,62.0984622884307,59.66835771156932,56.94827895000006,59.74046640000006,61.09593460000007,61.18046599999993,61.81770333333333,1506500,467945,59.24798151644802,NaN,1.5,2.75,NaN,NaN,0.616558542011388,3.219395441772003,NaN,0.07833409558587107,0.05025231590630597,-0.028081779679565093,9.025735729779608,2.6418028607554818,NaN,NaN,NaN,14932999
822580200,61.96875,62,61.625,61.70312,NaN,NaN,58.90401285714285,64.5841040425532,57.00366955000006,59.79093510000006,61.14062200000008,61.192184499999925,60.808598945826226,61.1976983987436,60.873794615384625,62.060436909189654,59.687152321579596,57.00366955000006,59.79093510000006,61.14062200000008,61.192184499999925,61.776039999999995,298400,475275,56.433352401941704,NaN,1.5,2.75,NaN,NaN,0.599304360439146,0.6278470359265689,NaN,0.0938321533336516,0.0892084119874994,-0.004623741346152191,9.589605344716883,2.4383919015007547,NaN,NaN,NaN,14634599
822666600,61.65625,62.26562,61.57812,62.23437,NaN,NaN,58.83704857142857,64.64793382978723,57.06085705000006,59.84140380000006,61.20374700000008,61.23359049999992,60.86451153618598,61.296429027434684,60.98677538461539,62.37351621323373,59.600034555997055,57.06085705000006,59.84140380000006,61.20374700000008,61.23359049999992,62.026036666666656,726300,498780,61.24812619909829,NaN,1.5,2.75,NaN,NaN,0.605604048979207,1.4561530133525804,NaN,0.1325724868250526,0.16109186718516355,0.02851938036011096,9.874059623006554,3.5352225451705785,NaN,NaN,NaN,15360899
822925800,62.1875,62.48437,62.14062,62.48437,NaN,NaN,58.77008428571428,64.71176361702128,57.11788830000006,59.89327880000006,61.25999700000008,61.283590499999924,60.92803539751202,61.409566262917096,61.18028461538462,62.64468590190664,59.7158833288626,57.11788830000006,59.89327880000006,61.25999700000008,61.283590499999924,62.36978666666666,254800,494560,63.303416296289534,NaN,1.5,2.75,NaN,NaN,0.5869001883378352,0.5152054351342608,NaN,0.1655989187150096,0.23551802875387295,0.06991911003886336,9.26947397071808,2.6964478685156625,NaN,NaN,NaN,15615699
823012200,62.60937,63.14062,62.53125,63.01562,NaN,NaN,58.70312,64.77559340425532,57.17906015000006,59.95015380000006,61.32030940000008,61.32734049999992,61.00990146035468,61.5625237616869,61.387015384615395,63.05630483878931,59.71772593044148,57.17906015000006,59.95015380000006,61.32030940000008,61.32734049999992,62.89583,272100,482445,67.27532601938492,NaN,1.5,2.75,NaN,NaN,0.591853746313704,0.5640021142306377,NaN,0.21088397216033497,0.33352407523928207,0.1226401030789471,8.256517674311594,3.8897393096342063,NaN,NaN,NaN,15887799
823098600,63,63.6875,62.96875,63.67187,NaN,NaN,58.636155714285714,64.83942319148936,57.24437265000006,60.01140380000006,61.389996800000084,61.39530899999992,61.11429238347803,61.76341387962148,61.65143846153847,63.5761145437552,59.726762379321734,57.24437265000006,60.01140380000006,61.389996800000084,61.39530899999992,63.44270666666667,498000,476830,71.39423634284398,NaN,1.5,2.75,NaN,NaN,0.6009177644341538,1.0443973743262798,NaN,0.2689751355232116,0.4588590224829616,0.18988388695975,7.927301891398111,4.621309750659594,NaN,NaN,NaN,16385799
823185000,63.60937,63.90625,63.5625,63.90625,NaN,NaN,58.56919142857143,64.9032529787234,57.31109140000006,60.07343510000006,61.47062180000008,61.50468399999992,61.22378091745929,61.96749351013372,61.943506153846165,63.9918813090952,59.89513099859713,57.31109140000006,60.07343510000006,61.47062180000008,61.50468399999992,63.79166666666666,373900,439040,72.71512117831668,NaN,1.5,2.75,NaN,NaN,0.5825486384031429,0.8516308309037901,NaN,0.3045118791355592,0.570523735879199,0.2660118567436398,7.906537904886945,4.310133481061649,NaN,NaN,NaN,16759699
823271400,63.875,64.01562,63.5,63.64062,NaN,NaN,58.502227142857144,64.96708276595744,57.37609140000006,60.13015380000006,61.53624680000008,61.607027499999916,61.31855892069618,62.126838890120986,62.15865000000001,64.28579940808049,60.031500591919524,57.37609140000006,60.13015380000006,61.53624680000008,61.607027499999916,63.71874666666667,496200,448730,68.83570452688991,NaN,1.5,2.75,NaN,NaN,0.5777680213743468,1.1057874445657745,NaN,0.2914455403237174,0.6303187821482865,0.3388732418245691,9.327246987812895,3.850068332483424,NaN,NaN,NaN,16263499
823530600,63.53125,64.25,63.4375,64.15625,NaN,NaN,58.43526285714285,65.03091255319148,57.44241955000006,60.18937260000006,61.61593440000008,61.72343399999992,61.42984092380613,62.320116138680895,62.42788076923078,64.61148240038682,60.244279138074745,57.44241955000006,60.18937260000006,61.61593440000008,61.72343399999992,63.94791666666666,295300,454500,71.96267647159652,NaN,1.5,2.75,NaN,NaN,0.5945345912761792,0.6497249724972497,NaN,0.29779461481260483,0.7111165103403252,0.41332189552772036,9.317545688182802,4.451801939602298,NaN,NaN,NaN,16558799
823617000,64.1875,64.82812,64.09375,64.76562,NaN,NaN,58.36829857142857,65.09474234042553,57.50882580000006,60.24937260000006,61.704684400000076,61.923433999999915,61.560655789539226,62.55302126833033,62.72836153846155,65.03736884729105,60.419354229632056,57.50882580000006,60.24937260000006,61.704684400000076,61.923433999999915,64.56249666666668,301600,448805,75.1376261075543,NaN,1.5,2.75,NaN,NaN,0.604522834756452,0.6720067735430755,NaN,0.32128359888472663,0.8149263941336287,0.49364279524890203,9.57485860352278,4.592480814936629,NaN,NaN,NaN,16860399
823703400,64.75,65.14062,64.6875,65.14062,NaN,NaN,58.30133428571428,65.15857212765957,57.57781015000006,60.31640380000006,61.80062180000008,62.18202749999991,61.70104654289063,62.799459242775065,63.02643846153847,65.49792216071631,60.55495476236062,57.57781015000006,60.31640380000006,61.80062180000008,62.18202749999991,64.98958,585100,438675,76.87322827048652,NaN,1.5,2.75,NaN,NaN,0.5937083465595625,1.3337892517239414,NaN,0.3385949986898259,0.9168865436111844,0.5782915449213585,9.417298611986245,5.57103109210685,NaN,NaN,NaN,17445499
823789800,65.04687,65.90625,64.92187,65.84375,NaN,NaN,58.23437,65.22240191489361,57.65007580000006,60.39265380000006,61.89780940000008,62.45780899999992,61.86350550199296,63.08939169584411,63.37740000000001,66.04585114764647,60.708948852353544,57.65007580000006,60.39265380000006,61.89780940000008,62.45780899999992,65.55729000000001,1526600,489345,79.73043152470677,NaN,1.5,2.75,NaN,NaN,0.6216134646624509,3.1196803890915406,NaN,0.371295679708292,1.0424111445567235,0.6711154648484314,8.120396052843414,5.799657006249122,NaN,NaN,NaN,18972099
823876200,65.8125,66.375,65.51562,65.82812,NaN,NaN,58.167405714285714,65.28623170212765,57.72163830000006,60.465935000000066,61.993434400000076,62.73749649999992,62.01898058034618,63.35022296290657,63.716342307692315,66.42419521008208,61.008489405302555,57.72163830000006,60.465935000000066,61.993434400000076,62.73749649999992,65.90624666666668,804600,510055,79.49531902862472,NaN,1.5,2.75,NaN,NaN,0.6385967886151331,1.5774769387615062,NaN,0.3652119983120391,1.1276304627384803,0.7624184644264412,8.836028517910815,5.351338262672729,NaN,NaN,NaN,18167499
824135400,65.95312,66.625,65.89062,66.32812,NaN,NaN,58.10044142857143,65.3500614893617,57.79531015000006,60.54140370000007,62.10187180000008,63.048433999999915,62.187966439940446,63.633832204534514,64.05528461538462,66.88035404494104,61.23021518582819,57.79531015000006,60.54140370000007,62.10187180000008,63.048433999999915,66.28124666666668,626500,533675,81.38627177343372,NaN,1.5,2.75,NaN,NaN,0.6499027322854809,1.1739354476038788,NaN,0.3672118565391581,1.2214332851003888,0.8542214285612307,8.83545132839184,5.256633196658226,NaN,NaN,NaN,18793999
824221800,66.04687,66.6875,66,66.1875,NaN,NaN,58.033477142857144,66.6875,57.86898205000006,60.62031000000006,62.205934400000075,63.31562149999992,62.34481089327611,63.877038661245514,64.40023692307693,67.08380934143426,61.7166645047196,57.86898205000006,60.62031000000006,62.205934400000075,63.31562149999992,66.29166666666667,1045900,563245,79.17482473673516,NaN,1.5,2.75,NaN,NaN,0.6525882514079465,1.856918392529006,NaN,0.33245366302990154,1.2697885073486077,0.9373348443187062,9.777471996927714,3.9509284084164666,NaN,NaN,NaN,17748099
824308200,66.14062,66.35937,65.57812,65.60937,NaN,NaN,57.96651285714285,66.78239341463414,57.939216400000056,60.693278700000064,62.283434400000075,63.56327749999991,62.47283281902999,64.04202259826975,64.65985230769232,67.09674151959287,62.222963095791776,57.939216400000056,60.693278700000064,62.283434400000075,63.56327749999991,65.84895333333333,431400,564435,70.672478149412,NaN,1.5,2.75,NaN,NaN,0.6617783763073789,0.7643041271359855,NaN,0.24779972150964746,1.2470844962057654,0.999284774696118,11.821381465279824,2.665028850855743,NaN,NaN,NaN,17316699
824394600,65.46875,65.90625,65.125,65.20312,NaN,NaN,57.89954857142857,66.87728682926829,58.00382575000006,60.763122400000064,62.34468440000008,63.780464999999914,62.579902904558224,64.15260330319644,64.86898692307693,66.96614442274542,62.771829423408455,58.00382575000006,60.763122400000064,62.34468440000008,63.780464999999914,65.41145666666667,889500,587635,65.36091478337632,NaN,1.5,2.75,NaN,NaN,0.6703120637139948,1.5136947254673394,NaN,0.1467139856428079,1.1826772567496278,1.0359632711068198,12.92143595953334,2.45519292552461,NaN,NaN,NaN,16427199
824481000,65.07812,65.23437,64.73437,64.9375,NaN,NaN,57.83258428571428,66.97218024390244,58.06726325000006,60.83046620000007,62.39780940000008,63.96405899999992,62.67235769261477,64.22735536955868,65.01682384615386,66.821034851577,63.21261284073072,58.06726325000006,60.83046620000007,62.39780940000008,63.96405899999992,64.96874666666666,606100,609450,62.07582941840763,NaN,1.5,2.75,NaN,NaN,0.6581469163058522,0.9945032406267946,NaN,0.04926848793889138,1.0975488810304341,1.0482803930915428,12.90701065882367,1.2177301509985388,NaN,NaN,NaN,15821099
824826600,64.4375,64.625,63.875,64.29687,NaN,NaN,57.76562,67.06707365853659,58.12781010000006,60.89187240000007,62.44468440000008,64.11483999999992,62.736064057610264,64.23397581055309,65.06490076923077,66.75274974257498,63.37705179588657,58.12781010000006,60.89187240000007,62.44468440000008,64.11483999999992,64.26562333333334,492300,619660,54.90788781393301,NaN,1.5,2.75,NaN,NaN,0.6870292794268628,0.7944679340283382,NaN,-0.06483167995520289,0.9672407931475391,1.032072473102742,13.906086831121806,-0.7237636264425478,NaN,NaN,NaN,15328799
824913000,64.42187,65.14062,64.42187,65.09375,NaN,NaN,57.698655714285714,67.16196707317073,58.19046635000006,60.956872400000066,62.50343440000008,64.29843399999992,62.82852232986084,64.31585906669089,65.15624692307694,66.70629388266819,63.606199963485686,58.19046635000006,60.956872400000066,62.50343440000008,64.29843399999992,64.88541333333333,434000,623255,60.94848833199851,NaN,1.5,2.75,NaN,NaN,0.6982236166106582,0.6963441929868192,NaN,-0.09150305870008824,0.9176936497276316,1.0091967084277198,14.675901616180562,-0.07195203238777649,NaN,NaN,NaN,15762799
824999400,65.45312,66.32812,65.40625,66.125,NaN,NaN,57.63169142857143,67.25686048780487,58.25851325000006,61.03327870000007,62.57749700000008,64.50859049999993,62.95779596398394,64.48815820319652,65.34735307692308,66.70327176890993,63.99143438493624,58.25851325000006,61.03327870000007,62.57749700000008,64.50859049999993,65.95312333333334,721400,584000,67.09223907942442,NaN,1.5,2.75,NaN,NaN,0.736519786852754,1.2352739726027397,NaN,-0.04681210858829876,0.9506815726923463,0.9974936812806451,16.914974271725985,0.42714760322733747,NaN,NaN,NaN,16484199
825085800,66.5,66.60937,65.32812,65.9375,NaN,NaN,57.564727142857144,67.35175390243903,58.32531015000006,61.11077870000006,62.65155960000007,64.72030949999993,63.074647102651234,64.62619075527304,65.48437230769231,66.68188983206251,64.28685478332211,58.32531015000006,61.11077870000006,62.65155960000007,64.72030949999993,65.95833,1430400,640600,65.08724264122407,NaN,1.5,2.75,NaN,NaN,0.7754290877918429,2.2329066500156105,NaN,-0.03740649023354792,0.9507355684887102,0.9881420587222581,15.972614465148819,0.1661599936319032,NaN,NaN,NaN,15053799
825345000,65.75,65.89062,64.96875,65,NaN,NaN,57.49776285714285,67.44664731707317,58.38671640000006,61.178278700000064,62.699059600000076,64.85859099999993,63.150151137841384,64.66179163572323,65.50240153846154,66.662566338473,64.34223673845008,58.38671640000006,61.178278700000064,62.699059600000076,64.85859099999993,65.28645666666667,1408400,674705,56.065477223973225,NaN,1.5,2.75,NaN,NaN,0.7892377243781399,2.0874308030917215,NaN,-0.09838808319527537,0.8651569547281639,0.9635450379234393,18.004892785047282,-2.0023483252653604,NaN,NaN,NaN,13645399
825431400,65.15625,65.17187,64.5,64.79687,NaN,NaN,57.43079857142857,67.54154073170731,58.44695075000006,61.24437240000007,62.75155960000007,64.97421599999993,63.214728348122115,64.67465624184483,65.47595923076923,66.68263833632079,64.26928012521768,58.44695075000006,61.24437240000007,62.75155960000007,64.97421599999993,64.82291333333335,601000,692015,54.30895135727372,NaN,1.5,2.75,NaN,NaN,0.780854315493987,0.8684782844302508,NaN,-0.15320023659169302,0.772044742183823,0.925244978775516,17.111140022786213,-2.1010462700661026,NaN,NaN,NaN,13044399
825517800,65.3125,65.73437,64.5,64.5,NaN,NaN,57.36383428571428,67.63643414634146,58.50445075000006,61.30577870000006,62.80530960000007,65.04843499999994,63.265131157999676,64.65802231405009,65.37259384615385,66.6628616945404,64.0823259977673,58.50445075000006,61.30577870000006,62.80530960000007,65.04843499999994,64.91145666666667,865900,721705,51.75681711535273,NaN,1.5,2.75,NaN,NaN,0.8132482929587022,1.1997977012768375,NaN,-0.20690525461450815,0.6666134105073809,0.873518665121889,17.158386250670677,-1.6908712886589194,NaN,NaN,NaN,12178499
825604200,64.125,64.95312,63.875,63.875,NaN,NaN,57.29687,67.73132756097561,58.55866950000006,61.36046620000006,62.87030960000007,65.05859149999995,63.289047583176156,64.58344876033102,65.22235384615385,66.70584428783164,63.738863404476064,58.55866950000006,61.36046620000006,62.87030960000007,65.05859149999995,64.23437333333334,914300,742520,46.77337732672656,NaN,1.5,2.75,NaN,NaN,0.832167700604509,1.2313473037763292,NaN,-0.277569946946423,0.5265562314388603,0.8041261783852833,17.293704660285467,-2.03689639391489,NaN,NaN,NaN,11264199
825690600,64.64062,64.89062,63.60937,64.89062,NaN,NaN,57.229905714285714,67.82622097560976,58.61898200000006,61.43015370000006,62.942809600000075,65.10780999999994,63.35185434462023,64.61270316410902,65.11177692307693,66.45694398448275,63.766609861671114,58.61898200000006,61.43015370000006,62.942809600000075,65.10780999999994,64.46353666666666,1452600,796455,54.448725693125134,NaN,1.5,2.75,NaN,NaN,0.8642450077041869,1.823831854907057,NaN,-0.24982710096362104,0.491842302180757,0.741669403144378,20.029389342996993,-0.07219249278152313,NaN,NaN,NaN,12716799
825949800,65.03125,65.65625,64.8125,65.26562,NaN,NaN,57.16294142857143,67.9211143902439,58.68499760000006,61.503903700000066,63.03468460000008,65.18905999999994,63.42690397816453,64.67488571990816,65.04086307692309,66.24110733061019,63.84061882323598,58.68499760000006,61.503903700000066,63.03468460000008,65.18905999999994,65.24479000000001,652600,804275,56.91897034139123,NaN,1.5,2.75,NaN,NaN,0.8627810785824593,0.8114140064032824,NaN,-0.20217210756224502,0.48895426869157177,0.6911263762538168,20.177443169888733,1.5066829847238288,NaN,NaN,NaN,13369399
826036200,65.10937,65.875,65.07812,65.875,NaN,NaN,57.095977142857144,68.01600780487804,58.75390385000006,61.58187250000006,63.132497200000074,65.27499749999994,63.522907743726705,64.78918231801215,65.06129615384616,66.30771403898488,63.81487826870743,58.75390385000006,61.58187250000006,63.132497200000074,65.27499749999994,65.60937333333334,402000,809610,60.65311708855967,NaN,1.5,2.75,NaN,NaN,0.8580738586837124,0.4965353688813132,NaN,-0.12911634424761798,0.5297309459442943,0.6588472901919122,19.55105678716578,1.200192030724916,NaN,NaN,NaN,13771399
826122600,65.78125,65.96875,65.29687,65.29687,NaN,NaN,57.02901285714285,68.1109012195122,58.817028850000064,61.65046620000007,63.21437220000007,65.30155999999994,63.59247489103154,64.83753352582052,65.06850769230769,66.31920189599613,63.81781348861925,58.817028850000064,61.65046620000007,63.21437220000007,65.30155999999994,65.52083,624700,825765,55.718779130199245,NaN,1.5,2.75,NaN,NaN,0.8447742973491617,0.7565106295374592,NaN,-0.11945940597193871,0.5095230327269888,0.6289824386989276,19.399302005534466,-1.2523705103969778,NaN,NaN,NaN,13146699
826209000,65.42187,65.65625,65.23437,65.625,NaN,NaN,56.96204857142857,68.20579463414634,58.87937260000006,61.72046620000006,63.296872200000074,65.32577899999994,63.672181758049916,64.91253033288523,65.12139230769232,66.40320946388641,63.83957515149822,58.87937260000006,61.72046620000006,63.296872200000074,65.32577899999994,65.50520666666667,534200,823220,57.81638862191334,NaN,1.5,2.75,NaN,NaN,0.8145675618242217,0.6489152352955467,NaN,-0.09193818749132632,0.5140597043347697,0.605997891826096,17.134066597280093,-0.47393364928909953,NaN,NaN,NaN,13680899
826295400,64.1875,64.875,62,63.5,NaN,NaN,62,68.30068804878049,58.93124760000006,61.772028700000064,63.33749720000007,65.20859149999994,63.66542953224404,64.7780036345152,65.06009461538461,66.55265660056409,63.56753263020513,58.93124760000006,61.772028700000064,63.33749720000007,65.20859149999994,63.458333333333336,2289900,861385,43.458825914223375,NaN,1.5,2.75,NaN,NaN,1.0153127359796346,2.658393169140396,NaN,-0.21100617193083337,0.34224017691255426,0.5532463488433876,25.227606454396234,-2.3076923076923075,NaN,NaN,NaN,11390999
826554600,63.25,64.32812,63.0625,64.23437,NaN,NaN,62.05754585365854,68.39558146341463,58.98656010000006,61.827028700000064,63.39405960000008,65.12890399999995,63.68774092313643,64.72622900265661,64.99398846153846,66.54952817077121,63.43844875230572,58.98656010000006,61.827028700000064,63.39405960000008,65.12890399999995,63.87499666666667,1511400,896725,48.242319966931504,NaN,1.5,2.75,NaN,NaN,1.0331918262668034,1.6854665588669882,NaN,-0.23275244922275534,0.2623057873149435,0.4950582365376988,25.622366138219558,-0.868097486807619,NaN,NaN,NaN,12902399
826641000,63.8125,64.04687,62.90625,63.73437,NaN,NaN,62.11509170731707,68.49047487804879,59.04241945000006,61.87530990000007,63.43905960000007,64.99921649999995,63.68956951438598,64.63176624049883,64.81009384615385,66.3525060320973,63.26768166021041,59.04241945000006,61.87530990000007,63.43905960000007,64.99921649999995,63.56249666666667,1385300,934665,45.42451777806954,NaN,1.5,2.75,NaN,NaN,1.054258124390603,1.4821353105123225,NaN,-0.2706035098935422,0.15680384917077106,0.42740735906431326,25.89142540881584,-1.187023255813956,NaN,NaN,NaN,11517099
826727400,64.15625,64.4375,63.79687,64.17187,NaN,NaN,62.17263756097561,68.58536829268293,59.10054445000006,61.925153600000066,63.47968460000007,64.89843499999994,63.70848325891986,64.58796659854656,64.67427615384617,66.10238368501345,63.24616862267888,59.10054445000006,61.925153600000066,63.47968460000007,64.89843499999994,64.13541333333335,1019300,933335,48.27162541281064,NaN,1.5,2.75,NaN,NaN,1.0291775440769888,1.0921051926692988,NaN,-0.2561187016728427,0.10725898197325989,0.36337768364610257,26.244590787829406,0.4647671232876687,NaN,NaN,NaN,12536399
826813800,64.26562,64.8125,64.23437,64.45312,NaN,NaN,62.23018341463415,68.68026170731707,59.15460695000006,61.981403600000064,63.52249700000007,64.84062249999994,63.73768469974654,64.57512406535164,64.63220846153847,66.0516508420575,63.212766081019446,59.15460695000006,61.981403600000064,63.52249700000007,64.84062249999994,64.49999666666668,725600,948045,50.074749896470884,NaN,1.5,2.75,NaN,NaN,1.0014241480714898,0.7653645132878714,NaN,-0.21897786597009727,0.089655351183481,0.3086332171535783,25.67369898853283,-0.6742114653859064,NaN,NaN,NaN,13261999
826900200,64.0625,64.32812,63.75,64.125,NaN,NaN,62.287729268292686,68.77515512195122,59.20773195000006,62.035622400000065,63.57062200000008,64.78671649999994,63.7528735350506,64.53225510674673,64.58052615384617,66.020993748001,63.140058559691326,59.20773195000006,62.035622400000065,63.57062200000008,64.78671649999994,64.06770666666667,869200,947030,47.97375291979269,NaN,1.5,2.75,NaN,NaN,0.9801167089235261,0.9178167534291416,NaN,-0.20797313009100626,0.04866680453982042,0.2566399346308267,23.992443093282542,-1.747658261731059,NaN,NaN,NaN,12392799
827159400,64.71875,65.35937,64.57812,65.35937,NaN,NaN,62.34527512195122,68.87004853658537,59.26679445000006,62.10155990000007,63.64593440000008,64.80780999999993,63.81587339642116,64.61102795372324,64.64663153846155,66.14400171341528,63.14926136350782,59.26679445000006,62.10155990000007,63.64593440000008,64.80780999999993,65.09895333333333,917600,962605,55.53245354430684,NaN,1.5,2.75,NaN,NaN,0.9982776582861312,0.9532466588060523,NaN,-0.11373840730964338,0.11446692549377246,0.22820533280341584,26.481565208386748,-0.7827400379506666,NaN,NaN,NaN,13310399
827245800,65.9375,66,65,65.21875,NaN,NaN,62.40282097560976,66,59.323513200000065,62.17093490000006,63.713747000000076,64.85390399999994,63.87088816518896,64.66890624384483,64.74999692307694,66.20495013406651,63.29504371208736,59.323513200000065,62.17093490000006,63.713747000000076,64.85390399999994,65.40625,858500,980915,54.559963562719325,NaN,1.5,2.75,NaN,NaN,0.9984006826942647,0.875203254104586,NaN,-0.059766097789909545,0.1534977105660289,0.21326380835593844,25.842938982858072,-0.11963820011586837,NaN,NaN,NaN,12451899
827332200,65.53125,65.53125,64.64062,65.14062,NaN,NaN,62.460366829268295,65.97135416666667,59.38031005000006,62.244841100000066,63.801247000000075,64.85624749999994,63.920681570475665,64.71383136347866,64.7692276923077,66.23765359952446,63.300801785090925,59.38031005000006,62.244841100000066,63.801247000000075,64.85624749999994,65.10416333333335,744300,996430,53.99419249011412,NaN,1.5,2.75,NaN,NaN,0.9907027767875317,0.7469666710155254,NaN,-0.029734621701770658,0.17609553122872512,0.20583015293049578,25.36670620500841,-0.7381028571428596,NaN,NaN,NaN,11707599
827418600,65.21875,65.25,64.76562,64.98437,NaN,NaN,62.51791268292683,65.94270833333333,59.43773190000006,62.31280980000007,63.90155940000008,64.79921599999993,63.96239484222172,64.73959694790926,64.74759307692308,66.19425382074117,63.300932333105,59.43773190000006,62.31280980000007,63.90155940000008,64.79921599999993,64.99999666666668,650800,992900,52.814664961591575,NaN,1.5,2.75,NaN,NaN,0.9545368641598511,0.6554537214220969,NaN,-0.021200760478615355,0.1793292023322266,0.20052996281084196,25.16149222189037,2.3375905511811,NaN,NaN,NaN,11056799
827505000,65.01562,65.32812,64.9375,65.15625,NaN,NaN,62.575458536585366,65.9140625,59.49663815000006,62.37874730000007,63.99812200000007,64.76015349999993,64.00921269154635,64.77927819096553,64.69230461538463,66.01173389513988,63.37287533562937,59.49663815000006,62.37874730000007,63.99812200000007,64.76015349999993,65.14062333333334,344500,938605,54.00497979856923,NaN,1.5,2.75,NaN,NaN,0.914257088148433,0.3670340558594936,NaN,-0.005599736031599745,0.19353029277134226,0.199130028802942,14.814781013117683,1.4351818193281909,NaN,NaN,NaN,11401299
827764200,65.75,65.8125,64.85937,65.03125,NaN,NaN,62.633004390243904,65.88541666666667,59.556481900000065,62.44593480000007,64.09405960000008,64.76171599999994,64.04929258599552,64.80327550611167,64.67187230769231,65.96110126256812,63.3826433528165,59.556481900000065,62.44593480000007,64.09405960000008,64.76171599999994,65.23437333333334,802400,908305,52.95866779680469,NaN,1.5,2.75,NaN,NaN,0.9170337247092594,0.8834037025008119,NaN,-0.005320407173600078,0.19247951983594191,0.197799927009542,13.828047957214647,2.0348204587258047,NaN,NaN,NaN,10598899
827850600,64.92187,65.51562,64.85937,65.34375,NaN,NaN,62.690550243902436,65.85677083333333,59.616403800000064,62.51155980000007,64.19874720000007,64.78905999999994,64.10005562183883,64.85474926743437,64.6502376923077,65.88296377939358,63.41751160522182,59.616403800000064,62.51155980000007,64.19874720000007,64.78905999999994,65.23958,969400,926725,55.29077868707796,NaN,1.5,2.75,NaN,NaN,0.8984063158014551,1.046049259489061,NaN,0.01327329104384406,0.21439154081434708,0.20111824977050302,12.65557398254502,1.8261584086609937,NaN,NaN,NaN,11568299
827937000,65.4375,65.48437,64.6875,64.75,NaN,NaN,62.748096097560975,65.828125,59.670466300000065,62.56749730000007,64.27687220000007,64.80155999999994,64.12554363666868,64.84477314672634,64.74639153846155,65.78494936698186,63.707833709941234,59.670466300000065,62.56749730000007,64.27687220000007,64.80155999999994,64.97395666666667,809600,923910,50.1986442924775,NaN,1.5,2.75,NaN,NaN,0.8911537218156368,0.8762758277321384,NaN,-0.015493641567650901,0.1817511978109394,0.1972448393785903,13.90171490962625,0.46061385391428933,NaN,NaN,NaN,10758699
828023400,64.51562,65.03125,64.5,65,NaN,NaN,62.80564195121951,65.79947916666667,59.72601320000006,62.62515360000007,64.36374720000008,64.85780999999994,64.15983604307382,64.85955665656192,64.80528615384615,65.80721005574514,63.803362251947156,59.72601320000006,62.62515360000007,64.36374720000008,64.85780999999994,64.84375,1001300,928260,52.19501596059784,NaN,1.5,2.75,NaN,NaN,0.8654463131145198,1.0786848512270268,NaN,-0.018555822922910997,0.17405006072495155,0.19260588364786255,13.857407409492719,1.364522417153996,NaN,NaN,NaN,11759999
828109800,65.1875,65.1875,64.375,64.6875,NaN,NaN,62.86318780487805,65.77083333333333,59.77882570000006,62.68171610000007,64.44030980000007,64.84765399999995,64.180528747267,64.84317030831792,64.87860384615385,65.67468043104539,64.08252726126231,59.77882570000006,62.68171610000007,64.44030980000007,64.84765399999995,64.75,457700,878515,49.52263322259452,NaN,1.5,2.75,NaN,NaN,0.8616644336063398,0.5209928117334366,NaN,-0.04120138299141851,0.1411041549085894,0.18230553790000792,13.813712906654569,-1.027962784831002,NaN,NaN,NaN,11302299
828369000,65,65.45312,64.79687,65.4375,NaN,NaN,62.920733658536584,65.7421875,59.836169450000064,62.74796610000007,64.52374740000006,64.85624799999995,64.22982173757026,64.89977313609717,64.97596,65.70961755620776,64.24230244379224,59.836169450000064,62.74796610000007,64.52374740000006,64.85624799999995,65.22916333333333,773400,884555,55.4217688357312,NaN,1.5,2.75,NaN,NaN,0.8548041169201726,0.8743379439379123,NaN,-0.007034133673210874,0.1735128708084943,0.1805470044817052,10.457726157193129,0.33540967896502155,NaN,NaN,NaN,12075699
828455400,65.51562,65.5625,65.29687,65.5625,NaN,NaN,62.97827951219512,65.71354166666667,59.89109135000006,62.81015360000006,64.60937240000007,64.84062299999995,64.28208363021457,64.96288998027839,65.06129692307692,65.78990360436623,64.33269024178762,59.89109135000006,62.81015360000006,64.60937240000007,64.84062299999995,65.47395666666667,638800,896395,56.33763574971333,NaN,1.5,2.75,NaN,NaN,0.8127202514258746,0.71263226590956,NaN,0.021081172581060986,0.20689847020803143,0.18581729762697044,10.394401878663245,0.6476450485119755,NaN,NaN,NaN,12714499
828541800,65.32812,65.60937,65.17187,65.5625,NaN,NaN,63.03582536585366,65.68489583333333,59.94671635000006,62.870153600000066,64.69218500000007,64.85390449999996,64.33229603687282,65.01999569644235,65.17187384615384,65.70993826359731,64.63380942871038,59.94671635000006,62.870153600000066,64.69218500000007,64.85390449999996,65.44791333333333,288000,879560,56.33763574971333,NaN,1.5,2.75,NaN,NaN,0.785918804895455,0.327436445495475,NaN,0.03590413112249127,0.23069746153008452,0.19479333040759325,10.344404120064281,0.8896446945627103,NaN,NaN,NaN,12714499
828628200,65.5625,65.71875,65.5,65.51562,NaN,NaN,63.09337121951219,65.65625,60.00226320000006,62.92999730000007,64.76406000000006,64.84843549999995,64.37870089817193,65.06719801106689,65.18389307692308,65.74467464335478,64.62311151049138,60.00226320000006,62.92999730000007,64.76406000000006,64.84843549999995,65.57812333333334,934900,899595,55.83864628535636,NaN,1.5,2.75,NaN,NaN,0.7454067474029225,1.039245438224979,NaN,0.03854505479529158,0.24297464890170772,0.20442959410641615,10.207346276030254,0.5515510791366882,NaN,NaN,NaN,11779599
828970200,63.875,64.39062,63.59375,64.39062,NaN,NaN,63.15091707317073,65.62760416666667,60.04859130000006,62.97921600000007,64.81781000000007,64.89296649999994,64.3791683139299,65.0027620100129,65.12019076923077,65.82125814544676,64.41912339301479,60.04859130000006,62.97921600000007,64.81781000000007,64.89296649999994,64.12499666666666,2217200,895960,45.437975800730655,NaN,1.5,2.75,NaN,NaN,0.8294398368741421,2.4746640475021207,NaN,-0.035478878257004964,0.16008099628515993,0.1955598745421649,14.438296862234482,-0.9851110043248462,NaN,NaN,NaN,9562399
829056600,64.64062,64.64062,64.01562,64.14062,NaN,NaN,63.20846292682927,65.59895833333333,60.09421630000006,63.02984100000007,64.85593500000006,64.88827899999994,64.36981347808951,64.92065324715453,65.0432676923077,65.91673623800033,64.16979914661506,60.09421630000006,63.02984100000007,64.85593500000006,64.88827899999994,64.26562,1180900,879435,43.49897644958689,NaN,1.5,2.75,NaN,NaN,0.8148369913831319,1.3427939529356916,NaN,-0.0977530819895113,0.07336852205527578,0.17112160404478707,14.518975575562797,-1.8412319464371139,NaN,NaN,NaN,8381499
829143000,64.03125,64.3125,62.75,63,NaN,NaN,63.26600878048781,65.5703125,60.13741945000006,63.06312230000007,64.86624760000007,64.85156049999995,64.31609530247816,64.73773389028267,64.89062384615384,66.28822077069006,63.49302692161762,60.13741945000006,63.06312230000007,64.86624760000007,64.85156049999995,63.354166666666664,939500,857145,35.95925888962185,NaN,1.5,2.75,NaN,NaN,0.8682414919986225,1.0960805931318505,NaN,-0.20601275505357688,-0.08639433977218403,0.11961841528139286,16.678376512670553,-2.7027027027027026,NaN,NaN,NaN,7441999
829229400,63.15625,63.46875,62.125,62.92187,NaN,NaN,62.125,65.54166666666667,60.18077880000006,63.09234100000007,64.86437260000007,64.78906049999995,64.2614198004202,64.56479447216051,64.71874846153847,66.45253491920266,62.98496200387427,60.18077880000006,63.09234100000007,64.86437260000007,64.78906049999995,62.83854,1276000,869980,35.50528531710988,NaN,1.5,2.75,NaN,NaN,0.9022063854272924,1.4667003839168717,NaN,-0.26914490408494096,-0.21681271482478337,0.05233218926015762,16.342524325129972,-3.1971230769230794,NaN,NaN,NaN,6165999
829315800,63.35937,63.8125,63.17187,63.71875,NaN,NaN,62.130434782608695,65.51302083333333,60.226716300000064,63.12765350000007,64.86531020000005,64.75234199999996,64.24013863177628,64.48421880814523,64.61778692307692,66.41858828357056,62.81698556258328,60.226716300000064,63.12765350000007,64.86531020000005,64.75234199999996,63.56770666666667,411300,854265,43.35956251403665,NaN,1.5,2.75,NaN,NaN,0.9013795007539144,0.48146652385383926,NaN,-0.24422797404896673,-0.2529527783010508,-0.008724804252084058,18.301375325963416,-1.497584541062802,NaN,NaN,NaN,6577299
829575000,64.04687,64.32812,63.84375,64.25,NaN,NaN,62.13586956521739,65.484375,60.27577880000006,63.17140350000007,64.87218520000006,64.75859199999995,64.24052535209877,64.46191225498855,64.53365230769231,66.29263808198338,62.77466653340123,60.27577880000006,63.17140350000007,64.87218520000006,64.75859199999995,64.14062333333334,484200,835015,47.91360519482647,NaN,1.5,2.75,NaN,NaN,0.8805216792714917,0.5798698226977959,NaN,-0.18182501477823396,-0.2360060727248765,-0.054181057946642554,19.089547087520383,-1.8147086914995225,NaN,NaN,NaN,7061499
829661400,64.375,64.65625,64.23437,64.4375,NaN,NaN,62.141304347826086,65.45572916666667,60.32593505000006,63.21218480000007,64.88812280000006,64.71249849999995,64.2482498480949,64.45958727832297,64.50961384615385,66.26465296683052,62.75457472547718,60.32593505000006,63.21218480000007,64.88812280000006,64.71249849999995,64.44270666666667,429700,810620,49.45817806759333,NaN,1.5,2.75,NaN,NaN,0.8477615593235281,0.5300880807283314,NaN,-0.12072071079844046,-0.20508194644469313,-0.08436123564625267,17.664448182894507,-1.7159199237368923,NaN,NaN,NaN,7491199
829747800,64.375,64.5625,63.84375,64.28125,NaN,NaN,62.14673913043478,65.42708333333333,60.374294450000065,63.253278600000066,64.89062280000006,64.66562349999995,64.24954397169903,64.44260277562555,64.45432538461539,66.18925703112455,62.71939373810622,60.374294450000065,63.253278600000066,64.89062280000006,64.66562349999995,64.22916666666667,525300,793960,48.17608645384021,NaN,1.5,2.75,NaN,NaN,0.8385464479432762,0.6616202327573177,NaN,-0.08529574239868472,-0.19098091364460856,-0.10568517124592385,17.52979816903546,-1.9542421353670163,NaN,NaN,NaN,6965899
829834200,64.4375,64.57812,64.09375,64.375,NaN,NaN,62.15217391304348,65.3984375,60.422106950000064,63.293747400000065,64.88281040000005,64.62734249999997,64.25446381594612,64.43616441604216,64.43028692307692,66.16028207690417,62.70029176924968,60.422106950000064,63.293747400000065,64.88281040000005,64.62734249999997,64.34895666666667,818600,797675,49.0298406876319,NaN,1.5,2.75,NaN,NaN,0.813248130233042,1.0262324881687404,NaN,-0.05167429722470131,-0.17027804277680048,-0.11860374555209917,17.609406637730814,-1.7409894006955875,NaN,NaN,NaN,7784499
829920600,64.6875,64.85937,64.42187,64.53125,NaN,NaN,62.15760869565217,65.36979166666667,60.46718510000006,63.33562240000006,64.87062300000005,64.60468649999997,64.2653181761051,64.4452201859429,64.36057538461539,65.99288472404795,62.72826604518283,60.46718510000006,63.33562240000006,64.87062300000005,64.60468649999997,64.60416333333333,885100,809390,50.493690920368806,NaN,1.5,2.75,NaN,NaN,0.7897568352163961,1.093539579189266,NaN,-0.016839377016794735,-0.13965296682309258,-0.12281358980629785,17.77298402570888,0.2184013758525723,NaN,NaN,NaN,8669599
830179800,65.125,65.28125,64.59375,65.03125,NaN,NaN,62.16304347826087,65.34114583333333,60.51351325000006,63.37609120000006,64.85437300000005,64.59843649999996,64.29535471821862,64.50103254918643,64.31971,65.85322097478206,62.78619902521794,60.51351325000006,63.37609120000006,64.85437300000005,64.59843649999996,64.96875,828900,833610,54.952192971010646,NaN,1.5,2.75,NaN,NaN,0.7869170612723677,0.9943498758412207,NaN,0.038905724037999065,-0.07418143475879901,-0.11308715879679808,15.261376051881168,1.388558451726849,NaN,NaN,NaN,9498499
830266200,64.92187,65.28125,64.78125,65.23437,NaN,NaN,62.16847826086956,65.3125,60.56070075000006,63.417966200000066,64.84249800000005,64.60859249999996,64.33217884691592,64.57087421116867,64.29446923076924,65.75436125888059,62.83457720265788,60.56070075000006,63.417966200000066,64.84249800000005,64.60859249999996,65.09895666666667,225400,804760,56.65979533199175,NaN,1.5,2.75,NaN,NaN,0.7664229854671987,0.2800835031562205,NaN,0.08579980898929021,-0.005837397560185309,-0.09163720654947552,14.969227319500401,3.546619047619045,NaN,NaN,NaN,9723899
830352600,65.5625,65.5625,64.85937,65,NaN,NaN,62.17391304347826,65.28385416666667,60.60804450000006,63.458903700000064,64.81593560000005,64.59140499999997,64.35836791174275,64.61174333391452,64.25480615384616,65.60362772203023,62.905984585662104,60.60804450000006,63.458903700000064,64.81593560000005,64.59140499999997,65.14062333333334,699000,791240,54.11101286239509,NaN,1.5,2.75,NaN,NaN,0.7619020579338275,0.8834234871846721,NaN,0.09657283823384885,0.02907884124283555,-0.0674939969910133,9.277779077162164,3.3027149383831116,NaN,NaN,NaN,9024899
830439000,65.14062,65.5625,64.75,65.29687,NaN,NaN,62.17934782608695,65.25520833333333,60.65343510000006,63.50202870000007,64.79812300000005,64.61874849999995,64.39517191520382,64.67699349258933,64.3245176923077,65.78339654012916,62.86563884448623,60.65343510000006,63.50202870000007,64.79812300000005,64.61874849999995,65.20312333333334,475500,774535,56.76409847695977,NaN,1.5,2.75,NaN,NaN,0.7655161966528398,0.6139167371390576,NaN,0.11782353624145843,0.07978542331080973,-0.038038112930648696,8.8679260874083,2.4766964198136314,NaN,NaN,NaN,9500399
830525400,65.46875,65.8125,65.23437,65.4375,NaN,NaN,62.18478260869565,65.2265625,60.70015385000006,63.53906000000006,64.79468560000005,64.64062349999996,64.43604752637229,64.7494226837713,64.4242776923077,65.99248086381999,62.856074520795396,60.70015385000006,63.53906000000006,64.79468560000005,64.64062349999996,65.49479000000001,563300,752635,58.002780067264624,NaN,1.5,2.75,NaN,NaN,0.7521314683204942,0.7484371574534802,NaN,0.1342880218716904,0.1298219144089643,-0.004466107462726097,6.8385370681041495,1.8482490272373542,NaN,NaN,NaN,10063699
830784600,65.15625,65.5625,65.15625,65.4375,NaN,NaN,62.19021739130435,65.19791666666667,60.74710700000006,63.57202880000006,64.79937320000005,64.67812349999996,64.4753201723969,64.81495385674546,64.6117776923077,66.02964392319227,63.193911461423134,60.74710700000006,63.57202880000006,64.79937320000005,64.67812349999996,65.38541666666667,219900,740745,58.002780067264624,NaN,1.5,2.75,NaN,NaN,0.7274256491547445,0.29686329303606507,NaN,0.13760875913690743,0.1675448414584082,0.029936082321500766,5.934625162753202,1.5518913676042676,NaN,NaN,NaN,10063699
830871000,65.4375,65.5625,65.125,65.39062,NaN,NaN,62.19565217391305,65.16927083333333,60.79226325000006,63.60312250000006,64.80843560000005,64.67577949999995,64.5112142832833,64.86977920372209,64.80168153846154,65.88520887222022,63.71815420470286,60.79226325000006,63.60312250000006,64.80843560000005,64.67577949999995,65.35937333333334,184400,711295,57.367362756300516,NaN,1.5,2.75,NaN,NaN,0.70671667421512,0.2592454607441357,NaN,0.1292117607517278,0.1914507832611605,0.06223902250943271,6.056448192820073,1.7258065143412713,NaN,NaN,NaN,9879299
830957400,65.375,65.79687,65.28125,65.53125,NaN,NaN,62.20108695652174,65.140625,60.84054450000006,63.638903800000065,64.83312320000005,64.67421699999996,64.55121568393885,64.93277642241523,64.94110461538462,65.88937063062774,63.9928386001415,60.84054450000006,63.638903800000065,64.83312320000005,64.67421699999996,65.53645666666667,561900,707450,58.82457684276796,NaN,1.5,2.75,NaN,NaN,0.6930669117711827,0.7942610785214502,NaN,0.12558244760470938,0.21921708201531942,0.09363463441061005,5.5267090800011065,1.796116504854369,NaN,NaN,NaN,10441199
831043800,65.01562,65.375,64.09375,64.40625,NaN,NaN,62.20652173913044,65.11197916666667,60.88624765000006,63.66140380000006,64.81937320000004,64.61640449999996,64.54553075515693,64.88263104885188,64.95312384615384,65.86946998184423,64.03677771046345,60.88624765000006,63.66140380000006,64.81937320000004,64.61640449999996,64.625,1299600,758030,45.44299778501189,NaN,1.5,2.75,NaN,NaN,0.7462407037875268,1.7144440193659882,NaN,0.04407590413353189,0.14872951457752492,0.10465361044399303,12.35911633201377,-0.1937046004842615,NaN,NaN,NaN,9141599
831130200,64.78125,64.98437,63.75,64.3125,NaN,NaN,62.21195652173913,65.08333333333333,60.93046640000006,63.680310100000064,64.78312320000005,64.55624849999995,64.53639229417038,64.82833285372313,64.94350846153847,65.8836103086787,64.00340661439824,60.93046640000006,63.680310100000064,64.78312320000005,64.55624849999995,64.34895666666667,1329300,777750,44.53383410720817,NaN,1.5,2.75,NaN,NaN,0.7811070820884176,1.7091610414657665,NaN,-0.016258362969429646,0.08433065673220597,0.10058901970163561,12.286777501292155,-1.1052378664103797,NaN,NaN,NaN,7812299
831389400,64.5625,64.5625,63.6875,64.25,NaN,NaN,62.21739130434783,65.0546875,60.974685150000056,63.70046640000006,64.74937320000005,64.54921749999997,64.52516122381076,64.77325353432093,64.94110461538462,65.88810228671701,63.99410694405223,60.974685150000056,63.70046640000006,64.74937320000005,64.54921749999997,64.16666666666667,647500,699265,43.90321825371878,NaN,1.5,2.75,NaN,NaN,0.7878137190821021,0.9259722708844287,NaN,-0.05812807734850367,0.027928923016006024,0.0860570003645097,11.164903134465797,-1.5089744869154074,NaN,NaN,NaN,7164799
831475800,64.25,64.25,63.76562,63.98437,NaN,NaN,62.22282608695652,65.02604166666667,61.01554450000006,63.71406010000006,64.72906060000005,64.54140499999997,64.50395372483779,64.6981217691475,64.91105615384616,65.94847065806796,63.87364164962435,61.01554450000006,63.71406010000006,64.72906060000005,64.54140499999997,63.999996666666675,582100,669325,41.23095072220619,NaN,1.5,2.75,NaN,NaN,0.7661398820048092,0.8696821424569529,NaN,-0.09906048458882788,-0.037768605371525155,0.061291879217302725,10.910484792878645,-1.5625076923076948,NaN,NaN,NaN,6582699
831562200,63.67187,64.78125,63.07812,64.78125,NaN,NaN,63.07812,64.99739583333333,61.05827890000006,63.74015390000006,64.72874820000004,64.63046749999997,64.51482808856964,64.70603874351441,64.93028692307692,65.94790601531183,63.91266783084202,61.05827890000006,63.74015390000006,64.72874820000004,64.63046749999997,64.21354000000001,1694700,707085,50.88850617985335,NaN,1.5,2.75,NaN,NaN,0.8330677475758944,2.396741551581493,NaN,-0.06922697658292983,-0.025241841511359553,0.04398513507157027,13.545347866572085,-0.7896550018400551,NaN,NaN,NaN,8277399
831648600,64.5625,65.0625,64.5,64.73437,NaN,NaN,63.12828421052632,64.96875,61.10101325000006,63.76937260000006,64.73343560000005,64.72109249999997,64.5234375752924,64.7087369584178,64.90745000000001,65.92830078800964,63.88659921199039,61.10101325000006,63.76937260000006,64.73343560000005,64.72109249999997,64.76562333333334,593400,672955,50.364158337146684,NaN,1.5,2.75,NaN,NaN,0.8137414798919019,0.8817825857598205,NaN,-0.05029169539150559,-0.01887948416781171,0.03141221122369388,13.18223150587369,-1.074506208213947,NaN,NaN,NaN,7683999
831735000,65.375,65.59375,65.0625,65.375,NaN,NaN,63.17844842105263,64.94010416666667,61.14460700000006,63.81687260000006,64.76343560000005,64.80390499999996,64.5568321801829,64.77219058142563,64.9182676923077,65.95559385583667,63.88094152877871,61.14460700000006,63.81687260000006,64.76343560000005,64.80390499999996,65.34375,925100,698645,56.899737128402634,NaN,1.5,2.75,NaN,NaN,0.8170013741853376,1.3241345747840463,NaN,0.004810076635296125,0.03742480701781403,0.03261473038251791,14.497480232610844,-0.09551098376313276,NaN,NaN,NaN,8609099
831994200,65.53125,66.64062,65.46875,66.35937,NaN,NaN,63.22861263157895,64.91145833333333,61.19491950000006,63.867810100000064,64.79281060000005,64.90937349999996,64.62751993782278,64.92335052605176,65.02283461538462,66.3148335024879,63.730835728281356,61.19491950000006,63.867810100000064,64.79281060000005,64.90937349999996,66.15624666666668,867500,717810,64.61052221835618,NaN,1.5,2.75,NaN,NaN,0.8490455617435276,1.2085370780568674,NaN,0.10161749913836629,0.15963660430547577,0.05801910516710948,16.86983689840038,1.4814815947608388,NaN,NaN,NaN,9476599
832080600,66.625,66.9375,66.5625,66.76562,NaN,NaN,63.27877684210526,64.8828125,61.24796635000006,63.92874760000006,64.82281060000005,65.02577949999996,64.71136699908463,65.09880476166587,65.13581538461538,66.72630284292775,63.54532792630302,61.24796635000006,63.92874760000006,64.82281060000005,65.02577949999996,66.75520666666667,632300,727940,67.21718366356976,NaN,1.5,2.75,NaN,NaN,0.8296944501904185,0.8686155452372448,NaN,0.1823645356910639,0.28597477478093936,0.10361023908987546,17.009933602446004,1.8836356700047663,NaN,NaN,NaN,10108899
832167000,66.78125,67.3125,66.64062,66.6875,NaN,NaN,63.32894105263158,64.85416666666667,61.301091350000064,63.98577890000006,64.83906060000005,65.14609199999995,64.78886241088523,65.25010907007865,65.23196923076924,67.02236092703443,63.441577534504056,61.301091350000064,63.98577890000006,64.83906060000005,65.14609199999995,66.88020666666667,466100,724980,66.20730332404669,NaN,1.5,2.75,NaN,NaN,0.8184219894625315,0.6429142872906839,NaN,0.21748533289844488,0.3754669052129316,0.1579815723144867,17.111207696759777,3.541969917515769,NaN,NaN,NaN,9642799
832253400,66.3125,66.9375,66.28125,66.82812,NaN,NaN,63.37910526315789,64.82552083333333,61.35554445000006,64.04202890000006,64.86968560000005,65.26874799999995,64.86883329673287,65.40039582530926,65.33894000000001,67.32152429442235,63.35635570557766,61.35554445000006,64.04202890000006,64.86968560000005,65.26874799999995,66.68229000000001,514400,709770,67.1636471566697,NaN,1.5,2.75,NaN,NaN,0.8068382759294935,0.7247418177719543,NaN,0.23563117970438452,0.45252054694496735,0.21688936724058283,12.099404315306233,3.9115568513119507,NaN,NaN,NaN,10157199
832339800,67,67.29687,67,67.1875,NaN,NaN,63.42926947368421,64.796875,61.41187260000006,64.09890390000005,64.90093560000005,65.40156049999995,64.95976140274335,65.57059622289886,65.47716153846154,67.69184799362644,63.26247508329665,61.41187260000006,64.09890390000005,64.90093560000005,65.40156049999995,67.16145666666667,427700,686900,69.5364579218505,NaN,1.5,2.75,NaN,NaN,0.7826891133631012,0.622652496724414,NaN,0.25560992219890305,0.5364017699892116,0.2807918477903086,11.663835911065279,4.571984435797665,NaN,NaN,NaN,10584899
832599000,67.65625,67.75,66.98437,67.64062,NaN,NaN,63.47943368421053,64.76822916666667,61.47015385000006,64.16062260000007,64.98374800000005,65.53202899999994,65.06489311243969,65.76774134452754,65.63942076923078,68.13717850258715,63.141663035874416,61.47015385000006,64.16062260000007,64.98374800000005,65.53202899999994,67.45833,788500,684880,72.25842755072284,NaN,1.5,2.75,NaN,NaN,0.781470605265737,1.1512965775026283,NaN,0.28108985059607455,0.6321541610354018,0.35106431043932723,11.201203292583251,5.714286160823339,NaN,NaN,NaN,11373399
832685400,67.75,67.875,67.5,67.54687,NaN,NaN,63.52959789473684,64.73958333333333,61.52734135000006,64.22202880000006,65.04999800000004,65.64765399999995,65.16222553940284,65.93718216885824,65.88100692307692,68.46110838933748,63.30090545681636,61.52734135000006,64.22202880000006,65.04999800000004,65.64765399999995,67.64062333333334,352700,691245,70.84792861760398,NaN,1.5,2.75,NaN,NaN,0.7524369906038987,0.510238772070684,NaN,0.2731414893510756,0.6924911721281717,0.4193496827770961,10.453753957601275,4.2691673902556655,NaN,NaN,NaN,11020699
832771800,67.625,68.1875,67.39062,68.1875,NaN,NaN,63.57976210526316,64.7109375,61.58773200000006,64.28906010000006,65.13906060000005,65.80702899999994,65.28086375354391,66.15149815277651,66.17908384615386,68.85890300720932,63.499264685098396,61.58773200000006,64.28906010000006,65.13906060000005,65.80702899999994,67.92187333333334,1218100,717200,74.50961636325718,NaN,1.5,2.75,NaN,NaN,0.7556114912750489,1.6984104852203012,NaN,0.29090146125179184,0.7829765093418359,0.4920750480900441,9.858580621797234,5.334306953168775,NaN,NaN,NaN,12238799
832858200,68.28125,68.4375,67.53125,67.90625,NaN,NaN,63.62992631578947,64.68229166666667,61.64679450000006,64.34671640000006,65.21374820000004,65.93749799999995,65.38382007693434,66.31861737632161,66.46033384615386,69.03673969192313,63.883928000384586,61.64679450000006,64.34671640000006,65.21374820000004,65.93749799999995,67.95833333333333,967900,741820,70.33285123991944,NaN,1.5,2.75,NaN,NaN,0.7663713847554025,1.3047639589118654,NaN,0.26434866004734636,0.822510873149227,0.5581622131018806,10.750121776055744,3.87189292543021,NaN,NaN,NaN,11270899
832944600,67.96875,68.32812,67.9375,68.17187,NaN,NaN,63.68009052631579,64.65364583333333,61.70781010000006,64.40531010000007,65.28812320000004,66.07421649999995,65.49315536803496,66.49511762619575,66.78244923076923,69.07109470738175,64.49380375415672,61.70781010000006,64.40531010000007,65.28812320000004,66.07421649999995,68.14583,659100,746610,71.93305677132287,NaN,1.5,2.75,NaN,NaN,0.7417641429871592,0.8827902117571422,NaN,0.24571087460068364,0.8653008063527352,0.6195899317520516,10.256596149459956,2.731339975047985,NaN,NaN,NaN,11929999
833290200,68.375,68.375,67.3125,67.48437,NaN,NaN,63.730254736842106,64.625,61.76695070000006,64.46296630000006,65.35531060000005,66.17655999999994,65.57124221634731,66.58933213798663,66.99038153846155,68.98645439883519,64.9943086780879,61.76695070000006,64.46296630000006,65.35531060000005,66.17655999999994,67.72395666666667,456400,758435,62.5315819497166,NaN,1.5,2.75,NaN,NaN,0.764673847059505,0.6017654775953114,NaN,0.17162517467896332,0.8341214001007557,0.6624962254217924,10.719757825436055,1.0765271108094256,NaN,NaN,NaN,11473599
833376600,67.625,67.6875,66.8125,67.03125,NaN,NaN,63.78041894736842,64.59635416666667,61.82132570000006,64.51734130000006,65.38874820000005,66.25859149999994,65.62849742354938,66.63141955341648,67.16706461538462,68.68163585722564,65.65249337354359,61.82132570000006,64.51734130000006,65.38874820000005,66.25859149999994,67.17708333333333,649600,781695,57.22317023931168,NaN,1.5,2.75,NaN,NaN,0.7725542865552547,0.8310146540530514,NaN,0.08123590653587898,0.7640411085916412,0.6828052020557622,11.297053800824479,0.5154639175257731,NaN,NaN,NaN,10823999
833463000,66.9375,67.71875,66.75,67.375,NaN,NaN,63.830583157894736,64.56770833333333,61.87796635000006,64.57281010000005,65.43187320000004,66.35077899999995,65.69698772066509,66.70223673880538,67.32091076923078,68.42743809966834,66.21438343879322,61.87796635000006,64.57281010000005,65.43187320000004,66.35077899999995,67.28125,895800,798390,59.997550147972326,NaN,1.5,2.75,NaN,NaN,0.7865682660870222,1.1220080411828806,NaN,0.036035461184552475,0.7278495285364528,0.6918140673519003,11.550277259610532,0.8183381486715496,NaN,NaN,NaN,11719799
833549400,67.35937,67.64062,66.875,66.875,NaN,NaN,63.88074736842105,64.5390625,61.93132575000006,64.63390390000006,65.46656080000004,66.47421649999994,65.74318428063901,66.71869038272868,67.36057461538462,68.35797628225606,66.36317294851318,61.93132575000006,64.63390390000006,65.46656080000004,66.47421649999994,67.13020666666667,923500,779585,54.46428914893344,NaN,1.5,2.75,NaN,NaN,0.7850719613665206,1.1846046293861479,NaN,-0.03240030940978711,0.6513136805896664,0.6837139899994535,12.484514852334911,-0.46511627906976744,NaN,NaN,NaN,10796299
833808600,66.89062,67.10937,66.70312,67.0625,NaN,NaN,63.93091157894737,64.51041666666667,61.986091400000056,64.70484140000006,65.50812340000004,66.61171649999994,65.7949221519865,66.75143415580214,67.38341153846154,68.33795217429635,66.42887090262674,61.986091400000056,64.70484140000006,65.50812340000004,66.61171649999994,66.95833,503100,738275,56.09935225052852,NaN,1.5,2.75,NaN,NaN,0.7580132498403406,0.6814533879651892,NaN,-0.06786352481040547,0.5988845839864467,0.6667481087968522,12.17031686167082,-0.8546935258724689,NaN,NaN,NaN,11299399
833895000,67.375,67.59375,67.25,67.53125,NaN,NaN,63.98107578947368,64.48177083333333,62.04288830000006,64.77687270000006,65.55562340000004,66.77577899999994,65.86301344014389,66.82570233144004,67.44831538461538,68.31550024715409,66.58113052207668,62.04288830000006,64.77687270000006,65.55562340000004,66.77577899999994,67.45833333333333,627100,737255,59.969260774380274,NaN,1.5,2.75,NaN,NaN,0.7418158748517448,0.8505876528473866,NaN,-0.06269774839950037,0.5883759232974768,0.6510736716969772,12.221553407249292,-0.023124683645590702,NaN,NaN,NaN,11926499
833981400,67.5625,68.20312,67.42187,68.125,NaN,NaN,64.03124,64.453125,62.10343520000006,64.85577900000006,65.61749840000004,66.98281049999994,65.95171879543236,66.949444966541,67.54807538461539,68.4052467899142,66.69090397931657,62.10343520000006,64.85577900000006,65.61749840000004,66.98281049999994,67.91666333333333,428000,729550,64.26617162733487,NaN,1.5,2.75,NaN,NaN,0.7446325980766202,0.5866630114454116,NaN,-0.024217196742756464,0.6208021757685316,0.645019372511288,13.193872694341637,-0.09165902841429881,NaN,NaN,NaN,12354499
834067800,68.5,68.5,67.5,67.625,NaN,NaN,64.08140421052632,68.5,62.16093520000006,64.93093530000006,65.66312340000005,67.12499799999995,66.01733766619971,67.01378354115614,67.58172923076924,68.41361187587147,66.74984658566702,62.16093520000006,64.93093530000006,65.66312340000005,67.12499799999995,67.875,523300,670980,58.565145573799015,NaN,1.5,2.75,NaN,NaN,0.762873126785433,0.7799040209842321,NaN,-0.036618177390848716,0.5992466507727272,0.6358648281635759,12.708601135287289,-0.4141739530602853,NaN,NaN,NaN,11831199
834154200,66.1875,67.64062,66.1875,67.625,NaN,NaN,66.1875,68.54545454545455,62.21945085000006,64.99874780000006,65.72062340000004,67.26952949999995,66.08038324791737,67.07199463247461,67.5805276923077,68.41211169670778,66.74894368790761,62.21945085000006,64.99874780000006,65.72062340000004,67.26952949999995,67.15104000000001,1422800,712450,58.56514557379902,NaN,1.5,2.75,NaN,NaN,0.8121764748721877,1.9970524247315602,NaN,-0.04826834470911712,0.5755293972771796,0.6237977419862967,12.535906586660145,-0.8021930453132625,NaN,NaN,NaN,11831199
834413400,67.53125,67.73437,67.29687,67.40625,NaN,NaN,66.33556571428572,68.5909090909091,62.27656025000006,65.06624780000006,65.76874840000004,67.37109199999995,66.13237802250885,67.10382847700085,67.56971076923077,68.40640714027273,66.7330143981888,62.27656025000006,65.06624780000006,65.76874840000004,67.37109199999995,67.47916333333333,548800,693635,56.042615148594734,NaN,1.5,2.75,NaN,NaN,0.7854138695241744,0.7911942159781441,NaN,-0.07268729639495364,0.5329386214926046,0.6056259178875583,12.304082873459837,-0.11576013823645151,NaN,NaN,NaN,11282399
834499800,67.65625,68.03125,67.34375,67.34375,NaN,NaN,66.48363142857143,68.63636363636364,62.331794650000056,65.13109160000005,65.82187340000004,67.42031099999996,66.17988280593987,67.12667814585791,67.50480692307693,68.26735927117201,66.74225457498184,62.331794650000056,65.13109160000005,65.82187340000004,67.42031099999996,67.57291666666667,688700,684695,55.30959768002413,NaN,1.5,2.75,NaN,NaN,0.7784200217010191,1.0058493197701166,NaN,-0.09369221392901783,0.48851065047628595,0.5822028644053038,10.895051043786719,0.4662004662004662,NaN,NaN,NaN,10593699
834586200,67.5625,67.73437,67.10937,67.21875,NaN,NaN,66.63169714285715,68.68181818181819,62.387419650000055,65.19062290000005,65.85749840000004,67.44296749999997,66.22062269590302,67.13544689387145,67.45192230769231,68.1907662316323,66.71307838375233,62.387419650000055,65.19062290000005,65.85749840000004,67.44296749999997,67.35416333333333,1120600,709110,53.79413400438522,NaN,1.5,2.75,NaN,NaN,0.7674614487223749,1.580290787042913,NaN,-0.1152312289925479,0.43816382816461896,0.5533950571571669,10.162149493315804,-0.23191094619666047,NaN,NaN,NaN,9473099
834672600,67.375,67.46875,66.82812,67.21875,NaN,NaN,66.77976285714286,68.72727272727273,62.44234155000006,65.24999790000005,65.89062340000004,67.46952999999996,66.2597649431225,67.14338052302655,67.37860538461538,67.9963701985928,66.76084057063797,62.44234155000006,65.24999790000005,65.89062340000004,67.46952999999996,67.17187333333334,1502000,760905,53.79413400438522,NaN,1.5,2.75,NaN,NaN,0.7584020595279196,1.9739652124772475,NaN,-0.12773605202221938,0.3937249921293926,0.521461044151612,9.685419867423223,0.514018691588785,NaN,NaN,NaN,9473099
834759000,67.25,67.25,66.71875,66.9375,NaN,NaN,66.92782857142858,68.77272727272727,62.49523220000005,65.30515420000005,65.91812340000004,67.47499899999997,66.28634278849024,67.12377285416687,67.33653846153847,67.99303056255485,66.68004636052208,62.49523220000005,65.30515420000005,65.91812340000004,67.47499899999997,66.96875,1468200,808595,50.20458182679958,NaN,1.5,2.75,NaN,NaN,0.7421769124187826,1.8157421205918909,NaN,-0.15158047666781538,0.33198544831684274,0.4835659249846581,8.951929186307412,-0.1863932898415657,NaN,NaN,NaN,8004899
835018200,66.96875,67.21875,66.71875,66.89062,NaN,NaN,67.07589428571428,68.81818181818181,62.547654050000055,65.35484170000005,65.94562340000004,67.46015499999996,66.31003993403965,67.1015678204367,67.32572076923077,68.00617583037392,66.64526570808762,62.547654050000055,65.35484170000005,65.94562340000004,67.46015499999996,66.94270666666667,1101000,842260,49.61034798859245,NaN,1.5,2.75,NaN,NaN,0.7248785615317267,1.3071973024956665,NaN,-0.1659799513438755,0.2760909858048137,0.4420709371486892,8.788995475978256,-0.9486422952336905,NaN,NaN,NaN,6903899
835104600,66.84375,67.03125,66.32812,66.34375,NaN,NaN,67.22396,68.86363636363636,62.596091550000054,65.40124800000005,65.98468600000004,67.39531149999996,66.31136189741065,67.02939469468082,67.24639384615385,68.10301409284529,66.38977359946242,62.596091550000054,65.40124800000005,65.98468600000004,67.39531149999996,66.56770666666667,718000,838735,43.188457465836684,NaN,1.5,2.75,NaN,NaN,0.7233250928508891,0.8560510769194084,NaN,-0.20523456195037731,0.1855277347107176,0.3907622966610949,8.537427708283506,-2.614678899082569,NaN,NaN,NaN,6185899
835191000,66.65625,67,66.42187,66.64062,NaN,NaN,67.37202571428571,68.9090909090909,62.64335715000006,65.44531050000005,66.03468600000004,67.34999899999997,66.32427397986514,66.99236853328264,67.22836461538462,68.12444963461834,66.3322795961509,62.64335715000006,65.44531050000005,66.03468600000004,67.34999899999997,66.68749666666668,552100,848705,47.18525978239087,NaN,1.5,2.75,NaN,NaN,0.7185340147901113,0.6505204988777019,NaN,-0.20369681193002448,0.13614128174856432,0.3398380936785888,6.77995729739672,-1.4556451016635883,NaN,NaN,NaN,6737999
835277400,66.70312,66.92187,66.1875,66.59375,NaN,NaN,67.52009142857143,68.95454545454545,62.689841550000054,65.48640430000005,66.10656100000004,67.27031149999996,66.33484166692925,66.9544048634462,67.19230692307693,68.14793314090643,66.23668070524742,62.689841550000054,65.48640430000005,66.10656100000004,67.27031149999996,66.56770666666667,1234400,849520,46.62751986589531,NaN,1.5,2.75,NaN,NaN,0.7196651565908175,1.4530558432997458,NaN,-0.19814422946786442,0.0921578068437583,0.2903020363116227,5.952849581641982,-1.5249537892791127,NaN,NaN,NaN,5503599
835363800,66.5625,66.8125,66.375,66.8125,NaN,NaN,67.66815714285714,69,62.73726345000006,65.52437310000005,66.18437360000003,67.21562399999996,66.35357336626535,66.94089011454656,67.13701846153846,68.09097412561931,66.18306279745761,62.73726345000006,65.52437310000005,66.18437360000003,67.21562399999996,66.66666666666667,573300,829790,49.6205857853586,NaN,1.5,2.75,NaN,NaN,0.6995105025486162,0.6908976970076767,NaN,-0.17296344471662342,0.07409773041584344,0.24706117513246686,6.530563365637495,-0.8808530366249421,NaN,NaN,NaN,6076899
835623000,66.96875,67.21875,66.84375,66.9375,NaN,NaN,67.81622285714286,69.04545454545455,62.78421660000006,65.55702940000005,66.24874860000004,67.15390549999998,66.37647244994122,66.94056724649451,67.04567230769231,67.81285067784856,66.27849393753607,62.78421660000006,65.55702940000005,66.24874860000004,67.15390549999998,67,416500,817660,51.301184138182855,NaN,1.5,2.75,NaN,NaN,0.6785633237951437,0.5093804270723773,NaN,-0.1423887886834746,0.06907518927812362,0.21146397796159822,6.606615276923406,-0.6032482598607889,NaN,NaN,NaN,6493399
835709400,67.125,67.17187,66.78125,66.85937,NaN,NaN,67.96428857142857,69.0909090909091,62.829997850000055,65.58656060000004,66.30093600000004,67.12265549999998,66.39540960876705,66.93283417539979,66.9867776923077,67.6811119297555,66.29244345485989,62.829997850000055,65.58656060000004,66.30093600000004,67.12265549999998,66.93749666666668,454400,817560,50.17454011951305,NaN,1.5,2.75,NaN,NaN,0.657995943524062,0.5558001859190763,NaN,-0.1226748818185329,0.05812037568843209,0.18079525750696498,6.611098913002199,-0.5346424918642515,NaN,NaN,NaN,6038999
835795800,66.78125,66.92187,66.39062,66.40625,NaN,NaN,68.11235428571429,69.13636363636364,62.87218535000005,65.61421690000005,66.34031100000004,67.09140549999998,66.39583472214873,66.88268330155219,66.8930276923077,67.54518434720086,66.24087103741454,62.87218535000005,65.61421690000005,66.34031100000004,67.09140549999998,66.57291333333333,838200,826990,44.12252781867522,NaN,1.5,2.75,NaN,NaN,0.6489426618437718,1.013555182045732,NaN,-0.1344531025828531,0.012728879278398608,0.1471819818612517,7.4719271531227225,-1.208740120874012,NaN,NaN,NaN,5200799
835882200,66.40625,67.04687,66.15625,66.875,NaN,NaN,68.26042,69.18181818181819,62.915388500000056,65.64140440000004,66.39218600000004,67.06640549999997,66.41462551735859,66.88195155854721,66.85216230769231,67.4332673844364,66.27105723094822,62.915388500000056,65.64140440000004,66.39218600000004,67.06640549999997,66.69270666666667,1090500,836725,50.741765499319335,NaN,1.5,2.75,NaN,NaN,0.6662053288549308,1.3032955869610685,NaN,-0.10621450948480064,0.014413845005250892,0.12062835449005153,8.850286277197464,-0.09337068160597572,NaN,NaN,NaN,6291299
835968600,67.15625,67.5,66.96875,67.10937,NaN,NaN,68.40848571428572,69.22727272727273,62.95710725000006,65.66484190000004,66.44687340000004,67.07812399999997,66.4418703990308,66.9036104577332,66.83413307692308,67.36552942468798,66.30273672915818,62.95710725000006,65.66484190000004,66.44687340000004,67.07812399999997,67.19270666666667,1060800,843590,53.69529791598939,NaN,1.5,2.75,NaN,NaN,0.6632620910795787,1.2574829004611245,NaN,-0.06908996611806519,0.034265896842470056,0.10335586296053524,8.780521894949667,0.32702642014680083,NaN,NaN,NaN,7352099
836227800,67.28125,67.70312,67.1875,67.6875,NaN,NaN,68.55655142857142,69.27272727272727,63.00335725000005,65.69031070000004,66.50999840000004,67.10937399999997,66.49071861867665,66.97826660461574,66.87019076923077,67.54527358796186,66.19510795049969,63.00335725000005,65.69031070000004,66.50999840000004,67.10937399999997,67.52604000000001,471300,842000,60.05748551430692,NaN,1.5,2.75,NaN,NaN,0.6582969417167517,0.5597387173396675,NaN,-0.006246581058867412,0.09554763663695098,0.1017942176958184,9.944634703591536,2.025435704192181,NaN,NaN,NaN,7823399
836314200,67.625,67.64062,67.32812,67.4375,NaN,NaN,68.70461714285715,69.31818181818181,63.049451000000055,65.70624820000005,66.55812340000004,67.10468649999997,66.52784730029718,67.02200311846185,66.8870176923077,67.60552254503082,66.16851283958457,63.049451000000055,65.70624820000005,66.55812340000004,67.10468649999997,67.46874666666666,389400,830115,56.44578227606152,NaN,1.5,2.75,NaN,NaN,0.6369457315941267,0.46909163188232955,NaN,0.016587436912317538,0.12252851383621532,0.10594107692389779,8.640348758346002,1.1957871940567204,NaN,NaN,NaN,7433999
836400600,67.40625,67.5,67.0625,67.29687,NaN,NaN,68.85268285714285,69.36363636363636,63.09343535000006,65.72093570000004,66.59937340000005,67.06327999999996,66.55800505322671,67.04818091670359,66.91466153846154,67.66572356759892,66.16359950932417,63.09343535000006,65.72093570000004,66.59937340000005,67.06327999999996,67.28645666666667,308300,824130,54.461704051725626,NaN,1.5,2.75,NaN,NaN,0.6226996079088319,0.37409146615218475,NaN,0.020089293517207965,0.13105269382040774,0.11096340030319977,8.673208396195815,1.0558348193336438,NaN,NaN,NaN,7125699
836573400,66.125,66.4375,65.375,65.57812,NaN,NaN,69.00074857142857,69.4090909090909,63.127419700000054,65.71343570000005,66.61093580000005,66.96093599999996,66.51957818839429,66.90817511511277,66.81370000000001,67.84945454873426,65.77794545126577,63.127419700000054,65.71343570000005,66.61093580000005,66.96093599999996,65.79687333333334,842900,840110,37.23511179619313,NaN,1.5,2.75,NaN,NaN,0.7154974930582009,1.0033209936793992,NaN,-0.0894671663933717,-0.0008705576885148503,0.08859660870485685,17.726738021452743,-1.8475285313377012,NaN,NaN,NaN,6282799
836832600,65.625,65.98437,65.125,65.3125,NaN,NaN,69.14881428571428,69.45454545454545,63.16249785000005,65.70468570000004,66.61124840000004,66.84531099999995,66.47224178884942,66.7562060565306,66.73437307692308,68.0278480476981,65.44089810614805,63.16249785000005,65.70468570000004,66.61124840000004,66.84531099999995,65.47395666666667,942000,816070,35.372971341222396,NaN,1.5,2.75,NaN,NaN,0.7257741006969007,1.1543127427794184,NaN,-0.17120398253737984,-0.12540836946686795,0.04579561307051188,17.496459787456956,-2.4276377217553686,NaN,NaN,NaN,5340799
836919000,65.60937,65.8125,65.375,65.57812,NaN,NaN,69.29688,69.5,63.19882595000006,65.70437320000005,66.61406080000005,66.75390449999995,66.4371781892867,66.64400738448006,66.65264230769232,68.08617419902002,65.21911041636461,63.19882595000006,65.70437320000005,66.61406080000005,66.75390449999995,65.58854000000001,739200,825590,38.675730027246374,NaN,1.5,2.75,NaN,NaN,0.7096473792185506,0.8953596821666929,NaN,-0.19692650172488738,-0.20036251408559735,-0.003436012360709971,17.7290088809695,-1.9163357357390596,NaN,NaN,NaN,6079999
837005400,65.5625,65.84375,64.92187,65.84375,NaN,NaN,69.44494571428572,69.54545454545455,63.23695095000006,65.71077950000004,66.62218580000004,66.67890449999996,66.41390649558917,66.56779239548196,66.59495000000001,68.09226695447222,65.0976330455278,63.23695095000006,65.71077950000004,66.62218580000004,66.67890449999996,65.53645666666667,1132300,847770,41.87483078004252,NaN,1.5,2.75,NaN,NaN,0.7248068521315113,1.3356216898451232,NaN,-0.1857424542888783,-0.23561408022180785,-0.04987162593292955,18.072002924022055,-0.8470588235294118,NaN,NaN,NaN,7212299
837091800,65.5625,65.6875,63.875,64.51562,NaN,NaN,69.59301142857143,69.5909090909091,63.26851345000006,65.70656070000004,66.60468580000004,66.54374799999995,66.33946388791901,66.37234740543606,66.41826692307693,68.27106764071604,64.56546620543782,63.26851345000006,65.70656070000004,66.60468580000004,66.54374799999995,64.69270666666667,1587400,871110,32.691858234617825,NaN,1.5,2.75,NaN,NaN,0.8136599341221177,1.8222727324907302,NaN,-0.25329906740050234,-0.3664954601835575,-0.11319639278305516,20.961335117376105,-3.5280448598130865,NaN,NaN,NaN,5624899
837178200,64.625,64.90625,64.07812,64.5625,NaN,NaN,69.74107714285715,69.63636363636364,63.30054470000005,65.70921700000004,66.58531080000004,66.41093549999995,66.26977902956925,66.19998098587072,66.23557461538462,68.30343882581236,64.16771040495688,63.30054470000005,65.70921700000004,66.58531080000004,66.41093549999995,64.51562333333334,1312000,861610,33.24830575779957,NaN,1.5,2.75,NaN,NaN,0.8146935102562523,1.522730701825652,NaN,-0.2783401260542953,-0.4611215503509243,-0.18278142429662897,20.168263887098167,-3.7951034259448395,NaN,NaN,NaN,6936899
837437400,64.71875,64.71875,62.65625,62.65625,NaN,NaN,69.88914285714286,69.68181818181819,63.320857200000056,65.68484200000005,66.55031080000005,66.19687299999995,66.12807200880182,65.86248279674018,65.91225769230769,68.6835782312572,63.14093715335818,63.320857200000056,65.68484200000005,66.55031080000005,66.19687299999995,63.34375,1951300,885765,24.411011362777785,NaN,1.5,2.75,NaN,NaN,0.9038225452379486,2.2029545082499307,NaN,-0.39943036544655636,-0.6820693811048244,-0.28263901565826804,24.561663342097678,-7.433056325023084,NaN,NaN,NaN,4985599
837523800,62.84375,63.5,60.375,62.8125,NaN,NaN,60.375,69.72727272727273,63.34249785000006,65.65171700000005,66.52031080000005,65.99296699999995,65.9980495770841,65.57200824466969,65.63581538461538,68.8383005628144,62.433330206416365,63.34249785000006,65.65171700000005,66.52031080000005,65.99296699999995,62.229166666666664,4141000,1037765,26.14386246643555,NaN,1.5,2.75,NaN,NaN,1.0624780777209524,3.990306090492549,NaN,-0.4418403058795385,-0.8349393980076911,-0.39309909212815264,23.384190952395226,-6.85820203892493,NaN,NaN,NaN,9126599
837610200,63.75,64,63,63.5625,NaN,NaN,60.15144230769231,69.77272727272727,63.369372850000055,65.62796700000004,66.50656080000005,65.85390449999996,65.90253782896316,65.3806265070821,65.38100769230769,68.6743912445096,62.08762414010578,63.369372850000055,65.62796700000004,66.50656080000005,65.85390449999996,63.52083333333334,1340500,1068890,33.968750772495014,NaN,1.5,2.75,NaN,NaN,1.0714082150265987,1.2541047254628634,NaN,-0.39381297873499144,-0.8853653155468919,-0.49155233681190047,25.87191553248225,-5.549099088858068,NaN,NaN,NaN,10467099
837696600,63.75,64.54687,63.32812,64.4375,NaN,NaN,59.92788461538461,69.81818181818181,63.400310350000055,65.62234200000005,66.51562340000004,65.74374849999995,65.84508536508226,65.29080493497904,65.17547923076924,68.34283894847982,62.00811951305865,63.400310350000055,65.62234200000005,66.51562340000004,65.74374849999995,64.10416333333333,1432500,1112910,41.72584415414018,NaN,1.5,2.75,NaN,NaN,1.0819326282389845,1.2871660781195244,NaN,-0.2827442087682521,-0.8449825977722156,-0.5622383890039635,28.19590399550582,-1.7393301302324593,NaN,NaN,NaN,11899599
837783000,64.28125,64.375,63.625,63.96875,NaN,NaN,59.70432692307692,69.86363636363636,63.42921660000005,65.61406080000005,66.49937340000004,65.61249849999996,65.77150358605942,65.16489494117151,64.88942153846155,67.75495758376604,62.023885493157046,63.42921660000005,65.61406080000005,66.49937340000004,65.61249849999996,63.98958333333334,1216000,1111990,39.07738710566569,NaN,1.5,2.75,NaN,NaN,1.0626874405076285,1.093535013804081,NaN,-0.22309524672030145,-0.8411074474043403,-0.6180122006840388,24.82797106367105,-2.0574162679425836,NaN,NaN,NaN,10683599
838042200,63.53125,63.75,63.01562,63.5,NaN,NaN,59.48076923076923,69.9090909090909,63.45491975000005,65.60406080000004,66.47468600000003,65.44687349999995,65.68242501405709,65.0063335182028,64.58653692307692,67.12436730353168,62.048706542622156,63.45491975000005,65.60406080000004,66.47468600000003,65.44687349999995,63.42187333333334,519800,1109315,36.57714378690777,NaN,1.5,2.75,NaN,NaN,1.054861909042798,0.46857745545674584,NaN,-0.19829364206961742,-0.8658792532710606,-0.6675856112014432,24.975672236226085,-3.1689228053503187,NaN,NaN,NaN,10163799
838128600,63.59375,63.9375,62.57812,62.6875,NaN,NaN,59.25721153846154,69.95454545454545,63.47632600000006,65.59218580000004,66.42093600000004,65.23437349999996,65.56497697429015,64.78549223075491,64.23197,66.41990900835964,62.044030991640376,63.47632600000006,65.59218580000004,66.42093600000004,65.23437349999996,63.06770666666667,1479800,1162480,32.67471217295464,NaN,1.5,2.75,NaN,NaN,1.0766132012540268,1.2729681370862294,NaN,-0.2181191976448893,-0.9402346082575548,-0.7221154106126655,25.160232261526204,-4.793545325106787,NaN,NaN,NaN,8683999
838215000,61.9375,63.1875,61.625,62.8125,NaN,NaN,59.03365384615385,70,63.50077915000006,65.57140460000004,66.34999860000003,65.03202999999996,65.45703670078858,64.59758820877825,64.01923000000001,66.17988644217246,61.858573557827555,63.50077915000006,65.57140460000004,66.34999860000003,65.03202999999996,62.541666666666664,2463400,1262930,33.84411812900376,NaN,1.5,2.75,NaN,NaN,1.1113194011644534,1.9505435772370598,NaN,-0.20455070669314124,-0.977803793979092,-0.7732530872859508,24.932314056666126,-2.639856828470374,NaN,NaN,NaN,11147399
838301400,63.4375,63.5625,63.125,63.375,NaN,NaN,58.81009615384615,70.04545454545455,63.52820105000005,65.55249840000005,66.28218620000003,64.88046749999997,65.37538820271844,64.48115123651365,63.87019153846154,65.91778981857544,61.82259325834764,63.52820105000005,65.55249840000005,66.28218620000003,64.88046749999997,63.354166666666664,1989800,1320510,38.98045222074927,NaN,1.5,2.75,NaN,NaN,1.0855108725098497,1.506842053449046,NaN,-0.1423763166878591,-0.9512234831457747,-0.8088471664579155,23.84399699469461,-1.8393030009680542,NaN,NaN,NaN,13137199
838387800,63.5625,63.8125,63.39062,63.71875,NaN,NaN,58.58653846153846,70.0909090909091,63.55640420000005,65.53093590000005,66.22281120000004,64.72265499999996,65.31042199869026,64.40854159494093,63.72716307692308,65.52169433422583,61.932631819620326,63.55640420000005,65.53093590000005,66.22281120000004,64.72265499999996,63.640623333333345,642300,1298100,41.94675946277433,NaN,1.5,2.75,NaN,NaN,1.039224381616289,0.49480009244280104,NaN,-0.0666315846055685,-0.8921366472148762,-0.8255050626093077,24.172747581698538,1.6957605985037407,NaN,NaN,NaN,13779499
838647000,63.625,63.71875,62.9375,63.01562,NaN,NaN,58.36298076923077,70.13636363636364,63.57929480000005,65.50812340000004,66.14656120000004,64.51796749999997,65.2204297634475,64.27588239542274,63.50961461538462,64.85437206283237,62.16485716793687,63.57929480000005,65.50812340000004,66.14656120000004,64.51796749999997,63.22395666666667,1297900,1309955,37.88940848803868,NaN,1.5,2.75,NaN,NaN,1.0207976400722683,0.990797393803604,NaN,-0.053009458066556214,-0.8917668851925029,-0.8387574271259467,17.508147782196584,0.32337512437810695,NaN,NaN,NaN,12481599
838733400,63.4375,63.6875,62.9375,63.625,NaN,NaN,58.13942307692308,70.18181818181819,63.604294800000055,65.48812340000003,66.07531120000003,64.31484249999997,65.15786389037113,64.21389359585866,63.44110538461538,64.65860119885583,62.22360957037493,63.604294800000055,65.48812340000003,66.07531120000003,64.31484249999997,63.416666666666664,1868200,1379800,43.03232971691944,NaN,1.5,2.75,NaN,NaN,1.0014549514956776,1.3539643426583563,NaN,0.004843469665103184,-0.8327030900445678,-0.837546559709671,18.254900216880866,0.09832841691248771,NaN,NaN,NaN,14349799
838819800,63.67187,64.26562,63.51562,64.09375,NaN,NaN,57.91586538461539,70.22727272727273,63.63304480000005,65.49406090000004,66.00437380000002,64.14765499999996,65.11613393388599,64.20245134863403,63.40504769230769,64.51013790857778,62.29995747603761,63.63304480000005,65.49406090000004,66.00437380000002,64.14765499999996,63.95833,767100,1398685,46.68910244504689,NaN,1.5,2.75,NaN,NaN,0.9834938835317006,0.5484437167768297,NaN,0.07840094331238467,-0.7395453805691901,-0.8179463238815747,17.463819001549343,-0.533462657613967,NaN,NaN,NaN,15116899
838906200,64.15625,65.39062,64.0625,65.15625,NaN,NaN,57.69230769230769,70.27272727272727,63.66515420000005,65.50327970000004,65.95656140000003,64.04062399999997,65.11770711294929,64.29328931543078,63.59735538461538,64.95543338877731,62.23927738045346,63.66515420000005,65.50327970000004,65.95656140000003,64.04062399999997,64.86979000000001,1168600,1441700,53.91082480183717,NaN,1.5,2.75,NaN,NaN,1.0081100347080076,0.8105708538530901,NaN,0.19565876405846705,-0.5733728688084909,-0.769031632866958,18.260910527198952,1.8563751831949193,NaN,NaN,NaN,16285499
838992600,66,66.59375,65.75,66.5625,NaN,NaN,57.46875,70.31818181818181,63.70343545000005,65.53156100000004,65.92406140000003,64.08984299999997,65.17436565753951,64.5094046187231,63.88581692307692,65.89261884950045,61.8790149966534,63.70343545000005,65.53156100000004,65.92406140000003,64.08984299999997,66.30208333333333,1098500,1454480,61.369668526383414,NaN,1.5,2.75,NaN,NaN,1.0387807465145786,0.7552527363731368,NaN,0.35565164306313124,-0.32446707903804395,-0.6801187221011752,20.670186341524303,4.822834645669292,NaN,NaN,NaN,17383999
839251800,66.57812,66.59375,65.96875,66.17187,NaN,NaN,57.24519230769231,70.36363636363636,63.738357300000054,65.55156100000004,65.88937380000003,64.13281149999997,65.21348347489091,64.66773465503518,64.0865376923077,66.41933564872907,61.75373973588633,63.738357300000054,65.55156100000004,65.88937380000003,64.13281149999997,66.24479000000001,710200,1442890,58.53578647083639,NaN,1.5,2.75,NaN,NaN,1.0092249789063945,0.49220661311673103,NaN,0.4185596517793482,-0.15691915737698992,-0.5754788091563381,20.391593679711008,5.5583170488534375,NaN,NaN,NaN,16673799
839338200,66.15625,66.51562,65.79687,66.375,NaN,NaN,57.02163461538461,70.4090909090909,63.77609170000005,65.57077980000004,65.85343640000002,64.17265549999998,65.25903314254225,64.83033135455564,64.23557615384615,66.86741953625018,61.603732771442125,63.77609170000005,65.57077980000004,65.85343640000002,64.17265549999998,66.22916333333333,640000,1437930,59.58100397385836,NaN,1.5,2.75,NaN,NaN,0.9884767661273663,0.44508425305821564,NaN,0.4542573968338397,-0.007657063114038465,-0.46191445994787816,17.36288117736923,5.6716417910447765,NaN,NaN,NaN,17313799
839424600,66.625,66.75,66.125,66.54687,NaN,NaN,56.79807692307692,70.45454545454545,63.815310450000055,65.59499850000003,65.83468640000002,64.20781149999996,65.30953654871706,64.99381122555035,64.43389307692308,67.33063113029722,61.537155023548955,63.815310450000055,65.59499850000003,65.83468640000002,64.20781149999996,66.47395666666667,917800,1427205,60.48854640787419,NaN,1.5,2.75,NaN,NaN,0.9625141399754116,0.6430751013344264,NaN,0.4679986563269388,0.12308386046079534,-0.3449147958661435,17.319666075259,5.004923076923075,NaN,NaN,NaN,18231599
839511000,66.5625,66.5625,66.1875,66.4375,NaN,NaN,56.57451923076923,70.5,63.85366985000005,65.60577980000004,65.82281140000003,64.30390549999997,65.35377040955169,65.13130539454555,64.65985461538462,67.68536508933268,61.63434414143656,63.85366985000005,65.60577980000004,65.82281140000003,64.30390549999997,66.39583333333333,925100,1394090,59.57189200090841,NaN,1.5,2.75,NaN,NaN,0.9205488442628822,0.6635869994046295,NaN,0.448242933132745,0.21538887054978773,-0.23285406258295724,17.67476995031383,4.26679744973026,NaN,NaN,NaN,17306499
839597400,66.67187,66.76562,66.0625,66.21875,NaN,NaN,56.35096153846154,70.54545454545455,63.89335735000005,65.61577980000004,65.79968640000003,64.38671799999997,65.38769117780456,65.23487154744598,64.93148923076923,67.83137419648094,62.03160426505752,63.89335735000005,65.61577980000004,65.79968640000003,64.38671799999997,66.34895666666667,648800,1360930,57.68885466017788,NaN,1.5,2.75,NaN,NaN,0.9050182125298191,0.47673282240820614,NaN,0.40052556540596107,0.2678028941744941,-0.13272267123146697,18.246010655606646,5.083073053950753,NaN,NaN,NaN,16657699
839856600,66.25,66.85937,66,66.70312,NaN,NaN,56.12740384615385,70.5909090909091,63.93812295000005,65.63140480000004,65.79624880000003,64.58906149999997,65.43927662181223,65.3747047334035,65.2307676923077,67.99396055570195,62.46757482891345,63.93812295000005,65.63140480000004,65.79624880000003,64.58906149999997,66.52083,764200,1301575,60.65454605769885,NaN,1.5,2.75,NaN,NaN,0.9017576259205462,0.5871348174327258,NaN,0.38174240086060884,0.34445532984429406,-0.03728707101631476,15.600578180224032,4.837909626719054,NaN,NaN,NaN,17421899
839943000,66.57812,66.625,66,66.17187,NaN,NaN,55.90384615384615,70.63636363636364,63.97804480000005,65.64327980000003,65.77843620000003,64.75702999999996,65.46800577389803,65.45062523498412,65.44591153846154,68.02718037122533,62.864642705697754,63.97804480000005,65.64327980000003,65.77843620000003,64.75702999999996,66.26562333333334,805200,1134785,56.016909506066206,NaN,1.5,2.75,NaN,NaN,0.8875692240690786,0.7095617231457941,NaN,0.31639471496726446,0.35820632269276587,0.04181160772550138,17.16762854245389,3.242313018039978,NaN,NaN,NaN,16616699
840029400,66.1875,66.46875,66,66.40625,NaN,NaN,55.68028846153846,70.68181818181819,64.01726355000005,65.65577980000003,65.75593620000004,64.89921749999996,65.50479966511772,65.54163711736658,65.65264230769232,68.0729510989396,63.232333516445046,64.01726355000005,65.65577980000003,65.75593620000004,64.89921749999996,66.29166666666667,533800,1094450,57.558710133724375,NaN,1.5,2.75,NaN,NaN,0.8576535652070015,0.48773356480423957,NaN,0.2734265132673994,0.3835947493097507,0.11016823604235124,17.029283078403765,1.9184652278177459,NaN,NaN,NaN,17150499
840115800,66.23437,66.625,66.20312,66.28125,NaN,NaN,55.45673076923077,70.72727272727273,64.05710730000006,65.66827980000004,65.71906120000003,64.99140499999996,65.5352486978582,65.61207643952214,65.90384461538461,67.7978907348546,64.00979849591462,64.05710730000006,65.66827980000004,65.71906120000003,64.99140499999996,66.36979000000001,632600,1054455,56.42273004683835,NaN,1.5,2.75,NaN,NaN,0.8265268819779301,0.5999307699237995,NaN,0.2231798164770144,0.3891430066386192,0.16596319016160482,15.092524915238215,-0.4225352112676056,NaN,NaN,NaN,16517899
840202200,66.46875,66.875,66.46875,66.84375,NaN,NaN,55.23317307692308,70.77272727272727,64.09741980000005,65.68327980000004,65.70343620000003,65.13515499999997,65.58656247441277,65.72937868337718,66.15144076923077,67.571345859717,64.73153567874455,64.09741980000005,65.68327980000004,65.70343620000003,65.13515499999997,66.72916666666667,475100,1017410,60.22679122277468,NaN,1.5,2.75,NaN,NaN,0.8098999618366494,0.4669700514050383,NaN,0.21437108677449745,0.43392704862972664,0.2195559618552292,9.872918542820484,1.0153559208769551,NaN,NaN,NaN,16992999
840461400,66.85937,66.92187,66.625,66.875,NaN,NaN,55.00961538461539,70.81818181818181,64.13601355000006,65.70452980000003,65.68843620000003,65.30390499999996,65.63708943620051,65.8384854754365,66.36538307692308,67.19684955339198,65.53391660045418,64.13601355000006,65.70452980000003,65.68843620000003,65.30390499999996,66.80729000000001,436400,1013240,60.43343768317978,NaN,1.5,2.75,NaN,NaN,0.7732549645626029,0.43069756424933875,NaN,0.19760491124988472,0.4665621009175851,0.2689571896677004,9.026648002250754,0.7532956685499058,NaN,NaN,NaN,17429399
840547800,66.89062,66.90625,66.67187,66.82812,NaN,NaN,54.78605769230769,70.86363636363636,64.17398230000005,65.72281100000004,65.67687360000004,65.51093599999996,65.68379651713383,65.93273638253778,66.49398846153846,66.9851267963525,66.00285012672443,64.17398230000005,65.72281100000004,65.67687360000004,65.51093599999996,66.80208,645700,971535,59.93039280701281,NaN,1.5,2.75,NaN,NaN,0.7347638956652742,0.6646183616647882,NaN,0.17129361783293162,0.4830742119588649,0.3117805941259333,8.9788190732328,0.4226344529802829,NaN,NaN,NaN,16783699
840634200,66.65625,66.8125,66.375,66.59375,NaN,NaN,54.5625,70.9090909090909,64.21179480000005,65.74187350000004,65.66187360000004,65.69999849999996,65.71948096744231,65.99569006039133,66.49639230769232,66.98915164080574,66.00363297457889,64.21179480000005,65.74187350000004,65.66187360000004,65.69999849999996,66.59375,266400,861685,57.35978373357837,NaN,1.5,2.75,NaN,NaN,0.7146464745463259,0.3091617006214568,NaN,0.1280233243256374,0.47180974953298005,0.34378642520734265,9.18448186192161,0.23518344308560676,NaN,NaN,NaN,16517299
840720600,66.75,67.34375,66.71875,67.21875,NaN,NaN,54.33894230769231,67.34375,64.25382605000006,65.75968600000004,65.66187360000004,65.89218599999995,65.77827583146419,66.11217195940168,66.57692153846155,67.16430679731728,65.98953627960582,64.25382605000006,65.75968600000004,65.66187360000004,65.89218599999995,67.09375,584800,791435,62.036277720595365,NaN,1.5,2.75,NaN,NaN,0.7171717263644455,0.7389109655246483,NaN,0.1309429531009742,0.5074651165835604,0.3765221634825862,10.499907203152793,1.510146295422369,NaN,NaN,NaN,17102099
840807000,67.09375,67.20312,66.64062,66.85937,NaN,NaN,54.11538461538461,67.32233796296296,64.29140415000005,65.77265470000003,65.65468600000004,66.04921699999996,65.82067168121068,66.1833336775539,66.61418076923077,67.20702976016543,66.02133177829612,64.29140415000005,65.77265470000003,65.65468600000004,66.04921699999996,66.90103666666666,757100,797175,58.0910780508772,NaN,1.5,2.75,NaN,NaN,0.7072401744812709,0.9497287295763164,NaN,0.09954120116471254,0.5009486649384769,0.40140746377376435,10.879908467999412,0.23424691378754098,NaN,NaN,NaN,16344999
841066200,66.70312,66.78125,66.42187,66.53125,NaN,NaN,53.89182692307692,67.30092592592592,64.32624790000006,65.78234220000004,65.64656100000003,66.22499849999996,65.8485374976338,66.21646856540592,66.61297923076924,67.20643203868312,66.01952642285536,64.32624790000006,65.78234220000004,65.64656100000003,66.22499849999996,66.57812333333334,784700,771515,54.67242464296404,NaN,1.5,2.75,NaN,NaN,0.68797301916118,1.017089751981491,NaN,0.050041670077860645,0.46395955137109013,0.4139178812932295,10.533741523266213,0.543100867483421,NaN,NaN,NaN,15560299
841152600,66.71875,66.84375,66.5,66.78125,NaN,NaN,53.66826923076923,67.27951388888889,64.36249790000005,65.79499850000003,65.64437360000004,66.38281099999996,65.8851144585109,66.27025727346249,66.63942153846155,67.22986799602083,66.04897508090227,64.36249790000005,65.79499850000003,65.64437360000004,66.38281099999996,66.70833333333333,389400,697575,56.760372139340824,NaN,1.5,2.75,NaN,NaN,0.6633856606496672,0.5582195462853456,NaN,0.028573861563098046,0.449635208247102,0.42106134668400397,9.483229242547608,0.5647058823529412,NaN,NaN,NaN,15949699
841239000,66.9375,67,66.65625,66.67187,NaN,NaN,53.44471153846154,67.25810185185185,64.39851350000005,65.81781100000003,65.65093600000004,66.51171699999995,65.91596761700066,66.3085061045613,66.67427692307693,67.21245976305423,66.13609408309964,64.39851350000005,65.81781100000003,65.65093600000004,66.51171699999995,66.77604000000001,227600,670600,55.554615057122,NaN,1.5,2.75,NaN,NaN,0.6405545420318338,0.33939755442886965,NaN,0.002801254054857427,0.42456291425257575,0.4217616601977183,9.42522846390713,0.589337105139083,NaN,NaN,NaN,15722099
841325400,66.59375,66.59375,65.625,66.01562,NaN,NaN,53.22115384615385,67.23668981481481,64.43320100000005,65.83656100000003,65.63843600000004,66.55468549999995,65.91987555358887,66.28061218984118,66.62139230769232,67.26301797047125,65.97976664491338,64.43320100000005,65.83656100000003,65.63843600000004,66.55468549999995,66.07812333333334,680200,646180,48.84970965529491,NaN,1.5,2.75,NaN,NaN,0.6695770747438455,1.0526478690148255,NaN,-0.05922482582849503,0.3477306279120995,0.40695545374059455,11.101634173656345,-1.2389041608228168,NaN,NaN,NaN,15041899
841411800,66,66.01562,65.125,65.32812,NaN,NaN,52.99759615384615,67.21527777777777,64.46148225000006,65.85984220000005,65.61312340000003,66.49296649999994,65.89666945344813,66.18989864795154,66.55648846153846,67.47697189350968,65.63600502956724,64.46148225000006,65.85984220000005,65.61312340000003,66.49296649999994,65.48958,1500900,666300,42.99531830923743,NaN,1.5,2.75,NaN,NaN,0.6853658551192849,2.2525889239081494,NaN,-0.14258168688564948,0.22872834513353268,0.37131003201918217,10.889027265191709,-2.313091588785049,NaN,NaN,NaN,13540999
841757400,64.46875,65.84375,64.375,65.75,NaN,NaN,64.375,67.19386574074075,64.49023225000005,65.88812350000003,65.59187340000004,66.47187299999995,65.89091771017566,66.14800353862282,66.50600769230769,67.52103565269402,65.49097973192136,64.49023225000005,65.88812350000003,65.59187340000004,66.47187299999995,65.32291666666667,1782000,719890,47.17872031343384,NaN,1.5,2.75,NaN,NaN,0.7413218654679075,2.4753781827779244,NaN,-0.16381555154758937,0.16654059258469545,0.3303561441322848,11.929356606978219,-1.6132729755079125,NaN,NaN,NaN,15322999
841843800,65.75,66.75,65.48437,65.8125,NaN,NaN,64.49264705882354,67.17245370370371,64.51835725000005,65.90906100000004,65.56937340000005,66.44374799999994,65.88784250585505,66.11605082065874,66.46995000000001,67.54583254677229,65.39406745322773,64.51835725000005,65.90906100000004,65.56937340000005,66.44374799999994,66.01562333333334,930200,734400,47.79001191990478,NaN,1.5,2.75,NaN,NaN,0.7787724465059142,1.2666122004357299,NaN,-0.16756023456289593,0.1209058509286649,0.28846608549156083,12.016872116426434,-1.1731581417175034,NaN,NaN,NaN,16253199
841930200,65.5,65.76562,65.01562,65.01562,NaN,NaN,64.61029411764706,67.15104166666667,64.54406035000005,65.91671720000004,65.53249840000004,66.36718549999995,65.85363770170387,66.0112478853579,66.32932461538462,67.62787035836534,65.0307788724039,64.54406035000005,65.91671720000004,65.53249840000004,66.36718549999995,65.26562,616600,719340,41.237218574266876,NaN,1.5,2.75,NaN,NaN,0.7800658431840632,0.8571746323018322,NaN,-0.21460845513550791,0.020205516572175952,0.23481397170768387,13.477174880659067,-3.277552766155279,NaN,NaN,NaN,15636599
842016600,65.25,66.17187,65.14062,65.9375,NaN,NaN,64.7279411764706,67.12962962962963,64.57195100000006,65.93171720000004,65.52312340000005,66.34218549999994,65.85692641928412,66.00422427722857,66.25720923076923,67.53040933375188,64.98400912778659,64.57195100000006,65.93171720000004,65.52312340000005,66.34218549999994,65.74999666666666,804900,713330,49.810858657859406,NaN,1.5,2.75,NaN,NaN,0.8069361400994872,1.1283697587371904,NaN,-0.1761557647108502,0.014619265819121097,0.1907750305299713,15.153113085331862,-1.3788194534288887,NaN,NaN,NaN,16441499
842275800,66.1875,66.73437,66.07812,66.71875,NaN,NaN,64.84558823529412,67.1082175925926,64.60468540000005,65.95609220000004,65.51999840000003,66.36718549999995,65.89072342244945,66.07227434606395,66.24879615384616,67.50816544278777,64.98942686490454,64.60468540000005,65.95609220000004,65.51999840000003,66.36718549999995,66.51041333333333,719200,716850,55.708562979551665,NaN,1.5,2.75,NaN,NaN,0.8062171300923808,1.003278231150171,NaN,-0.09470169671538531,0.07239790963573967,0.16709960635112497,16.82627043202922,0.28182245185533117,NaN,NaN,NaN,17160699
842362200,66.625,66.90625,66.375,66.6875,NaN,NaN,64.96323529411765,67.08680555555556,64.63648230000005,65.97921720000004,65.51156100000004,66.36640449999996,65.92196956274556,66.13086726548643,66.25600769230769,67.52423814894328,64.9877772356721,64.63648230000005,65.97921720000004,65.51156100000004,66.36640449999996,66.65625,669900,712135,55.427989234790076,NaN,1.5,2.75,NaN,NaN,0.7865766208000678,0.9406924248913479,NaN,-0.042201162703300626,0.11434815297199918,0.1565493156752998,16.56291634858068,-0.14038371548900327,NaN,NaN,NaN,16490799
842448600,66.5625,67.125,66.40625,67.0625,NaN,NaN,65.08088235294117,67.06539351851852,64.67007605000005,66.00452970000003,65.49906100000004,66.41093599999996,65.96669624655947,66.21959419258296,66.24398846153846,67.47799465560428,65.00998226747265,64.67007605000005,66.00452970000003,65.49906100000004,66.41093599999996,66.86458333333333,713500,707550,58.15174613702067,NaN,1.5,2.75,NaN,NaN,0.7817318621714915,1.0084092996961345,NaN,0.015421803297379744,0.1758265697970245,0.16040476649964475,16.74004126599872,0.585899270561935,NaN,NaN,NaN,17204299
842535000,67.25,67.73437,67.15625,67.53125,NaN,NaN,65.19852941176471,67.04398148148148,64.70281045000006,66.02952970000004,65.50093600000004,66.46718599999996,66.028051295714,66.34451379328935,66.29567153846155,67.67604269117444,64.91530038574865,64.70281045000006,66.02952970000004,65.50093600000004,66.46718599999996,67.47395666666667,713300,716525,61.33261399233616,NaN,1.5,2.75,NaN,NaN,0.7738845863020991,0.9954991102892432,NaN,0.07918247590900557,0.2593828613859017,0.18020038547689615,17.07672891753408,2.2958657360182357,NaN,NaN,NaN,17917599
842621400,68.3125,68.625,68.125,68.5625,NaN,NaN,65.31617647058823,67.02256944444444,64.74038860000005,66.06281100000004,65.52624860000003,66.58124849999996,66.1274414409801,66.55575057488085,66.45192153846155,68.28816024739041,64.61568282953269,64.74038860000005,66.06281100000004,65.52624860000003,66.58124849999996,68.4375,2008800,785335,67.23336735014276,NaN,1.5,2.75,NaN,NaN,0.7967321158519491,2.55788930838432,NaN,0.17916466731727332,0.4041562196234878,0.22499155230621448,17.129479677107362,4.950976700385686,NaN,NaN,NaN,19926399
842880600,68.65625,69.15625,68.5625,68.8125,NaN,NaN,65.43382352941177,67.0011574074074,64.77991985000006,66.10093600000003,65.59093620000003,66.67968599999996,66.23273785505931,66.77067909155886,66.60817153846155,68.83422368814004,64.38211938878305,64.77991985000006,66.10093600000003,65.59093620000003,66.67968599999996,68.84375,1220200,822590,68.48878582730279,NaN,1.5,2.75,NaN,NaN,0.7822333932910956,1.4833635225324888,NaN,0.24634267091784617,0.5329198909535222,0.28657722003567604,14.560204306230087,4.657794676806084,NaN,NaN,NaN,21146599
842967000,68.875,68.98437,68.23437,68.65625,NaN,NaN,65.55147058823529,66.97974537037037,64.81827925000005,66.13452980000004,65.65781120000003,66.76874849999996,66.32777754701777,66.95025727331516,66.76081615384615,69.24104037021638,64.28059193747592,64.81827925000005,66.13452980000004,65.65781120000003,66.76874849999996,68.62499666666666,604700,831005,66.7669840035883,NaN,1.5,2.75,NaN,NaN,0.7799310080560174,0.72767311869363,NaN,0.2629506724652104,0.6152655606171891,0.35231488815197864,15.13383922734325,4.320987654320987,NaN,NaN,NaN,20541899
843053400,68.5625,68.75,68.21875,68.48437,NaN,NaN,65.66911764705883,66.95833333333333,64.85202925000004,66.16499850000004,65.71593620000003,66.85156099999996,66.4123498000759,67.09636324728514,66.95072,69.54887970160998,64.35256029839003,64.85202925000004,66.16499850000004,65.71593620000003,66.85156099999996,68.48437333333334,225500,809995,64.83603783841247,NaN,1.5,2.75,NaN,NaN,0.762168078909159,0.27839678022703845,NaN,0.24539496968736907,0.65905860026119,0.41366363057382094,15.539473853248236,5.335256358395106,NaN,NaN,NaN,20316399
843139800,68.375,68.79687,68.28125,68.75,NaN,NaN,65.78676470588235,66.93692129629629,64.88507615000005,66.19812350000004,65.77406120000003,66.95937349999996,66.50402235693566,67.25385246182941,67.21394153846154,69.79450648581202,64.63337659111106,64.88507615000005,66.19812350000004,65.77406120000003,66.95937349999996,68.60937333333334,410000,817175,66.45086552935123,NaN,1.5,2.75,NaN,NaN,0.744557501844219,0.5017285159237618,NaN,0.23470797917109493,0.7070486045376896,0.47234062536659466,11.693307715521259,4.265402843601896,NaN,NaN,NaN,20726399
843226200,68.59375,68.78125,68.375,68.64062,NaN,NaN,65.90441176470588,66.91550925925925,64.91687300000005,66.23062350000004,65.85656120000003,67.03046699999996,66.58781049980094,67.3859255607028,67.43629692307692,69.97172690554868,64.90086694060517,64.91687300000005,66.23062350000004,65.85656120000003,67.03046699999996,68.59895666666667,948400,835355,65.12463456488379,NaN,1.5,2.75,NaN,NaN,0.7203926802839177,1.1353256998521586,NaN,0.2044191850642536,0.7278646066969117,0.5234454216326581,10.964991388237411,2.880554566744728,NaN,NaN,NaN,19777999
843485400,68.46875,68.75,68.15625,68.625,NaN,NaN,66.0220588235294,66.89409722222223,64.95023240000005,66.26156100000004,65.93781120000003,67.11874849999995,66.66770028412247,67.50393265015968,67.65264307692308,70.07434888939784,65.23093726444833,64.95023240000005,66.26156100000004,65.93781120000003,67.11874849999995,68.51041666666667,466800,820840,64.92535596889088,NaN,1.5,2.75,NaN,NaN,0.7113467745493521,0.5686857365625457,NaN,0.16894978034085872,0.7346326470587314,0.5656828667178727,9.97811544616369,2.9053420805998127,NaN,NaN,NaN,19311199
843571800,68.5625,69.25,68.3125,68.60937,NaN,NaN,66.13970588235294,66.87268518518519,64.98249800000005,66.30359220000004,66.05687360000003,67.22265449999995,66.74384419454904,67.60921239776353,67.92908538461539,69.8528727581935,66.00529801103728,64.98249800000005,66.30359220000004,66.05687360000003,67.22265449999995,68.72395666666667,1269800,845095,64.71197159201736,NaN,1.5,2.75,NaN,NaN,0.7275005763672555,1.5025529674178644,NaN,0.13170692515306448,0.7303165231592033,0.5986095980061388,9.95009992890919,2.3066095060577796,NaN,NaN,NaN,18041399
843658200,68.9375,68.9375,68.5,68.65625,NaN,NaN,66.25735294117646,66.85127314814815,65.01366990000005,66.34702970000004,66.17374860000004,67.31640449999995,66.81884050064515,67.70893026464319,68.13822,69.70929355152312,66.56714644847689,65.01366990000005,66.34702970000004,66.17374860000004,67.31640449999995,68.69791666666667,1353300,893290,65.08265470838585,NaN,1.5,2.75,NaN,NaN,0.7067862494838801,1.514961546642188,NaN,0.098993893022711,0.7223519642845275,0.6233580712618165,9.850183632516686,1.6658954187875983,NaN,NaN,NaN,19394699
843744600,68.75,69.1875,68.39062,68.625,NaN,NaN,66.375,66.82986111111111,65.04562305000005,66.39077970000004,66.27499860000003,67.41406099999996,66.88967028493357,67.79617500134384,68.28485461538462,69.63955262781798,66.93015660295126,65.04562305000005,66.39077970000004,66.27499860000003,67.41406099999996,68.73437333333334,773200,920570,64.59554689854019,NaN,1.5,2.75,NaN,NaN,0.7132215173778889,0.8399144008603365,NaN,0.06562323624683797,0.705387116570364,0.639763880323526,9.49243310352609,0.09115770282588878,NaN,NaN,NaN,18621499
843831000,68.71875,68.71875,68.375,68.6875,NaN,NaN,66.49264705882354,66.80844907407408,65.07593555000005,66.43781100000004,66.35999860000004,67.54765499999996,66.96017341101461,67.88106309645396,68.43870076923078,69.44136046633784,67.43604107212371,65.07593555000005,66.43781100000004,66.35999860000004,67.54765499999996,68.59375,407600,906940,65.15722469034806,NaN,1.5,2.75,NaN,NaN,0.6868306947080397,0.4494233356120581,NaN,0.03942307540733225,0.6890427245826913,0.6496196491753591,3.984377974565407,-0.18165304268846502,NaN,NaN,NaN,19029099
844090200,68.78125,69.0625,68.57812,68.625,NaN,NaN,66.61029411764706,66.78703703703704,65.10820120000005,66.47624850000004,66.45312360000004,67.71249899999997,67.02546072822972,67.95191423012501,68.55889307692308,69.17165213034768,67.94613402349849,65.10820120000005,66.47624850000004,66.45312360000004,67.71249899999997,68.75520666666667,578200,860805,64.06271555719619,NaN,1.5,2.75,NaN,NaN,0.6723699308003227,0.6716968419096079,NaN,0.011023637089537242,0.6633991955372807,0.6523755584477434,3.345424806407941,-0.04551661356395084,NaN,NaN,NaN,18450899
844176600,68.70312,69.04687,68.4375,69,NaN,NaN,66.7279411764706,66.765625,65.14413870000004,66.51890480000003,66.56312360000004,67.87499899999997,67.10289364084817,68.05173192249406,68.67187384615384,68.91548381581994,68.42826387648775,65.14413870000004,66.51890480000003,66.56312360000004,67.87499899999997,68.82812333333334,561400,799775,67.58144883024126,NaN,1.5,2.75,NaN,NaN,0.6678699357431567,0.7019474227126379,NaN,0.010629582561342166,0.6656625366494211,0.6550329540880789,4.416652494963883,0.7529163223666971,NaN,NaN,NaN,19012299
844263000,69.25,69.59375,69.15625,69.46875,NaN,NaN,66.84558823529412,66.74421296296296,65.18835745000005,66.55984230000004,66.69874860000003,68.05781149999997,67.19567232159922,68.18668602511367,68.74158538461539,69.22284871918227,68.26032205004852,65.18835745000005,66.55984230000004,66.69874860000003,68.05781149999997,69.40625,609000,783715,71.35679975479594,NaN,1.5,2.75,NaN,NaN,0.6625756546186455,0.7770681944329252,NaN,0.03376809604164288,0.6972430741401325,0.6634749780984897,5.236533008660114,1.0454545454545454,NaN,NaN,NaN,19621299
844349400,69.5,69.53125,69.20312,69.40625,NaN,NaN,66.96323529411765,66.72280092592592,65.22906060000005,66.59031110000004,66.83062360000004,68.27734299999997,67.28236164232082,68.30283497510284,68.78725846153847,69.38530105578671,68.18921586729023,65.22906060000005,66.59031110000004,66.83062360000004,68.27734299999997,69.38020666666667,342200,769995,70.1831992018433,NaN,1.5,2.75,NaN,NaN,0.6386866792887425,0.4444184702498068,NaN,0.03646330991224611,0.7090541154887973,0.6725908055765512,5.136820557393159,1.1154182465135098,NaN,NaN,NaN,19279099
844435800,69.6875,70.34375,69.5,70.34375,NaN,NaN,67.08088235294117,66.70138888888889,65.27742000000005,66.62609240000003,66.96999860000004,68.49765549999998,67.40241608772,68.49720783461686,68.91706615384615,69.93215702227171,67.90197528542059,65.27742000000005,66.62609240000003,66.96999860000004,68.49765549999998,70.0625,754100,767455,76.44209304633074,NaN,1.5,2.75,NaN,NaN,0.6600304879109752,0.9825983282407438,NaN,0.08993832863391993,0.785013716368951,0.6950753877350311,8.516791993176447,2.504553734061931,NaN,NaN,NaN,20033199
844695000,70.3125,70.625,70.25,70.42187,NaN,NaN,67.19852941176471,66.67997685185185,65.32460750000004,66.66343610000004,67.10406100000004,68.68281149999997,67.52082604506431,68.68050899322478,69.06610461538462,70.32336383422155,67.80884539654768,65.32460750000004,66.66343610000004,67.10406100000004,68.68281149999997,70.43229000000001,235100,743250,76.87764921495864,NaN,1.5,2.75,NaN,NaN,0.6396711673459056,0.31631348805919945,NaN,0.1173892848480248,0.8418119937950621,0.7244227089470373,8.396911894573282,2.6417674437179643,NaN,NaN,NaN,20268299
844781400,70.45312,70.6875,70.01562,70.14062,NaN,NaN,67.31617647058823,66.65856481481481,65.36929500000005,66.69656110000004,67.24656100000004,68.85546749999996,67.62356306290492,68.81956718434623,69.17307538461539,70.53668856106353,67.80946220816725,65.36929500000005,66.69656110000004,67.24656100000004,68.85546749999996,70.28124666666668,386200,729065,71.73536850759291,NaN,1.5,2.75,NaN,NaN,0.6419717982497696,0.5297195723289418,NaN,0.10388813059523261,0.854282872191078,0.7503947415958454,9.106888548013156,2.1620318616294925,NaN,NaN,NaN,19882099
844867800,70.25,70.375,69.51562,69.59375,NaN,NaN,67.43382352941177,66.63715277777777,65.40976375000005,66.72062360000004,67.36593600000003,68.98202999999997,67.70082529573217,68.89329888107515,69.24639307692308,70.58995436201005,67.90283179183612,65.40976375000005,66.72062360000004,67.36593600000003,68.98202999999997,69.82812333333334,528800,719830,62.922133033099335,NaN,1.5,2.75,NaN,NaN,0.6575009555176433,0.7346178958920856,NaN,0.048238709764253485,0.8106931288011623,0.7624544190369088,10.779470407724128,1.4116575591985427,NaN,NaN,NaN,19353299
844954200,69.59375,69.85937,69.375,69.45312,NaN,NaN,67.55147058823529,66.61574074074075,65.44968560000005,66.73874860000004,67.47312340000003,69.07812349999996,67.76954273511522,68.94661517811562,69.31009461538461,70.60750198972102,68.01268724104821,65.44968560000005,66.73874860000004,67.47312340000003,69.07812349999996,69.56249666666668,1562200,762275,60.851736292624636,NaN,1.5,2.75,NaN,NaN,0.6451344586949544,2.0493916237578302,NaN,-0.005095851442009303,0.7560846047343972,0.7611804561764065,10.912241649856,1.114642402183801,NaN,NaN,NaN,17791099
845040600,69.71875,70.3125,69.71875,70.3125,NaN,NaN,67.66911764705883,66.59432870370371,65.49421685000004,66.76640490000004,67.57624840000004,69.16562349999995,67.86926654942442,69.07669944686651,69.44110461538462,70.77253399950156,68.10967523126767,65.49421685000004,66.76640490000004,67.57624840000004,69.16562349999995,70.11458333333333,331300,678400,67.82004681555138,NaN,1.5,2.75,NaN,NaN,0.660437711645315,0.4883549528301887,NaN,0.00964629881836876,0.7732383296993675,0.7635920308809987,12.620210943852472,2.459016393442623,NaN,NaN,NaN,18122399
845299800,70.3125,70.6875,70.29687,70.40625,NaN,NaN,67.78676470588235,66.57291666666667,65.53882625000004,66.78859240000003,67.65312340000004,69.24531099999996,67.96875609650581,69.2033233090697,69.57572,70.91635367209668,68.23508632790333,65.53882625000004,66.78859240000003,67.65312340000004,69.24531099999996,70.46354000000001,201600,627470,68.47919492261556,NaN,1.5,2.75,NaN,NaN,0.6411657322420783,0.3212902608889668,NaN,0.01740210126909114,0.7853446574673626,0.7679425561982715,12.47411120029654,2.0380434782608696,NaN,NaN,NaN,18323999
845386200,71.125,71.125,69.95312,70.3125,NaN,NaN,67.90441176470588,66.55150462962963,65.57968565000004,66.81265490000004,67.73593600000004,69.32812349999996,68.06066762213304,69.3089591843964,69.7055276923077,70.97785401210947,68.43320137250592,65.57968565000004,66.81265490000004,67.73593600000004,69.32812349999996,70.46354000000001,776900,636080,67.00122689236815,NaN,1.5,2.75,NaN,NaN,0.6790738942247871,1.221387246887184,NaN,0.008366949405768542,0.7784012429554821,0.7700342935497135,12.50677872195401,1.214574898785425,NaN,NaN,NaN,17547099
845472600,70.5,70.65625,69.9375,70.65625,NaN,NaN,68.0220588235294,66.5300925925926,65.62140440000005,66.83749870000003,67.82156100000003,69.43671749999996,68.16245516636312,69.43727259540627,69.85697,71.07611053445844,68.63782946554157,65.62140440000005,66.83749870000003,67.82156100000003,69.43671749999996,70.41666666666667,590100,654310,69.5926651419867,NaN,1.5,2.75,NaN,NaN,0.6819079017801595,0.9018660879399673,NaN,0.01718234821387321,0.7915122288170551,0.7743298806031819,12.281826375190825,1.8009905447996397,NaN,NaN,NaN,18137199
845559000,70.875,71.03125,70.54687,70.84375,NaN,NaN,68.13970588235294,66.50868055555556,65.66702940000005,66.87109250000003,67.90749860000004,69.54140499999997,68.26760398336849,69.5712228244152,70.02764307692308,71.12418177623734,68.93110437760883,65.66702940000005,66.87109250000003,67.90749860000004,69.54140499999997,70.80729000000001,792500,673435,70.93351112097568,NaN,1.5,2.75,NaN,NaN,0.6677987659387197,1.1768025124919257,NaN,0.026713336569191393,0.8077215513146712,0.7810082147454798,12.17613388712831,0.7107952021323856,NaN,NaN,NaN,18929699
845645400,70.875,71.3125,70.71875,71.21875,NaN,NaN,68.25735294117646,66.48726851851852,65.71515440000005,66.91296750000004,68.00312360000004,69.67031149999997,68.38333519970698,69.72813017447089,70.19831615384615,71.2926083601156,69.1040239475767,65.71515440000005,66.91296750000004,68.00312360000004,69.67031149999997,71.08333333333333,695800,660805,73.45468659350897,NaN,1.5,2.75,NaN,NaN,0.6625095683716682,1.0529581343966827,NaN,0.04809813929885265,0.8411308888690456,0.793032749570193,10.123551369664977,1.1315802889074114,NaN,NaN,NaN,19625499
845904600,71.28125,71.625,70.9375,71.125,NaN,NaN,68.375,66.46585648148148,65.76163880000004,66.95046750000003,68.10124860000003,69.79531149999997,68.49085146638514,69.86116539594985,70.32572,71.43612653871602,69.21531346128398,65.76163880000004,66.95046750000003,68.10124860000003,69.79531149999997,71.22916666666667,879200,681425,71.77847281775394,NaN,1.5,2.75,NaN,NaN,0.6642945992022634,1.290237370216825,NaN,0.0457675012327583,0.8502421261111408,0.8044746248783825,10.229628009526616,1.4034378367342655,NaN,NaN,NaN,18746299
845991000,71.0625,71.07812,70.59375,70.625,NaN,NaN,68.49264705882354,66.44444444444444,65.81093570000004,66.98796750000002,68.17968620000003,69.89609299999998,68.57454356574259,69.93391154871654,70.41947,71.40195418878929,69.43698581121072,65.81093570000004,66.98796750000002,68.17968620000003,69.89609299999998,70.76562333333334,848900,660380,63.46085052217456,NaN,1.5,2.75,NaN,NaN,0.6547914135449588,1.285472000969139,NaN,0.0026644208999060393,0.8078051510032651,0.8051407301033591,10.901360521788483,1.481814099685676,NaN,NaN,NaN,17897399
846077400,70.46875,70.89062,70.1875,70.85937,NaN,NaN,68.61029411764706,66.4230324074074,65.86538880000005,67.02593620000003,68.27343620000003,70.00624899999997,68.66414460238013,70.02205044883877,70.45913307692308,71.46747852365802,69.45078763018815,65.86538880000005,67.02593620000003,68.27343620000003,70.00624899999997,70.64583,735900,629510,65.48010540265838,NaN,1.5,2.75,NaN,NaN,0.6582434554346045,1.1690044637892965,NaN,-0.016874796633190803,0.7840472343118705,0.8009220309450613,9.505617217799347,2.024747052400238,NaN,NaN,NaN,18633299
846163800,70.85937,70.98437,70.21875,70.25,NaN,NaN,68.7279411764706,66.40162037037037,65.91499820000004,67.05312370000003,68.35031120000004,70.08749899999997,68.72633501012993,70.04375992990174,70.44591230769231,71.4603538150036,69.43147080038102,65.91499820000004,67.05312370000003,68.35031120000004,70.08749899999997,70.48437333333334,379300,609815,56.70560447121901,NaN,1.5,2.75,NaN,NaN,0.665913208617847,0.6219919155809549,NaN,-0.0744274179957427,0.7078877584503829,0.7823151764461256,11.099366087364503,-0.08888888888888889,NaN,NaN,NaN,18253999
846250200,70.23437,70.5625,70.125,70.3125,NaN,NaN,68.84558823529412,66.38020833333333,65.96538885000004,67.07499870000004,68.43093620000003,70.16874899999996,68.78853755875228,70.06935422229205,70.45913384615385,71.46172595446872,69.45654173783898,65.96538885000004,67.07499870000004,68.43093620000003,70.16874899999996,70.33333333333333,568300,617850,57.33706672829077,NaN,1.5,2.75,NaN,NaN,0.649597979430858,0.9198025410698389,NaN,-0.10974229199366037,0.6451373114540502,0.7548796034477105,8.546095086277687,-0.13315579227696406,NaN,NaN,NaN,18822299
846513000,70.375,70.73437,69.8125,69.84375,NaN,NaN,68.96323529411765,66.35879629629629,66.01406075000004,67.09718620000004,68.49093620000004,70.22968649999997,68.82991843880122,70.04786810588328,70.47836461538462,71.42166013568342,69.53506909508582,66.01406075000004,67.09718620000004,68.49093620000004,70.22968649999997,70.13020666666667,975400,637710,51.29436295852555,NaN,1.5,2.75,NaN,NaN,0.6690459809000823,1.5295353687412774,NaN,-0.16292072173123862,0.5512287012836623,0.7141494230149009,9.293557871194874,-0.6666666666666666,NaN,NaN,NaN,17846899
846599400,70.0625,70.57812,69.70312,70.40625,NaN,NaN,69.08088235294117,66.33738425925925,66.06187325000005,67.12499870000003,68.56156120000003,70.29999899999997,68.8917353627698,70.08199971484677,70.5516823076923,71.29092591900323,69.81243869638138,66.06187325000005,67.12499870000003,68.56156120000003,70.29999899999997,70.22916333333333,815900,650435,57.13268497379978,NaN,1.5,2.75,NaN,NaN,0.6837569822643621,1.25439129198152,NaN,-0.15832468587956228,0.516243565665448,0.6745682515450103,10.558942332306556,-0.35382574082264484,NaN,NaN,NaN,18662799
846685800,70.625,70.625,70.09375,70.17187,NaN,NaN,69.19852941176471,66.31597222222223,66.10945135000004,67.15265490000003,68.62843620000004,70.33515499999996,68.94193672109255,70.09055878962327,70.54086461538462,71.2976984149423,69.78403081582694,66.10945135000004,67.15265490000003,68.62843620000004,70.33515499999996,70.29687333333334,495400,644755,54.21644944722161,NaN,1.5,2.75,NaN,NaN,0.6728636263883363,0.7683538708501679,NaN,-0.16825183202597516,0.4642534615125413,0.6325052935385165,10.25698726411451,-0.9483970004411139,NaN,NaN,NaN,18167399
846772200,70.26562,70.875,70.1875,70.84375,NaN,NaN,69.31617647058823,66.29456018518519,66.15937325000004,67.18765490000004,68.71343620000003,70.40702999999996,69.01651763399087,70.16229128584963,70.57451846153846,71.34323096243247,69.80580596064445,66.15937325000004,67.18765490000004,68.71343620000003,70.40702999999996,70.63541666666667,726300,663960,60.4488198410146,NaN,1.5,2.75,NaN,NaN,0.6750255102177409,1.0938911982649557,NaN,-0.1285425539127475,0.4718271011475821,0.6003696550603296,11.726624664366621,-0.5265467310223783,NaN,NaN,NaN,18893699
846858600,70.98437,71.15625,70.26562,70.59375,NaN,NaN,69.43382352941177,66.27314814814815,66.20601390000004,67.22140490000004,68.78093620000003,70.41952999999997,69.07836988363829,70.2033825919592,70.59615307692307,71.3498348903523,69.84247126349385,66.20601390000004,67.22140490000004,68.78093620000003,70.41952999999997,70.67187333333334,821300,667320,57.32203249459719,NaN,1.5,2.75,NaN,NaN,0.6904258309164738,1.2307438710064138,NaN,-0.11834300610444992,0.4524408974297671,0.570783903534217,11.360725408217814,-0.7469244288224957,NaN,NaN,NaN,18072399
847117800,70.6875,71.0625,70.53125,71.0625,NaN,NaN,69.55147058823529,66.25173611111111,66.25492015000005,67.25984240000004,68.86499880000002,70.45156149999997,69.15617890780933,70.28520329748689,70.62740307692307,71.42108784221855,69.83371831162759,66.25492015000005,67.25984240000004,68.86499880000002,70.45156149999997,70.88541666666667,1608400,735985,61.3580707649056,NaN,1.5,2.75,NaN,NaN,0.6790561287081542,2.185370625760036,NaN,-0.08103558918469123,0.469489417053353,0.5505250062380442,12.133732100785835,0.6194690265486725,NaN,NaN,NaN,19680799
847204200,71.29687,71.79687,71.28125,71.46875,NaN,NaN,69.66911764705883,66.23032407407408,66.30515455000004,67.30515490000003,68.96374880000003,70.51796799999997,69.24686797024819,70.39792203105957,70.67548000000001,71.58327546553946,69.76768453446056,66.30515455000004,67.30515490000003,68.96374880000003,70.51796799999997,71.51562333333334,764000,754875,64.49216809257639,NaN,1.5,2.75,NaN,NaN,0.6830071195147145,1.0120880940553072,NaN,-0.032497109004109626,0.5099036199829072,0.5424007289870169,11.653455563532,0.8599850661951999,NaN,NaN,NaN,20444799
847290600,71.59375,72.875,71.53125,72.84375,NaN,NaN,69.78676470588235,66.20891203703704,66.35976395000004,67.36468620000004,69.08499880000004,70.68046799999998,69.38792216749336,70.63085802810151,70.80048000000001,72.25559601161417,69.34536398838584,66.35976395000004,67.36468620000004,69.08499880000004,70.68046799999998,72.41666666666667,1665000,811685,72.59414558210632,NaN,1.5,2.75,NaN,NaN,0.7346673252636634,2.0512883692565467,NaN,0.0824337460176724,0.6454429115091074,0.563009165491435,15.545103218632521,3.692170818505338,NaN,NaN,NaN,22109799
847377000,72.625,73.29687,72.53125,73.01562,NaN,NaN,69.90441176470588,66.1875,66.41632645000004,67.43140490000003,69.21187380000003,70.85859299999997,69.53018482759165,70.85797821590137,70.94591230769231,72.81945303075659,69.07237158462803,66.41632645000004,67.43140490000003,69.21187380000003,70.85859299999997,72.94791333333335,1446300,805890,73.41082899724609,NaN,1.5,2.75,NaN,NaN,0.736878230601973,1.7946618024792464,NaN,0.15598436097065038,0.757989616704748,0.6020052557340976,13.77944151877875,3.8444373333333313,NaN,NaN,NaN,23556099
847463400,73.03125,73.4375,72.75,73.42187,NaN,NaN,70.0220588235294,66.16608796296296,66.47226395000004,67.49921740000003,69.35999880000003,71.01406149999997,69.68279993239199,71.10215838581553,71.16105615384616,73.43692661447494,68.88518569321738,66.47226395000004,67.49921740000003,69.35999880000003,71.01406149999997,73.20312333333334,1355700,857110,75.28556073453557,NaN,1.5,2.75,NaN,NaN,0.7333512141304036,1.5817106322409025,NaN,0.21434506247904994,0.8699365838329101,0.6555915213538601,13.67097706091376,5.12303534675615,NaN,NaN,NaN,24911799
847722600,73.25,73.51562,73.21875,73.34375,NaN,NaN,70.13970588235294,66.14467592592592,66.52656085000004,67.56671740000003,69.52031140000003,71.16093649999996,69.82636660170995,71.31564330145214,71.35216230769231,73.8960547360665,68.80826987931812,66.52656085000004,67.56671740000003,69.52031140000003,71.16093649999996,73.35937333333334,655900,879825,74.20212237982275,NaN,1.5,2.75,NaN,NaN,0.7021739845496604,0.7454891597760919,NaN,0.22872575853004573,0.9414987195164173,0.7127729609863716,12.331127024237695,4.172214824678207,NaN,NaN,NaN,24255899
847809000,73.54687,73.59375,73.01562,73.125,NaN,NaN,70.25735294117646,66.12326388888889,66.57710775000004,67.62984240000003,69.66781140000003,71.30156149999996,69.9557247741919,71.48796298702813,71.57331615384615,74.19420194986523,68.95243035782707,66.57710775000004,67.62984240000003,69.66781140000003,71.30156149999996,73.24479000000001,719900,876975,71.11588282792889,NaN,1.5,2.75,NaN,NaN,0.6933136999389705,0.8208899911628039,NaN,0.20529078901183695,0.9693864472511677,0.7640956582393308,12.911187165262499,4.2084242588946275,NaN,NaN,NaN,23535999
847895400,73.20312,73.5625,73.01562,73.45312,NaN,NaN,70.375,66.10185185185185,66.62601400000004,67.69499860000003,69.82062380000004,71.44140499999996,70.09287752814517,71.67512079778736,71.81490230769231,74.50446403784616,69.12534057753845,66.62601400000004,67.69499860000003,69.82062380000004,71.44140499999996,73.34374666666668,481900,871565,72.93433283795241,NaN,1.5,2.75,NaN,NaN,0.6828541499433298,0.5529134373225175,NaN,0.1938142593303922,1.006363482402321,0.8125492230719289,12.088156671208083,3.6832748125275674,NaN,NaN,NaN,24017899
847981800,73.1875,73.9375,73.15625,73.9375,NaN,NaN,70.49264705882354,66.08043981481481,66.67617025000004,67.76577990000004,69.99906140000003,71.59609249999997,70.24364703684536,71.89058548371237,72.12980615384616,74.78081492550497,69.47879738218735,66.67617025000004,67.76577990000004,69.99906140000003,71.59609249999997,73.67708333333333,558800,859880,75.39680825272949,NaN,1.5,2.75,NaN,NaN,0.6898824249473777,0.6498581197376379,NaN,0.19996507296164956,1.062505564273991,0.8625404913123413,11.759749502486368,4.7366091190792385,NaN,NaN,NaN,24576699
848068200,74.125,74.5,73.71875,74.03125,NaN,NaN,70.61029411764706,66.05902777777777,66.72812340000004,67.84202990000003,70.16093640000003,71.73671749999997,70.39218048638084,72.09445829478739,72.40865230769231,75.03833669799722,69.77896791738739,66.72812340000004,67.84202990000003,70.16093640000003,71.73671749999997,74.08333333333333,2250900,937635,75.85469246003281,NaN,1.5,2.75,NaN,NaN,0.6964086803082793,2.4006143115391385,NaN,0.1914570732014822,1.101861832814194,0.9104047596127118,10.88531636980107,4.177660510114336,NaN,NaN,NaN,26827599
848327400,74.17187,74.25,73.73437,74.04687,NaN,NaN,70.7279411764706,66.03761574074075,66.77757650000004,67.91374860000003,70.30749880000003,71.88281099999996,70.53550164377766,72.2804022667124,72.70672923076924,75.12461413064834,70.28884433089014,66.77757650000004,67.91374860000003,70.30749880000003,71.88281099999996,74.01041333333335,1518200,969585,75.9350531315244,NaN,1.5,2.75,NaN,NaN,0.6834959174291165,1.565824553803947,NaN,0.16878477313053275,1.1213857260258777,0.952600952895345,11.102218113202001,3.6073388718845627,NaN,NaN,NaN,28345799
848413800,74.14062,74.59375,74.03125,74.57812,NaN,NaN,70.84558823529412,66.01620370370371,66.82663900000004,67.98843610000003,70.46531120000003,72.08046699999996,70.69403569696286,72.4992325270255,72.99398846153846,75.344682209069,70.64329471400792,66.82663900000004,67.98843610000003,70.46531120000003,72.08046699999996,74.40104000000001,1029300,978605,78.54988107217328,NaN,1.5,2.75,NaN,NaN,0.6748533518984654,1.0518033322944396,NaN,0.17094469082149444,1.166281816422213,0.9953371256007186,11.208299627763578,2.380945516945515,NaN,NaN,NaN,29375099
848500200,74.5625,75.01562,74.3125,74.70312,NaN,NaN,70.96323529411765,65.99479166666667,66.87445150000003,68.05859230000004,70.61812360000003,72.27265449999996,70.85125468923883,72.70912657207069,73.31009384615385,75.37218505631715,71.24800263599055,66.87445150000003,68.05859230000004,70.61812360000003,72.27265449999996,74.67708,730000,978310,79.12464284754485,NaN,1.5,2.75,NaN,NaN,0.6768723981914321,0.7461847471660312,NaN,0.16224019161628123,1.1981373651210703,1.035897173504789,6.091810019064537,2.3111493129826193,NaN,NaN,NaN,30105099
848586600,74.79687,74.84375,74.375,74.59375,NaN,NaN,71.08088235294117,65.97337962962963,66.91820150000004,68.13015480000004,70.75937360000003,72.48984199999995,70.99801921122946,72.88861451758777,73.58172846153846,75.28751957556986,71.87593734750706,66.91820150000004,68.13015480000004,70.75937360000003,72.48984199999995,74.60416666666667,653000,991995,77.17608282891709,NaN,1.5,2.75,NaN,NaN,0.6620065126063298,0.6582694469226156,NaN,0.13185566652767067,1.2007167566643773,1.0688610901367066,6.508870258763526,1.5960911919023604,NaN,NaN,NaN,29452099
848673000,74.70312,75.25,74.70312,75.17187,NaN,NaN,71.19852941176471,65.9519675925926,66.96492025000003,68.20890480000004,70.89156100000004,72.73281049999994,71.16169963431851,73.10606742067465,73.86658384615384,75.27705231899768,72.45611537331001,66.96492025000003,68.20890480000004,70.89156100000004,72.73281049999994,75.04166333333335,965100,1011835,79.98229653400789,NaN,1.5,2.75,NaN,NaN,0.6615953331344491,0.9538116392494824,NaN,0.13304880820276166,1.2351721003901588,1.1021232921873971,7.022942919425244,2.4925368555602874,NaN,NaN,NaN,30417199
848932200,75.25,76.15625,75.07812,76.125,NaN,NaN,71.31617647058823,65.93055555555556,67.01390465000004,68.31437360000004,71.03781100000003,73.04687299999995,71.35633886434523,73.39358480918183,74.11898769230768,75.84584999529265,72.39212538932271,67.01390465000004,68.31437360000004,71.03781100000003,73.04687299999995,75.78645666666667,2058800,1066005,83.56912141608717,NaN,1.5,2.75,NaN,NaN,0.6913478093391314,1.931323023813209,NaN,0.17760069014747404,1.3241241548717397,1.1465234647242657,8.748781549714499,4.102564102564102,NaN,NaN,NaN,32475999
849018600,76.28125,76.6875,75.46875,75.875,NaN,NaN,71.43382352941177,76.6875,67.06234215000003,68.41999860000004,71.18218600000004,73.32031049999995,71.5335412618219,73.62991006545023,74.33894,76.17271754917728,72.50516245082271,67.06234215000003,68.41999860000004,71.18218600000004,73.32031049999995,76.01041666666667,2861800,1168300,79.54314493959389,NaN,1.5,2.75,NaN,NaN,0.7290193943863363,2.449542069673885,NaN,0.16980777345802567,1.358783181546798,1.1889754080887722,8.834742936970331,3.2971778462235526,NaN,NaN,NaN,29614199
849105000,76.0625,76.1875,75.64062,75.73437,NaN,NaN,71.55147058823529,76.82695895522389,67.11296715000005,68.52156110000004,71.32718600000004,73.59843549999995,71.69827964371123,73.83033482112164,74.5168246153846,76.40799882543836,72.62565040533086,67.11296715000005,68.52156110000004,71.32718600000004,73.59843549999995,75.85416333333335,872000,1187130,77.28756777840732,NaN,1.5,2.75,NaN,NaN,0.7160094376444553,0.7345446581250579,NaN,0.13620738026945145,1.3592346334255865,1.223027253156135,9.359176125973757,2.430255283178358,NaN,NaN,NaN,28742199
849277800,76,76.21875,75.85937,76.01562,NaN,NaN,71.66911764705883,76.96641791044776,67.16702965000005,68.62327980000003,71.47249840000003,73.85702899999994,71.86758710866373,74.03845721911006,74.72235307692307,76.63947374425844,72.8052324095877,67.16702965000005,68.62327980000003,71.47249840000003,73.85702899999994,76.03124666666668,1073400,1204485,78.59485876269159,NaN,1.5,2.75,NaN,NaN,0.6994644778127086,0.8911692549097747,NaN,0.11480570075793617,1.3665343791035554,1.2517286783456192,9.107136205634186,2.6804491346559707,NaN,NaN,NaN,29815599
849537000,75.92187,76.125,75.39062,76.04687,NaN,NaN,71.78676470588235,77.10587686567165,67.22257650000005,68.73859230000004,71.62062340000004,74.12968499999994,72.0314805553828,74.22973462681387,74.9471123076923,76.74377449897814,73.15045011640645,67.22257650000005,68.73859230000004,71.62062340000004,74.12968499999994,75.85416333333335,1350600,1230950,78.74127458742663,NaN,1.5,2.75,NaN,NaN,0.7019584436832295,1.0972013485519314,NaN,0.08595576868618382,1.3591733892033488,1.273217620517165,9.171757579534423,2.7009919527996256,NaN,NaN,NaN,31166199
849623400,76.0625,76.57812,74.75,74.75,NaN,NaN,71.90441176470588,77.24533582089552,67.27484215000004,68.84046730000004,71.74312340000004,74.31405999999994,72.13808916105407,74.27928370997445,75.0468723076923,76.63223296491536,73.46151165046923,67.27484215000004,68.84046730000004,71.74312340000004,74.31405999999994,75.35937333333334,1777800,1239420,60.305611862382484,NaN,1.5,2.75,NaN,NaN,0.782398554848713,1.434380597376192,NaN,-0.031003648935671535,1.2344630593475756,1.2654667082832471,14.668767404598878,0.23046974099105957,NaN,NaN,NaN,29388399
849709800,74.875,75.0625,74.09375,74.95312,NaN,NaN,72.0220588235294,77.3847947761194,67.32413900000005,68.96343600000004,71.86999840000004,74.48827849999994,72.24848252728724,74.34345859473879,75.1249969230769,76.57860622409467,73.67138762205914,67.32413900000005,68.96343600000004,71.86999840000004,74.48827849999994,74.70312333333334,2365100,1319475,61.813626834159834,NaN,1.5,2.75,NaN,NaN,0.7957093723595193,1.79245533261335,NaN,-0.10126065806073692,1.138890885707326,1.240151543768063,14.196779436549047,0.3346580437336486,NaN,NaN,NaN,31753499
849796200,74.84375,75.14062,74.53125,74.75,NaN,NaN,72.13970588235294,77.52425373134328,67.36726400000003,69.08281100000004,71.99187340000005,74.58359099999993,72.34658125170735,74.38217682381129,75.18028538461537,76.51292726955924,73.8476434996715,67.36726400000003,69.08281100000004,71.99187340000005,74.58359099999993,74.80729000000001,1697700,1321110,59.38404785057994,NaN,1.5,2.75,NaN,NaN,0.7823994171909822,1.2850557485750618,NaN,-0.16425700803011867,1.0348302837304146,1.1990872917605333,14.286935968395367,0.20946795140343527,NaN,NaN,NaN,30055799
849882600,73.25,74.75,72.65625,74.3125,NaN,NaN,72.25735294117646,77.66371268656717,67.40913900000004,69.19031100000004,72.10562340000004,74.64843499999994,72.42367610458157,74.37554093582926,75.20071846153846,76.4698526522168,73.93158427086011,67.40913900000004,69.19031100000004,72.10562340000004,74.64843499999994,73.90625,3401800,1418885,54.422309938017435,NaN,1.5,2.75,NaN,NaN,0.8760673159630549,2.3975163596767883,NaN,-0.23398335383964097,0.906608099460982,1.140591453300623,14.676630012938594,-1.1432068937489495,NaN,NaN,NaN,26653999
850141800,74.6875,75.42187,74.57812,75.40625,NaN,NaN,72.375,77.80317164179104,67.46117025000004,69.29999850000004,72.23999840000005,74.74765399999994,72.54063978675485,74.47370370384553,75.26442076923077,76.48433763364216,74.04450390481938,67.46117025000004,69.29999850000004,72.23999840000005,74.74765399999994,75.13541333333333,1864600,1444330,62.792246466624,NaN,1.5,2.75,NaN,NaN,0.8927317933942651,1.2909792083526619,NaN,-0.20601866728125673,0.8830681191990521,1.0890867864803089,16.48440646333629,-0.9441707717569786,NaN,NaN,NaN,28518599
850228200,75.5625,75.67187,74.96875,75.04687,NaN,NaN,72.49264705882354,77.94263059701493,67.51242025000005,69.41077970000003,72.36843580000004,74.83280999999994,72.63892332452917,74.52829097014596,75.29086307692307,76.4753553079759,74.10637084587025,67.51242025000005,69.41077970000003,72.36843580000004,74.83280999999994,75.22916333333335,1331600,1478115,58.96087471058619,NaN,1.5,2.75,NaN,NaN,0.8791880938661032,0.9008771306698058,NaN,-0.21055489291065932,0.8258931703419847,1.036448063252644,14.66456324852602,-1.0914398682042854,NaN,NaN,NaN,27186999
850314600,73.625,74.625,73.3125,74.35937,NaN,NaN,72.61029411764706,78.08208955223881,67.56171710000004,69.51937340000003,72.47562320000004,74.89452849999994,72.70639182160646,74.5122032587035,75.27283384615384,76.5053806799476,74.04028701236008,67.56171710000004,69.51937340000003,72.47562320000004,74.89452849999994,74.09895666666667,1847900,1534515,52.37685433697332,NaN,1.5,2.75,NaN,NaN,0.9402725157328099,1.2042241359647836,NaN,-0.25568421886883497,0.7168427896666003,0.9725270085354353,15.316022459765877,-1.8155561338927095,NaN,NaN,NaN,25339099
850401000,74.78125,74.875,72.9375,73.125,NaN,NaN,72.7279411764706,78.22154850746269,67.60796710000004,69.62374840000004,72.54874820000005,74.87812249999993,72.72280782860228,74.3800886626365,75.1153823076923,76.79951839928653,73.43124621609807,67.60796710000004,69.62374840000004,72.54874820000005,74.87812249999993,73.64583333333333,2540200,1637430,43.07605085402812,NaN,1.5,2.75,NaN,NaN,1.0115030503233233,1.5513334921187472,NaN,-0.3582079696122139,0.5247670465201679,0.8829750161323818,17.481127100315174,-3.8026658205247794,NaN,NaN,NaN,22798899
850487400,73.0625,73.57812,72.40625,73.3125,NaN,NaN,72.84558823529412,78.36100746268657,67.65007650000004,69.72874840000004,72.62687320000005,74.84687249999993,72.74593301179435,74.27841355190921,74.89903615384614,76.72539064735466,73.07268166033762,67.65007650000004,69.72874840000004,72.62687320000005,74.84687249999993,73.09895666666667,1678300,1693405,44.68292139852567,NaN,1.5,2.75,NaN,NaN,1.0229578324430857,0.9910801019248201,NaN,-0.39977411939654894,0.38325736688669565,0.7830314862832446,17.320141718337666,-3.595637795480601,NaN,NaN,NaN,24477199
850746600,73.5,73.6875,72.0625,72.375,NaN,NaN,72.96323529411765,78.50046641791045,67.68562340000004,69.81874840000005,72.66749820000004,74.76405999999994,72.73138661917497,74.097136070775,74.62980538461537,76.80070029235637,72.45891047687437,67.68562340000004,69.81874840000005,72.66749820000004,74.76405999999994,72.70833333333333,1831100,1672415,38.78729389298305,NaN,1.5,2.75,NaN,NaN,1.0659608444114368,1.0948837459601832,NaN,-0.4718379652990127,0.19323402965947878,0.6650719949584915,17.856154628397373,-3.177257525083612,NaN,NaN,NaN,22646099
850833000,72.15625,73.28125,71.875,72.95312,NaN,NaN,71.875,78.63992537313433,67.72101400000004,69.91109210000005,72.71812320000005,74.70937249999994,72.74008204587399,73.98818215927261,74.41586307692306,76.65624313552244,72.17548301832367,67.72101400000004,69.91109210000005,72.71812320000005,74.70937249999994,72.70312333333334,2023200,1697665,43.71883811696906,NaN,1.5,2.75,NaN,NaN,1.0902672126677628,1.19175455699446,NaN,-0.4614407286064389,0.08827108420044283,0.5497118128068817,17.370693905394283,-2.668334553651669,NaN,NaN,NaN,24669299
850919400,73.375,73.76562,73.26562,73.53125,NaN,NaN,71.97635135135135,78.7793843283582,67.76218590000003,70.01624840000004,72.78593580000005,74.65702899999994,72.77110824015344,73.94466481077046,74.22475769230768,76.3047928784899,72.14472250612545,67.76218590000003,70.01624840000004,72.78593580000005,74.65702899999994,73.52083,1666800,1729540,48.21210111772406,NaN,1.5,2.75,NaN,NaN,1.0704266974772083,0.9637244585265446,NaN,-0.3988511682709871,0.0511478524681479,0.449999020739135,18.16635258082149,-1.6304347826086956,NaN,NaN,NaN,26336099
851005800,74.1875,75.125,73.89062,75.04687,NaN,NaN,72.07770270270271,78.91884328358209,67.80929525000005,70.13046710000005,72.89499820000005,74.67421649999994,72.86035379936311,74.04963673355422,74.1478346153846,76.01579343793287,72.27987579283632,67.80929525000005,70.13046710000005,72.89499820000005,74.67421649999994,74.68749666666668,2269300,1806505,57.73786339736106,NaN,1.5,2.75,NaN,NaN,1.1078069333716933,1.2561825181773645,NaN,-0.24609203464244167,0.1423839774360829,0.38847601207852456,22.182818702299677,0.9882186711522266,NaN,NaN,NaN,28605399
851092200,75.125,75.71875,74.75,74.84375,NaN,NaN,72.17905405405405,79.05830223880596,67.86601400000004,70.23796710000005,73.00281080000005,74.68671649999995,72.93813404252535,74.12526656845382,74.15504615384613,76.03294571856313,72.27714658912913,67.86601400000004,70.23796710000005,73.00281080000005,74.68671649999995,75.10416666666667,1543200,1851015,56.24472424501733,NaN,1.5,2.75,NaN,NaN,1.0978742952737153,0.8337047511770569,NaN,-0.15394932353973223,0.19603935765385927,0.3499886811935915,21.929498314109562,-0.7459593866556155,NaN,NaN,NaN,27062199
851351400,75.09375,75.20312,74.32812,74.65625,NaN,NaN,72.2804054054054,79.19776119402985,67.91812340000004,70.33296710000005,73.08968580000004,74.66093549999995,73.0055111388969,74.17583641907727,74.13220999999997,75.97767438448165,72.2867456155183,67.91812340000004,70.33296710000005,73.08968580000004,74.66093549999995,74.72916333333333,1263700,1865945,54.83501100920874,NaN,1.5,2.75,NaN,NaN,1.0819547027541643,0.6772439702134844,NaN,-0.10328237135765728,0.22088571699651993,0.3241680883541772,20.08691077430465,-0.5205013879992576,NaN,NaN,NaN,25798499
851437800,74.84375,75.20312,74.79687,75.20312,NaN,NaN,72.38175675675676,79.33722014925374,67.97546715000004,70.41937330000005,73.18562320000005,74.61484149999994,73.091691878548,74.27367295059372,74.16706538461537,76.07397921461565,72.26015155461509,67.97546715000004,70.41937330000005,73.18562320000005,74.61484149999994,75.06770333333333,633000,1794655,58.13116415750981,NaN,1.5,2.75,NaN,NaN,1.0437343668431525,0.35271403138764834,NaN,-0.034166487510645716,0.28145997896587005,0.31562646647651577,20.44714037472106,1.1346922385168137,NaN,NaN,NaN,26431499
851610600,75.4375,75.82812,75.375,75.78125,NaN,NaN,72.48310810810811,79.47667910447761,68.03351405000004,70.51546710000004,73.29499820000005,74.61015399999994,73.19716474605593,74.41725171720384,74.28004615384613,76.37300441314497,72.18708789454729,68.03351405000004,70.51546710000004,73.29499820000005,74.61015399999994,75.66145666666667,1384300,1720780,61.34304349692741,NaN,1.5,2.75,NaN,NaN,1.0138247692114988,0.8044607677913505,NaN,0.044962472956058486,0.3718295576715889,0.3268670847155304,19.89070006066046,3.6324786324786325,NaN,NaN,NaN,27815799
851697000,75.78125,76.03125,75.5,75.875,NaN,NaN,72.58445945945945,79.6161380597015,68.09062345000004,70.61046710000004,73.39937320000004,74.61718549999995,73.30217789326943,74.55608488699394,74.31610384615382,76.4996212639055,72.13258642840215,68.09062345000004,70.61046710000004,73.39937320000004,74.61718549999995,75.80208333333333,410400,1697700,61.85407414880736,NaN,1.5,2.75,NaN,NaN,0.9793551428392488,0.24173882311362432,NaN,0.0952048864295536,0.4458731927524724,0.3506683063229188,16.039731350877403,3.495311167945439,NaN,NaN,NaN,28226199
851956200,76.125,76.125,75.15625,75.21875,NaN,NaN,72.6858108108108,79.75559701492537,68.14609220000004,70.69718590000004,73.48687320000005,74.57734199999996,73.37733758372946,74.61919585013737,74.32932538461536,76.53237644437418,72.12627432485654,68.14609220000004,70.69718590000004,73.48687320000005,74.57734199999996,75.5,694100,1678735,56.24858382158541,NaN,1.5,2.75,NaN,NaN,0.9785976326364454,0.41346609202762796,NaN,0.07662774247978421,0.446452984422649,0.3698252419428648,17.553227953403443,3.929188255613126,NaN,NaN,NaN,27532099
852042600,75.28125,75.375,73.84375,73.84375,NaN,NaN,72.78716216216216,79.89505597014926,68.18851410000003,70.77124840000005,73.53937320000004,74.46718599999996,73.39562826672046,74.54534386441,74.28966230769228,76.50763713644808,72.07168747893648,68.18851410000003,70.77124840000005,73.53937320000004,74.46718599999996,74.35416666666667,1378100,1680110,46.69924649029207,NaN,1.5,2.75,NaN,NaN,1.0180728017338423,0.8202439126009606,NaN,-0.03015391821764013,0.3321328441708147,0.3622867623884548,19.524608784668604,1.2208250997352843,NaN,NaN,NaN,26153999
852215400,74.375,74.375,72.75,74.03125,NaN,NaN,72.88851351351352,80.03451492537313,68.23257660000004,70.84937340000005,73.59749820000005,74.43124849999995,73.42055460920201,74.49638254399,74.3593738461538,76.48143762075583,72.23731007155178,68.23257660000004,70.84937340000005,73.59749820000005,74.43124849999995,73.71875,2031900,1692815,47.99577924489965,NaN,1.5,2.75,NaN,NaN,1.0614247444671394,1.2003083621069048,NaN,-0.08683896351072146,0.253738058000053,0.34057702151077446,19.16586038218401,0.6799830004249894,NaN,NaN,NaN,28185899
852301800,74.375,75.125,74.07812,75.09375,NaN,NaN,72.98986486486487,80.17397388059702,68.28234225000004,70.93327970000004,73.68687320000005,74.43827999999996,73.4861701147235,74.55327468265762,74.49639307692304,76.55959079197638,72.4331953618697,68.28234225000004,70.93327970000004,73.68687320000005,74.43827999999996,74.76562333333334,2123200,1680720,54.71766743471032,NaN,1.5,2.75,NaN,NaN,1.0637336912909152,1.2632681231853016,NaN,-0.0531145176551997,0.27418387444177483,0.32729839209697453,20.258929222105174,0.06246762856332528,NaN,NaN,NaN,30309099
852561000,75.09375,75.4375,74.3125,74.4375,NaN,NaN,73.09121621621621,80.31343283582089,68.32960790000004,71.01593600000004,73.75843580000004,74.42265499999996,73.52347716904808,74.5422485224045,74.65504692307688,76.32011674254912,72.98997710360464,68.32960790000004,71.01593600000004,73.75843580000004,74.42265499999996,74.72916666666667,1374100,1664540,50.38570123567814,NaN,1.5,2.75,NaN,NaN,1.068109856198707,0.8255133550410324,NaN,-0.07405659640631673,0.23472764658907863,0.30878424299539536,17.329835774025437,-0.5427974947807933,NaN,NaN,NaN,28934999
852647400,74.4375,75.46875,74.125,75.34375,NaN,NaN,73.19256756756756,80.45289179104478,68.38054540000003,71.10531100000004,73.86031080000004,74.47421749999997,73.5948604173207,74.61858199646122,74.8389415384615,76.21439889784902,73.46348417907397,68.38054540000003,71.10531100000004,73.86031080000004,74.47421749999997,74.97916666666667,939000,1541400,55.61191618336394,NaN,1.5,2.75,NaN,NaN,1.0877984378987995,0.6091864538731023,NaN,-0.02828088566260034,0.2734331359171449,0.30171402157974525,18.758991626408886,0.9208874005860193,NaN,NaN,NaN,29873999
852733800,75.75,75.78125,74.6875,74.6875,NaN,NaN,73.29391891891892,80.59235074626865,68.42882665000003,71.18937350000004,73.94781080000004,74.43827999999996,73.63770902840616,74.62514561584587,74.92788384615379,76.08595351536204,73.76981417694554,68.42882665000003,71.18937350000004,73.94781080000004,74.43827999999996,75.05208333333333,1802200,1538280,51.39040062896186,NaN,1.5,2.75,NaN,NaN,1.0882235494774568,1.1715682450529163,NaN,-0.04273803725589331,0.24829147500987858,0.2910295122657719,19.471750097837702,-0.6856364469984735,NaN,NaN,NaN,28071799
852820200,75.0625,75.875,74.9375,75.3125,NaN,NaN,73.39527027027027,80.73180970149254,68.47867040000004,71.27406100000003,74.05718580000004,74.45156149999997,73.70338710572356,74.69060793814626,74.94831692307687,76.12331304858968,73.77332079756407,68.47867040000004,71.27406100000003,74.05718580000004,74.45156149999997,75.375,1415700,1542485,54.90161172219009,NaN,1.5,2.75,NaN,NaN,1.0953147245147814,0.9178047112289585,NaN,-0.012326321883431635,0.2756216099114823,0.28794793179491396,19.62098708838928,-0.6185567010309279,NaN,NaN,NaN,29487499
852906600,74.25,76.25,74.25,76.125,NaN,NaN,73.49662162162163,80.87126865671642,68.53554540000003,71.36656100000003,74.17156080000004,74.53984299999998,73.79835231726382,74.82721670594185,75.04687461538455,76.37519031436557,73.71855891640354,68.53554540000003,71.36656100000003,74.17156080000004,74.53984299999998,75.54166666666667,2369500,1568565,59.043390783820506,NaN,1.5,2.75,NaN,NaN,1.1599351013351542,1.5106163914150832,NaN,0.056608003822705755,0.35870793657329614,0.3020999327505904,20.122982028048643,0.32948929159802304,NaN,NaN,NaN,31856999
853165800,76.5,76.5,75.64062,76.01562,NaN,NaN,73.59797297297297,81.0107276119403,68.59062350000004,71.45843600000003,74.28843580000004,74.68437399999996,73.8853039910966,74.94039797204263,75.15144153846147,76.55233228030089,73.75055079662205,68.59062350000004,71.45843600000003,74.28843580000004,74.68437399999996,76.05208,1364600,1509785,58.267586507335466,NaN,1.5,2.75,NaN,NaN,1.1384668798112147,0.9038373013376076,NaN,0.08711265510535449,0.4109907516322835,0.323878096526929,20.143326827351288,1.0594034067303677,NaN,NaN,NaN,30492399
853252200,76.6875,77.39062,76.5,76.96875,NaN,NaN,73.69932432432432,81.15018656716418,68.65202975000004,71.56218600000004,74.41093580000005,74.86718649999997,74.00622344242615,75.13357435565761,75.28725923076917,76.99139392373739,73.58312453780094,68.65202975000004,71.56218600000004,74.41093580000005,74.86718649999997,76.95312333333334,2111200,1531430,62.848537983624624,NaN,1.5,2.75,NaN,NaN,1.1553621026818424,1.3785808035626832,NaN,0.1595395853599344,0.523302578226847,0.3637629928669126,20.38877645921021,4.231908590774439,NaN,NaN,NaN,32603599
853338600,76.71875,77.20312,76.375,76.78125,NaN,NaN,73.80067567567568,81.28964552238806,68.70874850000004,71.65781100000004,74.53468580000005,75.08749899999997,74.1150480133114,75.29049584559499,75.36418230769225,77.23289658225264,73.49546803313186,68.70874850000004,71.65781100000004,74.53468580000005,75.08749899999997,76.78645666666667,1583900,1519070,61.420212063599585,NaN,1.5,2.75,NaN,NaN,1.1319876667759963,1.0426774276366462,NaN,0.18128988367392151,0.5903753474593145,0.409085463785393,16.043761529363394,3.71464753060363,NaN,NaN,NaN,31019699
853425000,77.03125,77.29687,76.5,77.09375,NaN,NaN,73.90202702702703,81.42910447761194,68.76640475000004,71.76015480000004,74.65531080000004,75.29453049999998,74.23185985592663,75.46223433649071,75.45793230769225,77.53087256471139,73.3849920506731,68.76640475000004,71.76015480000004,74.65531080000004,75.29453049999998,76.96354000000001,1308400,1483330,62.93224701893506,NaN,1.5,2.75,NaN,NaN,1.1080506905777108,0.8820693979087594,NaN,0.2016324998715464,0.661126088624826,0.4594935887532796,16.02019630622235,2.663337494798169,NaN,NaN,NaN,32328099
853511400,77.20312,77.75,77.10937,77.5625,NaN,NaN,74.00337837837837,81.56856343283582,68.82640475000004,71.87046730000003,74.77718580000004,75.49609299999997,74.3624731949099,75.66225963777731,75.63822076923071,77.98604858157007,73.29039295689135,68.82640475000004,71.87046730000003,74.77718580000004,75.49609299999997,77.47395666666667,1604000,1480190,65.13930612922866,NaN,1.5,2.75,NaN,NaN,1.0757792126793029,1.0836446672386653,NaN,0.22953836335254574,0.7464165429439618,0.516878179591416,14.755435712709374,4.198152812762385,NaN,NaN,NaN,33932099
853770600,77.75,78.09375,77.46875,77.65625,NaN,NaN,74.10472972972973,81.7080223880597,68.88710790000003,71.97921730000003,74.87343580000004,75.62656199999998,74.49164091275657,75.85216348179851,75.93148999999994,78.26183747231318,73.6011425276867,68.88710790000003,71.97921730000003,74.87343580000004,75.62656199999998,77.73958333333333,1889900,1461220,65.58070814730745,NaN,1.5,2.75,NaN,NaN,1.043580697487924,1.293371292481625,NaN,0.23626706393785046,0.8122120095137291,0.5759449455758786,12.763861793399126,3.0692658647863955,NaN,NaN,NaN,35821999
853857000,77.375,78.54687,77.10937,78.28125,NaN,NaN,74.20608108108108,81.84748134328358,68.95656105000003,72.09531110000003,74.97874840000004,75.79843699999998,74.64025303382493,76.08350505496055,76.25841307692302,78.62290845542886,73.89391769841718,68.95656105000003,72.09531110000003,74.97874840000004,75.79843699999998,77.97916333333333,2785800,1523350,68.44888800674931,NaN,1.5,2.75,NaN,NaN,1.071717790524501,1.8287327272130502,NaN,0.2627342329591259,0.904362736774786,0.6416285038156601,12.038906056607424,4.811715481171548,NaN,NaN,NaN,38607799
853943400,78.3125,78.84375,77.875,78.84375,NaN,NaN,74.30743243243244,81.98694029850746,69.03007670000004,72.22359240000003,75.08718600000003,76.00781199999997,74.80509605210631,76.34638552591669,76.54687461538455,79.17313378224883,73.92061544852028,69.03007670000004,72.22359240000003,75.08718600000003,76.00781199999997,78.52083333333333,1201600,1520245,70.80672844033775,NaN,1.5,2.75,NaN,NaN,1.0643629483441794,0.7903989159642031,NaN,0.2955982104121688,1.0111262668308711,0.7155280564187023,9.058671562405538,4.6887966804979255,NaN,NaN,NaN,39809399
854029800,79.0625,79.6875,76.90625,77.75,NaN,NaN,74.40878378378379,79.6875,69.10382670000004,72.34781120000004,75.17531100000004,76.13515599999998,74.92058248143547,76.480063094877,76.80168230769225,79.19204886341336,74.41131575197113,69.10382670000004,72.34781120000004,75.17531100000004,76.13515599999998,78.11458333333333,2601100,1618650,61.225669608075336,NaN,1.5,2.75,NaN,NaN,1.1869977377481666,1.6069564142958639,NaN,0.22437706564734528,0.9959993884778839,0.7716223228305387,14.06966998814138,2.134646962233169,NaN,NaN,NaN,37208299
854116200,77.875,77.90625,76.75,76.75,NaN,NaN,74.51013513513513,79.76442307692308,69.17296735000004,72.45781120000004,75.24781100000004,76.18359349999999,74.9923243449086,76.50577137155538,76.90985538461533,79.1490177237001,74.67069304553056,69.17296735000004,72.45781120000004,75.24781100000004,76.18359349999999,77.13541666666667,2176000,1658235,54.027523517426005,NaN,1.5,2.75,NaN,NaN,1.184801470766155,1.3122386151540644,NaN,0.0971224180996837,0.8930253454551433,0.7959029273554596,15.864578555705975,0.9660909165774108,NaN,NaN,NaN,35032299
854375400,76.875,77.23437,76.375,76.53125,NaN,NaN,74.61148648648648,79.84134615384616,69.23702985000004,72.56499870000003,75.30937360000003,76.21640599999998,75.05267437059845,76.50819790759773,77.05168230769225,78.91121005003963,75.19215456534486,69.23702985000004,72.56499870000003,75.30937360000003,76.21640599999998,76.71354000000001,2108500,1743140,52.571494006519515,NaN,1.5,2.75,NaN,NaN,1.1615563657114296,1.2095987700356827,NaN,-0.008945856319283352,0.7847206069563555,0.7936664632756388,15.95856928254543,-0.5684125050751117,NaN,NaN,NaN,32923799
854461800,77.625,77.84375,76,76.75,NaN,NaN,74.71283783783784,79.91826923076923,69.29952985000004,72.68234250000003,75.36562360000003,76.29296849999999,75.11923615998676,76.53122667830272,77.16225923076917,78.74537144490313,75.5791470166352,69.29952985000004,72.68234250000003,75.36562360000003,76.29296849999999,76.86458333333333,4376000,1927235,53.90918016367416,NaN,1.5,2.75,NaN,NaN,1.2102844824463277,2.2706104860071554,NaN,-0.06823403095854463,0.7083739245774581,0.7766079555360027,14.224948697792565,-0.0407000407000407,NaN,NaN,NaN,37299799
854548200,76.875,77.5,76.59375,77.5,NaN,NaN,74.8141891891892,79.9951923076923,69.36484235000003,72.79796750000003,75.43499860000003,76.47578099999998,75.21259944783041,76.62349080417864,77.2680284615384,78.73960776401897,75.79644915905784,69.36484235000003,72.79796750000003,75.43499860000003,76.47578099999998,77.19791666666667,1122700,1914465,58.25631814521954,NaN,1.5,2.75,NaN,NaN,1.1885677337001614,0.5864301515044673,NaN,-0.06103470819135315,0.7003145702968112,0.7613492784881644,15.225690542436189,0.526955816781516,NaN,NaN,NaN,38422499
854634600,77.875,78.53125,77.40625,78.5,NaN,NaN,74.91554054054055,80.07211538461539,69.43593610000003,72.91578000000003,75.52406120000003,76.69921849999999,75.34151711654295,76.80220596568545,77.45913461538456,78.87470407969064,76.04356515107847,69.43593610000003,72.91578000000003,75.52406120000003,76.69921849999999,78.14583333333333,2126300,1919185,63.23532923111115,NaN,1.5,2.75,NaN,NaN,1.1840271812930072,1.1079182048630016,NaN,0.003553815877993416,0.7657915483356561,0.7622377324576627,16.6444337359884,1.20870265914585,NaN,NaN,NaN,40548799
854721000,78.9375,79.40625,78.375,78.40625,NaN,NaN,75.01689189189189,80.14903846153847,69.50609235000003,73.03296750000003,75.60062380000004,76.86484349999998,75.46170271981578,76.9549720641916,77.56971153846146,79.0383651453959,76.10105793152702,69.50609235000003,73.03296750000003,75.60062380000004,76.86484349999998,78.72916666666667,3208100,1973430,62.48289346012667,NaN,1.5,2.75,NaN,NaN,1.173114525486364,1.6256467166304354,NaN,0.03091827268493763,0.8008855733138347,0.7699673006288971,16.48635487735244,0.96579476861167,NaN,NaN,NaN,37340699
854980200,78.71875,78.89062,78.35937,78.64062,NaN,NaN,75.11824324324324,80.22596153846153,69.57663920000003,73.14874870000003,75.67937380000004,77.07499949999998,75.5863661425681,77.11550996284001,77.71273999999993,79.20830231880021,76.21717768119964,69.57663920000003,73.14874870000003,75.67937380000004,77.07499949999998,78.63020333333333,755000,1942475,63.647448385528506,NaN,1.5,2.75,NaN,NaN,1.1272670593801952,0.38867939098315296,NaN,0.05438629809267048,0.8379501732447352,0.7835638751520647,16.5227224035465,0.4590754491017944,NaN,NaN,NaN,38095699
855066600,78.75,79.20312,78.4375,79.125,NaN,NaN,75.2195945945946,80.30288461538461,69.64710795000003,73.26468620000003,75.76999880000002,77.26406199999998,75.7251360977615,77.30688996637906,77.86898999999993,79.49221030218074,76.24576969781911,69.64710795000003,73.26468620000003,75.76999880000002,77.26406199999998,78.92187333333334,654100,1928230,65.99665466126952,NaN,1.5,2.75,NaN,NaN,1.101435126567324,0.3392230180009646,NaN,0.09001297987132717,0.8960800999912237,0.8060671201198966,16.27591184681264,0.356718192627824,NaN,NaN,NaN,38749799
855153000,79.23437,79.46875,77.125,77.64062,NaN,NaN,75.32094594594595,80.3798076923077,69.70913920000004,73.35546740000004,75.81937380000004,77.41171799999998,75.80025311353556,77.33867377910487,77.87499923076915,79.49420993889598,76.25578852264232,69.70913920000004,73.35546740000004,75.81937380000004,77.41171799999998,78.07812333333334,2255400,1950890,54.39568529856059,NaN,1.5,2.75,NaN,NaN,1.1901719032410865,1.1560877343161327,NaN,0.005546040775284866,0.8129996710890026,0.8074536303137178,19.304567740464663,-0.1406816720257255,NaN,NaN,NaN,36494399
855239400,77.78125,78.20312,77.40625,78.15625,NaN,NaN,75.42229729729729,80.45673076923077,69.77492045000004,73.44890490000003,75.85999880000003,77.55390549999997,75.89264514829887,77.41653818109488,77.91346076923068,79.5338131317914,76.29310840666996,69.77492045000004,73.44890490000003,75.85999880000003,77.55390549999997,77.92187333333334,2483100,2004260,57.20951210463137,NaN,1.5,2.75,NaN,NaN,1.1620789101524374,1.2389111193158573,NaN,-0.022142031499357562,0.7797760909395208,0.8019181224388784,18.029690144935085,1.8322475570032573,NaN,NaN,NaN,38977499
855325800,78.8125,79.25,77.78125,79.21875,NaN,NaN,75.52364864864865,80.53365384615384,69.84452985000003,73.55452990000003,75.92687380000002,77.70859299999998,76.02308063267931,77.58817740194299,77.98557615384607,79.74266410014856,76.22848820754358,69.84452985000003,73.55452990000003,75.92687380000002,77.70859299999998,78.75,2321000,2001835,62.36279765007799,NaN,1.5,2.75,NaN,NaN,1.183983987998692,1.1594362172706543,NaN,0.022159676441844245,0.8296177179911837,0.8074580415493394,17.171514022009887,3.5116374030216413,NaN,NaN,NaN,41298499
855585000,79.25,79.53125,78.42187,78.46875,NaN,NaN,75.625,80.61057692307692,69.90968610000003,73.65437370000004,75.98156140000003,77.83124949999998,76.11898923531933,77.6720414589008,77.95672999999991,79.66823774497264,76.24522225502717,69.90968610000003,73.65437370000004,75.98156140000003,77.83124949999998,78.80729000000001,1670000,2017105,57.132380831729506,NaN,1.5,2.75,NaN,NaN,1.1786551317130711,0.8279192208635644,NaN,-0.006459206841407772,0.7993840329975797,0.8058432398389874,18.403423568923834,2.239413680781759,NaN,NaN,NaN,39628499
855671400,78.78125,79.375,78.125,79.375,NaN,NaN,75.72635135135135,80.6875,69.97937360000003,73.76062370000004,76.04874900000003,77.95156199999998,76.24667593197347,77.83422798662453,78.08172999999991,79.94520223244858,76.21825776755124,69.97937360000003,73.76062370000004,76.04874900000003,77.95156199999998,78.95833333333333,1664300,1994760,61.350562912801365,NaN,1.5,2.75,NaN,NaN,1.1837511937335659,0.8343359602157653,NaN,0.026429672691590023,0.8388803307034749,0.8124506580118849,19.11478925850766,2.4193548387096775,NaN,NaN,NaN,41292799
855757800,79.375,80.64062,79.26562,80.5,NaN,NaN,75.82770270270271,80.76442307692308,70.05492050000004,73.87921750000004,76.13781160000002,78.13749949999998,76.41347295424902,78.08811103551743,78.37019153846146,80.46623269369077,76.27415038323214,70.05492050000004,73.87921750000004,76.13781160000002,78.13749949999998,80.13541333333333,2675400,2049335,65.84375755587098,NaN,1.5,2.75,NaN,NaN,1.197411822752597,1.3054966611120193,NaN,0.11004621233289402,0.9500084234280024,0.8399622110951084,19.793587785952646,2.5477707006369426,NaN,NaN,NaN,43968199
855844200,80.8125,81.5625,80.6875,81.375,NaN,NaN,75.92905405405405,80.84134615384616,70.13413925000003,74.00671750000004,76.27031160000003,78.35156199999997,76.60804264231768,78.40114807975387,78.7427876923076,81.10407273962969,76.38150264498552,70.13413925000003,74.00671750000004,76.27031160000003,78.35156199999997,81.20833333333333,1104800,2039155,68.87462451122639,NaN,1.5,2.75,NaN,NaN,1.1877752639845542,0.5417930466296088,NaN,0.20486931586182566,1.0960488559223904,0.8911795400605648,19.49039220210956,3.786369071343165,NaN,NaN,NaN,45072999
855930600,81.1875,81.46875,80.90625,81.1875,NaN,NaN,76.0304054054054,80.91826923076923,70.21804550000003,74.13249880000004,76.39499920000002,78.53281199999998,76.78762920536406,78.66651492930112,79.08413384615376,81.47717567714709,76.69109201516044,70.21804550000003,74.13249880000004,76.39499920000002,78.53281199999998,81.1875,1112900,2014600,67.49255290974347,NaN,1.5,2.75,NaN,NaN,1.1431127451285146,0.5524173533207585,NaN,0.23347248633565243,1.1830201479801303,0.9495476616444779,19.600274194023818,3.2386316384586,NaN,NaN,NaN,43960099
856276200,81.34375,81.9375,80.75,81.875,NaN,NaN,76.13175675675676,80.9951923076923,70.30585800000003,74.26468630000004,76.53749920000001,78.74374949999998,76.9871339424086,78.97208493603435,79.42067230769223,82.04708887742922,76.79425573795524,70.30585800000003,74.26468630000004,76.53749920000001,78.74374949999998,81.52083333333333,833100,1961760,69.87922907541655,NaN,1.5,2.75,NaN,NaN,1.1462832633336206,0.4246696843650599,NaN,0.27437918502056036,1.2925216429201782,1.0181424578996179,19.797150065328132,3.4755134281200633,NaN,NaN,NaN,44793199
856362600,81.65625,82,81.15625,81.32812,NaN,NaN,76.23310810810811,82,70.39124860000004,74.39171750000003,76.67781160000003,78.89609299999998,77.15736868976514,79.1964692278406,79.6382199999999,82.38911782345217,76.88732217654764,70.39124860000004,74.39171750000003,76.67781160000003,78.89609299999998,81.49479000000001,648100,1854875,65.74425794709586,NaN,1.5,2.75,NaN,NaN,1.1246737445240762,0.3494035986252443,NaN,0.24145248656194274,1.3199580661020462,1.0785055795401035,20.647628684171927,4.74944687458704,NaN,NaN,NaN,44145099
856449000,81.03125,81.35937,80.15625,80.34375,NaN,NaN,76.33445945945945,82.12847222222223,70.47304550000004,74.50828000000003,76.77656160000002,78.97109299999997,77.28232481957826,79.30573406328435,79.78725846153837,82.46396347932405,77.11055344375269,70.47304550000004,74.50828000000003,76.77656160000002,78.97109299999997,80.61979000000001,1193900,1854490,58.97916164404412,NaN,1.5,2.75,NaN,NaN,1.130277048486642,0.6437888583923342,NaN,0.13550460830506617,1.2478863399214362,1.11238173161637,18.28444714696109,2.7988804478208715,NaN,NaN,NaN,42951199
856535400,80.40625,80.76562,80.14062,80.375,NaN,NaN,76.4358108108108,82.25694444444444,70.55101425000004,74.62578000000003,76.88312420000003,79.10234299999998,77.40360619920264,79.40756891440013,79.92067230769223,82.52745085264249,77.31389376274197,70.55101425000004,74.62578000000003,76.88312420000003,79.10234299999998,80.42708,1844400,1816655,59.122965942522356,NaN,1.5,2.75,NaN,NaN,1.0941858307375962,1.015272575144978,NaN,0.05384808536916541,1.1796918383278268,1.1258437529586613,18.235472302305787,1.4595660749506902,NaN,NaN,NaN,44795599
856794600,79.96875,81.375,79.96875,81.32812,NaN,NaN,76.53716216216216,82.38541666666667,70.63398300000003,74.74906120000003,77.02249920000003,79.33124899999997,77.55750870119469,79.59047854160012,80.09014307692298,82.75381069808533,77.42647545576064,70.63398300000003,74.74906120000003,77.02249920000003,79.33124899999997,80.89062333333334,787300,1747220,63.343789049828644,NaN,1.5,2.75,NaN,NaN,1.1164761285420537,0.45060152699717265,NaN,0.05040634227469587,1.1888516808020313,1.1384453385273354,17.891412845450137,3.6439601752289903,NaN,NaN,NaN,45582899
856881000,81.40625,81.53125,80.875,81.39062,NaN,NaN,76.63851351351352,82.51388888888889,70.71406110000004,74.86827990000003,77.18781160000002,79.57421749999996,77.70782679134392,79.76192058525726,80.37860461538452,82.7102268991481,78.04698233162094,70.71406110000004,74.86827990000003,77.18781160000002,79.57421749999996,81.26562333333332,1653900,1724490,63.609143981885744,NaN,1.5,2.75,NaN,NaN,1.0836028336461927,0.9590661586903955,NaN,0.0392163557734857,1.1874657832441926,1.148249427470707,16.23914121743953,2.539363779527557,NaN,NaN,NaN,47236799
856967400,81.3125,81.4375,79.625,80.59375,NaN,NaN,76.73986486486487,82.64236111111111,70.78523300000003,74.98015490000003,77.33343660000003,79.76640499999996,77.8210002505069,79.84114243428037,80.56610461538452,82.51300742525136,78.61920180551768,70.78523300000003,74.98015490000003,77.33343660000003,79.76640499999996,80.55208333333333,1597800,1585580,57.858229904644226,NaN,1.5,2.75,NaN,NaN,1.135666916957179,1.0077069589676964,NaN,-0.03117584976612675,1.1092796152630484,1.1404554650291752,17.06534295311091,0.11645962732919254,NaN,NaN,NaN,45638999
857053800,80.8125,80.8125,79.375,79.39062,NaN,NaN,76.84121621621621,82.77083333333333,70.84835800000003,75.07062360000003,77.47374900000003,79.86093599999995,77.88255396617329,79.79823553577748,80.57932538461529,82.49147493290079,78.66717583632979,70.84835800000003,75.07062360000003,77.47374900000003,79.86093599999995,79.85937333333334,1813100,1620100,50.4429497293166,NaN,1.5,2.75,NaN,NaN,1.1572264228888092,1.1191284488611815,NaN,-0.1608402915641689,0.9394051005739641,1.100245392138133,17.405448998307776,-2.438562211981569,NaN,NaN,NaN,43825899
857140200,79.25,79.875,79.0625,79.15625,NaN,NaN,76.94256756756756,82.89930555555556,70.91070175000003,75.15796740000003,77.59781160000003,79.89374849999996,77.93250283024493,79.73709405617963,80.6322099999999,82.33445138050331,78.92996861949649,70.91070175000003,75.15796740000003,77.59781160000003,79.89374849999996,79.36458333333333,2961200,1661845,49.12221821914179,NaN,1.5,2.75,NaN,NaN,1.13260310696818,1.7818749642716378,NaN,-0.2586676108964512,0.7769108785175689,1.03557848941402,15.576118163300924,-2.501924557351809,NaN,NaN,NaN,40864699
857399400,78.75,79.75,78.6875,79.6875,NaN,NaN,77.04391891891892,83.02777777777777,70.97499865000003,75.25343620000004,77.72093660000002,79.95781099999996,78.0013262486667,79.73237081273395,80.65624846153835,82.2944155012638,79.01808142181291,70.97499865000003,75.25343620000004,77.72093660000002,79.95781099999996,79.375,1210400,1561960,52.17866849808118,NaN,1.5,2.75,NaN,NaN,1.1275957421847385,0.7749238136700044,NaN,-0.28196213334297116,0.6831258227353061,0.9650879560782772,16.498615496465142,-2.6717557251908395,NaN,NaN,NaN,42075099
857485800,79.90625,80.125,79.09375,79.25,NaN,NaN,77.14527027027027,83.15625,71.03531115000004,75.34999870000003,77.80499920000003,79.98827999999996,78.05029384675821,79.68643073533072,80.56009461538451,82.36219598782353,78.7579932429455,71.03531115000004,75.34999870000003,77.80499920000003,79.98827999999996,79.48958333333333,1478700,1598145,49.53928383606362,NaN,1.5,2.75,NaN,NaN,1.120713903457257,0.9252602235717035,NaN,-0.31850051836911375,0.5669623081168851,0.8854628264859988,15.206871721135885,-2.5552293597835516,NaN,NaN,NaN,40596399
857572200,79.71875,80.59375,79.45312,80.59375,NaN,NaN,77.24662162162163,83.28472222222223,71.10007680000004,75.46140500000003,77.91999920000002,80.06171749999996,78.15003722531671,79.77284209387065,80.49999846153835,82.24044156936377,78.75955535371294,71.10007680000004,75.46140500000003,77.91999920000002,80.06171749999996,80.21354000000001,1254800,1628180,56.77197888339968,NaN,1.5,2.75,NaN,NaN,1.13664505321031,0.7706764608335688,NaN,-0.2470233565814003,0.5766836307592484,0.8237069873406487,18.809452973984378,0.31116297160637885,NaN,NaN,NaN,41851199
857658600,80.625,80.90625,79.875,80.125,NaN,NaN,77.34797297297297,83.41319444444444,71.16296745000004,75.55953000000004,78.02937420000002,80.18593649999997,78.22748674589252,79.80638094207345,80.4182676923076,82.12128209904952,78.71525328556567,71.16296745000004,75.55953000000004,78.02937420000002,80.18593649999997,80.30208333333333,1528500,1591835,53.87122373166515,NaN,1.5,2.75,NaN,NaN,1.1291168351238594,0.9602125848470476,NaN,-0.22669759306316373,0.5403349960116941,0.7670325890748578,17.743173366024276,-0.3110419906687403,NaN,NaN,NaN,40322699
857745000,80.4375,81.15625,80.25,80.84375,NaN,NaN,77.44932432432432,83.54166666666667,71.22624870000003,75.66390500000003,78.14218680000002,80.32031149999997,78.33008530487713,79.90517799520931,80.33894076923067,81.84819417758739,78.82968736087396,71.22624870000003,75.66390500000003,78.14218680000002,80.32031149999997,80.75,1859300,1560645,57.460376483491125,NaN,1.5,2.75,NaN,NaN,1.1221263469007265,1.1913663901784197,NaN,-0.1631978796690412,0.5630352394885563,0.7262331191575975,18.517864815888267,-0.5955750606309336,NaN,NaN,NaN,42181999
858004200,80.9375,81.6875,80.54687,81.6875,NaN,NaN,77.55067567567568,83.67013888888889,71.29515495000004,75.77765500000004,78.26031180000001,80.44374899999997,78.4617486262545,80.07492294804652,80.36658538461529,81.9582174005524,78.77495336867818,71.29515495000004,75.77765500000004,78.26031180000001,80.44374899999997,81.30729000000001,1074900,1498340,61.270048382116116,NaN,1.5,2.75,NaN,NaN,1.1234480364078177,0.7173939159336332,NaN,-0.06761716185903821,0.6417116668337997,0.7093288286928379,18.22246808154451,0.36475947719774293,NaN,NaN,NaN,43256899
858090600,81.75,81.79687,81.25,81.25,NaN,NaN,77.65202702702703,81.79687,71.36054560000004,75.88359250000003,78.36781180000001,80.58281149999996,78.57109181738178,80.18683504823257,80.43629692307682,82.0957615621557,78.77683228399795,71.36054560000004,75.88359250000003,78.36781180000001,80.58281149999996,81.43229000000001,624600,1446070,58.351960677944454,NaN,1.5,2.75,NaN,NaN,1.0822638909501163,0.43192929802844954,NaN,-0.03855145973769092,0.6611395040207242,0.6996909637584151,18.519436408707662,0.81426909654905,NaN,NaN,NaN,42632299
858177000,81.3125,81.34375,80.29687,80.53125,NaN,NaN,77.75337837837839,81.78236071428572,71.42578000000003,75.98046750000003,78.47406180000002,80.64062399999997,78.64796076571976,80.21963647221041,80.44831615384606,82.10809418871787,78.78853811897426,71.42578000000003,75.98046750000003,78.47406180000002,80.64062399999997,80.72395666666667,1055600,1415635,53.81718721573591,NaN,1.5,2.75,NaN,NaN,1.0797364701679653,0.7456724367509987,NaN,-0.07056060434782796,0.6114902083236302,0.6820508126714582,18.345044230067998,1.436731442581002,NaN,NaN,NaN,41576699
858263400,80.25,80.46875,79.0625,79.28125,NaN,NaN,77.85472972972973,81.76785142857143,71.48703000000003,76.06109250000003,78.58281180000002,80.57968649999997,78.67279563765231,80.13026633199989,80.29086461538454,81.97509106878783,78.60663816198124,71.48703000000003,76.06109250000003,78.58281180000002,80.57968649999997,79.60416666666667,2514100,1407570,46.97927814660597,NaN,1.5,2.75,NaN,NaN,1.1075231508702534,1.7861278657544564,NaN,-0.17291461943267072,0.4659075383806197,0.6388221578132904,18.526851343766694,0.15791551519936833,NaN,NaN,NaN,39062599
858349800,79.64062,80.03125,79.25,79.6875,NaN,NaN,77.95608108108108,81.75334214285714,71.54859250000003,76.14671750000004,78.69593680000001,80.49531149999997,78.71258796558752,80.08809810990466,80.15985538461531,81.74347086218903,78.5762399070416,71.54859250000003,76.14671750000004,78.69593680000001,80.49531149999997,79.65625,1642700,1434465,49.23673728484537,NaN,1.5,2.75,NaN,NaN,1.0842179258080924,1.1451656192378343,NaN,-0.20790175682897982,0.3789449617770657,0.5868467186060455,18.655429386451086,0,NaN,NaN,NaN,40705299
858609000,79.25,80.03125,78.4375,79.90625,NaN,NaN,78.05743243243244,81.73883285714285,71.61374875000003,76.23953000000003,78.79218680000002,80.43124899999997,78.75939824144683,80.07077924229469,80.10697076923068,81.6749352918281,78.53900624663326,71.61374875000003,76.23953000000003,78.79218680000002,80.43124899999997,79.45833333333333,3013500,1529495,50.459862283301035,NaN,1.5,2.75,NaN,NaN,1.1206130739646574,1.9702581571041422,NaN,-0.2103225186554072,0.32394357028678655,0.5342660889421937,18.324731051106866,0.8280757097791798,NaN,NaN,NaN,43718799
858695400,80,80.10937,78.71875,79.04687,NaN,NaN,78.15878378378379,81.72432357142857,71.67367060000004,76.32140500000003,78.88437420000002,80.28984249999996,78.77067164374303,79.97326407636186,80.08052846153838,81.70644662500891,78.45461029806785,71.67367060000004,76.32140500000003,78.88437420000002,80.28984249999996,79.29166333333335,1352500,1555465,45.791856067663716,NaN,1.5,2.75,NaN,NaN,1.1398992829671817,0.8695149039033344,NaN,-0.2605287771829616,0.20860511746349175,0.46913389464645333,19.168828892493345,-1.919354788677784,NaN,NaN,NaN,42366299
858781800,78.84375,79.5,78.0625,78.78125,NaN,NaN,78.26013513513513,81.70981428571429,71.72992060000003,76.40671750000003,78.95312420000002,80.16249899999997,78.7710864812433,79.85973892623215,80.05168230769223,81.75369456742824,78.34967004795622,71.72992060000003,76.40671750000003,78.95312420000002,80.16249899999997,78.78125,1510000,1598560,44.42393021808153,NaN,1.5,2.75,NaN,NaN,1.1611564770409544,0.9446001401261135,NaN,-0.2995679903988099,0.09467390664794095,0.39424189704675083,15.803468670833045,-1.6770670826833074,NaN,NaN,NaN,40856299
858868200,78.75,79,77.875,78.375,NaN,NaN,78.36148648648648,81.69530499999999,71.78117060000004,76.48734250000003,79.02687420000002,80.06406149999997,78.7555536780573,79.71833521897194,79.95072076923068,81.86912326316694,78.03231827529443,71.78117060000004,76.48734250000003,79.02687420000002,80.06406149999997,78.41666666666667,1808200,1629275,42.34064348348265,NaN,1.5,2.75,NaN,NaN,1.1585738715380292,1.109818784428657,NaN,-0.3378533179050778,-0.028074750334596388,0.3097785675704814,15.753455245936422,-3.0537301894085815,NaN,NaN,NaN,39048099
858954600,78.6875,78.75,78.34375,78.4375,NaN,NaN,78.46283783783784,81.68079571428571,71.83523310000004,76.57328000000003,79.08937420000002,79.96718649999997,78.74308098480014,79.59635091240318,79.88822076923068,81.94202906441113,77.83441247405024,71.83523310000004,76.57328000000003,79.08937420000002,79.96718649999997,78.51041666666667,2810600,1677585,42.78518456145097,NaN,1.5,2.75,NaN,NaN,1.1048364521424556,1.6753845557751172,NaN,-0.3429745783556474,-0.1189396553740778,0.22403492298156955,14.274745444659173,-3.978576893649579,NaN,NaN,NaN,41858699
859213800,78.5,79.57812,78.09375,79.53125,NaN,NaN,78.5641891891892,81.66628642857142,71.89476435000003,76.66453000000003,79.15749920000002,79.87734299999997,78.77398957363151,79.59015082550764,79.80648999999993,81.82576141168916,77.7872185883107,71.89476435000003,76.66453000000003,79.15749920000002,79.87734299999997,79.06770666666667,2145600,1745500,50.04380651702788,NaN,1.5,2.75,NaN,NaN,1.1319459912751373,1.229217989114867,NaN,-0.26044710488249306,-0.1015239581215468,0.15892314676094627,15.544137386850064,-2.1153846153846154,NaN,NaN,NaN,44004299
859300200,79.34375,79.96875,78.53125,78.75,NaN,NaN,78.66554054054055,81.65177714285714,71.95148310000003,76.75031130000004,79.21218680000001,79.74531199999998,78.77304880603812,79.51013646117357,79.70072076923068,81.78517053380737,77.616271004654,71.95148310000003,76.75031130000004,79.21218680000001,79.74531199999998,79.08333333333333,2125800,1769095,45.594290389076015,NaN,1.5,2.75,NaN,NaN,1.1537712776126274,1.2016313425791154,NaN,-0.2463738375767932,-0.14904415021004525,0.09732968736674796,16.035380297792752,-2.2118742724097786,NaN,NaN,NaN,41878499
859386600,79.0625,79.65625,78.6875,79.09375,NaN,NaN,78.76689189189189,81.63726785714286,72.01023310000004,76.83281130000003,79.25468680000002,79.67031199999998,78.78562532344839,79.47048060772848,79.56610538461531,81.56205096254152,77.5701598066891,72.01023310000004,76.83281130000003,79.25468680000002,79.67031199999998,79.14583333333333,1335300,1755970,47.793780695076194,NaN,1.5,2.75,NaN,NaN,1.1405554720688682,0.7604344037768299,NaN,-0.20358767683864815,-0.15715490868156223,0.04643276815708592,16.09501603983751,-0.2364998029168309,NaN,NaN,NaN,43213799
859473000,79.375,79.375,76.15625,77,NaN,NaN,78.86824324324324,81.62275857142856,72.05913935000004,76.89687380000004,79.25906180000001,79.55078099999999,78.71560080096022,79.23519674032576,79.20552846153838,81.23164436235312,77.17941256072363,72.05913935000004,76.89687380000004,79.25906180000001,79.55078099999999,77.51041666666667,2898500,1810240,37.77620376472077,NaN,1.5,2.75,NaN,NaN,1.2889979383496633,1.601168905780449,NaN,-0.3001392900633705,-0.3287413444221272,-0.028602054358756714,20.326516619345398,-3.372549019607843,NaN,NaN,NaN,40315299
859818600,75.6875,75.6875,75.6875,75.6875,NaN,NaN,78.9695945945946,81.60824928571428,72.10148310000004,76.94312380000002,79.23093680000002,79.37734349999998,78.59685174994218,78.89732086029474,78.77764384615377,81.20557589139611,76.34971180091142,72.10148310000004,76.94312380000002,79.23093680000002,79.37734349999998,75.6875,4270699,1875714.95,33.09353317900796,NaN,1.5,2.75,NaN,NaN,1.2906766570389732,2.2768379598403263,NaN,-0.4284220974660117,-0.5641296761912713,-0.13570757872525963,21.11458796384814,-5.279624560031286,NaN,NaN,NaN,36044600
859905000,75.25,76.1875,75.04687,75.85937,NaN,NaN,79.07094594594595,81.59374,72.14609245000003,76.98703000000003,79.19687420000002,79.18593699999998,78.48949952445425,78.60799220693333,78.41826846153837,81.07391583036072,75.76262109271603,72.14609245000003,76.98703000000003,79.19687420000002,79.18593699999998,75.69791333333335,3210900,1975739.95,34.24301637414294,NaN,1.5,2.75,NaN,NaN,1.2799590386790467,1.6251632711076172,NaN,-0.47416311964060476,-0.7284114782760156,-0.25424835863541084,21.05169441670001,-4.032417728874021,NaN,NaN,NaN,39255500
859991400,75.625,75.9375,74.4375,74.5,NaN,NaN,79.17229729729729,81.57923071428571,72.18413935000004,77.00359250000002,79.13374920000003,78.94843699999998,78.33304856271094,78.21675485389206,78.05047999999991,81.36803733119322,74.7329226688066,72.18413935000004,77.00359250000002,79.13374920000003,78.94843699999998,74.95833333333333,2672700,2035439.95,29.871660338074747,NaN,1.5,2.75,NaN,NaN,1.2956762502019719,1.31308221596024,NaN,-0.5624101758496954,-0.9572610784475302,-0.39485090259783473,22.143416021158046,-5.43435144783816,NaN,NaN,NaN,36582800
860077800,74.4375,75.125,74.1875,74.90625,NaN,NaN,79.27364864864865,81.56472142857143,72.22695185000003,77.02249880000004,79.06624920000002,78.66406199999997,78.19866430534972,77.90146867733091,77.68269153846146,81.24393444290527,74.12144863401764,72.22695185000003,77.02249880000004,79.06624920000002,78.66406199999997,74.73958333333333,2284200,2086909.95,32.63918730254356,NaN,1.5,2.75,NaN,NaN,1.2700922323304025,1.0945369252755732,NaN,-0.5587135440606772,-1.0932428326736812,-0.534529288613004,23.07023621125101,-4.425837320574162,NaN,NaN,NaN,38867000
860164200,74.5,75.85937,74.15625,75.84375,NaN,NaN,79.375,81.55021214285713,72.27296750000004,77.04671760000002,79.00624920000001,78.44999949999998,78.10631472474778,77.70549546996607,77.37019153846146,80.80691306785687,73.93347000906604,72.27296750000004,77.04671760000002,79.00624920000001,78.44999949999998,75.28645666666667,3706700,2195819.95,38.65557721388463,NaN,1.5,2.75,NaN,NaN,1.301022787163945,1.6880710096472162,NaN,-0.46240561834026495,-1.112536311538335,-0.6501306931980702,25.148788667294863,-3.306772908366534,NaN,NaN,NaN,42573700
860419800,76.1875,76.625,76.14062,76.14062,NaN,NaN,79.47635135135135,81.53570285714285,72.32070185000003,77.07468630000002,78.97406160000003,78.21484299999997,78.02922865711061,77.55645971092169,77.14663384615375,80.4949656600126,73.7983020322949,72.32070185000003,77.07468630000002,78.97406160000003,78.21484299999997,76.30208,2596200,2232664.95,40.46880747316155,NaN,1.5,2.75,NaN,NaN,1.2638961595093774,1.1628256178787595,NaN,-0.3529289424024187,-1.0912918712010935,-0.7383629287986748,25.394865587406283,-4.263267583497055,NaN,NaN,NaN,45169900
860506200,76.125,76.78125,75.84375,76.6875,NaN,NaN,79.57770270270271,81.52119357142857,72.37007685000003,77.11031130000003,78.97281160000003,77.96484299999997,77.97661184702784,77.47370164321485,76.98557615384607,80.20276215148318,73.76839015620895,72.37007685000003,77.11031130000003,78.97281160000003,77.96484299999997,76.4375,1822700,2270054.95,43.76630807036833,NaN,1.5,2.75,NaN,NaN,1.2405821481158503,0.8029321052338402,NaN,-0.22417784662268692,-1.0185852370770334,-0.7944073904543465,24.030183337774883,-2.619047619047619,NaN,NaN,NaN,46992600
860592600,77,77.04687,75.84375,76.0625,NaN,NaN,79.67905405405405,81.50668428571429,72.41570185000003,77.13640510000003,78.96343660000002,77.70546799999997,77.90154863734047,77.3393014867182,76.80769153846146,79.95282900418587,73.66255407273704,72.41570185000003,77.13640510000003,78.96343660000002,77.70546799999997,76.31770666666667,2453200,2361484.95,40.9730488463413,NaN,1.5,2.75,NaN,NaN,1.2379062803932894,1.0388378719076738,NaN,-0.1643709603011695,-0.9998710908308084,-0.8355001305296389,23.889469214898106,-3.832477281706835,NaN,NaN,NaN,44539400
860679000,76.09375,76.54687,75.6875,75.78125,NaN,NaN,79.7804054054054,81.492175,72.46031125000003,77.15484260000002,78.94406160000003,77.46796799999997,77.81839967117025,77.19091563084028,76.60336461538454,79.64174498736082,73.56498424340825,72.46031125000003,77.15484260000002,78.94406160000003,77.46796799999997,76.00520666666665,1996500,2408529.95,39.74380520268048,NaN,1.5,2.75,NaN,NaN,1.2108679746509114,0.8289288659250427,NaN,-0.12860018799925643,-0.9962503655287094,-0.867650177529453,23.3664211016695,-1.5827922077922079,NaN,NaN,NaN,42542900
860765400,75.0625,75.3125,73.375,73.375,NaN,NaN,79.88175675675676,81.4776657142857,72.49515500000003,77.14828010000002,78.86156160000002,77.17265549999998,77.64414870367338,76.82749509456978,76.12980692307684,79.11374806483474,73.14586578131895,72.49515500000003,77.14828010000002,78.86156160000002,77.17265549999998,74.02083333333333,4221602,2493905.05,31.136885387123087,NaN,1.5,2.75,NaN,NaN,1.296252405032989,1.6927677338798446,NaN,-0.24508937907133,-1.1740119013686154,-0.9289225222972854,25.401691896201758,-3.05532617671346,NaN,NaN,NaN,38321298
861024600,73.73437,74.45312,73.3125,74.35937,NaN,NaN,73.3125,81.46315642857142,72.53257685000003,77.15140510000003,78.77874900000002,76.90624899999997,77.51533385254893,76.59243556175362,75.79206615384606,78.49385079375264,73.09028151393949,72.53257685000003,77.15140510000003,78.77874900000002,76.90624899999997,74.04166333333335,3988500,2611195.05,37.13468199499774,NaN,1.5,2.75,NaN,NaN,1.2851358046734898,1.5274615352843903,NaN,-0.23396555397046015,-1.2213794647603606,-0.9874139107899005,25.992654633423506,-1.9773430757466086,NaN,NaN,NaN,42309798
861111000,75.25,75.64062,74.5,75.625,NaN,NaN,73.33046875,81.44864714285714,72.57515500000004,77.16187390000003,78.72312400000003,76.69218649999996,77.44120311323329,76.50029884158661,75.52523923076913,77.44076846246361,73.60970999907465,72.57515500000004,77.16187390000003,78.72312400000003,76.69218649999996,75.25520666666667,2760400,2598540.05,43.900177840597905,NaN,1.5,2.75,NaN,NaN,1.284858247196812,1.0622888032839826,NaN,-0.12495688095114876,-1.1436100119788364,-1.0186531310276876,28.085530705636653,1.5100671140939597,NaN,NaN,NaN,45070198
861197400,75.375,76.60937,75.25,76.5,NaN,NaN,73.3484375,81.43413785714286,72.61921750000003,77.17984270000002,78.68031160000002,76.56484299999997,77.40429318722414,76.50027038048313,75.4867776923076,77.29964437528605,73.67391100932915,72.61921750000003,77.17984270000002,78.68031160000002,76.56484299999997,76.11979000000001,2273300,2644580.05,48.061788801683825,NaN,1.5,2.75,NaN,NaN,1.2901805152541823,0.8596071803536445,NaN,0.015045411621597449,-0.9998463665006909,-1.0148917781222884,26.315254788048247,2.127659574468085,NaN,NaN,NaN,47343498
861283800,76.5,77,76,76.1875,NaN,NaN,73.36640625,81.41962857142856,72.66296750000004,77.19578020000003,78.62156160000002,76.43515549999998,77.356575807333,76.47048272519902,75.52523923076913,77.37436124877553,73.67611721276273,72.66296750000004,77.19578020000003,78.62156160000002,76.43515549999998,76.39583333333333,1386000,2638380.05,46.72854699554085,NaN,1.5,2.75,NaN,NaN,1.2694533355931694,0.5253223469454297,NaN,0.09131698564484447,-0.9007455460662328,-0.9920625317110773,26.512840323668833,0.45323444581788214,NaN,NaN,NaN,45957498
861370200,76.8125,76.98437,76.25,76.5625,NaN,NaN,73.384375,81.40511928571428,72.70929565000003,77.20968650000003,78.59999920000001,76.34453049999998,77.32543557959445,76.47924627518006,75.57932615384605,77.50396847154538,73.65468383614673,72.70929565000003,77.20968650000003,78.59999920000001,76.34453049999998,76.59895666666667,1702100,2633075.05,48.57217411082724,NaN,1.5,2.75,NaN,NaN,1.2356973830508,0.6464304919831283,NaN,0.1673116120001905,-0.7829230167108392,-0.9502346287110297,25.73937259733684,0.5540800692192966,NaN,NaN,NaN,47659598
861629400,76.75,76.90625,75.46875,76.0625,NaN,NaN,73.40234375,81.39061,72.76171755000003,77.20906150000002,78.55812420000002,76.22578049999997,77.27590869412016,76.43955615373434,75.69951846153837,77.53250826003175,73.866528663045,72.76171755000003,77.20906150000002,78.55812420000002,76.22578049999997,76.14583333333333,2809400,2633015.05,46.27270866953747,NaN,1.5,2.75,NaN,NaN,1.2501118556900284,1.0669897234351169,NaN,0.18292709618607417,-0.721575758478437,-0.9045028546645112,25.996590800687095,-0.8149959250203749,NaN,NaN,NaN,44850198
861715800,76.10937,77.73437,76,77.73437,NaN,NaN,73.4203125,81.37610071428571,72.82382690000003,77.22765520000003,78.52843660000002,76.13593649999997,77.29388756886054,76.5628717581406,75.91706615384606,77.97885123974478,73.85528106794735,72.82382690000003,77.22765520000003,78.52843660000002,76.13593649999997,77.15624666666668,3215000,2686485.05,54.097809444411936,NaN,1.5,2.75,NaN,NaN,1.2847017231407405,1.1967310221957126,NaN,0.2980662559752407,-0.5319200346954602,-0.829986290670701,28.68795117880451,2.198021364009858,NaN,NaN,NaN,48065198
861802200,77.65625,78.03125,77.1875,77.8125,NaN,NaN,73.43828125,81.36159142857143,72.88499880000003,77.24843650000003,78.51531160000002,76.08906149999997,77.31422531125817,76.68188397165102,76.06850846153837,78.36263171084997,73.77438521222678,72.88499880000003,77.24843650000003,78.51531160000002,76.08906149999997,77.67708333333333,2047700,2682580.05,54.43181731808077,NaN,1.5,2.75,NaN,NaN,1.2532051714878303,0.7633323001861585,NaN,0.3671610257012142,-0.37103500854418314,-0.7381960342453974,28.049036586796596,2.6804123711340204,NaN,NaN,NaN,50112898
861888600,78.04687,78.28125,76.875,77.42187,NaN,NaN,73.45625,81.34708214285713,72.94288940000003,77.26249900000002,78.47624900000002,76.00546749999997,77.31844667160098,76.75235883149378,76.16706615384605,78.57250007640849,73.76163223128361,72.94288940000003,77.26249900000002,78.47624900000002,76.00546749999997,77.52604000000001,2689900,2750310.05,52.37962466757177,NaN,1.5,2.75,NaN,NaN,1.2641369449529853,0.9780351855239012,NaN,0.37302199942314995,-0.2719185349664599,-0.6449405343896099,28.162490544872036,5.515325383304938,NaN,NaN,NaN,47422998
861975000,77.0625,77.20312,76.42187,76.53125,NaN,NaN,73.47421875,81.33257285714285,73.00296755000004,77.26734280000002,78.39687400000003,75.98202999999997,77.28757621389114,76.73130084754199,76.15504692307681,78.55150364320271,73.75859020295091,73.00296755000004,77.26734280000002,78.39687400000003,75.98202999999997,76.71874666666666,1606200,2685695.05,47.941603375515,NaN,1.5,2.75,NaN,NaN,1.2452700203134863,0.598057474916968,NaN,0.30618362660117515,-0.2622110011381409,-0.568394627739316,20.345822925675204,2.920788597321362,NaN,NaN,NaN,45816798
862234200,76.5,77.8125,76.375,77.28125,NaN,NaN,73.4921875,81.31806357142857,73.06656130000003,77.29265530000002,78.31499900000003,76.06171749999996,77.28732812707189,76.78367695729989,76.24879692307681,78.71769741097278,73.77989643518085,73.06656130000003,77.29265530000002,78.31499900000003,76.06171749999996,77.15625,1666500,2555485.1,51.656276469996484,NaN,1.5,2.75,NaN,NaN,1.2590007331482373,0.6521266745010565,NaN,0.30128517092729784,-0.19178816408019372,-0.49307333500749156,19.85867488964778,2.190082644628099,NaN,NaN,NaN,47483298
862320600,78.59375,79.78125,78.29687,79.71875,NaN,NaN,73.51015625,81.30355428571428,73.15187380000003,77.34031160000002,78.28562400000003,76.25468649999996,77.38267800444162,77.06320772327133,76.55168153846142,79.61208082462181,73.49128225230103,73.15187380000003,77.34031160000002,78.28562400000003,76.25468649999996,79.26562333333334,3197400,2554810.1,61.31714863865311,NaN,1.5,2.75,NaN,NaN,1.347643537923363,1.2515215905871047,NaN,0.4424718583310299,0.06001648790629588,-0.38245537042473404,24.395800502411234,4.207516339869281,NaN,NaN,NaN,50680698
862407000,79.25,80.6875,79.21875,80.09375,NaN,NaN,73.528125,81.28904499999999,73.23828005000003,77.39374910000002,78.24999900000003,76.53437399999997,77.48899455328704,77.3518307972455,77.06850846153836,80.07732396166541,74.0596929614113,73.23828005000003,77.39374910000002,78.24999900000003,76.53437399999997,80,3372200,2589785.1,62.5568579144055,NaN,1.5,2.75,NaN,NaN,1.3562939995002659,1.3021157624236852,NaN,0.535188229330718,0.2865299162386634,-0.24865831309205455,24.070900612727673,5.12715340442986,NaN,NaN,NaN,54052898
862493400,80.21875,80.53125,79.3125,80,NaN,NaN,73.54609375,81.2745357142857,73.32046755000003,77.45062410000003,78.22343660000003,76.78906149999997,77.58746535511892,77.60403738798402,77.50240307692296,80.44957524290338,74.55523091094254,73.32046755000003,77.45062410000003,78.22343660000003,76.78906149999997,79.94791666666667,2149500,2583050.1,62.02171493248012,NaN,1.5,2.75,NaN,NaN,1.34646942810739,0.8321557526119993,NaN,0.5615296675134489,0.45325377129975664,-0.1082758962136923,23.742131223878733,4.489795918367347,NaN,NaN,NaN,51903398
862579800,80.28125,81.67187,80.0625,81.4375,NaN,NaN,73.5640625,81.26002642857142,73.40546755000003,77.51093660000002,78.24531160000002,77.06874899999997,77.73844710589857,77.96912906531888,77.94951846153835,81.35044207271586,74.54859485036083,73.40546755000003,77.51093660000002,78.24531160000002,77.06874899999997,81.05729000000001,1448300,2470130.1,66.72246647530571,NaN,1.5,2.75,NaN,NaN,1.369712326099719,0.586325392334598,NaN,0.641328680008719,0.6933849537972065,0.052056273788487484,24.871727652623882,7.066557107641742,NaN,NaN,NaN,53351698
862839000,81.65625,83.5625,81.29687,83.375,NaN,NaN,73.58203125,81.24551714285714,73.50249880000003,77.59421790000002,78.30531160000002,77.43046799999998,77.95948839586333,78.4839739162409,78.47836461538449,82.8209743739945,74.13575485677448,73.50249880000003,77.59421790000002,78.30531160000002,77.43046799999998,82.74479000000002,3636200,2522130.1,71.79056329100501,NaN,1.5,2.75,NaN,NaN,1.433706445664025,1.4417178558711146,NaN,0.7808977824607892,1.028178501864474,0.2472807194036848,25.22406494651174,7.256288305932114,NaN,NaN,NaN,56987898
862925400,82.96875,83.46875,82.5,83.3125,NaN,NaN,73.6,81.23100785714286,73.60156130000003,77.68374920000002,78.34499920000002,77.76171799999997,78.16941041955496,78.94383354326557,79.02644153846141,83.84643514137606,74.20644793554676,73.60156130000003,77.68374920000002,78.34499920000002,77.76171799999997,83.09375,1721100,2517050.1,71.41273676987548,NaN,1.5,2.75,NaN,NaN,1.4004952709737375,0.6837766161269495,NaN,0.8211980247402197,1.2737782503289594,0.4525802255887397,24.41654424187527,7.068273092369478,NaN,NaN,NaN,55266798
863011800,83,83,81.40625,81.5,NaN,NaN,73.61796875,81.21649857142856,73.69562380000004,77.76749920000002,78.34718680000002,78.03359299999997,78.30002177565085,79.18727796771647,79.4062492307691,84.16754455085149,74.64495391068672,73.69562380000004,77.76749920000002,78.34718680000002,78.03359299999997,81.96875,2327200,2510750.1,61.33194792328371,NaN,1.5,2.75,NaN,NaN,1.4366206087613276,0.926894317359581,NaN,0.6836132752370134,1.3070968196350066,0.6234835443979931,29.486214615023368,5.267413458238611,NaN,NaN,NaN,52939598
863098200,81.3125,83.21875,81.1875,82.0625,NaN,NaN,73.6359375,81.20198928571428,73.79187380000003,77.85499920000002,78.37656180000002,78.34765549999997,78.4475699413116,79.46110863745776,79.86778769230757,84.40084782759403,75.33472755702111,73.79187380000003,77.85499920000002,78.37656180000002,78.34765549999997,82.15625,2923700,2557110.1,63.074073423656664,NaN,1.5,2.75,NaN,NaN,1.4790941367069472,1.1433610152335638,NaN,0.5917549376383295,1.363177216445905,0.7714222788075755,28.84480324948966,7.227439771335239,NaN,NaN,NaN,55863298
863184600,82.96875,83.125,81.65625,82.625,NaN,NaN,73.65390625,81.18748,73.88812380000003,77.95749920000002,78.44124940000002,78.81015549999998,78.61139072792683,79.76243162436654,80.24398999999988,84.81796129201928,75.67001870798049,73.88812380000003,77.95749920000002,78.44124940000002,78.81015549999998,82.46875,2558200,2473940,64.7827777703094,NaN,1.5,2.75,NaN,NaN,1.4783552697993083,1.0340590313427165,NaN,0.5320236657966134,1.4364518610533423,0.9044281952567289,26.639041034229784,6.914678528103518,NaN,NaN,NaN,58421498
863443800,82.9375,84.25,82.875,84,NaN,NaN,73.671875,81.17297071428571,73.98953005000003,78.06796800000002,78.53812440000002,79.29218699999998,78.82270873859636,80.16600956490306,80.71995153846143,85.46723898957868,75.97266408734419,73.98953005000003,78.06796800000002,78.53812440000002,79.29218699999998,83.70833333333333,2357900,2392410,68.60692209958916,NaN,1.5,2.75,NaN,NaN,1.4888298933850719,0.9855752149506146,NaN,0.5461994906380472,1.5871775585542878,1.0409780679162406,27.109450982979396,5.3704429635437085,NaN,NaN,NaN,60779398
863530200,83.9375,84.09375,83.01562,83.65625,NaN,NaN,73.68984375,81.15846142857143,74.09273320000003,78.16921800000001,78.61749940000001,79.69374949999998,79.01225937629846,80.49841341586468,81.19951923076913,85.77366391106229,76.62537455047597,74.09273320000003,78.16921800000001,78.61749940000001,79.69374949999998,83.58854000000001,1195100,2314145,66.6581671245921,NaN,1.5,2.75,NaN,NaN,1.4594941867147095,0.5164326349472483,NaN,0.4950242228888797,1.6597583465273402,1.1647341236384605,23.620197875030254,4.4479126024190405,NaN,NaN,NaN,59584298
863616600,84.23437,84.5,83.4375,83.8125,NaN,NaN,73.7078125,81.14395214285713,74.19367070000003,78.25687430000002,78.70874940000002,80.05937449999998,79.2005041066397,80.81404070959185,81.75961538461527,85.64076625782694,77.8784645114036,74.19367070000003,78.25687430000002,78.70874940000002,80.05937449999998,83.91666666666667,2772000,2339080,67.11540666435945,NaN,1.5,2.75,NaN,NaN,1.4311374590922303,1.1850813140208971,NaN,0.4363514200352767,1.7101733986825565,1.2738219786472798,23.681289748657516,4.765625,NaN,NaN,NaN,62356298
863703000,83.8125,84.59375,83.51562,84.375,NaN,NaN,73.72578125,81.12944285714285,74.29507695000002,78.35218680000001,78.78437440000002,80.46874949999997,79.40342551422246,81.15317968963072,82.30528846153835,85.4367389048213,79.17383801825541,74.29507695000002,78.35218680000001,78.78437440000002,80.46874949999997,84.16145666666667,884100,2313985,68.77551625816476,NaN,1.5,2.75,NaN,NaN,1.4059226405856424,0.38206816379535735,NaN,0.4009864254822537,1.7750550105000968,1.3740685850178431,23.416609197936683,3.607060629316961,NaN,NaN,NaN,63240398
863789400,84.125,84.3125,83,83.21875,NaN,NaN,73.74375,81.11493357142857,74.38538945000003,78.43781180000002,78.84624940000002,80.80156199999998,79.55304608229217,81.34990067157065,82.57451923076913,85.35197596353862,79.79706249799963,74.38538945000003,78.43781180000002,78.84624940000002,80.80156199999998,83.51041666666667,1934200,2325590,61.86224120544887,NaN,1.5,2.75,NaN,NaN,1.4037138805438107,0.831702922699186,NaN,0.2714836662155977,1.7134231677873402,1.4419395015717424,24.258100622848932,-0.1874062968515742,NaN,NaN,NaN,61306198
864048600,83.3125,83.90625,83.0625,83.46875,NaN,NaN,73.76171875,81.10042428571428,74.46992070000003,78.52046810000002,78.89874940000001,81.17187449999997,79.70660309867287,81.55169584570677,82.83413461538451,85.24185265101491,80.42641657975412,74.46992070000003,78.52046810000002,78.89874940000001,81.17187449999997,83.47916666666667,1375800,2253910,62.73446961899478,NaN,1.5,2.75,NaN,NaN,1.3637164605049672,0.6104059168289772,NaN,0.1788907519647036,1.665552941527622,1.4866621895629184,20.17406216976086,0.18754688672168043,NaN,NaN,NaN,62681998
864135000,83.28125,84.6875,82.75,84.46875,NaN,NaN,73.7796875,81.085915,74.56140510000003,78.60734310000002,78.95437440000002,81.50859349999999,79.89335395754844,81.82951052706804,83.17788461538451,85.09494250360484,81.26082672716419,74.56140510000003,78.60734310000002,78.95437440000002,81.50859349999999,83.96875,1756400,2180980,66.07657003150548,NaN,1.5,2.75,NaN,NaN,1.4047009990403265,0.8053260460893726,NaN,0.16174160672838034,1.6888391979733939,1.5270975912450135,21.25249135952972,3.642638036809816,NaN,NaN,NaN,64438398
864221400,84.6875,84.98437,83.65625,84.28125,NaN,NaN,73.79765625,81.0714057142857,74.65093635000002,78.69140560000001,79.01499940000002,81.83203099999999,80.06542831215438,82.06300952449013,83.39663461538451,85.1072815309886,81.68598769978043,74.65093635000002,78.69140560000001,79.01499940000002,81.83203099999999,84.30729000000001,1208000,2138995,64.90126311500227,NaN,1.5,2.75,NaN,NaN,1.3992309276803032,0.5647512032519945,NaN,0.11662602323044369,1.672880120283068,1.5562540970526244,15.579335600923434,2.703731911652704,NaN,NaN,NaN,63230398
864307800,84.375,84.46875,83.5625,84,NaN,NaN,73.815625,81.05689642857142,74.73820200000003,78.77921810000002,79.08437440000002,82.16093749999999,80.2197252410895,82.24748480787201,83.44471153846143,85.1850961538583,81.70432692306457,74.73820200000003,78.77921810000002,79.08437440000002,82.16093749999999,84.01041666666667,907600,2049880,63.08854508153449,NaN,1.5,2.75,NaN,NaN,1.3640180042745673,0.4427576248365758,NaN,0.05009793118612604,1.6188765110352819,1.5687785798491558,15.835094443818281,1.6641452344931922,NaN,NaN,NaN,62322798
864394200,84.375,85.21875,84.15625,84.78125,NaN,NaN,73.83359375,81.04238714285714,74.82992075000003,78.88859310000002,79.19437440000002,82.57343749999998,80.39860856496836,82.48879577855087,83.55769230769221,85.43442966847007,81.68095494691434,74.82992075000003,78.88859310000002,79.19437440000002,82.57343749999998,84.71875,644400,2001790,65.93477845369463,NaN,1.5,2.75,NaN,NaN,1.3536417182549554,0.32191188885947075,NaN,0.04132849061892019,1.620439193122806,1.5791107025038857,16.144689193348498,0.9300595238095238,NaN,NaN,NaN,62967198
864739800,84.375,85.53125,84.26562,85.125,NaN,NaN,73.8515625,81.02787785714285,74.92445200000003,78.99953060000001,79.30312440000002,82.96562499999999,80.58395724869509,82.73986284726031,83.83653846153835,85.46876239092727,82.20431453214944,74.92445200000003,78.99953060000001,79.30312440000002,82.96562499999999,84.97395666666667,1531000,1995015,67.13558383075136,NaN,1.5,2.75,NaN,NaN,1.34735516695103,0.76741277634504,NaN,0.04120633848163813,1.6306186256059334,1.5894122871242953,13.600216125960806,1.7556966753828913,NaN,NaN,NaN,64498198
864826200,85.125,85.45312,84.51562,85.10937,NaN,NaN,73.86953125,81.01336857142856,75.01648325000002,79.09968680000001,79.40718680000002,83.23515599999999,80.76142441541293,82.96553019514029,84.07091307692296,85.47609932615279,82.66572682769313,75.01648325000002,79.09968680000001,79.40718680000002,83.23515599999999,85.02603666666666,716700,1870980,67.01990173511197,NaN,1.5,2.75,NaN,NaN,1.3180797978830991,0.38306128339159157,NaN,0.023481833019918907,1.618764578399194,1.595282745379275,13.208950199985548,1.5473467561521235,NaN,NaN,NaN,63781498
864912600,85.09375,85.25,84.5,84.60937,NaN,NaN,73.8875,80.99885928571427,75.10867075000003,79.20140550000002,79.51843680000002,83.46093699999997,80.91232424225949,83.12208636703168,84.2235569230768,85.37563219396773,83.07148165218587,75.10867075000003,79.20140550000002,79.51843680000002,83.46093699999997,84.78645666666667,1282700,1766505,63.264395806551455,NaN,1.5,2.75,NaN,NaN,1.277502669462878,0.7261230508829581,NaN,-0.035311220297338686,1.5511437200076017,1.5864549403049404,13.908029006250418,0.27777185185185,NaN,NaN,NaN,62498798
864999000,83.21875,85.5625,83.125,85.15625,NaN,NaN,73.90546875,80.98434999999999,75.20242075000003,79.29953050000002,79.64593680000002,83.71874949999997,81.07875270334735,83.31581623683819,84.3124992307691,85.55665489521756,83.06834356632065,75.20242075000003,79.29953050000002,79.64593680000002,83.71874949999997,84.61458333333333,2143300,1766195,65.53896769885029,NaN,1.5,2.75,NaN,NaN,1.360359621644101,1.213512664230167,NaN,-0.04987329746344993,1.524113318475628,1.5739866159390778,13.871592063032184,2.328201276755539,NaN,NaN,NaN,64642098
865258200,85.34375,85.5,84.71875,84.78125,NaN,NaN,73.9234375,80.96984071428571,75.29492075000003,79.40046800000002,79.77406180000001,83.88593699999998,81.2239486757651,83.45538135713932,84.39903769230757,85.60446889418593,83.19360649042922,75.29492075000003,79.40046800000002,79.77406180000001,83.88593699999998,85,1479100,1767735,62.67334337886882,NaN,1.5,2.75,NaN,NaN,1.3189946486695223,0.8367204360382071,NaN,-0.0946674441136457,1.4556523107970207,1.5503197549106664,10.977525974366273,1.5724447772369898,NaN,NaN,NaN,63162998
865344600,84.40625,85.4375,84.34375,84.5,NaN,NaN,73.94140625,80.95533142857143,75.38320200000003,79.49234300000002,79.89531180000002,83.94218699999998,81.35242127671549,83.55486884693558,84.45192230769219,85.60914284953525,83.29470176584913,75.38320200000003,79.49234300000002,79.89531180000002,83.94218699999998,84.76041666666667,1562100,1664030,60.53550069749127,NaN,1.5,2.75,NaN,NaN,1.3029057451931279,0.9387450947398784,NaN,-0.14986361080043986,1.3629902414101167,1.5128538522105566,11.330422743490155,0.03699593044765076,NaN,NaN,NaN,61600898
865431000,84.53125,84.75,84.07812,84.40625,NaN,NaN,73.959375,80.94082214285713,75.47085825000003,79.57515550000002,79.99281180000001,83.99687449999998,81.4721792658639,83.63595276627504,84.45432615384604,85.61102727089765,83.29762503679443,75.47085825000003,79.57515550000002,79.99281180000001,83.99687449999998,84.41145666666667,1063100,1631130,59.80321451850651,NaN,1.5,2.75,NaN,NaN,1.257832477679333,0.6517567575852323,NaN,-0.19637870641138488,1.2673804691963255,1.4637591756077104,9.085315229785701,0.14831294030404152,NaN,NaN,NaN,60537798
865517400,84.59375,85.3125,84.42187,84.71875,NaN,NaN,73.97734375,80.92631285714285,75.56031140000003,79.66218680000001,80.11218680000002,84.15781199999998,81.59949576524178,83.73907631234408,84.56971076923065,85.48430297032156,83.65511856813974,75.56031140000003,79.66218680000001,80.11218680000002,84.15781199999998,84.81770666666667,1180800,1573810,61.47609321477421,NaN,1.5,2.75,NaN,NaN,1.2327194435593807,0.7502811648165916,NaN,-0.20864076395663833,1.2029582206619125,1.4115989846185508,9.206884590961435,0.8556547619047619,NaN,NaN,NaN,61718598
865603800,84.59375,86.4375,84.59375,86.375,NaN,NaN,73.9953125,80.91180357142856,75.65921765000003,79.75624930000002,80.25781180000001,84.37343699999998,81.78677044111465,83.9901166635494,84.79326846153835,85.91861236857045,83.66792455450624,75.65921765000003,79.75624930000002,80.25781180000001,84.37343699999998,85.80208333333333,1511100,1503180,68.87053420246296,NaN,1.5,2.75,NaN,NaN,1.2763644833051393,1.00526883008023,NaN,-0.1125603632555916,1.2708985305490614,1.383458893804653,13.788295618624515,1.8798378179137487,NaN,NaN,NaN,63229698
865863000,86.4375,86.875,86.34375,86.8125,NaN,NaN,74.01328125,80.89729428571428,75.75718640000002,79.85656180000002,80.45406180000002,84.58281199999998,81.98385787479643,84.2589150765447,84.9735569230768,86.50930821973566,83.43780562641794,75.75718640000002,79.85656180000002,80.45406180000002,84.58281199999998,86.67708333333333,1823400,1466440,70.4822734395905,NaN,1.5,2.75,NaN,NaN,1.223142020211915,1.2434194375494394,NaN,-0.031130931979358234,1.3445452288304551,1.3756761608098134,13.268990951528536,1.9823788546255507,NaN,NaN,NaN,65053098
865949400,86.84375,87.40625,86.5,87.07812,NaN,NaN,74.03125,80.88278499999998,75.85828015000003,79.95640550000002,80.68187420000002,84.73671799999997,82.18363286009853,84.52741078354043,85.18870076923064,87.02955313425544,83.34784840420583,75.85828015000003,79.95640550000002,80.68187420000002,84.73671799999997,86.99479000000001,1217500,1409420,71.44880232996084,NaN,1.5,2.75,NaN,NaN,1.200506875911064,0.8638305118417505,NaN,0.025948863788724852,1.4081122405457194,1.3821633767569945,13.235335270233085,2.313200062460808,NaN,NaN,NaN,66270598
866035800,87,87.40625,86.82812,87.28125,NaN,NaN,74.04921875,80.8682757142857,75.96203015000003,80.05359300000002,80.91031180000002,84.91796799999997,82.38353941460447,84.78968118510801,85.44110461538449,87.45268258696007,83.42952664380891,75.96203015000003,80.05359300000002,80.91031180000002,84.91796799999997,87.17187333333334,1673800,1433355,72.1985201401957,NaN,1.5,2.75,NaN,NaN,1.1560513847745593,1.1677497898287583,NaN,0.06072745401563484,1.458072694276538,1.3973452402609032,13.143445447763375,3.157900832969211,NaN,NaN,NaN,67944398
866122200,87.875,89,87.5625,88.96875,NaN,NaN,74.0671875,80.85376642857142,76.07296765000002,80.16671800000002,81.19968680000002,85.17578049999997,82.64178296697293,85.18768773890724,85.76321999999988,88.46996172358946,83.05647827641029,76.07296765000002,80.16671800000002,81.19968680000002,85.17578049999997,88.51041666666667,4273301,1508420.05,77.48729987492905,NaN,1.5,2.75,NaN,NaN,1.196244143004948,2.832964862804628,NaN,0.17429554497631505,1.6152146714812972,1.440919126504982,14.999099585139884,4.477064220183486,NaN,NaN,NaN,72217699
866208600,89.0625,90,88.90625,89.71875,NaN,NaN,74.08515625,80.83925714285714,76.18820205000003,80.28109300000001,81.49593680000002,85.44296799999998,82.91931108591517,85.61921747805893,86.11658538461526,89.51008983786113,82.7230809313694,76.18820205000003,80.28109300000001,81.49593680000002,85.44296799999998,89.54166666666667,2132900,1570860.05,79.36606222325562,NaN,1.5,2.75,NaN,NaN,1.188923132790309,1.3577912303518063,NaN,0.2710676269676906,1.7797536602145954,1.5086860332469048,15.107809693184418,5.823811279026907,NaN,NaN,NaN,74350599
866467800,89.75,90,89.46875,89.75,NaN,NaN,74.103125,80.82474785714285,76.30687395000002,80.39015550000002,81.77406180000001,85.76953049999997,83.18718123940869,86.01262533729141,86.4735569230768,90.31492012849685,82.63219371765675,76.30687395000002,80.39015550000002,81.77406180000001,85.76953049999997,89.73958333333333,800400,1514170.05,79.4430419831488,NaN,1.5,2.75,NaN,NaN,1.141946480448144,0.5286064137908421,NaN,0.30575257966144,1.8908767578237047,1.5851241781622647,14.220097945709531,6.21301775147929,NaN,NaN,NaN,75150999
866554200,89.4375,90.23437,88.9375,89.625,NaN,NaN,74.12109375,80.81023857142856,76.42835835000002,80.50890550000003,82.04374940000001,86.07734299999997,83.4396447202162,86.35666101945414,86.8593746153845,90.87773683199752,82.84101239877147,76.42835835000002,80.50890550000003,82.04374940000001,86.07734299999997,89.59895666666667,2048100,1547785.05,78.18651742932474,NaN,1.5,2.75,NaN,NaN,1.1530124461304194,1.323245756896282,NaN,0.2890358980566896,1.9464190507331267,1.657383152676437,13.81063194493867,6.182895223991115,NaN,NaN,NaN,73102899
866640600,89.125,89.625,88.96875,89.3125,NaN,NaN,74.1390625,80.79572928571427,76.54617085000002,80.63453050000003,82.29624940000002,86.31953049999997,83.6699527704038,86.63816949379184,87.17908615384604,91.26534466643605,83.09282764125604,76.54617085000002,80.63453050000003,82.29624940000002,86.31953049999997,89.30208333333333,1971900,1558560.05,74.99306176478059,NaN,1.5,2.75,NaN,NaN,1.117529414263961,1.265206303728881,NaN,0.2283534007180783,1.942824903574035,1.7144715028559567,14.309845493276217,5.422353375138325,NaN,NaN,NaN,71130999
866727000,89.60937,90.5,89.375,90.23437,NaN,NaN,74.15703125,80.78121999999999,76.66828020000003,80.77156170000002,82.57968680000002,86.61718649999997,83.92738089705463,86.98066478009737,87.5985569230768,91.73338534559319,83.4637285005604,76.66828020000003,80.77156170000002,82.57968680000002,86.61718649999997,90.03645666666667,2029900,1599655.05,77.86522124567978,NaN,1.5,2.75,NaN,NaN,1.1225273132451066,1.268961080077858,NaN,0.22154920471566641,1.9914080087505397,1.7698588040348733,14.477130480847942,4.46815629522431,NaN,NaN,NaN,73160899
866813400,89.9375,90.34375,89.5,89.57812,NaN,NaN,74.175,80.76671071428571,76.79109270000002,80.89984290000002,82.85562420000002,86.89609249999997,84.14897850893485,87.22804146770714,87.98918153846141,91.82819567753286,84.15016739938996,76.79109270000002,80.89984290000002,82.85562420000002,86.89609249999997,89.80729000000001,1396900,1624120.05,71.56397032068149,NaN,1.5,2.75,NaN,NaN,1.1026146480133132,0.8600965181114536,NaN,0.14765468431621276,1.9544271594301392,1.8067724751139265,13.748507875225593,3.18573938084953,NaN,NaN,NaN,71763999
867072600,89.40625,89.90625,87.34375,87.40625,NaN,NaN,74.19296875,80.75220142857142,76.89843645000002,80.99890540000003,83.13624920000002,87.02734249999996,84.27671464583936,87.24501370887789,88.21995076923064,91.48791645716379,84.95198508129748,76.89843645000002,80.99890540000003,83.13624920000002,87.02734249999996,88.21875,3991500,1791475.05,55.543774086866925,NaN,1.5,2.75,NaN,NaN,1.2068921731552196,2.228052241084798,NaN,-0.06147694132385695,1.7299262984591053,1.7914032397829622,21.125530951070644,0.376822558870129,NaN,NaN,NaN,67772499
867159000,88.25,89.875,88,89.625,NaN,NaN,74.2109375,80.73769214285713,77.01296770000003,81.11015540000002,83.44156180000002,87.25234249999997,84.48645132639469,87.47167906993714,88.59735461538449,91.23278294379486,85.96192628697412,77.01296770000003,81.11015540000002,83.44156180000002,87.25234249999997,89.16666666666667,4895102,1959680.15,64.32891856026058,NaN,1.5,2.75,NaN,NaN,1.297024875072704,2.4979086510622666,NaN,-0.06407030966506388,1.7113153527016323,1.7753856623666961,25.36929457456558,2.6852846401718584,NaN,NaN,NaN,72667601
867245400,89.48437,90.25,87.9375,89,NaN,NaN,74.22890625,80.72318285714285,77.12453020000002,81.21609290000002,83.70906180000001,87.44687399999997,84.66345323516352,87.61723344422884,88.79927769230757,91.10419105516617,86.49436432944897,77.12453020000002,81.21609290000002,83.70906180000001,87.44687399999997,89.0625,4708898,2159290.05,60.690652506829124,NaN,1.5,2.75,NaN,NaN,1.3695588125675109,2.180762144483554,NaN,-0.11840900327418469,1.6273744082739654,1.74578341154815,25.999012442086592,0.035124692658939236,NaN,NaN,NaN,67958703
867331800,88.84375,89.625,87.6875,88.5625,NaN,NaN,74.246875,80.70867357142856,77.23203020000003,81.31531170000002,83.95031180000002,87.64453049999997,84.81635702986298,87.70725883049276,88.93389307692294,90.94457488912889,86.923211264717,77.23203020000003,81.31531170000002,83.95031180000002,87.64453049999997,88.625,2569900,2223650.05,58.208889859151796,NaN,1.5,2.75,NaN,NaN,1.4101260402412603,1.1557124287609915,NaN,-0.19009645014231502,1.5081628488702563,1.6982592990125713,23.750385130582014,-1.2887495646116336,NaN,NaN,NaN,65388803
867418200,88.96875,89.71875,88.6875,88.90625,NaN,NaN,74.26484375,80.69416428571428,77.33890520000003,81.41312420000003,84.20468680000002,87.83203049999997,84.9767449894762,87.82144846568393,89.07451846153835,90.77872351687448,87.37031340620221,77.33890520000003,81.41312420000003,84.20468680000002,87.83203049999997,89.10416666666667,2617900,2247380.05,59.606541096815874,NaN,1.5,2.75,NaN,NaN,1.3919920373668846,1.1648675087242144,NaN,-0.21860896690929654,1.4249980903759507,1.6436070572852473,23.271891563130694,-0.9401114206128134,NaN,NaN,NaN,68006703
867677400,88.90625,89.46875,87.875,88.3125,NaN,NaN,74.2828125,80.679655,77.43765520000002,81.51984300000002,84.43968680000002,88.00859299999998,85.10755891145753,87.86821527847593,89.15384538461527,90.59201492642578,87.71567584280476,77.43765520000002,81.51984300000002,84.43968680000002,88.00859299999998,88.55208333333333,2384900,2292670.05,56.11558793318064,NaN,1.5,2.75,NaN,NaN,1.4064033204121071,1.0402281828560547,NaN,-0.2778964064560763,1.296236549215152,1.5741329556712282,23.48255538205096,-1.4644351464435146,NaN,NaN,NaN,65621803
867763800,88.5,89.5625,88.39062,89.34375,NaN,NaN,74.30078125,80.6651457142857,77.54031145000003,81.63171800000002,84.70531180000002,88.25078049999998,85.27368405218469,88.00874239481155,89.18269153846141,90.61989651335557,87.74548656356725,77.54031145000003,81.63171800000002,84.70531180000002,88.25078049999998,89.09895666666667,1749000,2302015.05,60.448304044385175,NaN,1.5,2.75,NaN,NaN,1.3952316546683854,0.7597691422564766,NaN,-0.24902794001631912,1.2628480306508294,1.5118759706671485,24.67939521717962,0.03498950314905528,NaN,NaN,NaN,67370803
867850200,89.5625,90.8125,89.21875,90.8125,NaN,NaN,74.31875,80.65063642857142,77.65109270000002,81.74765550000002,84.96687440000001,88.57109299999998,85.49089252072646,88.27576692863902,89.26682615384604,90.92999816179585,87.60365414589623,77.65109270000002,81.74765550000002,84.96687440000001,88.57109299999998,90.28125,1961800,2346950.05,65.65000342113757,NaN,1.5,2.75,NaN,NaN,1.4094115364777866,0.8358933757452572,NaN,-0.13793057931286534,1.339462746526067,1.4773933258389322,26.303972196893508,0.6406982173200761,NaN,NaN,NaN,69332603
867936600,91.875,92.15625,91.46875,92.0625,NaN,NaN,74.33671875,80.63612714285713,77.76898335000003,81.88359300000002,85.25187440000002,88.93828049999998,85.74860261795287,88.63640817353054,89.44471076923065,91.67464252268543,87.21477901577587,77.76898335000003,81.88359300000002,85.25187440000002,88.93828049999998,91.89583333333333,2539100,2414865.05,69.34510808805828,NaN,1.5,2.75,NaN,NaN,1.4047214267293733,1.0514459182719134,NaN,0.00523660977953555,1.4839390880633516,1.478702478283816,26.778078008330763,2.773422795655905,NaN,NaN,NaN,71871703
868282200,92.375,92.5,90.90625,91.125,NaN,NaN,74.3546875,80.62161785714285,77.88085835000003,82.00109300000003,85.52593700000001,89.17578049999997,85.95944173097432,88.87341691890859,89.56009538461527,91.96385695929504,87.15633380993549,77.88085835000003,82.00109300000003,85.52593700000001,89.17578049999997,91.51041666666667,1158600,2397240.05,63.801683643079,NaN,1.5,2.75,NaN,NaN,1.4182234676772754,0.48330579159145953,NaN,0.02138641049142942,1.505435491398103,1.4840490809066735,27.200040566999547,4.254558455488023,NaN,NaN,NaN,70713103
868368600,91.25,92.1875,91.1875,92.07812,NaN,NaN,74.37265625,80.60710857142855,77.99804585000003,82.11687420000003,85.83687440000001,89.43906149999997,86.1993898983871,89.1786267361554,89.77283538461526,92.5167524634878,87.02891830574272,77.99804585000003,82.11687420000003,85.83687440000001,89.43906149999997,91.81770666666667,3396500,2475895.05,66.71490258591216,NaN,1.5,2.75,NaN,NaN,1.39281464855747,1.3718271297484925,NaN,0.07768378127396902,1.5811538074991347,1.5034700262251657,21.707388990519284,2.737093444909343,NaN,NaN,NaN,74109603
868455000,92.3125,92.375,90.03125,91.0625,NaN,NaN,74.390625,80.59259928571427,78.11023335000003,82.21374920000002,86.11249940000002,89.63828049999998,86.39010009845035,89.35804323747392,89.83653769230757,92.65772019767924,87.0153551869359,78.11023335000003,82.21374920000002,86.11249940000002,89.63828049999998,91.15625,5390301,2684535.1,61.07446532575302,NaN,1.5,2.75,NaN,NaN,1.4607386022319364,2.0079085574258277,NaN,0.03037622546997376,1.5414403080626329,1.5110640825926591,19.402981546462147,2.317415730337079,NaN,NaN,NaN,68719302
868541400,91.125,91.84375,90.48437,91.46875,NaN,NaN,74.40859375,80.57808999999999,78.22453025000003,82.31656170000002,86.34749940000002,89.84765549999997,86.58926283968759,89.55906292914307,89.98197076923066,92.92707659433545,87.03686494412587,78.22453025000003,82.31656170000002,86.34749940000002,89.84765549999997,91.26562333333334,2072200,2704455.1,62.44230640960541,NaN,1.5,2.75,NaN,NaN,1.4534987020725123,0.7662171947317594,NaN,0.011282237179882859,1.5251668790675126,1.5138846418876297,18.64805196530528,3.2815808045165844,NaN,NaN,NaN,70791502
868627800,91.59375,92.1875,91.375,91.78125,NaN,NaN,74.4265625,80.5635807142857,78.34015525000002,82.41562420000002,86.58124940000002,89.98828049999997,86.79287017930768,89.7706997930342,90.31850923076912,92.99720406470816,87.63981439683009,78.34015525000002,82.41562420000002,86.58124940000002,89.98828049999997,91.78125,2260400,2603810.05,63.50468546298783,NaN,1.5,2.75,NaN,NaN,1.4077130804959044,0.8681124800175036,NaN,0.004864284353753856,1.5199649973298222,1.5151007129760683,17.998315139843854,3.233743409490334,NaN,NaN,NaN,73051902
868887000,91.89062,92.3125,91.21875,92.0625,NaN,NaN,74.44453125,80.54907142857142,78.45734275000002,82.52296800000002,86.82249940000001,90.10546799999997,86.99952232913876,89.98896647941189,90.50600923076912,93.302907900227,87.70911056131125,78.45734275000002,82.52296800000002,86.82249940000001,90.10546799999997,91.86458333333333,3186400,2656485.05,64.47854980728897,NaN,1.5,2.75,NaN,NaN,1.3852871461747682,1.199479741096228,NaN,0.004722475990851294,1.5210038079646324,1.5162813319737811,17.99934621129795,4.246284501061571,NaN,NaN,NaN,76238302
868973400,92.3125,92.76562,91.46875,92.53125,NaN,NaN,74.4625,80.53456214285713,78.57656150000003,82.64484300000002,87.04437440000001,90.24453049999997,87.21645282603528,90.23108871946789,90.77764384615374,93.6222291844931,87.93305850781438,78.57656150000003,82.64484300000002,87.04437440000001,90.24453049999997,92.25520666666667,2983100,2765620.05,66.10210664298639,NaN,1.5,2.75,NaN,NaN,1.3789716357337132,1.0786369588259241,NaN,0.02047691570484611,1.5418774766048386,1.5214005608999925,16.79106306599473,3.5676810073452256,NaN,NaN,NaN,79221402
869059800,93.125,94.09375,92.89062,93.75,NaN,NaN,74.48046875,80.52005285714284,78.70218650000002,82.77859300000001,87.25187440000002,90.45078049999998,87.47267036226918,90.56622312713762,91.17668230769219,94.12004200525361,88.23332261013077,78.70218650000002,82.77859300000001,87.25187440000002,90.45078049999998,93.57812333333334,2621300,2794280.05,69.94808622334912,NaN,1.5,2.75,NaN,NaN,1.3920808046098767,0.9380949486433904,NaN,0.0931855188194608,1.6378824594243184,1.5446969406048576,17.033326660957872,3.2346868547832073,NaN,NaN,NaN,81842702
869146200,93.625,93.8125,92.78125,93.28125,NaN,NaN,74.4984375,80.50554357142856,78.82359275000003,82.89812430000002,87.45124940000001,90.64921799999998,87.70045779904294,90.82479711502927,91.51322076923066,94.33935850028938,88.68708303817193,78.82359275000003,82.89812430000002,87.45124940000001,90.64921799999998,93.29166666666667,1794800,2785425.05,66.80846612061367,NaN,1.5,2.75,NaN,NaN,1.3663071757091712,0.6443540816149407,NaN,0.08987568670835944,1.657041548990307,1.5671658622819475,16.142811398479548,1.3238289205702647,NaN,NaN,NaN,80047902
869232600,93.01562,93.21875,91.0625,91.29687,NaN,NaN,74.51640625,80.49103428571428,78.93273335000002,82.99718680000002,87.64718680000001,90.70234299999997,87.84149357162948,90.86975643740743,91.74278769230757,93.89649709474803,89.58907828986712,78.93273335000002,82.99718680000002,87.64718680000001,90.70234299999997,91.85937333333334,3961900,2882025.05,55.45973517772793,NaN,1.5,2.75,NaN,NaN,1.4271959488728019,1.3746931172579504,NaN,-0.05783633169387015,1.49487044766461,1.5527067793584801,19.617635613113606,0.18860905349794063,NaN,NaN,NaN,76086002
869491800,91.28125,91.59375,90.6875,91.3125,NaN,NaN,74.534375,80.47652499999998,79.04226460000002,83.10437430000002,87.83218680000002,90.78906199999997,87.97761147078127,90.91192249098768,91.89422999999988,93.5773244234019,90.21113557659785,79.04226460000002,83.10437430000002,87.83218680000002,90.78906199999997,91.19791666666667,3810300,3002695.05,55.5238210188048,NaN,1.5,2.75,NaN,NaN,1.3899855239533159,1.2689600297572676,NaN,-0.16054574832995128,1.352024593946041,1.5125703422759922,18.68192394475633,-0.8314896090406694,NaN,NaN,NaN,79896302
869578200,91.6875,93.79687,91.625,93.73437,NaN,NaN,74.55234375,80.4620157142857,79.15921770000003,83.24781180000002,88.05437420000003,91.10546799999997,88.20336670722122,91.18072701565552,92.1189892307691,93.93903829155492,90.29894016998328,79.15921770000003,83.24781180000002,88.05437420000003,91.10546799999997,93.05208,4243398,3015289.95,64.13490479635597,NaN,1.5,2.75,NaN,NaN,1.4681558436709359,1.4072935174940637,NaN,-0.07573767706485302,1.4178982459449259,1.4936359230097789,23.4129433391169,2.9341056966369234,NaN,NaN,NaN,84139700
869664600,93.9375,94.48437,93.53125,93.65625,NaN,NaN,74.5703125,80.44750642857142,79.27538960000003,83.39281180000002,88.24749920000002,91.30703049999997,88.41720526772235,91.41649110940261,92.24158538461526,94.23622993873394,90.24694083049658,79.27538960000003,83.39281180000002,88.24749920000002,91.30703049999997,93.89062333333334,3204300,2930749.85,63.70644526505156,NaN,1.5,2.75,NaN,NaN,1.4313675691230117,1.0933379387531146,NaN,-0.03721395631647706,1.4471184776141826,1.4843324339306596,22.05287122049206,2.3915271609156132,NaN,NaN,NaN,80935400
869751000,93.9375,94.26562,92.6875,94.09375,NaN,NaN,74.58828125,80.43299714285713,79.39515525000003,83.53687430000002,88.45624920000002,91.56171799999997,88.63981486506657,91.67146814660236,92.46995076923064,94.57753878341087,90.3623627550504,79.39515525000003,83.53687430000002,88.45624920000002,91.56171799999997,93.68229000000001,4152699,2902939.9,65.11213742635823,NaN,1.5,2.75,NaN,NaN,1.441849885614225,1.4305149755253288,NaN,0.003270635057561533,1.4884207277526116,1.48515009269505,22.058883347344917,2.519577800476677,NaN,NaN,NaN,85088099
869837400,94.5625,94.8125,93.625,94.03125,NaN,NaN,74.60625,80.41848785714285,79.51734275000003,83.68468680000002,88.66062420000002,91.83515549999997,88.85124369388748,91.89620927549738,92.62019153846141,94.86840092540923,90.37198215151359,79.51734275000003,83.68468680000002,88.66062420000002,91.83515549999997,94.15625,2364800,2892684.9,64.72645559082548,NaN,1.5,2.75,NaN,NaN,1.4236820366417804,0.8175104035700536,NaN,0.010945706626239948,1.49883222597785,1.48788651935161,22.143182117106583,2.1384928716904277,NaN,NaN,NaN,82723299
870096600,94.25,94.5625,93.5,93.96875,NaN,NaN,74.62421875,80.40397857142855,79.63992090000002,83.81843680000001,88.85249920000003,92.08828049999997,89.05193021569582,92.09359410640239,92.8437492307691,95.00419364064123,90.68330482089698,79.63992090000002,83.81843680000001,88.85249920000003,92.08828049999997,94.01041666666667,2794700,2901524.9,64.31618330511527,NaN,1.5,2.75,NaN,NaN,1.397883319738796,0.9631831868821805,NaN,-0.002370880606637815,1.4849229185933126,1.4872937991999504,22.206836310934776,1.553529213103681,NaN,NaN,NaN,79928599
870183000,93.625,94.46875,93.42187,94.28125,NaN,NaN,74.6421875,80.38946928571427,79.75976465000002,83.95999930000002,89.07374920000002,92.38671799999997,89.25700157978618,92.30194228674502,93.06009538461527,95.1895049940683,90.93068577516223,79.75976465000002,83.95999930000002,89.07374920000002,92.38671799999997,94.05729000000001,2737100,2919134.9,65.49390023065311,NaN,1.5,2.75,NaN,NaN,1.372811654043168,0.9376408058428544,NaN,-0.004209527744834407,1.4820318895189075,1.486241417263742,22.14205342483851,0.5666666666666667,NaN,NaN,NaN,82665699
870269400,94.5,95.625,94.40625,95.40625,NaN,NaN,74.66015625,80.37495999999999,79.88476465000002,84.10562430000002,89.31249920000002,92.68984299999997,89.49814857665731,92.59759064038835,93.33894153846141,95.66570428327006,91.01217879365277,79.88476465000002,84.10562430000002,89.31249920000002,92.68984299999997,95.14583333333333,4839801,3073674.95,69.40826192765883,NaN,1.5,2.75,NaN,NaN,1.370735821611513,1.5745975351102106,NaN,0.05310380674193271,1.5526211756911579,1.4995173689492252,21.925980989395384,2.2780569514237854,NaN,NaN,NaN,87505500
870355800,95.40625,96.03125,95.03125,95.3125,NaN,NaN,74.678125,80.3604507142857,80.00976465000002,84.24187430000002,89.52937420000002,92.91484299999998,89.72616235796487,92.85615343654183,93.58894153846141,96.00987974372634,91.16800333319648,80.00976465000002,84.24187430000002,89.52937420000002,92.91484299999998,95.45833333333333,2138700,3082519.95,68.70877321465522,NaN,1.5,2.75,NaN,NaN,1.3442546914964049,0.6938154609510313,NaN,0.06658918555218829,1.5827538508894605,1.5161646653372722,21.591357810381265,4.398431183894915,NaN,NaN,NaN,85366800
870442200,95.5,95.71875,93.8125,94.9375,NaN,NaN,74.69609375,80.34594142857142,80.13117090000003,84.37874930000002,89.74249920000003,93.05859299999997,89.93052854000545,93.05437691877594,93.77403769230757,96.2110959279695,91.33697945664565,80.13117090000003,84.37874930000002,89.74249920000003,93.05859299999997,94.82291666666667,7077699,3309449.9,65.85006124715596,NaN,1.5,2.75,NaN,NaN,1.3843972135323759,2.138633070106304,NaN,0.033796636820044856,1.5584104613623282,1.5246138245422833,16.2550480291917,3.969883641341547,NaN,NaN,NaN,78289101
870701400,94.78125,95.54687,94.40625,95.1875,NaN,NaN,74.7140625,80.33143214285712,80.25288965000003,84.52531180000001,89.96624920000002,93.26171799999997,90.13668428353465,93.25753149794014,93.88461461538449,96.43508457513815,91.33414465563084,80.25288965000003,84.52531180000001,89.96624920000002,93.26171799999997,95.04687333333334,2339500,3368494.9,66.84057081645348,NaN,1.5,2.75,NaN,NaN,1.3669845554229203,0.694523836150086,NaN,0.013526029762785496,1.5415213617457653,1.5279953319829798,16.10904873248304,1.5502637933129562,NaN,NaN,NaN,80628601
870787800,95.09375,95.6875,94.90625,95.25,NaN,NaN,74.73203125,80.31692285714284,80.37304590000002,84.68499930000002,90.17562420000002,93.42031199999998,90.33720646849407,93.44729040289822,94.0360569230768,96.65803454704128,91.41407929911232,80.37304590000002,84.68499930000002,90.17562420000002,93.42031199999998,95.28125,1467000,3272019.9,67.09750522421704,NaN,1.5,2.75,NaN,NaN,1.3251463728927118,0.44834690644760444,NaN,-0.009830088649108282,1.5157077211715944,1.5255378098207026,7.949792739386198,1.7017017017017018,NaN,NaN,NaN,82095601
870874200,95.4375,96.53125,95.0625,96.03125,NaN,NaN,74.75,80.30241357142856,80.49757715000003,84.84843680000002,90.39374920000002,93.66874949999998,90.560502293259,93.69338179309838,94.40023999999988,96.6938069892299,92.10667301076987,80.49757715000003,84.84843680000002,90.39374920000002,93.66874949999998,95.875,2478200,3126414.85,70.20527798407386,NaN,1.5,2.75,NaN,NaN,1.3354037748289467,0.7926651192819149,NaN,0.01199557114888572,1.54053227375681,1.5285367026079242,8.59077966715693,2.0591165725672536,NaN,NaN,NaN,84573801
870960600,96.5,96.625,95.125,95.3125,NaN,NaN,74.76796875,96.625,80.62101465000002,85.00249930000001,90.59781180000002,93.86093699999998,90.74685514450375,93.84758352708901,94.70793230769219,96.19259976644395,93.22326484894043,80.62101465000002,85.00249930000001,90.59781180000002,93.86093699999998,95.6875,3641900,3204899.85,64.19753569091958,NaN,1.5,2.75,NaN,NaN,1.3471606480554503,1.1363537615691797,NaN,-0.03475767899904092,1.485089603859123,1.519847282858164,10.164621189435879,1.3625789298770357,NaN,NaN,NaN,80931901
871047000,94.3125,94.75,92.40625,93.375,NaN,NaN,74.7859375,96.76757817307693,80.73359280000003,85.14578060000002,90.77312440000001,93.94062449999998,90.84991964864086,93.80257557212816,94.68028846153835,96.2475224145145,93.1130545085622,80.73359280000003,85.14578060000002,90.77312440000001,93.94062449999998,93.51041666666667,7167602,3450259.95,51.42294453335223,NaN,1.5,2.75,NaN,NaN,1.4585241731943468,2.07740926882915,NaN,-0.19974253667456732,1.2701691120149547,1.469911648689522,16.16674065861759,-0.6318589956767542,NaN,NaN,NaN,73764299
871306200,93.75,94.28125,92.625,94.0625,NaN,NaN,74.80390625,96.91015634615384,80.85265530000002,85.29859310000002,90.95124940000001,94.04062449999998,90.97590319183142,93.82733027954453,94.71153846153835,96.21056736318712,93.21250955988958,80.85265530000002,85.29859310000002,90.95124940000001,94.04062449999998,93.65625,6355898,3608734.85,54.85573219529745,NaN,1.5,2.75,NaN,NaN,1.4726474465376076,1.7612538089352838,NaN,-0.2622072753914073,1.1421525544502629,1.4043598298416702,16.810660635001923,-0.23201856148491878,NaN,NaN,NaN,80120197
871392600,94.21875,94.54687,92.46875,92.5625,NaN,NaN,74.821875,97.05273451923077,80.96390530000002,85.44046810000002,91.10687440000001,94.04218699999998,91.03812267450469,93.70687025292123,94.5937499999999,96.46329334203259,92.72420665796722,80.96390530000002,85.44046810000002,91.10687440000001,94.04218699999998,93.19270666666667,6160801,3767619.9,47.04437191579836,NaN,1.5,2.75,NaN,NaN,1.5158954860706355,1.6351970643323124,NaN,-0.3961434010495082,0.9091805785297851,1.3053239795792932,18.988905257838933,-2.9806747461513265,NaN,NaN,NaN,73959396
871479000,93.6875,93.84375,91.46875,92.28125,NaN,NaN,74.83984375,97.1953126923077,81.07609280000003,85.57890560000001,91.26249940000001,93.96874949999997,91.08687276570059,93.57109689550016,94.45913461538451,96.68866013076313,92.2296091000059,81.07609280000003,85.57890560000001,91.26249940000001,93.96874949999997,92.53125,6982301,3985669.95,45.72948937086257,NaN,1.5,2.75,NaN,NaN,1.5772600942084474,1.7518512791055365,NaN,-0.48917458566524585,0.6938557474977358,1.1830303331629817,16.86640791010914,-3.180327868852459,NaN,NaN,NaN,66977095
871565400,93.09375,93.3125,91.71875,92.625,NaN,NaN,74.8578125,97.33789086538462,81.18718655000002,85.70984310000001,91.42687440000002,93.93593699999998,91.14719148077116,93.48099242926205,94.35576923076913,96.78252544227975,91.9290130192585,81.18718655000002,85.70984310000001,91.42687440000002,93.93593699999998,92.55208333333333,3462700,4069064.95,47.65518572331392,NaN,1.5,2.75,NaN,NaN,1.5784379446221297,0.8509817470473161,NaN,-0.5106895295551166,0.544668421219086,1.0553579507742026,17.314484639054044,-2.435813034891376,NaN,NaN,NaN,70439795
871651800,92.125,92.125,89.625,89.78125,NaN,NaN,74.87578125,97.48046903846154,81.28523345000002,85.82015560000002,91.52812440000001,93.86015599999999,91.09362514819189,93.12863600742756,94.00961538461527,97.45156046651122,90.56767030271932,81.28523345000002,85.82015560000002,91.52812440000001,93.86015599999999,90.51041666666667,4907102,4116325.05,36.20873900702575,NaN,1.5,2.75,NaN,NaN,1.6799780914348348,1.1921075086137816,NaN,-0.6885064690264423,0.19472486449114967,0.883231333517592,23.771280062529655,-5.679579776756402,NaN,NaN,NaN,65532693
871911000,90.375,91.78125,89.34375,91.78125,NaN,NaN,89.34375,97.62304721153846,81.38992095000002,85.94703060000002,91.63624940000001,93.88359349999999,91.12059082865495,93.0003135305297,93.73076923076913,97.26116084373199,90.20037761780627,81.38992095000002,85.94703060000002,91.63624940000001,93.88359349999999,90.96875,5638898,4207754.95,46.02749303608867,NaN,1.5,2.75,NaN,NaN,1.7340867991894895,1.3401203413711151,NaN,-0.6442829588294724,0.07787763498075151,0.7221605938102239,28.37382907686483,-3.641732283464567,NaN,NaN,NaN,71171591
871997400,92.21875,92.90625,91.53125,92.84375,NaN,NaN,89.52592329545455,97.76562538461539,81.50117095000002,86.10546810000001,91.75687440000002,93.83906249999998,91.18816569811946,92.9854027180983,93.54086538461527,96.97476950168901,90.10696126754154,81.50117095000002,86.10546810000001,91.75687440000002,93.83906249999998,92.42708333333333,3802800,4185725.05,50.395653210012114,NaN,1.5,2.75,NaN,NaN,1.7084377421045258,0.9085164349244583,NaN,-0.5215676745400011,0.0702010006352225,0.5917686751752236,29.6284364740279,-3.3192320208265538,NaN,NaN,NaN,74974391
872083800,92.9375,94.3125,92.60937,94.25,NaN,NaN,89.7080965909091,97.9082035576923,81.61710845000002,86.29109310000001,91.90031200000001,93.86874999999999,91.30823763152654,93.10584055446989,93.48798076923066,96.85473873077721,90.1212228076841,81.61710845000002,86.29109310000001,91.90031200000001,93.86874999999999,93.72395666666667,3558200,4203420.05,55.52603932692938,NaN,1.5,2.75,NaN,NaN,1.7080586176684884,0.8465011723013502,NaN,-0.33296212469766095,0.1755660193031474,0.5085281440008084,30.774594642057153,-1.1147540983606556,NaN,NaN,NaN,78532591
872170200,94.125,94.25,92.09375,92.59375,NaN,NaN,89.89026988636364,98.05078173076923,81.72273345000002,86.45843690000001,92.00656200000002,93.79374999999999,91.3586498812706,93.05707002547275,93.28846153846143,96.53394229488,90.04298078204286,81.72273345000002,86.45843690000001,92.00656200000002,93.79374999999999,92.97916666666667,5392602,4265415.2,49.08668845300221,NaN,1.5,2.75,NaN,NaN,1.740072287835025,1.2642619175736982,NaN,-0.30762755490008165,0.12399370037570634,0.431621255275788,31.99108914854252,-0.8366800535475234,NaN,NaN,NaN,73139989
872256600,91,92.73437,90.5625,92.5625,NaN,NaN,90.07244318181819,98.19335990384616,81.82132720000001,86.63906190000002,92.07843700000001,93.72031249999999,91.40585968984821,93.00996811828487,93.08173076923066,96.13794866484864,90.02551287361268,81.82132720000001,86.63906190000002,92.07843700000001,93.72031249999999,91.95312333333334,7172898,4505820.1,48.97129112266521,NaN,1.5,2.75,NaN,NaN,1.7709149815610945,1.5919184168049676,NaN,-0.2815513031942616,0.07968212628296101,0.3612334294772226,29.95498938788844,-1.5946843853820598,NaN,NaN,NaN,65967091
872515800,92.78125,93.40625,91.84375,92.21875,NaN,NaN,90.25461647727273,98.33593807692307,81.91734285000001,86.81218690000001,92.12843700000002,93.63281249999999,91.43773774122671,92.93461401178155,92.78846153846143,95.347518071696,90.22940500522687,81.91734285000001,86.81218690000001,92.12843700000002,93.63281249999999,92.48958333333333,3888000,4560485.1,47.64444170442215,NaN,1.5,2.75,NaN,NaN,1.7560281971638734,0.8525408843019793,NaN,-0.2756784474115637,0.016635370212767953,0.2923138176243317,29.516031885689337,-0.3713706954760297,NaN,NaN,NaN,62079091
872602200,92,92.5625,90.70312,90.85937,NaN,NaN,90.43678977272727,98.47851625,82.00453035000002,86.96234310000001,92.15062440000001,93.46171849999999,91.41505665333547,92.7369717249452,92.44591307692296,94.74030186993409,90.15152428391184,82.00453035000002,86.96234310000001,92.15062440000001,93.46171849999999,91.37499666666668,4290000,4638130.1,42.71555342727122,NaN,1.5,2.75,NaN,NaN,1.7634104687950252,0.9249417130407792,NaN,-0.346963360550682,-0.14139038306402085,0.20557297748666115,29.310163572872952,-1.5408113782593988,NaN,NaN,NaN,57789091
872688600,91,91.96875,90.40625,91.40625,NaN,NaN,90.61896306818181,98.62109442307693,82.09484285000002,87.11499940000002,92.18624940000001,93.26171849999999,91.41471129438114,92.61023632256948,92.29447076923066,94.58345842208392,90.00548311637739,82.09484285000002,87.11499940000002,92.18624940000001,93.26171849999999,91.26041666666667,5484301,4670355.1,45.17290781831486,NaN,1.5,2.75,NaN,NaN,1.749059721023952,1.17427923200101,NaN,-0.34042853600490774,-0.21996269251947353,0.12046584348543421,29.633176094110706,-1.3157894736842106,NaN,NaN,NaN,63273392
872775000,91.1875,91.9375,90,90.01562,NaN,NaN,90.80113636363636,98.76367259615385,82.17929595000001,87.24828060000002,92.20031180000002,92.99687449999998,91.3598449691113,92.36313000613428,91.98317230769219,94.32580104107508,89.64054357430929,82.17929595000001,87.24828060000002,92.20031180000002,92.99687449999998,90.65104000000001,4287898,4777815,40.424187345330935,NaN,1.5,2.75,NaN,NaN,1.7625197409508127,0.8974600314160344,NaN,-0.4083318301262583,-0.3899489441723887,0.018382885953869624,30.534775355886218,0.26104559693699786,NaN,NaN,NaN,58985494
872861400,90.125,91.10937,89.71875,90.375,NaN,NaN,90.9833096590909,98.90625076923077,82.26390535000002,87.39140560000001,92.20312440000002,92.76874949999998,91.3212235977736,92.17378429126435,91.81490307692296,94.27806015969841,89.3517459941475,82.26390535000002,87.39140560000001,92.20312440000002,92.76874949999998,90.40104000000001,2652300,4556545.05,42.11763516280299,NaN,1.5,2.75,NaN,NaN,1.7359554737400402,0.5820857625450231,NaN,-0.4067196713439901,-0.490016703226118,-0.0832970318821279,24.727913644219473,-1.5321756894790604,NaN,NaN,NaN,61637794
873207000,90.6875,93.35937,90.59375,93.3125,NaN,NaN,91.16548295454545,99.0488289423077,82.36078035000003,87.56671810000002,92.27781200000001,92.67499949999998,91.39931286844914,92.28223340638203,91.89422999999988,94.47592445542303,89.31253554457673,82.36078035000003,87.56671810000002,92.27781200000001,92.67499949999998,92.42187333333334,7294000,4804270.05,53.702010704659784,NaN,1.5,2.75,NaN,NaN,1.8251279399014657,1.5182327229919144,NaN,-0.19616449360366708,-0.32850264888671177,-0.13233815528304468,28.272476338075503,0.5048805116122518,NaN,NaN,NaN,68931794
873293400,93.29687,94,92.75,92.8125,NaN,NaN,91.34765625,99.19140711538462,82.45468660000002,87.76109310000001,92.38593700000001,92.55312449999998,91.45473197164722,92.3327349867266,91.90865307692296,94.50854751394479,89.30875863990113,82.45468660000002,87.76109310000001,92.38593700000001,92.55312449999998,93.1875,2812500,4871545.05,51.80160472698231,NaN,1.5,2.75,NaN,NaN,1.7840473727656467,0.5773322367202578,NaN,-0.08461165063476364,-0.23810271857649923,-0.1534910679417356,27.77594132528695,-1.5251989389920424,NaN,NaN,NaN,66119294
873379800,93.0625,93.71875,92.75,93.40625,NaN,NaN,91.52982954545455,99.33398528846153,82.55148350000003,87.95156190000002,92.46156200000001,92.42187449999997,91.53126209040616,92.43497451180026,92.1874992307691,94.58457125282325,89.79042720871496,82.55148350000003,87.95156190000002,92.46156200000001,92.42187449999997,93.29166666666667,2473700,4871320.05,53.88842064145307,NaN,1.5,2.75,NaN,NaN,1.725811846139529,0.5078089664833252,NaN,0.029034079400133084,-0.11719846869156925,-0.14623254809170233,26.47476357718177,0.8774890313871077,NaN,NaN,NaN,68592994
873466200,93.96875,94.4375,92.59375,93.14062,NaN,NaN,91.7120028409091,99.47656346153846,82.64429600000003,88.12671810000002,92.54437440000001,92.31328049999998,91.5943741652922,92.50217884400976,92.29206615384602,94.72742157137657,89.85671073631548,82.64429600000003,88.12671810000002,92.54437440000001,92.31328049999998,93.39062333333334,3663300,4872390.05,52.78728934735675,NaN,1.5,2.75,NaN,NaN,1.7342359999867054,0.7518486743482288,NaN,0.08312429507137664,-0.04232717925248153,-0.12545147432385817,24.30701664462127,0.6245725860904777,NaN,NaN,NaN,64929694
873725400,93.71875,94,93.3125,93.54687,NaN,NaN,91.89417613636364,99.61914163461539,82.73851475000004,88.29718680000002,92.64406180000002,92.32187399999997,91.67094262939838,92.60167323981835,92.34615230769217,94.85813929940686,89.83416531597747,82.73851475000004,88.29718680000002,92.64406180000002,92.32187399999997,93.61979,803500,4554184.95,54.32448119995007,NaN,1.5,2.75,NaN,NaN,1.671746285701941,0.17643113066806826,NaN,0.13973912451923934,0.049222431325190996,-0.09051669319404834,24.39025157228188,1.4401843442900695,NaN,NaN,NaN,65733194
873811800,93.21875,94.28125,92.90625,93.59375,NaN,NaN,92.07634943181819,99.7617198076923,82.83351475000003,88.47124930000001,92.73781180000002,92.29843649999997,91.7463468400102,92.69615674078804,92.2956715384614,94.67548999067202,89.91585308625079,82.83351475000003,88.47124930000001,92.73781180000002,92.29843649999997,93.59375,1885200,4330650.05,54.508549007771535,NaN,1.5,2.75,NaN,NaN,1.6505501224375168,0.4353157097050592,NaN,0.1717158424839009,0.12412810991082779,-0.04758773257307311,24.2076993513599,3.0094639661269955,NaN,NaN,NaN,67618394
873898200,93.125,93.5,91.65625,91.65625,NaN,NaN,92.25852272727273,99.90429798076923,82.91593665000003,88.62218680000002,92.80468680000001,92.25312399999997,91.74281363059804,92.59711800357013,92.22355615384602,94.61963580606907,89.82747650162297,82.91593665000003,88.62218680000002,92.80468680000001,92.25312399999997,92.27083333333333,3623700,4203795,46.21863124247835,NaN,1.5,2.75,NaN,NaN,1.6710465422634084,0.8620068295433055,NaN,0.05954372622963626,0.026841925213972218,-0.03270180101566404,25.892955148199928,0.27350427350427353,NaN,NaN,NaN,63994694
873984600,91.78125,91.90625,90.25,91.1875,NaN,NaN,92.44069602272727,100.04687615384616,82.99124915000004,88.77343680000001,92.84156180000002,92.19843649999997,91.72103662547654,92.46286866989678,92.11778692307679,94.56551675074658,89.670057095407,82.99124915000004,88.77343680000001,92.84156180000002,92.19843649999997,91.11458333333333,7055898,4207474.85,44.457019497625936,NaN,1.5,2.75,NaN,NaN,1.6699896463874508,1.6769911292517887,NaN,-0.04350135746071674,-0.08707849784155997,-0.043577140380843225,25.87412633696133,1.3018629433425017,NaN,NaN,NaN,56938796
874071000,92,92.96875,90.9375,92.65625,NaN,NaN,92.62286931818181,100.18945432692308,83.07515540000004,88.92265560000001,92.87843680000002,92.19999899999996,91.75771165977159,92.48128593943042,92.15144076923063,94.61577183088853,89.68710970757273,83.07515540000004,88.92265560000001,92.87843680000002,92.19999899999996,92.1875,6708000,4369739.85,50.78650756481889,NaN,1.5,2.75,NaN,NaN,1.6957939573597758,1.53510282768893,NaN,-0.011678128359236456,-0.058174800829888795,-0.04649667247065234,25.427769759074152,2.524204702627939,NaN,NaN,NaN,63646796
874330200,92.65625,93.3125,92.1875,92.5,NaN,NaN,92.80504261363636,100.3320325,83.15898355000004,89.06953060000002,92.88718680000002,92.33593649999997,91.78682100644721,92.48306823091323,92.27764307692294,94.62986036230146,89.92542579154443,83.15898355000004,89.06953060000002,92.88718680000002,92.33593649999997,92.66666666666667,2060500,4227409.75,50.13200506552732,NaN,1.5,2.75,NaN,NaN,1.6550229604055062,0.48741430848996836,NaN,-0.0006673667750650703,-0.04733088093948368,-0.04666351416441861,25.546316216520324,-0.87073007367716,NaN,NaN,NaN,61586296
874416600,93.3125,95.28125,93.03125,94.8125,NaN,NaN,92.9872159090909,100.47461067307692,83.25296795000006,89.24343690000002,92.96093680000001,92.48749899999997,91.90547508462575,92.70491887558816,92.53966230769218,95.18574392358913,89.89358069179524,83.25296795000006,89.24343690000002,92.96093680000001,92.48749899999997,94.375,6979000,4294414.85,58.62964957577772,NaN,1.5,2.75,NaN,NaN,1.7354677489479702,1.6251340971401496,NaN,0.15427271967081166,0.14617738542409597,-0.008095334246715685,22.630830231548263,2.154882154882155,NaN,NaN,NaN,68565296
874503000,95.375,95.5,94.5,94.8125,NaN,NaN,93.16938920454545,100.61718884615385,83.34679610000006,89.42624940000002,93.01562440000002,92.58593649999997,92.01947606169925,92.9056408874369,92.90865307692296,95.37570849377408,90.44159766007184,83.34679610000006,89.42624940000002,93.01562440000002,92.58593649999997,94.9375,2220000,4215274.85,58.62964957577772,NaN,1.5,2.75,NaN,NaN,1.6829343383088293,0.5266560494863105,NaN,0.24337273689513741,0.2961205868722061,0.05274784997706868,22.23308265625117,1.5055202408832384,NaN,NaN,NaN,68565296
874589400,95,96.375,94.96875,95.21875,NaN,NaN,93.3515625,100.75976701923076,83.44913985000007,89.60562440000001,93.09874940000002,92.63437399999997,92.14493778476987,93.1259369933953,93.2812492307691,95.56113216679836,91.00136629473985,83.44913985000007,89.60562440000001,93.09874940000002,92.63437399999997,95.52083333333333,5045398,4289634.75,60.01776234037984,NaN,1.5,2.75,NaN,NaN,1.6743318855724845,1.1761835899898003,NaN,0.31190593436110536,0.4426302679284504,0.13072433356734503,22.11897163198466,2.2311747549028573,NaN,NaN,NaN,73610694
874675800,94.65625,95.35937,94.40625,95.03125,NaN,NaN,93.53373579545455,100.90234519230769,83.54953050000007,89.75874940000001,93.16999940000001,92.75624899999997,92.25812649909261,93.30739537497669,93.41346076923065,95.87718856741162,90.94973297104968,83.54953050000007,89.75874940000001,93.16999940000001,92.75624899999997,94.93229000000001,1566400,4098324.65,59.03324184142658,NaN,1.5,2.75,NaN,NaN,1.6228167508887357,0.3822049578234365,NaN,0.3253529895829147,0.5374155705459884,0.21206258096307373,22.055579673616727,1.586776767624616,NaN,NaN,NaN,72044294
874935000,95.5,96.20312,95.21875,95.5625,NaN,NaN,93.7159090909091,101.04492336538462,83.65359300000007,89.91343690000002,93.24562440000001,92.90624899999997,92.387709773638,93.52216724402653,93.6249992307691,96.30844349608846,90.94155496544975,83.65359300000007,89.91343690000002,93.24562440000001,92.90624899999997,95.66145666666665,3259000,3902629.75,60.98599715974727,NaN,1.5,2.75,NaN,NaN,1.5906062686823972,0.8350779368706447,NaN,0.34869560178060854,0.6479320831888344,0.2992364814082259,22.11402691360707,2.1035058430717863,NaN,NaN,NaN,75303294
875021400,95.5625,95.70312,94.75,95.125,NaN,NaN,93.89808238636364,101.18750153846153,83.75765550000007,90.06468690000001,93.30687440000001,93.05156149999996,92.49505448839729,93.67481798269067,93.75721076923065,96.55158699831749,90.96283454014382,83.75765550000007,90.06468690000001,93.30687440000001,93.05156149999996,95.19270666666667,1872800,3801869.75,58.51240564386765,NaN,1.5,2.75,NaN,NaN,1.5450715352050828,0.49259972675286945,NaN,0.31439878944505883,0.6922349682145494,0.3778361787694906,22.441012080395435,3.7845209682918513,NaN,NaN,NaN,73430494
875107800,95.375,96.10937,94.28125,94.34375,NaN,NaN,94.08025568181819,101.33007971153846,83.85234300000008,90.19374940000002,93.34312440000002,93.22578049999997,92.5675523515974,93.73852579386299,93.84975923076912,96.636002713335,91.06351574820324,83.85234300000008,90.19374940000002,93.34312440000002,93.22578049999997,94.91145666666667,2793100,3727024.75,54.27867026823099,NaN,1.5,2.75,NaN,NaN,1.5652892826904339,0.7494181518381384,NaN,0.2231186976739149,0.6567345508618843,0.43361585318796936,18.6502799661871,3.461274845784784,NaN,NaN,NaN,70637394
875194200,94.25,94.75,93.625,93.6875,NaN,NaN,94.26242897727272,101.47265788461539,83.94554615000008,90.29687440000002,93.34187440000001,93.33984299999997,92.61147186722103,93.73366619444747,93.86057692307682,96.643122039068,91.07803180708564,83.94554615000008,90.29687440000002,93.34187440000001,93.33984299999997,94.02083333333333,6327801,3769199.75,50.94414507049112,NaN,1.5,2.75,NaN,NaN,1.5338400482125458,1.6788181629270245,NaN,0.1083763188788825,0.5690862517865725,0.46070993290768997,18.968532148292827,1.1129848229342327,NaN,NaN,NaN,64309593
875280600,94.4375,94.8125,94.1875,94.46875,NaN,NaN,94.44460227272727,101.61523605769231,84.0460930500001,90.40843690000001,93.36562440000002,93.56249949999997,92.6843063038006,93.80367417592866,93.92788461538451,96.72365587003443,91.13211336073459,84.0460930500001,90.40843690000001,93.36562440000002,93.56249949999997,94.48958333333333,3995800,3754594.85,54.52573522358903,NaN,1.5,2.75,NaN,NaN,1.5046371876259355,1.0642426572337091,NaN,0.0764340984014441,0.5562525559094951,0.47981845750805097,17.458202869375516,2.1283783783783785,NaN,NaN,NaN,68305393
875539800,94.5,95.5625,94.15625,95.375,NaN,NaN,94.62677556818181,101.75781423076923,84.1573430500001,90.54718690000001,93.44718700000001,93.81249949999997,92.78982370365155,93.95332425441164,94.21394230769221,96.77237554335625,91.65550907202817,84.1573430500001,90.54718690000001,93.44718700000001,93.81249949999997,95.03125,2065000,3725229.85,58.32663390004455,NaN,1.5,2.75,NaN,NaN,1.4976095313669402,0.5543282114525094,NaN,0.10586687623719648,0.6121520528045465,0.5062851765673501,17.79111336660653,0.5932762030323006,NaN,NaN,NaN,70370393
875626200,95,95.6875,94.375,94.375,NaN,NaN,94.80894886363636,101.90039240384615,84.26265555000009,90.67031190000002,93.50843700000001,93.86562449999998,92.85198747997894,93.99348384922958,94.45913461538451,96.32857904763257,92.58969018313645,84.26265555000009,90.67031190000002,93.50843700000001,93.86562449999998,94.8125,4137602,3567409.95,53.05678458975292,NaN,1.5,2.75,NaN,NaN,1.4843874219835873,1.1598336210280513,NaN,0.05033168545681632,0.5691997833883704,0.5188680979315541,12.959110440718483,-0.4614370468029005,NaN,NaN,NaN,66232791
875712600,95.25,95.8125,94.78125,95.625,NaN,NaN,94.9911221590909,102.04297057692308,84.37890555000008,90.80031190000001,93.54624960000001,94.00624949999998,92.96073306899937,94.14886633977915,94.6874999999999,96.3319837862142,93.0430162137856,84.37890555000008,90.80031190000001,93.54624960000001,94.00624949999998,95.40625,3567500,3605159.95,58.14717150137817,NaN,1.5,2.75,NaN,NaN,1.481038320413331,0.9895538754112698,NaN,0.08792649201673564,0.6287762129524737,0.540849720935738,15.141202037403994,0.426649163111257,NaN,NaN,NaN,69800291
875799000,95.53125,96.1875,95.3125,96.15625,NaN,NaN,95.17329545454545,102.18554875,84.49492120000009,90.92187440000002,93.59624960000001,94.14374949999998,93.08604745845038,94.34004573599066,94.9687499999999,96.2254627448711,93.7120372551287,84.49492120000009,90.92187440000002,93.59624960000001,94.14374949999998,95.88541666666667,2577500,3610349.95,60.12614421955643,NaN,1.5,2.75,NaN,NaN,1.4377498689552362,0.7139197129630052,NaN,0.13585324666938825,0.7106662792724734,0.5748130326030851,15.26239004279378,1.183821111476488,NaN,NaN,NaN,72377791
875885400,97.46875,97.75,95.34375,96.64062,NaN,NaN,95.35546875,102.32812692307692,84.6104680500001,91.05171810000002,93.64718700000002,94.31874949999998,93.22544246007978,94.55914804684869,95.1093746153845,96.64324544162677,93.57550378914222,84.6104680500001,91.05171810000002,93.64718700000002,94.31874949999998,96.57812333333334,6499898,3752179.85,61.895262789813124,NaN,1.5,2.75,NaN,NaN,1.506928449744148,1.7322991593806465,NaN,0.18444205744014275,0.8053656044032635,0.6209235469631208,15.29535425933205,1.12818312622629,NaN,NaN,NaN,78877689
876144600,97.3125,97.60937,96.90625,97.28125,NaN,NaN,95.53764204545455,102.47070509615385,84.7216399500001,91.18640560000001,93.71218700000001,94.50546849999998,93.38449373615508,94.81839585191072,95.29927846153835,97.20526515061336,93.39329177246334,84.7216399500001,91.18640560000001,93.71218700000001,94.50546849999998,97.26562333333334,2272100,3825609.85,64.16016486489048,NaN,1.5,2.75,NaN,NaN,1.4684871319052804,0.5939183787912926,NaN,0.24045049380021521,0.9214866642133899,0.6810361704131747,15.40239619170017,2.266754270696452,NaN,NaN,NaN,81149789
876231000,97.53125,98.5,97.20312,98.1875,NaN,NaN,95.7198153409091,98.5,84.8383587000001,91.32453060000002,93.79656200000001,94.73515599999999,93.57284692297253,95.13926291363352,95.52764384615374,97.9748671504197,93.08042054188778,84.8383587000001,91.32453060000002,93.79656200000001,94.73515599999999,97.96354000000001,1832800,3822989.85,67.136046773834,NaN,1.5,2.75,NaN,NaN,1.456229479626332,0.47941534555735216,NaN,0.31457656550383406,1.0742568772929673,0.7596803117891332,15.358430847129451,4.074196753892017,NaN,NaN,NaN,82982589
876317400,98.35937,98.375,96.73437,97.5,NaN,NaN,95.90198863636364,98.54464285714286,84.95257745000009,91.46734310000002,93.860937,95.02734349999999,93.72685292599321,95.36409501709699,95.71754769230758,98.35683011255966,93.07826527205549,84.95257745000009,91.46734310000002,93.860937,95.02734349999999,97.53645666666667,4439398,3863774.75,62.87113219135762,NaN,1.5,2.75,NaN,NaN,1.4694009453673083,1.1489795050811387,NaN,0.29374622354314917,1.1268630912180697,0.8331168676749205,15.040006695926703,4.0693795863909275,NaN,NaN,NaN,78543191
876403800,96.78125,97.60937,96.21875,97.15625,NaN,NaN,96.08416193181819,98.58928571428571,85.0623431000001,91.60421810000001,93.89593700000002,95.32578099999998,93.86133908575819,95.53477644404013,95.84014384615374,98.58517151467555,93.09511617763192,85.0623431000001,91.60421810000001,93.89593700000002,95.32578099999998,96.99479000000001,3607800,3691369.85,60.791659323484694,NaN,1.5,2.75,NaN,NaN,1.463773734983929,0.9773607486120633,NaN,0.2357588169303172,1.127815388837817,0.8920565719074999,14.291702761565338,2.844856103208733,NaN,NaN,NaN,74935391
876490200,96.3125,96.98437,96.25,96.875,NaN,NaN,96.26633522727272,98.63392857142857,85.1678118500001,91.72828060000002,93.92718700000002,95.53671849999998,93.97952186670885,95.66241678270298,95.97475923076912,98.73788146384469,93.21163699769356,85.1678118500001,91.72828060000002,93.92718700000002,95.53671849999998,96.70312333333334,2858100,3498874.85,59.07016856806425,NaN,1.5,2.75,NaN,NaN,1.4239506110565057,0.8168625979863212,NaN,0.160973139675482,1.0932729965018524,0.9322998568263704,14.397963246525888,1.5727391874180865,NaN,NaN,NaN,72077291
876749400,97.34375,97.54687,96.71875,96.96875,NaN,NaN,96.44850852272727,98.67857142857143,85.2732806000001,91.85515560000002,93.96781200000001,95.76015599999998,94.09674649938694,95.7868294700646,96.17668230769219,98.81433995183312,93.53902466355126,85.2732806000001,91.85515560000002,93.96781200000001,95.76015599999998,97.07812333333334,1760300,3483864.85,59.482049414176004,NaN,1.5,2.75,NaN,NaN,1.3813912816953267,0.5052721835636075,NaN,0.10314375418278554,1.0612295495548523,0.9580857953720667,13.690842799351396,2.748344370860927,NaN,NaN,NaN,73837591
876835800,97.46875,97.5,96.1875,97,NaN,NaN,96.63068181818181,98.72321428571429,85.38218685000011,91.98515560000001,94.00406200000002,95.86953099999998,94.21059957784236,95.90236952053463,96.43148999999988,98.6674751372693,94.19550486273046,85.38218685000011,91.98515560000001,94.00406200000002,95.86953099999998,96.89583333333333,2235700,3246699.85,59.62788936980628,NaN,1.5,2.75,NaN,NaN,1.3764704758599462,0.6886069249672093,NaN,0.05475006634647228,1.026523378305157,0.9717733119586848,11.378862092292334,1.4379084967320261,NaN,NaN,NaN,76073291
876922200,96.3125,97.0625,96.28125,96.78125,NaN,NaN,96.81285511363636,98.76785714285714,85.49687435000011,92.10515560000002,94.03468700000002,95.96796849999998,94.31140939831913,95.98607242334086,96.6093746153845,98.5394939072511,94.67925532351789,85.49687435000011,92.10515560000002,94.03468700000002,95.96796849999998,96.70833333333333,2601700,3265784.85,58.05269495920646,NaN,1.5,2.75,NaN,NaN,1.3339547275842356,0.7966538273334203,NaN,-0.001271834345925038,0.9701835190262784,0.9714553533722035,9.504963479796931,0.6499837504062398,NaN,NaN,NaN,73471591
877008600,97.3125,97.5,95,95.25,NaN,NaN,96.9950284090909,98.8125,85.60296810000011,92.20640560000001,94.01906200000002,95.96953099999999,94.34821687289485,95.91597028778459,96.59975923076912,98.55545609995528,94.64406236158297,85.60296810000011,92.20640560000001,94.01906200000002,95.96953099999999,95.91666666666667,9488102,3487920.05,48.411775419364076,NaN,1.5,2.75,NaN,NaN,1.417243675613933,2.7202750819933503,NaN,-0.14289597546032573,0.7928353840467963,0.935731359507122,13.190053963483448,-1.4389601391216225,NaN,NaN,NaN,63983489
877095000,95.01562,95.375,93,94.28125,NaN,NaN,97.17720170454545,98.85714285714286,85.6989056000001,92.29812440000002,93.99843700000001,95.93203099999998,94.34559072101662,95.76028264132891,96.59254769230758,98.58141622491694,94.60367915969822,85.6989056000001,92.29812440000002,93.99843700000001,95.93203099999998,94.21875,8151301,3817165.1,43.49087562401534,NaN,1.5,2.75,NaN,NaN,1.4856548416415092,2.135433177883765,NaN,-0.29452664624983993,0.5675730516948221,0.862099697944662,13.5602449085485,-3.0838419530999035,NaN,NaN,NaN,55832188
877354200,94.84375,95.75,94.15625,95.625,NaN,NaN,97.359375,98.90178571428571,85.80484310000011,92.40828070000002,94.04343700000001,95.93515599999998,94.39576363391792,95.74739858024996,96.59254769230758,98.58141622491694,94.60367915969822,85.80484310000011,92.40828070000002,94.04343700000001,95.93515599999998,95.17708333333333,3636400,3836035.1,50.94010833369732,NaN,1.5,2.75,NaN,NaN,1.4933759243814015,0.9479579579446497,NaN,-0.2962308522786694,0.49181113259632525,0.7880419848749947,15.892877523934333,-2.609802673456397,NaN,NaN,NaN,59468588
877440600,96.21875,97.5,96.03125,97.48437,NaN,NaN,97.54154829545455,98.94642857142857,85.9155462000001,92.53156190000001,94.11187440000002,96.05312449999998,94.51688545219565,95.91282442974996,96.69471076923065,98.71955645425231,94.669865084209,85.9155462000001,92.53156190000001,94.11187440000002,96.05312449999998,97.00520666666667,5225398,4003665,58.99503258308925,NaN,1.5,2.75,NaN,NaN,1.5206347869255872,1.3051536529654704,NaN,-0.17029388360634878,0.5751746303670586,0.7454685139734074,19.116545756064617,-0.016030769230770858,NaN,NaN,NaN,64693986
877527000,97.34375,97.39062,96.53125,96.84375,NaN,NaN,97.7237215909091,98.99107142857143,86.0263274500001,92.65218690000002,94.19749940000001,96.17812449999998,94.60813504230562,96.00148400786901,96.71033615384604,98.73640571397668,94.6842665937154,86.0263274500001,92.65218690000002,94.19749940000001,96.17812449999998,96.92187333333334,4485199,4088269.95,55.60746969445184,NaN,1.5,2.75,NaN,NaN,1.4800980164309023,1.0970897359652094,NaN,-0.13011111061047187,0.5828296257103176,0.7129407363207895,19.065901846368813,-0.32164683177870695,NaN,NaN,NaN,60208787
877613400,94.9375,95.75,94.28125,94.9375,NaN,NaN,97.90589488636364,99.03571428571429,86.12445245000009,92.75656190000001,94.25062440000002,96.24062449999998,94.62105131515638,95.90015219759577,96.53004769230758,98.73043698513682,94.32965839947833,86.12445245000009,92.75656190000001,94.25062440000002,96.24062449999998,94.98958333333333,8054102,4174585,46.96546337345825,NaN,1.5,2.75,NaN,NaN,1.5574124438286951,1.9293180040650748,NaN,-0.2262568538067744,0.43011966906232146,0.6563765228690959,22.03168155841249,-2,NaN,NaN,NaN,52154685
877699800,96.15625,96.15625,93.67187,94,NaN,NaN,98.08806818181819,99.08035714285714,86.2138274500001,92.85249940000001,94.27812440000001,96.21718699999998,94.59669636162083,95.71918532163427,96.20793230769219,98.5639852246893,93.85187939069507,86.2138274500001,92.85249940000001,94.27812440000001,96.21718699999998,94.60937333333334,6778699,4313729.95,43.393688209894385,NaN,1.5,2.75,NaN,NaN,1.6236244121266457,1.5714240526345418,NaN,-0.3404715041381795,0.23078714269637146,0.571258646834551,22.463889205191258,-3.0615533354817916,NaN,NaN,NaN,45375986
877962600,93.01562,93.9375,86.84375,87.1875,NaN,NaN,98.27024147727272,99.125,86.26968685000011,92.87718690000001,94.22624940000001,95.80781199999998,94.30613964155727,94.90664386243101,95.41466307692296,100.66409890108137,90.16522725276455,86.26968685000011,92.87718690000001,94.22624940000001,95.80781199999998,89.32291666666667,10840699,4752514.9,27.203539489850797,NaN,1.5,2.75,NaN,NaN,2.0188119541175995,2.2810447159250358,NaN,-0.8341768462083681,-0.4714624109259091,0.36271443528245895,46.80496335996128,-10.1159793814433,NaN,NaN,NaN,34535287
878049000,84.375,92.875,84.375,92.21875,NaN,NaN,84.375,99.16964285714286,86.3459368500001,92.93562440000001,94.23499940000002,95.69999949999998,94.2242812242413,94.65065397077092,95.03485538461527,100.43754156658369,89.63216920264685,86.3459368500001,92.93562440000001,94.23499940000002,95.69999949999998,89.82291666666667,19548000,5523034.8,43.86201219508388,NaN,1.5,2.75,NaN,NaN,2.481753957394914,3.53935847009329,NaN,-0.7821170384536937,-0.6149318627846583,0.16718517566903549,60.48880688085173,-4.714239586696803,NaN,NaN,NaN,54083287
878135400,92.5,93.75,91.28125,91.96875,NaN,NaN,84.275625,99.21428571428571,86.42187435000011,92.98718690000001,94.21749940000001,95.51718699999998,94.13582901936908,94.39523454498321,94.65745153846143,100.17741644474731,89.13748663217555,86.42187435000011,92.98718690000001,94.21749940000001,95.51718699999998,92.33333333333333,10184199,5853869.75,43.33140095835426,NaN,1.5,2.75,NaN,NaN,2.480825103295277,1.7397378887700738,NaN,-0.7259657032644233,-0.7402719534114937,-0.014306250147070348,60.48166144466459,-3.4448818897637796,NaN,NaN,NaN,43899088
878221800,90.625,92.5625,89.75,89.9375,NaN,NaN,84.17625,99.25892857142857,86.4860931000001,93.01578070000001,94.13124940000002,95.20624949999998,93.97118866566834,93.97068839784195,94.11658615384604,99.99118396143676,88.24198834625533,86.4860931000001,93.01578070000001,94.13124940000002,95.20624949999998,90.75,9772898,6213639.65,39.183752247264394,NaN,1.5,2.75,NaN,NaN,2.5045161673456144,1.5728137694627977,NaN,-0.7822140147112138,-0.9920737685360876,-0.20985975382487382,61.008140473127405,-4.607225720914816,NaN,NaN,NaN,34126190
878308200,91.8125,92.5,90.4375,92.0625,NaN,NaN,84.076875,99.30357142857143,86.55859310000011,93.06359320000001,94.12062440000001,94.97734349999999,93.89633812975977,93.78895616947605,93.73677846153835,99.45289110217682,88.02066582089988,86.55859310000011,93.06359320000001,94.12062440000001,94.97734349999999,91.66666666666667,7072699,6242279.7,45.103757528402205,NaN,1.5,2.75,NaN,NaN,2.508657869678071,1.1330314147890552,NaN,-0.6389386284871865,-1.008533039433857,-0.36959441094667045,63.10640551747799,-3.7254901960784315,NaN,NaN,NaN,41198889
878567400,93.1875,94.375,92.875,94,NaN,NaN,83.9775,99.34821428571429,86.6403118500001,93.11390570000002,94.14937440000001,94.81328099999999,93.90040330114174,93.8090555819069,93.52283615384604,98.96895738976563,88.07671491792645,86.6403118500001,93.11390570000002,94.14937440000001,94.81328099999999,93.75,5548500,6406099.7,49.89301518992512,NaN,1.5,2.75,NaN,NaN,2.4946465932724946,0.8661276376950549,NaN,-0.38862592806417895,-0.8553768210268942,-0.4667508929627152,63.856247453028544,-3.5742858060220306,NaN,NaN,NaN,46747389
878653800,93.875,94.4375,93.28125,94,NaN,NaN,83.878125,99.39285714285714,86.71890560000011,93.15671820000001,94.18499940000001,94.60390599999998,93.90430905403814,93.82724076458244,93.42668230769219,98.79095634288186,88.06240827250252,86.71890560000011,93.15671820000001,94.18499940000001,94.60390599999998,93.90625,3455700,6487244.7,49.89301518992512,NaN,1.5,2.75,NaN,NaN,2.399046836610174,0.5326914830266847,NaN,-0.20710708468263261,-0.725634748816006,-0.5185276641333734,62.48699404231639,-2.936431106808648,NaN,NaN,NaN,46747389
878740200,94.1875,95.28125,93.84375,94.3125,NaN,NaN,83.77875,99.4375,86.79624935000011,93.20234320000002,94.25406200000002,94.44453099999998,93.92031654211507,93.8734559298603,93.42908615384604,98.79491761649558,88.0632546911965,86.79624935000011,93.20234320000002,94.25406200000002,94.44453099999998,94.47916666666667,4774898,6504019.7,50.69759907519424,NaN,1.5,2.75,NaN,NaN,2.3303649197094467,0.7341456853213406,NaN,-0.05780735696944217,-0.590786860345176,-0.5329795033757339,62.57418681188051,-0.6583278472679395,NaN,NaN,NaN,51522287
878826600,94.03125,94.34375,93.5,93.95312,NaN,NaN,83.679375,99.48214285714286,86.8772649500001,93.24562440000001,94.30499940000001,94.28437449999998,93.92160295222821,93.88104298415932,93.30047999999988,98.52798237387364,88.07297762612612,86.8772649500001,93.24562440000001,94.30499940000001,94.28437449999998,93.93229000000001,3679800,6507619.7,49.70905255463539,NaN,1.5,2.75,NaN,NaN,2.2241781397302005,0.565460209667753,NaN,0.020725457491930888,-0.5070726815108202,-0.5277981390027511,61.62980411920795,-0.0498723404255336,NaN,NaN,NaN,47842487
878913000,92.375,93.25,91.4375,92.9375,NaN,NaN,83.58,99.52678571428571,86.9582024500001,93.28187440000002,94.36343700000002,94.08749949999998,93.8830106795918,93.79118174757272,92.95072076923066,97.58665226366324,88.31478927479807,86.9582024500001,93.28187440000002,94.36343700000002,94.08749949999998,92.54166666666667,10606801,6895054.75,46.924403294189965,NaN,1.5,2.75,NaN,NaN,2.2449954154637575,1.5383200546739677,NaN,0.008859180592955207,-0.5167241632615571,-0.5255833438545123,61.681854054263816,6.594982078853047,NaN,NaN,NaN,37235686
879172200,93.625,93.84375,92,92.375,NaN,NaN,83.480625,99.57142857142857,87.0374212000001,93.30328070000002,94.40343700000001,93.85781199999998,93.82387300588232,93.65630729542293,92.60697076923066,96.66380518000514,88.55013635845617,87.0374212000001,93.30328070000002,94.40343700000001,93.85781199999998,92.73958333333333,4347898,7024434.65,45.40722729159825,NaN,1.5,2.75,NaN,NaN,2.2163350286449175,0.6189676773489522,NaN,-0.03014857764165535,-0.5632690659065815,-0.5331204882649262,40.434545694575796,0.16943409013893596,NaN,NaN,NaN,32887788
879258600,92.6875,93.0625,92.03125,92.40625,NaN,NaN,83.38125,99.61607142857143,87.1157024500001,93.33156200000002,94.38531200000001,93.62812449999998,93.76827994682812,93.53725421966837,92.41225923076912,96.23945950968138,88.58505895185687,87.1157024500001,93.33156200000002,94.38531200000001,93.62812449999998,92.5,3212400,7073269.65,45.51262841574502,NaN,1.5,2.75,NaN,NaN,2.1316860980274233,0.45416054511650067,NaN,-0.04616278681704766,-0.5908239717862358,-0.5446611849691881,24.65625484221055,0.47570506286102615,NaN,NaN,NaN,36100188
879345000,91.625,92.71875,90.375,90.5,NaN,NaN,83.281875,99.66071428571429,87.1807024500001,93.36249950000001,94.33906200000001,93.31406199999998,93.64011210577603,93.24799191303329,92.14302846153835,95.97799946098871,88.30805746208799,87.1807024500001,93.36249950000001,94.33906200000001,93.31406199999998,91.19791666666667,6775301,7281949.7,40.389941297792895,NaN,1.5,2.75,NaN,NaN,2.146833519596893,0.9304240319045324,NaN,-0.17046710291177614,-0.7577450636089083,-0.5872779606971321,27.468633169728047,0.6254343293954134,NaN,NaN,NaN,29324887
879431400,91.46875,92.15625,90.09375,91.8125,NaN,NaN,83.1825,99.70535714285714,87.2472649500001,93.3843745,94.30718700000001,93.14218699999998,93.56844104280442,93.11127839750631,92.49879769230758,95.0830287119895,89.91456667262565,87.2472649500001,93.3843745,94.30718700000001,93.14218699999998,91.35416666666667,8589602,7237024.7,44.981682061510355,NaN,1.5,2.75,NaN,NaN,2.1408096967685437,1.186896874899432,NaN,-0.15032768802014174,-0.7751875707223093,-0.6248598827021675,25.338814285024405,-0.27155465037338766,NaN,NaN,NaN,37914489
879517800,92.3125,93.39062,91.60937,93.0625,NaN,NaN,83.083125,99.75,87.3205462000001,93.42499950000001,94.30562460000002,93.08124949999998,93.5486002175964,93.10663283583904,92.56370153846143,95.1588972975835,89.96850577933937,87.3205462000001,93.42499950000001,94.30562460000002,93.08124949999998,92.68749666666668,5827898,7120854.55,49.01012437066687,NaN,1.5,2.75,NaN,NaN,2.115126861285076,0.8184267715452775,NaN,-0.0443554590731996,-0.6803042065436671,-0.6359487474704675,22.826061863812342,-0.9973404255319149,NaN,NaN,NaN,43742387
879777000,94.375,95.3125,94.03125,94.78125,NaN,NaN,82.98375,99.79464285714286,87.40124935000011,93.487187,94.33031220000001,93.03906199999997,93.59693942474948,93.26612018480675,92.78004769230758,95.59997478520071,89.96012059941444,87.40124935000011,93.487187,94.33031220000001,93.03906199999997,94.70833333333333,5149898,7196529.45,53.99777535671419,NaN,1.5,2.75,NaN,NaN,2.1247606569075708,0.7156085493404046,NaN,0.1398755004914184,-0.46110437185619446,-0.6009798723476129,22.06133407277945,0.8311170212765957,NaN,NaN,NaN,48892285
879863400,94.8125,95.09375,93.89062,94.1875,NaN,NaN,82.884375,99.83928571428571,87.47656185000011,93.53999950000001,94.34218720000001,92.87421849999998,93.6200986629946,93.35387064339659,93.10697076923066,95.4834830921663,90.73045844629502,87.47656185000011,93.53999950000001,94.34218720000001,92.87421849999998,94.39062333333332,3433600,7106939.55,52.1017674076889,NaN,1.5,2.75,NaN,NaN,2.058929895699887,0.48313341851908675,NaN,0.21560267281816248,-0.33147653132490973,-0.5470792041430722,22.4381803215015,-0.13253810470510272,NaN,NaN,NaN,45458685
879949800,93.6875,95.0625,93.6875,94.65625,NaN,NaN,82.785,99.88392857142857,87.56164000000011,93.60343700000001,94.40218720000001,92.76484349999998,93.66073204875951,93.47790677259691,93.30648999999988,95.73372198541176,90.879258014588,87.56164000000011,93.60343700000001,94.40218720000001,92.76484349999998,94.46875,4387801,7102069.65,53.49021955616186,NaN,1.5,2.75,NaN,NaN,2.0100777602927526,0.6178200463015735,NaN,0.28666689556826974,-0.18874558468273506,-0.4754124802510048,22.541267550044623,0.7483838748516298,NaN,NaN,NaN,49846486
880036200,95.3125,96.53125,95.28125,96.09375,NaN,NaN,82.685625,99.92857142857143,87.65132750000012,93.67093700000001,94.50031220000001,92.82265599999998,93.75614451743562,93.72703469901626,93.46754769230758,96.30129360974892,90.63380177486623,87.65132750000012,93.67093700000001,94.50031220000001,92.82265599999998,95.96875,4822699,6940499.5,57.55373714084685,NaN,1.5,2.75,NaN,NaN,2.0004293488432703,0.6948633884347949,NaN,0.41225315785706806,0.03990396707033028,-0.3723491907867378,23.825751104662658,3.3960995292535308,NaN,NaN,NaN,54669185
880122600,96.625,96.8125,95.65625,96.75,NaN,NaN,82.58625,99.97321428571429,87.73898375000012,93.73031200000001,94.5821872,92.96015599999998,93.87355061479109,94.0149361562528,93.67908615384604,97.00761706924952,90.35055523844257,87.73898375000012,93.73031200000001,94.5821872,92.96015599999998,96.40625,5436500,6873389.55,59.30188551133948,NaN,1.5,2.75,NaN,NaN,1.9401308239258939,0.7909489139896051,NaN,0.5146321806761097,0.2709410350583994,-0.24369114561771035,22.382742821354167,4.7361299052774015,NaN,NaN,NaN,60105685
880381800,96,96.34375,94.625,95,NaN,NaN,82.486875,100.01785714285714,87.82164000000012,93.75968700000001,94.6321872,93.35078099999998,93.91772510048555,94.1087517604192,93.73197076923066,97.12038432102675,90.34355721743457,87.82164000000012,93.75968700000001,94.6321872,93.35078099999998,95.32291666666667,4337199,6548214.55,53.02979658277355,NaN,1.5,2.75,NaN,NaN,1.9533357650740444,0.6623483343257286,NaN,0.4423642734445539,0.30926419618798207,-0.13310007725657186,25.28804720286689,2.8068988840040583,NaN,NaN,NaN,55768486
880468200,95.625,95.8125,94.65625,95.25,NaN,NaN,82.3875,100.0625,87.90101500000011,93.80093700000002,94.64093720000001,93.50234349999998,93.96997117497632,94.2174420689507,93.83173076923066,97.31534095707867,90.34812058138264,87.90101500000011,93.80093700000002,94.64093720000001,93.50234349999998,95.23958333333333,4525000,5797064.55,53.78184014691898,NaN,1.5,2.75,NaN,NaN,1.8964010675687555,0.7805674684095074,NaN,0.39104654701976665,0.35570810651813645,-0.035338440501630194,25.24062786805745,5.248618784530387,NaN,NaN,NaN,60293486
880554600,95.875,95.98437,95.3125,95.53125,NaN,NaN,82.288125,100.10714285714286,87.97617125000012,93.83546830000002,94.65531220000001,93.68046849999999,94.03119779556549,94.34256663381254,94.0312499999999,97.58357183010774,90.47892816989206,87.97617125000012,93.83546830000002,94.65531220000001,93.68046849999999,95.60937333333334,2681100,5421909.6,54.66132147091367,NaN,1.5,2.75,NaN,NaN,1.8133988484567014,0.4944936743320103,NaN,0.35665317588298895,0.410478029352106,0.05382485346911704,20.20789049234559,4.050374404356705,NaN,NaN,NaN,62974586
880727400,95.75,96.25,95.59375,95.625,NaN,NaN,82.18875,100.15178571428571,88.04742125000011,93.88109330000002,94.6634372,93.96484349999999,94.09369984279822,94.46470314487802,94.2812499999999,97.78931077265774,90.77318922734206,88.04742125000011,93.88109330000002,94.6634372,93.96484349999999,95.82291666666667,1564700,5011499.7,54.96892387503944,NaN,1.5,2.75,NaN,NaN,1.7352096449955086,0.312221908344123,NaN,0.3218919234116521,0.4561897577336822,0.13429783432203007,19.47976213973067,2.7535258562793823,NaN,NaN,NaN,64539286
880986600,96.21875,98.09375,96.03125,98.09375,NaN,NaN,82.089375,100.19642857142857,88.13195250000011,93.94734330000001,94.7246872,94.26640599999999,94.25056455484534,94.81032665488964,94.7187499999999,98.58287867082088,90.85462132917893,88.13195250000011,93.94734330000001,94.7246872,94.26640599999999,97.40625,4850898,4900409.65,62.23501309297187,NaN,1.5,2.75,NaN,NaN,1.7876053846386866,0.9898964263120328,NaN,0.43955562710310414,0.6837423682009103,0.24418674109780614,22.563016015227202,3.494889548302011,NaN,NaN,NaN,69390184
881073000,97.6875,97.98437,97.25,97.5,NaN,NaN,81.99,100.24107142857143,88.21007750000011,94.00453080000001,94.76343720000001,94.44140599999999,94.3779933958318,95.06648602109063,95.25721153846143,98.52456111034692,91.98986196657594,88.21007750000011,94.00453080000001,94.76343720000001,94.44140599999999,97.57812333333334,1974900,4721729.65,59.73838931517652,NaN,1.5,2.75,NaN,NaN,1.7201871428787803,0.41825774586649617,NaN,0.4501447829489963,0.8068677197840515,0.3567229368350552,21.732464260068134,3.51692103516921,NaN,NaN,NaN,67415284
881159400,97.625,98.53125,96.875,97.78125,NaN,NaN,81.890625,100.28571428571429,88.29234315000012,94.06171830000001,94.8165622,94.63046849999998,94.5114544391325,95.32503497146294,95.71634615384605,98.56967812339502,92.86301418429707,88.29234315000012,94.06171830000001,94.8165622,94.63046849999998,97.72916666666667,3302500,4714069.65,60.54578298128687,NaN,1.5,2.75,NaN,NaN,1.7156202041017246,0.7005624110793526,NaN,0.4478810703619957,0.9165742747875498,0.4686932044255541,20.950622700568953,3.301419610432486,NaN,NaN,NaN,70717784
881245800,98.5,98.71875,97.375,97.6875,NaN,NaN,81.79125,100.33035714285714,88.37906190000012,94.11328080000001,94.8834372,94.79921849999998,94.63600524544104,95.55003164084742,96.07211538461527,98.65352830733185,93.49070246189869,88.37906190000012,94.11328080000001,94.8834372,94.79921849999998,97.92708333333333,2872500,4618949.75,60.11304367982996,NaN,1.5,2.75,NaN,NaN,1.689058046665887,0.6218946200919375,NaN,0.4127276609091224,0.984602780561957,0.5718751196528347,21.099299230975518,1.6585365853658536,NaN,NaN,NaN,67845284
881332200,97.375,99,97.125,98.9375,NaN,NaN,81.691875,99,88.47187440000012,94.16515580000001,94.9884372,95.04843749999999,94.80469131424728,95.87264767505243,96.39182692307682,99.26730925977962,93.51634458637402,88.47187440000012,94.16515580000001,94.9884372,95.04843749999999,98.35416666666667,3458800,4607899.75,63.82555461207166,NaN,1.5,2.75,NaN,NaN,1.702339614761181,0.7506239691955103,NaN,0.44361672238133776,1.1263960226295069,0.6827793002481691,20.65165375721404,2.260981912144703,NaN,NaN,NaN,71304084
881591400,98.96875,99,98.25,98.65625,NaN,NaN,81.5925,99.01190476190476,88.55851505000014,94.21890580000002,95.0721872,95.334375,94.95573283133562,96.13775265838078,96.73557692307682,99.54242117066677,93.92873267548687,88.55851505000014,94.21890580000002,95.0721872,95.334375,98.63541666666667,2289200,4192019.7,62.41784582592998,NaN,1.5,2.75,NaN,NaN,1.6343153565639537,0.5460852199716523,NaN,0.415548779564462,1.2022152747037467,0.7866664951392847,20.72898314391121,3.848684210526316,NaN,NaN,NaN,69014884
881677800,98.21875,98.59375,97.625,98.0625,NaN,NaN,81.493125,99.02380952380952,88.64187445000015,94.28656210000001,95.12593720000001,95.61874999999999,95.07756683794992,96.32106192901118,96.99759615384605,99.60818635781665,94.38700594987544,88.64187445000015,94.28656210000001,95.12593720000001,95.61874999999999,98.09375,1703000,4059774.8,59.43744855389545,NaN,1.5,2.75,NaN,NaN,1.5912392596665283,0.4194813958646179,NaN,0.33110895692017395,1.2005526912895021,0.8694437343693282,17.27799788773242,2.952755905511811,NaN,NaN,NaN,67311884
881764200,97.5625,97.84375,96.46875,97.21875,NaN,NaN,81.39375,99.03571428571429,88.72499945000014,94.34562460000001,95.1828122,95.85937499999999,95.16153480508913,96.40655603101011,97.08413461538451,99.64321824506858,94.52505098570045,88.72499945000014,94.34562460000001,95.1828122,95.85937499999999,97.17708333333333,3558400,4077074.8,55.38991093009282,NaN,1.5,2.75,NaN,NaN,1.5914185982617763,0.8727826136523176,NaN,0.19905372689438416,1.1182608929873084,0.9192071660929242,18.566925911035323,1.7664376840039253,NaN,NaN,NaN,63753484
881850600,96.3125,96.59375,95.3125,95.5625,NaN,NaN,81.294375,99.04761904761905,88.80585885000015,94.3639059,95.1815622,96.11249999999998,95.17725893037975,96.32616974234249,96.99278846153835,99.67487758590697,94.31069933716974,88.80585885000015,94.3639059,95.1815622,96.11249999999998,95.82291666666667,5072801,3991949.8,48.41964811196036,NaN,1.5,2.75,NaN,NaN,1.6139065555287924,1.270757713436176,NaN,-0.008228900205420886,0.9089210408361481,0.917149941041569,21.554598017448097,-0.06535947712418301,NaN,NaN,NaN,58680683
881937000,96.4375,96.5,94.90625,95.75,NaN,NaN,81.195,99.05952380952381,88.88882760000016,94.38484340000001,95.17343720000001,96.30937499999999,95.1997193644825,96.27129643354796,97.05048076923066,99.58693831154368,94.51402322691764,88.88882760000016,94.38484340000001,95.17343720000001,96.30937499999999,95.71875,4478398,3786389.6,49.19903043640101,NaN,1.5,2.75,NaN,NaN,1.61246680156245,1.1827620697035508,NaN,-0.1341139315715485,0.7495075265771334,0.8836214581486819,21.577616460422366,-2.389295954125518,NaN,NaN,NaN,63159081
882196200,96.25,97.10937,95.875,96.71875,NaN,NaN,81.095625,99.07142857142857,88.97398385000015,94.41109340000001,95.17499980000001,96.49218749999999,95.25928919332632,96.31391105892435,97.16346153846143,99.49132808274148,94.83559499418139,88.97398385000015,94.41109340000001,95.17499980000001,96.49218749999999,96.56770666666667,4674699,3728729.65,53.138833165337104,NaN,1.5,2.75,NaN,NaN,1.5943884585937034,1.2536974891703399,NaN,-0.15221820286985843,0.6933487045613589,0.8455669074312173,16.069453269167806,-0.8012820512820513,NaN,NaN,NaN,67833780
882282600,97.21875,97.8125,96.875,97.3125,NaN,NaN,80.99625,99.08333333333333,89.06429635000015,94.4439059,95.17562480000001,96.61874999999999,95.33980726417627,96.40901476759822,97.30048076923066,99.42908891381498,95.17187262464634,89.06429635000015,94.4439059,95.17562480000001,96.61874999999999,97.33333333333333,2885800,3615524.75,55.42081003895795,NaN,1.5,2.75,NaN,NaN,1.5586285686941532,0.7981690624576695,NaN,-0.12540321385733733,0.6888128901095456,0.8142161039668829,16.296719586972383,-0.4793863854266539,NaN,NaN,NaN,70719580
882369000,97.84375,97.875,96.70312,96.8125,NaN,NaN,80.896875,99.0952380952381,89.14539010000016,94.47234340000001,95.1481248,96.74999999999999,95.39755992048309,96.44744193258887,97.39182692307682,99.31721015551857,95.46644369063507,89.14539010000016,94.47234340000001,95.1481248,96.74999999999999,97.13020666666667,2236300,3555659.75,53.076828586252525,NaN,1.5,2.75,NaN,NaN,1.5310036709302852,0.6289409440821777,NaN,-0.14135413925609852,0.6375234298967598,0.7788775691528583,16.393813712046125,-0.8957133717210493,NaN,NaN,NaN,68483280
882455400,96.9375,96.9375,95.21875,95.875,NaN,NaN,80.7975,99.10714285714286,89.22414010000016,94.4882809,95.1156248,96.8109375,95.4162830608563,96.3929236532947,97.22115384615374,99.25755065971786,95.18475703258962,89.22414010000016,94.4882809,95.1156248,96.8109375,96.01041666666667,4658301,3569184.75,48.90062495539077,NaN,1.5,2.75,NaN,NaN,1.5444141230066932,1.3051442629861063,NaN,-0.21087179067119777,0.5152878308138611,0.7261596214850589,17.14056741018099,-3.0953885028427037,NaN,NaN,NaN,63824979
882541800,94.53125,95.875,92.375,94.78125,NaN,NaN,80.698125,99.11904761904762,89.29382760000016,94.48203090000001,95.0681248,96.74531249999998,95.39137980356782,96.23943092440949,97.01201923076913,99.41613460031888,94.60790386121937,89.29382760000016,94.48203090000001,95.0681248,96.74531249999998,94.34375,8556000,3755849.8,44.50134765797873,NaN,1.5,2.75,NaN,NaN,1.684098828506215,2.278046369159917,NaN,-0.3198106885393648,0.3263962608108528,0.6462069493502176,15.113468701324203,-3.9277795375356352,NaN,NaN,NaN,55268979
882801000,95.4375,95.90625,94.5625,95.39062,NaN,NaN,80.59875,99.13095238095238,89.36234320000014,94.4828121,95.0384372,96.67734349999998,95.39135000734947,96.15859178875144,96.8281246153845,99.33238869046903,94.32386054029996,89.36234320000014,94.4828121,95.0384372,96.67734349999998,95.28645666666667,5136801,3740864.85,47.34361953453054,NaN,1.5,2.75,NaN,NaN,1.6597881978986282,1.373158669445115,NaN,-0.3383292500772329,0.22329538675367644,0.5616246368309094,16.319300100968054,-2.7246704907584465,NaN,NaN,NaN,60405780
882887400,95.4375,95.625,93.53125,93.6875,NaN,NaN,80.499375,99.14285714285714,89.42453070000015,94.47031210000002,94.9728122,96.61171849999998,95.32453236000244,95.92324971363226,96.52043230769219,99.47006477528029,93.57079984010409,89.42453070000015,94.47031210000002,94.9728122,96.61171849999998,94.28125,4436500,3745829.9,41.02047980392887,NaN,1.5,2.75,NaN,NaN,1.6907854694772977,1.1843837329612859,NaN,-0.4460099115438164,0.004112247401138802,0.4501221589449552,18.352365097439968,-3.632272581163613,NaN,NaN,NaN,55969280
882973800,94.4375,94.4375,93.25,93.40625,NaN,NaN,80.4,99.1547619047619,89.48890570000015,94.45249960000001,94.9009372,96.51953099999999,95.24930560078666,95.68353545519109,96.09495153846143,99.12193545072289,93.06796762619997,89.48890570000015,94.45249960000001,94.9009372,96.51953099999999,93.69791666666667,2019200,3620539.9,40.0687598222279,NaN,1.5,2.75,NaN,NaN,1.6548365073717763,0.5577068768113839,NaN,-0.5121738832214915,-0.1900951950819092,0.3220786881395823,18.178766385569883,-2.2563767168083713,NaN,NaN,NaN,53950080
883146600,94.125,94.125,93.40625,93.78125,NaN,NaN,80.300625,99.16666666666667,89.56140570000014,94.43781210000002,94.84093720000001,96.43203099999998,95.19173479291267,95.50236541183956,95.71995153846143,98.58852892463622,92.85137415228664,89.56140570000014,94.43781210000002,94.84093720000001,96.43203099999998,93.77083333333333,941800,3533574.9,42.0009624074176,NaN,1.5,2.75,NaN,NaN,1.5879731854166494,0.2665289477803343,NaN,-0.5057998835629733,-0.31017116631413444,0.19562871724883893,16.55448944456989,-2.0561357702349867,NaN,NaN,NaN,54891880
883405800,94.59375,95.71875,94.4375,95.625,NaN,NaN,80.20125,99.17857142857143,89.64109320000014,94.43374960000001,94.8484372,96.43203099999998,95.20872558534747,95.51404489642627,95.53245153846143,98.06275063702122,93.00215243990164,89.64109320000014,94.43374960000001,94.8484372,96.43203099999998,95.26041666666667,2080000,3559339.9,50.45816828203583,NaN,1.5,2.75,NaN,NaN,1.6129393864583172,0.5843780190815718,NaN,-0.35940961037996555,-0.25363329572611804,0.10577631465384754,20.587948487461652,-1.1308562197092085,NaN,NaN,NaN,56971880
883492200,95.9375,97.25,95.84375,97.125,NaN,NaN,80.101875,99.19047619047619,89.72718695000015,94.45187460000001,94.90531220000001,96.38359349999999,95.28387360160835,95.66746919200472,95.52523999999988,98.0367382341705,93.01374176582927,89.72718695000015,94.45187460000001,94.90531220000001,96.38359349999999,96.73958333333333,3616000,3497595,56.07041924704507,NaN,1.5,2.75,NaN,NaN,1.6138008588541517,1.033853262027193,NaN,-0.15405202427067127,-0.08678871568449154,0.06726330858617972,21.78805228307225,-0.1926782273603083,NaN,NaN,NaN,60587880
883578600,96.875,97.625,96.6875,97.0625,NaN,NaN,80.0025,99.20238095238095,89.81726510000016,94.4887496,94.93406220000001,96.36171849999998,95.35362365644724,95.80032926895665,95.6406246153845,98.28279616182755,92.99845306894144,89.81726510000016,94.4887496,94.93406220000001,96.36171849999998,97.125,4359500,3616825,55.786842740284484,NaN,1.5,2.75,NaN,NaN,1.5654936546502838,1.2053389367746574,NaN,-0.021864036797309735,0.03993326258954255,0.061797299386852286,21.484845942436923,0.2582311168495804,NaN,NaN,NaN,56228380
883751400,97.3125,97.65625,96.53125,97.5625,NaN,NaN,79.903125,99.21428571428571,89.91117135000015,94.52374960000002,94.9356248,96.35078099999998,95.4402462581552,95.96815505286554,95.78004769230758,98.61485425225246,92.9452411323627,89.91117135000015,94.52374960000002,94.9356248,96.35078099999998,97.25,2360900,3569745,57.63287835347917,NaN,1.5,2.75,NaN,NaN,1.5340298221752635,0.6613637668797071,NaN,0.09348041950802416,0.17864782377188249,0.08516740426385833,21.438673609577343,1.7601043024771839,NaN,NaN,NaN,58589280
884010600,97.84375,98.4375,96.78125,97.78125,NaN,NaN,79.80375,98.4375,90.00820260000015,94.5759371,94.95437480000001,96.35546849999999,95.53205032646284,96.14083076211644,95.86177846153835,98.85686297127799,92.86669395179871,90.00820260000015,94.5759371,94.95437480000001,96.35546849999999,97.66666666666667,4191801,3635710.05,58.45025024600663,NaN,1.5,2.75,NaN,NaN,1.5427598348770304,1.1529525023592022,NaN,0.17405935105953022,0.3027415930882711,0.12868224202874087,20.369391853048697,3.1651829871414443,NaN,NaN,NaN,62781081
884097000,97.25,97.28125,96.1875,96.21875,NaN,NaN,79.704375,98.40789473684211,90.09710885000015,94.61531210000001,94.9799998,96.21953099999999,95.55897972542508,96.14825164191487,95.77764384615374,98.66448614170918,92.8908015505983,90.09710885000015,94.61531210000001,94.9799998,96.21953099999999,96.5625,3154900,3620515.05,50.89691370029322,NaN,1.5,2.75,NaN,NaN,1.5464019895286711,0.8713953557519393,NaN,0.11455191432832285,0.2718721349391444,0.15732022061082157,21.620630905993256,0.8681461552509058,NaN,NaN,NaN,59626181
884183400,96.09375,96.71875,95.21875,96.46875,NaN,NaN,79.605,98.3782894736842,90.18179635000016,94.65374960000001,95.0293748,96.11015599999999,95.59465699109468,96.17877529506583,95.75120153846143,98.6057606902832,92.89664238663966,90.18179635000016,94.65374960000001,95.0293748,96.11015599999999,96.13541666666667,4424199,3727265,51.96646513569817,NaN,1.5,2.75,NaN,NaN,1.5430875617051947,1.186982680329947,NaN,0.08576896273156573,0.26453142402527874,0.178762461293713,21.414443523866964,2.9686457638425616,NaN,NaN,NaN,64050380
884269800,96.3125,96.3125,95.375,95.625,NaN,NaN,79.505625,98.34868421052632,90.26617135000015,94.71218710000001,95.1981248,95.98828099999999,95.59584691301254,96.12603479077384,95.73197076923066,98.58630318038502,92.8776383580763,90.26617135000015,94.71218710000001,95.1981248,95.98828099999999,95.77083333333333,3831000,3833665,48.15418031235134,NaN,1.5,2.75,NaN,NaN,1.510992021583395,0.9993048427549095,NaN,0.007756318453256722,0.18845785936028392,0.1807015409070272,18.910315936469676,2.375376380060221,NaN,NaN,NaN,60219380
884356200,95.25,95.5,91.90625,92.3125,NaN,NaN,79.40625,98.31907894736842,90.33226510000014,94.71749960000001,95.1999998,95.74296849999999,95.46708821054146,95.76284100117634,95.54206692307682,98.90697767324032,92.17715617291331,90.33226510000014,94.71749960000001,95.1999998,95.74296849999999,93.23958333333333,10258801,4168685.05,36.754363859852965,NaN,1.5,2.75,NaN,NaN,1.668689020041724,2.4609201407527777,NaN,-0.25459052750592587,-0.13753661847538012,0.11705390903054573,28.603976254605794,-1.5661446184605132,NaN,NaN,NaN,49960579
884615400,91.125,94.1875,90.90625,94,NaN,NaN,90.90625,98.28947368421052,90.41726510000015,94.72906210000001,95.2406248,95.66484349999999,95.40955533953984,95.59495138201669,95.43509615384605,98.89941127952335,91.97078102816874,90.41726510000015,94.72906210000001,95.2406248,95.66484349999999,93.03125,12097898,4519939.9,44.02437969991223,NaN,1.5,2.75,NaN,NaN,1.7838719471816007,2.6765616949906788,NaN,-0.29905324236008285,-0.25676264391955783,0.04229059844052502,30.61000799576807,-1.6993464052287581,NaN,NaN,NaN,62058477
884701800,94.625,95.375,94.21875,95.3125,NaN,NaN,91.0343137254902,98.25986842105263,90.51539010000015,94.73968710000001,95.34812480000001,95.64296849999998,95.40574924779318,95.56805125039605,95.56009615384605,98.87730629734695,92.24288601034515,90.51539010000015,94.73968710000001,95.34812480000001,95.64296849999998,94.96875,5224898,4557264.9,48.94049031233029,NaN,1.5,2.75,NaN,NaN,1.7546668080972005,1.146498637812342,NaN,-0.2278696170709011,-0.24254642289810135,-0.01467680582720026,29.472076457632518,-1.8661518661518661,NaN,NaN,NaN,67283375
884788200,95.6875,95.96875,94.71875,95.75,NaN,NaN,91.16237745098039,98.23026315789474,90.61484325000016,94.7712496,95.42187480000001,95.59453099999999,95.41924927729148,95.58537970273929,95.74038461538451,98.81569970003406,92.66506953073497,90.61484325000016,94.7712496,95.42187480000001,95.59453099999999,95.47916666666667,3770400,4512049.95,50.501056138355366,NaN,1.5,2.75,NaN,NaN,1.7186191789474006,0.8356290470587543,NaN,-0.14325376437469112,-0.19374401129556418,-0.05049024692087305,27.942916128130143,-1.3522215067611076,NaN,NaN,NaN,71053775
884874600,95.5,95.75,94.8125,94.95312,NaN,NaN,91.2904411764706,98.20065789473684,90.71710885000014,94.79515580000002,95.44093720000001,95.47656199999997,95.40096969778986,95.52516449295459,95.83052846153835,98.73479691657799,92.92626000649871,90.71710885000014,94.79515580000002,95.44093720000001,95.47656199999997,95.17187333333334,2875400,4511529.95,47.64465503480605,NaN,1.5,2.75,NaN,NaN,1.6628249518797291,0.6373447659368857,NaN,-0.13310329814162283,-0.2168693695979016,-0.08376607145627876,28.212555547289142,-2.674572709801411,NaN,NaN,NaN,68178375
884961000,96.25,96.6875,95.65625,96.3125,NaN,NaN,91.41850490196079,98.17105263157895,90.82414010000015,94.83609330000002,95.48718720000001,95.45156199999998,95.43671598415105,95.60014882695891,95.88341307692296,98.79581182571391,92.97101432813201,90.82414010000015,94.83609330000002,95.48718720000001,95.45156199999998,96.21875,4374801,4618455,52.57275245772227,NaN,1.5,2.75,NaN,NaN,1.667936026745463,0.9472433963305911,NaN,-0.032247552598189455,-0.12407551220401558,-0.09182795960582613,29.523142734330364,-1.5020773410035155,NaN,NaN,NaN,72553176
885306600,96.6875,98.01562,96.5,97.875,NaN,NaN,91.54656862745098,98.14144736842105,90.93429635000015,94.90624960000001,95.55843720000001,95.55156199999998,95.53233496516474,95.81680131962949,95.94110538461527,98.97670580362913,92.90550496560141,90.93429635000015,94.90624960000001,95.55843720000001,95.55156199999998,97.46354000000001,5091699,4640124.9,57.522071214826056,NaN,1.5,2.75,NaN,NaN,1.6704491676922155,1.097319384657081,NaN,0.13320962249611332,0.07468406851431553,-0.0585255539817978,31.150454504789337,1.7213380967846703,NaN,NaN,NaN,77644875
885393000,97.21875,97.6875,96.15625,96.9375,NaN,NaN,91.67463235294117,98.11184210526316,91.03828075000015,94.96156210000001,95.6181248,95.65937449999998,95.58743947633475,95.92353452728382,95.93148999999988,98.95358309080122,92.90939690919855,91.03828075000015,94.96156210000001,95.6181248,95.65937449999998,96.92708333333333,4699398,4447294.8,53.888375712432655,NaN,1.5,2.75,NaN,NaN,1.6738992271427715,1.0566868650128614,NaN,0.1706364123523962,0.15476996145869748,-0.015866450893698737,30.124107430719018,0.4859086491739553,NaN,NaN,NaN,72945477
885479400,96.15625,96.875,95.875,96.07812,NaN,NaN,91.80269607843137,98.08223684210526,91.13523385000015,95.02218710000001,95.6809372,95.69374949999998,95.60668184981182,95.93825695325678,95.8173069230768,98.69289206871336,92.94172177744024,91.13523385000015,95.02218710000001,95.6809372,95.69374949999998,96.27604000000001,4543398,4417624.65,50.72511007703198,NaN,1.5,2.75,NaN,NaN,1.6302278537754307,1.028470809533354,NaN,0.13045078393063425,0.14719702901959408,0.016746245088959825,30.58378475397885,0.47385098039215523,NaN,NaN,NaN,68402079
885565800,96.5,96.78125,95,95.9375,NaN,NaN,91.93075980392157,98.05263157894737,91.23460885000014,95.07781210000002,95.75218720000001,95.80624949999998,95.61965511060352,95.93818486247042,95.67547999999988,98.32239971043228,93.02856028956748,91.23460885000014,95.07781210000002,95.75218720000001,95.80624949999998,95.90625,6350301,4513314.7,50.20578313905745,NaN,1.5,2.75,NaN,NaN,1.6410151499343286,1.4070148930673945,NaN,0.08929805270158253,0.128368810965938,0.03907075826435546,30.13627481517961,3.9268788083953963,NaN,NaN,NaN,62051778
885825000,96.375,96.73437,95.40625,95.875,NaN,NaN,92.05882352941177,98.02302631578948,91.33507760000015,95.10343710000001,95.8215622,95.92968699999997,95.62966863567789,95.93216725652086,95.64903769230757,98.28054350533782,93.01753187927733,91.33507760000015,95.10343710000001,95.8215622,95.92968699999997,96.00520666666667,4362898,4630499.6,49.960952274040025,NaN,1.5,2.75,NaN,NaN,1.6186654963675908,0.9422089141309936,NaN,0.054478361913700375,0.10716871065648093,0.05269034874278055,20.068567840965667,1.9946808510638299,NaN,NaN,NaN,57688880
885911400,95.8125,97.5,95.65625,96.84375,NaN,NaN,92.18688725490196,97.99342105263158,91.45242135000015,95.1437496,95.9484372,96.08281199999998,95.67727966957287,96.01898466066173,95.67788384615372,98.35256664063857,93.00320105166887,91.45242135000015,95.1437496,95.9484372,96.08281199999998,96.66666666666667,7044199,4935619.55,53.72756650246027,NaN,1.5,2.75,NaN,NaN,1.634742960912763,1.4272167716006394,NaN,0.09114120251620506,0.16661685188803688,0.07547564937183182,18.432922579440817,1.6065573770491803,NaN,NaN,NaN,64733079
885997800,97.40625,98.10937,97.1875,97.71875,NaN,NaN,92.31495098039215,97.96381578947368,91.56921825000016,95.18687460000001,96.0665622,96.18749949999997,95.75733732958962,96.18086707393203,95.83894153846141,98.725269499974,92.95261357694882,91.56921825000016,95.18687460000001,96.0665622,96.18749949999997,97.67187333333334,4268602,5045049.65,56.884439860306394,NaN,1.5,2.75,NaN,NaN,1.60837703513328,0.8460971241383124,NaN,0.16449534704117355,0.28109483317329875,0.1165994861321252,17.574301897270917,2.0561357702349867,NaN,NaN,NaN,69001681
886084200,97.84375,99.5625,97.5625,98.25,NaN,NaN,92.44301470588235,97.9342105263158,91.68234325000016,95.23796840000001,96.17031220000001,96.24374949999998,95.8550888068606,96.37792735260517,96.29567230769219,98.63207082599386,93.95927378939051,91.68234325000016,95.23796840000001,96.17031220000001,96.24374949999998,98.45833333333333,8007699,5264634.6,58.72559836887129,NaN,1.5,2.75,NaN,NaN,1.6363501040523314,1.5210360468321962,NaN,0.23468930446086234,0.4099611167082031,0.17527181224734079,17.61736915932935,3.4721133965898137,NaN,NaN,NaN,77009380
886170600,98.78125,98.96875,98,98.3125,NaN,NaN,92.57107843137256,97.90460526315789,91.79140575000015,95.28562470000001,96.2409372,96.30624949999998,95.95145787325824,96.56217236664277,96.62740307692296,98.783457683901,94.47134846994491,91.79140575000015,95.28562470000001,96.2409372,96.30624949999998,98.42708333333333,3649100,5229114.6,58.9477044000235,NaN,1.5,2.75,NaN,NaN,1.5886643823343078,0.6978428049750526,NaN,0.26877340027585117,0.5112385625921547,0.24246516231630358,16.28350566161846,2.0765736534717716,NaN,NaN,NaN,80658480
886429800,99.90625,100.5,99.75,99.9375,NaN,NaN,92.69914215686275,97.875,91.91015575000016,95.3490622,96.35593720000001,96.42499949999998,96.10777325077753,96.88363214124821,96.98317230769219,99.62544383150438,94.34090078387999,91.91015575000016,95.3490622,96.35593720000001,96.42499949999998,100.0625,5756301,5398884.65,64.32325357173198,NaN,1.5,2.75,NaN,NaN,1.6314383550247145,1.0662018867174723,NaN,0.3775403005459595,0.714390537998753,0.33685023745279347,16.846153307515365,2.10727969348659,NaN,NaN,NaN,86414781
886516200,100,100.8125,99.71875,100.6875,NaN,NaN,92.82720588235294,97.84539473684211,92.03078075000016,95.4393747,96.4765622,96.57031199999997,96.28737037819802,97.24590527065314,97.36297999999988,100.55027329821806,94.1756867017817,92.03078075000016,95.4393747,96.4765622,96.57031199999997,100.40625,2763000,5327444.6,66.50336717883494,NaN,1.5,2.75,NaN,NaN,1.5930320439515206,0.5186351445118735,NaN,0.4707142486073054,0.9252430482119252,0.4545287996046198,15.172221173882862,3.8684719535783367,NaN,NaN,NaN,89177781
886602600,100.28125,101.15625,99.9375,100.5625,NaN,NaN,92.95526960784314,97.8157894736842,92.15328075000016,95.5331247,96.56593720000001,96.78749949999998,96.45502252022948,97.56177143535284,97.79447076923066,101.07730878479758,94.51163275366373,92.15328075000016,95.5331247,96.56593720000001,96.78749949999998,100.55208333333333,3374000,5338399.6,65.78187181623102,NaN,1.5,2.75,NaN,NaN,1.5662976122406977,0.6320246240090382,NaN,0.4923171951611016,1.0699252935559969,0.5776080983948952,13.305900857589323,4.667431044654081,NaN,NaN,NaN,85803781
886689000,101.3125,101.59375,100.03125,100.5,NaN,NaN,93.08333333333333,97.78618421052632,92.26710890000017,95.61156220000001,96.64093720000001,96.98906199999998,96.61364908806361,97.841602727224,98.11658615384604,101.57179963063459,94.6613726770575,92.26710890000017,95.61156220000001,96.64093720000001,96.98906199999998,100.70833333333333,5076199,5370999.6,65.3998209784955,NaN,1.5,2.75,NaN,NaN,1.566026354223505,0.9451125261673824,NaN,0.4707948758904722,1.1661016932579855,0.6953068173675133,11.11492522307994,4.755700325732899,NaN,NaN,NaN,80727582
886775400,101,101.625,100.6875,101.625,NaN,NaN,93.21139705882354,97.75657894736842,92.38617140000017,95.70281220000001,96.7734372,97.28906199999997,96.81017265323759,98.20192627701219,98.40504769230758,102.32615423275543,94.48394115185972,92.38617140000017,95.70281220000001,96.7734372,97.28906199999997,101.3125,5701199,5464509.55,68.90103061031371,NaN,1.5,2.75,NaN,NaN,1.5345244717789688,1.043313942053592,NaN,0.49808115004574016,1.3179082549246885,0.8198271048789484,10.99186311793009,5.9973924380704045,NaN,NaN,NaN,86428781
887034600,101.71875,101.75,100.71875,101.28125,NaN,NaN,93.33946078431373,97.72697368421052,92.50546830000017,95.7674997,96.89406220000001,97.73749949999998,96.98550901977728,98.49519520301104,98.73918230769219,102.83933033053724,94.63903428484714,92.50546830000017,95.7674997,96.89406220000001,97.73749949999998,101.25,2322200,5067679.5,66.68071414826294,NaN,1.5,2.75,NaN,NaN,1.4985762952233281,0.45823734512018766,NaN,0.45966189197652474,1.3944044698496043,0.9347425778730796,11.665691945541502,4.582123265569539,NaN,NaN,NaN,84106581
887121000,101.4375,102.46875,101.1875,102.25,NaN,NaN,93.46752450980392,97.69736842105263,92.63406205000018,95.8418747,97.02843720000001,98.14999949999996,97.19195964645269,98.85279565986713,99.21394230769221,103.4000317769258,95.02785283845861,92.63406205000018,95.8418747,97.02843720000001,98.14999949999996,101.96875,3660400,4645804.6,69.6490631032929,NaN,1.5,2.75,NaN,NaN,1.4830529884216619,0.7878936621656452,NaN,0.4647867015583198,1.5157259548209794,1.0509392532626596,11.593146572345201,4.63703229932843,NaN,NaN,NaN,87766981
887207400,102.09375,102.34375,101.70312,102.15625,NaN,NaN,93.59558823529412,97.66776315789474,92.75843705000017,95.91124970000001,97.15906220000001,98.49218699999997,97.38663769953297,99.1674103589274,99.6923076923076,103.68838796482821,95.69622741978698,92.75843705000017,95.91124970000001,97.15906220000001,98.49218699999997,102.06770666666667,4073200,4588219.7,69.008347731203,NaN,1.5,2.75,NaN,NaN,1.4228799178201148,0.8877517351664742,NaN,0.4280698274525738,1.5860265375783769,1.157956710125803,11.87005860108529,3.975826972010178,NaN,NaN,NaN,83693781
887293800,101.71875,102.9375,100.875,102.59375,NaN,NaN,93.72365196078431,97.63815789473684,92.87281205000018,95.9868747,97.24906220000001,98.83437449999997,97.59083818190423,99.49372841998193,100.20913461538451,103.81563454135456,96.60263468941447,92.87281205000018,95.9868747,97.24906220000001,98.83437449999997,102.13541666666667,5024699,4650934.65,70.37783538185666,NaN,1.5,2.75,NaN,NaN,1.4685670665472494,1.0803632770888318,NaN,0.39997963200871633,1.6579312501366985,1.2579516181279822,11.85366151752316,4.354736172917991,NaN,NaN,NaN,88718480
887380200,102.1875,102.51562,101.875,102,NaN,NaN,93.8517156862745,97.60855263157895,92.98234330000018,96.05124970000001,97.3390622,99.18671849999997,97.76374648849622,99.73242095141222,100.60576923076913,103.74894124729886,97.4625972142394,92.98234330000018,96.05124970000001,97.3390622,99.18671849999997,102.13020666666667,2101300,4612229.65,66.10830913495927,NaN,1.5,2.75,NaN,NaN,1.4150087046510174,0.45559309909904416,NaN,0.31204540578473305,1.6480083753588985,1.3359629695741655,13.095146640886492,2.0637898686679175,NaN,NaN,NaN,86617180
887725800,102.8125,103.09375,102.15625,102.5,NaN,NaN,93.97977941176471,97.57894736842105,93.09484330000018,96.1249997,97.43343720000001,99.49609349999996,97.9494819203199,99.99599990842059,100.9735576923076,103.7803195903194,98.1667957942958,93.09484330000018,96.1249997,97.43343720000001,99.49609349999996,102.58333333333333,3055500,4546264.6,67.87568424195615,NaN,1.5,2.75,NaN,NaN,1.3920616543188018,0.6720902254567409,NaN,0.2603011130828716,1.6613393609277551,1.4010382478448835,10.402217519634625,1.8001241464928617,NaN,NaN,NaN,89672680
887812200,102.3125,103.48437,102.28125,103.4375,NaN,NaN,94.1078431372549,97.54934210526316,93.20484330000018,96.21593720000001,97.54843720000001,99.77421849999996,98.16469831560147,100.32376182190434,101.37259615384605,103.98537235595533,98.75981995173676,93.20484330000018,96.21593720000001,97.54843720000001,99.77421849999996,103.06770666666667,3007400,4442049.65,70.93606757347479,NaN,1.5,2.75,NaN,NaN,1.3785658218674588,0.6770298031225293,NaN,0.26127943995398684,1.7276375477873671,1.4663581078333803,10.721657393492196,2.8589185829707895,NaN,NaN,NaN,92680080
887898600,103.25,103.40625,102.75,102.89062,NaN,NaN,94.2359068627451,97.51973684210526,93.30242140000017,96.30796840000001,97.62749960000001,100.07187449999996,98.35002857773475,100.5682245055325,101.72475923076912,103.76394544993882,99.68557301159943,93.30242140000017,96.30796840000001,97.62749960000001,100.07187449999996,103.01562333333334,3387800,4376469.75,66.93043563154643,NaN,1.5,2.75,NaN,NaN,1.3292039774483546,0.774094234285522,NaN,0.19992682534266826,1.7162666395117157,1.5163398141690474,11.49044728926397,2.3787263681592026,NaN,NaN,NaN,89292280
887985000,103.07812,103.71875,102.375,103.65625,NaN,NaN,94.36397058823529,97.49013157894737,93.40414015000016,96.39984340000001,97.72749960000002,100.45078099999998,98.55811569233339,100.86232217167226,102.01081692307682,104.00981631961436,100.01181752653928,93.40414015000016,96.39984340000001,97.72749960000002,100.45078099999998,103.25,3707000,4334649.85,69.52497127099487,NaN,1.5,2.75,NaN,NaN,1.3302429790591863,0.8552017183118032,NaN,0.18602823786079314,1.748875111495039,1.5628468736342458,11.669135991941737,1.998769987699877,NaN,NaN,NaN,92999280
888244200,104.25,104.25,103.34375,104.0625,NaN,NaN,94.49203431372548,97.46052631578948,93.51695265000016,96.48671840000002,97.8474996,100.85703099999996,98.77397390047717,101.16710101246538,102.27043230769219,104.38768955052119,100.15317506486319,93.51695265000016,96.48671840000002,97.8474996,100.85703099999996,103.88541666666667,3227800,4178524.8,70.83261021829102,NaN,1.5,2.75,NaN,NaN,1.2999577662692445,0.7724735772777991,NaN,0.17924271416199855,1.786900266336744,1.6076575521747454,10.531812170198275,2.746066029003394,NaN,NaN,NaN,96227080
888330600,103.90625,104.09375,102.9375,103.25,NaN,NaN,94.62009803921569,97.43092105263158,93.62289015000016,96.5754684,97.96812460000001,101.22578099999996,98.94950433575258,101.36547234461153,102.47716307692296,104.40317612975119,100.55115002409474,93.62289015000016,96.5754684,97.96812460000001,101.22578099999996,103.42708333333333,3386800,4129719.9,64.8401846851238,NaN,1.5,2.75,NaN,NaN,1.2896929258214413,0.8201040462816861,NaN,0.09908492122388934,1.731513703704607,1.6324287824807178,11.667557403623352,0.9779951100244498,NaN,NaN,NaN,92840280
888417000,103.75,104.875,103.625,104.53125,NaN,NaN,94.74816176470588,97.40131578947368,93.73242140000016,96.6645309,98.1474996,101.61015599999996,99.1683963225858,101.66697497845806,102.78725923076912,104.63666533448209,100.93785312705616,93.73242140000016,96.6645309,98.1474996,101.61015599999996,104.34375,3481800,3951599.95,69.25701420093839,NaN,1.5,2.75,NaN,NaN,1.3136434311199099,0.8811114596759725,NaN,0.11053321438387065,1.7705953004605561,1.6600620860766855,12.422908923977733,2.3248699908228816,NaN,NaN,NaN,96322080
888503400,104.4375,105.21875,104.1875,105.125,NaN,NaN,94.87622549019608,97.3717105263158,93.83804640000017,96.75421840000001,98.3349996,101.98046849999996,99.40198862366087,101.99631069479538,103.05648999999988,105.15321728396486,100.9597627160349,93.83804640000017,96.75421840000001,98.3349996,101.98046849999996,104.84375,3187600,3897549.85,71.07067780239551,NaN,1.5,2.75,NaN,NaN,1.2934724717542019,0.8178471405567782,NaN,0.13467171773170872,1.8284017332413214,1.6937300155096127,12.391501952688252,2.467255558939994,NaN,NaN,NaN,99509680
888589800,104.96875,105.53125,104.53125,105.125,NaN,NaN,95.00428921568627,97.34210526315789,93.94539015000016,96.8390622,98.5031246,102.32421849999996,99.62642044234083,102.29428110481487,103.35216307692296,105.44821250447092,101.25611364937501,93.94539015000016,96.8390622,98.5031246,102.32421849999996,105.0625,3442900,3669309.9,71.07067780239551,NaN,1.5,2.75,NaN,NaN,1.2725101523431874,0.9382963265108788,NaN,0.12730013676484964,1.8528551864656748,1.7255550497008252,12.456064646134353,3.0637254901960786,NaN,NaN,NaN,99509680
888849000,105.25,105.75,104.625,104.90625,NaN,NaN,95.13235294117646,97.3125,94.05085890000016,96.9153122,98.65499960000001,102.65390599999996,99.83347258185688,102.54304004721345,103.55648999999988,105.70026845696813,101.41271154303163,94.05085890000016,96.9153122,98.65499960000001,102.65390599999996,105.09375,4252301,3699469.95,69.32323362494284,NaN,1.5,2.75,NaN,NaN,1.2619737128901025,1.1494352049000964,NaN,0.08631481913456973,1.8334485736190373,1.7471337544844676,11.718131519149543,2.347560975609756,NaN,NaN,NaN,95257379
888935400,104.53125,105.625,104.53125,105.5,NaN,NaN,95.26041666666667,97.28289473684211,94.15648390000017,96.9884372,98.82874960000001,102.93203099999997,100.0556893433527,102.82465528081217,103.81370153846143,106.02505773330633,101.60234534361653,94.15648390000017,96.9884372,98.82874960000001,102.93203099999997,105.21875,3349200,3579114.9,71.38016685991806,NaN,1.5,2.75,NaN,NaN,1.2499577333979524,0.9357620790547965,NaN,0.07806470356452877,1.8447146339401286,1.7666499303755998,11.774815887984786,1.9939577039274925,NaN,NaN,NaN,98606579
889021800,105.09375,105.40625,104.4375,104.8125,NaN,NaN,95.38848039215686,97.2532894736842,94.26445265000017,97.06156220000001,99.00749960000002,103.13828099999996,100.24223093773102,103.01397382549672,103.9843746153845,106.1343977592819,101.8343514714871,94.26445265000017,97.06156220000001,99.00749960000002,103.13828099999996,104.88541666666667,4404102,3661170,65.87248990613054,NaN,1.5,2.75,NaN,NaN,1.2365678952980985,1.202922016732356,NaN,0.008820556133758872,1.7776756255427983,1.7688550694090395,12.165586120499778,1.8678864992746682,NaN,NaN,NaN,94202477
889108200,103.5,104.4375,103.15625,103.84375,NaN,NaN,95.51654411764706,97.22368421052632,94.36632765000017,97.12843720000001,99.18874960000001,103.30234349999996,100.38346697938863,103.09300012783036,104.12620153846143,105.95284096788123,102.29956210904163,94.36632765000017,97.12843720000001,99.18874960000001,103.30234349999996,103.8125,7268000,3855870,58.96800859595938,NaN,1.5,2.75,NaN,NaN,1.2665451884910914,1.884918319341679,NaN,-0.11299239796806892,1.6276145719489534,1.7406069699170224,13.133078250257059,0.18088634308109738,NaN,NaN,NaN,86934477
889194600,104.5625,105.9375,104.4375,105.9375,NaN,NaN,95.64460784313725,97.19407894736842,94.47367140000017,97.21906220000001,99.3996872,103.57421849999996,100.6012721958832,103.36390487756081,104.3906246153845,106.19415142205581,102.58709780871318,94.47367140000017,97.21906220000001,99.3996872,103.57421849999996,105.4375,6896301,3946875.1,67.0151150206218,NaN,1.5,2.75,NaN,NaN,1.3256312464560136,1.7472812858962778,NaN,-0.06566969735132311,1.6585198482278685,1.7241895455791916,16.842429669517642,1.8018018018018018,NaN,NaN,NaN,93830778
889453800,105.53125,106.21875,105.25,105.5625,NaN,NaN,95.77267156862744,97.16447368421052,94.58007765000016,97.30499970000001,99.63718720000001,103.77109349999996,100.79583014898581,103.57329488922169,104.55408615384604,106.36760747802927,102.74056482966282,94.58007765000016,97.30499970000001,99.63718720000001,103.77109349999996,105.67708333333333,3362800,3829955.15,64.57249537096072,NaN,1.5,2.75,NaN,NaN,1.3001397288520127,0.8780259476406662,NaN,-0.0722169622484885,1.633918342768581,1.7061353050170696,17.10245596876347,2.2397094430992737,NaN,NaN,NaN,90467978
889540200,106.21875,106.84375,105.9375,106.5625,NaN,NaN,95.90073529411765,97.13486842105263,94.69289015000017,97.40062470000001,99.9003122,104.03515599999996,101.02197406471186,103.85798109024819,104.83653846153835,106.66942347039208,103.00365345268463,94.69289015000017,97.40062470000001,99.9003122,104.03515599999996,106.44791666666669,5481898,3987940.05,67.92943202561756,NaN,1.5,2.75,NaN,NaN,1.2987904625054403,1.3746189589785835,NaN,-0.02427177463612118,1.675795586721918,1.7000673613580393,16.540653258293748,1.9431988041853512,NaN,NaN,NaN,95949876
889626600,106.96875,107.3125,106.78125,107.0625,NaN,NaN,96.02879901960785,97.10526315789474,94.80429640000017,97.50343720000001,100.1659372,104.27578099999997,101.25885743472315,104.1631733673674,105.0985576923076,107.14325741781902,103.05385796679617,94.80429640000017,97.50343720000001,100.1659372,104.27578099999997,107.05208333333333,3439600,3976900.05,69.48630121926843,NaN,1.5,2.75,NaN,NaN,1.2595911437550515,0.8648947564070664,NaN,0.02346134892991225,1.7293940475204295,1.7059326985905172,15.54275411771409,1.8430439952437574,NaN,NaN,NaN,99389476
889713000,107.09375,107.59375,106.5,107.5,NaN,NaN,96.15686274509804,97.07565789473684,94.91617140000017,97.62593720000001,100.40343720000001,104.54296849999996,101.50360812355754,104.48096637999909,105.36298076923066,107.67496595902212,103.0509955794392,94.91617140000017,97.62593720000001,100.40343720000001,104.54296849999996,107.19791666666669,3191300,3932805.05,70.82107450261454,NaN,1.5,2.75,NaN,NaN,1.247745347772548,0.8114564437919444,NaN,0.06451722849893615,1.7865792342141873,1.7220620057152511,15.447200657196808,2.2592152199762188,NaN,NaN,NaN,102580776
889799400,107.84375,108,106.875,107.09375,NaN,NaN,96.28492647058823,97.04605263157895,95.02609330000017,97.7540622,100.6028122,104.76796849999997,101.7228293736141,104.72980291523727,105.65865384615374,107.7902135093327,103.52709418297478,95.02609330000017,97.7540622,100.6028122,104.76796849999997,107.32291666666667,2879400,3825540.1,67.85295477763168,NaN,1.5,2.75,NaN,NaN,1.2389778229316517,0.7526780336193574,NaN,0.045242522181326184,1.7786151584419088,1.7333726362605826,15.795571759790597,2.0851951146857313,NaN,NaN,NaN,99701376
890058600,107.84375,108.375,107.53125,108.25,NaN,NaN,96.41299019607843,97.01644736842105,95.14429645000018,97.8803122,100.82656220000001,105.08046849999997,101.97879684915866,105.06505978045277,105.94471153846143,108.3719153653412,103.51750771158167,95.14429645000018,97.8803122,100.82656220000001,105.08046849999997,108.05208333333333,3223600,3881655.1,71.51241919494402,NaN,1.5,2.75,NaN,NaN,1.2419972641508195,0.8304704866746146,NaN,0.08877616823817824,1.8443428465583054,1.7555666783201271,16.32914808212774,2.6066350710900474,NaN,NaN,NaN,102924976
890145000,108.3125,108.5625,107.65625,108.5625,NaN,NaN,96.54105392156863,96.98684210526316,95.26132770000018,97.9910935,101.04656220000001,105.38359349999996,102.23698128644655,105.39814932517156,106.20913461538451,108.95020234401977,103.46806688674926,95.26132770000018,97.9910935,101.04656220000001,105.38359349999996,108.26041666666667,4581898,3957975,72.42602490610952,NaN,1.5,2.75,NaN,NaN,1.2180153167114753,1.1576369229214434,NaN,0.11534627440997403,1.8997495213325948,1.7844032469226208,16.25096565787485,3.5778175313059033,NaN,NaN,NaN,107506874
890231400,108.25,108.96875,108.03125,108.96875,NaN,NaN,96.66911764705883,96.95723684210526,95.38226520000018,98.11234350000001,101.2703122,105.66015599999996,102.50097221638983,105.73820653229808,106.5048076923076,109.52893405156254,103.48068133305264,95.38226520000018,98.11234350000001,101.2703122,105.66015599999996,108.65625,1944100,3904810,73.6108563430717,NaN,1.5,2.75,NaN,NaN,1.1979785083749412,0.49787313595283766,NaN,0.13561112204101944,1.9539171494738952,1.8183060274328757,15.10870548355241,4.935299428227506,NaN,NaN,NaN,109450974
890317800,108.96875,109.375,108.65625,109.25,NaN,NaN,96.79718137254902,96.92763157894737,95.50601520000018,98.2554685,101.53093720000001,105.97812499999995,102.76563997260983,106.07266305303159,106.83894230769221,110.03757916372247,103.64030545166194,95.50601520000018,98.2554685,101.53093720000001,105.97812499999995,109.09375,2554800,3863160,74.43002135698994,NaN,1.5,2.75,NaN,NaN,1.163747900633874,0.6613238902867082,NaN,0.14257534581734577,1.9965252097045578,1.853949863887212,12.66536503396984,3.1268436578171093,NaN,NaN,NaN,112005774
890404200,109.5625,110.1875,108.875,109.875,NaN,NaN,96.92524509803921,96.89802631578948,95.63335895000019,98.4142185,101.79906220000001,106.28906249999996,103.04443840505651,106.4347903813143,107.17548076923066,110.64863835199839,103.70232318646293,95.63335895000019,98.4142185,101.79906220000001,106.28906249999996,109.64583333333333,3123300,3833975,76.19820730984691,NaN,1.5,2.75,NaN,NaN,1.1743730505885972,0.8146375498014463,NaN,0.16245028400341854,2.0570127188914853,1.8945624348880667,8.499799122262287,4.085257548845471,NaN,NaN,NaN,115129074
890663400,109.71875,110.3125,109.40625,109.625,NaN,NaN,97.0533088235294,96.86842105263158,95.75789020000019,98.63859350000001,102.07906220000001,106.56718749999996,103.3024996440739,106.73861986880817,107.54567307692297,110.95782748538078,104.13351866846516,95.75789020000019,98.63859350000001,102.07906220000001,106.56718749999996,109.78125,4453102,3895240.1,73.99406745922346,NaN,1.5,2.75,NaN,NaN,1.155221404117983,1.143216306486473,NaN,0.13316481785992007,2.061018457212967,1.9278536393530468,8.131016588815898,2.873900293255132,NaN,NaN,NaN,110675972
890749800,110.0625,110.8125,109.9375,110.5625,NaN,NaN,97.18137254901961,96.83881578947368,95.87882770000019,98.82203100000001,102.4440622,106.93281249999995,103.58720554038473,107.10279892892169,108.0624999999999,111.08872750048099,105.03627249951882,95.87882770000019,98.82203100000001,102.4440622,106.93281249999995,110.4375,3333600,3892580.1,76.71426416353478,NaN,1.5,2.75,NaN,NaN,1.1575270181095558,0.8563985619717883,NaN,0.15008172143222898,2.115455791143333,1.965374069711104,7.913296548645723,3.269118505545826,NaN,NaN,NaN,114009572
890836200,111.40625,111.53125,109.1875,110.15625,NaN,NaN,97.3094362745098,96.8092105263158,95.99554645000018,99.003906,102.76718720000001,107.21406249999995,103.84481512703631,107.3936037928339,108.38701923076913,111.33595752383043,105.43808093770782,95.99554645000018,99.003906,102.76718720000001,107.21406249999995,110.29166666666667,4597602,3948370.2,73.14389798035043,NaN,1.5,2.75,NaN,NaN,1.2422572311017304,1.164430326214092,NaN,0.1089735108580947,2.1015909582837224,1.9926174474256277,8.916856484849392,2.4709302325581395,NaN,NaN,NaN,109411970
890922600,109.875,110.75,109.625,110.09375,NaN,NaN,97.4375,96.77960526315789,96.1106246000002,99.20546850000001,103.06281220000001,107.46249999999995,104.0898713965643,107.65076057446876,108.73557692307682,111.31468764777168,106.15646619838196,96.1106246000002,99.20546850000001,103.06281220000001,107.46249999999995,110.15625,3333500,3955665.2,72.5842047085646,NaN,1.5,2.75,NaN,NaN,1.2338817145944638,0.8427154047314216,NaN,0.055340192459631954,2.0617926880001676,2.0064524955405356,9.07913886932344,2.8012839217974905,NaN,NaN,NaN,106078470
891009000,110.75,110.78125,109,109.625,NaN,NaN,97.5655637254902,96.75,96.22234335000019,99.3810935,103.34031220000001,107.68749999999996,104.3069352633657,107.83878337690031,108.97115384615374,111.25593595611444,106.68637173619304,96.22234335000019,99.3810935,103.34031220000001,107.68749999999996,109.80208333333333,2611300,3914085.2,68.35931263617707,NaN,1.5,2.75,NaN,NaN,1.2729794492662878,0.6671546138035013,NaN,-0.02938413111486926,1.969722331646949,1.9991064627618182,9.201707531892557,1.2702078521939955,NaN,NaN,NaN,103467170
891268200,109.625,110.09375,108.96875,109.5625,NaN,NaN,97.69362745098039,96.72039473684211,96.32531210000019,99.5367185,103.6324998,107.92031249999995,104.51303584127292,108.00294686481456,109.16346153846143,111.17815424119468,107.14876883572819,96.32531210000019,99.5367185,103.6324998,107.92031249999995,109.54166666666667,3108700,3856905.15,67.79270829126922,NaN,1.5,2.75,NaN,NaN,1.2624094886044102,0.8060089317985951,NaN,-0.10316140705422372,1.8701547039440385,1.9733161109982622,7.570712665490864,0.9211283822682786,NaN,NaN,NaN,100358470
891354600,110.15625,111.1875,109.75,109.9375,NaN,NaN,97.8216911764706,96.6907894736842,96.4264058500002,99.6960935,103.9049998,108.14218749999995,104.72575992592888,108.18719002054651,109.35096153846143,111.1540961365319,107.54782694039096,96.4264058500002,99.6960935,103.9049998,108.14218749999995,110.29166666666667,5926500,3985770.15,69.42995535443521,NaN,1.5,2.75,NaN,NaN,1.2883088108469525,1.4869146430834703,NaN,-0.13805440526520596,1.8007481044167548,1.9388025096819608,7.6199457960554575,0.8890163464295956,NaN,NaN,NaN,106284970
891441000,110.3125,111.07812,109.40625,110.82812,NaN,NaN,97.94975490196079,96.66118421052632,96.53179645000019,99.8612497,104.1640622,108.44296849999996,104.96506816412776,108.43870716144684,109.63822076923066,111.06121519254309,108.21522634591823,96.53179645000019,99.8612497,104.1640622,108.44296849999996,110.43749666666668,2929000,3912015.05,72.94731121187075,NaN,1.5,2.75,NaN,NaN,1.3157060386435986,0.7487190009660112,NaN,-0.1135260251527237,1.7968949782410562,1.9104210033937798,8.489195124806548,1.4445034324942778,NaN,NaN,NaN,109213970
891527400,110.9375,112.25,110.75,112.03125,NaN,NaN,98.07781862745098,96.63157894736842,96.64382770000019,100.04203100000001,104.46593720000001,108.85234349999996,105.24217333416196,108.78085409845191,109.92908615384604,111.61892592122632,108.23924638646577,96.64382770000019,100.04203100000001,104.46593720000001,108.85234349999996,111.67708333333333,3920900,3744660.05,76.82631444450243,NaN,1.5,2.75,NaN,NaN,1.3288698930261986,1.047064338991199,NaN,-0.03283688761228021,1.8693748938784296,1.9022117814907098,9.978749366923081,1.9624573378839592,NaN,NaN,NaN,113134870
891613800,112.34375,112.8125,111.84375,112.59375,NaN,NaN,98.20588235294117,96.60197368421052,96.76023395000018,100.23859350000001,104.7962498,109.18515599999996,105.53047045831248,109.1439870414565,110.23918230769219,112.2593396134544,108.21902500192998,96.76023395000018,100.23859350000001,104.7962498,109.18515599999996,112.41666666666667,3787600,3589225,78.38667828385373,NaN,1.5,2.75,NaN,NaN,1.303147043524327,1.055269591624933,NaN,0.03801419868457012,1.9497295298464223,1.9117153311618522,9.905209316281788,2.708095781071836,NaN,NaN,NaN,116922470
891869400,113.25,113.375,111.6875,111.6875,NaN,NaN,98.33394607843137,96.57236842105263,96.86749960000019,100.4317185,105.11124980000001,109.49140599999996,105.77192259720219,109.3862263708416,110.44831692307682,112.46199374833476,108.43464009781887,96.86749960000019,100.4317185,105.11124980000001,109.49140599999996,112.25,4550500,3648610,70.18698630061891,NaN,1.5,2.75,NaN,NaN,1.3306008261297322,1.247187285020871,NaN,0.0051660182566297674,1.9181728539826395,1.9130068357260097,11.365876255937303,1.0175240248728095,NaN,NaN,NaN,112371970
891955800,111.75,111.9375,110.15625,110.9375,NaN,NaN,98.46200980392157,96.54276315789474,96.97429650000021,100.61703100000001,105.4124998,109.71015599999996,105.97449426005701,109.53396671647573,110.5781246153845,112.48056780671162,108.67568142405737,96.97429650000021,100.61703100000001,105.4124998,109.71015599999996,111.01041666666667,5583699,3653700.05,64.20151338125925,NaN,1.5,2.75,NaN,NaN,1.3627900528347514,1.5282313609733782,NaN,-0.08099716209776586,1.8117603831038025,1.8927575452015684,11.469453060866583,0.7092198581560284,NaN,NaN,NaN,106788271
892042200,111.21875,111.28125,109.75,110.3125,NaN,NaN,98.59007352941177,96.51315789473684,97.0888277500002,100.815156,105.6818748,109.87265599999996,106.14461213221163,109.60811274347805,110.61177846153835,112.47842015733585,108.74513676574085,97.0888277500002,100.815156,105.6818748,109.87265599999996,110.44791666666667,4854801,3724460.1,59.63732591156911,NaN,1.5,2.75,NaN,NaN,1.3748229062036976,1.303491209370185,NaN,-0.18789851833711824,1.6578843972801707,1.845782915617289,11.772765731207723,0.19869429463525404,NaN,NaN,NaN,101933470
892128600,110.5625,111.28125,110.53125,111.1875,NaN,NaN,98.71813725490196,96.48355263157895,97.1966402500002,101.00890600000001,105.9512498,110.05703099999997,106.34237244075236,109.75853057743252,110.73197076923066,112.52889673778591,108.9350448006754,97.1966402500002,101.00890600000001,105.9512498,110.05703099999997,111,4481199,3788955.05,63.54475373160289,NaN,1.5,2.75,NaN,NaN,1.345817698617719,1.1827004915247015,NaN,-0.20603946125799877,1.5882335890447905,1.7942730503027893,12.560674429421246,1.4253135689851768,NaN,NaN,NaN,106414669
892474200,111.375,111.375,110,110.875,NaN,NaN,98.84620098039215,96.45394736842105,97.3060152500002,101.187031,106.20374980000001,110.24609349999996,106.52012254111501,109.86486099862942,110.75600923076912,112.55158409423547,108.96043436730278,97.3060152500002,101.187031,106.20374980000001,110.24609349999996,110.75,4350199,3862495,61.263672696133106,NaN,1.5,2.75,NaN,NaN,1.3479021487164535,1.1262665712188624,NaN,-0.2429099886552062,1.4906355644837816,1.7335455531389878,12.364940269527011,1.1979463776383343,NaN,NaN,NaN,102064470
892560600,111.125,111.8125,110.90625,111.8125,NaN,NaN,98.97426470588235,96.42434210526316,97.4222652500002,101.35734350000001,106.47374980000001,110.42421849999997,106.72766675518893,110.05035042733138,110.88341307692296,112.72512954503084,109.04169660881509,97.4222652500002,101.35734350000001,106.47374980000001,110.42421849999997,111.51041666666667,3279100,3865270,65.28927307219186,NaN,1.5,2.75,NaN,NaN,1.318587709522421,0.8483495331503362,NaN,-0.20926132200611924,1.4719689006313388,1.681230222637458,12.971457580697495,1.7055144968732234,NaN,NaN,NaN,105343570
892647000,111.96875,112.125,111.15625,112.125,NaN,NaN,99.10232843137254,96.39473684210526,97.5383590000002,101.5367185,106.7174998,110.60234349999996,106.93932688243643,110.24793610091886,111.03966307692296,112.93088376810014,109.14844238574578,97.5383590000002,101.5367185,106.7174998,110.60234349999996,111.80208333333333,3867200,3829535.1,66.5376121771307,NaN,1.5,2.75,NaN,NaN,1.293599301699391,1.009835371400565,NaN,-0.17258560042414928,1.4654982221072714,1.6380838225314207,12.952027792622106,1.1701723353242857,NaN,NaN,NaN,109210770
892733400,111.3125,111.5,110.5,110.8125,NaN,NaN,99.23039215686275,96.36513157894737,97.6508590000002,101.69828100000001,106.9199998,110.69453099999996,107.09121602430167,110.30170409130754,111.13100923076912,112.84665523321088,109.41536322832737,97.6508590000002,101.69828100000001,106.9199998,110.69453099999996,110.9375,7177898,4091225,57.22837206644394,NaN,1.5,2.75,NaN,NaN,1.3172707801494343,1.754461805449468,NaN,-0.239245527592999,1.339026913040172,1.578272440633171,14.448746977315812,-1.0878661087866108,NaN,NaN,NaN,102032872
892819800,110.71875,112.4375,110.4375,112.28125,NaN,NaN,99.35845588235294,96.33552631578948,97.7655465000002,101.860156,107.1543748,110.84609349999997,107.2947467684467,110.49023227308777,111.34014384615374,112.89532692250624,109.78496076980123,97.7655465000002,101.860156,107.1543748,110.84609349999997,111.71875,5688801,4247925.05,63.39953331809044,NaN,1.5,2.75,NaN,NaN,1.3660371529959032,1.3391952383905643,NaN,-0.18914164747750428,1.3418453812862907,1.530987028763795,15.143186737082406,-0.2775464890369137,NaN,NaN,NaN,107721673
893079000,112,112.5625,111.875,112.25,NaN,NaN,99.48651960784314,96.30592105263158,97.87273400000021,102.015156,107.3893748,110.96484349999996,107.48907042458605,110.65782919946037,111.51802846153835,112.91136447950014,110.12469244357656,97.87273400000021,102.015156,107.3893748,110.96484349999996,112.22916666666667,3688300,4276175.05,63.190627465268626,NaN,1.5,2.75,NaN,NaN,1.317570213496196,0.8625231560620981,NaN,-0.16377440688790346,1.3262690201539158,1.4900434270418192,14.833373004431538,0.5036373810856184,NaN,NaN,NaN,104033373
893165400,112.4375,113.15625,111.90625,112.78125,NaN,NaN,99.61458333333333,96.27631578947368,97.9763277500002,102.1929685,107.61249980000001,111.12265599999996,107.69660687852385,110.8600597518927,111.66826923076913,113.15003712579755,110.1865013357407,97.9763277500002,102.1929685,107.61249980000001,111.12265599999996,112.61458333333333,4573199,4282179.9,65.2848243912731,NaN,1.5,2.75,NaN,NaN,1.3127437696750393,1.067960503013897,NaN,-0.11897069449497089,1.3413300589231056,1.4603007534180765,14.184601739557003,1.6619718309859155,NaN,NaN,NaN,108606572
893251800,112.875,113.4375,112.8125,113.09375,NaN,NaN,99.74264705882354,113.4375,98.0861715000002,102.37140600000001,107.84874980000001,111.24921849999996,107.9082595499543,111.07279215647435,111.7499999999999,113.40939921938174,110.09060078061806,98.0861715000002,102.37140600000001,107.84874980000001,111.24921849999996,113.11458333333331,2386100,4234804.9,66.49246402542329,NaN,1.5,2.75,NaN,NaN,1.2658513575553936,0.563449806152817,NaN,-0.07802221844307988,1.3627729803642268,1.4407951988073067,13.317954323844162,2.5212464589235126,NaN,NaN,NaN,110992672
893338200,112.625,113,111.75,112,NaN,NaN,99.87071078431373,113.64020270270271,98.18578090000021,102.5360935,108.0437498,111.34140599999996,108.06871995976,111.16109766538156,111.70432692307682,113.29977104241512,110.10888280373852,98.18578090000021,102.5360935,108.0437498,111.34140599999996,112.25,5062000,4258024.8,58.78459620487092,NaN,1.5,2.75,NaN,NaN,1.271415546301437,1.1888141186965375,NaN,-0.13120247794569084,1.276792101375193,1.407994579320884,14.328385849366287,0.7307476110174255,NaN,NaN,NaN,105930672
893424600,111.75,112.46875,110.34375,110.8125,NaN,NaN,99.99877450980392,113.8429054054054,98.2845309000002,102.68796850000001,108.2168748,111.37734349999997,108.17631917702431,111.12789788772618,111.63701923076913,113.30193911176038,109.97209934977788,98.2845309000002,102.68796850000001,108.2168748,111.37734349999997,111.20833333333331,11039699,4643334.75,51.768043114206705,NaN,1.5,2.75,NaN,NaN,1.3323858644227629,2.3775367477005616,NaN,-0.24627687723400316,1.1001484827783798,1.346425360012383,15.231096116542604,-0.05636978579481398,NaN,NaN,NaN,94890973
893683800,109.375,109.6875,107.625,108.71875,NaN,NaN,107.625,114.04560810810811,98.37078090000021,102.7942185,108.3393748,111.33203099999996,108.19759097400375,110.89845523175225,111.46634615384605,113.73025369765895,109.20243861003314,98.37078090000021,102.7942185,108.3393748,111.33203099999996,108.67708333333333,14510199,5238279.7,42.20313362558086,NaN,1.5,2.75,NaN,NaN,1.4648940169639941,2.770031352086831,NaN,-0.45138637710397833,0.78219238863241,1.2335787657363884,18.661329456860887,-2.76690888764673,NaN,NaN,NaN,80380774
893770200,109.78125,109.8125,108.125,108.5625,NaN,NaN,107.85720486111111,114.2483108108108,98.45468715000021,102.90484350000001,108.47062480000001,111.28203099999996,108.21190113188595,110.6759833049187,111.33173076923066,114.02202878291331,108.64143275554801,98.45468715000021,102.90484350000001,108.47062480000001,111.28203099999996,108.83333333333333,6511398,5408414.6,41.58562611266689,NaN,1.5,2.75,NaN,NaN,1.4807944443237087,1.2039383962908465,NaN,-0.5775004303320137,0.5117032278213713,1.089203658153385,17.47693084188518,-3.177257525083612,NaN,NaN,NaN,73869376
893856600,109.03125,109.96875,108.4375,109.3125,NaN,NaN,108.08940972222223,114.45101351351352,98.5409371500002,103.020156,108.6068748,111.25078099999996,108.25506187181199,110.5461277520693,111.1874999999999,114.08623148649949,108.28876851350032,98.5409371500002,103.020156,108.6068748,111.25078099999996,109.23958333333333,7703102,5497244.7,45.693132261829334,NaN,1.5,2.75,NaN,NaN,1.484398412586301,1.4012659833025078,NaN,-0.5883395628053829,0.35377920464665635,0.9421187674520393,18.113643127315623,-1.353637901861252,NaN,NaN,NaN,81572478
893943000,110.5625,111.92187,110.40625,111.34375,NaN,NaN,108.32161458333333,114.65371621621621,98.63499965000021,103.15671850000001,108.7649998,111.27656249999995,108.37618689644681,110.62209177568174,111.2235576923076,114.11750094407377,108.32961444054142,98.63499965000021,103.15671850000001,108.7649998,111.27656249999995,111.22395666666667,8684500,5785019.7,54.93544008077559,NaN,1.5,2.75,NaN,NaN,1.5647535259729939,1.501204913787934,NaN,-0.44325107632209515,0.38805492204942027,0.8313059983715154,20.5899965682162,-0.8349568605622043,NaN,NaN,NaN,90256978
894029400,111.75,112.59375,111.3125,112.59375,NaN,NaN,108.55381944444444,114.85641891891892,98.7292184000002,103.29328100000001,108.95906240000001,111.30468749999996,108.5415815279587,110.80986874942633,111.28365384615374,114.25542220432503,108.31188548798245,98.7292184000002,103.29328100000001,108.95906240000001,111.30468749999996,112.16666666666667,4008800,5789414.7,59.50295832883412,NaN,1.5,2.75,NaN,NaN,1.54450327411778,0.6924361455744394,NaN,-0.2568832482996951,0.5102019379968965,0.7670851862965916,20.16703506353063,0.3062360801781737,NaN,NaN,NaN,94265778
894288600,112.71875,113.3125,112.15625,112.3125,NaN,NaN,108.78602430555556,115.05912162162163,98.82437465000021,103.4298435,109.1321874,111.29062499999995,108.68946068372502,110.95297648757621,111.29807692307682,114.28780446653079,108.30834937962285,98.82437465000021,103.4298435,109.1321874,111.29062499999995,112.59375,4537199,5826894.65,58.076648405839606,NaN,1.5,2.75,NaN,NaN,1.5167708973950815,0.7786650132759823,NaN,-0.15154734705328776,0.5776510024799819,0.7291983495332697,20.229553048748112,-0.41562759767248547,NaN,NaN,NaN,89728579
894375000,112,112.15625,111.125,111.53125,NaN,NaN,109.01822916666667,115.26182432432432,98.92554655000022,103.564531,109.2815624,111.28281249999995,108.8009034020103,111.00805015542609,111.35336538461527,114.33169099589581,108.37503977333473,98.92554655000022,103.564531,109.2815624,111.28281249999995,111.60416666666667,5146398,5856689.55,54.190823072238686,NaN,1.5,2.75,NaN,NaN,1.4932515475811472,0.8787213247456492,NaN,-0.1340859945134465,0.5615908563914616,0.695676850904908,20.355830820512846,-1.3815971262779774,NaN,NaN,NaN,84582181
894461400,112.125,112.125,110.1875,110.21875,NaN,NaN,109.25043402777777,115.46452702702703,99.02007780000022,103.69453100000001,109.4209374,111.24687499999996,108.85650522938245,110.93287871205217,111.19471153846143,114.17815481793514,108.21126825898773,99.02007780000022,103.69453100000001,109.4209374,111.24687499999996,110.84375,5526102,5853809.7,48.33921430077567,NaN,1.5,2.75,NaN,NaN,1.5249835798967797,0.944018046913961,NaN,-0.20621558444244525,0.43790737035185145,0.6441229547942967,21.048655814442114,-1.5904017857142858,NaN,NaN,NaN,79056079
894547800,110.5,110.5625,109.34375,109.34375,NaN,NaN,109.48263888888889,115.66722972972973,99.09812470000023,103.83234350000001,109.5171874,111.19843749999995,108.87561286744588,110.78153312042815,110.97115384615374,114.03913966462096,107.90316802768652,99.09812470000023,103.83234350000001,109.5171874,111.19843749999995,109.75,6940398,5958089.55,44.86133019320492,NaN,1.5,2.75,NaN,NaN,1.5031097527612953,1.1648697022353416,NaN,-0.30232765420307595,0.2662133870404517,0.5685410412435277,20.855103705895726,-1.3254371122391426,NaN,NaN,NaN,72115681
894634200,110,111.375,110,111.125,NaN,NaN,109.71484375,115.86993243243244,99.18546845000023,103.98609350000001,109.6371874,111.19531249999996,108.96382412754605,110.81424425181595,110.8437499999999,113.73282507824658,107.95467492175322,99.18546845000023,103.98609350000001,109.6371874,111.19531249999996,110.83333333333333,7951000,6131579.6,52.37350444283636,NaN,1.5,2.75,NaN,NaN,1.5408340561354887,1.2967294757129142,NaN,-0.2382283887956136,0.2707555552490106,0.5089839440446242,22.57232850539151,2.2132796780684103,NaN,NaN,NaN,80066681
894893400,111.5625,112.21875,110.375,110.75,NaN,NaN,109.94704861111111,116.07263513513513,99.26874970000023,104.126406,109.7496874,111.18906249999995,109.0338702401913,110.808125751643,110.66346153846143,113.24449836685514,108.08242471006773,99.26874970000023,104.126406,109.7496874,111.18906249999995,111.11458333333331,6336301,6230884.7,50.80422504482982,NaN,1.5,2.75,NaN,NaN,1.5624709092686682,1.0169183518995304,NaN,-0.2141358186459298,0.24131417073721195,0.45544998938314174,19.200293632774454,2.0149683362118593,NaN,NaN,NaN,73730380
894979800,110.8125,111.96875,110.34375,111.9375,NaN,NaN,110.17925347222223,116.27533783783784,99.35828095000022,104.27265600000001,109.8903124,111.19531249999996,109.1477380739093,110.91568520386748,110.65865384615374,113.22992887064063,108.08737882166685,99.35828095000022,104.27265600000001,109.8903124,111.19531249999996,111.41666666666669,6045199,6369189.65,55.36511975448417,NaN,1.5,2.75,NaN,NaN,1.5669372728923345,0.9491315743753995,NaN,-0.11617848380266294,0.31022688462981307,0.426405368432476,19.690394159325145,2.4013722126929675,NaN,NaN,NaN,79775579
895066200,112.0625,112.5625,111.59375,112.21875,NaN,NaN,110.41145833333333,116.47804054054055,99.44953095000022,104.4267185,110.0246874,111.19999999999996,109.26816991414815,111.03978661302295,110.76682692307682,113.46983621747931,108.06381762867433,99.44953095000022,104.4267185,110.0246874,111.19999999999996,112.125,4441500,6397904.65,56.39619468690551,NaN,1.5,2.75,NaN,NaN,1.5242096105428822,0.6942116588123894,NaN,-0.03462919437671952,0.38311887546157664,0.41774806983829615,19.539417927200063,0.7858546168958742,NaN,NaN,NaN,84217079
895152600,111.53125,112.6875,111.34375,111.65625,NaN,NaN,110.64366319444444,116.68074324324324,99.53640595000023,104.58453100000001,110.16156240000001,111.24218749999996,109.36182011359331,111.09849741178267,110.99278846153835,113.45343470910696,108.53214221396975,99.53640595000023,104.58453100000001,110.16156240000001,111.24218749999996,111.89583333333333,4187500,6248384.75,53.72323335291426,NaN,1.5,2.75,NaN,NaN,1.511319638361248,0.6701731995616947,NaN,-0.02140632535462117,0.39099016314501966,0.41239648849964083,17.091530786806462,-0.832639467110741,NaN,NaN,NaN,80029579
895239000,112,112.21875,110.8125,111.03125,NaN,NaN,110.87586805555556,116.88344594594595,99.61453095000023,104.747031,110.3053124,111.17968749999996,109.42728795227593,111.0920928963748,111.18269230769221,113.20597121689948,109.15941339848493,99.61453095000023,104.747031,110.3053124,111.17968749999996,111.35416666666667,6716102,6299749.8,50.83993215994854,NaN,1.5,2.75,NaN,NaN,1.5038146641925874,1.0660902755217359,NaN,-0.05564211222588461,0.3428438482172851,0.3984859604431697,15.852083357390653,-1.14079020589872,NaN,NaN,NaN,73313477
895498200,110.71875,111.59375,109.82812,110.59375,NaN,NaN,111.10807291666667,117.08614864864865,99.69093720000022,104.89906230000001,110.3984374,111.09687499999995,109.4730315619906,111.04463166814863,111.2812499999999,113.03776260699115,109.52473739300865,99.69093720000022,104.89906230000001,110.3984374,111.09687499999995,110.67187333333334,4847199,6357694.75,48.86300457999653,NaN,1.5,2.75,NaN,NaN,1.5225157596074028,0.7624145528534537,NaN,-0.10573673706958453,0.26631503910618903,0.37205177617577356,15.910443901759544,-0.8405715886803026,NaN,NaN,NaN,68466278
895584600,111,111.6875,110.78125,111.34375,NaN,NaN,111.34027777777777,117.28885135135135,99.77296845000022,105.0756248,110.5140624,111.02499999999995,109.54639306936352,111.07311912832495,111.2812499999999,113.03776260699115,109.52473739300865,99.77296845000022,105.0756248,110.5140624,111.02499999999995,111.27083333333333,5918699,6424969.75,52.288156834679924,NaN,1.5,2.75,NaN,NaN,1.4918896339211598,0.9212026251174179,NaN,-0.08712086011032072,0.26315070103787264,0.35027156114819336,16.1433564436196,1.0206974766090162,NaN,NaN,NaN,74384977
895671000,112.09375,112.5,110.875,112.40625,NaN,NaN,111.57248263888889,117.49155405405405,99.85906220000022,105.26562480000001,110.63093740000001,110.99062499999995,109.65854432154534,111.20008397324638,111.26682692307682,112.98260063715779,109.55105320899585,99.85906220000022,105.26562480000001,110.63093740000001,110.99062499999995,111.92708333333333,5716602,6591494.85,56.7116749946658,NaN,1.5,2.75,NaN,NaN,1.5013975172125054,0.8672694328206901,NaN,-0.006272860790104584,0.3424304851605626,0.3487033459506672,15.112508584492444,2.8008002286367533,NaN,NaN,NaN,80101579
895757400,112.375,112.78125,111.3125,111.6875,NaN,NaN,111.8046875,117.69425675675676,99.94124970000023,105.4446873,110.72343740000001,110.97499999999995,109.7381112108965,111.24650454722291,111.2187499999999,112.84744402615216,109.59005597384764,99.94124970000023,105.4446873,110.72343740000001,110.97499999999995,111.92708333333333,6301500,6653469.85,53.12359064369106,NaN,1.5,2.75,NaN,NaN,1.4990655516973264,0.9470998053744845,NaN,-0.0043180750865641215,0.34330575209246206,0.3476238271790262,14.761417291959157,0.5061867266591676,NaN,NaN,NaN,73800079
895843800,111.75,112.0625,110.9375,111.25,NaN,NaN,112.03689236111111,117.89695945945945,100.01734345000023,105.6009373,110.7984374,110.99687499999996,109.79740096733194,111.2468374474874,111.19711538461527,112.81607320011136,109.57815756911918,100.01734345000023,105.6009373,110.7984374,110.99687499999996,111.41666666666667,4862199,6344594.85,51.00808554471579,NaN,1.5,2.75,NaN,NaN,1.4723465837189458,0.7663529531755681,NaN,-0.033955940643834004,0.30517890137423365,0.33913484201806765,12.02437836556506,0.45146726862302483,NaN,NaN,NaN,68937880
896189400,112.09375,112.09375,109.1875,109.46875,NaN,NaN,112.26909722222223,118.09966216216216,100.08812470000022,105.7243748,110.8459374,111.03437499999995,109.78451269410324,111.07749578582192,111.13942307692297,112.9372943115738,109.34155184227214,100.08812470000022,105.7243748,110.8459374,111.03437499999995,110.25,6899301,5964049.95,43.425713039942515,NaN,1.5,2.75,NaN,NaN,1.5747682563104495,1.1568147580655324,NaN,-0.16751939537092425,0.12973559780441235,0.2972549931753366,15.185873974820835,-2.2054718034617533,NaN,NaN,NaN,62038579
896275800,109.3125,109.90625,107.57812,109.625,NaN,NaN,112.50130208333333,118.30236486486487,100.16937470000022,105.8499998,110.8734374,111.08749999999995,109.77825729433448,110.93916285383888,111.1610576923076,112.87687182017,109.44524356444519,100.16937470000022,105.8499998,110.8734374,111.08749999999995,109.03645666666667,10202602,6148610.15,44.20915862198172,NaN,1.5,2.75,NaN,NaN,1.628579809431132,1.659334670941855,NaN,-0.23519124478203274,0.0032659371977956653,0.2384571819798284,13.374293719858468,-2.311333890281259,NaN,NaN,NaN,72241181
896362200,109.875,110.375,109.0625,110.125,NaN,NaN,112.73350694444444,118.50506756756756,100.24968720000022,105.9756248,110.9046874,111.12812499999995,109.79185504749783,110.86162353442565,111.08413461538451,112.88697435843282,109.2812948723362,100.24968720000022,105.9756248,110.9046874,111.12812499999995,109.85416666666669,4907602,6008835.15,46.75037118313139,NaN,1.5,2.75,NaN,NaN,1.6060026801860512,0.8167310098364072,NaN,-0.23554267198655016,-0.05597115800335928,0.17957151398319088,13.678096060826517,-1.3713965855023789,NaN,NaN,NaN,77148783
896448600,110.625,110.8125,109.03125,109.03125,NaN,NaN,112.96571180555556,118.70777027027027,100.33203095000023,106.0881248,110.9059374,111.01249999999996,109.76202739857635,110.68730224543273,110.95192307692297,113.05968907789487,108.84415707595106,100.33203095000023,106.0881248,110.9059374,111.01249999999996,109.625,4772602,5813240.25,42.220044557518804,NaN,1.5,2.75,NaN,NaN,1.6185203458870474,0.8209882603768183,NaN,-0.2948530926851046,-0.18899485187318987,0.10585824081191472,14.371068273732705,-1.8012946805516465,NaN,NaN,NaN,72376181
896707800,108.96875,110.21875,108.5625,109.53125,NaN,NaN,113.19791666666667,118.91047297297297,100.41828095000022,106.22124980000001,110.91156240000001,110.85937499999996,109.75297730451453,110.57720203158199,110.76682692307682,112.91805300805652,108.61560083809712,100.41828095000022,106.22124980000001,110.91156240000001,110.85937499999996,109.4375,6092199,5917410.2,44.85103019425045,NaN,1.5,2.75,NaN,NaN,1.6212153211808296,1.0295380570371815,NaN,-0.28562728647106245,-0.2511758672769133,0.03445141919414911,14.716432605731148,-0.9607233681831026,NaN,NaN,NaN,78468380
896794200,110,110.34375,109.15625,109.625,NaN,NaN,113.43012152777777,119.11317567567568,100.50328095000023,106.35281230000001,110.9065624,110.72499999999995,109.74795858669043,110.48651612381228,110.5673076923076,112.62182987291465,108.51278551170054,100.50328095000023,106.35281230000001,110.9065624,110.72499999999995,109.70833333333333,6701102,6025605.35,45.35347662704767,NaN,1.5,2.75,NaN,NaN,1.5902356553821988,1.1121043630910876,NaN,-0.25920285656583864,-0.28955215151314917,-0.03034929494731055,14.665556424478162,-1.5436429974740387,NaN,NaN,NaN,85169482
896880600,109.875,110.1875,107.875,107.875,NaN,NaN,113.66232638888889,119.31587837837839,100.59374970000023,106.4753123,110.8715624,110.54218749999995,109.67450923034963,110.23780030249682,110.27644230769221,112.67396283103152,107.8789217843529,100.59374970000023,106.4753123,110.8715624,110.54218749999995,108.64583333333331,6445102,6090540.55,38.332862958450605,NaN,1.5,2.75,NaN,NaN,1.6418259657120415,1.0582151037480574,NaN,-0.3404569167259664,-0.45592044085476857,-0.11546352412880216,16.099414003162988,-4.031137058659994,NaN,NaN,NaN,78724380
896967000,108.25,110.0625,108.0625,109.875,NaN,NaN,113.89453125,119.51858108108108,100.68421845000023,106.65093730000001,110.8578124,110.52499999999995,109.68237161347317,110.20324789273522,110.1874999999999,112.55197566964911,107.82302433035069,100.68421845000023,106.65093730000001,110.8578124,110.52499999999995,109.33333333333333,6566301,6142550.5,48.20152154296175,NaN,1.5,2.75,NaN,NaN,1.6808026824468956,1.0689860832238987,NaN,-0.24485008678368314,-0.4215261326084061,-0.17667604582472296,19.15905984281124,-1.6228315612758815,NaN,NaN,NaN,85290681
897053400,110.375,112,109.875,112,NaN,NaN,114.12673611111111,119.72128378378379,100.77999970000023,106.8309373,110.89468740000001,110.65781249999995,109.7732590011801,110.37436714104615,110.29567307692297,112.84596239222972,107.74538376161621,100.77999970000023,106.8309373,110.89468740000001,110.65781249999995,111.29166666666667,8463199,6218690.55,56.21846692943124,NaN,1.5,2.75,NaN,NaN,1.7125310622721173,1.3609294323223722,NaN,-0.034866874445331486,-0.22025963888138733,-0.18539276443605585,22.46398470120587,0.6741573033707865,NaN,NaN,NaN,93753880
897312600,111.9375,112.46875,111.65625,111.875,NaN,NaN,114.35894097222223,119.92398648648648,100.86812470000022,106.99656230000001,110.9303124,110.69531249999996,109.85568021682009,110.5172845561846,110.33653846153835,112.96841519648973,107.70466172658698,100.86812470000022,106.99656230000001,110.9303124,110.69531249999996,112,4159898,6029135.45,55.6726219009876,NaN,1.5,2.75,NaN,NaN,1.6482431292526802,0.6899659220626732,NaN,0.09228729663849139,-0.07003364363794162,-0.162320940276433,22.329408161890697,2.19811590065658,NaN,NaN,NaN,89593982
897399000,111.71875,112.42187,111.40625,112.21875,NaN,NaN,114.59114583333333,120.1266891891892,100.96624970000022,107.16124980000001,110.9821874,110.76874999999995,109.94834962008204,110.67932888416702,110.32211538461527,112.91015469754375,107.7340760716868,100.96624970000022,107.16124980000001,110.9821874,110.76874999999995,112.01562333333334,2725300,5848585.4,56.911612413090204,NaN,1.5,2.75,NaN,NaN,1.6030557628774886,0.46597592641803603,NaN,0.19056438606635528,0.0758845423065111,-0.11467984375984419,19.637281740367715,2.3660205245153936,NaN,NaN,NaN,92319282
897485400,111.625,113.0625,111.25,111.5,NaN,NaN,114.82335069444444,120.32939189189189,101.06093720000023,107.3267186,111.02093740000001,110.74687499999996,110.00919865458863,110.75748803805588,110.30769230769221,112.86706494833622,107.7483196670482,101.06093720000023,107.3267186,111.02093740000001,110.74687499999996,111.9375,6186898,5855670.35,53.541778009382455,NaN,1.5,2.75,NaN,NaN,1.6180160655290965,1.0565652829141927,NaN,0.19734943014197998,0.1320069439176308,-0.06534248622434918,20.295837498315294,1.2485811577752555,NaN,NaN,NaN,86132384
897571800,111.4375,111.875,109.375,109.40625,NaN,NaN,115.05555555555556,120.5320945945946,101.14687470000023,107.45765610000001,111.0103124,110.60624999999996,109.98555360931064,110.62879870109818,110.16586538461527,112.7049096067952,107.62682116243535,101.14687470000023,107.45765610000001,111.0103124,110.60624999999996,110.21875,8056602,6036425.45,45.154185347864846,NaN,1.5,2.75,NaN,NaN,1.6810149179913039,1.3346643749240703,NaN,0.05823426244380427,0.00745034183040616,-0.05078392061339811,23.333638642758743,0.34393809114359414,NaN,NaN,NaN,78075782
897658200,109.875,110.4375,108.25,110.4375,NaN,NaN,115.28776041666667,120.73479729729729,101.24476535000024,107.58328110000001,111.0025,110.54531249999995,110.00327699718082,110.61057977718407,110.24038461538451,112.7499078969369,107.73086133383212,101.24476535000024,107.58328110000001,111.0025,110.54531249999995,109.70833333333333,9779000,6316000.45,49.3618953869132,NaN,1.5,2.75,NaN,NaN,1.717192423849068,1.5482899466861184,NaN,0.03426178729678224,-0.007956686492420317,-0.04221847378920256,23.14713986395496,0.8273894436519258,NaN,NaN,NaN,87854782
897917400,108.8125,109.90625,107.5,107.53125,NaN,NaN,107.5,120.9375,101.32539035000023,107.6892186,110.9125,110.37031249999995,109.90633476199726,110.31731027459512,110.07932692307682,112.96648926021847,107.19216458593517,101.32539035000023,107.6892186,110.9125,110.37031249999995,108.3125,10234199,6491905.3,40.03920170826377,NaN,1.5,2.75,NaN,NaN,1.8043572507169916,1.5764553743567393,NaN,-0.16764494290970552,-0.25177465242633446,-0.08412970951662893,27.952357780207432,-1.9099201824401368,NaN,NaN,NaN,77620583
898003800,108.40625,109.21875,107.75,109.1875,NaN,NaN,107.49632352941177,121.14020270270271,101.42124975000024,107.8203124,110.844375,110.29999999999995,109.87814516348756,110.20970929606224,110.00721153846143,112.93278612928182,107.08163694764104,101.42124975000024,107.8203124,110.844375,110.29999999999995,108.71875,7471500,6623120.35,46.2674336224803,NaN,1.5,2.75,NaN,NaN,1.7960103042372064,1.1280936484870006,NaN,-0.17894294469157507,-0.30780839038109775,-0.12886544568952268,29.63368724392066,1.216685979142526,NaN,NaN,NaN,85092083
898090200,110.15625,111.78125,109.9375,111.46875,NaN,NaN,107.49264705882354,121.3429054054054,101.52671850000024,107.9756249,110.84,110.30624999999995,109.94052182374296,110.32961793453251,110.19471153846143,113.15824732848515,107.23117574843772,101.52671850000024,107.9756249,110.84,110.30624999999995,111.0625,12057699,6930070.35,53.440965162378816,NaN,1.5,2.75,NaN,NaN,1.852991711077406,1.7399100429045429,NaN,-0.029884941225706424,-0.1662216222216557,-0.13633668099594928,30.018007978716664,1.4505119453924915,NaN,NaN,NaN,97149782
898176600,111.1875,111.4375,110.75,110.96875,NaN,NaN,107.48897058823529,121.54560810810811,101.61499975000024,108.1265624,110.840625,110.23437499999996,109.98084449732167,110.39048765505322,110.30528846153835,113.26882425156207,107.34175267151464,101.61499975000024,108.1265624,110.840625,110.23437499999996,111.05208333333333,3844600,6836470.25,51.80837489231281,NaN,1.5,2.75,NaN,NaN,1.7719744460004485,0.5623662298537758,NaN,0.03444246920230104,-0.093283594493073,-0.12772606369537404,28.65137227145797,-0.9207589285714286,NaN,NaN,NaN,93305182
898263000,111.0625,111.23437,109.625,110.0625,NaN,NaN,107.48529411764706,121.7483108108108,101.70124975000024,108.2587499,110.835625,110.15312499999996,109.9840466738973,110.35925073552434,110.33894230769221,113.28066862030087,107.39721599508354,101.70124975000024,108.2587499,110.835625,110.15312499999996,110.30729000000001,3549100,6698850.25,48.89288668805642,NaN,1.5,2.75,NaN,NaN,1.7603598427147022,0.5298073352214434,NaN,0.016285808987672595,-0.10736880246078329,-0.12365461144845588,26.532632490586106,-1.6201117318435754,NaN,NaN,NaN,89756082
898522200,110.25,111.0625,110.0625,110.59375,NaN,NaN,107.48161764705883,121.95101351351352,101.78718725000024,108.38749990000001,110.82375,110.12031249999995,110.00795660825426,110.38158399880774,110.54807692307682,113.12310672414557,107.97304712200807,101.78718725000024,108.38749990000001,110.82375,110.12031249999995,110.57291666666667,5438301,6727655.35,50.64623116009264,NaN,1.5,2.75,NaN,NaN,1.7060484253779378,0.8083501185892349,NaN,0.03908230649206909,-0.07480172833336951,-0.1138840348254386,26.800383419156415,-1.4480646059593427,NaN,NaN,NaN,95194383
898608600,111.09375,112.0625,111,111.90625,NaN,NaN,107.4779411764706,122.15371621621622,101.88101540000025,108.5240624,110.844375,110.24218749999996,110.08239948636194,110.52679028463558,110.70432692307682,113.34275587276416,108.06589797338948,101.88101540000025,108.5240624,110.844375,110.24218749999996,111.65625,5004602,6632920.4,54.77438114524879,NaN,1.5,2.75,NaN,NaN,1.6890985378509422,0.7545095822346971,NaN,0.1361208931671566,0.05626708163350713,-0.07985381153364945,27.752269628034238,0.36434977578475336,NaN,NaN,NaN,100198985
898695000,112.15625,113.6875,111.60937,113.40625,NaN,NaN,107.47426470588235,122.35641891891892,101.98031230000026,108.6749999,110.87625,110.43124999999995,110.21274656532813,110.80102454324171,110.8124999999999,113.75260727173082,107.87239272826898,101.98031230000026,108.6749999,110.87625,110.43124999999995,112.90104000000001,8291898,6537385.2,58.995638490078484,NaN,1.5,2.75,NaN,NaN,1.716886499433018,1.268381431768775,NaN,0.2862616248798392,0.2779732195661495,-0.008288405313689656,28.45390224545705,3.656098257640674,NaN,NaN,NaN,108490883
898781400,113.90625,114.4375,112.8125,113.21875,NaN,NaN,107.47058823529412,122.55912162162163,102.07843730000026,108.8078124,110.898125,110.58593749999996,110.33062905296232,111.03128411055202,110.91586538461527,114.08378076699134,107.74795000223921,102.07843730000026,108.8078124,110.898125,110.58593749999996,113.48958333333331,5854801,6584745.15,58.2635743534633,NaN,1.5,2.75,NaN,NaN,1.7103231780449453,0.8891461805473215,NaN,0.35347037125022573,0.4335495587490925,0.08007918749886679,25.438618350557576,2.518392756083758,NaN,NaN,NaN,102636082
898867800,113.3125,113.84375,113.125,113.6875,NaN,NaN,107.46691176470588,122.76182432432432,102.18859355000026,108.9378124,110.955625,110.81874999999995,110.46227105088536,111.28425705240421,111.02884615384605,114.46774111019131,107.58995119750078,102.18859355000026,108.9378124,110.955625,110.81874999999995,113.55208333333333,4833102,6587770.15,59.61283930796737,NaN,1.5,2.75,NaN,NaN,1.6394965224703064,0.7336476364464537,NaN,0.40625047373023393,0.5878922796616592,0.1816418059314253,25.166441887300532,5.725079918628306,NaN,NaN,NaN,107469184
899127000,114.25,114.6875,113.79687,114.09375,NaN,NaN,107.46323529411765,122.96452702702703,102.30312480000026,109.0731249,110.991875,111.04687499999996,110.60468199006633,111.5518278093181,111.22836538461527,115.03478271195799,107.42194805727256,102.30312480000026,109.0731249,110.991875,111.04687499999996,114.19270666666667,5953398,6580830.1,60.795749885459855,NaN,1.5,2.75,NaN,NaN,1.593818199436713,0.9046576054288349,NaN,0.4423056305678033,0.7345238441411794,0.29221821357337613,16.763773461252683,4.4934172867773325,NaN,NaN,NaN,113422582
899213400,113.90625,114.1875,113.0625,113.3125,NaN,NaN,107.4595588235294,123.16722972972973,102.40640605000026,109.20124990000001,111.013125,111.23124999999996,110.71087093163236,111.71951087509733,111.52884615384605,115.32918627799782,107.72850602969427,102.40640605000026,109.20124990000001,111.013125,111.23124999999996,113.52083333333333,4284801,6460015.05,57.318886114182746,NaN,1.5,2.75,NaN,NaN,1.5603311851912334,0.6632803432865068,NaN,0.38919626480819847,0.7787135445836242,0.3895172797754257,17.055051447069307,1.6540510232688534,NaN,NaN,NaN,109137781
899299800,114.0625,114.9375,113.625,114.625,NaN,NaN,107.45588235294117,123.36993243243244,102.51703105000026,109.3312499,111.05,111.56874999999995,110.8643661892154,111.99622412508806,111.85096153846143,115.92658043364273,107.77534264328014,102.51703105000026,109.3312499,111.05,111.56874999999995,114.39583333333333,3489500,6312234.95,61.320951685803244,NaN,1.5,2.75,NaN,NaN,1.5649503862490024,0.5528152908820354,NaN,0.41571556100516877,0.9091617310318867,0.4934461700267179,14.31638141311553,3.294846522106449,NaN,NaN,NaN,112627281
899386200,114.71875,114.875,114.25,114.84375,NaN,NaN,107.45220588235294,123.57263513513513,102.61718730000025,109.46687490000001,111.085,111.81718749999996,111.02042045630499,112.26741706555586,112.41346153846143,115.9290649654254,108.89785811149747,102.61718730000025,109.46687490000001,111.085,111.81718749999996,114.65625,3503900,6159114.9,61.9611423753178,NaN,1.5,2.75,NaN,NaN,1.4978110729455023,0.5688966770209142,NaN,0.4200063048705578,1.0184540511149152,0.5984477462443574,13.578032569589427,4.34412265758092,NaN,NaN,NaN,116131181
899731800,114.78125,116,114.5625,116,NaN,NaN,107.44852941176471,123.77533783783784,102.72312480000026,109.6043749,111.165,112.01718749999995,111.2156980854695,112.62290115455055,112.9374999999999,116.40402952145948,109.47097047854032,102.72312480000026,109.6043749,111.165,112.01718749999995,115.52083333333333,3144400,5893174.95,65.23640840275748,NaN,1.5,2.75,NaN,NaN,1.4935031391636806,0.5335663757954445,NaN,0.4690114753913148,1.184712090483501,0.7157006150921861,11.776518711725457,4.888386549872846,NaN,NaN,NaN,119275581
899818200,115.98437,116.125,115.28125,115.78125,NaN,NaN,107.44485294117646,123.97804054054055,102.82593730000026,109.7406249,111.264375,112.21249999999995,111.39473933701971,112.9236962826886,113.26923076923066,116.92999092811748,109.60847061034384,102.82593730000026,109.7406249,111.264375,112.21249999999995,115.72916666666667,4920699,5931215,64.11170644637477,NaN,1.5,2.75,NaN,NaN,1.447092200651989,0.8296274877912873,NaN,0.45465559048839377,1.2840201032026783,0.8293645127142846,12.47368554714468,3.4627199106394864,NaN,NaN,NaN,114354882
899904600,115.875,116.9375,115.75,116.625,NaN,NaN,107.44117647058823,124.18074324324324,102.93390605000026,109.88093740000001,111.4225,112.43281249999995,111.59984759831306,113.27620139862302,113.70432692307682,117.50965714419759,109.89899670195605,102.93390605000026,109.88093740000001,111.4225,112.43281249999995,116.4375,6875000,6138700,66.51005474153052,NaN,1.5,2.75,NaN,NaN,1.4285499006054183,1.1199439620766611,NaN,0.4681087985102812,1.414500510852136,0.9463917123418548,11.767001192538173,2.838247451088454,NaN,NaN,NaN,121229882
899991000,116.28125,116.71875,115.625,115.84375,NaN,NaN,107.4375,124.38344594594595,103.03531230000026,110.0193749,111.568125,112.64999999999995,111.76627514347726,113.5207298368494,114.14903846153835,117.4682129641468,110.8298639589299,103.03531230000026,110.0193749,111.568125,112.64999999999995,116.0625,6942500,6176480.1,62.354866297678875,NaN,1.5,2.75,NaN,NaN,1.4046356219907457,1.1240220785298087,NaN,0.3935163494867271,1.4382871492002636,1.0447707997135365,11.661844649800242,2.3185205630692796,NaN,NaN,NaN,114287382
900077400,116.03125,116.9375,115.0625,116.46875,NaN,NaN,107.43382352941177,124.58614864864865,103.14203105000026,110.1590624,111.71125,113.00312499999995,111.95068592216442,113.80149366191137,114.60096153846143,117.42344955606916,111.77847352085371,103.14203105000026,110.1590624,111.71125,113.00312499999995,116.15625,7849699,6166134.95,64.27759823494236,NaN,1.5,2.75,NaN,NaN,1.4382330775628351,1.273033928652502,NaN,0.35649553417384494,1.4903902174308428,1.1338946832569978,11.525546498446333,2.4463991203958217,NaN,NaN,NaN,122137081
900336600,116.5625,116.84375,116.0625,116.5,NaN,NaN,107.43014705882354,124.78885135135135,103.25281230000026,110.2896874,111.814375,113.30624999999995,112.12909039580504,114.05849426553885,114.95432692307682,117.47272263025454,112.4359312158991,103.25281230000026,110.2896874,111.814375,113.30624999999995,116.46875,6555102,6004940.05,64.3755726042389,NaN,1.5,2.75,NaN,NaN,1.3913057148797756,1.0916182252310747,NaN,0.3062603199742622,1.5167200832248255,1.2104597632505634,11.57888697281501,2.1090112298000547,NaN,NaN,NaN,128692183
900423000,116.9375,118.15625,116.9375,117.8125,NaN,NaN,107.42647058823529,124.99155405405405,103.37343730000026,110.4389062,111.91875,113.82031249999996,112.35196920381269,114.41601862120181,115.29326923076913,118.06075499241146,112.5257834691268,103.37343730000026,110.4389062,111.91875,113.82031249999996,117.63541666666667,6983602,5842410.2,68.30715213634568,NaN,1.5,2.75,NaN,NaN,1.4102303066740773,1.1953289414700803,NaN,0.33144434204310036,1.624765190804439,1.2933208487613386,12.628804485851743,3.971318257032543,NaN,NaN,NaN,135675785
900509400,118.0625,118.28125,117.53125,117.59375,NaN,NaN,107.42279411764706,125.19425675675676,103.48906230000026,110.5782812,112.024375,114.24062499999995,112.55752923503572,114.71865970489688,115.6298076923076,118.37026821758282,112.88934716703237,103.48906230000026,110.5782812,112.024375,114.24062499999995,117.80208333333333,4977500,5717710.2,66.98036840447938,NaN,1.5,2.75,NaN,NaN,1.3630709990545002,0.8705407979578957,NaN,0.3041032658194933,1.6734499310357052,1.3693466652162118,11.43950442759608,2.589967284623773,NaN,NaN,NaN,130698285
900595800,117.6875,118.59375,117.0625,118.40625,NaN,NaN,107.41911764705883,125.39695945945945,103.60421855000025,110.7217187,112.161875,114.58749999999995,112.78689083366177,115.06985878062099,115.99278846153835,118.85534030082616,113.13023662225055,103.60421855000025,110.7217187,112.161875,114.58749999999995,118.02083333333333,6315602,5430605.35,69.36087967643829,NaN,1.5,2.75,NaN,NaN,1.3750837848363218,1.1629646407651406,NaN,0.3103925929164584,1.7573374063617848,1.4469448134453264,10.559948354785412,3.1020408163265305,NaN,NaN,NaN,137013887
900682200,118.625,119,118.3125,118.5625,NaN,NaN,107.4154411764706,125.59966216216216,103.72515605000027,110.8748437,112.32875,114.96718749999995,113.01338531077307,115.40249127770471,116.33653846153835,119.27655925455718,113.39651766851952,103.72515605000027,110.8748437,112.32875,114.96718749999995,118.625,3539500,5415350.35,69.8116125907985,NaN,1.5,2.75,NaN,NaN,1.325970657348013,0.6536049879025833,NaN,0.2948433189809756,1.8154989621715458,1.5206556431905702,10.592478929804606,2.209051724137931,NaN,NaN,NaN,140553387
900941400,118.75,119.23437,117.9375,118.5625,NaN,NaN,107.41176470588235,119.23437,103.83984355000025,111.0151562,112.513125,115.39218749999995,113.23099765152708,115.70344448935188,116.74038461538451,119.32923652618135,114.15153270458768,103.83984355000025,111.0151562,112.513125,115.39218749999995,118.57812333333334,2338400,5354815.35,69.81161259079849,NaN,1.5,2.75,NaN,NaN,1.3238920389660118,0.43669106162549565,NaN,0.2557776340998732,1.8403776858154117,1.5846000517155385,9.757719005819592,2.4021592442645074,NaN,NaN,NaN,140553387
901027800,119,119,116.28125,116.5,NaN,NaN,107.40808823529412,119.3294006557377,103.94156230000026,111.1289062,112.620625,115.68749999999996,113.35919382205543,115.77930691893742,116.88461538461527,119.17805091319059,114.59117985603996,103.94156230000026,111.1289062,112.620625,115.68749999999996,117.26041666666667,5518602,5358830.4,56.979337182415094,NaN,1.5,2.75,NaN,NaN,1.4235247504684396,1.0298146401498356,NaN,0.07181330559055965,1.674366683703738,1.6025533781131784,14.911354720015144,-0.10718113612004287,NaN,NaN,NaN,135034785
901114200,116.34375,116.98437,115.53125,116.5,NaN,NaN,107.40441176470588,119.4244313114754,104.04085920000027,111.2426562,112.735625,115.91718749999995,113.48236269177875,115.8479443552291,117.01201923076913,119.00170695716947,115.02233150436878,104.04085920000027,111.2426562,112.735625,115.91718749999995,116.33854000000002,10417301,5629465.35,56.979337182415094,NaN,1.5,2.75,NaN,NaN,1.425638696863551,1.8504956247754507,NaN,-0.06186671693046142,1.5252199819501016,1.587086698880563,14.29897701989815,0.566495818721338,NaN,NaN,NaN,135034785
901200600,116.3125,116.59375,113.90625,114.1875,NaN,NaN,107.40073529411765,119.51946196721312,104.12539045000027,111.3354687,112.780625,115.95624999999995,113.5100151352384,115.68980679758823,116.87259615384605,119.32630967812672,114.41888262956537,104.12539045000027,111.3354687,112.780625,115.95624999999995,114.89583333333333,15110898,5970415.35,45.98744552049068,NaN,1.5,2.75,NaN,NaN,1.515771647087583,2.5309626071492666,NaN,-0.3044591237666918,1.2065127941721983,1.51097191793889,18.08775293620103,-1.9586799034075664,NaN,NaN,NaN,119923887
901287000,114.96875,115.09375,112.875,114.09375,NaN,NaN,107.3970588235294,119.61449262295082,104.20492170000027,111.4214062,112.818125,115.99999999999996,113.53290669856239,115.53780138829411,116.74278846153835,119.56463764962496,113.92093927345175,104.20492170000027,111.4214062,112.818125,115.99999999999996,114.02083333333333,11540500,6254700.3,45.603361603484394,NaN,1.5,2.75,NaN,NaN,1.5659843865813272,1.845092401949299,NaN,-0.4603092427526472,0.9355853644980812,1.3958946072507283,17.57617156385587,-2.065450643776824,NaN,NaN,NaN,108383387
901546200,113.625,115,112.84375,114.90625,NaN,NaN,107.39338235294117,119.70952327868852,104.29195295000027,111.52234370000001,112.883125,116.06093749999995,113.58676329861876,115.47765363702801,116.61057692307682,119.59829370237738,113.62286014377626,104.29195295000027,111.52234370000001,112.883125,116.06093749999995,114.25,9600000,6493045.2,49.537018850189014,NaN,1.5,2.75,NaN,NaN,1.6081462161112323,1.478505031814656,NaN,-0.4947371597140804,0.777473157608128,1.2722103173222084,18.32600100751181,-2.46684350132626,NaN,NaN,NaN,117983387
901632600,114.4375,114.65625,111.875,112.96875,NaN,NaN,107.38970588235294,119.80455393442622,104.37101545000027,111.6135937,112.921875,116.00468749999996,113.56252748298665,115.23871043350154,116.38942307692297,119.94340372914934,112.8354424246966,104.37101545000027,111.6135937,112.921875,116.00468749999996,113.16666666666667,13693000,6880025.3,41.77847736867382,NaN,1.5,2.75,NaN,NaN,1.7097964863890014,1.9902543090938924,NaN,-0.6256261939254979,0.49017757491533587,1.1158037688408338,18.389506357194843,-3.9330321551953227,NaN,NaN,NaN,104290387
901719000,113.71875,114.125,112.25,112.53125,NaN,NaN,107.38602941176471,119.89958459016393,104.44929670000027,111.6795312,112.960625,115.96562499999996,113.52208522875188,114.98085705888235,116.08653846153835,120.19044386628039,111.98263305679632,104.44929670000027,111.6795312,112.960625,115.96562499999996,112.96875,7462398,7038905.15,40.24566037406543,NaN,1.5,2.75,NaN,NaN,1.7215967373612155,1.0601645910799067,NaN,-0.712961343835968,0.22460208904587375,0.9375634328818417,18.332031324186044,-4.961731327527052,NaN,NaN,NaN,96827989
901805400,113.625,114.59375,113.40625,114.21875,NaN,NaN,107.38235294117646,119.99461524590164,104.53554670000027,111.7660937,113.018125,115.94531249999996,113.54940541585965,114.9082754342269,115.9110576923076,120.12290897152994,111.69920641308525,104.53554670000027,111.7660937,113.018125,115.94531249999996,114.07291666666667,6821602,7205510.25,48.14796728440074,NaN,1.5,2.75,NaN,NaN,1.745946970406843,0.9467201854303101,NaN,-0.6311819912403596,0.14858594383139234,0.7797679350717519,20.56655704513354,-3.6636794939377966,NaN,NaN,NaN,103649591
901891800,114.34375,114.5,111.3125,111.78125,NaN,NaN,107.37867647058823,120.08964590163934,104.60945295000027,111.8182812,113.005625,115.79218749999995,113.48006598778673,114.61046348811004,115.44711538461527,120.03122415890333,110.86300661032722,104.60945295000027,111.8182812,113.005625,115.79218749999995,112.53125,7680500,7414340.25,39.93306168866297,NaN,1.5,2.75,NaN,NaN,1.8489150439492115,1.0358979681300706,NaN,-0.7095012253781808,-0.10710859665097416,0.6023926287272067,22.647407024871708,-5.719557195571956,NaN,NaN,NaN,95969091
902151000,111.78125,112.42187,111.03125,111.3125,NaN,NaN,107.375,120.18467655737705,104.68210920000027,111.8607812,112.998125,115.55781249999995,113.3950634000304,114.29637172733766,114.96394230769221,119.85499367789623,110.07289093748818,104.68210920000027,111.8607812,112.998125,115.55781249999995,111.58854000000001,10486500,7781445.25,38.570181609238304,NaN,1.5,2.75,NaN,NaN,1.816179683667125,1.3476288354017527,NaN,-0.7568034059345602,-0.3436116286909936,0.4131917772435666,22.37495570384597,-4.452789699570816,NaN,NaN,NaN,85482591
902237400,112.21875,112.21875,107,107,NaN,NaN,107.37132352941177,120.27970721311475,104.74085920000027,111.8557812,112.913125,115.11874999999995,113.1442766000292,113.60147918187693,114.08653846153835,120.14560042514074,108.02747649793596,104.74085920000027,111.8557812,112.913125,115.11874999999995,108.73958333333333,15091602,8289990.4,28.823709950789308,NaN,1.5,2.75,NaN,NaN,2.0592204205480447,1.8204607329822722,NaN,-1.0257592769897868,-0.8690073189936669,0.15675195799611985,28.9708782712563,-8.15450643776824,NaN,NaN,NaN,70390989
902323800,107.9375,108.875,105.59375,108.46875,NaN,NaN,107.36764705882354,120.37473786885246,104.81179670000027,111.8695312,112.893125,114.71093749999996,112.96092261571432,113.11264783122198,113.31009615384605,119.46209031628054,107.15810199141156,104.81179670000027,111.8695312,112.893125,114.71093749999996,107.64583333333333,21718400,9032160.4,34.86097762591338,NaN,1.5,2.75,NaN,NaN,2.146508247651756,2.4045631430548995,NaN,-1.0482604940870248,-1.1535736596126611,-0.10531316552563635,31.385115850399067,-5.008210180623974,NaN,NaN,NaN,92109389
902410200,108.125,109.5,107.5625,108.9375,NaN,NaN,107.36397058823529,120.46976852459017,104.87835920000026,111.8764062,112.879375,114.36562499999995,112.8031413366667,112.71501470443893,112.56971153846143,118.31851753103854,106.82090554588433,104.87835920000026,111.8764062,112.879375,114.36562499999995,108.66666666666667,13084398,9339255.3,36.70618194742033,NaN,1.5,2.75,NaN,NaN,2.131579087105202,1.4010108493339934,NaN,-0.9765376238320586,-1.3259851953157096,-0.349447571483651,30.829487378484494,-4.519309778142975,NaN,NaN,NaN,105193787
902496600,109.6875,110.59375,108.46875,109.125,NaN,NaN,107.36029411764706,120.56479918032787,104.93656235000027,111.8820312,112.859375,113.99843749999995,112.65890049993467,112.37310854211141,112.00240384615374,117.5395088816954,106.46529881061208,104.93656235000027,111.8820312,112.859375,113.99843749999995,109.39583333333331,12083801,9550960.4,37.46921227731621,NaN,1.5,2.75,NaN,NaN,2.1311091523119736,1.2651922418189483,NaN,-0.8652397435945887,-1.430997250976887,-0.5657575073822982,30.980407630662423,-5.031275496328528,NaN,NaN,NaN,117277588
902755800,108.75,109.65625,108.1875,108.5,NaN,NaN,107.35661764705883,120.65982983606557,104.99484360000028,111.8773437,112.84875,113.59843749999996,112.49580636268233,112.00424106191032,111.38701923076913,116.55374306054733,106.22029540099092,104.99484360000028,111.8773437,112.84875,113.59843749999996,108.78125,6273000,9536855.3,35.91496751152451,NaN,1.5,2.75,NaN,NaN,2.0837977842896898,0.6577639906101962,NaN,-0.7848512280447062,-1.546821542438181,-0.7619703143934748,30.09477195730759,-3.955739972337483,NaN,NaN,NaN,111004588
902842200,106.78125,107.4375,105.5,106.875,NaN,NaN,107.3529411764706,120.75486049180327,105.05453110000028,111.8535937,112.795625,113.05156249999996,112.27538258375361,111.51574191315696,110.82451923076913,116.23565327749712,105.41338518404113,105.05453110000028,111.8535937,112.795625,113.05156249999996,106.60416666666667,14287102,9902030.3,32.177671514038565,NaN,1.5,2.75,NaN,NaN,2.149240799697569,1.4428457161962025,NaN,-0.7900790313978332,-1.7495691036407663,-0.9594900722429331,29.852071806572113,-5.0263815606775895,NaN,NaN,NaN,96717486
902928600,107.75,108.875,107.5,108.6875,NaN,NaN,107.34926470588235,120.84989114754099,105.12796860000027,111.8417187,112.776875,112.60624999999996,112.13468130595935,111.24638554047534,110.40865384615374,115.57636177632453,105.24094591598295,105.12796860000027,111.8417187,112.776875,112.60624999999996,108.35416666666667,11158398,10211075.2,39.71319795697277,NaN,1.5,2.75,NaN,NaN,2.138580742576314,1.092774049886539,NaN,-0.6275214653829799,-1.743891903971658,-1.1163704385886781,32.511850409983886,-4.8426812585499315,NaN,NaN,NaN,107875884
903015000,108.8125,109.65625,107.375,107.375,NaN,NaN,107.34558823529412,120.94492180327869,105.22890610000027,111.81921870000001,112.766875,112.05468749999996,111.9480271370982,110.87768215566817,109.82932692307682,114.51657790266165,105.14207594349199,105.22890610000027,111.81921870000001,112.766875,112.05468749999996,108.13541666666667,9073898,10348990,36.54659372547984,NaN,1.5,2.75,NaN,NaN,2.148771403820863,0.8767906819892569,NaN,-0.5663207676912605,-1.8242713982027539,-1.2579506305114934,30.574012698636686,-3.941850712887895,NaN,NaN,NaN,98801986
903101400,108.34375,108.71875,105.78125,106.125,NaN,NaN,107.34191176470588,121.03995245901639,105.29843735000027,111.7748437,112.691875,111.43281249999995,111.71967313172179,110.42504575989025,109.30288461538451,113.99876715968652,104.6070020710825,105.29843735000027,111.7748437,112.691875,111.43281249999995,106.875,8628500,10603440,33.78371562400393,NaN,1.5,2.75,NaN,NaN,2.2051091606908013,0.8137453505654768,NaN,-0.5665774695848835,-1.9661724674925978,-1.3995949979077142,29.255826685267888,-4.660303200449186,NaN,NaN,NaN,90173486
903360600,106,108.9375,105.5,108.375,NaN,NaN,107.33823529411765,121.13498311475409,105.38046860000027,111.7570312,112.619375,110.92343749999995,111.5885094794974,110.22980330656738,108.98317307692297,113.30757939627516,104.65876675757077,105.38046860000027,111.7570312,112.619375,110.92343749999995,107.60416666666667,11290000,11051020,42.24712955204399,NaN,1.5,2.75,NaN,NaN,2.2931370777843156,1.0216251531532836,NaN,-0.3806878541516412,-1.8754548155972657,-1.4947669614456245,32.90019171330161,1.2850467289719627,NaN,NaN,NaN,101463486
903447000,109,110.59375,108.78125,110.375,NaN,NaN,107.3345588235294,121.2300137704918,105.48265610000027,111.7598437,112.589375,110.61718749999996,111.54092087245829,110.24363156308478,108.6874999999999,111.92981710237639,105.44518289762341,105.48265610000027,111.7598437,112.589375,110.61718749999996,109.91666666666667,7603898,11155284.8,48.54302086462336,NaN,1.5,2.75,NaN,NaN,2.287823715085436,0.6816408667576107,NaN,-0.10295672540996414,-1.6234628682080796,-1.5205061427981155,25.010419874680963,1.7574186113511956,NaN,NaN,NaN,109067384
903533400,111.09375,111.09375,109.625,110.09375,NaN,NaN,107.33088235294117,121.32504442622951,105.57281235000028,111.76453120000001,112.546875,110.29687499999996,111.48416907353835,110.22935712850527,108.55769230769221,111.40526699203394,105.71011762335047,105.57281235000028,111.76453120000001,112.546875,110.29687499999996,110.27083333333333,6258602,10947349.85,47.75462148567859,NaN,1.5,2.75,NaN,NaN,2.2293184497221907,0.5717001909827519,NaN,0.07243037352925774,-1.4299681758865432,-1.502398549415801,24.23191347683386,1.0613884107860012,NaN,NaN,NaN,102808782
903619800,109.6875,110.40625,109.15625,109.4375,NaN,NaN,107.32720588235294,121.42007508196721,105.64999985000027,111.7632812,112.505625,110.05937499999996,111.40390754124273,110.15394216388572,108.41346153846143,110.84832868732397,105.9785943895989,105.64999985000027,111.7632812,112.505625,110.05937499999996,109.66666666666667,7402801,10561945,45.88211068604591,NaN,1.5,2.75,NaN,NaN,2.1593671318848915,0.7008937274337255,NaN,0.1503794283777551,-1.3144242639436072,-1.4648036923213623,24.51021547290551,0.286368843069874,NaN,NaN,NaN,95405981
903706200,108.1875,108.71875,105.5,108.5625,NaN,NaN,107.32352941176471,121.51510573770491,105.72281235000028,111.7495312,112.48875,109.78281249999995,111.29247979452732,110.00237624351564,108.53365384615374,110.82775444534798,106.2395532469595,105.72281235000028,111.7495312,112.48875,109.78281249999995,107.59375,16685398,10819189.9,43.436500829782226,NaN,1.5,2.75,NaN,NaN,2.286376622464542,1.5422040054958273,NaN,0.14886712752290343,-1.278719782917733,-1.4275869104406365,24.959628581431772,0.0576036866359447,NaN,NaN,NaN,78720583
903965400,109.25,109.9375,108.3125,109.25,NaN,NaN,107.31985294117646,121.61013639344262,105.79749985000028,111.73375,112.465,109.49999999999996,111.21238254768312,109.93072136318082,108.5937499999999,110.91862592722272,106.26887407277708,105.79749985000028,111.73375,112.465,109.49999999999996,109.16666666666667,7201699,10699274.85,45.877517951545684,NaN,1.5,2.75,NaN,NaN,2.239135435145646,0.6731015980956878,NaN,0.19700506706399068,-1.181330576610648,-1.3783356436746388,24.994591329127246,2.2222222222222223,NaN,NaN,NaN,85922282
904051800,110.375,111.25,108.64062,109.5,NaN,NaN,107.31617647058823,111.25,105.87523425000029,111.7084375,112.504375,109.32656249999995,111.14523029091123,109.88970028097313,108.63701923076913,111.00638735867103,106.26765110286722,105.87523425000029,111.7084375,112.504375,109.32656249999995,109.79687333333334,9688301,10499039.9,46.776986552272824,NaN,1.5,2.75,NaN,NaN,2.2655814754923855,0.9227797105523906,NaN,0.24537010274723903,-1.07162301524059,-1.316993117987829,22.885852778391456,0.7475560667050029,NaN,NaN,NaN,95610583
904138200,108.28125,109.625,107.75,108.875,NaN,NaN,107.3125,110.94290884615384,105.95492175000028,111.67125,112.498125,109.14374999999995,111.05620165205197,109.79306215897569,108.61778846153835,110.97502897542117,106.26054794765554,105.95492175000028,111.67125,112.498125,109.14374999999995,108.75,9339699,10592904.95,44.77364302738326,NaN,1.5,2.75,NaN,NaN,2.237682798671501,0.8816938360237058,NaN,0.23494239886497992,-1.023315119406604,-1.2582575182715838,21.30443282640344,1.3969732246798603,NaN,NaN,NaN,86270884
904224600,107,107.5625,103.46875,103.75,NaN,NaN,107.30882352941177,110.6358176923077,106.01179675000029,111.591875,112.34375,108.62031249999995,110.76968394020679,109.21753242954944,108.25240384615374,111.76084674831014,104.74396094399734,106.01179675000029,111.591875,112.34375,108.62031249999995,104.92708333333333,24887808,11496215.25,32.487039211016906,NaN,1.5,2.75,NaN,NaN,2.4640090273378226,2.1648696948328277,NaN,-0.09950378613429534,-1.382637250939453,-1.2831334648051578,34.721974502600496,-2.237926972909305,NaN,NaN,NaN,61383076
904311000,104.96875,105.71875,102.15625,103.375,NaN,NaN,107.30514705882354,110.32872653846154,106.06664050000029,111.51625,112.191875,108.19999999999996,110.47969633470848,108.66110076959235,107.98317307692297,112.31389790249814,103.65244825134779,106.06664050000029,111.51625,112.191875,108.19999999999996,103.75,23735904,12298985.45,31.799415814464453,NaN,1.5,2.75,NaN,NaN,2.542472668242264,1.9299074786693078,NaN,-0.31614556376275926,-1.678315419508607,-1.3621698557458477,34.32555938225984,-4.61361014994233,NaN,NaN,NaN,37647172
904570200,103.75,104.01562,95,96,NaN,NaN,107.30147058823529,110.02163538461538,106.09414050000028,111.373125,111.910625,107.43437499999996,109.91186510589638,107.45528164867879,107.00721153846143,114.68679837592487,99.327624700998,106.09414050000028,111.373125,111.910625,107.43437499999996,98.33854000000002,22563104,12902815.65,21.95657363749696,NaN,1.5,2.75,NaN,NaN,3.0048403347963877,1.7486961460229806,NaN,-0.8935961881691465,-2.479165090957281,-1.5855689027881343,50.05692823303951,-13.023782559456398,NaN,NaN,NaN,15084068
904656600,96.0625,100.5625,93.625,100.0625,NaN,NaN,93.625,109.71454423076923,106.13539050000028,111.261875,111.7,107.08749999999995,109.52561549390045,106.75120720594748,106.44471153846143,114.95990419143293,97.92951888548994,106.13539050000028,111.261875,111.7,107.08749999999995,98.08333333333333,24748496,13385660.35,34.063721446958795,NaN,1.5,2.75,NaN,NaN,3.2857445965966456,1.8488812171302405,NaN,-0.9349726754004037,-2.754284747038639,-1.8193120716382354,56.53384354324281,-9.111552653988078,NaN,NaN,NaN,39832564
904743000,99.8125,101.75,98.78125,99.34375,NaN,NaN,93.37272727272727,109.40745307692308,106.16679675000029,111.1465625,111.44875,106.63124999999995,109.12632665100239,106.04573509109534,105.92307692307682,115.24528776680162,96.60086607935202,106.16679675000029,111.1465625,111.44875,106.63124999999995,99.95833333333333,13843199,12991900.3,33.08577298272692,NaN,1.5,2.75,NaN,NaN,3.2631021254111707,1.0655253412004708,NaN,-0.9411764683755233,-2.9957826571076396,-2.0546061887321163,56.37841799737273,-9.223300970873787,NaN,NaN,NaN,25989365
904829400,97.625,99.375,96.75,98.5625,NaN,NaN,93.12045454545455,109.10036192307692,106.18570300000029,111.0140625,111.151875,106.11249999999995,108.71205893919837,105.33304603480055,105.16826923076913,115.14048238198038,95.19605607955788,106.18570300000029,111.0140625,111.151875,106.11249999999995,98.22916666666667,17311296,13203245.2,32.01003409380414,NaN,1.5,2.75,NaN,NaN,3.2175234021675156,1.3111394765280888,NaN,-0.9268529573569309,-3.2131723854282797,-2.286319428071349,56.33579944237073,-9.211283822682786,NaN,NaN,NaN,8678069
904915800,99.4375,99.8125,95.75,97.75,NaN,NaN,92.86818181818182,108.79327076923077,106.20351550000028,110.8703125,110.8425,105.54374999999996,108.28217427491609,104.61085117434335,104.19711538461527,114.40806305331667,93.98616771591388,106.20351550000028,110.8703125,110.8425,105.54374999999996,97.77083333333333,17783808,13488245.55,30.88533605625871,NaN,1.5,2.75,NaN,NaN,3.2778788734412645,1.3184671004154427,NaN,-0.9002960086125333,-3.4116894388370156,-2.5113934302244822,56.33203000484479,-10.526315789473685,NaN,NaN,NaN,-9105739
905261400,100.875,103,99.8125,103,NaN,NaN,92.61590909090908,108.48617961538461,106.24523425000028,110.7921875,110.62875,105.26874999999995,108.0750301857037,104.45743677678685,103.65144230769221,113.28548670195283,94.01739791343158,106.24523425000028,110.7921875,110.62875,105.26874999999995,101.9375,14746500,13911920.55,44.46369786771731,NaN,1.5,2.75,NaN,NaN,3.4187446681954596,1.0599902398091254,NaN,-0.4785169936297433,-3.1095396722616613,-2.631022678631918,66.57936519465663,-5.936073059360731,NaN,NaN,NaN,5640761
905347800,102.75,103.125,100.4375,100.5,NaN,NaN,92.36363636363636,108.17908846153846,106.26726550000029,110.674375,110.356875,104.94999999999996,107.7779701784212,104.08053803614048,102.96394230769221,112.11156462624523,93.81631998913919,106.26726550000029,110.674375,110.356875,104.94999999999996,101.35416666666667,12109699,13803050.4,40.39402334936266,NaN,1.5,2.75,NaN,NaN,3.366512906181498,0.8773204943162418,NaN,-0.3246270547390768,-3.036806497055764,-2.712179442316687,67.1524306460619,-7.6923076923076925,NaN,NaN,NaN,-6468938
905434200,98.4375,99.34375,96.8125,98.5,NaN,NaN,92.11136363636363,107.87199730769231,106.27601550000028,110.536875,110.060625,104.44062499999995,107.41412821063997,103.54905822317473,102.18990384615374,111.00860602596228,93.3712016663452,106.27601550000028,110.536875,110.060625,104.44062499999995,98.21875,19889296,14239595.3,37.44157141184805,NaN,1.5,2.75,NaN,NaN,3.3894405557399625,1.3967599205575736,NaN,-0.31406324112495687,-3.1047584937228834,-2.7906952525979265,67.43449752352828,-5.0602409638554215,NaN,NaN,NaN,-26358234
905520600,98.1875,101.6875,97,101.6875,NaN,NaN,91.85909090909091,107.56490615384615,106.30945300000029,110.4259375,109.801875,104.15624999999996,107.18955455532075,103.37176696382475,101.60817307692297,109.42844288189443,93.7879032719515,106.30945300000029,110.4259375,109.801875,104.15624999999996,100.125,20379808,14804890.8,44.414741166738374,NaN,1.5,2.75,NaN,NaN,3.4821590874728225,1.3765591570590983,NaN,-0.06211729400209931,-2.8683418701005508,-2.8062245760984514,66.48612198814877,-1.6324062877871826,NaN,NaN,NaN,-5978426
905779800,102.875,104.45312,102.09375,103.4375,NaN,NaN,91.60681818181818,107.25781500000001,106.35039050000029,110.329375,109.57375,104.02187499999995,107.04241516099445,103.3780272529843,101.14182692307682,107.63436217930045,94.64929166685319,106.35039050000029,110.329375,109.57375,104.02187499999995,103.32812333333335,10686801,14907805.85,47.85157207906707,NaN,1.5,2.75,NaN,NaN,3.4309777240819064,0.7168594163037078,NaN,0.23631856132605567,-2.5108263744408816,-2.7471449357669373,67.35423186046559,7.747395833333333,NaN,NaN,NaN,4708375
905866200,102.875,104.3125,102.28125,104.0625,NaN,NaN,91.35454545454546,106.95072384615385,106.39304675000028,110.25,109.335,103.80624999999995,106.92555574291623,103.44321513365246,100.77163461538451,105.8538543175067,95.68941491326233,106.39304675000028,110.25,109.335,103.80624999999995,103.55208333333333,8337898,14760200.75,49.06289366187253,NaN,1.5,2.75,NaN,NaN,3.33099717236177,0.5648905554350269,NaN,0.4759154001814614,-2.1522506855401105,-2.628166085721572,48.09293407101757,3.9975015615240475,NaN,NaN,NaN,13046273
905952600,104.75,105.25,103.15625,105,NaN,NaN,91.10227272727273,106.64363269230769,106.43992175000028,110.191875,109.119375,103.53749999999995,106.85004375299795,103.59148035901889,100.86778846153835,106.21229913874409,95.52327778433262,106.43992175000028,110.191875,109.119375,103.53749999999995,104.46875,11024898,14931250.75,50.90506845713253,NaN,1.5,2.75,NaN,NaN,3.2426223743359297,0.7383773927981218,NaN,0.6849313336833442,-1.7720019186173914,-2.4569332523007357,43.22008711918377,5.693614344133375,NaN,NaN,NaN,24071171
906039000,102.25,103.03125,101.78125,102,NaN,NaN,90.85,106.33654153846155,106.45945300000028,110.1246875,108.826875,103.13281249999996,106.65984595876273,103.43991080101709,100.76201923076913,105.95617844481701,95.56786001672124,106.45945300000028,110.1246875,108.826875,103.13281249999996,102.27083333333333,12945199,15265580.6,45.26373680183643,NaN,1.5,2.75,NaN,NaN,3.240917204740506,0.8479991255622469,NaN,0.610979639204714,-1.693208703294843,-2.304188342499557,47.06348329856334,3.4876347495244135,NaN,NaN,NaN,11125972
906125400,102.375,102.40625,101.09375,102.09375,NaN,NaN,90.59772727272727,106.02945038461539,106.48242175000028,110.06,108.551875,102.76562499999996,106.48078337214459,103.31170501044403,101.23076923076913,105.66569795911447,96.79584050242379,106.48242175000028,110.06,108.551875,102.76562499999996,101.86458333333333,7019199,15246400.5,45.46711938136213,NaN,1.5,2.75,NaN,NaN,3.103173118687613,0.46038400998320883,NaN,0.5595893387754698,-1.60470166903022,-2.16429100780569,46.61238556391218,4.443734015345268,NaN,NaN,NaN,18145171
906384600,99.625,103.40625,98.9375,102.03125,NaN,NaN,90.34545454545454,105.72235923076923,106.50367175000028,109.9871875,108.263125,102.43906249999995,106.3062918673546,103.18975691421126,101.38221153846143,105.78153635050212,96.98288672642074,106.50367175000028,109.9871875,108.263125,102.43906249999995,101.45833333333333,8834602,14853860.7,45.34615083589139,NaN,1.5,2.75,NaN,NaN,3.200714324495641,0.5947680659210707,NaN,0.5137871202486188,-1.5220571074949163,-2.035844227743535,46.108566726552674,-0.9405339805825242,NaN,NaN,NaN,9310569
906471000,103.5,103.65625,102.15625,102.875,NaN,NaN,90.09318181818182,105.41526807692308,106.52960925000029,109.9025,107.990625,102.12031249999995,106.17173140196815,103.15978006523876,101.65384615384605,105.95105717487243,97.35663513281966,106.52960925000029,109.9025,107.990625,102.12031249999995,102.89583333333333,7270102,14857280.85,47.3814684655974,NaN,1.5,2.75,NaN,NaN,3.088163301317381,0.48932924358093427,NaN,0.5305521642380739,-1.3726540224459427,-1.9032061866840166,34.911120939375685,2.36318407960199,NaN,NaN,NaN,16580671
906557400,103.875,107,103.78125,107,NaN,NaN,89.8409090909091,107,106.56992175000029,109.8465625,107.774375,101.99531249999995,106.20421252345959,103.52551529712079,102.30288461538451,107.06049394399872,97.5452752867703,106.56992175000029,109.8465625,107.774375,101.99531249999995,105.92708333333333,13688500,15057290.8,56.00706646106978,NaN,1.5,2.75,NaN,NaN,3.1622230655089965,0.9090944833183403,NaN,0.7938467786343266,-0.9108977133911083,-1.7047444920254349,37.67304501113516,8.629441624365482,NaN,NaN,NaN,30269171
906643800,106.3125,106.8125,103.25,104.375,NaN,NaN,89.58863636363637,106.7875,106.59851550000029,109.7671875,107.51,101.77031249999996,106.13247869901019,103.60641860215691,102.8124999999999,106.87932462125731,98.74567537874249,106.59851550000029,109.7671875,107.51,101.77031249999996,104.8125,11129500,15146780.85,50.350600447092525,NaN,1.5,2.75,NaN,NaN,3.204207132258354,0.7347765911593024,NaN,0.7652804447733115,-0.7481439360587956,-1.513424380832107,38.95923448694773,2.642901044867855,NaN,NaN,NaN,19139671
906730200,103.125,105.42187,102.625,104.25,NaN,NaN,89.33636363636364,106.575,106.62945300000028,109.694375,107.226875,101.79531249999995,106.05865600493136,103.66771206861816,102.90865384615374,107.04714152301624,98.77016616929124,106.62945300000028,109.694375,107.226875,101.79531249999995,104.09895666666667,10247398,14414760.35,50.09116525958098,NaN,1.5,2.75,NaN,NaN,3.1751116228113285,0.7108961752527506,NaN,0.7130787478656553,-0.622075946000038,-1.3351546938656933,35.327464253718105,0.7854984894259819,NaN,NaN,NaN,8892273
906989400,105.3125,106.3125,104.25,105.1875,NaN,NaN,89.0840909090909,106.3625,106.66929675000029,109.6440625,106.959375,101.88593749999995,106.02449302434582,103.81245377636881,103.26923076923066,107.32136536084698,99.21709617761434,106.66929675000029,109.6440625,106.959375,101.88593749999995,105.25,8847801,13670355.2,52.0852314366616,NaN,1.5,2.75,NaN,NaN,3.0956393640390907,0.6472253917732876,NaN,0.7149803796034264,-0.4414292193614102,-1.1564095989648366,34.39982305240676,1.0810810810810811,NaN,NaN,NaN,17740074
907075800,105.375,105.9375,103.375,104.9375,NaN,NaN,88.83181818181818,106.15,106.71617175000029,109.6,106.686875,102.33281249999996,105.98186584692048,103.91960103576226,103.76442307692297,106.81346290300088,100.71538325084505,106.71617175000029,109.6,106.686875,102.33281249999996,104.75,10618102,13073105.1,51.49438391369256,NaN,1.5,2.75,NaN,NaN,3.057557980893441,0.8122096409979906,NaN,0.6732801822082548,-0.31480937120451813,-0.9880895534127729,34.34942627267537,-0.05952380952380952,NaN,NaN,NaN,7121972
907162200,103.5,104.3125,101.375,101.75,NaN,NaN,88.57954545454545,105.9375,106.74617175000029,109.50625,106.391875,102.41718749999995,105.81591032351184,103.71297236568967,103.76923076923066,106.80532557533466,100.73313596312666,106.74617175000029,109.50625,106.391875,102.41718749999995,102.47916666666667,7908398,12231100.2,44.55456833601428,NaN,1.5,2.75,NaN,NaN,3.093625267972481,0.6465810818882834,NaN,0.41743826708390874,-0.46629171955788706,-0.8837299866417958,38.266055029066244,-0.24509803921568626,NaN,NaN,NaN,-786426
907248600,100.03125,101.54687,98.09375,98.8125,NaN,NaN,88.32727272727273,105.725,106.75664050000029,109.386875,106.038125,102.39062499999996,105.54126678141334,103.24626071181446,103.41346153846143,107.44303623852295,99.38388683839992,106.75664050000029,109.386875,106.038125,102.39062499999996,99.48437333333335,13335602,12205720.35,39.29833561600604,NaN,1.5,2.75,NaN,NaN,3.13381274883159,1.0925698457444997,NaN,0.05579111755556543,-0.813991089697339,-0.8697822072529044,38.34210450513018,-3.2139577594123048,NaN,NaN,NaN,-14122028
907335000,98.875,100.875,97.21875,100.71875,NaN,NaN,88.075,105.5125,106.77367175000029,109.2746875,105.76875,102.49843749999995,105.35214847625987,103.00554540592736,103.1562499999999,107.40801716654683,98.90448283345297,106.77367175000029,109.2746875,105.76875,102.49843749999995,99.60416666666667,14351801,12057745.6,43.921756317756916,NaN,1.5,2.75,NaN,NaN,3.171129695343619,1.1902557473098454,NaN,-0.04422491206280976,-0.9250633473314167,-0.880838435268607,40.41230730478745,-1.2863705972434916,NaN,NaN,NaN,229773
907594200,99.59375,99.96875,96.34375,98.6875,NaN,NaN,87.82272727272728,105.3,106.78304675000028,109.139375,105.460625,102.54531249999995,105.09078971248498,102.59430298631523,102.67067307692297,107.3858551452986,97.95549100854733,106.78304675000028,109.139375,105.460625,102.54531249999995,98.33333333333333,12807199,11808915.15,40.39138964853842,NaN,1.5,2.75,NaN,NaN,3.257120431390504,1.0845364571867553,NaN,-0.22619387257912593,-1.1635807759925143,-0.9373869034133884,41.841489585402215,-4.070473876063184,NaN,NaN,NaN,-12577426
907680600,100.75,101.28125,97.53125,98.59375,NaN,NaN,87.57045454545454,105.0875,106.79664050000028,109.00875,105.134375,102.32499999999996,104.83600384140713,102.21329793999949,102.40865384615374,107.59846806225933,97.21883963004815,106.79664050000028,109.00875,105.134375,102.32499999999996,99.13541666666667,12621000,11702640.15,40.23066226335152,NaN,1.5,2.75,NaN,NaN,3.2923261148626106,1.0784745867794627,NaN,-0.32582796365380373,-1.344671857980643,-1.0188438943268392,41.24148718807032,-7.856308411214953,NaN,NaN,NaN,-25198426
907767000,98.625,100.03125,95.75,97.125,NaN,NaN,87.31818181818181,104.875,106.80835925000028,108.8696875,104.8175,102.15624999999996,104.53361153390097,101.72869813619002,102.02644230769221,107.9348399205923,96.11804469479212,106.80835925000028,108.8696875,104.8175,102.15624999999996,97.63541666666667,14348500,11814580.2,37.6996202924767,NaN,1.5,2.75,NaN,NaN,3.362963535229567,1.2144739598957566,NaN,-0.45563982987417506,-1.588393681669558,-1.132753851795383,30.702803669483966,-6.946107784431137,NaN,NaN,NaN,-39546926
907853400,94.5625,96.75,92.21875,96.59375,NaN,NaN,92.21875,104.6625,106.81437490000029,108.7296875,104.49875,102.06093749999995,104.22224441492446,101.23965545655287,101.60817307692297,108.18773493510366,95.02861121874227,106.81437490000029,108.7296875,104.49875,102.06093749999995,95.1875,20625008,11851365.8,36.79784101622724,NaN,1.5,2.75,NaN,NaN,3.4731982827131693,1.740306421054019,NaN,-0.5366940332162149,-1.8036213933156517,-1.2669273600994369,29.181933384266365,-7.344124700239808,NaN,NaN,NaN,-60171934
907939800,97,98.78125,94.0625,98.53125,NaN,NaN,92.16466346153847,104.45,106.83859365000029,108.6015625,104.185,101.90312499999996,103.9990681633588,100.98171207973832,101.27403846153835,108.00184000509807,94.54623691797863,106.83859365000029,108.6015625,104.185,101.90312499999996,97.125,12708500,11467800.4,42.22566415057519,NaN,1.5,2.75,NaN,NaN,3.5621662625193715,1.1081898495547584,NaN,-0.4241657909704888,-1.7971345988125478,-1.372968807842059,33.13508339681068,-6.327985739750446,NaN,NaN,NaN,-47463434
908199000,100.625,101.4375,99.6875,99.96875,NaN,NaN,92.11057692307692,104.2375,106.8714061500003,108.4771875,103.94875,101.72968749999995,103.84101647067806,100.88523950071561,100.73317307692297,106.60932964192355,94.85701651192238,106.8714061500003,108.4771875,103.94875,101.72968749999995,100.36458333333333,9508500,11408885.35,45.93551675897508,NaN,1.5,2.75,NaN,NaN,3.5153151009108448,0.833429358635811,NaN,-0.22714481081945714,-1.6568998213663804,-1.4297550105469232,34.16012194039636,-4.734961286480048,NaN,NaN,NaN,-37954934
908285400,99.5625,100.40625,98.75,99.625,NaN,NaN,92.05649038461539,104.025,106.9006249000003,108.3565625,103.715,101.50781249999996,103.67568249143578,100.76521669112365,100.36778846153835,105.8716198328077,94.86395709026901,106.9006249000003,108.3565625,103.715,101.50781249999996,99.59375,6256801,11304830.5,45.18826508189183,NaN,1.5,2.75,NaN,NaN,3.3825247365600704,0.5534626105185744,NaN,-0.10065108949167167,-1.5555688724115129,-1.4549177829198412,34.13473810405064,-2.0884520884520885,NaN,NaN,NaN,-44211735
908371800,98.9375,101.8125,98.84375,100.5625,NaN,NaN,92.00240384615384,103.8125,106.9253124000003,108.2496875,103.58625,101.28593749999996,103.55359690353633,100.74591033958806,100.08413461538451,105.11847489993484,95.04979433083419,106.9253124000003,108.2496875,103.58625,101.28593749999996,100.40625,8176898,11162430.5,47.68766444636062,NaN,1.5,2.75,NaN,NaN,3.352969398234351,0.7325374164703646,NaN,0.057002288411756474,-1.3836649224051456,-1.440667210816902,30.7146970900673,1.7710309930423782,NaN,NaN,NaN,-36034837
908458200,100.125,107.25,99.9375,105.96875,NaN,NaN,91.9483173076923,103.6,106.9695311500003,108.2146875,103.53625,101.48437499999996,103.64830878967216,101.24332364057967,100.14423076923066,105.43303757614711,94.8554239623142,106.9695311500003,108.2146875,103.53625,101.48437499999996,104.38541666666667,20541104,11542225.75,59.232457880685025,NaN,1.5,2.75,NaN,NaN,3.6357930126461833,1.779648435658088,NaN,0.510976750253898,-0.8019462729995297,-1.3129230232534277,38.178553956349134,5.2125349053676695,NaN,NaN,NaN,-15493733
908544600,106.125,106.75,105,106,NaN,NaN,91.89423076923077,103.3875,107.01421865000029,108.1784375,103.4775,101.67968749999996,103.74053197439089,101.69634043671495,100.22596153846143,105.83186683434778,94.62005624257509,107.01421865000029,108.1784375,103.4775,101.67968749999996,105.91666666666667,16573898,12019960.7,59.28838712417646,NaN,1.5,2.75,NaN,NaN,3.5010935117428845,1.3788645748234436,NaN,0.7826968729747326,-0.3345519320350121,-1.1172488050097447,37.516326501074154,7.409753008233059,NaN,NaN,NaN,1080165
908803800,105.6875,106.8125,105.5,106.375,NaN,NaN,91.84014423076923,103.175,107.0582811500003,108.1409375,103.4225,101.89687499999995,103.84384444598341,102.14192706178972,100.58173076923066,107.05005867545322,94.1134028630081,107.0582811500003,108.1409375,103.4225,101.89687499999995,106.22916666666667,7915898,11974025.5,59.997599650903496,NaN,1.5,2.75,NaN,NaN,3.34476540376125,0.6610891216157841,NaN,0.9460928863988958,0.06536730298887505,-0.8807255834100207,33.918666232589764,7.892234548335975,NaN,NaN,NaN,8996063
908890200,107.5625,108.79687,106.09375,107,NaN,NaN,91.7860576923077,102.9625,107.1043749000003,108.120625,103.3925,102.10312499999995,103.96761525202328,102.6046006749526,101.21153846153835,108.42018852413085,94.00288839894586,107.1043749000003,108.120625,103.3925,102.10312499999995,107.29687333333334,14611602,12341100.5,61.210447417833976,NaN,1.5,2.75,NaN,NaN,3.2989335892068747,1.183978851804991,NaN,1.0468260365712196,0.42780696230400395,-0.6190190742672157,33.52159070779086,10.167310167310168,NaN,NaN,NaN,23607665
908976600,106.875,107.625,105.875,106.625,NaN,NaN,91.73197115384616,102.75,107.1564061500003,108.0915625,103.3875,102.08437499999995,104.0718264186106,102.98749584876663,101.66586538461527,109.41708212438004,93.9146486448505,107.1564061500003,108.0915625,103.3875,102.08437499999995,106.70833333333333,9178398,12115595.4,60.03431629171558,NaN,1.5,2.75,NaN,NaN,3.188295475692098,0.7575688768873876,NaN,1.0367991277468842,0.6769798354163896,-0.35981929233049464,31.184418072147466,10.384988676803623,NaN,NaN,NaN,14429267
909063000,106.78125,108.46875,106.15625,108.21875,NaN,NaN,91.67788461538461,102.5375,107.2151561500003,108.0775,103.378125,102.27656249999995,104.23445087278273,103.48571052983647,102.39903846153835,110.67032342553809,94.12775349753862,107.2151561500003,108.0775,103.378125,102.27656249999995,107.61458333333333,8277500,11972995.4,63.26492756093937,NaN,1.5,2.75,NaN,NaN,3.125738655999805,0.6913474634760154,NaN,1.0811535375575962,0.9916226296165007,-0.08953090794109558,29.80478302741551,9.831906121154455,NaN,NaN,NaN,22706767
909149400,107.96875,108,106.78125,106.84375,NaN,NaN,91.62379807692308,102.325,107.2712499000003,108.0671875,103.3675,102.40624999999996,104.33677632875204,103.80552381270918,103.03365384615374,111.30567651885548,94.761631173452,107.2712499000003,108.0671875,103.3675,102.40624999999996,107.20833333333331,6237199,11772485.45,58.845387570511875,NaN,1.5,2.75,NaN,NaN,3.0051501805712477,0.5298115700792818,NaN,0.9653451158274259,1.1171504868431867,0.1518053710157609,32.186581795856476,6.877149109096592,NaN,NaN,NaN,16469568
909412200,107.71875,108.46875,106.78125,107.625,NaN,NaN,91.56971153846153,102.1125,107.3478124000003,108.0446875,103.3975,102.52812499999996,104.46572627664412,104.16928344959402,103.84134615384605,111.68742635241026,95.99526595528184,107.3478124000003,108.0446875,103.3975,102.52812499999996,107.625,5838602,11622025.5,60.532431680201206,NaN,1.5,2.75,NaN,NaN,2.9110323105304445,0.5023738762232108,NaN,0.8906272238071614,1.2650894007747127,0.37446217696755124,31.928802145513817,8.030112923462987,NaN,NaN,NaN,22308170
909498600,108.4375,108.96875,106.28125,107,NaN,NaN,91.515625,101.9,107.41281240000029,107.9946875,103.37,102.63124999999995,104.56510955991298,104.43887550201363,104.64182692307682,111.41718063336164,97.866473212792,107.41281240000029,107.9946875,103.37,102.63124999999995,107.41666666666667,10089699,11595605.35,58.46753936106344,NaN,1.5,2.75,NaN,NaN,2.895065716921127,0.8701312864187811,NaN,0.753807405776368,1.3167214341880111,0.5629140284116432,32.25075685016924,6.401491609695463,NaN,NaN,NaN,12218471
909585000,106.5625,107.53125,106.03125,106.8125,NaN,NaN,91.46153846153847,101.6875,107.4703124000003,107.9440625,103.29875,102.88437499999995,104.65324251834777,104.66493497801233,105.27884615384605,111.1306036529618,99.4270886547303,107.4703124000003,107.9440625,103.29875,102.88437499999995,106.79166666666667,5650602,11482715.55,57.83020119025904,NaN,1.5,2.75,NaN,NaN,2.7954181657124755,0.49209631427297695,NaN,0.6114377729445186,1.3272112445922915,0.7157734716477728,32.59867073672258,0.7962253022707166,NaN,NaN,NaN,6567869
909671400,107.09375,109.4375,106.625,109.40625,NaN,NaN,91.40745192307692,101.475,107.5385936500003,107.9159375,103.285,103.41406249999996,104.83963496860864,105.1164887896302,106.0048076923076,111.36210446384075,100.64751092077444,107.5385936500003,107.9159375,103.285,103.41406249999996,108.48958333333333,9625602,11297215.55,63.72155729317973,NaN,1.5,2.75,NaN,NaN,2.7966382967330126,0.8520331366077192,NaN,0.6491521622480654,1.5272136744578546,0.8780615122097892,19.168574615298024,3.213443396226415,NaN,NaN,NaN,16193471
909757800,110.125,110.90625,109.5,110,NaN,NaN,91.35336538461539,101.2625,107.61382805000031,107.9009375,103.29625,103.87812499999995,105.04200222474164,105.58158509537971,106.80288461538451,111.10875218907887,102.49701704169016,107.61382805000031,107.9009375,103.29625,103.87812499999995,110.13541666666669,9872801,11073265.55,64.9294181535619,NaN,1.5,2.75,NaN,NaN,2.7040212755377975,0.891588931505395,NaN,0.668647800488356,1.7138712628202342,1.0452234623318781,19.110540870791585,3.407755581668625,NaN,NaN,NaN,26066272
910017000,110.8125,111.875,110.1875,111.875,NaN,NaN,91.29927884615384,101.05,107.6916405500003,107.925625,103.3625,104.53749999999995,105.3099629218106,106.18095794343878,107.67307692307682,111.05613491267871,104.29001893347493,107.6916405500003,107.925625,103.3625,104.53749999999995,111.3125,6501398,10757975.5,68.49647297352621,NaN,1.5,2.75,NaN,NaN,2.6448054701422405,0.6043328505442311,NaN,0.7559446831220253,1.9901543162344097,1.2342096331123844,20.548777059215833,4.55607476635514,NaN,NaN,NaN,32567670
910103400,111.59375,111.8125,110.75,111.0625,NaN,NaN,91.2451923076923,100.8375,107.7575780500003,107.931875,103.39875,105.16093749999996,105.53555261115136,106.64586671073033,108.06490384615374,111.73533054813353,104.39447714417395,107.7575780500003,107.931875,103.39875,105.16093749999996,111.20833333333333,6866000,10470225.5,65.39261187642671,NaN,1.5,2.75,NaN,NaN,2.536247936560652,0.6557642908455028,NaN,0.7079289030194682,2.1191207618867196,1.4111918588672514,21.70695903884451,4.161781946072685,NaN,NaN,NaN,25701670
910189800,112.46875,113.09375,111.09375,112.25,NaN,NaN,91.19110576923077,100.625,107.8341405500003,107.9790625,103.45375,105.91718749999995,105.79886427345915,107.17959369066078,108.54567307692297,112.62302134031695,104.46832481352898,107.8341405500003,107.9790625,103.45375,105.91718749999995,112.14583333333333,8233602,10164480.6,67.6965851410177,NaN,1.5,2.75,NaN,NaN,2.5001766553777487,0.810036668277964,NaN,0.7036406483570803,2.2907426693136017,1.5871020209565214,21.498671591377704,3.725093849263644,NaN,NaN,NaN,33935272
910276200,111.53125,113.9375,111.125,113.78125,NaN,NaN,91.13701923076923,100.4125,107.9226562000003,108.025,103.551875,106.77656249999995,106.1118990078333,107.8083228629788,109.11538461538451,113.83882914819155,104.39194008257748,107.9226562000003,108.025,103.551875,106.77656249999995,112.94791666666667,6841500,9475305.2,70.43029702348375,NaN,1.5,2.75,NaN,NaN,2.5224854657079097,0.7220347899717258,NaN,0.7473183394609124,2.521249945282662,1.7739316058217496,21.298481179371713,6.4931266452179,NaN,NaN,NaN,40776772
910362600,113.46875,114.5625,113.3125,114.125,NaN,NaN,91.0829326923077,100.2,108.01359370000031,108.0515625,103.759375,107.55624999999995,106.42613826242807,108.40991116174273,109.66346153846143,114.90315803527797,104.4237650416449,108.01359370000031,108.0515625,103.759375,107.55624999999995,114,5224801,9101120.25,71.0231363046464,NaN,1.5,2.75,NaN,NaN,2.4315936467287735,0.5740832838682689,NaN,0.7412837339285216,2.7005362732324016,1.95925253930388,18.174796281758326,6.039488966318235,NaN,NaN,NaN,46001573
910621800,113.9375,114.25,112.5,113.3125,NaN,NaN,91.02884615384616,99.9875,108.10078120000031,108.075,103.958125,108.22343749999996,106.69619166390147,108.8768243844339,110.17788461538451,115.43642760830076,104.91934162246827,108.10078120000031,108.075,103.958125,108.22343749999996,113.35416666666667,6188699,8935130.2,67.57456949820278,NaN,1.5,2.75,NaN,NaN,2.382908386248147,0.6926254974997454,NaN,0.6289280585804216,2.7454126125294067,2.116484553948985,19.784596031994376,5.899532710280374,NaN,NaN,NaN,39812874
910708200,113,113.9375,112.25,113,NaN,NaN,90.97475961538461,99.775,108.18156245000031,108.104375,104.298125,108.89218749999995,106.94339983394455,109.26950777639257,110.54567307692297,115.87303438214641,105.21831177169952,108.18156245000031,108.104375,104.298125,108.89218749999995,113.0625,14015199,9323050.1,66.24231969425642,NaN,1.5,2.75,NaN,NaN,2.3332363586589935,1.5032847458365584,NaN,0.486297644258213,2.7243566092717515,2.2380589650135385,19.234817416919572,5.792861322410767,NaN,NaN,NaN,25797675
910794600,113.8125,114,111.89062,112.25,NaN,NaN,90.92067307692308,99.5625,108.25421870000031,108.1209375,104.541875,109.47656249999996,107.15150180124084,109.5533641786409,110.96153846153835,115.89773923061195,106.02533769246476,108.25421870000031,108.1209375,104.541875,109.47656249999996,112.71354000000001,10922398,9460325.1,63.030514791818874,NaN,1.5,2.75,NaN,NaN,2.3172466187547798,1.1545478495236914,NaN,0.30313993345114154,2.6169838818274656,2.313843948376324,20.09230729135168,2.599257355041417,NaN,NaN,NaN,14875277
910881000,112.3125,113.125,111.6875,112.125,NaN,NaN,90.86658653846153,99.35,108.32359370000032,108.123125,104.7975,109.78437499999995,107.34654094629022,109.7982818759132,111.30769230769221,115.87692773083884,106.73845688454557,108.32359370000032,108.123125,104.7975,109.78437499999995,112.3125,5457398,8706139.8,62.48672032005006,NaN,1.5,2.75,NaN,NaN,2.2544075745580097,0.6268447469681109,NaN,0.1433770508646428,2.4930652619571276,2.349688211092485,16.18744708863493,1.9318181818181819,NaN,NaN,NaN,9417879
910967400,112.21875,113.21875,112.125,113.21875,NaN,NaN,90.8125,99.1375,108.39812495000031,108.12125,105.090625,110.14531249999996,107.57682365427884,110.12404074487385,111.7860576923076,115.70737257752914,107.86474280708605,108.39812495000031,108.12125,105.090625,110.14531249999996,112.85416666666667,5524602,8153675,65.30715824401307,NaN,1.5,2.75,NaN,NaN,2.1715034620895803,0.6775597506645776,NaN,0.0841036201511538,2.454817736281427,2.3707141161302734,16.654349833267478,1.2011173184357542,NaN,NaN,NaN,14942481
911226600,114.21875,114.35937,112.89062,114.0625,NaN,NaN,90.75841346153847,98.925,108.46874995000032,108.1296875,105.416875,110.52968749999995,107.83116390313064,110.49913210250492,112.3437499999999,115.19260688952501,109.49489311047479,108.46874995000032,108.1296875,105.416875,110.52968749999995,113.77082999999999,6023699,8059065.05,67.34672824969371,NaN,1.5,2.75,NaN,NaN,2.121306786226039,0.7474438985946639,NaN,0.0747761371330169,2.4641842875465443,2.3894081504135274,14.487709167061414,2.7011817670230727,NaN,NaN,NaN,20966180
911313000,113.65625,115.625,113,114.0625,NaN,NaN,90.70432692307692,98.7125,108.53562495000031,108.1334375,105.638125,110.88281249999996,108.0755300245765,110.83850047369492,112.70192307692297,115.12199332690905,110.28185282693688,108.53562495000031,108.1334375,105.638125,110.88281249999996,114.22916666666667,9058898,7781429.85,67.34672824969371,NaN,1.5,2.75,NaN,NaN,2.157284872924179,1.1641688191791641,NaN,0.04322618480093965,2.443440881414702,2.4002146966137623,13.351328732845113,1.6146993318485523,NaN,NaN,NaN,20966180
911399400,114.3125,115,113.5,114.75,NaN,NaN,90.65024038461539,98.5,108.60656245000031,108.14,105.923125,111.28906249999996,108.33727394518134,111.21102423810493,113.0673076923076,115.15706725848811,110.97754812612708,108.60656245000031,108.14,105.923125,111.28906249999996,114.41666666666667,4567699,7550894.9,69.06531973716291,NaN,1.5,2.75,NaN,NaN,2.110335953429595,0.6049215438027087,NaN,0.043177642514442116,2.454186749756815,2.4110091072423727,12.584622630811344,0.8514144465806097,NaN,NaN,NaN,25533879
911485800,115.28125,115.90625,114.625,115.75,NaN,NaN,90.59615384615384,98.2875,108.68281245000031,108.164375,106.268125,111.66562499999995,108.62796908458598,111.64330764399969,113.36538461538451,115.77135483082266,110.95941439994637,108.68281245000031,108.164375,106.268125,111.66562499999995,115.42708333333333,5249301,7399484.95,71.42144412123491,NaN,1.5,2.75,NaN,NaN,2.051115528184624,0.7094143761992515,NaN,0.08272072778944928,2.514410016979184,2.431689289189735,11.216673502847655,1.4238773274917853,NaN,NaN,NaN,30783180
911572200,116.35937,116.75,115.84375,116.625,NaN,NaN,90.5420673076923,98.075,108.75781245000032,108.184375,106.566875,112.15468749999995,108.94157814009242,112.11775453504734,113.79326923076913,116.38051355825874,111.20602490327951,108.75781245000032,108.184375,106.566875,112.15468749999995,116.40625,5562000,7365725,73.33518812414219,NaN,1.5,2.75,NaN,NaN,1.9760358476000077,0.7551191498460776,NaN,0.13684041908224964,2.6027398130425468,2.465899393960297,11.695991226963589,2.9233314947600664,NaN,NaN,NaN,36345180
911831400,117.46875,119.625,117.15625,119.375,NaN,NaN,90.48798076923077,97.8625,108.84828120000032,108.2296875,106.885625,112.74218749999996,109.35073193852017,112.80892076980473,114.34134615384605,118.12893512990229,110.5537571777898,108.84828120000032,108.2296875,106.885625,112.74218749999996,118.71875,7151301,7431359.95,78.26206004369342,NaN,1.5,2.75,NaN,NaN,2.049176144200007,0.9623139032580437,NaN,0.31660563364813665,2.8616564360204677,2.545050802372331,15.310400162064587,5.6415929203539825,NaN,NaN,NaN,43496481
911917800,119,119.65625,118.45312,118.625,NaN,NaN,90.43389423076923,97.65,108.93015620000031,108.2559375,107.176875,113.32343749999995,109.71442872524487,113.36283307744237,114.71394230769221,119.1116748797353,110.31620973564911,108.93015620000031,108.2559375,107.176875,113.32343749999995,118.91145666666667,5323699,7193059.95,74.23353433475498,NaN,1.5,2.75,NaN,NaN,1.9887442767571495,0.7401160336499072,NaN,0.3416160068042009,2.9720708108775824,2.6304548040733815,16.097755310426752,5.679287305122495,NaN,NaN,NaN,38172782
912004200,118.9375,119.1875,118.21875,118.625,NaN,NaN,90.3798076923077,97.4375,109.0124999500003,108.284375,107.449375,113.91406249999996,110.06386289288233,113.86399183197167,115.06009615384605,119.90371194222088,110.21648036547121,109.0124999500003,108.284375,107.449375,113.91406249999996,118.67708333333333,4393500,7130204.85,74.23353433475498,NaN,1.5,2.75,NaN,NaN,1.9158875427030675,0.6161814551513202,NaN,0.31540259425747674,3.0247080468952277,2.709305452637751,14.755232885647914,5.797101449275362,NaN,NaN,NaN,38172782
912177000,119.46875,119.71875,119.01562,119.5,NaN,NaN,90.32572115384616,97.225,109.09703120000032,108.313125,107.799375,114.41874999999996,110.43390748531831,114.40075451464104,115.5360576923076,120.79725489503456,110.27486048958063,109.09703120000032,108.313125,107.799375,114.41874999999996,119.41145666666667,4557898,6876819.65,75.91127501116517,NaN,1.5,2.75,NaN,NaN,1.857163432509991,0.6627915565591428,NaN,0.3135788451319619,3.1012790090527034,2.7877001639207415,14.150444780288451,5.54788849020149,NaN,NaN,NaN,42730680
912436200,119.01562,119.375,116.125,116.125,NaN,NaN,90.27163461538461,97.0125,109.16765620000031,108.3159375,108.08,114.72499999999995,110.65708758393329,114.56496837038951,115.77644230769221,120.8337964204042,110.71908819498022,109.16765620000031,108.3159375,108.08,114.72499999999995,117.20833333333333,8705398,6818449.5,59.750507323022404,NaN,1.5,2.75,NaN,NaN,1.965580330187849,1.2767415817921655,NaN,0.05519788763171318,2.856697523460383,2.80149963582867,24.291773850919498,1.8082191780821917,NaN,NaN,NaN,34025282
912522600,116.125,118.03125,115.21875,117.625,NaN,NaN,90.21754807692308,96.8,109.24328120000031,108.3275,108.391875,115.01249999999996,110.93033905123002,114.85639995416193,116.18990384615374,120.89288862483045,111.48691906747703,109.24328120000031,108.3275,108.391875,115.01249999999996,116.95833333333333,8950602,6940909.7,63.47251790228381,NaN,1.5,2.75,NaN,NaN,2.0260745923172885,1.2895430695489383,NaN,-0.03945809703247427,2.752177014538077,2.7916351115705513,24.880016971015095,3.1232876712328768,NaN,NaN,NaN,42975884
912609000,117.21875,117.90625,116,117.28125,NaN,NaN,90.16346153846153,96.5875,109.31249995000032,108.3353125,108.68,115.32343749999995,111.17939438255434,115.08733805376555,116.58653846153835,120.68179499923403,112.49128192384268,109.31249995000032,108.3353125,108.68,115.32343749999995,117.0625,7495500,6972384.7,62.05627091796761,NaN,1.5,2.75,NaN,NaN,2.0175156928660534,1.0750267408509457,NaN,-0.144106302154269,2.611502233877715,2.755608536031984,25.0679044068737,2.2058823529411766,NaN,NaN,NaN,35480384
912695400,117.25,118.3125,115.09375,115.34375,NaN,NaN,90.109375,96.375,109.37476560000032,108.310625,108.846875,115.47812499999995,111.34270244598358,115.11175823912122,116.7499999999999,120.44454184211558,113.05545815788422,109.37476560000032,108.310625,108.846875,115.47812499999995,116.25,12145301,7167969.65,54.65409103385329,NaN,1.5,2.75,NaN,NaN,2.103318143375621,1.6943851038766604,NaN,-0.35091255993905746,2.3169678361081623,2.6678803960472197,27.27265514984325,-0.3509719222462203,NaN,NaN,NaN,23335083
912781800,116.625,118.5,116.5,118.375,NaN,NaN,90.05528846153847,96.1625,109.44835935000032,108.3184375,109.126875,115.70781249999996,111.61847882065089,115.42254316872872,117.08173076923066,120.51678570924258,113.64667582921874,109.44835935000032,108.3184375,109.126875,115.70781249999996,117.79166666666667,10007199,7326254.6,62.24237184154537,NaN,1.5,2.75,NaN,NaN,2.1785275617059336,1.3659365591799117,NaN,-0.29301456243798274,2.301612192999741,2.594626755437724,30.73356079021381,1.5005359056806002,NaN,NaN,NaN,33342282
913041000,118.0625,119.46875,118,118.9375,NaN,NaN,90.00120192307692,95.95,109.52273435000032,108.32375,109.420625,115.94843749999995,111.90549925905674,115.75730096218312,117.45673076923066,120.53762514152136,114.37583639693996,109.52273435000032,108.32375,109.420625,115.94843749999995,118.80208333333333,4290000,7279514.55,63.46419789745585,NaN,1.5,2.75,NaN,NaN,2.127829164441224,0.589325012064163,NaN,-0.2291221926895739,2.3082240145757567,2.5373462072653306,30.599624707595883,-0.36649214659685864,NaN,NaN,NaN,37632282
913127400,118.53125,119.75,117.5,118.40625,NaN,NaN,89.94711538461539,95.7375,109.59851560000033,108.3221875,109.685,116.20312499999996,112.16043066066236,116.00958182292759,117.73798076923066,120.42100907740024,115.05495246106108,109.59851560000033,108.3221875,109.685,116.20312499999996,118.55208333333333,10102602,7475209.7,61.441966342048055,NaN,1.5,2.75,NaN,NaN,2.136555652695422,1.3514807484263618,NaN,-0.23410036412293556,2.244720752111661,2.4788211162345966,27.51436465165933,-0.18440463645943098,NaN,NaN,NaN,27529680
913213800,118.6875,118.96875,117.875,118.625,NaN,NaN,89.89302884615384,95.525,109.66898435000031,108.3228125,109.95875,116.48437499999996,112.41394318377364,116.25866926836305,117.95913461538451,120.4145525620838,115.50371666868523,109.66898435000031,108.3228125,109.95875,116.48437499999996,118.48958333333333,5327898,7040844.65,61.979192591635915,NaN,1.5,2.75,NaN,NaN,2.062069534645749,0.7567129037565116,NaN,-0.2335874826056381,2.186836762977549,2.4204242455831873,27.316819028431862,0,NaN,NaN,NaN,32857578
913300200,118.84375,118.84375,116.71875,116.89062,NaN,NaN,89.8389423076923,95.3125,109.72781245000031,108.3267187,110.2615624,116.71640599999996,112.58949913735114,116.31885505232847,117.97956692307682,120.3943217145092,115.56481213164443,109.72781245000031,108.3267187,110.2615624,116.71640599999996,117.48437333333334,5966602,6793054.85,55.38969642024307,NaN,1.5,2.75,NaN,NaN,2.066564567885339,0.8783385577992205,NaN,-0.3537716021843118,1.9782097428527976,2.3319813450371094,28.59144895438791,-2.1835815899581603,NaN,NaN,NaN,26890976
913386600,116.4375,117.34375,115.5625,117.125,NaN,NaN,89.78485576923077,95.1,109.78781245000032,108.3329687,110.6278124,116.96640599999996,112.76736191627855,116.39563076163053,117.80648999999988,120.1166355405939,115.49634445940586,109.78781245000032,108.3329687,110.6278124,116.96640599999996,116.67708333333333,8198199,6930094.9,56.069422887275934,NaN,1.5,2.75,NaN,NaN,2.046184955893529,1.1829850988043467,NaN,-0.41685803275763833,1.8109088040900616,2.2277668368477,28.150149518950947,0.8611410118406889,NaN,NaN,NaN,35089175
913645800,116.15625,116.40625,113.75,113.75,NaN,NaN,113.75,94.8875,109.83203120000032,108.3285937,110.8884374,116.99296849999996,112.80589674309115,116.14366592718953,117.43148999999988,120.53491430529995,114.32806569469982,109.83203120000032,108.3285937,110.8884374,116.99296849999996,114.63541666666667,9521398,7129934.7,45.35313793084597,NaN,1.5,2.75,NaN,NaN,2.1411003161868485,1.33541166933829,NaN,-0.6702417387442612,1.3899646634173735,2.0602064021616346,28.355071931343726,-3.2943676939426143,NaN,NaN,NaN,25567777
913732200,114.6875,116.75,114.53125,116.6875,NaN,NaN,114.2180706521739,94.675,109.88796870000031,108.3545312,111.2484374,117.12421849999996,112.95811647865621,116.19545964840958,117.28245153846143,120.32784305511869,114.23706002180417,109.88796870000031,108.3545312,111.2484374,117.12421849999996,115.98958333333333,9631500,7310324.75,53.65555643100658,NaN,1.5,2.75,NaN,NaN,2.2024502936020736,1.317520127953276,NaN,-0.62524067837697,1.278655554190422,1.903896232567392,31.5342458898867,-0.506261657340794,NaN,NaN,NaN,35199277
913818600,117.125,117.125,115.75,116.53125,NaN,NaN,114.68614130434783,94.4625,109.94656245000031,108.3707812,111.6071874,117.24765599999996,113.09823936184615,116.22743968189438,117.05408615384604,119.83371831977865,114.27445398791343,109.94656245000031,108.3707812,111.6071874,117.24765599999996,116.46875,7260000,7220379.85,53.19262396376298,NaN,1.5,2.75,NaN,NaN,2.1433467012019256,1.0054872667121524,NaN,-0.5915877045344484,1.1644116018993316,1.75599930643378,31.50829389900482,1.0295312923327011,NaN,NaN,NaN,27939277
913905000,117.21875,118.59375,117.03125,118.39062,NaN,NaN,115.15421195652173,94.25,110.0192968000003,108.4249999,112.03249980000001,117.42968699999997,113.30578370059729,116.4334568550473,117.22836461538449,120.03708326935514,114.41964596141385,110.0192968000003,108.4249999,112.03249980000001,117.42968699999997,118.00520666666667,6914699,7337729.85,57.85279826317016,NaN,1.5,2.75,NaN,NaN,2.1375719368303594,0.9423485384924604,NaN,-0.43683112838572336,1.2099603959516259,1.6467915243373492,30.978108299175602,0.013195353748678702,NaN,NaN,NaN,34853976
913991400,118.3125,119.125,117.875,118.5,NaN,NaN,115.62228260869566,94.0375,110.0821093000003,108.4846874,112.47062480000001,117.56718699999996,113.50947845743661,116.63027048789994,117.29567230769219,120.18010102025906,114.41124359512531,110.0821093000003,108.4846874,112.47062480000001,117.56718699999996,118.5,4802398,7315384.7,58.116967817198514,NaN,1.5,2.75,NaN,NaN,2.0741739413424765,0.6564792142783686,NaN,-0.3249664029237951,1.2405835206826055,1.5655499236064006,27.186563472091585,-0.3678402522333158,NaN,NaN,NaN,39656374
914250600,119.25,121.34375,119,120.15625,NaN,NaN,116.09035326086956,93.825,110.1550780500003,108.5440624,112.9031248,117.74374949999996,113.77013616498812,116.9660780604809,117.51682615384604,120.77904100627929,114.2546113014128,110.1550780500003,108.5440624,112.9031248,117.74374949999996,120.16666666666667,8580699,7466319.65,62.00080543614679,NaN,1.5,2.75,NaN,NaN,2.129143659818014,1.1492541710292299,NaN,-0.14639129847968446,1.3825608005067949,1.5289520989864793,28.23955722188399,1.4779625230931643,NaN,NaN,NaN,48237073
914337000,120.40625,121.21875,119.1875,120.6875,NaN,NaN,116.55842391304348,93.6125,110.2257030500003,108.6331249,113.31749980000001,117.80937449999996,114.04140533498858,117.32049919757796,117.92788384615372,121.3347082999266,114.52105939238083,110.2257030500003,108.6331249,113.31749980000001,117.80937449999996,120.36458333333331,5461102,7381809.7,63.18020786023149,NaN,1.5,2.75,NaN,NaN,2.122151255545299,0.739805308175311,NaN,-0.006825839354405172,1.5204197997934727,1.527245639147878,28.067119690410927,1.7386722866174922,NaN,NaN,NaN,53698175
914423400,121.1875,123.21875,120.8125,123.21875,NaN,NaN,117.02649456521739,93.4,110.3064843000003,108.7521874,113.7893748,118.03906199999997,114.40130120420471,117.8822373692372,118.30047999999988,122.72800095851692,113.87295904148284,110.3064843000003,108.7521874,113.7893748,118.03906199999997,122.41666666666667,7791000,7505174.75,68.23855527926092,NaN,1.5,2.75,NaN,NaN,2.1513725944349202,1.0380837568105925,NaN,0.22862376294305053,1.8130253428266911,1.5844015798836406,30.072890869607033,5.413719253093192,NaN,NaN,NaN,61489175
914509800,123.15625,123.25,122.5,122.6875,NaN,NaN,117.4945652173913,93.1875,110.3824218000003,108.9090624,114.2318748,118.24218699999997,114.72625017658885,118.33988142930986,118.58894153846141,123.59564412920837,113.58223894771446,110.3824218000003,108.9090624,114.2318748,118.24218699999997,122.8125,1507100,7360854.75,66.18349022614096,NaN,1.5,2.75,NaN,NaN,2.051274551975283,0.2047452437503946,NaN,0.3158663561386723,1.979234525056981,1.6633681689183086,28.269981726008492,4.749199573105656,NaN,NaN,NaN,59982075
914855400,123.25,123.3125,122,122.375,NaN,NaN,117.96263586956522,92.975,110.4588280500003,109.0481249,114.5599998,118.38593699999997,115.02620115005595,118.72417843604225,118.89422999999988,124.28816474473088,113.50029525526888,110.4588280500003,109.0481249,114.5599998,118.38593699999997,122.5625,4203602,7343139.95,64.94448317611113,NaN,1.5,2.75,NaN,NaN,1.9985049411199058,0.5724529327539236,NaN,0.31888245702057416,2.0619712401940262,1.743088783173452,28.555798185814684,7.582417582417582,NaN,NaN,NaN,55778473
914941800,122.71875,124.48437,122.125,124.3125,NaN,NaN,118.43070652173913,92.7625,110.5391405500003,109.2018749,114.92624980000001,118.79531199999997,115.3903697324067,119.25639953737156,119.33172999999988,125.44235411136745,113.22110588863231,110.5391405500003,109.2018749,114.92624980000001,118.79531199999997,123.64062333333334,3935800,7104660.05,68.83946463633775,NaN,1.5,2.75,NaN,NaN,2.0242810167541982,0.5539744297828859,NaN,0.41181186123335145,2.2578536097151414,1.84604174848179,19.386827511302574,6.534547402249598,NaN,NaN,NaN,59714273
915028200,123.9375,124.75,123.03125,123.3125,NaN,NaN,118.89877717391305,92.55,110.6128905500003,109.3437499,115.2649998,119.07968699999996,115.70104150760643,119.64269481952665,119.82572076923066,126.10313511122573,113.54830642723559,110.6128905500003,109.3437499,115.2649998,119.07968699999996,123.69791666666667,6810699,6997664.9,64.83537301429067,NaN,1.5,2.75,NaN,NaN,2.0024573727003268,0.9732816728620428,NaN,0.36782267913925315,2.3058200974058565,1.9379974182666033,18.40837626546167,5.819254491820863,NaN,NaN,NaN,52903574
915114600,123.3125,123.9375,122.46875,123.3125,NaN,NaN,119.36684782608695,92.3375,110.6846093000003,109.4918749,115.5912498,119.38124949999997,115.9995300759356,119.99220007480983,120.30168230769219,126.62594571582163,113.97741889956275,110.6846093000003,109.4918749,115.5912498,119.38124949999997,123.23958333333333,6790500,6962414.9,64.83537301429067,NaN,1.5,2.75,NaN,NaN,1.9643354175074461,0.9753081506245771,NaN,0.30330088684490963,2.3171235268227406,2.013822639977831,18.241321723818313,4.157322598699121,NaN,NaN,NaN,52903574
915460200,123.375,125.21875,121.71875,123.03125,NaN,NaN,119.83491847826087,92.125,110.7535155500003,109.6534374,115.9193748,119.76562449999997,116.27528379844793,120.28163340101841,121.0156246153845,126.21585305896969,115.8153961717993,110.7535155500003,109.6534374,115.9193748,119.76562449999997,123.32291666666669,9450398,6827669.75,63.62817670588952,NaN,1.5,2.75,NaN,NaN,2.074025744828343,1.3841322656240074,NaN,0.21065198920778183,2.2771376264875585,2.0664856372797766,17.49283828447399,3.8238396624472575,NaN,NaN,NaN,43453176
915546600,122.9375,124.875,122.9375,124.4375,NaN,NaN,120.30298913043478,91.9125,110.8263280500003,109.8109374,116.2437498,120.06874949999997,116.59537070831271,120.67743021996904,121.61177846153835,126.45530221747683,116.76825470559987,110.8263280500003,109.8109374,116.2437498,120.06874949999997,124.08333333333333,8031000,6728859.8,66.94247024437968,NaN,1.5,2.75,NaN,NaN,2.0642739059120325,1.1935157275828514,NaN,0.21244256436195252,2.332038842732217,2.1195962783702647,17.875883199395883,3.5630689206762027,NaN,NaN,NaN,51484176
915633000,125.8125,127.75,125.75,127.4375,NaN,NaN,120.77105978260869,91.7,110.9153905500003,110.0115624,116.6556248,120.49374949999996,117.0205522491632,121.3212463894958,122.45072076923066,127.26165847308101,117.6397830653803,110.9153905500003,110.0115624,116.6556248,120.49374949999996,126.97916666666667,7737699,6901244.75,72.66500347519536,NaN,1.5,2.75,NaN,NaN,2.1534329126326015,1.1212033887075226,NaN,0.3745573086892269,2.587792914231798,2.2132356055425713,20.427344814984785,5.592957017089591,NaN,NaN,NaN,59221875
915719400,126.375,127.21875,125.78125,126.8125,NaN,NaN,121.23913043478261,91.4875,110.99664055000031,110.2184374,117.0393748,120.91406199999997,117.40455020017642,121.84422292382953,123.0985576923076,127.81534734840214,118.38176803621305,110.99664055000031,110.2184374,117.0393748,120.91406199999997,126.60416666666667,5504898,6671359.55,69.9483222948653,NaN,1.5,2.75,NaN,NaN,2.1179198474445586,0.8251538473893226,NaN,0.3964690902686643,2.708821968378402,2.3123528781097376,21.351380178393782,2.916560994166878,NaN,NaN,NaN,53716977
915805800,128.1875,128.29687,126.1875,127.75,NaN,NaN,121.70720108695652,128.29687,111.0846093000003,110.41218740000001,117.45437480000001,121.37031199999997,117.81025411389498,122.40667788346482,123.81009615384605,128.3237946907804,119.2963976169117,111.0846093000003,110.41218740000001,117.45437480000001,121.37031199999997,127.41145666666667,6221898,6716059.55,71.65987798142946,NaN,1.5,2.75,NaN,NaN,2.1173091440556626,0.9264209100111389,NaN,0.4281671856435403,2.847561860164163,2.4193946745206225,18.980923691337015,4.12633723892002,NaN,NaN,NaN,59938875
916065000,127.6875,127.6875,125.21875,126.53125,NaN,NaN,122.17527173913044,128.58466554054056,111.1667968000003,110.5737499,117.84874980000001,121.85234349999996,118.15225395256577,122.7994942755158,124.30048076923066,128.4935768048553,120.10738473360601,111.1667968000003,110.5737499,117.84874980000001,121.85234349999996,126.47916666666667,7578301,6796644.5,66.3680084019287,NaN,1.5,2.75,NaN,NaN,2.146876348051687,1.1150062357976793,NaN,0.3257547691425846,2.826588135948853,2.5008333668062686,19.996746345987233,3.39632277834525,NaN,NaN,NaN,52360574
916151400,126.21875,126.21875,123.75,124.25,NaN,NaN,122.64334239130434,128.8724610810811,111.2399218000003,110.7153124,118.14562480000001,122.20859349999996,118.39138124854358,122.93763767784763,124.57451923076913,128.21676422455408,120.93227423698417,111.2399218000003,110.7153124,118.14562480000001,122.20859349999996,124.73958333333333,7768801,6775174.6,57.768612543667224,NaN,1.5,2.75,NaN,NaN,2.1921887517622807,1.146656943719207,NaN,0.07610438123313701,2.5959638433476897,2.5198594621145527,23.336883101504984,-0.05027652086475616,NaN,NaN,NaN,44591773
916237800,120.40625,125.125,120.375,123.375,NaN,NaN,120.375,129.16025662162164,111.3089843000003,110.8546874,118.4131248,122.68984349999997,118.58681727801246,122.97929123233834,124.58653846153835,128.21179987836229,120.96127704471441,111.3089843000003,110.8546874,118.4131248,122.68984349999997,122.95833333333333,10810602,6839634.8,54.83381932192042,NaN,1.5,2.75,NaN,NaN,2.374889555207832,1.5805817585465236,NaN,-0.1631746963552696,2.3158910916704656,2.479065788025735,21.888848077994176,0.05068423720223011,NaN,NaN,NaN,33781171
916324200,123.625,123.90625,120.90625,121.21875,NaN,NaN,120.70625,129.44805216216218,111.3653905500003,110.98124990000001,118.5999998,122.91640599999997,118.69003032593353,122.8116206387823,124.4735576923076,128.4069610980296,120.5401542865856,111.3653905500003,110.98124990000001,118.5999998,122.91640599999997,122.01041666666667,11400699,6928094.75,48.31930567548295,NaN,1.5,2.75,NaN,NaN,2.4195403012644157,1.645574925198591,NaN,-0.4648043065495582,1.8980604048387875,2.3628647113883456,23.667891377099036,-1.6979219462747086,NaN,NaN,NaN,22380472
916410600,122.375,124.40625,122.0625,124.375,NaN,NaN,121.0375,129.73584770270273,111.4331249500003,111.1324999,118.8662498,123.30859349999996,118.91297031315183,122.96051391127922,124.62740384615374,128.3723893988653,120.88241829344217,111.4331249500003,111.1324999,118.8662498,123.30859349999996,123.61458333333333,7812699,6955729.7,56.47133630306686,NaN,1.5,2.75,NaN,NaN,2.4743945654598147,1.123203364271041,NaN,-0.4496113779987736,1.8008504888898784,2.250461866888652,28.449053683281896,1.0922021844043688,NaN,NaN,NaN,30193171
916756200,125.29687,125.625,123.5,125.1875,NaN,NaN,121.36875,130.02364324324327,111.4989062000003,111.2893749,119.12499980000001,123.64843749999996,119.15903030087136,123.17260782449073,124.69471153846143,128.44608579356273,120.94333728336014,111.4989062000003,111.2893749,119.12499980000001,123.64843749999996,124.77083333333331,6535102,6936749.85,58.29507038019445,NaN,1.5,2.75,NaN,NaN,2.4494378107841137,0.9420985535466585,NaN,-0.3851845527500437,1.7689811759510974,2.154165728701141,28.541017225072668,0.6027122049221497,NaN,NaN,NaN,36728273
916842600,126.09375,127.9375,125.03125,126.1875,NaN,NaN,121.7,130.31143878378379,111.56687495000031,111.4624999,119.3731248,124.03281249999995,119.4346565635823,123.45974041263446,124.91586538461527,128.6541792765339,121.17755149269662,111.56687495000031,111.4624999,119.3731248,124.03281249999995,126.38541666666667,6534398,7023349.85,60.48920495391675,NaN,1.5,2.75,NaN,NaN,2.4820672528709626,0.9303819601126663,NaN,-0.2804325100335716,1.8036250911591765,2.084057601192748,28.18595924602764,-0.980872976949485,NaN,NaN,NaN,43262671
916929000,125.57812,125.84375,122.59375,122.84375,NaN,NaN,122.03125,130.59923432432433,111.6226562000003,111.6534374,119.54749980000001,124.16718749999995,119.56834650226534,123.40107465905022,124.8798076923076,128.68768210521273,121.07193327940247,111.6226562000003,111.6534374,119.54749980000001,124.16718749999995,123.76041666666667,6937500,6941189.9,50.85477379691586,NaN,1.5,2.75,NaN,NaN,2.5614731633801795,0.9994684052657887,NaN,-0.43246549220331865,1.5434757359385998,1.9759412281419184,28.433744928622744,-3.129620502710695,NaN,NaN,NaN,36325171
917015400,122.125,123.84375,121.78125,122.5625,NaN,NaN,122.3625,130.88702986486487,111.68078120000031,111.8453124,119.7324998,124.26093749999995,119.68576428649023,123.32121040580735,124.8437499999999,128.72904958750604,120.95845041249378,111.68078120000031,111.8453124,119.7324998,124.26093749999995,122.72916666666667,7522301,7044249.85,50.13150068214177,NaN,1.5,2.75,NaN,NaN,2.525832223138738,1.0678640252943328,NaN,-0.5410492612940729,1.2996296515243273,1.8406789128184002,28.43158182071476,-4.060665362035225,NaN,NaN,NaN,28802870
917274600,123.28125,124,121.90625,123.8125,NaN,NaN,122.69375,131.17482540540541,111.7482812000003,112.1234374,119.9487498,124.29062499999995,119.84759705956904,123.36799989096855,124.79567307692297,128.71520744088136,120.87613871296459,111.7482812000003,112.1234374,119.9487498,124.29062499999995,123.23958333333331,5700301,6939714.9,53.30982535138375,NaN,1.5,2.75,NaN,NaN,2.4949692072002567,0.8214027639665715,NaN,-0.5177538063458393,1.193486654886101,1.7112404612319403,28.857839735258626,-2.148678686095332,NaN,NaN,NaN,34503171
917361000,124.125,126.0625,123.625,126.0625,NaN,NaN,123.025,131.46262094594596,111.82265620000031,112.3834374,120.2249998,124.45937499999995,120.09131874350751,123.62461894897154,124.68990384615374,128.38643463419447,120.99337305811301,111.82265620000031,112.3834374,120.2249998,124.45937499999995,125.25,6047000,7166709.9,58.44391843090877,NaN,1.5,2.75,NaN,NaN,2.49086426382881,0.8437623518150218,NaN,-0.34802246546427296,1.2762123794015992,1.624234844865872,30.868941661321127,1.4587525150905432,NaN,NaN,NaN,40550171
917447400,126.375,126.625,124.15625,124.59375,NaN,NaN,123.35625,131.7504164864865,111.89124995000032,112.6359374,120.4743748,124.57031249999996,120.26788467513467,123.71691714430759,124.51923076923066,128.006978766828,121.03148277163332,111.89124995000032,112.6359374,120.4743748,124.57031249999996,125.125,7399398,7326499.7,54.25028640917678,NaN,1.5,2.75,NaN,NaN,2.489284673555324,1.0099499492233652,NaN,-0.331934269296418,1.2093170082453497,1.5412512775417677,29.70568905504581,0.9878419452887538,NaN,NaN,NaN,33150773
917533800,125.25,126.96875,125.1875,126.6875,NaN,NaN,123.6875,132.03821202702704,111.9656249500003,112.9171874,120.7437498,124.68906249999995,120.51963429571762,123.99982979723067,124.4374999999999,127.65815151078186,121.21684848921794,111.9656249500003,112.9171874,120.7437498,124.68906249999995,126.28125,5961699,7427794.65,58.78987554600395,NaN,1.5,2.75,NaN,NaN,2.481121482587086,0.8026203309215071,NaN,-0.1848830168068214,1.3101475065332409,1.4950305233400623,30.663051820003904,4.511472028873421,NaN,NaN,NaN,39112472
917620200,127.34375,128.29687,125.40625,127.65625,NaN,NaN,124.01875,132.3260075675676,112.04328120000031,113.21624990000001,121.01562480000001,124.90624999999996,120.7995015782385,124.34806029273251,124.52403846153835,128.01425089637843,121.03382602669828,112.04328120000031,113.21624990000001,121.01562480000001,124.90624999999996,127.11979000000002,6456801,7410099.75,60.73140978148731,NaN,1.5,2.75,NaN,NaN,2.5103713766880094,0.8713514281639732,NaN,-0.03482881343853661,1.4514945065418914,1.486323319980428,27.85367638204418,2.6381909547738696,NaN,NaN,NaN,45569273
917879400,128.6875,128.6875,126.90625,126.90625,NaN,NaN,124.35,128.6875,112.12374995000032,113.4553124,121.2724998,125.08593749999996,121.03898190850366,124.59169740771037,124.72836538461527,128.4347937121058,121.02193705712476,112.12374995000032,113.4553124,121.2724998,125.08593749999996,127.5,9426801,7541914.8,58.436022322957804,NaN,1.5,2.75,NaN,NaN,2.4582912783531516,1.249921439048874,NaN,-0.0003657357053381549,1.4858661503487554,1.4862318860540935,25.104789258366946,1.3729405891163255,NaN,NaN,NaN,36142472
917965800,127.07812,127.21875,124.76562,126.125,NaN,NaN,124.68125,128.713542,112.1929687000003,113.7115624,121.49999980000001,125.24062499999995,121.23843359836626,124.73772622602367,124.93990384615374,128.62707475214907,121.25273294015842,112.1929687000003,113.7115624,121.49999980000001,125.24062499999995,126.03645666666667,9194500,7529119.9,56.05916707972434,NaN,1.5,2.75,NaN,NaN,2.457922615613641,1.2211918686538648,NaN,-0.04215301603893051,1.4335406160054305,1.475693632044361,25.327407898174616,-0.04952947003467063,NaN,NaN,NaN,26947972
918052200,125.6875,127.9375,125.65625,127.40625,NaN,NaN,125.0125,128.739584,112.26874995000031,114.0006249,121.7331248,125.38906249999995,121.4803087513715,124.99187134735475,125.41586538461527,128.62524397661977,122.20648679261076,112.26874995000031,114.0006249,121.7331248,125.38906249999995,127,10290699,7642104.85,59.00419892383378,NaN,1.5,2.75,NaN,NaN,2.44530314306981,1.346579143048528,NaN,0.0021780215655842206,1.4784161590013412,1.476238137435757,25.579668090193366,3.714067667260239,NaN,NaN,NaN,37238671
918138600,127.375,127.5,124.78125,125.5,NaN,NaN,125.34375,128.765626,112.33234370000031,114.2387499,121.91062480000001,125.29218749999995,121.6379437022981,125.04026455236858,125.50240384615374,128.65501852131007,122.34978917099741,112.33234370000031,114.2387499,121.91062480000001,125.29218749999995,125.92708333333333,7761102,7643275,53.28235766134424,NaN,1.5,2.75,NaN,NaN,2.464835061421966,1.015415773997403,NaN,-0.10526132135067856,1.3446614857474088,1.4499228070980874,21.46365667568904,2.39673635900051,NaN,NaN,NaN,29477569
918225000,125.65625,125.65625,123.21875,124.0625,NaN,NaN,125.675,128.791668,112.38718745000031,114.4449999,122.00437480000001,125.15468749999995,121.73302434142367,124.94714411880967,125.41586538461527,128.65877412533987,122.17295664389067,112.38718745000031,114.4449999,122.00437480000001,125.15468749999995,124.3125,7516102,7743835.2,49.392559235958686,NaN,1.5,2.75,NaN,NaN,2.462882557034683,0.9705916778807483,NaN,-0.2720408088476436,1.109871796038533,1.3819126048861765,22.77093637813684,0.20191822311963656,NaN,NaN,NaN,21961467
918484200,125.09375,125.09375,123.34375,124.3125,NaN,NaN,126.00625,128.81771,112.4487499500003,114.6474999,122.1181248,124.98281249999995,121.83418024960314,124.88670182178018,125.27163461538451,128.53117908932296,122.01209014144605,112.4487499500003,114.6474999,122.1181248,124.98281249999995,124.25,8528398,7859160.2,50.07517614615061,NaN,1.5,2.75,NaN,NaN,2.4119623743893484,1.085153856515102,NaN,-0.3589583493096782,0.9332146682490787,1.292173017558757,22.073065055751666,-1.3882002974714922,NaN,NaN,NaN,30489865
918570600,124.375,124.5,121.51562,121.53125,NaN,NaN,126.3375,128.843752,112.50234370000031,114.8128124,122.17624980000001,124.73281249999995,121.82230063197164,124.56713498161064,125.17067307692297,128.7865946818995,121.55475147194645,112.50234370000031,114.8128124,122.17624980000001,124.73281249999995,122.51562333333332,8985699,7929530.1,43.108711845587685,NaN,1.5,2.75,NaN,NaN,2.452849347647252,1.1331943868905927,NaN,-0.5838927622171843,0.5623070647872765,1.1461998270044609,22.525374491393336,-2.457988462503135,NaN,NaN,NaN,21504166
918657000,122.125,123,121.32812,122.3125,NaN,NaN,121.32812,128.86979399999998,112.57031245000032,115.0159374,122.2324998,124.63593749999995,121.8415241366002,124.35240784050487,125.15144230769221,128.82484644133547,121.47803817404896,112.57031245000032,115.0159374,122.2324998,124.63593749999995,122.21354000000001,6936699,7887925,45.40627441888715,NaN,1.5,2.75,NaN,NaN,2.3970658228153057,0.8794073219509567,NaN,-0.6548608062663975,0.327623819171464,0.9824846254378615,22.554288685965886,-3.4533793783917117,NaN,NaN,NaN,28440865
918743400,123.0625,126.09375,122.5,125.125,NaN,NaN,121.37828421052632,128.895836,112.6531249500003,115.24624990000001,122.4124998,124.72343749999996,121.97028789594921,124.42598804617107,125.25240384615374,128.84430023589385,121.66050745641363,112.6531249500003,115.24624990000001,122.4124998,124.72343749999996,124.57291666666667,9181801,7806484.95,52.7968718267471,NaN,1.5,2.75,NaN,NaN,2.495936121185641,1.176176097028151,NaN,-0.4944832611294363,0.3643805490260661,0.8588638101555024,24.552285430717856,-1.9828641370869033,NaN,NaN,NaN,37622666
918829800,124.8125,125.5,122.625,123.625,NaN,NaN,121.42844842105264,128.921878,112.72468745000032,115.4621874,122.53249980000001,124.84374999999996,122.0351785666963,124.34970347034526,125.06490384615374,128.7219621508393,121.40784554146819,112.72468745000032,115.4621874,122.53249980000001,124.84374999999996,123.91666666666667,10676602,7770280.1,48.98788953077638,NaN,1.5,2.75,NaN,NaN,2.523012112529524,1.3740305191829572,NaN,-0.4715966863647205,0.26936795219960175,0.7409646385643223,24.551249423247267,-2.5855700566362967,NaN,NaN,NaN,26946064
919175400,124.75,125.625,122.875,122.875,NaN,NaN,121.47861263157894,128.94791999999998,112.78234370000031,115.66218740000001,122.64437480000001,124.76874999999995,122.06811274055136,124.20925552078857,124.93269230769221,128.76824259493773,121.09714202044668,112.78234370000031,115.66218740000001,122.64437480000001,124.76874999999995,123.79166666666667,6915500,7725420.15,47.15602790067581,NaN,1.5,2.75,NaN,NaN,2.5392255330631293,0.8951616696212956,NaN,-0.48714842814836246,0.1320291033788692,0.6191775315272317,24.559186152301052,-2.576808721506442,NaN,NaN,NaN,20030564
919261800,123.1875,125.35937,122.25,122.75,NaN,NaN,121.52877684210526,128.973962,112.83312495000031,115.8196874,122.7924998,124.64687499999995,122.09485341739249,124.070278804523,124.6298076923076,128.48504935965926,120.77456602495593,112.83312495000031,115.8196874,122.7924998,124.64687499999995,123.45312333333334,7858102,7791570.15,46.841637384318844,NaN,1.5,2.75,NaN,NaN,2.5799501378443344,1.0085389528322477,NaN,-0.48498096437444077,0.012951326059180701,0.49793229043362147,24.51113865454145,-3.6546480255089526,NaN,NaN,NaN,12172462
919348200,123.1875,124.375,122.21875,123.71875,NaN,NaN,121.57894105263158,129.000004,112.8901562000003,116.01312490000001,122.8993748,124.52343749999996,122.15853563631828,124.0367998707589,124.32692307692297,127.78134953152235,120.87249662232358,112.8901562000003,116.01312490000001,122.8993748,124.52343749999996,123.4375,9048898,7917295.15,49.64366689313797,NaN,1.5,2.75,NaN,NaN,2.5496858422840245,1.1429279606937477,NaN,-0.40091512834777404,-0.003211620001096094,0.39770350834667795,24.11290544555758,-1.4193227091633467,NaN,NaN,NaN,21221360
919434600,124,125.75,123.375,124.25,NaN,NaN,121.6291052631579,129.02604599999998,112.95374995000032,116.2131249,123.0056248,124.59374999999996,122.24055384665874,124.05710464497234,124.12259615384605,127.24042075628239,121.0047715514097,112.95374995000032,116.2131249,123.0056248,124.59374999999996,124.45833333333333,5312199,7836030.1,51.16391292883483,NaN,1.5,2.75,NaN,NaN,2.5372082821208797,0.6779196777204824,NaN,-0.2969303105108547,0.026540620208109544,0.32347093071896427,23.087053857506334,0.15113350125944586,NaN,NaN,NaN,26533559
919693800,124.4375,127.71875,124.28125,127.5625,NaN,NaN,121.67926947368422,129.052088,113.0404687000003,116.4368749,123.18874980000001,124.84374999999996,122.44925761737801,124.39095182164164,124.23317307692297,127.70867243443797,120.75767371940796,113.0404687000003,116.4368749,123.18874980000001,124.84374999999996,126.52083333333333,10695801,7994705.1,59.395373923341275,NaN,1.5,2.75,NaN,NaN,2.6037469762551027,1.337860604764521,NaN,-0.0077420750145014705,0.31379333695083744,0.3215354119653389,26.695509988260163,2.6143790849673203,NaN,NaN,NaN,37229360
919780200,127.59375,128.5,126.59375,127.5,NaN,NaN,121.72943368421052,129.07813,113.13124995000031,116.6624999,123.3662498,125.02812499999996,122.64732594610828,124.68705164815195,124.24038461538451,127.74247744911176,120.73829178165727,113.13124995000031,116.6624999,123.3662498,125.02812499999996,127.53125,7770699,8098225,59.192646436675574,NaN,1.5,2.75,NaN,NaN,2.5539257636654527,0.959555828592068,NaN,0.16700137988913483,0.5302871368267574,0.3632857569376226,26.76030260169407,4.911288248907174,NaN,NaN,NaN,29458661
919866600,127.84375,128.84375,125,125.25,NaN,NaN,121.77959789473684,129.10417199999998,113.20187495000032,116.8974999,123.5334374,124.98749999999995,122.7493915952805,124.74066577689938,124.22115384615374,127.6980229424955,120.74428474981198,113.20187495000032,116.8974999,123.5334374,124.98749999999995,126.36458333333333,7271000,8159425,52.27524082626514,NaN,1.5,2.75,NaN,NaN,2.6460560662607775,0.8911167147194808,NaN,0.12087095329836084,0.5143744485605737,0.39350349526221284,25.202847186174377,2.401635155850792,NaN,NaN,NaN,22187661
919953000,124.53125,125.28125,122.6875,124.0625,NaN,NaN,121.82976210526316,129.130214,113.2684374500003,117.1499999,123.6721874,124.96093749999996,122.8008860425244,124.67607856005182,124.22115384615374,127.6980229424955,120.74428474981198,113.2684374500003,117.1499999,123.6721874,124.96093749999996,124.01041666666669,11633000,8371105.1,49.01928685399291,NaN,1.5,2.75,NaN,NaN,2.642319918670722,1.389661204946525,NaN,0.006250068467883563,0.40131608084706727,0.3950660123791837,26.059776194483526,-0.8491508491508492,NaN,NaN,NaN,10554661
920039400,124.75,124.84375,122.8125,123.5625,NaN,NaN,121.87992631578948,129.15625599999998,113.32656245000031,117.3784374,123.8684374,124.80468749999996,122.83075325654305,124.5700234590945,124.16346153846143,127.65720197864525,120.66972109827762,113.32656245000031,117.3784374,123.8684374,124.80468749999996,123.73958333333333,9621301,8554085.2,47.67288494638221,NaN,1.5,2.75,NaN,NaN,2.5986720673370987,1.1247609504754525,NaN,-0.10143029381737978,0.26827814510745895,0.36970843892483873,22.316420690062248,-0.05055611729019211,NaN,NaN,NaN,933360
920298600,123.65625,124.3125,122.375,123.90625,NaN,NaN,121.93009052631578,129.18229799999997,113.3849999500003,117.6306249,124.0128124,124.61718749999996,122.87292959942371,124.50680693918073,124.34615384615374,127.50229308055711,121.19001461175037,113.3849999500003,117.6306249,124.0128124,124.61718749999996,123.53125,7607199,8611605.1,48.71579944560551,NaN,1.5,2.75,NaN,NaN,2.5514454910987348,0.883365982492625,NaN,-0.14503835450420288,0.18841049579458513,0.333448850298788,21.291406686935876,0.8392675483214649,NaN,NaN,NaN,8540559
920385000,124.5,125.3125,122.3125,122.8125,NaN,NaN,121.9802547368421,129.20834,113.44078120000032,117.8728124,124.1384374,124.41249999999995,122.87055981121102,124.34544437354447,124.38461538461527,127.45161410309055,121.31761666614,113.44078120000032,117.8728124,124.1384374,124.41249999999995,123.47916666666669,9651500,8622840.05,45.601495191230185,NaN,1.5,2.75,NaN,NaN,2.5834850988773965,1.1192947966140228,NaN,-0.2376084512255215,0.036438286266886166,0.27404673749240765,21.649044125670013,0.05091649694501019,NaN,NaN,NaN,-1110941
920471400,123.09375,123.5625,121.78125,123.46875,NaN,NaN,121.78125,129.23438199999998,113.50296870000031,118.1362499,124.24,124.27968749999995,122.89401824998706,124.26194967130213,124.25721153846143,127.3282019127163,121.18622116420657,113.50296870000031,118.1362499,124.24,124.27968749999995,122.9375,7881398,8557184.95,47.7594143741456,NaN,1.5,2.75,NaN,NaN,2.526182591814725,0.9210269552488755,NaN,-0.24379185674151443,-0.030693083434485402,0.21309877330702903,21.850280809119614,-0.20207123010861328,NaN,NaN,NaN,6770457
920557800,124.0625,125.48437,123.26562,125.03125,NaN,NaN,121.81361642857144,129.26042399999997,113.57515620000031,118.4206249,124.370625,124.16093749999996,122.97783125979149,124.33521636927335,124.36538461538451,127.43874493254906,121.29202429821997,113.57515620000031,118.4206249,124.370625,124.16093749999996,124.59374666666668,8256398,8455469.9,52.58247264735957,NaN,1.5,2.75,NaN,NaN,2.504223120970816,0.9764564356145363,NaN,-0.1371152046732998,0.0417047674654043,0.1788199721387041,22.57834764501168,0.6287726358148893,NaN,NaN,NaN,15026855
920644200,127.5,128.125,126.5625,127.54687,NaN,NaN,121.84598285714286,129.286466,113.65617180000031,118.7107811,124.5184374,124.26328099999996,123.15700924960359,124.64108814362827,124.72475923076912,128.09520399911588,121.35431446242237,113.65617180000031,118.7107811,124.5184374,124.26328099999996,127.41145666666667,10703102,8602569.9,59.12547254451837,NaN,1.5,2.75,NaN,NaN,2.546332183758615,1.2441749528823938,NaN,0.09584618367470657,0.2986277017320873,0.20278151805738073,25.038967558129862,-0.012252817246449063,NaN,NaN,NaN,25729957
920903400,128.28125,128.79687,127.25,128.375,NaN,NaN,121.87834928571428,129.31250799999998,113.7360155500003,118.99484360000001,124.6721874,124.47890599999997,123.36163633785443,124.99669879661604,125.15745153846143,128.8331663393441,121.48173673757877,113.7360155500003,118.99484360000001,124.6721874,124.47890599999997,128.14062333333334,4802199,8466874.75,61.03175403152797,NaN,1.5,2.75,NaN,NaN,2.4749420277758576,0.5671749189392461,NaN,0.28783805489739306,0.562579086679122,0.274741031781729,20.325472712255205,0.6862745098039216,NaN,NaN,NaN,30532156
920989800,128.125,129.9375,127.75,128.0625,NaN,NaN,121.91071571428571,129.33854999999997,113.8178905500003,119.27921860000001,124.7690624,124.66640599999997,123.54598393244838,125.288679863605,125.49158615384604,129.36768272040337,121.6154895872887,113.8178905500003,119.27921860000001,124.7690624,124.66640599999997,128.58333333333334,7893398,8435124.75,59.89655421765137,NaN,1.5,2.75,NaN,NaN,2.454410454363296,0.9357772687357113,NaN,0.37063811232525334,0.7380386721882957,0.3674005598630423,20.39532894943358,2.245508982035928,NaN,NaN,NaN,22638758
921076200,128.46875,129.25,127.78125,129.1875,NaN,NaN,121.94308214285715,129.364592,113.9075780500003,119.5654686,124.8990624,125.04921849999997,123.76721985666609,125.65999606707119,125.87139384615374,130.13470232768037,121.60808536462712,113.9075780500003,119.5654686,124.8990624,125.04921849999997,128.73958333333334,3960100,8183844.8,62.59395474874523,NaN,1.5,2.75,NaN,NaN,2.3840061361944893,0.48389236315918405,NaN,0.47155147294001887,0.9568399010380659,0.48528842809804706,17.144153532480924,4.130982367758186,NaN,NaN,NaN,26598858
921162600,129.6875,131.1875,128.875,130.625,NaN,NaN,121.97544857142857,129.39063399999998,114.0133593000003,119.8120311,125.0640624,125.46484349999996,124.03615241130663,126.13285358449298,126.10697076923066,131.00867610963684,121.20526542882446,114.0133593000003,119.8120311,125.0640624,125.46484349999996,130.22916666666666,6583699,8166194.8,65.76280648987336,NaN,1.5,2.75,NaN,NaN,2.37889855503774,0.8062138071945087,NaN,0.5973961147156255,1.232033571492579,0.6346374567769535,15.604058763787842,5.715730905412241,NaN,NaN,NaN,33182557
921249000,131,131.03125,129.21875,129.375,NaN,NaN,122.007815,129.41667599999997,114.1121093000003,120.0457811,125.1653124,125.67734349999996,124.24551898341225,126.44162943358889,126.25120153846143,131.4118775963391,121.09052548058375,114.1121093000003,120.0457811,125.1653124,125.67734349999996,129.875,5286500,7971429.75,60.92918810451577,NaN,1.5,2.75,NaN,NaN,2.3384415153921876,0.663180905533289,NaN,0.5593986583571594,1.3338857797234027,0.7744871213662433,17.062562783185292,4.4136191677175285,NaN,NaN,NaN,27896057
921508200,129.9375,131.25,129.5,131.21875,NaN,NaN,122.04018142857143,129.44271799999999,114.2175780500003,120.29421860000001,125.3234374,126.05703099999997,124.51897902327843,126.89659329705661,126.71033615384604,132.4613106512855,120.9593616564066,114.2175780500003,120.29421860000001,125.3234374,126.05703099999997,130.65625,5394398,7707319.55,65.01392381511235,NaN,1.5,2.75,NaN,NaN,2.3053385500070314,0.6999058446979793,NaN,0.6168609532260849,1.5455633128988495,0.9287023596727646,17.8470886963917,6.844783715012722,NaN,NaN,NaN,33290455
921594600,131.125,131.65625,130.46875,130.71875,NaN,NaN,122.07254785714287,129.46875999999997,114.3260155500003,120.5314061,125.4715624,126.44921849999996,124.76210729687536,127.26060822114646,127.22235538461527,133.12249272820014,121.3222180410304,114.3260155500003,120.5314061,125.4715624,126.44921849999996,130.94791666666666,4547500,7588919.55,63.08769084522484,NaN,1.5,2.75,NaN,NaN,2.2254929392922436,0.599228911314523,NaN,0.5801647018894678,1.6539082370345994,1.0737435351451317,16.525158367162106,5.871931156669198,NaN,NaN,NaN,28742955
921681000,130.6875,130.9375,129.625,130.15625,NaN,NaN,122.10491428571429,129.49480199999996,114.4291405500003,120.7667186,125.61406240000001,126.81953099999996,124.97364230484104,127.53638362865631,127.72956692307682,133.4137294629481,122.04540438320552,114.4291405500003,120.7667186,125.61406240000001,126.81953099999996,130.23958333333334,4524102,7422219.55,60.90159933487925,NaN,1.5,2.75,NaN,NaN,2.160279157914226,0.6095349200496232,NaN,0.4810644593786795,1.675074109368481,1.1940096499898014,17.60742662997084,4.098975256185954,NaN,NaN,NaN,24218853
921767400,129.78125,132.375,129.75,132.25,NaN,NaN,122.13728071428571,129.52084399999998,114.54226555000031,121.0070311,125.77031240000001,127.24609349999996,125.25898966543551,127.98529947354619,128.37139384615372,134.0680286639319,122.67475902837555,114.54226555000031,121.0070311,125.77031240000001,127.24609349999996,131.45833333333334,3506300,7145089.65,65.67011328440489,NaN,1.5,2.75,NaN,NaN,2.1934735037774957,0.49072862227837827,NaN,0.5164648289373477,1.8395906861614861,1.3231258572241384,18.21564388077179,3.687373904196945,NaN,NaN,NaN,27725153
921853800,132.3125,132.625,129.6875,129.6875,NaN,NaN,122.16964714285714,129.54688599999997,114.6513280500003,121.2354686,125.8153124,127.51796849999997,125.43265673737922,128.14741380939893,128.90023999999988,133.62864432056347,124.1718356794363,114.6513280500003,121.2354686,125.8153124,127.51796849999997,130.66666666666666,5526699,7155814.65,56.57564502072161,NaN,1.5,2.75,NaN,NaN,2.2466182535076746,0.7723368016526252,NaN,0.3359837055964614,1.7431054892197153,1.407121783623254,20.77489852153722,1.0223953261927945,NaN,NaN,NaN,22198454
922113000,130.0625,130.59375,129.42187,129.9375,NaN,NaN,122.20201357142858,129.57292799999996,114.7516405500003,121.4585936,125.8778124,127.63671849999996,125.60931725748199,128.31789820850378,129.39783615384604,132.95046784049472,125.84520446719738,114.7516405500003,121.4585936,125.8778124,127.63671849999996,129.98437333333334,4603801,6851214.65,57.19841859987394,NaN,1.5,2.75,NaN,NaN,2.1698512353999826,0.6719685829723638,NaN,0.20837476820169032,1.6675902438753667,1.4592154756736764,20.553140666563028,1.4641288433382138,NaN,NaN,NaN,26802255
922199400,129.3125,129.53125,125.70312,126.1875,NaN,NaN,122.23438,129.59896999999998,114.8225780500003,121.65046860000001,125.8465624,127.57109349999996,125.63199109052191,128.11500314102722,129.48677846153834,132.6322375923452,126.34131933073147,114.8225780500003,121.65046860000001,125.8465624,127.57109349999996,127.14062333333335,9713801,6948369.75,46.43966776099571,NaN,1.5,2.75,NaN,NaN,2.317317575728555,1.3979971345077022,NaN,-0.13515101950177066,1.290276701296463,1.4254277207982338,27.031205153963022,-2.3222060957910013,NaN,NaN,NaN,17088454
922285800,126.84375,127.17187,125.625,126.90625,NaN,NaN,125.625,129.62501199999997,114.89773430000031,121.8514061,125.8540624,127.65390599999996,125.6819620281485,127.99988379426271,129.4374999999999,132.72006612800052,126.15493387199925,114.89773430000031,121.8514061,125.8540624,127.65390599999996,126.56770666666668,6280898,6898864.65,48.4414187852096,NaN,1.5,2.75,NaN,NaN,2.2622856060336582,0.910424876939715,NaN,-0.31050789483649144,1.0372928522526195,1.347800747089111,26.662578593989597,-2.84688995215311,NaN,NaN,NaN,23369352
922372200,128.0625,129.5,127.75,129.5,NaN,NaN,125.88125,129.65105399999996,114.9841405500003,122.0523436,125.95906240000001,127.92578099999996,125.8316890074368,128.14275200433292,129.52403846153837,132.7488068124788,126.29927011059794,114.9841405500003,122.0523436,125.95906240000001,127.92578099999996,128.91666666666666,6639602,6649194.75,54.980311640268596,NaN,1.5,2.75,NaN,NaN,2.2859616341741114,0.998557306506927,NaN,-0.25090142674342886,1.0341739636598248,1.2850753904032537,28.713477157719527,0.0966183574879227,NaN,NaN,NaN,30008954
922458600,128.625,129.125,127.71875,128.5625,NaN,NaN,126.1375,129.67709599999998,115.0694530500003,122.2379686,126.0628124,128.17578099999997,125.93877963459613,128.18272800392026,129.5624999999999,132.72800670389185,126.39699329610792,115.0694530500003,122.2379686,126.0628124,128.17578099999997,128.46875,6159699,6476114.65,52.39381946892223,NaN,1.5,2.75,NaN,NaN,2.249910803161675,0.951141129041006,NaN,-0.27193342679111376,0.9451586069143616,1.2170920337054754,28.482761292638454,-2.0242914979757085,NaN,NaN,NaN,23849255
922717800,129.15625,131.4375,129.15625,131.15625,NaN,NaN,126.39375,129.70313799999997,115.1782030500003,122.4307811,126.2615624,128.53828099999996,126.14338631559237,128.46592057497548,129.7139423076922,132.97997581213426,126.44790880325014,115.1782030500003,122.4307811,126.2615624,128.53828099999996,130.58333333333334,5863898,6388949.6,58.246305684220154,NaN,1.5,2.75,NaN,NaN,2.29456003150727,0.9178187913706504,NaN,-0.1164296076042024,1.0715550242002223,1.1879846318044247,29.75305024457446,0.33468802295003586,NaN,NaN,NaN,29713153
922804200,129.9375,131.21875,129.5625,130.46875,NaN,NaN,126.65,129.72917999999996,115.2783593000003,122.6248436,126.3834374,128.92109349999996,126.31300842086326,128.65666623450164,129.70192307692298,132.95558368039144,126.44826247345452,115.2783593000003,122.6248436,126.3834374,128.92109349999996,130.41666666666666,5401398,6176444.5,56.271629784425144,NaN,1.5,2.75,NaN,NaN,2.248966457828179,0.8745157509308147,NaN,-0.06756466692254337,1.1035287981512454,1.1710934650737888,29.83086604036786,0.24009603841536614,NaN,NaN,NaN,24311755
922890600,131.15625,131.60937,128.3125,128.375,NaN,NaN,126.90625,129.75522199999997,115.3825780500003,122.7860936,126.4471874,129.16640599999997,126.39387083573136,128.6298408788348,129.6249999999999,132.95238852903444,126.29761147096532,115.3825780500003,122.7860936,126.4471874,129.16640599999997,129.43229,7413602,6153054.7,50.64088862285655,NaN,1.5,2.75,NaN,NaN,2.323816710840453,1.2048652842302865,NaN,-0.1776900864863311,0.9489808569658749,1.126670943452206,31.174138696712753,-2.9300567107750473,NaN,NaN,NaN,16898153
922977000,129.6875,129.6875,128.125,129.34375,NaN,NaN,127.1625,129.78126399999996,115.4833593000003,122.9417186,126.5103124,129.38203099999996,126.50955237158503,128.69783222370768,129.4807692307691,132.67937718197498,126.28216127956324,115.4833593000003,122.9417186,126.5103124,129.38203099999996,129.05208333333334,7683602,6124414.9,52.985030036525885,NaN,1.5,2.75,NaN,NaN,2.269436945780421,1.2545854788512123,NaN,-0.18584804013798495,0.8943608932797247,1.0802089334177096,29.806215530076866,-0.26506024096385544,NaN,NaN,NaN,24581755
923319000,130.9375,132.59375,130.25,132.40625,NaN,NaN,127.41875,129.80730599999995,115.5880468000003,123.1245311,126.7015624,129.62499999999994,126.7407954158366,129.05101486906887,129.61057692307682,133.12134464750127,126.09980919865238,115.5880468000003,123.1245311,126.7015624,129.62499999999994,131.75,5791102,5878814.9,59.52858726451096,NaN,1.5,2.75,NaN,NaN,2.339477163938962,0.9850798330119221,NaN,0.004374710711680496,1.0856773218073101,1.0813026110956296,30.83609192517361,1.8999518999519,NaN,NaN,NaN,30372857
923405400,132.1875,132.98437,131.15625,132.09375,NaN,NaN,127.675,129.83334799999997,115.6936718000003,123.3123436,126.8921874,129.81093749999997,126.95071520345086,129.34079916725278,129.75961538461527,133.50692087614073,126.01230989308982,115.6936718000003,123.3123436,126.8921874,129.81093749999997,132.07812333333334,5381301,5907770,58.631840381004864,NaN,1.5,2.75,NaN,NaN,2.3029516522290367,0.9108853255966295,NaN,0.09357226670690055,1.1982679444792552,1.1046956777723547,30.941444626724056,4.680534918276375,NaN,NaN,NaN,24991556
923491800,132.6875,133.375,131.375,133.15625,NaN,NaN,127.93125,129.85938999999996,115.80914055000031,123.5139061,127.0790624,130.06562499999995,127.19406950919787,129.70417543703823,129.82932692307682,133.78715869344657,125.87149515270706,115.80914055000031,123.5139061,127.0790624,130.06562499999995,132.63541666666666,6248602,5825530.2,60.79434297371278,NaN,1.5,2.75,NaN,NaN,2.281312248498391,1.0726237416123943,NaN,0.20230932209913166,1.3575823303962693,1.1552730082971376,23.92064886477946,4.924895345973898,NaN,NaN,NaN,31240158
923578200,133.1875,134.9375,132.28125,134.84375,NaN,NaN,128.1875,129.88543199999995,115.9303905500003,123.7398436,127.25468740000001,130.34843749999996,127.49405697942541,130.1936587287489,130.22596153846143,134.99730489811344,125.45461817880943,115.9303905500003,123.7398436,127.25468740000001,130.34843749999996,134.02083333333334,5909102,5922980.3,64.01205389055468,NaN,1.5,2.75,NaN,NaN,2.308093516462791,0.9976568721661965,NaN,0.35701811706529063,1.601545654628751,1.2445275375634604,24.278289990230817,4.126447876447877,NaN,NaN,NaN,37149260
923664600,134.4375,135.5,133.59375,134.875,NaN,NaN,128.44375,129.91147399999997,116.0452343000003,123.9673436,127.4603124,130.56093749999997,127.7835057253303,130.63950075458231,130.6057692307691,135.9735829902324,125.23795547130584,116.0452343000003,123.9673436,127.4603124,130.56093749999997,134.65625,4365801,5812085.4,64.07086183656146,NaN,1.5,2.75,NaN,NaN,2.27939040814402,0.7511591278407574,NaN,0.4259192948953425,1.7769266561826385,1.351007361287296,22.672038008238903,4.910063198833252,NaN,NaN,NaN,41515061
923923800,133.46875,136.40625,133.21875,136.3125,NaN,NaN,128.7,129.93751599999996,116.1597655500003,124.1982811,127.6528124,130.90781249999995,128.11797608904283,131.17978639700306,131.38461538461527,136.89833214241895,125.8708986268116,116.1597655500003,124.1982811,127.6528124,130.90781249999995,135.3125,8213199,5958420.35,66.76154346367532,NaN,1.5,2.75,NaN,NaN,2.344255378990876,1.3784188623080278,NaN,0.5261988405945361,2.008755912030466,1.48255707143593,21.704401823210866,3.9313795568263044,NaN,NaN,NaN,49728260
924010200,136.25,136.46875,134.5,135.4375,NaN,NaN,128.95625,129.96355799999995,116.2708593000003,124.41203110000001,127.8084374,131.11874999999995,128.4050162424137,131.58528293062182,132.04086538461527,137.29077292818698,126.79095784104358,116.2708593000003,124.41203110000001,127.8084374,131.11874999999995,135.46875,10071398,6192270.35,63.63752441666453,NaN,1.5,2.75,NaN,NaN,2.317433566205813,1.626446752280446,NaN,0.4921112587093184,2.097696144822578,1.6055848861132596,20.688075389161263,3.808383233532934,NaN,NaN,NaN,39656862
924096600,136.0625,136.0625,132.6875,133.15625,NaN,NaN,129.2125,129.98959999999997,116.3682030500003,124.6029686,127.9334374,131.24062499999997,128.59133913486806,131.73489884199117,132.32211538461527,137.38585482307977,127.25837594615078,116.3682030500003,124.6029686,127.9334374,131.24062499999997,133.96875,11551699,6542480.3,56.24758771797195,NaN,1.5,2.75,NaN,NaN,2.392974025762541,1.7656452095086936,NaN,0.28472668090146547,1.9614932372400915,1.676766556338626,23.360724134069365,3.72444011684518,NaN,NaN,NaN,28105163
924183000,133.4375,133.5625,131,132.65625,NaN,NaN,129.46875,130.01564199999996,116.4610155500003,124.7820311,128.0640624,131.36562499999997,128.7507474040889,131.82264657132535,132.6370192307691,137.21195213680576,128.06208632473246,116.4610155500003,124.7820311,128.0640624,131.36562499999997,132.40625,11150000,6873775.2,54.74697247008987,NaN,1.5,2.75,NaN,NaN,2.4050830239223595,1.62210716463349,NaN,0.09262060960061946,1.7925423183394003,1.6999217087387808,20.766577607166212,2.561005073689297,NaN,NaN,NaN,16955163
924269400,132.90625,132.90625,131.1875,131.53125,NaN,NaN,129.725,130.04168399999995,116.5521093000003,124.9398436,128.1465624,131.32968749999995,128.85978672157563,131.79489451691342,132.66586538461527,137.2076971678061,128.12403360142446,116.5521093000003,124.9398436,128.1465624,131.32968749999995,131.875,6476199,7022270.15,51.42276529695695,NaN,1.5,2.75,NaN,NaN,2.356059236499334,0.9222372340659665,NaN,-0.11993581310824442,1.5500019423534752,1.6699377554617196,21.589621261402648,-0.660844937455747,NaN,NaN,NaN,10478964
924528600,132.6875,134.53125,128.375,129.5,NaN,NaN,129.98125,130.06772599999996,116.6264843000003,125.0685936,128.2265624,131.32031249999994,128.8848931246511,131.57633313435022,132.59134615384605,137.3035223273357,127.87916998035638,116.6264843000003,125.0685936,128.2265624,131.32031249999994,130.80208333333334,12487199,7370295.15,45.99261760883202,NaN,1.5,2.75,NaN,NaN,2.6275014338922387,1.6942603716487528,NaN,-0.391728960835396,1.1802765544174747,1.5720055152528707,18.626062932036334,-1.9635675419919565,NaN,NaN,NaN,-2008235
924615000,129.8125,131.1875,129,131.125,NaN,NaN,130.2375,130.09376799999995,116.7078905500003,125.1860936,128.3678124,131.37968749999996,128.97274045309615,131.53334902631687,132.8028846153845,136.9522433916919,128.6535258390771,116.7078905500003,125.1860936,128.3678124,131.37968749999996,130.4375,9049602,7592585.2,50.496307500431556,NaN,1.5,2.75,NaN,NaN,2.596072760042793,1.1918999605035712,NaN,-0.45217653140353087,1.0067848509984572,1.458961382401988,20.43656026477859,-1.5254635062191975,NaN,NaN,NaN,7041367
924701400,131.0625,135.625,130.40625,134.875,NaN,NaN,130.49375,130.11980999999994,116.8022655500003,125.3485936,128.5790624,131.81406249999995,129.20420161179825,131.85160150000098,133.22836538461527,136.98767950790727,129.46905126132327,116.8022655500003,125.3485936,128.5790624,131.81406249999995,133.63541666666666,5772199,7395505.1,58.994394376504104,NaN,1.5,2.75,NaN,NaN,2.783406848611165,0.7805009829551737,NaN,-0.240344889725026,1.1585302702457057,1.3988751599707316,26.084646258966067,0.023174971031286212,NaN,NaN,NaN,12813566
924787800,135.125,136.375,134.39062,136.15625,NaN,NaN,130.75,130.14585199999996,116.9041405500003,125.5239061,128.87156240000002,132.27656249999995,129.4768309603552,132.2615680238104,133.51682692307682,137.54539194907787,129.48826189707577,116.9041405500003,125.5239061,128.87156240000002,132.27656249999995,135.64062333333334,6897398,7426330.1,61.43059898596389,NaN,1.5,2.75,NaN,NaN,2.7263335022817956,0.92877611244348,NaN,-0.02596054035663231,1.3664244845249414,1.3923850248815737,25.646217466580435,0.9499536607970342,NaN,NaN,NaN,19710964
924874200,135.875,136.75,135,135.8125,NaN,NaN,131.00625,130.17189399999995,117.0000780500003,125.6870311,129.1415624,132.59218749999997,129.72528856975302,132.59975202154274,133.8028846153845,137.91390292278152,129.69186630798748,117.0000780500003,125.6870311,129.1415624,132.59218749999997,135.85416666666666,4593102,7324005.1,60.39388957148515,NaN,1.5,2.75,NaN,NaN,2.656595394975953,0.6271298199942543,NaN,0.07514088050941403,1.4863111255183412,1.4111702450089272,25.72381443062277,-0.36680421824850984,NaN,NaN,NaN,15117862
925133400,136.5,136.8125,135.46875,136.59375,NaN,NaN,131.2625,130.19793599999994,117.1038280500003,125.8917186,129.3709374,132.99374999999995,129.99463999839014,132.9801327813958,134.0673076923076,138.41342431060497,129.72119107401022,117.1038280500003,125.8917186,129.3709374,132.99374999999995,136.29166666666666,3606500,7196345.15,61.964934023092674,NaN,1.5,2.75,NaN,NaN,2.562820723906242,0.5011571742080769,NaN,0.17156246343001125,1.6256233242964413,1.45406086086643,25.185229320826803,0.8537148131056761,NaN,NaN,NaN,18724362
925219800,137.125,137.5,135.84375,137.25,NaN,NaN,131.51875,130.22397799999996,117.2077343000003,126.08796860000001,129.6434374,133.29843749999995,130.2791639200219,133.38678680221525,134.25240384615375,138.90890142208227,129.59590627022524,117.2077343000003,126.08796860000001,129.6434374,133.29843749999995,136.86458333333334,5147199,7160510.2,63.2824735849237,NaN,1.5,2.75,NaN,NaN,2.498065672198653,0.718831320148109,NaN,0.25162800234923344,1.7685958638029717,1.5169678614537383,24.92485333253892,3.074395681764844,NaN,NaN,NaN,23871561
925306200,136.4375,137.25,135,135.375,NaN,NaN,131.775,130.25001999999995,117.3021093000003,126.26890610000001,129.8934374,133.54374999999996,130.47900062904063,133.57614044009952,134.29086538461527,138.9754724801052,129.60625828912535,117.3021093000003,126.26890610000001,129.8934374,133.54374999999996,135.875,5544301,7167655.35,57.187177686741514,NaN,1.5,2.75,NaN,NaN,2.480346695613035,0.7735166842250584,NaN,0.15513274925051346,1.71088379801688,1.5557510487663666,24.1136613103824,2.049469964664311,NaN,NaN,NaN,18327260
925392600,135.5625,136.0625,133.8125,134.34375,NaN,NaN,132.03125,130.27606199999994,117.3847655500003,126.45890610000001,130.1253124,133.84218749999997,130.63055942790177,133.649246112471,134.13942307692298,138.6778285932085,129.60101756063747,117.3847655500003,126.45890610000001,130.1253124,133.84218749999997,134.73958333333334,9824301,7288190.3,54.1007103367638,NaN,1.5,2.75,NaN,NaN,2.4638933602121043,1.347975367767222,NaN,0.006523627814693622,1.5639055835347335,1.55738195572004,24.53124134610101,2.1382751247327154,NaN,NaN,NaN,8502959
925479000,135.09375,135.625,131.5,133.25,NaN,NaN,132.2875,130.30210399999996,117.4630468000003,126.6076561,130.3159374,134.03749999999997,130.7332825875919,133.61122267318805,133.97115384615375,138.46657496333336,129.47573272897415,117.4630468000003,126.6076561,130.3159374,134.03749999999997,133.45833333333334,10991898,7453605.1,50.95929593525335,NaN,1.5,2.75,NaN,NaN,2.582543834482668,1.4747089297768137,NaN,-0.17096259362685418,1.3436787136864723,1.5146413073133265,24.48220772653079,2.8957528957528957,NaN,NaN,NaN,-2488939
925738200,133.4375,135.84375,133.09375,135.6875,NaN,NaN,132.54375,130.32814599999995,117.5494530500003,126.7751561,130.54468740000002,134.20156249999997,130.9275656233726,133.80896337097965,134.16586538461527,138.72209689346033,129.60963387577021,117.5494530500003,126.7751561,130.54468740000002,134.20156249999997,134.875,10709699,7699534.95,56.9576182648405,NaN,1.5,2.75,NaN,NaN,2.5945049891624774,1.390954008202794,NaN,-0.13149851721034378,1.3502681608003968,1.4817666780107406,23.612404855447245,3.4795042897998094,NaN,NaN,NaN,8220760
925824600,135.125,135.8125,133.125,133.75,NaN,NaN,132.8,130.35418799999994,117.6253905500003,126.9285936,130.66843740000002,134.28437499999995,131.03824932441682,133.80334781183873,134.2499999999999,138.73139851970163,129.76860148029814,117.6253905500003,126.9285936,130.66843740000002,134.28437499999995,134.22916666666666,10509301,7955934.95,51.559261740298,NaN,1.5,2.75,NaN,NaN,2.601147489936586,1.3209385277842172,NaN,-0.2370255367013081,1.1854847571341054,1.4225102938354135,25.326985645022,-0.8341056533827618,NaN,NaN,NaN,-2288541
925911000,133.9375,135.0625,131.84375,134.8125,NaN,NaN,133.05625,130.38022999999995,117.7066405500003,127.09046860000001,130.8146874,134.36718749999994,131.18625915483184,133.89945754404457,134.50240384615375,138.70372729396118,130.30108039834633,117.7066405500003,127.09046860000001,130.8146874,134.36718749999994,133.90625,10032301,8145119.9,54.1269330616522,NaN,1.5,2.75,NaN,NaN,2.6452619549411156,1.2316946985642285,NaN,-0.23590504482947217,1.1276289877985732,1.3635340326280454,19.708690391202886,-0.9869176038558641,NaN,NaN,NaN,7743760
925997400,134.4375,135.125,132.375,133.98437,NaN,NaN,133.3125,130.40627199999994,117.7940624000003,127.2614061,130.9893748,134.32421849999997,131.29598899189727,133.90754444461174,134.8473553846153,137.93895991265103,131.75575085657957,117.7940624000003,127.2614061,130.9893748,134.32421849999997,133.82812333333334,13507199,8525024.75,51.82129465303717,NaN,1.5,2.75,NaN,NaN,2.652743243873893,1.5844175701659986,NaN,-0.2881166114042286,1.0033882683727597,1.2915048797769884,18.979803817065626,-1.3460690289921675,NaN,NaN,NaN,-5763439
926083800,134.5,135.125,133.4375,135,NaN,NaN,133.56875,130.43231399999993,117.88656240000029,127.44015610000001,131.2081248,134.33046849999997,131.44124432554835,134.0115878308392,135.1454323076922,137.36948840860535,132.92137620677906,117.88656240000029,127.44015610000001,131.2081248,134.33046849999997,134.52083333333334,8680699,8740769.65,54.38745488672611,NaN,1.5,2.75,NaN,NaN,2.5837972978829007,0.9931275331114577,NaN,-0.2526975305264567,0.9756329666189174,1.2283304971453741,19.668219977845634,-1.1667810569663692,NaN,NaN,NaN,2917260
926343000,134.84375,135.71875,133.53125,134.32812,NaN,NaN,133.825,130.45835599999995,117.98726550000029,127.6459373,131.4234372,134.23124949999996,131.55445513631116,134.04173375171166,135.10336461538452,137.3666326950036,132.84009653576544,117.98726550000029,127.6459373,131.4234372,134.23124949999996,134.52604,5580102,8609114.8,52.399102434626975,NaN,1.5,2.75,NaN,NaN,2.5554903480341222,0.64816210837379,NaN,-0.27132698134145894,0.8891717704685504,1.1604987518100094,19.365417899005937,-2.1288743169398816,NaN,NaN,NaN,-2662842
926429400,135.3125,136.875,134.71875,135.6875,NaN,NaN,134.08125,130.48439799999994,118.09523425000029,127.83593730000001,131.6590622,134.24374949999998,131.71653532704406,134.1984733944058,135.06730692307684,137.27662197682537,132.85799186932832,118.09523425000029,127.83593730000001,131.6590622,134.24374949999998,135.76041666666666,7000602,8455575,55.91112648741983,NaN,1.5,2.75,NaN,NaN,2.5548753231745414,0.8279273733601795,NaN,-0.19260774125144664,0.9197390752457011,1.1123468164971477,20.225379407972163,0.23084025854108955,NaN,NaN,NaN,4337760
926515800,135.75,137.21875,131.5,136.75,NaN,NaN,134.3375,130.51043999999993,118.20445300000029,128.0381248,131.9378122,134.42343699999998,131.91392609853253,134.4414759282719,135.13942230769223,137.4975194785221,132.78132513686236,118.20445300000029,128.0381248,131.9378122,134.42343699999998,135.15625,13865801,8571280.1,58.48909320578145,NaN,1.5,2.75,NaN,NaN,2.780866371519217,1.617704804676725,NaN,-0.07550601633398335,1.0179642960796684,1.0934703124136518,19.059593378975872,1.7911142126075832,NaN,NaN,NaN,18203561
926602200,137.25,138,136.8125,137.34375,NaN,NaN,134.59375,138,118.32632800000029,128.2276561,132.2153122,134.65781199999998,132.1268603691783,134.7178829827222,135.19711461538452,137.72527872128578,132.66895050948327,118.32632800000029,128.2276561,132.2153122,134.65781199999998,137.38541666666666,4485699,8238065.05,59.90016859610609,NaN,1.5,2.75,NaN,NaN,2.6715187735535584,0.544508810354684,NaN,0.029772004129465568,1.1306853175754839,1.1009133134460183,18.294823276252338,3.072232645403377,NaN,NaN,NaN,22689260
926688600,134.5625,135.875,133.5,133.78125,NaN,NaN,134.85,138.13116197183098,118.43257800000029,128.3804686,132.3903122,134.77031199999996,132.1917383939164,134.62867984151055,134.93028769230762,137.25986493972627,132.60071044488896,118.43257800000029,128.3804686,132.3903122,134.77031199999996,134.38541666666666,8370102,8332760.2,49.112736722338475,NaN,1.5,2.75,NaN,NaN,2.75524957544259,1.0044813242075536,NaN,-0.14318971375386447,0.9219261712536877,1.0651158850075522,24.075595216248743,-1.4048825426070934,NaN,NaN,NaN,14319158
926947800,133.625,134.48437,132.375,134.1875,NaN,NaN,135.10625,138.26232394366198,118.53242175000028,128.5207811,132.5231248,135.00468699999996,132.2700035549393,134.58666271374764,134.83894153846146,137.18467507664906,132.49320800027385,118.53242175000028,128.5207811,132.5231248,135.00468699999996,133.68229,6268102,8021805.35,50.21382457293573,NaN,1.5,2.75,NaN,NaN,2.7091153200538343,0.7813829588871787,NaN,-0.22787705857804919,0.7802695617849906,1.0081466203630398,21.427028916552025,0.32710280373831774,NaN,NaN,NaN,20587260
927034200,134.53125,134.98437,132.625,133.9375,NaN,NaN,135.3625,138.39348591549296,118.64320300000028,128.65328110000002,132.63437480000002,135.14531199999996,132.33539557239266,134.52483769339074,134.80769153846146,137.18952669581313,132.42585638110978,118.64320300000028,128.65328110000002,132.63437480000002,135.14531199999996,133.84895666666668,8218602,7980255.35,49.50394608971643,NaN,1.5,2.75,NaN,NaN,2.684133511478561,1.0298670455451029,NaN,-0.29415724994170545,0.640450057935908,0.9346073078776135,19.731388948991476,-0.6490496059341678,NaN,NaN,NaN,12368658
927120600,134.46875,135,133.25,134.90625,NaN,NaN,135.61875,138.52464788732394,118.76117175000029,128.7701561,132.7712498,135.14687449999997,132.43621339308314,134.56116267497256,134.9350953846153,137.14068262898348,132.7295081402471,118.76117175000029,128.7701561,132.7712498,135.14687449999997,134.38541666666666,5052398,7944265.3,52.31701601382921,NaN,1.5,2.75,NaN,NaN,2.6174096892300924,0.6359805229566037,NaN,-0.26697745531574857,0.6008854887329278,0.8678629440486764,19.633826570921823,0.6880504046852535,NaN,NaN,NaN,17421056
927207000,135.125,135.59375,130.0625,134.09375,NaN,NaN,135.875,138.65580985915494,118.89664050000029,128.8842186,132.8693748,135.04374949999996,132.5012148286485,134.51664718211802,134.81249923076913,137.0143418703987,132.61065659113956,118.89664050000029,128.8842186,132.8693748,135.04374949999996,133.25,4675398,7833165.3,49.810665712931154,NaN,1.5,2.75,NaN,NaN,2.825541139999372,0.5968721226909383,NaN,-0.2957102798896316,0.49822509418663685,0.7939353740762685,19.61994294904844,-0.6712962962962963,NaN,NaN,NaN,12745658
927293400,134.125,134.6875,132.59375,133.34375,NaN,NaN,136.13125,138.78697183098592,119.02101550000029,128.9939061,132.9237498,134.92031199999997,132.53425542360347,134.40494268858296,134.78124923076913,137.05294701378799,132.50955144775028,119.02101550000029,128.9939061,132.9237498,134.92031199999997,133.54166666666666,6414602,7924240.3,47.54634211339966,NaN,1.5,2.75,NaN,NaN,2.773270344285131,0.8094911003645359,NaN,-0.3533192412951497,0.3522863224573314,0.7056055637524811,19.237254842358286,-0.7328100772943241,NaN,NaN,NaN,6331056
927552600,133.84375,133.84375,130.39062,131.125,NaN,NaN,136.3875,138.9181338028169,119.13195300000028,129.0620311,132.9587498,134.64687449999997,132.4789905050308,134.0925671944322,134.4975953846153,137.4895432155926,131.505647553638,119.13195300000028,129.0620311,132.9587498,134.64687449999997,131.78645666666668,7952000,8141515.3,41.5314840029255,NaN,1.5,2.75,NaN,NaN,2.821831748264764,0.976722355358099,NaN,-0.5189341566039357,0.0569378679975614,0.5758720246014971,21.16723627263064,-3.3625057577153386,NaN,NaN,NaN,-1620944
927639000,131.375,132.34375,128.4375,129,NaN,NaN,136.64375,139.04929577464787,119.23132800000029,129.1189061,132.91437480000002,134.23437449999997,132.3425595048335,133.60756079496247,134.1141823076922,138.30730031425142,129.921064301133,119.23132800000029,129.1189061,132.91437480000002,134.23437449999997,129.92708333333334,15406398,8654475.25,36.73792432527852,NaN,1.5,2.75,NaN,NaN,2.8992901948172807,1.780165469882186,NaN,-0.7363976419747152,-0.34462502786689697,0.3917726141078183,20.89270088876356,-5.6672760511883,NaN,NaN,NaN,-17027342
927725400,129.3125,131,128.09375,130.4375,NaN,NaN,136.9,139.18045774647888,119.34101550000028,129.1901561,132.9087498,133.98749949999996,132.26785128895767,133.30565024306128,133.76322076923068,138.34661330830323,129.17982823015814,119.34101550000028,129.1901561,132.9087498,133.98749949999996,129.84375,12575898,9006055.1,41.644683259647785,NaN,1.5,2.75,NaN,NaN,2.8997873237589036,1.396382529349615,NaN,-0.7459301848077273,-0.5406401169018409,0.20529006790588644,21.69879708007924,-5.02844141069397,NaN,NaN,NaN,-4451444
927811800,129.84375,130.28125,128,128.5625,NaN,NaN,128,139.31161971830986,119.44945300000029,129.2454686,132.8768748,133.69843699999996,132.12254339527306,132.853921648484,133.31971153846143,138.65307857947306,127.98634449744982,119.44945300000029,129.2454686,132.8768748,133.69843699999996,128.94791666666666,14515398,9240609.95,37.55323773403155,NaN,1.5,2.75,NaN,NaN,2.866766800633268,1.5708268262096705,NaN,-0.8343318151213974,-0.8376247009958604,-0.003292885874462942,21.51023107225681,-3.9009577201588415,NaN,NaN,NaN,-18966842
927898200,129,130.75,128.59375,130.20312,NaN,NaN,128.05277777777778,139.44278169014083,119.55703110000027,129.3031248,132.83593720000002,133.54609299999998,132.04727188957608,132.60146434862838,132.89783615384607,138.2826755180129,127.51299678967925,119.55703110000027,129.3031248,132.83593720000002,133.54609299999998,129.84895666666668,8748000,9128415.05,42.84458210600533,NaN,1.5,2.75,NaN,NaN,2.8182477434451774,0.9583262759289193,NaN,-0.7412726357367054,-0.9298836805453448,-0.1886110448086393,20.044789448808775,-2.9692631578947273,NaN,NaN,NaN,-10218842
928243800,130.125,130.15625,128.375,129.75,NaN,NaN,128.10555555555555,139.57394366197184,119.66890610000027,129.3262498,132.83718720000002,133.24921799999998,131.95718279586723,132.32989631542569,132.35937461538452,137.48964928377725,127.2290999469918,119.66890610000027,129.3262498,132.83718720000002,133.24921799999998,129.42708333333334,6705301,8928195.15,41.791330304538555,NaN,1.5,2.75,NaN,NaN,2.7475243331990944,0.7510253626120617,NaN,-0.6712837374302232,-1.0277157165964184,-0.3564319791661951,19.708455456324074,-3.126458236117592,NaN,NaN,NaN,-16924143
928330200,129.75,130.1875,128.01562,129.875,NaN,NaN,128.15833333333333,139.70510563380282,119.78765610000028,129.3568748,132.83593720000002,133.05546799999996,131.87552856857832,132.09609666633753,131.7848553846153,136.17282014194825,127.39689062728236,119.78765610000028,129.3568748,132.83593720000002,133.05546799999996,129.35937333333334,6981898,8751825,42.213362119291794,NaN,1.5,2.75,NaN,NaN,2.7064068808277293,0.7977648090541116,NaN,-0.5809995188277247,-1.082681377700851,-0.5016818588731263,19.853016539151113,-3.7294417419504287,NaN,NaN,NaN,-9942245
928416600,130.6875,130.875,129.78125,130.59375,NaN,NaN,128.2111111111111,139.8362676056338,119.89874985000027,129.3853123,132.9240622,132.84453049999996,131.82526274235957,131.95301603144824,131.53966307692298,135.80861549422494,127.27071065962102,119.89874985000027,129.3853123,132.9240622,132.84453049999996,130.41666666666666,6076602,8554040.05,44.69629113134956,NaN,1.5,2.75,NaN,NaN,2.5912171036257488,0.710378016058038,NaN,-0.44351148125686035,-1.0560712104442018,-0.6125597291873415,19.555125255829328,-2.6101141924959217,NaN,NaN,NaN,-3865643
928503000,131.46875,133.35937,130.9375,133.21875,NaN,NaN,128.26388888888889,139.9674295774648,120.01296860000028,129.4521873,133.0503122,132.80624949999998,131.8799093014827,132.07356212369126,131.46514384615375,135.57756237200084,127.35272532030666,120.01296860000028,129.4521873,133.0503122,132.80624949999998,132.50520666666668,9787199,8368040.05,52.691222420133954,NaN,1.5,2.75,NaN,NaN,2.6036744533667675,1.1695927530843977,NaN,-0.16098108053289284,-0.8137860798534575,-0.6528049993205647,23.464986559279517,-0.0937426763534099,NaN,NaN,NaN,5921556
928762200,133.4375,134.1875,132.90625,133.5625,NaN,NaN,128.31666666666666,140.09859154929578,120.13031235000028,129.5453123,133.13156220000002,132.73437449999997,131.9458932504442,132.21536573095875,131.4362976923076,135.48368984433847,127.3889055402767,120.13031235000028,129.5453123,133.13156220000002,132.73437449999997,133.55208333333334,5299102,8198960.2,53.63644756284935,NaN,1.5,2.75,NaN,NaN,2.50921556384057,0.6463139069756675,NaN,0.052431215874241155,-0.5872659794777633,-0.6396971953520044,23.30264875074803,1.8589132507149666,NaN,NaN,NaN,11220658
928848600,133.375,133.79687,131.59375,132.25,NaN,NaN,128.36944444444444,140.22975352112675,120.24437485000027,129.6340623,133.2053122,132.63046849999995,131.95781900532873,132.2186642327722,131.23197076923068,134.79754525281643,127.66639628564494,120.24437485000027,129.6340623,133.2053122,132.63046849999995,132.54687333333334,4895699,8164740.05,49.564470713018956,NaN,1.5,2.75,NaN,NaN,2.487351594994816,0.5996148034131228,NaN,0.10551669126630658,-0.5078013312691212,-0.6133180225354278,21.75500191519987,2.5193798449612403,NaN,NaN,NaN,6324959
928935000,132.40625,133.09375,131.8125,132.125,NaN,NaN,128.42222222222222,140.36091549295776,120.36218735000028,129.7431248,133.2246872,132.45234349999996,131.96437512276682,132.20974382965105,131.08052846153836,134.29720918463525,127.86384773844148,120.36218735000028,129.7431248,133.2246872,132.45234349999996,132.34375,7409699,8185194.9,49.18152022492381,NaN,1.5,2.75,NaN,NaN,2.401201481066615,0.9052562694628078,NaN,0.1308725748533821,-0.4497273039687002,-0.5805998788220823,18.91879597828894,1.2937230474365118,NaN,NaN,NaN,-1084740
929021400,131.4375,131.46875,129.59375,130.90625,NaN,NaN,128.475,140.49207746478874,120.47046860000027,129.8084373,133.2334372,132.16015599999997,131.92288001991324,132.08560156016048,130.89302846153836,133.83236555800033,127.95369136507641,120.47046860000027,129.8084373,133.2334372,132.16015599999997,130.65625,7040699,7843939.8,45.49100512709528,NaN,1.5,2.75,NaN,NaN,2.4104906609904284,0.8975972763075005,NaN,0.06742003532085428,-0.4963248346710145,-0.5637448699918688,19.101949895506234,1.8230432668935344,NaN,NaN,NaN,-8125439
929107800,131.21875,131.73437,129.09375,129.8125,NaN,NaN,128.52777777777777,140.6232394366197,120.57203110000027,129.8546873,133.2621872,131.78359349999997,131.8401200191323,131.86911569728807,130.79206692307682,133.78232043864227,127.80181340751136,120.57203110000027,129.8546873,133.2621872,131.78359349999997,130.21354,12824301,8260869.9,42.41496318660378,NaN,1.5,2.75,NaN,NaN,2.4269284709196843,1.5524153212968528,NaN,-0.04054607226628071,-0.6144274603247197,-0.573881388058439,17.638385993289262,-0.30000817184719736,NaN,NaN,NaN,-20949740
929367000,130.6875,130.75,129.54687,129.9375,NaN,NaN,128.58055555555555,140.7544014084507,120.67734360000027,129.89218730000002,133.2740622,131.59140599999995,131.76550746936243,131.68515229754635,130.8641823076922,133.720291812167,128.0080728032174,120.67734360000027,129.89218730000002,133.2740622,131.59140599999995,130.07812333333334,6823500,8183539.8,42.8902476600755,NaN,1.5,2.75,NaN,NaN,2.3395142944254204,0.8338078834784918,NaN,-0.09288246969557556,-0.6899844751779085,-0.5971020054823329,16.0007932813605,0.14450867052023122,NaN,NaN,NaN,-14126240
929453400,130.46875,131.65625,130.07812,130.8125,NaN,NaN,128.63333333333333,140.8855633802817,120.81265610000028,129.9718748,133.24218720000002,131.42265599999996,131.72813462742664,131.6020425549229,130.89302846153836,133.7388740620634,128.04718286101334,120.81265610000028,129.9718748,133.24218720000002,131.42265599999996,130.84895666666668,5700898,8155179.6,46.23545235610628,NaN,1.5,2.75,NaN,NaN,2.2951739876807475,0.699052415718717,NaN,-0.05953273628960676,-0.6715179258443413,-0.6119851895547346,16.30198632196304,0.7218479307025987,NaN,NaN,NaN,-8425342
929539800,132.375,133.875,132.375,133.3125,NaN,NaN,128.6861111111111,141.01672535211267,120.96234360000028,130.0793748,133.2665622,131.39140599999996,131.79026660282167,131.76494326397784,131.25841307692298,134.03236463403255,128.4844615198134,120.96234360000028,130.0793748,133.2665622,131.39140599999996,133.1875,7865801,8137539.55,54.44573492975977,NaN,1.5,2.75,NaN,NaN,2.349982988560694,0.966606792098479,NaN,0.12961454662668448,-0.449967006271379,-0.5795815528980635,19.33247539362695,2.0818377602297202,NaN,NaN,NaN,-559541
929626200,132.875,135.5625,132.625,134.5625,NaN,NaN,128.73888888888888,141.14788732394365,121.15515610000028,130.1868748,133.2946872,131.37421849999996,131.89898163800513,132.03137723883708,131.5937499999999,134.79709485644398,128.3904051435558,121.15515610000028,130.1868748,133.2946872,131.37421849999996,134.25,8162801,8293059.7,57.90693972921263,NaN,1.5,2.75,NaN,NaN,2.391948489377787,0.9842930468714701,NaN,0.32642980461224697,-0.17154429713275476,-0.49797410174500173,19.66252893084259,1.0086793338024864,NaN,NaN,NaN,7603260
929712600,134.0625,134.6875,133.375,134.3125,NaN,NaN,128.79166666666666,141.27904929577466,121.32640610000027,130.2693748,133.2840622,131.38515599999997,131.99362941690688,132.2486270256145,131.94471153846143,135.26089724616952,128.62852583075335,121.32640610000027,130.2693748,133.2840622,131.38515599999997,134.125,2875100,8203044.8,56.97455770034725,NaN,1.5,2.75,NaN,NaN,2.314845025850802,0.35049180762733373,NaN,0.4212633244912701,0.02860505386908585,-0.3926582706221842,16.540544448645264,0.5615348619560131,NaN,NaN,NaN,4728160
929971800,134.46875,135.25,133.65625,134.625,NaN,NaN,128.84444444444443,141.41021126760563,121.50281235000028,130.3696873,133.2790622,131.44921849999997,132.09682042016544,132.47494826127027,132.31009615384605,135.67988036595435,128.94031194173775,121.50281235000028,130.3696873,133.2790622,131.44921849999997,134.51041666666666,4646398,8114634.6,57.88734707840556,NaN,1.5,2.75,NaN,NaN,2.2633382382900304,0.5725948522685175,NaN,0.4821426283908118,0.21002001486633048,-0.2721226135244813,16.531353175154997,1.7958412098298677,NaN,NaN,NaN,9374558
930058200,134,135.1875,133.5,133.6875,NaN,NaN,128.8972222222222,141.5413732394366,121.67843735000028,130.4396873,133.22656220000002,131.57734349999996,132.1592000115315,132.59042937924454,132.54807692307682,135.83536444406442,129.26078940208922,121.67843735000028,130.4396873,133.22656220000002,131.57734349999996,134.125,5862398,8010154.5,54.17418778283888,NaN,1.5,2.75,NaN,NaN,2.2222069355550285,0.7318707772740214,NaN,0.4376777134585786,0.2749745282987419,-0.16270318515983667,15.922914893743092,1.1825922421948911,NaN,NaN,NaN,3512160
930144600,133,133.625,132.125,133.03125,NaN,NaN,128.95,141.67253521126761,121.85484360000028,130.4934373,133.17843720000002,131.77890599999995,132.19339805029497,132.63241229550695,132.53365384615375,135.81067369621442,129.2566339960931,121.85484360000028,130.4934373,133.17843720000002,131.77890599999995,132.92708333333334,9629199,7721294.55,51.67541574718207,NaN,1.5,2.75,NaN,NaN,2.175085011586812,1.247096447058868,NaN,0.3464671692414373,0.2703807763919599,-0.07608639284947735,16.266897971361466,1.623299116734304,NaN,NaN,NaN,-6117039
930231000,132.875,132.9375,130.65625,132.03125,NaN,NaN,129.00277777777777,141.8036971830986,121.99999985000028,130.5446873,133.1559372,131.85859349999996,132.1870393032246,132.5751587435539,132.41586538461527,135.6462411047093,129.18548966452124,121.99999985000028,130.5446873,133.1559372,131.85859349999996,131.875,9176898,7551344.55,48.03923332611068,NaN,1.5,2.75,NaN,NaN,2.1893646536163254,1.2152667566996398,NaN,0.2080117869488517,0.18392834083658727,-0.02408344611226442,15.908489318279658,1.7091959557053442,NaN,NaN,NaN,-15293937
930317400,132.59375,133.01562,131.25,131.70312,NaN,NaN,129.05555555555554,141.93485915492957,122.15601545000027,130.6004685,133.1368746,132.01562449999997,132.16806207564716,132.49210743464403,132.3737976923076,135.62588825685654,129.12170712775864,122.15601545000027,130.6004685,133.1368746,132.01562449999997,131.98958000000002,4087000,7029924.65,46.87370825978219,NaN,1.5,2.75,NaN,NaN,2.1590971783580173,0.5813718074488892,NaN,0.08960538821191324,0.08792328915262715,-0.0016820990592861032,14.989554608069664,1.3588225108225205,NaN,NaN,NaN,-19380937
930576600,132.6875,133.625,132.5,133.3125,NaN,NaN,129.10833333333332,142.06602112676057,122.33007795000027,130.65953100000002,133.1724996,132.17109349999996,132.21294199424923,132.57024005991602,132.46514384615375,135.75068749877173,129.17960019353578,122.33007795000027,130.65953100000002,133.1724996,132.17109349999996,133.14583333333334,5028898,6843969.55,52.90853857916073,NaN,1.5,2.75,NaN,NaN,2.1421530941895868,0.7347925737045397,NaN,0.1134154960517025,0.14008727100534202,0.02667177495363952,16.18096687189376,1.9111323459149545,NaN,NaN,NaN,-14352039
930663000,133,135.1875,132.78125,134.5625,NaN,NaN,129.1611111111111,142.19718309859155,122.49445295000027,130.750156,133.2737496,132.41171849999995,132.3050815238865,132.75997910182878,132.74639384615375,136.0756821994527,129.4171054928548,122.49445295000027,130.750156,133.2737496,132.41171849999995,134.17708333333334,6956199,6856514.45,56.994683843205166,NaN,1.5,2.75,NaN,NaN,2.1610171588903304,1.0145386625707469,NaN,0.20192270094500048,0.2790751511348901,0.07715245018988964,16.49293628311417,0.9376465072667605,NaN,NaN,NaN,-7395840
930749400,134.625,137.5,133.84375,137,NaN,NaN,129.2138888888889,142.32834507042253,122.66226545000026,130.87953100000001,133.3912496,132.76796849999997,132.48919597393018,133.16379061594031,133.29927846153836,136.87419522621116,129.72436169686557,122.66226545000026,130.87953100000001,133.3912496,132.76796849999997,136.11458333333334,16856096,7350224.35,63.62318839839471,NaN,1.5,2.75,NaN,NaN,2.2678195046838785,2.293276395025956,NaN,0.40166435205191753,0.5792328902547865,0.177568538202869,16.15004725543225,1.8114259173246632,NaN,NaN,NaN,9460256
930835800,137,138.5,136.0625,138.03125,NaN,NaN,129.26666666666668,142.45950704225353,122.83210920000027,131.0167185,133.45437460000002,133.13984349999996,132.70653142593292,133.62735817632696,133.92187461538452,137.74833953095344,130.0954096998156,122.83210920000027,131.0167185,133.45437460000002,133.13984349999996,137.53125,9939500,7543369.25,66.01015642040386,NaN,1.5,2.75,NaN,NaN,2.2799395400636016,1.3176472834072122,NaN,0.5699957476175149,0.8900632227247627,0.32006747510724776,15.908754372159388,2.768729641693811,NaN,NaN,NaN,19399756
930922200,138.125,139.5,137.90625,139.40625,NaN,NaN,129.31944444444446,142.5906690140845,123.00414045000026,131.1954685,133.51937460000002,133.44921849999997,132.96926548766103,134.1777288262006,134.5829323076922,138.9617329163969,130.2041316989875,123.00414045000026,131.1954685,133.51937460000002,133.44921849999997,138.9375,3772800,7242649.3,68.93693393798193,NaN,1.5,2.75,NaN,NaN,2.23092600148763,0.5209143565739128,NaN,0.7304537799477798,1.2331347000419726,0.5026809200941927,16.14802927900447,3.551532033426184,NaN,NaN,NaN,23172556
931267800,139.25,140.75,138.59375,139.375,NaN,NaN,129.37222222222223,142.7218309859155,123.19101545000026,131.3660935,133.5906246,133.73984349999995,133.2204707626547,134.6727070332291,135.04927846153836,140.03658076813744,130.0619761549393,123.19101545000026,131.3660935,133.5906246,133.73984349999995,139.57291666666666,11221102,7538749.3,68.79195323810686,NaN,1.5,2.75,NaN,NaN,2.225592001381371,1.4884567125743258,NaN,0.786157023871749,1.485377199933879,0.6992201760621299,16.293955155358063,4.254324450677887,NaN,NaN,NaN,11951454
931354200,139.0625,139.71875,138.51562,139.5625,NaN,NaN,129.425,142.85299295774647,123.37835920000026,131.5104685,133.6499996,134.10546849999997,133.46917779157022,135.138401601493,135.43389384615375,140.95440071887094,129.91338697343656,123.37835920000026,131.5104685,133.6499996,134.10546849999997,139.26562333333334,3230700,7455499.35,69.21036007459912,NaN,1.5,2.75,NaN,NaN,2.1525590012827007,0.4333311356267505,NaN,0.7854502428479326,1.6810329796220458,0.8955827367741132,14.990063214041307,4.909560723514212,NaN,NaN,NaN,15182154
931440600,139.0625,140.625,138.75,139.67187,NaN,NaN,129.4777777777778,142.98415492957747,123.56656230000026,131.6709372,133.698437,134.48281199999997,133.71242062327335,135.5701604965889,135.846153076923,141.75678119392475,129.93552495992125,123.56656230000026,131.6709372,133.698437,134.48281199999997,139.68229,7101500,7440089.4,69.46750391014359,NaN,1.5,2.75,NaN,NaN,2.1327333583339363,0.9544912188823967,NaN,0.7426475276019828,1.8238921462765916,1.0812446186746087,14.035340365590896,5.786978461538471,NaN,NaN,NaN,22283654
931527000,140,140.59375,139.5625,140.5,NaN,NaN,129.53055555555557,143.11531690140845,123.75468730000026,131.8471872,133.800937,134.96249949999998,133.9786002066744,136.0396690207233,136.29807615384607,142.6481817536005,129.94797055409163,123.75468730000026,131.8471872,133.800937,134.96249949999998,140.21875,2934700,7234789.45,71.41423647269225,NaN,1.5,2.75,NaN,NaN,2.054055975595798,0.4056372366164713,NaN,0.7198806254887653,1.9810954005355654,1.2612147750468001,11.597551418744906,6.679325440429951,NaN,NaN,NaN,25218354
931786200,140.9375,140.9375,139.5,139.875,NaN,NaN,129.58333333333334,143.24647887323943,123.91906230000026,132.0184372,133.911562,135.46562449999996,134.20983157111854,136.40493863779727,136.77403769230762,143.19723478728613,130.3508405973291,123.91906230000026,132.0184372,133.911562,135.46562449999996,140.10416666666666,4436301,6815389.45,67.89577410500564,NaN,1.5,2.75,NaN,NaN,2.0100162630532408,0.6509240642147016,NaN,0.6164891461325133,2.0318262077124416,1.4153370615799283,12.177722805882087,4.922644163150492,NaN,NaN,NaN,20782053
931872600,139.375,139.92187,138.65625,139.375,NaN,NaN,129.63611111111112,143.37764084507043,124.09406230000026,132.1749997,134.034062,135.93749949999997,134.41238719578055,136.6878016246737,137.2620184615384,143.43261038438783,131.09142653868895,124.09406230000026,132.1749997,134.034062,135.93749949999997,139.31770666666668,6477602,6798094.55,65.13117784899475,NaN,1.5,2.75,NaN,NaN,1.9568451014065817,0.9528555321431945,NaN,0.47455580042234646,2.0085318121078615,1.533976011685515,12.618135885304678,3.5764050162563863,NaN,NaN,NaN,14304451
931959000,140,140.21875,138.75,140.15625,NaN,NaN,129.6888888888889,143.5088028169014,124.27359355000026,132.3340622,134.12343700000002,136.40468699999997,134.63763671751465,137.01813004137145,137.8870184615384,143.42528194124344,132.34875498183334,124.27359355000026,132.3340622,134.12343700000002,136.40468699999997,139.70833333333334,4382500,6732174.65,67.36706469357429,NaN,1.5,2.75,NaN,NaN,1.9219811655918257,0.6509783580852287,NaN,0.3965903131818853,2.0297139031628717,1.6331235899809864,12.266634932903292,2.303832116788321,NaN,NaN,NaN,18686951
932045400,140.78125,141.375,140.3125,141.04687,NaN,NaN,129.74166666666667,143.63996478873239,124.45289040000026,132.4689059,134.2693744,136.79140549999997,134.88897919918074,137.40181956124084,138.6057684615384,143.0680348382573,134.1435020848195,124.45289040000026,132.4689059,134.2693744,136.79140549999997,140.91145666666668,3348600,6506314.6,69.74853947457335,NaN,1.5,2.75,NaN,NaN,1.8717503680495524,0.5146692414781173,NaN,0.3688815483859087,2.094225525463372,1.7253439770774635,8.78062379241421,2.1847371519130725,NaN,NaN,NaN,22035551
932131800,141.25,142.15625,140.75,141.8125,NaN,NaN,129.79444444444445,143.7711267605634,124.63726540000025,132.6120309,134.40937440000002,137.15390549999998,135.1604898188207,137.8218843649322,139.25961461538452,142.8295817688936,135.68964746187544,124.63726540000025,132.6120309,134.40937440000002,137.15390549999998,141.57291666666666,2281500,6212249.55,71.6630350291004,NaN,1.5,2.75,NaN,NaN,1.8385003417602985,0.3672582663714789,NaN,0.36530793735437994,2.1819788987704385,1.8166709614160585,8.458300937396466,1.7260703878054249,NaN,NaN,NaN,24317051
932391000,142.1875,142.25,140.5625,140.875,NaN,NaN,129.84722222222223,142.25,124.83289040000025,132.7682809,134.547187,137.48203049999998,135.38458825729833,138.1126572825577,139.74519153846146,142.15680081313897,137.33358226378394,124.83289040000025,132.7682809,134.547187,137.48203049999998,141.22916666666666,4287000,6282844.55,66.14315147177332,NaN,1.5,2.75,NaN,NaN,1.8277146030631344,0.6823342461974489,NaN,0.2675267192609734,2.1510793604922753,1.883552641231302,8.624869539083608,1.0762331838565022,NaN,NaN,NaN,20030051
932477400,140.125,140.40625,137.53125,137.98437,NaN,NaN,129.9,142.34444444444443,125.02874975000024,132.90749960000002,134.6068744,137.64999899999998,135.4865404825023,138.10043944612363,139.82091230769223,141.9252244634206,137.71660015196386,125.02874975000024,132.90749960000002,134.6068744,137.64999899999998,138.64062333333334,7060102,6403529.75,52.671611658578264,NaN,1.5,2.75,NaN,NaN,1.936002845701482,1.1025328647844574,NaN,-0.009430090046417039,1.8717650286732805,1.8811951187196976,15.218417438772178,-1.130769368562463,NaN,NaN,NaN,12969949
932563800,138.09375,138.90625,137.3125,137.82812,NaN,NaN,129.95277777777778,142.4388888888889,125.21429660000024,133.0501558,134.6768744,137.85702999999998,135.5783671302473,138.07450426077853,139.80528692307686,141.96481517498364,137.64575867117009,125.21429660000024,133.0501558,134.6768744,137.85702999999998,138.01562333333334,4793699,6350094.8,52.05444510731663,NaN,1.5,2.75,NaN,NaN,1.9115562138656619,0.7549019583140711,NaN,-0.20964891845290667,1.6191339706535643,1.828782889106471,15.14501759934319,-1.3200582193107315,NaN,NaN,NaN,8176250
932650200,137.4375,138,135.46875,136.01562,NaN,NaN,130.00555555555556,142.53333333333333,125.40093720000023,133.17124950000002,134.6834368,138.0062485,135.59551430161017,137.8784200454663,139.54446923076918,142.5044373184237,136.58450114311466,125.40093720000023,133.17124950000002,134.6834368,138.0062485,136.49479,7804102,6258839.95,45.40784784457582,NaN,1.5,2.75,NaN,NaN,1.9558200557324004,1.246892724905036,NaN,-0.4564942386666704,1.258165090773133,1.7146593294398034,16.526758277183202,-3.191729537366539,NaN,NaN,NaN,372148
932736600,136.65625,137,135.125,135.75,NaN,NaN,130.05833333333334,142.62777777777777,125.58671845000022,133.30062450000003,134.66343680000003,138.192186,135.60157256429213,137.6757133744695,139.26562307692302,142.85333911170196,135.67790704214408,125.58671845000022,133.30062450000003,134.66343680000003,138.192186,135.95833333333334,4603000,6030145.05,44.51088346235513,NaN,1.5,2.75,NaN,NaN,1.9500471946086575,0.7633315553495683,NaN,-0.6198653905463565,0.9398275912568579,1.5596929818032144,15.629511938728314,-2.9490616621983916,NaN,NaN,NaN,-4230852
932995800,134.875,136.125,134.625,134.75,NaN,NaN,130.11111111111111,142.72222222222223,125.77484345000022,133.41343700000002,134.6115618,138.34453,135.56817756177088,137.3970740054724,138.8954307692307,143.20478413888503,134.58607739957637,125.77484345000022,133.41343700000002,134.6115618,138.34453,135.16666666666666,4333398,6042464.95,41.210417876532006,NaN,1.5,2.75,NaN,NaN,1.9179009664223248,0.7171573250085629,NaN,-0.7678059824815402,0.599935503701289,1.3677414861828292,15.789109022911179,-3.318385650224215,NaN,NaN,NaN,-8564250
933082200,136,137.20312,135.375,135.875,NaN,NaN,130.1638888888889,142.81666666666666,125.97124970000023,133.52187450000002,134.6534368,138.47265499999997,135.58020981425045,137.2521145763798,138.60336384615377,143.16964208236982,134.03708560993772,125.97124970000023,133.52187450000002,134.6534368,138.47265499999997,136.15104,5908500,6086445.05,46.056444217968725,NaN,1.5,2.75,NaN,NaN,1.9561308973921594,0.9707637137050963,NaN,-0.7609571873358558,0.4165450020130095,1.1775021893488653,17.236441546036467,-3.0546265328874025,NaN,NaN,NaN,-2655750
933168600,136.25,137.3125,135.59375,136.3125,NaN,NaN,130.21666666666667,142.9111111111111,126.16015595000023,133.60953080000002,134.69593680000003,138.56015499999998,135.60892707643671,137.16262747386745,138.28124846153838,142.85768931283948,133.70480761023728,126.16015595000023,133.60953080000002,134.69593680000003,138.56015499999998,136.40625,3955500,5936410.1,47.85653938636477,NaN,1.5,2.75,NaN,NaN,1.9391751190070052,0.6663117832779107,NaN,-0.6995886968141756,0.30301631833114584,1.0026050151453214,16.87741456392129,-3.3565934501063457,NaN,NaN,NaN,1299750
933255000,134.9375,135.25,133.3125,134.40625,NaN,NaN,130.26944444444445,143.00555555555556,126.33234345000022,133.66984330000003,134.7053118,138.4304675,135.56176326951763,136.90011533349912,137.86057538461532,142.76716117967467,132.95398958955596,126.33234345000022,133.66984330000003,134.7053118,138.4304675,134.32291666666666,7760602,5481635.4,41.377551518891245,NaN,1.5,2.75,NaN,NaN,2.0149483247922193,1.4157457462420795,NaN,-0.7552435005529567,0.05855063945412553,0.8137941400070823,16.90949092716423,-5.222565006610842,NaN,NaN,NaN,-6460852
933341400,134.8125,135.34375,132.5625,132.75,NaN,NaN,130.32222222222222,143.1,126.49796845000023,133.71671830000003,134.66218680000003,138.166405,135.45149804326203,136.50486625411824,137.35095999999993,142.8615287395134,131.84039126048646,126.49796845000023,133.71671830000003,134.66218680000003,138.166405,133.55208333333334,5994301,5284375.45,36.725311791364454,NaN,1.5,2.75,NaN,NaN,2.0696841587356323,1.1343442676844622,NaN,-0.8636529525768362,-0.2657720507139629,0.5978809018628732,16.03308014880218,-5.767524401064774,NaN,NaN,NaN,-12455153
933600600,132.75,134.75,132.5,133.0625,NaN,NaN,130.375,143.19444444444446,126.66046845000022,133.75546830000002,134.6415618,137.84921749999998,135.35781184548705,136.17702184896413,136.80528692307686,142.4984964884614,131.11207735769233,126.66046845000022,133.75546830000002,134.6415618,137.84921749999998,133.4375,6065500,5399010.45,38.13858447461571,NaN,1.5,2.75,NaN,NaN,2.082563861683087,1.1234466123324507,NaN,-0.871835528086212,-0.4919135082448918,0.37992201984132024,16.83401327933072,-3.5669764626240004,NaN,NaN,NaN,-6389653
933687000,133.71875,133.84375,131.375,132.4375,NaN,NaN,130.42777777777778,143.2888888888889,126.79281220000023,133.77359330000002,134.6234368,137.5023425,135.2432898123307,135.82087691096754,136.1430276923076,141.7101278933762,130.575927491239,126.79281220000023,133.77359330000002,134.6234368,137.5023425,132.55208333333334,5445398,5110225.25,36.38805482786412,NaN,1.5,2.75,NaN,NaN,2.110148585848581,1.0655886450406467,NaN,-0.8746108652907111,-0.7133415617720686,0.16126930351864244,13.85466986213356,-3.9111177022511896,NaN,NaN,NaN,-11835051
933773400,132.71875,133.875,130.4375,130.625,NaN,NaN,130.48055555555555,143.38333333333333,126.91593720000023,133.7860933,134.61343680000002,137.0554675,135.06218040792555,135.3260314908754,135.2824507692307,140.52734496474298,130.03755657371843,126.91593720000023,133.7860933,134.61343680000002,137.0554675,131.64583333333334,6497898,5273585.15,31.82591602912754,NaN,1.5,2.75,NaN,NaN,2.204959401145111,1.2321594921056693,NaN,-0.9476416232248925,-1.0232827255124732,-0.07564110228758072,14.733503438989189,-3.9632359871608953,NaN,NaN,NaN,-18332949
933859800,130.875,131.9375,128.84375,131.8125,NaN,NaN,130.53333333333333,143.4777777777778,127.04312470000022,133.79203080000002,134.66968680000002,136.66249899999997,134.93474196055593,134.99140944412537,134.58533538461532,139.017744606769,130.15292616246163,127.04312470000022,133.79203080000002,134.66968680000002,136.66249899999997,130.86458333333334,10322000,5434610.15,37.36651265764999,NaN,1.5,2.75,NaN,NaN,2.2684444439204605,1.8993082696097345,NaN,-0.867265866389729,-1.159723435274742,-0.292457568885013,15.881091454808365,-2.9005524861878453,NaN,NaN,NaN,-8010949
933946200,131.21875,132,129.5,130.375,NaN,NaN,130.5861111111111,143.57222222222222,127.15999970000023,133.7885933,134.66843680000002,136.15624899999997,134.75592855033804,134.55175140182772,133.99999923076913,138.49169295898943,129.50830550254884,127.15999970000023,133.7885933,134.66843680000002,136.15624899999997,130.625,7537699,5664760.1,33.78683700895206,NaN,1.5,2.75,NaN,NaN,2.2849841264975703,1.3306298708042377,NaN,-0.8604960012451894,-1.3680775704414998,-0.5075815691963104,16.464874514238772,-3.2467532467532467,NaN,NaN,NaN,-15548648
934205400,130.59375,131.79687,129.75,130.09375,NaN,NaN,130.63888888888889,143.66666666666666,127.27734345000023,133.78796830000002,134.6990618,135.66718649999999,134.57309801895224,134.1271798397489,133.4050476923076,137.75767607171883,129.05241931289635,127.27734345000023,133.78796830000002,134.6990618,135.66718649999999,130.54687333333334,5565898,5721239.95,33.118340660019086,NaN,1.5,2.75,NaN,NaN,2.2679759746048878,0.9728482022502831,NaN,-0.8244653523103305,-1.5381632595842234,-0.7136979072738929,16.348620570190068,-4.254829806807727,NaN,NaN,NaN,-21114546
934291800,129.875,130.15625,127,128.65625,NaN,NaN,127,143.76111111111112,127.37953095000023,133.7520308,134.6681244,135.13124899999997,134.34106476330706,133.60613890262994,132.8389423076922,137.58291914135285,128.09496547403157,127.37953095000023,133.7520308,134.6681244,135.13124899999997,128.60416666666666,9793301,5887024.9,29.865780234346616,NaN,1.5,2.75,NaN,NaN,2.3314241192759675,1.6635399316894344,NaN,-0.8438934476053108,-1.7685647167805314,-0.9246712691752206,14.948892811083784,-5.6166895919303075,NaN,NaN,NaN,-30907847
934378200,129.6875,130.53125,128.625,130.21875,NaN,NaN,126.98039215686275,143.85555555555555,127.49640595000022,133.7573433,134.67749940000002,134.63437399999998,134.17940536082443,133.2835304357128,132.41346153846143,137.0271531350024,127.79976994192045,127.49640595000022,133.7573433,134.67749940000002,134.63437399999998,129.79166666666666,8003398,6068069.8,37.097200989721735,NaN,1.5,2.75,NaN,NaN,2.301054539327684,1.3189363774292775,NaN,-0.7036871611882249,-1.8042802206605018,-1.1005930594722768,17.473394628036065,-3.1155545222041385,NaN,NaN,NaN,-22904449
934464600,130.6875,131.8125,129.90625,130.14062,NaN,NaN,126.96078431372548,143.95,127.60898405000022,133.7593745,134.68281180000002,134.08906149999999,134.02102162118425,132.98420563231159,132.05889384615375,136.6078429193137,127.50994477299379,127.60898405000022,133.7593745,134.68281180000002,134.08906149999999,130.61979,7036801,6252479.85,36.892362009656814,NaN,1.5,2.75,NaN,NaN,2.272854215089992,1.125441611779045,NaN,-0.573872310567308,-1.817933447681412,-1.244061137114104,16.47537388621923,-1.9656346516007437,NaN,NaN,NaN,-29941250
934551000,131.625,133.25,131.125,133.15625,NaN,NaN,126.94117647058823,144.04444444444445,127.73976530000022,133.82906200000002,134.7340618,133.65624899999997,133.9871090085888,133.00059081018668,131.84975923076914,135.90039971359158,127.7991187479467,127.73976530000022,133.82906200000002,134.7340618,133.65624899999997,132.51041666666666,5857699,6431289.8,48.672855409938606,NaN,1.5,2.75,NaN,NaN,2.3326060568692775,0.9108124780817684,NaN,-0.25863121287554636,-1.5673501532085368,-1.3087189403329904,21.08281635321658,0.07045561296383279,NaN,NaN,NaN,-24083551
934810200,133.125,133.96875,132.25,133.75,NaN,NaN,126.92156862745098,144.13888888888889,127.87445280000021,133.8974995,134.7446868,133.29999899999999,133.9778106160951,133.07196311397843,131.65264384615375,135.0045543772758,128.3007333150317,127.87445280000021,133.8974995,134.7446868,133.29999899999999,133.32291666666666,3927000,6413289.8,50.6271065976581,NaN,1.5,2.75,NaN,NaN,2.2887591956643294,0.6123222437258332,NaN,0.0023367541277561354,-1.3057979976732952,-1.3081347518010513,21.191124466994932,0.9910335063709297,NaN,NaN,NaN,-20156551
934896600,134.4375,134.84375,133.125,134.625,NaN,NaN,126.90196078431373,144.23333333333332,128.00054655000022,133.94874950000002,134.76593680000002,133.13203049999998,134.0031905919345,133.21987138883762,131.66947076923068,135.07822023735758,128.26072130110379,128.00054655000022,133.94874950000002,134.76593680000002,133.13203049999998,134.19791666666666,4808000,6300684.7,53.440501447992425,NaN,1.5,2.75,NaN,NaN,2.2480442531168774,0.7630916684340672,NaN,0.23355039421476453,-1.0161967590325958,-1.2497471532473603,21.158129374469336,3.062200956937799,NaN,NaN,NaN,-15348551
934983000,134.20312,134.375,133.25,133.65625,NaN,NaN,126.88235294117646,144.32777777777778,128.11882780000022,133.99968700000002,134.7940618,132.92343699999998,133.9895850785253,133.26143125656736,131.7391823076922,135.26840903733518,128.20995557804923,128.11882780000022,133.99968700000002,134.7940618,132.92343699999998,133.76041666666666,4355500,6278774.75,50.04069797083863,NaN,1.5,2.75,NaN,NaN,2.1856839493228146,0.6936862960404815,NaN,0.3157978712973244,-0.8549998141257049,-1.1707976854230293,19.697184058412603,1.3987671882408725,NaN,NaN,NaN,-19704051
935069400,132.375,133.23437,131.6875,132.5625,NaN,NaN,126.86274509803921,144.42222222222222,128.22226530000023,134.01374950000002,134.80281180000003,132.75078099999996,133.9336209577988,133.19486637498952,131.70072076923068,135.18199532775785,128.21944621070352,128.22226530000023,134.01374950000002,134.80281180000003,132.75078099999996,132.49479,6448102,6210974.75,46.44784156631181,NaN,1.5,2.75,NaN,NaN,2.1701886672283277,1.0381787496399015,NaN,0.2916677195014503,-0.8062130360462163,-1.0978807555476666,20.01908863624259,1.6778523489932886,NaN,NaN,NaN,-26152153
935155800,133.0625,134.125,132.6875,133.90625,NaN,NaN,126.84313725490196,144.51666666666668,128.33648405000022,134.0481245,134.86281180000003,132.65859349999997,133.93254758690475,133.2626171964191,131.81370153846143,135.47401723907598,128.15338583784688,128.33648405000022,134.0481245,134.86281180000003,132.65859349999997,133.57291666666666,3663700,6164009.75,51.09370421660521,NaN,1.5,2.75,NaN,NaN,2.1267823338548757,0.5943695984582114,NaN,0.3570178590565345,-0.6516084317269986,-1.008626290783533,19.212213420826533,2.9305789094403076,NaN,NaN,NaN,-22488453
935415000,134.8125,136.54687,134.65625,136.46875,NaN,NaN,126.82352941176471,144.61111111111111,128.45757780000022,134.129062,134.9959368,132.74453099999997,134.03200650506534,133.5679631777125,132.26322076923068,136.60169968269906,127.92474185576232,128.45757780000022,134.129062,134.9959368,132.74453099999997,135.89062333333334,5637801,6229229.9,58.48939188899152,NaN,1.5,2.75,NaN,NaN,2.163485024293814,0.9050558561018914,NaN,0.5519908112673031,-0.3186377766994042,-0.8706285879667073,21.00215147378968,6.072382803011902,NaN,NaN,NaN,-16850652
935501400,136.0625,137.96875,135.375,136.96875,NaN,NaN,126.80392156862744,144.70555555555555,128.57351530000022,134.20531200000002,135.1365618,132.79921849999997,134.1471729166314,133.89184763697799,132.6598553846153,137.65420624141805,127.66550452781254,128.57351530000022,134.20531200000002,135.1365618,132.79921849999997,136.77083333333334,9279500,6397779.9,59.76782530575997,NaN,1.5,2.75,NaN,NaN,2.194218236844256,1.4504250138395665,NaN,0.6851059965680186,-0.014246092256684051,-0.6993520888247027,18.476267120053024,5.183585313174946,NaN,NaN,NaN,-7571152
935587800,137.1875,138.78125,136.15625,138.375,NaN,NaN,126.7843137254902,138.78125,128.69476530000023,134.26499950000002,135.28781180000001,132.90234349999997,134.31297005715567,134.31881452869436,133.2752399999999,138.9208167160824,127.62966328391741,128.69476530000023,134.26499950000002,135.28781180000001,132.90234349999997,137.77083333333334,6005301,6500269.95,63.20053978070893,NaN,1.5,2.75,NaN,NaN,2.224988362783952,0.9238540931673153,NaN,0.8287450766635681,0.33657925700475744,-0.4921658196588107,18.292843229823745,6.327294275991606,NaN,NaN,NaN,-1565851
935674200,138.28125,138.42187,136.5,136.71875,NaN,NaN,126.76470588235294,138.65277777777777,128.81179655000022,134.3112495,135.35593680000002,133.01796849999997,134.40731436863976,134.54737981167585,133.7848553846153,139.38555380432376,128.18415696490683,128.81179655000022,134.3112495,135.35593680000002,133.01796849999997,137.21354,4322301,6328354.9,57.02881489024877,NaN,1.5,2.75,NaN,NaN,2.203337051156528,0.6830054679771514,NaN,0.7741200590946751,0.4754842542095332,-0.29863580488514185,20.817866694632368,2.6754283032152077,NaN,NaN,NaN,-5888152
935760600,136.875,137.0625,135.0625,135.0625,NaN,NaN,126.74509803921569,138.52430555555554,128.92210905000022,134.33031200000002,135.36593680000001,133.13359349999996,134.43300792281076,134.59643887723053,134.27764384615375,139.05316735521384,129.50212033709366,128.92210905000022,134.33031200000002,135.36593680000001,133.13359349999996,135.72916666666666,6247398,6341009.75,51.60209066566139,NaN,1.5,2.75,NaN,NaN,2.1888129760739186,0.9852370909853908,NaN,0.5963261036050349,0.44677182462115184,-0.1495542789838831,19.42788540339081,0.9813084112149533,NaN,NaN,NaN,-12135550
936019800,135.34375,135.5,132,132.5625,NaN,NaN,126.72549019607843,138.39583333333334,129.02367155000022,134.3074995,135.33093680000002,133.10859349999996,134.35965467093584,134.40273041273238,134.4579323076922,138.76044780196833,130.15541681341608,129.02367155000022,134.3074995,135.33093680000002,133.10859349999996,133.35416666666666,4652000,6270334.75,44.68940541815886,NaN,1.5,2.75,NaN,NaN,2.2824691920686386,0.7419061637817662,NaN,0.2954471952822344,0.21975471511890987,-0.07569248016332451,22.407583646615116,-1.532033426183844,NaN,NaN,NaN,-16787550
936106200,132.9375,133.75,130.875,132.0625,NaN,NaN,126.70588235294117,138.26736111111111,129.1233590500002,134.27937450000002,135.2796868,133.08984349999997,134.2695701740364,134.1798513258055,134.6057692307691,138.40769644177868,130.80384201975954,129.1233590500002,134.27937450000002,135.2796868,133.08984349999997,132.22916666666666,11453699,6570749.8,43.436133458030085,NaN,1.5,2.75,NaN,NaN,2.324792821206593,1.7431342462621238,NaN,0.06015553634294849,-0.0004980597346389004,-0.06065359607758739,21.936610231610477,-1.1924245966799158,NaN,NaN,NaN,-28241249
936192600,132.9375,133.73437,132.3125,133.6875,NaN,NaN,126.68627450980392,138.13888888888889,129.22570280000022,134.2531245,135.2796868,133.24296849999996,134.24674389270163,134.13296072334782,134.6466346153845,138.39642504346435,130.89684418730465,129.22570280000022,134.2531245,135.2796868,133.24296849999996,133.24479,6863898,6589049.8,48.491871480470174,NaN,1.5,2.75,NaN,NaN,2.2781554768346943,1.0417128733797094,NaN,0.013782501220715768,-0.043425469551692686,-0.057207970772408454,23.027104985047067,0.8486562942008486,NaN,NaN,NaN,-21377351
936279000,132.125,132.67187,130.65625,132.10937,NaN,NaN,126.66666666666667,138.01041666666666,129.3159371500002,134.2198432,135.2612492,133.25781199999997,134.16292530867412,133.9402377973147,134.5204323076922,138.48662496487054,130.55423965051386,129.3159371500002,134.2198432,135.2612492,133.25781199999997,131.81249666666668,10896301,6617764.85,44.34636504033685,NaN,1.5,2.75,NaN,NaN,2.3319479427750736,1.6465228437362807,NaN,-0.11619673593846881,-0.20245389069549447,-0.08625715475702565,23.593361062061074,-1.3418940490081586,NaN,NaN,NaN,-32273652
936365400,134.875,136.5,134.6875,135.96875,NaN,NaN,126.6470588235294,137.88194444444446,129.4254684000002,134.2479682,135.33999920000002,133.53749949999997,134.23374196323593,134.13342943566568,134.6237976923076,138.664837776629,130.58275760798617,129.4254684000002,134.2479682,135.33999920000002,133.53749949999997,135.71875,9160801,6698919.95,54.57394955743042,NaN,1.5,2.75,NaN,NaN,2.478996661148282,1.3675041750573538,NaN,0.05550902662981015,-0.01687087146976296,-0.07237989809957311,28.531699583170184,-0.36638424547744447,NaN,NaN,NaN,-23112851
936711000,136.0625,136.625,135.21875,135.46875,NaN,NaN,126.62745098039215,137.75347222222223,129.52906215000021,134.27609320000002,135.4153118,133.80624949999998,134.28217365095216,134.26060282274514,134.76322076923068,138.78614001806187,130.7403015203995,129.52906215000021,134.27609320000002,135.4153118,133.80624949999998,135.77083333333334,4560801,6648665.1,53.20965811131188,NaN,1.5,2.75,NaN,NaN,2.40237189963769,0.6859724367828364,NaN,0.1289720390199619,0.08883515067537928,-0.04013688834458263,26.35172970242167,-1.0951403148528405,NaN,NaN,NaN,-27673652
936797400,134.84375,136.0625,134.03125,134.8125,NaN,NaN,126.6078431372549,137.625,129.62437465000022,134.30890570000003,135.4453118,134.11406199999996,134.30297076267954,134.31316445867418,134.9362976923076,138.75396678100307,131.1186286036121,129.62437465000022,134.30890570000003,135.4453118,134.11406199999996,134.96875,6159602,6466980.15,51.393660318803164,NaN,1.5,2.75,NaN,NaN,2.375863192520712,0.9524696005136184,NaN,0.12674188303869185,0.11829046545378219,-0.008451417584909665,26.28541581899769,-2.5745257452574526,NaN,NaN,NaN,-33833254
936883800,134.75,135.25,133.6875,134.75,NaN,NaN,126.58823529411765,137.49652777777777,129.7149996500002,134.3614057,135.4490618,134.34062449999996,134.32050132100582,134.35476784356234,135.00120153846143,138.7750543785879,131.22734869833496,129.7149996500002,134.3614057,135.4490618,134.34062449999996,134.5625,6177801,6375700.3,51.21438841811058,NaN,1.5,2.75,NaN,NaN,2.317765821626376,0.968960382281457,NaN,0.11478849150729638,0.1350341967992108,0.02024570529191443,25.226712108200356,-1.44,NaN,NaN,NaN,-40011055
936970200,136.25,136.35937,134.9375,135.875,NaN,NaN,126.56862745098039,137.36805555555554,129.79749965000022,134.40890570000002,135.42656180000003,134.62734349999997,134.3814620535154,134.49955185846116,134.95552846153836,138.67115425898336,131.23990266409336,129.79749965000022,134.40890570000002,135.42656180000003,134.62734349999997,135.72395666666668,2934500,6170585.25,54.304227655076474,NaN,1.5,2.75,NaN,NaN,2.2671661200816358,0.4755626704938563,NaN,0.17288923043157517,0.23635724333138342,0.06346801289980823,25.15981326759867,0.6015733456732995,NaN,NaN,NaN,-37076555
937229400,135.125,135.46875,134.5,134.95312,NaN,NaN,126.54901960784314,137.23958333333334,129.8791402500002,134.40968690000003,135.36499920000003,134.71718699999997,134.40388001220109,134.542748824322,134.8004799999999,138.33072376903965,131.27023623096017,129.8791402500002,134.40968690000003,135.36499920000003,134.71718699999997,134.97395666666668,2320500,5993725.3,51.42971138376574,NaN,1.5,2.75,NaN,NaN,2.2034399686472335,0.38715488012104926,NaN,0.14083165516695675,0.23950758185850418,0.09867592669154743,24.435337004048495,1.803390853371061,NaN,NaN,NaN,-39397055
937315800,134.0625,134.5625,133.375,134.0625,NaN,NaN,126.52941176470588,137.11111111111111,129.9563277500002,134.38874940000002,135.25812420000003,134.73281199999997,134.39049256074222,134.49701084105322,134.46874923076913,137.34252192032164,131.59497654121662,129.9563277500002,134.38874940000002,135.25812420000003,134.73281199999997,134,3736000,5984175.3,48.7451972436414,NaN,1.5,2.75,NaN,NaN,2.1587742566010033,0.6243132616786812,NaN,0.05561906263504365,0.168199754985352,0.11258069235030835,21.93355052916308,1.5144344533838145,NaN,NaN,NaN,-43133055
937402200,135.4375,135.4375,131.875,131.9375,NaN,NaN,126.50980392156863,136.98263888888889,130.0185152500002,134.3499994,135.10937420000002,134.59843699999996,134.29429677404644,134.25324790381006,134.10096076923068,136.95249646379622,131.24942507466514,130.0185152500002,134.3499994,135.10937420000002,134.59843699999996,133.08333333333334,6984500,6093000.3,42.980526417313605,NaN,1.5,2.75,NaN,NaN,2.2590403811295032,1.1463153875111414,NaN,-0.13734509498609832,-0.05910067638231453,0.07824441860378377,23.950727309244012,-1.3090229079008882,NaN,NaN,NaN,-50117555
937488600,132.5,132.8125,130.3125,132.45312,NaN,NaN,126.49019607843137,136.85416666666666,130.1001558500002,134.30859310000002,134.96718660000002,134.53828049999998,134.2220937632995,134.08180715106624,133.90023923076916,136.81933519972014,130.98114326181818,130.1001558500002,134.30859310000002,134.96718660000002,134.53828049999998,131.85937333333334,15377602,6644105.4,44.689768820891786,NaN,1.5,2.75,NaN,NaN,2.276251782477396,2.3144729160979294,NaN,-0.2188991094260895,-0.19537946817882812,0.023519641247261386,22.836174753722005,0.26020107430684136,NaN,NaN,NaN,-34739953
937575000,132.625,133.9375,132.15625,133.75,NaN,NaN,126.47058823529412,136.72569444444446,130.1807808500002,134.27359310000003,134.84874920000001,134.59765549999997,134.20358028238581,134.0502064700123,133.99158538461532,136.81010633695652,131.17306443227412,130.1807808500002,134.27359310000003,134.84874920000001,134.59765549999997,133.28125,8542301,6748815.35,48.843478889628365,NaN,1.5,2.75,NaN,NaN,2.240894512300439,1.2657482175742147,NaN,-0.17599110491142905,-0.19646923989202492,-0.020478134980595877,22.411036472055844,-1.6318087795908987,NaN,NaN,NaN,-26197652
937834200,133.9375,134,133.09375,133.5625,NaN,NaN,126.45098039215686,136.59722222222223,130.2621871000002,134.25546810000003,134.70999920000003,134.58046799999997,134.178439879155,134.00375823477304,134.10696999999993,136.71511482190633,131.49882517809354,130.2621871000002,134.25546810000003,134.70999920000003,134.58046799999997,133.55208333333334,2803900,6705825.35,48.278964759266714,NaN,1.5,2.75,NaN,NaN,2.145562761421836,0.4181289928763206,NaN,-0.1516505711349825,-0.21004134889932402,-0.05839077776434151,13.937603197833893,-1.4071510957324107,NaN,NaN,NaN,-29001552
937920600,132.25,132.46875,130.15625,130.75,NaN,NaN,126.43137254901961,136.46875,130.33921835000018,134.2195306,134.52749920000002,134.29453049999998,134.04399125644304,133.693876498128,133.88100846153839,137.0451048118147,130.71691211126208,130.33921835000018,134.2195306,134.52749920000002,134.29453049999998,131.125,9335199,6890695.25,40.68338024549523,NaN,1.5,2.75,NaN,NaN,2.235611849891705,1.3547542971081183,NaN,-0.3073994645009432,-0.4426401083905205,-0.1352406438895773,17.899269017775055,-3.013444598980065,NaN,NaN,NaN,-38336751
938007000,131.25,131.84375,129.75,130.60156,NaN,NaN,126.41176470588235,136.34027777777777,130.40035115000018,134.1930462,134.35203040000002,133.97617099999997,133.9089939522688,133.39937016497294,133.765023076923,137.27231609491326,130.25773005893274,130.40035115000018,134.1930462,134.35203040000002,133.97617099999997,130.73177,13009102,7077175.35,40.322804031443795,NaN,1.5,2.75,NaN,NaN,2.225478860613726,1.8381771478927678,NaN,-0.39714559650448994,-0.6316726395201897,-0.23452704301569977,17.926813983019148,-3.078619666048233,NaN,NaN,NaN,-51345853
938093400,131.8125,131.8125,127.625,127.875,NaN,NaN,126.3921568627451,136.21180555555554,130.44503865000019,134.1149212,134.10640540000003,133.451171,133.67236673845431,132.87323967307074,133.14242692307684,137.60683009261575,128.67802375353793,130.44503865000019,134.1149212,134.10640540000003,133.451171,129.10416666666666,12204199,7387120.25,34.30796746877779,NaN,1.5,2.75,NaN,NaN,2.365623227712746,1.6520915575998645,NaN,-0.6044422561268473,-0.9900798631742589,-0.38563760704741157,20.50416774533725,-5.887764489420423,NaN,NaN,NaN,-63550052
938179800,127.75,128.375,126.3125,127.75,NaN,NaN,126.37254901960785,136.08333333333334,130.49175740000018,134.0549212,133.84046800000002,133.00273349999998,133.44011706243649,132.38531208515926,132.54867692307684,137.6283162847656,127.46903756138809,130.49175740000018,134.0549212,133.84046800000002,133.00273349999998,127.47916666666667,13792898,7860650.1,34.05714812837074,NaN,1.5,2.75,NaN,NaN,2.343971568590407,1.7546764993394122,NaN,-0.7071473480403504,-1.2695717920978495,-0.5624244440574991,18.890880068623964,-5.337497940025404,NaN,NaN,NaN,-77342950
938439000,128.75,129.75,128.28125,128.59375,NaN,NaN,126.3529411764706,135.95486111111111,130.5416011500002,133.9927337,133.57609300000001,132.67929599999997,133.25006345214487,132.0242109341917,132.07031153846145,137.37344876534794,126.76717431157496,130.5416011500002,133.9927337,133.57609300000001,132.67929599999997,128.875,6970301,7896795.25,37.384773623662525,NaN,1.5,2.75,NaN,NaN,2.3194021708339494,0.8826746521001668,NaN,-0.6754774072883145,-1.4067712031678923,-0.7312937958795778,20.236004979648047,-4.0792540792540795,NaN,NaN,NaN,-70372649
938525400,127.9375,128.8125,125.5625,128.34375,NaN,NaN,126.33333333333333,135.82638888888889,130.5988668000002,133.9363275,133.32546800000003,132.46835849999997,133.05765900304115,131.67369084522107,131.577523076923,136.98265494098433,126.17239121286167,130.5988668000002,133.9363275,133.32546800000003,132.46835849999997,127.57291666666667,11063398,8217365.15,36.79234626307146,NaN,1.5,2.75,NaN,NaN,2.3858734443458096,1.3463437243019436,NaN,-0.6295050101191823,-1.5181750585285556,-0.8886700484093734,20.262086872386714,-2.7238275698720984,NaN,NaN,NaN,-81436047
938611800,128.4375,129.125,126.75,126.8125,NaN,NaN,126.31372549019608,135.69791666666666,130.6473043000002,133.8544525,133.1020306,132.20585849999998,132.81275080684347,131.21072028853337,130.8804076923076,136.2259951714807,125.53482021313452,130.6473043000002,133.8544525,133.1020306,132.20585849999998,127.5625,7580301,8023695.25,33.31048048094145,NaN,1.5,2.75,NaN,NaN,2.3850967697496803,0.9447393954799068,NaN,-0.657309671890363,-1.7103071382723272,-1.0529974663819641,19.54553352666824,-4.258578431372558,NaN,NaN,NaN,-89016348
938698200,127.4375,129.4375,126.96875,128.75,NaN,NaN,126.29411764705883,135.56944444444446,130.7223043000002,133.7986713,132.92046820000002,131.9589835,132.6534272457908,130.97636597533972,130.40324461538452,135.29787257910016,125.5086166516689,130.7223043000002,133.7986713,132.92046820000002,131.9589835,128.38541666666666,7498898,8055445.25,40.92804558930949,NaN,1.5,2.75,NaN,NaN,2.4022327147675604,0.9309104298114371,NaN,-0.5070331355212967,-1.686788885783585,-1.1797557502622884,22.09834403460073,-3.7383177570093458,NaN,NaN,NaN,-81517450
938784600,127.9375,128.5625,126.625,128.46875,NaN,NaN,126.27450980392157,135.44097222222223,130.7812105500002,133.7264838,132.7695308,131.77695249999996,132.4893222557598,130.73754540625976,129.97295615384607,134.47275744179183,125.4731548659003,130.7812105500002,133.7264838,132.7695308,131.77695249999996,127.88541666666667,11127102,8066985.3,40.21003874954314,NaN,1.5,2.75,NaN,NaN,2.3824303779984493,1.3793383260534764,NaN,-0.3934563090380263,-1.6715761365598212,-1.2781198275217949,20.628586618443165,-3.813757604117922,NaN,NaN,NaN,-92644552
939043800,129.1875,130.875,128.75,130.75,NaN,NaN,126.25490196078431,135.3125,130.85230430000018,133.6664838,132.66953080000002,131.51601499999998,132.42111353984765,130.73873155804455,129.8816099999999,134.26488516672137,125.49833483327845,130.85230430000018,133.6664838,132.66953080000002,131.51601499999998,130.125,6341602,7926025.35,48.15480495493102,NaN,1.5,2.75,NaN,NaN,2.3841317795699886,0.8000986269871065,NaN,-0.1444065045916294,-1.4586279582613315,-1.314221453669702,24.095823077154765,0,NaN,NaN,NaN,-86302950
939130200,130.71875,131.96875,128.6875,130.625,NaN,NaN,126.23529411764706,135.18402777777777,130.91347620000022,133.5992963,132.5870308,131.27382749999998,132.3506777147556,130.72789998108792,129.74098538461527,133.89662900591415,125.5853417633164,130.91347620000022,133.5992963,132.5870308,131.27382749999998,130.42708333333334,11976000,8296785.3,47.780157966939036,NaN,1.5,2.75,NaN,NaN,2.4482116524578466,1.4434506338256097,NaN,0.023267413683117466,-1.2851371865658052,-1.3084046002489227,20.787443986514795,0.01794771823552007,NaN,NaN,NaN,-98278950
939216600,130.75,132.8125,130.6875,132.625,NaN,NaN,126.2156862745098,135.05555555555554,130.9841012000002,133.5877338,132.5220308,131.16445249999998,132.36143545143184,130.90857617336525,129.65444692307682,133.50845389064486,125.80043995550878,130.9841012000002,133.5877338,132.5220308,131.16445249999998,132.04166666666666,10308199,8504215.15,53.953043376187125,NaN,1.5,2.75,NaN,NaN,2.4295893915680002,1.2121281997433944,NaN,0.26670626362462335,-0.9750217707181434,-1.2417280343427668,22.52390855094234,3.7145650048875853,NaN,NaN,NaN,-87970751
939303000,132.85937,133,131.5,131.875,NaN,NaN,126.19607843137256,134.92708333333334,131.0426949500002,133.5646088,132.4332808,131.02070249999997,132.3423595513757,131.00061653780665,129.52463923076914,132.9310755901559,126.11820287138238,131.0426949500002,133.5646088,132.4332808,131.02070249999997,132.125,6535602,8522105.2,51.49476158598006,NaN,1.5,2.75,NaN,NaN,2.363190149313143,0.7668999439246538,NaN,0.3687651851241722,-0.7807715529375514,-1.1495367380617236,18.18226700393039,3.228962818003914,NaN,NaN,NaN,-94506353
939389400,131.75,133.875,131.23437,133.875,NaN,NaN,126.17647058823529,134.79861111111111,131.10863245000021,133.56398380000002,132.4226558,130.92070249999998,132.40246309838057,131.27436734372984,129.76502384615375,133.85573776029702,125.67430993201047,131.10863245000021,133.56398380000002,132.4226558,130.92070249999998,132.99479,9674301,8859095.25,57.107222186392256,NaN,1.5,2.75,NaN,NaN,2.3830072815050607,1.0920190749726955,NaN,0.5515178941994212,-0.4601393703124472,-1.0116572645118684,19.170782109130343,4.106925880923451,NaN,NaN,NaN,-84832052
939648600,133.59375,134.125,133.3125,133.65625,NaN,NaN,126.15686274509804,134.67013888888889,131.16081995000022,133.5514838,132.4407808,130.85585899999995,132.45163121216956,131.50121331099365,129.9999999999999,134.5778522004654,125.42214779953437,131.16081995000022,133.5514838,132.4407808,130.85585899999995,133.69791666666666,4282000,8957170.25,56.33936690886752,NaN,1.5,2.75,NaN,NaN,2.270828189968985,0.47805276448775774,NaN,0.632415244597485,-0.22113820876501222,-0.8535534533624972,19.45014279349005,4.139274409544679,NaN,NaN,NaN,-89114052
939735000,133.125,133.3125,131.1875,131.59375,NaN,NaN,126.13725490196079,134.54166666666666,131.2053512000002,133.5264838,132.4114058,130.73242149999996,132.4179888116923,131.51002632899426,130.2860576923076,134.76060148579379,125.81151389882139,131.2053512000002,133.5264838,132.4114058,130.73242149999996,132.03125,8686102,9204675.35,49.571511412550315,NaN,1.5,2.75,NaN,NaN,2.2849654621140574,0.9436619619615373,NaN,0.5261256367277978,-0.19589640745275005,-0.7220220441805478,22.28894635821786,3.7703302119270576,NaN,NaN,NaN,-97800154
939821400,130.6875,131.3125,128.1875,128.1875,NaN,NaN,126.11764705882354,134.41319444444446,131.2344137000002,133.4749213,132.3264058,130.54492149999996,132.25208728966516,131.19359525004242,130.31971153846143,134.72347371435734,125.91594936256554,131.2344137000002,133.4749213,132.3264058,130.54492149999996,129.22916666666666,10469301,9378915.4,40.84492384063991,NaN,1.5,2.75,NaN,NaN,2.3650572148201965,1.1162592425132654,NaN,0.22112861420431484,-0.4456112764251543,-0.6667398906294691,26.71766314039553,-0.4368932038834951,NaN,NaN,NaN,-108269455
939907800,128.48437,129.1875,126.75,128.15625,NaN,NaN,126.09803921568627,134.28472222222223,131.2536324500002,133.4452338,132.2770308,130.33007799999996,132.09146621948221,130.9043242738479,130.2860576923076,134.74836283201128,125.8237525526039,131.2536324500002,133.4452338,132.2770308,130.33007799999996,128.03125,10562199,9138145.25,40.7740062681212,NaN,1.5,2.75,NaN,NaN,2.3702316994758967,1.1558361911570623,NaN,0.022454700225657542,-0.6386715153473972,-0.6611262155730547,25.167474430863496,-0.24324981756263683,NaN,NaN,NaN,-118831654
939994200,126,126.75,124.5,124.875,NaN,NaN,126.07843137254902,134.15625,131.2614449500002,133.4039838,132.13828080000002,129.88632799999996,131.8084675442084,130.3301029144338,130.01923076923066,135.26095607409675,124.77750546436457,131.2614449500002,133.4039838,132.13828080000002,129.88632799999996,125.375,14238699,9422965.15,34.08253467644225,NaN,1.5,2.75,NaN,NaN,2.4620901495133327,1.5110635318437955,NaN,-0.3066217204855157,-1.0444033661799494,-0.7377816456944337,29.130725358516173,-4.493307839388145,NaN,NaN,NaN,-133070353
940253400,124.9375,125.9375,123.4375,125.78125,NaN,NaN,123.4375,134.02777777777777,131.2737887000002,133.3574213,132.0464058,129.49726549999997,131.5721060718865,129.89687882734486,129.93990384615375,135.4000116625733,124.47979602973422,131.2737887000002,133.3574213,132.0464058,129.49726549999997,125.05208333333331,9758801,9770710.2,37.150385605551776,NaN,1.5,2.75,NaN,NaN,2.4647979959766664,0.9987811326140857,NaN,-0.4322458561929403,-1.2780889659356092,-0.8458431097426689,27.003690765991514,-3.708133971291866,NaN,NaN,NaN,-123311552
940339800,127.1875,128.25,125.9375,127,NaN,NaN,123.36328125,133.89930555555554,131.29363245000022,133.3417963,131.98453080000002,129.30976549999997,131.39280779455763,129.62098560569297,129.80528846153837,135.45896290948664,124.1516140135901,131.29363245000022,133.3417963,131.98453080000002,129.30976549999997,127.0625,14392898,10023595.15,41.11918252450301,NaN,1.5,2.75,NaN,NaN,2.465080281978333,1.4359017682393127,NaN,-0.40283642072429715,-1.3493886356480402,-0.9465522149237431,28.083464368450258,-4.2412818096135725,NaN,NaN,NaN,-108918654
940426200,127.75,129.46875,127.125,128.25,NaN,NaN,123.2890625,133.77083333333334,131.3126949500002,133.3222651,131.9764058,129.19218749999996,131.26956043006518,129.49041554800792,129.78846153846143,135.45922377812317,124.1176992987997,131.3126949500002,133.3222651,131.9764058,129.19218749999996,128.28125,9759398,9861109.95,44.95827326286327,NaN,1.5,2.75,NaN,NaN,2.4653424046941663,0.9896855475179039,NaN,-0.2748841898633816,-1.29015745225297,-1.0152732623895884,26.96779052288235,-2.748815165876777,NaN,NaN,NaN,-99159256
940512600,127.21875,129,126.625,129,NaN,NaN,123.21484375,133.64236111111111,131.3205074500002,133.31476510000002,131.95203080000002,129.24843749999997,131.1805580602587,129.4437093053405,129.65384615384605,135.30998122166346,123.99771108602863,131.3205074500002,133.31476510000002,131.95203080000002,129.24843749999997,128.20833333333334,9105398,9706169.9,47.1834303254622,NaN,1.5,2.75,NaN,NaN,2.45888937578744,0.9381041228219176,NaN,-0.12315702655131089,-1.169219545578727,-1.0460625190274162,27.409288872591848,-3.641456582633053,NaN,NaN,NaN,-90053858
940599000,129.75,131.21875,129.5625,130.09375,NaN,NaN,123.140625,133.51388888888889,131.3369137000002,133.3169526,131.95109340000002,129.36562499999997,131.137938136327,129.5056179429271,129.61298076923066,135.24809659106893,123.97786494739239,131.3369137000002,133.3169526,131.95109340000002,129.36562499999997,130.29166666666666,8309602,9432005.1,50.33659463741243,NaN,1.5,2.75,NaN,NaN,2.4417365632311947,0.8810005838525258,NaN,0.0577360369190163,-0.9738924728786458,-1.031628509797662,26.122079165661358,-2.6654196866962825,NaN,NaN,NaN,-81744256
940858200,129.3125,130.46875,128.75,129.4375,NaN,NaN,123.06640625,133.38541666666666,131.3453512000002,133.3053901,131.87671840000002,129.40781249999995,131.07125428784357,129.49913051979118,129.36778846153837,134.7280182709345,124.00755865214221,131.3453512000002,133.3053901,131.87671840000002,129.40781249999995,129.55208333333334,8114301,9489205.1,48.466954280100985,NaN,1.5,2.75,NaN,NaN,2.3900946658575384,0.8551086117845635,NaN,0.13561450448458368,-0.8621103791919325,-0.9977248836765161,26.136899607654335,-1.6385656613630966,NaN,NaN,NaN,-89858557
940944600,130.1875,130.6875,127.8125,127.8125,NaN,NaN,122.9921875,133.25694444444446,131.3517574500002,133.2513276,131.7579684,129.38124999999997,130.94346000204578,129.33849904171583,129.05528846153837,134.2660019216495,123.84457500142726,131.3517574500002,133.2513276,131.7579684,129.38124999999997,128.77083333333334,6256301,9248850.25,44.09905827089358,NaN,1.5,2.75,NaN,NaN,2.424730761153429,0.6764409446460656,NaN,0.0827104463924836,-0.8943368256859117,-0.9770472720783953,25.68346092173215,-0.2925402242808386,NaN,NaN,NaN,-96114858
941031000,128.375,130.3125,128.25,130.125,NaN,NaN,122.91796875,133.12847222222223,131.3811324500002,133.2169526,131.6679684,129.54687499999994,130.91136353137733,129.41340389488576,128.76682692307682,133.24155667592407,124.29209717022957,131.3811324500002,133.2169526,131.6679684,129.54687499999994,129.5625,5433301,9141500.25,50.88285375590543,NaN,1.5,2.75,NaN,NaN,2.4301071353567556,0.594355505268405,NaN,0.20170129048584695,-0.7249206589710866,-0.9266219494569335,23.425862169522578,1.5362106803218727,NaN,NaN,NaN,-90681557
941117400,132.4375,134.85937,132.1875,134.5625,NaN,NaN,122.84375,133,131.4370699500002,133.2400776,131.6860934,129.83749999999995,131.05454535367627,129.90379400013472,128.83653846153837,133.63062497855256,124.04245194452417,131.4370699500002,133.2400776,131.6860934,129.83749999999995,133.86979,10509699,9292040.3,60.73082383699262,NaN,1.5,2.75,NaN,NaN,2.5946973399741315,1.1310432004906392,NaN,0.5573476500125168,-0.2299373869412875,-0.7872850369538044,29.674096775900136,7.757757757757758,NaN,NaN,NaN,-80171858
941203800,135.84375,137.6875,135.71875,137,NaN,NaN,122.76953125,132.87152777777777,131.5159762000002,133.2888276,131.7748434,130.26406249999997,131.28770043784584,130.57962314297905,129.25240384615375,135.61303346103514,122.89177423127236,131.5159762000002,133.2888276,131.7748434,130.26406249999997,136.80208333333334,10988602,9285115.3,64.8945236130261,NaN,1.5,2.75,NaN,NaN,2.6325761014045503,1.1834642484191875,NaN,0.9137758963198963,0.354934833446066,-0.5588410628738303,22.935744610956675,8.919254658385093,NaN,NaN,NaN,-69183256
941466600,136.5,137,135.5625,135.5625,NaN,NaN,122.6953125,132.74305555555554,131.5719137000002,133.3353901,131.80796840000002,130.50468749999996,131.45533963636169,131.0541828436477,129.81971153846143,136.96623578468532,122.67318729223754,131.5719137000002,133.3353901,131.80796840000002,130.50468749999996,136.04166666666666,4006500,9168360.2,60.80021438779099,NaN,1.5,2.75,NaN,NaN,2.5472135227327968,0.43699199339921224,NaN,1.0026335290735506,0.694450848468108,-0.3081826806054426,25.61851416784489,6.7421259842519685,NaN,NaN,NaN,-73189756
941553000,135.96875,137.25,134.59375,134.59375,NaN,NaN,122.62109375,132.61458333333334,131.6189449500002,133.3832026,131.7704684,130.70312499999994,131.57841455258279,131.39128447758603,130.31490384615375,137.8151226546038,122.8146850377037,131.6189449500002,133.3832026,131.7704684,130.70312499999994,135.47916666666666,6516898,8895405.1,58.138127790131904,NaN,1.5,2.75,NaN,NaN,2.555001842537597,0.7326139649334239,NaN,0.9467543463065695,0.8752602522777693,-0.07149409402880025,26.883942997641785,4.946393762183236,NaN,NaN,NaN,-79706654
941639400,136,136.375,135.125,135.5,NaN,NaN,122.546875,132.48611111111111,131.6655074500002,133.4388276,131.7410934,130.84687499999995,131.7322022171874,131.78259071781594,131.13221153846143,138.39501330989134,123.86940976703153,131.6655074500002,133.4388276,131.7410934,130.84687499999995,135.66666666666666,7221301,8741060.2,59.90664954274436,NaN,1.5,2.75,NaN,NaN,2.499733853784911,0.8261355985169855,NaN,0.9205864856801156,1.0792390130713443,0.15865252739122868,26.774894443922125,5.038759689922481,NaN,NaN,NaN,-72485353
941725800,136.75,137.35937,135.76562,136.53125,NaN,NaN,122.47265625,132.35763888888889,131.7339449500002,133.4960151,131.7042184,131.07968749999995,131.92040016945455,132.23484398278583,131.9591346153845,139.0423617146038,124.87590751616521,131.7339449500002,133.4960151,131.7042184,131.07968749999995,136.55208000000002,7910000,8809780.1,61.88017737203675,NaN,1.5,2.75,NaN,NaN,2.4539935785145617,0.8978657707926218,NaN,0.9202918738226208,1.3090173696695047,0.3887254958468839,26.801611076903203,4.948354552005765,NaN,NaN,NaN,-64575353
941812200,138.625,139.10937,136.78125,137.875,NaN,NaN,122.3984375,132.22916666666666,131.81050745000022,133.5416401,131.7273434,131.27968749999997,132.15391388829948,132.772001698711,132.79567307692298,139.907233249753,125.68411290409294,131.81050745000022,133.5416401,131.7273434,131.27968749999997,137.92187333333334,7431500,8697640.05,64.34311547912046,NaN,1.5,2.75,NaN,NaN,2.462859751477808,0.8544271730352878,NaN,0.9540750456924234,1.581319302962413,0.6272442572699897,26.863668198297944,6.518590053114438,NaN,NaN,NaN,-57143853
942071400,137,138.375,136.75,138,NaN,NaN,122.32421875,132.10069444444446,131.8814449500002,133.5760151,131.7860934,131.49687499999996,132.3831721671897,133.26990629883375,133.54567307692298,140.63793996630685,126.45340618753912,131.8814449500002,133.5760151,131.7860934,131.49687499999996,137.70833333333334,4649199,8716000,64.57242404804843,NaN,1.5,2.75,NaN,NaN,2.40301262637225,0.5334097062872878,NaN,0.9274942347162236,1.7866120506652692,0.8591178159490456,26.192254506353123,7.970660146699267,NaN,NaN,NaN,-52494654
942157800,138.5,138.6875,136.28125,136.70312,NaN,NaN,122.25,131.97222222222223,131.9346480500002,133.5999213,131.86890580000002,131.75234349999997,132.55258188612345,133.59687903227814,134.13822076923068,140.89140059388714,127.38504094457423,131.9346480500002,133.5999213,131.86890580000002,131.75234349999997,137.22395666666668,4533699,8508379.85,60.243671275671524,NaN,1.5,2.75,NaN,NaN,2.403243867345661,0.5328510339133484,NaN,0.7716168519681355,1.8236388809092148,1.0520220289410793,25.3972508016182,5.055231508165235,NaN,NaN,NaN,-57028353
942244200,136.25,138.39062,136.07812,137.71875,NaN,NaN,122.17578125,131.84375,132.0002730500002,133.6308588,131.98203080000002,132.22890599999997,132.75517671411862,133.98943817206117,134.72475923076914,141.29292869050897,128.1565897710293,132.0002730500002,133.6308588,131.98203080000002,132.22890599999997,137.39583000000002,6405602,8305194.9,62.37111209185899,NaN,1.5,2.75,NaN,NaN,2.3967621625352566,0.7712765416257721,NaN,0.6886905477703995,1.9128852136540786,1.224194665883679,24.398828361169173,2.345564328843474,NaN,NaN,NaN,-50622751
942330600,138.1875,138.5,137.46875,138.5,NaN,NaN,122.1015625,131.71527777777777,132.05933555000018,133.6789838,132.07828080000002,132.74609349999997,132.98046390180025,134.41901548900773,135.42187461538452,141.50305585660203,129.34069337416702,132.05933555000018,133.6789838,132.07828080000002,132.74609349999997,138.15625,4794102,8016790.05,63.9683674271969,NaN,1.5,2.75,NaN,NaN,2.299225579497024,0.5980076776489862,NaN,0.6393084510943088,2.023330229751565,1.3840217786572562,16.84054275355802,1.094890510948905,NaN,NaN,NaN,-45828649
942417000,139.25,139.98437,137.125,139.75,NaN,NaN,122.02734375,131.58680555555554,132.1198043000002,133.74617130000001,132.23109340000002,133.48984349999995,133.2459359056512,134.92672829957843,136.34014384615375,140.98294590303962,131.69734178926788,132.1198043000002,133.74617130000001,132.23109340000002,133.48984349999995,138.95312333333334,11802898,7895000,66.42412224762586,NaN,1.5,2.75,NaN,NaN,2.3392358952472376,1.4949839138695378,NaN,0.6419973215769919,2.186518430628496,1.544521109051504,14.538982242561074,3.0889810972798526,NaN,NaN,NaN,-34025751
942676200,139.84375,140.25,139.40625,140.07812,NaN,NaN,121.953125,131.45833333333334,132.18566365000018,133.82664,132.3132808,134.20468699999998,133.51386469366489,135.4173370329519,137.1057684615384,140.5152500183197,133.69628690475707,132.18566365000018,133.82664,132.3132808,134.20468699999998,139.91145666666668,2187500,7516434.95,67.05879222755692,NaN,1.5,2.75,NaN,NaN,2.2324154741581492,0.29102892721768314,NaN,0.6168868407798622,2.3156296600263317,1.6987428192464695,12.165726737444135,4.074758300441152,NaN,NaN,NaN,-31838251
942762600,140.5625,143,140.09375,141.25,NaN,NaN,121.87890625,131.32986111111111,132.26128865000018,133.92210880000002,132.42890580000002,134.91718699999996,133.81724254881527,135.97282874409933,137.62019153846146,141.3431378832276,133.8972451936953,132.26128865000018,133.92210880000002,132.42890580000002,134.91718699999996,141.44791666666666,7544801,7174030.1,69.2914157650527,NaN,1.5,2.75,NaN,NaN,2.281662940289709,1.0516823730639213,NaN,0.6281093801892379,2.483879544483017,1.855770164293779,10.426364701569371,4.243542435424354,NaN,NaN,NaN,-24293450
942849000,142.25,142.9375,141.3125,141.5625,NaN,NaN,121.8046875,131.20138888888889,132.3320699000002,134.0046088,132.56390580000001,135.58281199999996,134.12097813513626,136.50517838751844,137.971153076923,142.21748967982978,133.72481647401622,132.3320699000002,134.0046088,132.56390580000001,135.58281199999996,141.9375,9458102,7158965.3,69.87770987407984,NaN,1.5,2.75,NaN,NaN,2.2392227302690157,1.321154888123288,NaN,0.6052412364537485,2.6123217098609643,2.007080473407216,10.44866706087095,3.6850537880521856,NaN,NaN,NaN,-14835348
942935400,142.4375,143,141.625,142.625,NaN,NaN,121.73046875,131.07291666666666,132.41769490000019,134.0852338,132.7214058,136.26406199999997,134.4544691886603,137.0880185410881,138.51442230769223,143.17594433935864,133.85290027602582,132.41769490000019,134.0852338,132.7214058,136.26406199999997,142.41666666666666,4491000,6928245.4,71.84587431646544,NaN,1.5,2.75,NaN,NaN,2.181956820964086,0.6482160692518195,NaN,0.6086882795094071,2.7679408227939746,2.1592525432845675,10.437144518964095,3.445149592021759,NaN,NaN,NaN,-10344348
943021800,142.40625,142.96875,142,142.49609,NaN,NaN,121.65625,130.94444444444446,132.5098628500002,134.14019470000002,132.85382760000002,136.88417899999996,134.76982686753638,137.60307296574638,139.12229461538453,143.6389374286564,134.60565180211267,132.5098628500002,134.14019470000002,132.85382760000002,136.88417899999996,142.48828,4832102,6754370.4,71.2377033867687,NaN,1.5,2.75,NaN,NaN,2.095299190895223,0.7154037628732945,NaN,0.5510281455799704,2.8480377252595304,2.29700957967956,10.205137106141287,3.258036231884065,NaN,NaN,NaN,-15176450
943281000,142.4375,143,141.5,142.46875,NaN,NaN,121.58203125,130.81597222222223,132.60064410000018,134.1845697,133.0041402,137.53574149999997,135.07174542175065,138.06647077853245,139.65835230769224,143.97797821033288,135.3387264050516,132.60064410000018,134.1845697,133.0041402,137.53574149999997,142.32291666666666,4155398,6556425.25,71.1002385988626,NaN,1.5,2.75,NaN,NaN,2.052777820116993,0.6337901892498508,NaN,0.46331591196707844,2.876154469638408,2.4128385576713294,10.31780841280548,4.217628683237066,NaN,NaN,NaN,-19331848
943367400,142.84375,142.84375,140.375,141.21875,NaN,NaN,121.5078125,130.6875,132.6990816000002,134.20269470000002,133.1472652,138.20605399999997,135.31280442481926,138.36668784724364,140.01892923076915,144.00383010163233,136.03402835990596,132.6990816000002,134.20269470000002,133.1472652,138.20605399999997,141.47916666666666,5917898,6539505.1,64.93102248296341,NaN,1.5,2.75,NaN,NaN,2.082490118680065,0.9049458498013864,NaN,0.28228232917625107,2.765691469141643,2.483409139965392,10.03909628964451,2.541411390968913,NaN,NaN,NaN,-25249746
943453800,140.75,142.4375,140,142.0625,NaN,NaN,121.43359375,130.55902777777777,132.7978316000002,134.2295697,133.3497652,138.80292899999998,135.577498368944,138.71866995702996,140.34104461538453,144.25704942243314,136.42503980833592,132.7978316000002,134.2295697,133.3497652,138.80292899999998,141.5,4458102,6490745.15,67.01171146298238,NaN,1.5,2.75,NaN,NaN,2.107847967345774,0.6868397844891506,NaN,0.18522166729956968,2.714936224089854,2.5297145567902843,9.853399664007114,2.572202166064982,NaN,NaN,NaN,-20791644
943626600,142.46875,142.875,141.25,141.375,NaN,NaN,121.359375,130.43055555555554,132.87908160000018,134.2476947,133.5282028,139.14355399999997,135.80485137408346,138.97165377064616,140.60065999999992,144.303109346531,136.89821065346885,132.87908160000018,134.2476947,133.5282028,139.14355399999997,141.83333333333334,1693400,6049930.2,63.6955421079607,NaN,1.5,2.75,NaN,NaN,2.073358826821076,0.2799040557525771,NaN,0.04773873033973164,2.5893879697149487,2.541649239375217,10.66724026570654,1.1627906976744187,NaN,NaN,NaN,-22485044
943885800,140.875,141.92187,140.4375,140.9375,NaN,NaN,121.28515625,130.30208333333334,132.9656441000002,134.260351,133.67195279999999,139.34042899999997,136.0061317123547,139.1588772210608,140.92638153846144,143.86654587964426,137.98621719727862,132.9656441000002,134.260351,133.67195279999999,139.34042899999997,141.09895666666668,7348602,5867930.2,61.606242368495536,NaN,1.5,2.75,NaN,NaN,2.031288196333857,1.2523328924396544,NaN,-0.09202741306602258,2.426614973042689,2.5186423861087115,10.031221375105076,0.6135005238505394,NaN,NaN,NaN,-29833646
943972200,140.75,142.3125,139,139.39062,NaN,NaN,121.2109375,130.17361111111111,133.04822220000017,134.24925720000002,133.7885152,139.53183499999997,136.13885674324274,139.18094796191215,141.05498692307685,143.53254729755528,138.57742654859842,133.04822220000017,134.24925720000002,133.7885152,139.53183499999997,140.23437333333334,7681898,6051700.1,54.76607708963305,NaN,1.5,2.75,NaN,NaN,2.122803325167153,1.2693785007621248,NaN,-0.29648614464550915,2.148034705301825,2.444520849947334,12.033487619669163,-1.316375221238929,NaN,NaN,NaN,-37515544
944058600,139.3125,140.5,139,140.40625,NaN,NaN,121.13671875,130.04513888888889,133.1365034500002,134.25456970000002,133.98164020000002,139.82245999999998,136.3062054984097,139.297643394111,141.20162153846147,143.24446057068243,139.1587825062405,133.1365034500002,134.25456970000002,133.98164020000002,139.82245999999998,139.96875,6980199,6074865.15,58.05873758913101,NaN,1.5,2.75,NaN,NaN,2.0783173733694995,1.1490294562341026,NaN,-0.36656571902112445,1.9863137011709284,2.352879420192053,11.759324354766258,-0.8167770419426048,NaN,NaN,NaN,-30535345
944145000,140.625,141.375,140.375,141.25,NaN,NaN,121.0625,129.91666666666666,133.22415970000017,134.2733197,134.194609,140.10995999999997,136.5000797925897,139.48358211848137,141.31700615384608,143.18041330817215,139.45359899952,133.22415970000017,134.2733197,134.194609,140.10995999999997,141,6698301,6048715.15,60.62314306935178,NaN,1.5,2.75,NaN,NaN,2.0012947038431066,1.107392369105032,NaN,-0.35887885656319396,1.9042808494880603,2.2631597060512543,12.277347437531457,-0.9640666082383874,NaN,NaN,NaN,-23837044
944231400,143.03125,145.34375,143.03125,143.84375,NaN,NaN,120.98828125,145.34375,133.32212845000018,134.3101947,134.513984,140.47558499999997,136.78806685954697,139.89883620243552,141.60666999999992,143.75814598116742,139.45519401883243,133.32212845000018,134.3101947,134.513984,140.47558499999997,144.07291666666666,10044898,6155460.05,67.25187744585531,NaN,1.5,2.75,NaN,NaN,2.150755796425742,1.6318679543700394,NaN,-0.1903535869274262,2.0252177223919716,2.215571309319398,15.770661604849204,0.9457522659042717,NaN,NaN,NaN,-13792146
944490600,143.53125,143.71875,142.25,142.78125,NaN,NaN,120.9140625,145.4375,133.3982222000002,134.3275385,134.814609,140.72089749999998,137.02309364936866,140.17335180220357,141.72445846153838,143.9512754394642,139.49764148361254,133.3982222000002,134.3275385,134.814609,140.72089749999998,142.91666666666666,3138800,5940825.05,62.60277953129068,NaN,1.5,2.75,NaN,NaN,2.1109696681096177,0.5283441228419948,NaN,-0.1627517717436464,2.0121315946398397,2.174883366383486,16.46130673498232,0.21934634788330773,NaN,NaN,NaN,-16930946
944577000,143.28125,143.3125,141.375,141.625,NaN,NaN,120.83984375,145.53125,133.46884720000017,134.32566350000002,135.075234,140.90214749999998,137.2035605650797,140.31160401151752,141.72926615384605,143.95493327833202,139.5035990293601,133.46884720000017,134.32566350000002,135.075234,140.90214749999998,142.10416666666666,10714000,6244065.1,57.91104758355517,NaN,1.5,2.75,NaN,NaN,2.098578977530359,1.715869362092333,NaN,-0.23053694220493792,1.886712188627314,2.117249130832252,17.144988953617727,0.2876742642177473,NaN,NaN,NaN,-27644946
944663400,141.34375,142.0625,140.5,140.71875,NaN,NaN,120.765625,145.625,133.54619095000018,134.324101,135.322734,141.10292899999996,137.341411131155,140.3503798199444,141.58263153846144,143.80409761865891,139.36116545826397,133.54619095000018,134.324101,135.322734,141.10292899999996,141.09375,4611199,6247940.1,54.465621058137366,NaN,1.5,2.75,NaN,NaN,2.0602876219924764,0.7380350845553081,NaN,-0.33807556039178266,1.6946546803425235,2.032730240734306,16.77720277493938,-0.9458864936207655,NaN,NaN,NaN,-32256145
944749800,141.8125,142.21875,139.375,141.40625,NaN,NaN,120.69140625,145.71875,133.63290970000017,134.3583198,135.614609,141.28730399999998,137.50081657699207,140.4509388847116,141.4987976923076,143.65741556421705,139.34017982039813,133.63290970000017,134.3583198,135.614609,141.28730399999998,141,6474699,6251394.95,56.576279544129335,NaN,1.5,2.75,NaN,NaN,2.1162492204215853,1.035720675431009,NaN,-0.3624135730990219,1.5797132743605289,1.9421268474595508,16.639376884512668,0.022104332449160036,NaN,NaN,NaN,-25781446
944836200,142.28125,142.8125,140.875,141.875,NaN,NaN,120.6171875,145.8125,133.72447220000018,134.39878860000002,135.877109,141.45605399999997,137.6723531818159,140.5865637528343,141.45312461538452,143.55201834873765,139.3542308820314,133.72447220000018,134.39878860000002,135.877109,141.45605399999997,141.85416666666666,5127301,6268054.9,58.005579578431536,NaN,1.5,2.75,NaN,NaN,2.1034814189629008,0.8180051198977213,NaN,-0.3464613194307753,1.5090501981710815,1.8555115176018568,16.510729422360118,0.6651884700665188,NaN,NaN,NaN,-20654145
945095400,141.4375,142.71875,141.28125,142.125,NaN,NaN,120.54296875,145.90625,133.81556595000018,134.4598824,136.150234,141.57480399999997,137.84696678252902,140.7330814906596,141.52283615384607,143.64602044079658,139.39965186689557,133.81556595000018,134.4598824,136.150234,141.57480399999997,142.04166666666666,4210801,5888450.05,58.784759272553615,NaN,1.5,2.75,NaN,NaN,2.055911317608408,0.7150949679873739,NaN,-0.3192626093788722,1.4564332558782667,1.7756958652571389,16.37420535429683,1.9616671480476857,NaN,NaN,NaN,-16443344
945181800,141.625,142.48437,140.625,140.75,NaN,NaN,120.46875,146,133.90525345000017,134.5098824,136.350234,141.60839799999997,137.96081122242984,140.73469277726346,141.42187461538452,143.5575956474949,139.28615358327414,133.90525345000017,134.5098824,136.350234,141.60839799999997,141.28645666666668,5739000,6066025.05,52.96406586835423,NaN,1.5,2.75,NaN,NaN,2.0418726520649515,0.946089070304779,NaN,-0.3894166793071614,1.288925016123187,1.6783416954303485,16.040128710786203,0.24482528377476073,NaN,NaN,NaN,-22182344
945268200,140.375,142.20312,140.03125,141.48437,NaN,NaN,120.39453125,146.09375,133.99533155000017,134.57722610000002,136.5674214,141.62011649999997,138.09898999802084,140.8060906080003,141.43028769230762,143.56606550904874,139.2945098755665,133.99533155000017,134.57722610000002,136.5674214,141.62011649999997,141.23958000000002,6879000,6032735,55.49850294560734,NaN,1.5,2.75,NaN,NaN,2.051158176917456,1.1402788287567744,NaN,-0.3814093685104474,1.2015799847922892,1.5829893533027366,15.78719330468573,0.1659256637168231,NaN,NaN,NaN,-15303344
945354600,142.1875,142.65625,141.15625,142.125,NaN,NaN,120.3203125,146.1875,134.08080030000016,134.63972610000002,136.7574214,141.64824149999998,138.25687274319648,140.93170102628596,141.52163384615375,143.66684958148358,139.37641811082392,134.08080030000016,134.63972610000002,136.7574214,141.64824149999998,141.97916666666666,5854801,5852569.95,57.64266401485001,NaN,1.5,2.75,NaN,NaN,2.011789735709066,1.0003812086005055,NaN,-0.3299447336805321,1.1705584362020716,1.5005031698826037,15.630943731801862,-1.1948729089724093,NaN,NaN,NaN,-9448543
945441000,143,143.3125,142.0625,142.6875,NaN,NaN,120.24609375,146.28125,134.15650345000017,134.70347610000002,136.9736714,141.65136649999997,138.43062283169857,141.0989199761635,141.7752399999999,143.60980170501043,139.9406782949894,134.15650345000017,134.70347610000002,136.9736714,141.65136649999997,142.6875,4775398,5866789.85,59.48836967527788,NaN,1.5,2.75,NaN,NaN,1.9573761831584184,0.8139712043716719,NaN,-0.258173814538996,1.1777859017088588,1.4359597162478548,11.321780865910341,-0.06565988181221274,NaN,NaN,NaN,-4673145
945700200,142.5625,143.1875,141.09375,141.65625,NaN,NaN,120.171875,146.375,134.22290970000017,134.7759761,137.12929640000002,141.60937449999997,138.5571180147692,141.1519990260527,141.87139384615375,143.53161503652828,140.21117265577922,134.22290970000017,134.7759761,137.12929640000002,141.60937449999997,141.97916666666666,4608699,5855619.7,54.77589122887758,NaN,1.5,2.75,NaN,NaN,1.9671171700756742,0.7870557235812291,NaN,-0.27855863132911374,1.0877614270864626,1.3663200584155764,11.287954432871066,0.02206531332744925,NaN,NaN,NaN,-9281844
945786600,141.59375,144.0625,141.34375,143.8125,NaN,NaN,120.09765625,146.46875,134.3016597000002,134.8866011,137.33242140000002,141.67656199999996,138.76321142595472,141.40538007119054,142.06850923076914,143.97676993047085,140.16024853106742,134.3016597000002,134.8866011,137.33242140000002,141.67656199999996,143.07291666666666,7981301,6046914.85,61.62167477189607,NaN,1.5,2.75,NaN,NaN,2.0208052293559833,1.319896376579538,NaN,-0.15158257738126646,1.1768418366889932,1.3284244140702597,13.42744613347921,2.1985343104596935,NaN,NaN,NaN,-1300543
945873000,143.625,144.1875,142.96875,144.1875,NaN,NaN,120.0234375,146.5625,134.37665970000018,134.99785110000002,137.5842964,141.82499949999996,138.9759286249369,141.67034387393429,142.09495153846143,144.10754985648165,140.0823532204412,134.37665970000018,134.99785110000002,137.5842964,141.82499949999996,143.78125,5377500,6019894.95,62.679745219923625,NaN,1.5,2.75,NaN,NaN,1.96351557011627,0.8932880132733877,NaN,-0.0522296053946012,1.263137407327008,1.3153670127216093,12.436283779821176,1.9668508287292819,NaN,NaN,NaN,4076957
945959400,145.01562,146.48437,145,146.48437,NaN,NaN,119.94921875,146.65625,134.45595655000017,135.1383198,137.9502338,142.04609299999998,139.27037730631193,142.1288225526072,142.37980692307684,145.46353239957594,139.29608144657774,134.45595655000017,135.1383198,137.9502338,142.04609299999998,145.98958000000002,5721699,6083074.8,68.42223001342776,NaN,1.5,2.75,NaN,NaN,1.9873266008222517,0.9405932341979422,NaN,0.1473698023991683,1.4995792657205698,1.3522094633214015,14.607083474846602,3.248895154185031,NaN,NaN,NaN,9798656
946305000,146.5,146.78125,145.0625,146.28125,NaN,NaN,119.875,146.75,134.54048780000016,135.2948823,138.31273380000002,142.29140549999997,139.54531349037813,142.52429183331128,142.7379799999999,146.41280957632068,139.06315042367913,134.54048780000016,135.2948823,138.31273380000002,142.29140549999997,146.04166666666666,2691000,6132954.8,67.43405137329552,NaN,1.5,2.75,NaN,NaN,1.9681425579063767,0.43877708017675265,NaN,0.23945899632469692,1.6515332087272725,1.4120742124025756,14.878317007371075,2.9243623570800352,NaN,NaN,NaN,7107656
946391400,145.875,146.5,145.48437,146.1875,NaN,NaN,119.80078125,146.84375,134.61533155000018,135.4386323,138.7389838,142.55390549999998,139.80579139271626,142.87316880156735,143.158653076923,147.05778721736957,139.25951893647644,134.61533155000018,135.4386323,138.7389838,142.55390549999998,146.05729,4084500,5969749.7,66.95341762734475,NaN,1.5,2.75,NaN,NaN,1.9001059466273489,0.6841995402252794,NaN,0.265769365702349,1.7442859195305118,1.4785165538281628,15.017809544261313,3.863232682060391,NaN,NaN,NaN,3023156
946477800,146.3125,146.8125,145.3125,146.8125,NaN,NaN,119.7265625,146.9375,134.69580030000017,135.6030073,139.1596088,142.92499949999996,140.08056427927642,143.24834320141807,143.5745184615384,147.77861761335691,139.37041930971986,134.69580030000017,135.6030073,139.1596088,142.92499949999996,146.3125,3001000,5735704.8,68.56214107752221,NaN,1.5,2.75,NaN,NaN,1.8715269504396812,0.5232138167222274,NaN,0.2947348128872662,1.8469350699372455,1.5522002570499793,12.718544734402665,3.765878874111668,NaN,NaN,NaN,6024156
946564200,147.125,147.5625,146.1875,146.64062,NaN,NaN,119.65234375,147.03125,134.77822215000018,135.76847600000002,139.5524212,143.23671799999997,140.3378213663636,143.5714171822354,143.94110461538455,148.31612344755627,139.56608578321283,134.77822215000018,135.76847600000002,139.5524212,143.23671799999997,146.79687333333334,3641300,5568759.85,67.5877067773584,NaN,1.5,2.75,NaN,NaN,1.8360607396939896,0.6538798759655617,NaN,0.2723192145995166,1.892599275299375,1.6202800606998584,13.05835173216797,3.1772172383465347,NaN,NaN,NaN,2382856
946650600,146.84375,147.5,146.25,146.875,NaN,NaN,119.578125,147.125,134.85134715000015,135.95066350000002,139.9249212,143.51796799999997,140.59418131278073,143.88604411726058,144.30648923076916,148.80542914083793,139.8075493207004,134.85134715000015,135.95066350000002,139.9249212,143.51796799999997,146.875,3172700,5392479.8,68.25036085278923,NaN,1.5,2.75,NaN,NaN,1.794199258287276,0.5883563995918909,NaN,0.24417992865601001,1.9255049715198709,1.6813250428638609,13.089023123119071,2.9347349978098993,NaN,NaN,NaN,5555556
946909800,148.25,148.25,143.875,145.4375,NaN,NaN,119.50390625,148.25,134.93009715000017,136.10285100000002,140.2536712,143.59765549999997,140.78411537894618,144.0338018203786,144.66706615384606,148.69473436286927,140.63939794482286,134.93009715000017,136.10285100000002,140.2536712,143.59765549999997,145.85416666666666,8164301,5298449.95,60.13057693983976,NaN,1.5,2.75,NaN,NaN,1.9785421684096136,1.5408848016012682,NaN,0.10667624280980603,1.8146703463761185,1.7079941035663124,15.069278334489946,2.669313920141187,NaN,NaN,NaN,-2608745
946996200,143.53125,144.0625,139.64062,139.75,NaN,NaN,119.4296875,148.3953125,134.97915965000016,136.19894480000002,140.4467962,143.44609299999996,140.74356183467378,143.62582069462826,144.533653076923,149.0584041035402,140.0089020503058,134.97915965000016,136.19894480000002,140.4467962,143.44609299999996,141.15104,8089801,5546000,39.903017125157945,NaN,1.5,2.75,NaN,NaN,2.2512805849517834,1.4586730977280924,NaN,-0.3636349676895452,1.253450393954381,1.6170853616439262,28.201262901630194,-2.824858757062147,NaN,NaN,NaN,-10698546
947082600,139.9375,141.53125,137.25,140,NaN,NaN,137.25,148.540625,135.04822215000016,136.2673823,140.6580462,143.36484299999998,140.71440254703953,143.280504437997,144.37019153846146,149.36075196111494,139.37963111580797,135.04822215000016,136.2673823,140.6580462,143.36484299999998,139.59375,12177898,5619194.9,40.84499969449905,NaN,1.5,2.75,NaN,NaN,2.39627840031237,2.1671962294812017,NaN,-0.6381428197169807,0.8194068369977003,1.457549656714681,26.334901910177095,-2.904204594711747,NaN,NaN,NaN,1479352
947169000,139.625,141.5,137.75,137.75,NaN,NaN,137.50113636363636,148.6859375,135.10244090000018,136.3073823,140.85679620000002,143.21640549999998,140.59815146676345,142.75378972961633,143.99038384615375,150.06843231942395,137.91233537288355,135.10244090000018,136.3073823,140.85679620000002,143.21640549999998,139,6227199,5699994.9,35.458165018090384,NaN,1.5,2.75,NaN,NaN,2.4929728002900577,1.0924920301244478,NaN,-0.9336244677646548,0.2905190720088626,1.2241435397735174,27.149053136814345,-5.9626634568589205,NaN,NaN,NaN,-4747847
947255400,140.3125,145.75,140.0625,145.75,NaN,NaN,137.75227272727273,148.83125,135.18369090000016,136.4186323,141.16929620000002,143.43359299999997,140.80018474257665,143.03914308870048,144.30528769230762,150.29046473147278,138.32011065314245,135.18369090000016,136.4186323,141.16929620000002,143.43359299999997,143.85416666666666,8066602,5779590.05,57.114911508182324,NaN,1.5,2.75,NaN,NaN,2.8863318859836253,1.395704873566249,NaN,-0.5705034754310043,0.511014195484762,1.0815176709157663,43.408909515790285,-0.3631702627643666,NaN,NaN,NaN,3318755
947514600,146.25,146.90625,145.03125,146.25,NaN,NaN,138.0034090909091,148.9765625,135.27212840000016,136.5445698,141.4030462,143.65234299999997,141.0139029879658,143.34493898501472,144.49278769230762,150.55666950610262,138.4289058785126,135.27212840000016,136.5445698,141.4030462,143.65234299999997,146.0625,5741602,5810305.1,58.06207200058638,NaN,1.5,2.75,NaN,NaN,2.814093894127652,0.9881756467487396,NaN,-0.29095069561788667,0.7178293013934081,1.0087799970112947,43.46069249757316,0.04275331338178709,NaN,NaN,NaN,9060357
947601000,145.8125,146.09375,143.5,144.3125,NaN,NaN,138.25454545454545,149.121875,135.33790965000017,136.6620698,141.54929620000001,143.76171799999997,141.14325973353576,143.43708765310856,144.502403076923,150.5647142577254,138.4400918961206,135.33790965000017,136.6620698,141.54929620000001,143.76171799999997,144.63541666666666,7433699,5971450,53.16228404479933,NaN,1.5,2.75,NaN,NaN,2.80951575883282,1.244873355717623,NaN,-0.23332389115117225,0.7171251330723294,0.9504490242235016,44.13071233694758,-1.7028522775649213,NaN,NaN,NaN,1626658
947687400,144.59375,144.59375,142.875,143.0625,NaN,NaN,138.5056818181818,149.2671875,135.40087840000015,136.75363230000002,141.69929620000002,143.87734299999997,141.21852405771082,143.4014126385268,144.2391823076922,150.2311557980574,138.24720881732702,135.40087840000015,136.75363230000002,141.69929620000002,143.87734299999997,143.51041666666666,6911699,6030084.95,50.2178882618194,NaN,1.5,2.75,NaN,NaN,2.7316039189161896,1.1462025920546939,NaN,-0.2734104447057457,0.6086859683413195,0.8820964130470652,44.16045594799435,-2.440060605308415,NaN,NaN,NaN,-5285041
947773800,144.46875,145.75,143.28125,145,NaN,NaN,138.75681818181818,149.4125,135.48400340000018,136.8389448,141.90742120000002,144.05312449999997,141.36681723191825,143.5536590539052,144.14062461538452,150.0363780170412,138.24487121372786,135.48400340000018,136.8389448,141.90742120000002,144.05312449999997,144.67708333333334,5158301,5944050,54.43078206968647,NaN,1.5,2.75,NaN,NaN,2.7284536389936043,0.8678091536915067,NaN,-0.16859847354098711,0.6713483211208313,0.8399467946618184,45.11664583524479,-1.2765957446808511,NaN,NaN,NaN,-126740
947860200,146.53125,147.46875,145.96875,146.96875,NaN,NaN,139.00795454545454,149.5578125,135.57212840000017,136.9389448,142.13679620000002,144.29531199999997,141.58650086988223,143.87890581067612,144.20072076923068,150.19382824092034,138.20761329754103,135.57212840000017,136.9389448,142.13679620000002,144.29531199999997,146.80208333333334,7437301,6023175,58.29310513386316,NaN,1.5,2.75,NaN,NaN,2.70990337906549,1.234780825727295,NaN,0.023917241064368988,0.8698433459922796,0.8459261049279106,45.886512356890684,1.0528577567683712,NaN,NaN,NaN,7310561
948205800,145.34375,146.625,145.1875,145.8125,NaN,NaN,139.2590909090909,149.703125,135.63915965000015,137.0133198,142.3224212,144.45156199999997,141.75222632596527,144.06305763823076,144.1237976923076,150.00547365060854,138.24212173400664,135.63915965000015,137.0133198,142.3224212,144.45156199999997,145.875,6488500,6108830.1,55.327172020803985,NaN,1.5,2.75,NaN,NaN,2.6435709948465265,1.062151000074466,NaN,0.06182725941714695,0.9232101791993443,0.8613829197821974,45.747205475604055,4.338103756708408,NaN,NaN,NaN,822061
948292200,145.3125,146.46875,145,146.25,NaN,NaN,139.51022727272726,149.8484375,135.70994090000016,137.1086323,142.4899212,144.68124949999998,141.92860960729996,144.27133786316116,144.0937499999999,149.92748396060662,138.26001603939315,135.70994090000016,137.1086323,142.4899212,144.68124949999998,145.90625,6152898,6186040.05,56.23454656304287,NaN,1.5,2.75,NaN,NaN,2.5596552095003458,0.9946424449676817,NaN,0.10241460164233196,0.9894011718351123,0.8869865701927804,37.94805177445795,4.464285714285714,NaN,NaN,NaN,6974959
948378600,146.96875,146.96875,143.8125,144.75,NaN,NaN,139.76136363636363,149.99375,135.76790965000018,137.20550730000002,142.62492120000002,144.72812449999998,142.039252367798,144.3169247333363,143.93028846153837,149.55860766633526,138.30196925674147,135.76790965000018,137.20550730000002,142.62492120000002,144.72812449999998,145.17708333333334,5800102,6076980.1,52.3113761396052,NaN,1.5,2.75,NaN,NaN,2.602269123107464,0.954438208543747,NaN,0.01867223581526356,0.9103268649618599,0.8916546291465963,38.890703845525174,5.081669691470054,NaN,NaN,NaN,1174857
948465000,145.5,145.5,144.0625,144.4375,NaN,NaN,140.0125,150.1390625,135.81587840000017,137.3242573,142.7796088,144.74062449999997,142.13330129455105,144.32840809206618,143.85336538461527,149.4242258160775,138.28250495315305,135.81587840000017,137.3242573,142.7796088,144.74062449999997,144.66666666666666,6244801,6120345.15,51.50520263098309,NaN,1.5,2.75,NaN,NaN,2.519071328599788,1.0203347763810346,NaN,-0.06286675117683793,0.813071190175549,0.8759379413523869,37.107722738524934,-0.9005145797598628,NaN,NaN,NaN,-5069944
948724200,145.65625,145.84375,139.40625,140.34375,NaN,NaN,140.26363636363635,150.284375,135.84322215000017,137.40706980000002,142.83210880000001,144.43359349999997,142.0631228124118,143.94891684520275,143.89903846153837,149.34287064134068,138.45520628173605,135.84322215000017,137.40706980000002,142.83210880000001,144.43359349999997,141.86458333333334,7896898,6229105.1,42.30704149664915,NaN,1.5,2.75,NaN,NaN,2.7989590908426605,1.2677419746858984,NaN,-0.37991754983476955,0.40104100405892495,0.7809585538936945,23.353729983329476,-4.038461538461538,NaN,NaN,NaN,-12966842
948810600,140.51562,141.9375,139,141.9375,NaN,NaN,140.5147727272727,150.4296875,135.87134715000016,137.4895698,142.9008588,144.21640599999995,142.05819642761134,143.75735333613582,144.04807692307682,149.1522569234693,138.94389692268433,135.87134715000016,137.4895698,142.9008588,144.21640599999995,140.95833333333334,9942500,6591680.1,46.32586153671134,NaN,1.5,2.75,NaN,NaN,2.808854870068185,1.5083407946329193,NaN,-0.4641333907471541,0.2007918154597519,0.664925206206906,24.63952358088206,-1.645734084019056,NaN,NaN,NaN,-3024342
948897000,141,141.54687,140.09375,140.8125,NaN,NaN,140.7659090909091,150.575,135.89822215000015,137.5766011,142.92210880000002,143.94765599999997,142.00934558731285,143.4768911136467,144.28365384615375,148.38816748050965,140.17914021179786,135.89822215000015,137.5766011,142.92210880000002,143.94765599999997,140.81770666666668,5158102,6645360.2,43.996123096357124,NaN,1.5,2.75,NaN,NaN,2.7399188079204575,0.776195999127331,NaN,-0.5704444769888625,-0.04813039002917208,0.5223140869596904,23.999933010778783,-1.5727391874180865,NaN,NaN,NaN,-8182444
948983400,141.84375,142.21875,138.125,140.25,NaN,NaN,141.01704545454547,150.7203125,135.93369090000016,137.6194136,142.9255464,143.61953099999997,141.94035164271236,143.16956815044225,143.86057692307682,148.38558856941373,139.3355652767399,135.93369090000016,137.6194136,142.9255464,143.61953099999997,140.19791666666666,10919898,7041305.1,42.83614775696528,NaN,1.5,2.75,NaN,NaN,2.836621035926139,1.5508343758602365,NaN,-0.6478338378858848,-0.28747821039766563,0.36035562748821914,23.70303426559382,-3.2758620689655173,NaN,NaN,NaN,-19102342
949069800,139.4375,140.0625,135.53125,135.875,NaN,NaN,141.26818181818183,150.865625,135.94978465000017,137.6234761,142.81804640000001,143.08124999999995,141.70249471554718,142.47484737420965,143.0624999999999,149.04519740746522,137.07980259253455,135.94978465000017,137.6234761,142.81804640000001,143.08124999999995,137.15625,11916199,7455050.05,35.08748438293962,NaN,1.5,2.75,NaN,NaN,2.971058819074272,1.5984063044620338,NaN,-0.9448670424106703,-0.8207281755251188,0.12413886688555154,26.88026833502843,-7.548373378694451,NaN,NaN,NaN,-31018541
949329000,135.8125,139.67187,135,139.625,NaN,NaN,135,151.0109375,135.99025340000017,137.6716011,142.7792964,142.71874999999994,141.62102433454533,142.20343333857062,142.70192307692298,148.9009273095725,136.50291884427347,135.99025340000017,137.6716011,142.7792964,142.71874999999994,138.09895666666668,10768602,7834845.15,44.37545351069343,NaN,1.5,2.75,NaN,NaN,3.092545331997539,1.3744498830331062,NaN,-0.8433257198725921,-0.9300182829551886,-0.08669256308259654,31.384687498854262,-4.243463351907415,NaN,NaN,NaN,-20249939
949415400,139.75,141.6875,138.53125,140.9375,NaN,NaN,134.86764705882354,151.15625,136.04744090000017,137.73347610000002,142.7455464,142.49374999999995,141.5942194586808,142.08286825870675,142.53846153846143,148.8025396179913,136.27438345893157,136.04744090000017,137.73347610000002,142.7455464,142.49374999999995,140.38541666666666,8419801,7847620.15,47.22187374814841,NaN,1.5,2.75,NaN,NaN,3.0970956654262864,1.0729113844787708,NaN,-0.6509220150124835,-0.9003450818482008,-0.2494230668357174,32.370966934967704,-3.6324786324786325,NaN,NaN,NaN,-11830138
949501800,141.28125,142.25,140.375,141.0625,NaN,NaN,134.73529411764707,151.3015625,136.09712840000017,137.7853511,142.7168746,142.55937499999996,141.57336771520312,141.98569032930612,142.23557692307682,148.37378948671508,136.09736435943856,136.09712840000017,137.7853511,142.7168746,142.55937499999996,141.22916666666666,6205898,7753425,47.497428872377725,NaN,1.5,2.75,NaN,NaN,3.0098031178958378,0.8004073038689353,NaN,-0.4859535421938859,-0.8568649945780749,-0.37091145238418893,32.24114628208702,-2.547495682210708,NaN,NaN,NaN,-5624240
949588200,140.875,143.25,140,143.1875,NaN,NaN,134.60294117647058,151.446875,136.13869090000017,137.8676949,142.7312496,142.71874999999994,141.63666702048928,142.10014839318174,141.94471153846143,147.4877118154839,136.40171126143898,136.13869090000017,137.8676949,142.7312496,142.71874999999994,142.14583333333334,7997500,7544405.1,52.078033041523696,NaN,1.5,2.75,NaN,NaN,3.026960038046135,1.0600570746128148,NaN,-0.21808594719647323,-0.6435188863797805,-0.42543293918330727,33.550010798342,-0.8654262224145391,NaN,NaN,NaN,2373260
949674600,143.1875,144,142.125,142.59375,NaN,NaN,134.47058823529412,151.5921875,136.17087840000016,137.95300740000002,142.75874960000002,142.96093749999994,141.67419968635244,142.14715807002156,141.69711538461527,146.7967468178161,136.59748395141443,136.17087840000016,137.95300740000002,142.75874960000002,142.96093749999994,142.90625,4925398,7479315.05,50.74582550724547,NaN,1.5,2.75,NaN,NaN,2.944677178185697,0.6585359711515295,NaN,-0.07277244938100197,-0.5163985009095597,-0.4436260515285578,33.59279067057061,1.6032064128256514,NaN,NaN,NaN,-2552138
949933800,142.5625,142.78125,141.4375,142.375,NaN,NaN,134.33823529411765,151.7375,136.20369090000017,138.0573824,142.7649996,142.79218749999995,141.7016820515935,142.16885730144807,141.39903846153837,145.80518813621978,136.99288878685695,136.20369090000017,138.0573824,142.7649996,142.79218749999995,142.19791666666666,5845801,7368275,50.235953598000506,NaN,1.5,2.75,NaN,NaN,2.8303252368867184,0.7933744329575104,NaN,0.012206427977710876,-0.4283680165564192,-0.4405744445341301,28.741672135444784,0.30823425803610743,NaN,NaN,NaN,-8397939
950020200,143.96875,144.5625,143.625,144.3125,NaN,NaN,134.2058823529412,151.8828125,136.24228465000016,138.1759762,142.8237496,142.69531249999994,141.80406706917807,142.3730137489292,141.3653846153845,145.67425185728794,137.05651737348106,136.24228465000016,138.1759762,142.8237496,142.69531249999994,144.16666666666666,4936500,7328019.9,54.5881482247135,NaN,1.5,2.75,NaN,NaN,2.784409148537667,0.6736471881032965,NaN,0.1924930176262321,-0.19995817250133996,-0.39245119012757207,29.046751840354812,2.4855747891699957,NaN,NaN,NaN,-3461439
950106600,144.46875,144.46875,141.26562,141.28125,NaN,NaN,134.0735294117647,152.028125,136.26244090000017,138.2512887,142.83062460000002,142.54374999999996,141.78356443901424,142.2690362490312,141.12259615384605,145.05054255671965,137.19464975097245,136.26244090000017,138.2512887,142.83062460000002,142.54374999999996,142.33854,8511500,7381909.95,47.577488854260984,NaN,1.5,2.75,NaN,NaN,2.8143177807849757,1.1530213803271876,NaN,0.10553296636343129,-0.26053498217328297,-0.36606794853671426,31.539429386465876,0.7352941176470589,NaN,NaN,NaN,-11972939
950193000,141.625,142.5625,140.875,141.5625,NaN,NaN,133.94117647058823,152.1734375,136.29337840000017,138.33128870000002,142.8740622,142.46874999999994,141.7748952453274,142.2017470824568,141.21634615384605,145.12358345511885,137.30910885257325,136.29337840000017,138.33128870000002,142.8740622,142.46874999999994,141.66666666666666,6690602,7370855.1,48.241684609019096,NaN,1.5,2.75,NaN,NaN,2.733830796443192,0.9077104229060208,NaN,0.06678196800565178,-0.2825904885296495,-0.3493724565353013,31.425588339972986,4.185832566697332,NaN,NaN,NaN,-5282337
950279400,141.84375,141.9375,138.03125,138.6875,NaN,NaN,133.80882352941177,152.31875,136.31509715000016,138.41066370000001,142.83968720000001,142.15312499999996,141.65382092198124,141.86705688412758,140.96634615384605,145.06807696365792,136.86461534403418,136.31509715000016,138.41066370000001,142.83968720000001,142.15312499999996,139.55208333333334,9849199,7605400,42.33662232798757,NaN,1.5,2.75,NaN,NaN,2.8175750252686784,1.2950270860178295,NaN,-0.14129784962712333,-0.5259947685692055,-0.38469691894208213,27.613308657401838,-0.6714413607878246,NaN,NaN,NaN,-15131536
950538600,139.78125,139.78125,138.3125,139.5,NaN,NaN,133.6764705882353,152.4640625,136.34634715000016,138.4996481,142.80468720000002,141.77968749999997,141.56935735641335,141.64162289516304,140.8653846153845,145.04123556328722,136.68953366748178,136.34634715000016,138.4996481,142.80468720000002,141.77968749999997,139.19791666666666,8528801,7659975,44.4076562186321,NaN,1.5,2.75,NaN,NaN,2.72123038060663,1.1134241299743146,NaN,-0.20895212115264117,-0.6458870703828836,-0.43693494923024245,22.79702892790699,-1.0199556541019956,NaN,NaN,NaN,-6602735
950625000,139.25,141.21875,137.79687,141.09375,NaN,NaN,133.5441176470588,152.609375,136.37337840000018,138.63183560000002,142.7496872,141.54374999999996,141.5507060875344,141.58944452419513,140.93028846153837,145.09206752291112,136.7685094001656,136.37337840000018,138.63183560000002,142.7496872,141.54374999999996,140.03645666666668,11078301,7889465.05,48.32799797164576,NaN,1.5,2.75,NaN,NaN,2.7712767819918698,1.4041891217960336,NaN,-0.13471003815796462,-0.6053224969276982,-0.4706124587697336,23.126602526936477,0.022153300841825433,NaN,NaN,NaN,4475566
950711400,140.375,140.9375,138.79687,139.1875,NaN,NaN,133.41176470588235,152.7546875,136.40056590000017,138.7462106,142.6778122,141.19062499999995,141.45803133900364,141.3606879028432,141.18509615384605,144.36815882112856,138.00203348656353,136.40056590000017,138.7462106,142.6778122,141.19062499999995,139.64062333333334,8845398,8024090.05,44.3036732096381,NaN,1.5,2.75,NaN,NaN,2.737391297563878,1.1023552757860688,NaN,-0.19847675374484386,-0.7187084009507885,-0.5202316472059446,24.404889135051498,-2.793539938891314,NaN,NaN,NaN,-4369832
950797800,140.4375,140.4375,138.21875,138.28125,NaN,NaN,133.27941176470588,152.9,136.41790965000015,138.84308560000002,142.6109372,140.86718749999994,141.33345167865056,141.06740810257241,141.08173076923066,144.53641147618964,137.62705006227168,136.41790965000015,138.84308560000002,142.6109372,140.86718749999994,138.97916666666666,7584199,8113294.9,42.4921025283235,NaN,1.5,2.75,NaN,NaN,2.7003454905950295,0.9347865563225121,NaN,-0.2811319215202063,-0.8716465491062024,-0.5905146275859962,22.17522733981696,-3.0243261012491782,NaN,NaN,NaN,-11954031
950884200,138.875,138.875,134.625,135.3125,NaN,NaN,133.14705882352942,153.0453125,136.42455030000016,138.9127731,142.5028122,140.41093749999996,141.0973359265466,140.51932161661313,140.64903846153837,145.27729575047582,136.02078117260092,136.42455030000016,138.9127731,142.5028122,140.41093749999996,136.27083333333334,9650898,8283599.75,37.13522304501729,NaN,1.5,2.75,NaN,NaN,2.8110350984096706,1.1650608782733618,NaN,-0.5022762598288467,-1.2183599523720545,-0.7160836925432078,24.524613071048144,-4.960491659350307,NaN,NaN,NaN,-21604929
951229800,135.1875,136.34375,133.53125,134.96875,NaN,NaN,133.01470588235293,153.190625,136.42439405000016,138.9943356,142.3740622,140.14218749999995,140.8569992235448,139.99069574836426,140.18028846153837,145.6954638679405,134.66511305513623,136.42439405000016,138.9943356,142.3740622,140.14218749999995,134.94791666666666,16415398,8709524.75,36.560485755183,NaN,1.5,2.75,NaN,NaN,2.811139734237551,1.8847639189497682,NaN,-0.6299640188912691,-1.5035387161572942,-0.8735746972660251,24.47575505730549,-6.4746643568644435,NaN,NaN,NaN,-38020327
951316200,135.625,137.46875,134.5,136.5625,NaN,NaN,132.88235294117646,153.3359375,136.43556595000018,139.0724606,142.2678122,139.87343749999997,140.68858748928812,139.6642009151867,139.67067307692298,145.20447520352695,134.136870950319,136.43556595000018,139.0724606,142.2678122,139.87343749999997,136.17708333333334,12119000,8818349.75,41.11118689234742,NaN,1.5,2.75,NaN,NaN,2.82239761036344,1.3742934158400781,NaN,-0.5672988622385082,-1.5826982750641605,-1.0153994128256523,23.99227310208066,-3.3399690333996905,NaN,NaN,NaN,-25901327
951402600,136.6875,137.03125,133.09375,133.8125,NaN,NaN,132.75,153.48125,136.42619095000018,139.1258981,142.10156220000002,139.52343749999994,140.4189369995121,139.10689606612132,138.9951923076922,145.05557785062967,132.93480676475474,136.42619095000018,139.1258981,142.10156220000002,139.52343749999994,134.64583333333334,17375008,9429195.05,36.27578609841401,NaN,1.5,2.75,NaN,NaN,2.9020477810517655,1.8426820007292137,NaN,-0.6645241851734618,-1.8460546442924795,-1.1815304591190177,23.78508889502197,-5.474613686534217,NaN,NaN,NaN,-43276335
951489000,135.1875,136.71875,133.125,133.32812,NaN,NaN,132.61764705882354,153.6265625,136.40908155000017,139.1516793,141.95312460000002,139.17734349999995,140.14086574462928,138.55653644077643,138.29927846153836,144.7147320750124,131.88382484806434,136.40908155000017,139.1516793,141.95312460000002,139.17734349999995,134.39062333333334,10559898,9411195.05,35.48411528108984,NaN,1.5,2.75,NaN,NaN,2.951455082405211,1.1220570760564568,NaN,-0.7107678904991412,-2.069990322242944,-1.3592224317438029,23.359642330257916,-3.86435691753041,NaN,NaN,NaN,-53836233
951748200,133.375,136.6875,132.71875,136.125,NaN,NaN,132.71875,153.771875,136.40298780000018,139.20667930000002,141.8459372,139.18984349999997,139.98338081346733,138.32496154165486,137.66947076923068,143.13758110359285,132.20136043486852,136.40298780000018,139.20667930000002,141.8459372,139.18984349999997,135.17708333333334,13397801,9485275.15,43.19316287839034,NaN,1.5,2.75,NaN,NaN,3.024119005090553,1.412484170266795,NaN,-0.5116108027637889,-1.998735935198539,-1.48712513243475,25.84016621215943,-2.4193548387096775,NaN,NaN,NaN,-40438432
951834600,136.0625,137.4375,135.75,137.4375,NaN,NaN,132.59868421052633,153.9171875,136.42126905000018,139.25480430000002,141.7521872,139.08046849999997,139.88354235019412,138.24044139483058,137.3737976923076,142.4288216176868,132.3187737669284,136.42126905000018,139.25480430000002,141.7521872,139.08046849999997,136.875,8242500,9358970.05,46.42820844558278,NaN,1.5,2.75,NaN,NaN,2.9286462190126565,0.8807058849386957,NaN,-0.26264499508165917,-1.8154313762868242,-1.552786381205165,26.333715455126118,-2.5913621262458473,NaN,NaN,NaN,-32195932
951921000,137.625,139,137.21875,138.4375,NaN,NaN,132.47861842105263,154.0625,136.4425190500002,139.3204293,141.6671872,138.95546849999997,139.82683480704924,138.25920888103718,137.13341307692298,141.6358278489791,132.63099830486686,136.4425190500002,139.3204293,141.6671872,138.95546849999997,138.21875,6866000,9281280,48.81969547535095,NaN,1.5,2.75,NaN,NaN,2.8466893462260385,0.7397686525996414,NaN,-0.014855644598959383,-1.5713559369538643,-1.556500292354905,25.699406253438962,-0.5388414907947912,NaN,NaN,NaN,-25329932
952007400,138.6875,139.125,137.34375,138.53125,NaN,NaN,132.35855263157896,154.2078125,136.46548780000018,139.36699180000002,141.6046872,138.82890599999996,139.77602755971398,138.28511755903364,137.12139384615375,141.6079561734076,132.63483151889992,136.46548780000018,139.36699180000002,141.6046872,138.82890599999996,138.33333333333334,7600199,9350995.05,49.04933028186675,NaN,1.5,2.75,NaN,NaN,2.7705865357813217,0.8127690111438995,NaN,0.16140589928238036,-1.3547429182519295,-1.5161488175343099,24.606084633730273,0.1807909604519774,NaN,NaN,NaN,-17729733
952093800,140.4375,141.71875,139.71875,141.125,NaN,NaN,132.23848684210526,154.353125,136.49658155000017,139.4416793,141.55093720000002,138.72578099999996,139.8289284397252,138.5555825534114,137.24639384615375,142.06903292348363,132.42375476882387,136.49658155000017,139.4416793,141.55093720000002,138.72578099999996,140.85416666666666,12770301,9589635.1,55.05739513594292,NaN,1.5,2.75,NaN,NaN,2.8003660689397987,1.3316774691458282,NaN,0.44277156117186256,-0.9626843660694817,-1.4054559272413443,26.479680762158363,4.295612009237876,NaN,NaN,NaN,-4959432
952353000,140.8125,141.34375,138.75,139.8125,NaN,NaN,132.1184210526316,154.4984375,136.52517530000017,139.5238668,141.46343720000002,138.58671849999996,139.82828418718694,138.675288976896,137.14783615384607,141.69652926465545,132.5991430430367,136.52517530000017,139.5238668,141.46343720000002,138.58671849999996,139.96875,11966898,9941710.1,51.733031487446524,NaN,1.5,2.75,NaN,NaN,2.7856077783012414,1.2037061913523308,NaN,0.5249678798536217,-0.749246077424317,-1.2742139572779387,23.177173090613866,3.5887937022458902,NaN,NaN,NaN,-16926330
952439400,140,140.15625,135.21875,137.04687,NaN,NaN,131.9983552631579,154.64375,136.54369090000017,139.61246050000003,141.27468720000002,138.32031199999997,139.71920912102274,138.52020145528687,136.98317230769223,141.37694274015814,132.58940187522632,136.54369090000017,139.61246050000003,141.27468720000002,138.32031199999997,137.47395666666668,20061808,10652510.45,45.49893468812473,NaN,1.5,2.75,NaN,NaN,2.9393143655654383,1.883293904677653,NaN,0.3840879761042306,-0.7941039871476505,-1.1781919632518811,26.665728107659294,0.35468741418765226,NaN,NaN,NaN,-36988138
952525800,136.46875,137.84375,135.03125,136.875,NaN,NaN,131.87828947368422,154.7890625,136.57244090000017,139.69964800000002,141.0865622,137.94843699999996,139.6076715084336,138.3635156024024,136.87499923076913,141.20438140934115,132.54561705219712,136.57244090000017,139.69964800000002,141.0865622,137.94843699999996,136.58333333333334,11808398,10996105.35,45.13492826046804,NaN,1.5,2.75,NaN,NaN,2.930256196596478,1.0738709410418663,NaN,0.2754256647003026,-0.8339098823765028,-1.1093355470768054,25.877930571522644,2.288650163475012,NaN,NaN,NaN,-48796536
952612200,137.25,140.875,136.125,140.875,NaN,NaN,131.75822368421052,154.934375,136.63181590000016,139.85964800000002,140.98031220000001,137.92812449999997,139.65737066496564,138.6027045926498,137.30288384615375,142.01277627644643,132.59299141586106,136.63181590000016,139.85964800000002,140.98031220000001,137.92812449999997,139.29166666666666,5500898,10845575.25,54.298817993302706,NaN,1.5,2.75,NaN,NaN,3.060237896839587,0.5072020499788612,NaN,0.45826422028804537,-0.5365052717167487,-0.994769492004794,26.927700199197492,5.660381320909638,NaN,NaN,NaN,-43295638
952698600,140.1875,142,139.53125,140.1875,NaN,NaN,131.63815789473685,155.0796875,136.68056590000018,140.0037105,140.84781220000002,137.85937449999997,139.67816005065328,138.7536374885879,137.70432615384607,142.4395569350309,132.96909537266123,136.68056590000018,140.0037105,140.84781220000002,137.85937449999997,140.57291666666666,7924500,10907270.15,52.6704653869184,NaN,1.5,2.75,NaN,NaN,3.017988761351045,0.7265337606037016,NaN,0.514035396784972,-0.3522252460235791,-0.8662606428085511,27.087461527680283,2.9843893480257115,NaN,NaN,NaN,-51220138
952957800,136.6875,140.46875,136.5,138.59375,NaN,NaN,131.51809210526315,155.225,136.73072215000016,140.119648,140.6868748,137.85468699999996,139.63563416631393,138.7384101087224,137.86057615384607,142.5687608208683,133.15239148682383,136.73072215000016,140.119648,140.6868748,137.85468699999996,138.52083333333334,10540398,10941830.1,49.00184567867885,NaN,1.5,2.75,NaN,NaN,3.0859002783973994,0.9633121610981695,NaN,0.42823323605980135,-0.33096909773379934,-0.7592023337936007,26.53688898204591,0.8412914961346066,NaN,NaN,NaN,-61760536
953044200,139.28125,140.09375,136.15625,136.625,NaN,NaN,131.39802631578948,155.3703125,136.7628315500002,140.20339800000002,140.4818748,137.71093699999997,139.51757008136045,138.53713295551074,138.07692230769223,142.24913860188505,133.9047060134994,136.7628315500002,140.20339800000002,140.4818748,137.71093699999997,137.625,8263699,10928575,44.846394985901185,NaN,1.5,2.75,NaN,NaN,3.1467288299404426,0.7561552169427396,NaN,0.2332858872424295,-0.4675949747405639,-0.7008808619829934,27.492154750628302,-1.309255079006772,NaN,NaN,NaN,-70024235
953130600,136.875,140.4375,136.0625,139.8125,NaN,NaN,131.27796052631578,155.515625,136.81314405000018,140.31152300000002,140.3693748,137.64687449999997,139.52913596052278,138.65859648355735,138.57572076923068,141.80065828411514,135.35078325434623,136.81314405000018,140.31152300000002,140.3693748,137.64687449999997,138.77083333333334,10300801,10889700,51.950920425092136,NaN,1.5,2.75,NaN,NaN,3.2344624849446966,0.9459214670743914,NaN,0.30867603451667824,-0.3150358188371456,-0.6237118533538238,30.47105408096399,0.9248815700428603,NaN,NaN,NaN,-59723434
953217000,141.625,146.84375,140.875,146.34375,NaN,NaN,131.1578947368421,155.6609375,136.89548780000018,140.47402300000002,140.5012498,138.00468699999996,139.7963757267768,139.3905158660757,139.36177846153836,144.32640534244612,134.3971515806306,136.89548780000018,140.47402300000002,140.5012498,138.00468699999996,144.6875,25601392,11727499.7,62.585720941500306,NaN,1.5,2.75,NaN,NaN,3.505661593162933,2.183022183321821,NaN,0.7622431892060366,0.329092133153722,-0.43315105605231463,39.78512834043138,3.6979627989371124,NaN,NaN,NaN,-34122042
953303400,145.8125,148,145.4375,146.9375,NaN,NaN,131.0378289473684,155.80625,136.97720655000018,140.64902300000003,140.6399998,138.43749949999997,140.0764198159228,140.10927625978277,140.0925476923076,146.34002944356698,133.8450659410482,136.97720655000018,140.64902300000003,140.6399998,138.43749949999997,146.79166666666666,10272898,11861934.65,63.379251203544314,NaN,1.5,2.75,NaN,NaN,3.438292907937009,0.8660389981157078,NaN,1.0484129405725109,0.8773651196633239,-0.1710478209091869,38.905560871881136,5.096110862762629,NaN,NaN,NaN,-23849144
953562600,146.875,147.34375,144.78125,146.78125,NaN,NaN,130.91776315789474,155.9515625,137.04501905000018,140.83871050000002,140.82062480000002,139.01093699999996,140.33935433294545,140.74470233027967,140.73437461538452,147.8270610775119,133.64168815325715,137.04501905000018,140.83871050000002,140.82062480000002,139.01093699999996,146.30208333333334,12502102,12004494.85,63.000571794771176,NaN,1.5,2.75,NaN,NaN,3.3757362716557937,1.0414517358887452,NaN,1.1644069582961658,1.2844608769610204,0.1200539186648546,38.14827968770645,7.102956820538832,NaN,NaN,NaN,-36351246
953649000,145.53125,149.75,144.5,149.1875,NaN,NaN,130.79769736842104,156.096875,137.12314405000018,141.0293355,140.8893748,139.72187449999996,140.68634043753582,141.54877829882446,141.55408615384607,149.8070422429471,133.30113006474505,137.12314405000018,141.0293355,140.8893748,139.72187449999996,147.8125,13612801,11864365,66.33630825617168,NaN,1.5,2.75,NaN,NaN,3.5096122522518085,1.1473686960911942,NaN,1.3285363694836947,1.780724380519473,0.4521880110357783,35.06401380316619,8.995433789954339,NaN,NaN,NaN,-22738445
953735400,149.5625,150.84375,148.6875,150.09375,NaN,NaN,130.67763157894737,156.2421875,137.21236280000016,141.184648,140.9662498,140.39843699999997,141.05525845959323,142.36258512750786,142.2439899999999,151.6561889948529,132.83179100514693,137.21236280000016,141.184648,140.9662498,140.39843699999997,149.875,8259801,11671405.05,67.52386142154356,NaN,1.5,2.75,NaN,NaN,3.412943519948108,0.7076955143459783,NaN,1.4154776789635959,2.221535109740273,0.8060574307766772,34.569421347597654,6.5439219165927245,NaN,NaN,NaN,-14478644
953821800,149.15625,153.46875,149.15625,152.5,NaN,NaN,130.55756578947367,156.3875,137.31423780000017,141.339648,141.1299998,141.33281199999996,141.50407185333466,143.32805321060235,143.21995153846143,153.95890905435587,132.480994022567,137.31423780000017,141.339648,141.1299998,141.33281199999996,151.70833333333334,11653898,11385349.55,70.49961157806572,NaN,1.5,2.75,NaN,NaN,3.4771975542375286,1.0235871941235215,NaN,1.5419817103429851,2.7335345687054087,1.1915528583624235,32.6384761203402,8.782880071333036,NaN,NaN,NaN,-2824746
953908200,152.875,155.75,151.71875,153.5625,NaN,NaN,130.4375,155.75,137.42751905000017,141.51964800000002,141.33999980000002,142.34453099999996,141.976951388498,144.30276242864022,144.4903846153845,155.89465234660247,133.08611688416653,137.42751905000017,141.51964800000002,141.33999980000002,142.34453099999996,153.67708333333334,11462898,11430499.55,71.7313269930734,NaN,1.5,2.75,NaN,NaN,3.5167727289348476,1.0028343861839353,NaN,1.5973818650050853,3.18828018961878,1.5908983246136947,31.630861686990755,10.800450958286358,NaN,NaN,NaN,8638152
954167400,153.375,153.78125,151.8125,151.9375,NaN,NaN,130.31743421052633,155.8815789473684,137.53814405000017,141.69308550000002,141.4787498,143.13515599999997,142.36756113796866,145.02988029257924,145.64903846153837,156.78041503313938,134.51766188993736,137.53814405000017,141.69308550000002,141.4787498,143.13515599999997,152.51041666666666,8798602,11200539.6,67.11584744736481,NaN,1.5,2.75,NaN,NaN,3.4061996768680727,0.7855516175309982,NaN,1.4301605917025273,3.378599064241854,1.9484384725393267,31.44501163325105,11.20768526989936,NaN,NaN,NaN,-160450
954253800,151.25,152.98437,150.59375,151.0625,NaN,NaN,130.19736842105263,156.01315789473685,137.64376905000017,141.8487105,141.5606248,143.81640599999997,142.70853913255812,145.6044155028098,146.4326923076922,157.54374250065806,135.32164211472636,137.64376905000017,141.8487105,141.5606248,143.81640599999997,151.54687333333334,6334301,11105129.65,64.70170409117978,NaN,1.5,2.75,NaN,NaN,3.333658271377497,0.5703941511389738,NaN,1.1767741582950717,3.419406170408166,2.2426320121130945,29.433761744565185,8.046490835940993,NaN,NaN,NaN,-6494751
954340200,151.5625,152.48437,149.65625,151.21875,NaN,NaN,130.07730263157896,156.14473684210526,137.74580030000018,141.9955855,141.6687498,144.45546849999997,143.04227289206565,146.1391140263517,147.2812499999999,158.03404480665046,136.52845519334932,137.74580030000018,141.9955855,141.6687498,144.45546849999997,151.11979,6747500,11099204.65,64.94419451040713,NaN,1.5,2.75,NaN,NaN,3.297548394850534,0.6079264427293896,NaN,0.9457938668391281,3.4248743456620048,2.4790804788228766,28.57323739970289,3.331197950032031,NaN,NaN,NaN,252749
954426600,150.15625,151.92187,147.125,148.6875,NaN,NaN,129.95723684210526,156.27631578947367,137.82267530000018,142.1037105,141.7174998,144.96328099999997,143.26365434727876,146.38181745241346,148.0576923076922,157.57595177640204,138.53943283898238,137.82267530000018,142.1037105,141.7174998,144.96328099999997,149.24479,9491898,11193789.6,57.99361917204124,NaN,1.5,2.75,NaN,NaN,3.404642795218354,0.8479610872800397,NaN,0.56730005258735,3.1882055445570643,2.6209054919697143,19.361947205120337,1.1909825606125053,NaN,NaN,NaN,-9239149
954513000,149.625,152.3125,148.4375,150.375,NaN,NaN,129.8371710526316,156.4078947368421,137.90173780000018,142.2274605,141.8299998,145.42578099999997,143.54253064738546,146.7621205521836,149.1153846153845,156.01156634771183,142.21920288305716,137.90173780000018,142.2274605,141.8299998,145.42578099999997,150.375,9249102,11017729.65,60.9909790856915,NaN,1.5,2.75,NaN,NaN,3.438239738417043,0.8394744011530543,NaN,0.38412666889133273,3.1010638280838805,2.7169371591925477,20.126670741432616,2.4483713008303174,NaN,NaN,NaN,9953
954768600,150.125,151.25,148.6875,151.25,NaN,NaN,129.7171052631579,156.53947368421052,137.98642530000018,142.3729293,141.9662498,145.99765599999995,143.844784347488,147.18953764245182,149.9951923076922,154.3808829653253,145.60950165005912,137.98642530000018,142.3729293,141.9662498,145.99765599999995,150.39583333333334,8508199,10844794.7,62.48573084874912,NaN,1.5,2.75,NaN,NaN,3.3756868999586827,0.784542191471822,NaN,0.2802512443040137,3.0672512145725648,2.786999970268551,20.090930008570336,1.3824884792626728,NaN,NaN,NaN,8518152
954855000,151.75,153,141.39062,145.75,NaN,NaN,129.59703947368422,156.67105263157896,138.04205030000017,142.4532418,142.07437480000002,146.43281249999995,143.9194986868022,147.05243881936119,149.9495192307691,154.49579164072404,145.4032468208142,138.04205030000017,142.4532418,142.07437480000002,146.43281249999995,146.71354,21056400,10894524.3,49.61610285992382,NaN,1.5,2.75,NaN,NaN,3.9638078356759188,1.932750748924393,NaN,-0.17595279048019652,2.567058982168305,2.7430117726485017,28.651937356196623,-2.894024567978347,NaN,NaN,NaN,-12538248
954941400,147.875,150.8125,147.625,149.1875,NaN,NaN,129.47697368421052,156.80263157894737,138.11955030000018,142.5601168,142.2193748,147.04843749999995,144.12608697359428,147.25577797942202,150.12259615384605,154.35768463961946,145.88750766807263,138.11955030000018,142.5601168,142.2193748,147.04843749999995,149.20833333333334,8227898,10715499.3,55.75033028905505,NaN,1.5,2.75,NaN,NaN,4.042285847413353,0.7678501738131791,NaN,-0.25830320068008694,2.420132771798393,2.67843597247848,32.00601769674763,-2.1721311475409837,NaN,NaN,NaN,-4310350
955027800,150.25,151.6875,149,150.48437,NaN,NaN,129.35690789473685,156.93421052631578,138.20681590000015,142.6674605,142.41281220000002,147.52890599999995,144.37543140600235,147.5632629337628,150.40745153846143,154.17791772435328,146.63698535256958,138.20681590000015,142.6674605,142.41281220000002,147.52890599999995,150.39062333333334,6378500,10759379.4,57.83601284947576,NaN,1.5,2.75,NaN,NaN,3.945515429740971,0.5928315902681153,NaN,-0.23803373761285052,2.3808938004624167,2.6189275380752672,30.8913930063819,-2.004480260480252,NaN,NaN,NaN,2068150
955114200,151.5625,152.125,150.5,151.4375,NaN,NaN,129.23684210526315,157.06578947368422,138.30384715000017,142.78105430000002,142.63656220000001,148.09140599999995,144.65237527243363,147.93223789245204,150.58052846153836,154.31752209450187,146.84353482857486,138.30384715000017,142.78105430000002,142.63656220000001,148.09140599999995,151.35416666666666,6023602,10664334.5,59.35241133534869,NaN,1.5,2.75,NaN,NaN,3.7808807561880435,0.5648361836362128,NaN,-0.17590084153014107,2.399051486162591,2.574952327692732,30.831924462542553,-0.3290826820238585,NaN,NaN,NaN,8091752
955373400,151.75,153.10937,150.3125,150.84375,NaN,NaN,129.11677631578948,157.19736842105263,138.3995503000002,142.8769918,142.9359372,148.70390599999996,144.8951742813578,148.20952475983756,150.63822076923068,154.3665203473457,146.90992119111567,138.3995503000002,142.8769918,142.9359372,148.70390599999996,151.42187333333334,9624199,10618524.55,57.95413733589169,NaN,1.5,2.75,NaN,NaN,3.710594273603184,0.9063593491432855,NaN,-0.18910321995254353,2.338573302752053,2.5276765227045965,30.33337576713157,-0.1448076127430699,NaN,NaN,NaN,-1532447
955459800,150,151.625,148.375,150.40625,NaN,NaN,128.99671052631578,157.32894736842104,138.48501905000018,142.9654293,143.1515622,149.39296849999997,145.11129489777514,148.4187366874721,150.47716307692298,154.04738529189356,146.9069408619524,138.48501905000018,142.9654293,143.1515622,149.39296849999997,150.13541666666666,9006398,10655659.5,56.89059806280804,NaN,1.5,2.75,NaN,NaN,3.677694682631528,0.845222015587116,NaN,-0.23842968399375275,2.2296394177124057,2.4680691017061585,30.203159765767204,-0.5373010952676173,NaN,NaN,NaN,-10538845
955546200,150.375,151.15625,146.15625,146.28125,NaN,NaN,128.8766447368421,157.46052631578948,138.54361280000018,143.0019918,143.2584372,149.71640599999995,145.15717549001926,148.21516652676047,149.91706692307682,153.6560204648259,146.17811338132773,138.54361280000018,143.0019918,143.2584372,149.71640599999995,147.86458333333334,10779699,10679604.4,47.95482769355787,NaN,1.5,2.75,NaN,NaN,3.772145062443562,1.0093725007267123,NaN,-0.5425964561562484,1.789823531510848,2.3324199876670964,33.979045569045745,-1.6183270281630937,NaN,NaN,NaN,-21318544
955632600,147.46875,148.15625,141.125,144.25,NaN,NaN,128.7565789473684,157.5921052631579,138.57986280000017,143.0195309,143.3221872,149.61171849999997,145.12159998060673,147.83753161944995,149.32572076923068,153.9307945026584,144.72064703580298,138.57986280000017,143.0195309,143.3221872,149.61171849999997,144.51041666666666,12226801,10010874.85,44.267587230331806,NaN,1.5,2.75,NaN,NaN,4.004938272269022,1.221351898131061,NaN,-0.8556923508656853,1.26280454908499,2.1184968999506752,33.59538567829572,-4.073150457190358,NaN,NaN,NaN,-33545345
955719000,142.625,142.8125,133.5,138.375,NaN,NaN,133.5,157.72368421052633,138.58158155000018,142.97859340000002,143.2259372,149.18359349999997,144.85702743234765,146.93633813188328,148.34975923076914,155.65499780515987,141.0445206563784,138.58158155000018,142.97859340000002,143.2259372,149.18359349999997,138.22916666666666,29603808,10977420.35,35.71418260777523,NaN,1.5,2.75,NaN,NaN,4.4867283956783774,2.6967909632794558,NaN,-1.4013206917773382,0.3668460352290026,1.7681667270063408,38.65599900757129,-8.512396694214877,NaN,NaN,NaN,-63149153
955978200,135.1875,140.75,134.6875,140.75,NaN,NaN,133.52297794117646,157.85526315789474,138.58830030000018,142.9739059,143.1890622,148.88203099999996,144.6959675330399,146.3471630717039,147.54447076923068,155.66919141850803,139.41975011995333,138.58830030000018,142.9739059,143.1890622,148.88203099999996,138.72916666666666,23918192,11548224.85,40.70224463871393,NaN,1.5,2.75,NaN,NaN,4.599283510272779,2.0711574558578154,NaN,-1.5344035060174366,-0.14983765551545503,1.3845658505019816,40.63504943624181,-3.4305317324185247,NaN,NaN,NaN,-39230961
956064600,140.5625,144.46875,139.78125,144.46875,NaN,NaN,133.54595588235293,157.98684210526315,138.61376905000017,142.99796840000002,143.2309372,148.64609349999995,144.68705704154814,146.16826658868447,147.21995153846143,155.4721401566243,138.96776292029855,138.61376905000017,142.99796840000002,143.2309372,148.64609349999995,142.90625,10955699,11415369.75,47.56300881856463,NaN,1.5,2.75,NaN,NaN,4.605584688110438,0.9597322942605516,NaN,-1.3126821537203082,-0.25628684164840365,1.0563953120719045,39.80866987105743,-3.162966066191873,NaN,NaN,NaN,-28275262
956151000,144.5,145.125,142.53125,143.125,NaN,NaN,133.56893382352942,158.1184210526316,138.63158155000016,143.0154684,143.20718720000002,148.29765599999996,144.6257999026639,145.87843167547643,146.66225923076914,154.96594762890913,138.35857083262914,138.63158155000016,143.0154684,143.20718720000002,148.29765599999996,143.59375,6553699,11330064.65,45.51381220885276,NaN,1.5,2.75,NaN,NaN,4.461882210388264,0.5784343869564769,NaN,-1.2002844781214592,-0.4439602855799194,0.7563241925415397,36.85496202253945,-4.890454736262651,NaN,NaN,NaN,-34828961
956237400,143.5625,143.9375,142.375,143.8125,NaN,NaN,133.59191176470588,158.25,138.6522847000002,143.0442184,143.25781220000002,147.86328099999997,144.59390578883395,145.68167627781202,146.09014384615375,154.06915838773867,138.11112930456883,138.6522847000002,143.0442184,143.25781220000002,147.86328099999997,143.375,8537602,11174249.85,46.77724052210613,NaN,1.5,2.75,NaN,NaN,4.254783481074817,0.7640425187020496,NaN,-1.0299355162609334,-0.531095202784627,0.49884031347630636,36.42912749385134,-5.035080478745357,NaN,NaN,NaN,-26291359
956583000,141.5,143.3125,140.5,142.25,NaN,NaN,133.61488970588235,158.3815789473684,138.6610347000002,143.07281220000002,143.2715622,147.29765599999996,144.50198791476203,145.35484996563943,145.82091307692298,154.05963752373287,137.58218863011308,138.6610347000002,143.07281220000002,143.2715622,147.29765599999996,142.02083333333334,12893102,11245760.05,44.265024954367846,NaN,1.5,2.75,NaN,NaN,4.187477518140901,1.1464856037009254,NaN,-0.9734360971572404,-0.7179548079702442,0.2554812891869962,35.89119925861001,-5.697120364615703,NaN,NaN,NaN,-39184461
956669400,144.625,148.15625,144.4375,148.15625,NaN,NaN,133.6378676470588,158.51315789473685,138.70244095000018,143.1503122,143.46093720000002,147.10859349999996,144.64529231026157,145.62164996891187,145.74158615384607,153.86821800044854,137.6149543072436,138.70244095000018,143.1503122,143.46093720000002,147.10859349999996,146.91666666666666,14102000,11510929.95,54.26402800042731,NaN,1.5,2.75,NaN,NaN,4.310246981130836,1.2250965005655343,NaN,-0.5124003243221924,-0.38501911621574436,0.12738120810644807,44.91982046877994,-1.495948472885934,NaN,NaN,NaN,-25082461
956755800,147.96875,148.75,146,146.48437,NaN,NaN,133.6608455882353,158.64473684210526,138.73798780000018,143.2026559,143.6006246,146.87968699999996,144.7174130039768,145.70381378139646,145.43389384615375,153.10930777742502,137.75847991488249,138.73798780000018,143.2026559,143.6006246,146.87968699999996,147.07812333333334,7711102,11579770,51.45022229920998,NaN,1.5,2.75,NaN,NaN,4.198800768192919,0.6659114991057681,NaN,-0.30442794789683403,-0.25315372676459447,0.05127422113223956,45.25523755087934,0.13885580004273454,NaN,NaN,NaN,-32793563
956842200,143,147.34375,143,146,NaN,NaN,133.68382352941177,158.77631578947367,138.76720655000017,143.2242184,143.6987496,146.61874949999998,144.7677105332326,145.73202199269204,145.01562461538452,151.88734553269984,138.1439036980692,138.76720655000017,143.2242184,143.6987496,146.61874949999998,145.44791666666666,15595301,12022160.05,50.63108606341811,NaN,1.5,2.75,NaN,NaN,4.209154284750568,1.297212891455392,NaN,-0.189495094485864,-0.18559464697509043,0.0039004475107735637,42.36885190683258,1.2131715771230502,NaN,NaN,NaN,-48388864
956928600,147,147.85937,145.0625,145.09375,NaN,NaN,133.70680147058823,158.9078947368421,138.7874409500002,143.2473434,143.8168746,146.43906199999998,144.78049639467446,145.67123418386421,144.57331692307682,150.57235712923057,138.57427671692307,138.7874409500002,143.2473434,143.8168746,146.43906199999998,146.00520666666668,8743398,11984735.05,49.05736216162739,NaN,1.5,2.75,NaN,NaN,4.108276835839814,0.7295445384084648,NaN,-0.16539408007865894,-0.20284215258755012,-0.03744807250889118,41.67487843699357,4.85546522131888,NaN,NaN,NaN,-57132262
957187800,146.5625,148.48437,145.84375,147.0625,NaN,NaN,133.7297794117647,159.03947368421052,138.8136909500002,143.3017184,143.9924996,146.27343699999997,144.86998673213822,145.80373569016285,144.3161053846153,149.52779178118863,139.10441898804197,138.8136909500002,143.3017184,143.9924996,146.27343699999997,147.13020666666668,7328301,11888695,52.51066466708468,NaN,1.5,2.75,NaN,NaN,4.057015633279828,0.6164092021874562,NaN,-0.01563536761410915,-0.05699228202652762,-0.04135691441241847,32.21717519589593,4.484902309058614,NaN,NaN,NaN,-49803961
957274200,145.5,147.125,144.125,144.125,NaN,NaN,133.7527573529412,159.17105263157896,138.82994095000018,143.3357809,144.1687496,145.91718699999996,144.840771566172,145.64385610062354,144.1502399999999,149.23695042969965,139.06352957030018,138.82994095000018,143.3357809,144.1687496,145.91718699999996,145.125,9411898,11933879.95,47.352790325117695,NaN,1.5,2.75,NaN,NaN,3.9815145166169836,0.7886704105817656,NaN,-0.10803722051319914,-0.1764034400539174,-0.06836621954071825,34.57838237728622,-0.23794073112697384,NaN,NaN,NaN,-59215859
957360600,144,144,139.78125,141.625,NaN,NaN,133.77573529411765,159.30263157894737,138.84814410000018,143.33796840000002,144.30187460000002,145.71093699999997,144.71466287730252,145.26110790056416,143.94831692307682,149.20859950276073,138.6880343433929,138.84814410000018,143.33796840000002,144.30187460000002,145.71093699999997,141.80208333333334,12180699,11490094.9,43.441873288412985,NaN,1.5,2.75,NaN,NaN,4.007388479715771,1.0601042990515248,NaN,-0.31921029993719896,-0.4673790944622169,-0.148168794525018,32.638473691715866,-1.0480349344978166,NaN,NaN,NaN,-71396558
957447000,142,142.35937,140.75,141.8125,NaN,NaN,133.79871323529412,159.43421052631578,138.8680660000002,143.3373434,144.4068746,145.34218699999997,144.6008525683887,144.93266905289138,144.2127399999999,148.59874079749767,139.82673920250215,138.8680660000002,143.3373434,144.4068746,145.34218699999997,141.64062333333334,5963602,11376880.1,43.816662009461595,NaN,1.5,2.75,NaN,NaN,3.8361014454503595,0.524186063980757,NaN,-0.42151932504248346,-0.6750679508281223,-0.25354862578563886,32.3320745573749,-1.3906996957844415,NaN,NaN,NaN,-65432956
957533400,141.0625,144,140.9375,143.53125,NaN,NaN,133.82169117647058,159.56578947368422,138.9056441500002,143.3514059,144.60124960000002,144.99453099999997,144.55890736962834,144.79920057166365,144.4266823076922,148.36462761359994,140.48873700178447,138.9056441500002,143.3514059,144.60124960000002,144.99453099999997,142.82291666666666,7862398,11451075,47.2663174512249,NaN,1.5,2.75,NaN,NaN,3.7808441993467623,0.6866078512279414,NaN,-0.3515497362671808,-0.6929857961196149,-0.3414360598524341,33.05922159510092,0.9007029876977153,NaN,NaN,NaN,-57570558
957792600,142.75,143.375,141.84375,142.45312,NaN,NaN,133.84466911764707,159.69736842105263,138.9391597500002,143.36843710000002,144.78374960000002,144.54531199999997,144.47632747278018,144.5757643267433,144.27163384615375,148.34706685443084,140.19620083787666,138.9391597500002,143.36843710000002,144.78374960000002,144.54531199999997,142.55729,5064102,11403100,45.38391183096398,NaN,1.5,2.75,NaN,NaN,3.6313196136791364,0.4440987099999123,NaN,-0.35495626598395225,-0.7851313923323744,-0.43017512634842214,32.71342761839135,-3.8494022358152202,NaN,NaN,NaN,-62634660
957879000,143.0625,143.40625,140.26562,141.3125,NaN,NaN,133.86764705882354,159.82894736842104,138.9719722500002,143.3667184,144.8874996,144.06874949999997,144.35225580718097,144.26497724800583,144.13221076923068,148.47054617426664,139.79387536419472,138.9719722500002,143.3667184,144.8874996,144.06874949999997,141.66145666666668,5619801,11202880.1,43.4140043751844,NaN,1.5,2.75,NaN,NaN,3.5962703555591973,0.5016389490770324,NaN,-0.4073538980046759,-0.9393674988542671,-0.5320136008495912,20.202150638084948,-3.5306633738466515,NaN,NaN,NaN,-68254461
957965400,140.5,140.96875,137.75,138.125,NaN,NaN,133.890625,159.96052631578948,138.9832222500002,143.3267184,144.9012496,143.45468699999998,144.10804969709545,143.6802175101005,143.69471076923068,149.0917138060034,138.29770773245795,138.9832222500002,143.3267184,144.9012496,143.45468699999998,138.94791666666666,10293898,11267255.1,38.39811758566849,NaN,1.5,2.75,NaN,NaN,3.5938581873049693,0.9136118698510696,NaN,-0.6174100911629611,-1.3037762148032925,-0.6863661236403314,22.510422063613568,-5.3938356164383565,NaN,NaN,NaN,-78548359
958051800,140.125,141.5,139.125,141.28125,NaN,NaN,133.91360294117646,160.0921052631579,139.0080660000002,143.3126559,144.95812460000002,143.20468699999998,143.99719480701327,143.45174441390046,143.62019153846146,149.12068799030772,138.1196950866152,139.0080660000002,143.3126559,144.95812460000002,143.20468699999998,140.63541666666666,7091102,11082825.25,45.15520009168312,NaN,1.5,2.75,NaN,NaN,3.5782254596403287,0.6398280077546111,NaN,-0.5090216160113029,-1.3226431436544601,-0.8136215276431572,27.850695077913223,-2.6276114581089813,NaN,NaN,NaN,-71457257
958138200,141.8125,143.46875,141.625,142.8125,NaN,NaN,133.93658088235293,160.22368421052633,139.0500972500002,143.3242184,145.0437496,143.13281199999997,143.9507361871304,143.390863993529,143.20913384615375,148.05158073767865,138.36668695462885,139.0500972500002,143.3242184,145.0437496,143.13281199999997,142.63541666666666,5960801,10769525.25,48.127947833907626,NaN,1.5,2.75,NaN,NaN,3.4788879268088766,0.5534878150733711,NaN,-0.3092636355086653,-1.2002010720289888,-0.8909374365203235,28.88177996584935,-2.889927751806205,NaN,NaN,NaN,-65496456
958397400,142.75,145.60937,142,145.28125,NaN,NaN,133.95955882352942,160.35526315789474,139.1127535000002,143.33890590000001,145.1268746,143.47812449999998,144.00291319939979,143.57090075605004,143.11658615384607,147.74643400574362,138.48673830194852,139.1127535000002,143.33890590000001,145.1268746,143.47812449999998,144.29687333333334,4441301,9511399.9,52.58975217492308,NaN,1.5,2.75,NaN,NaN,3.488208074893958,0.4669450392891166,NaN,-0.002174728383870339,-0.8936558470001614,-0.8914811186162911,29.644888003133328,0.8022549869904597,NaN,NaN,NaN,-61055155
958483800,146.5625,147.71875,145.3125,146.5625,NaN,NaN,133.98253676470588,160.48684210526315,139.1802535000002,143.36265590000002,145.2618746,143.76874949999996,144.1032891523645,143.85581496975956,143.1598553846153,147.905744425517,138.41396634371358,139.1802535000002,143.36265590000002,145.2618746,143.76874949999996,146.53125,8192000,8725090.3,54.76444758973387,NaN,1.5,2.75,NaN,NaN,3.4131574981158184,0.9389014575585538,NaN,0.28031049711268596,-0.5410929972254337,-0.8214034943381197,27.45036539995048,3.4863195057369816,NaN,NaN,NaN,-52863155
958570200,145.6875,146.1875,144.46875,145.15625,NaN,NaN,134.00551470588235,160.6184210526316,139.2438472500002,143.3493747,145.4240622,143.80312449999997,144.14458173462472,143.97966592502056,143.16466307692298,147.91849866706585,138.4108274867801,139.2438472500002,143.3493747,145.4240622,143.80312449999997,145.27083333333334,5906898,8472650.25,51.94795871283645,NaN,1.5,2.75,NaN,NaN,3.3189141053932603,0.6971724107223711,NaN,0.3604174134780853,-0.37088172749051296,-0.7312991409685983,25.764682530959398,2.3578669017188187,NaN,NaN,NaN,-58770053
958656600,145.625,146.3125,143.8125,143.8125,NaN,NaN,134.0284926470588,160.75,139.3097847500002,143.3246872,145.5628122,143.83749949999998,144.13155892150218,143.96374536073287,142.91466307692298,147.13405627642302,138.69526987742293,139.3097847500002,143.3246872,145.5628122,143.83749949999998,144.64583333333334,4325301,8361230.35,49.33687045292985,NaN,1.5,2.75,NaN,NaN,3.2604202407223135,0.5173043701636566,NaN,0.3126453292714897,-0.3404924793792361,-0.6531378086507258,26.640784230439603,0.1959503592423253,NaN,NaN,NaN,-63095354
958743000,142.5625,143.23437,140.40625,141.125,NaN,NaN,134.0514705882353,160.8815789473684,139.3563472500002,143.2740622,145.56781220000002,143.70312449999997,144.01365465007072,143.6933886597107,142.68389384615375,146.94124323562335,138.42654445668416,139.3563472500002,143.2740622,145.56781220000002,143.70312449999997,141.58854,6518398,8260270.15,44.51741788179356,NaN,1.5,2.75,NaN,NaN,3.270836652099291,0.7891264912201449,NaN,0.10075788882601255,-0.5271904476182101,-0.6279483364442227,27.9888277649638,-0.9323207522587168,NaN,NaN,NaN,-69613752
959002200,141.25,141.46875,137,140.0625,NaN,NaN,134.07444852941177,161.01315789473685,139.4047847500002,143.2065622,145.5653122,143.59374949999997,143.85870740889146,143.34758973973825,142.56370153846143,147.01753226532645,138.1098708115964,139.4047847500002,143.2065622,145.5653122,143.59374949999997,139.51041666666666,10839398,8157584.95,42.73985761883454,NaN,1.5,2.75,NaN,NaN,3.356401891235056,1.328750857813623,NaN,-0.09941233161781393,-0.7522137509664901,-0.6528014193486762,27.990160766376864,-0.8845643520566121,NaN,NaN,NaN,-80453150
959088600,140.4375,140.8125,137.5625,138,NaN,NaN,134.09742647058823,161.14473684210526,139.44431600000019,143.120156,145.55343720000002,143.08593699999997,143.62895417717021,142.8382954788108,142.2704323076922,147.34264789110563,137.19821672427878,139.44431600000019,143.120156,145.55343720000002,143.08593699999997,138.79166666666666,7979199,7851444.9,39.44710429320039,NaN,1.5,2.75,NaN,NaN,3.3488017561468375,1.0162714126669856,NaN,-0.3453362548484511,-1.0844717379092401,-0.739135483060789,28.811572025083535,-0.09049773755656108,NaN,NaN,NaN,-88432349
959175000,138,140.6875,136.5,140.25,NaN,NaN,136.5,161.27631578947367,139.5022847500002,143.053906,145.6259372,142.77421849999996,143.49644617022236,142.59179114749548,142.01802846153836,147.14047501767502,136.8955819054017,139.5022847500002,143.053906,145.6259372,142.77421849999996,139.14583333333334,11084500,8020114.8,44.47289502872922,NaN,1.5,2.75,NaN,NaN,3.408708773564921,1.382087448424055,NaN,-0.3310452077707764,-1.1529419927742595,-0.8218967850034831,27.34262295739525,-0.7299270072992701,NaN,NaN,NaN,-77347849
959261400,140.6875,141.8125,137.71875,137.84375,NaN,NaN,136.61111111111111,161.4078947368421,139.5404097500002,142.9779685,145.5865622,142.36640599999996,143.27477181060578,142.13959675249592,141.66346153846143,147.23479494414235,136.09212813278052,139.5404097500002,142.9779685,145.5865622,142.36640599999996,139.125,8278898,7654294.65,40.59264469819573,NaN,1.5,2.75,NaN,NaN,3.457640289738855,1.0816016861854147,NaN,-0.4508020969671337,-1.3853994062124002,-0.9345973092452665,25.631516249565813,-3.4792122538293215,NaN,NaN,NaN,-85626747
959347800,138.8125,139.6875,137.32812,138,NaN,NaN,136.72222222222223,161.53947368421052,139.57970665000022,142.96046850000002,145.4196872,142.01171849999997,143.06791801411143,141.7453494427344,141.40865384615375,147.31387793993045,135.50342975237706,139.57970665000022,142.96046850000002,145.4196872,142.01171849999997,138.33854,4814000,7457824.75,40.95291360230717,NaN,1.5,2.75,NaN,NaN,3.379193126186079,0.645496530338823,NaN,-0.4837395489597691,-1.539271745444978,-1.055532196485209,24.377929389668868,-5.01183050118305,NaN,NaN,NaN,-80812747
959693400,140,142.9375,139.46875,142.71875,NaN,NaN,136.83333333333334,161.67105263157896,139.6275191500002,142.98765600000002,145.3353122,141.79453099999995,143.05422515081295,141.8380542577121,141.7620192307691,147.38186400847582,136.1421744530624,139.6275191500002,142.98765600000002,145.3353122,141.79453099999995,141.70833333333334,5362602,7359539.8,50.68034573447425,NaN,1.5,2.75,NaN,NaN,3.4905007600299305,0.7286599632221569,NaN,-0.16826299257450694,-1.2658609372033425,-1.0975979446288355,30.512505672560142,-2.6226012793176974,NaN,NaN,NaN,-75450145
959779800,142.5625,144,142.09375,142.8125,NaN,NaN,136.94444444444446,161.80263157894737,139.6728316500002,143.038281,145.2559372,141.72890599999997,143.04474573313402,141.93085861412047,141.8798076923076,147.5185647026235,136.24105068199168,139.6728316500002,143.038281,145.2559372,141.72890599999997,142.96875,6056500,7191769.9,50.85357475967931,NaN,1.5,2.75,NaN,NaN,3.3773399914563638,0.8421431836966864,NaN,0.054281722214504224,-1.0297457918607051,-1.0840275140752094,29.834008285160163,-1.6146393972012918,NaN,NaN,NaN,-69393645
959866200,143.6875,145.4375,143,145.3125,NaN,NaN,137.05555555555554,161.93421052631578,139.7262691500002,143.033906,145.17843720000002,141.91328099999996,143.13367727301113,142.25291969848993,142.07211538461527,147.98867179802014,136.1555589712104,139.7262691500002,143.033906,145.17843720000002,141.91328099999996,144.58333333333334,8961602,7030815.05,55.3566653187951,NaN,1.5,2.75,NaN,NaN,3.323601420638052,1.2746177984016234,NaN,0.3603499319292436,-0.6335900991636549,-0.9939400310928985,31.472897307803564,1.0430247718383312,NaN,NaN,NaN,-60432043
959952600,148.9375,149.09375,147.48437,147.84375,NaN,NaN,137.16666666666666,162.06578947368422,139.79720665000022,143.0498435,145.1334372,142.21484349999997,143.31838600740286,142.78537972720517,142.26923076923066,148.74466226202279,135.79379927643853,139.79720665000022,143.0498435,145.1334372,142.21484349999997,148.14062333333334,8962199,7180744.9,59.41174033018326,NaN,1.5,2.75,NaN,NaN,3.356290604878191,1.2480876461716388,NaN,0.7038974404456164,-0.114068230535878,-0.8179656709814944,32.248602009747046,4.760850310008857,NaN,NaN,NaN,-51469844
960211800,147.46875,148.21875,146.875,147.125,NaN,NaN,137.27777777777777,162.19736842105263,139.87001915000022,143.0779685,145.02593720000002,142.39453099999997,143.46766498750472,143.19867689604277,142.3124999999999,148.9084996618056,135.71650033819418,139.87001915000022,143.0779685,145.02593720000002,142.39453099999997,147.40625,6998102,7137530.1,57.80611738430423,NaN,1.5,2.75,NaN,NaN,3.2125377045297485,0.9804654974414749,NaN,0.8439151872163855,0.23692831303898743,-0.606986874177398,29.72155226514617,5.042391789379741,NaN,NaN,NaN,-58467946
960298200,146.625,147.78125,145.90625,146.46875,NaN,NaN,137.38888888888889,162.32894736842104,139.9328316500002,143.112031,144.88406220000002,142.59531249999995,143.58535459583786,143.51011242975298,142.41346153846143,149.21738406054203,135.60953901638084,139.9328316500002,143.112031,144.88406220000002,142.59531249999995,146.71875,4858898,7127269.9,56.309774166762004,NaN,1.5,2.75,NaN,NaN,3.116999297063338,0.6817334081876147,NaN,0.8510896112681081,0.4568751399077371,-0.394214471360371,29.327277626215622,6.136775362318841,NaN,NaN,NaN,-63326844
960384600,146.625,148,146,147.48437,NaN,NaN,137.5,162.46052631578948,139.9879097500002,143.13687470000002,144.7949996,142.90390599999995,143.73825716070695,143.8886131507289,142.69591307692298,149.99550430170433,135.39632185214163,139.9879097500002,143.13687470000002,144.7949996,142.90390599999995,147.16145666666668,4919500,7092254.85,58.11671833202286,NaN,1.5,2.75,NaN,NaN,3.037213632987385,0.6936439967325766,NaN,0.8793793513034303,0.7050097177689167,-0.17436963353451346,26.62585310950034,5.158196078431382,NaN,NaN,NaN,-58407344
960471000,147.5,147.75,146.0625,146.90625,NaN,NaN,137.61111111111111,162.5921052631579,140.0375972500002,143.1362497,144.71187460000002,143.34296849999996,143.86249217401257,144.17600713637376,143.14062461538452,150.70290519707666,135.5783440336924,140.0375972500002,143.1362497,144.71187460000002,143.34296849999996,146.90625,5723102,6863715.05,56.679709323871705,NaN,1.5,2.75,NaN,NaN,2.9408055163454287,0.8338198713537794,NaN,0.8157077204518737,0.8452650170303286,0.02955729657845499,26.49303593353891,6.574472908637497,NaN,NaN,NaN,-64130446
960557400,147.5,147.96875,145.625,146.59375,NaN,NaN,137.72222222222223,162.7236842105263,140.0786910000002,143.1440622,144.61937460000001,143.60859349999996,143.9696003240513,144.406268361481,143.64302846153836,151.18836188112954,136.0976950419472,140.0786910000002,143.1440622,144.61937460000001,143.60859349999996,146.72916666666666,3085300,6663424.95,55.8754499124915,NaN,1.5,2.75,NaN,NaN,2.898158693749327,0.4630201470191391,NaN,0.7128263409854453,0.9205902228102616,0.20776388182481634,23.118094366920204,6.2273550724637685,NaN,NaN,NaN,-67215746
960816600,146.96875,146.96875,144.875,144.875,NaN,NaN,137.83333333333334,162.85526315789474,140.1194722500002,143.13031220000002,144.5431246,143.71171849999996,144.00510619369635,144.45090946991138,144.17187461538452,150.98966468566317,137.35408454510588,140.1194722500002,143.13031220000002,144.5431246,143.71171849999996,145.57291666666666,3436800,6537224.9,51.54344121076759,NaN,1.5,2.75,NaN,NaN,2.840700929910089,0.5257276677141702,NaN,0.49939399745673063,0.8320063786457297,0.33261238118899905,25.233406356387416,1.5108386249178891,NaN,NaN,NaN,-70652546
960903000,144.8125,147.75,144.625,147.59375,NaN,NaN,137.94444444444446,162.98684210526315,140.1821285000002,143.15874970000002,144.4874996,143.82734349999996,144.14583732335532,144.75022761563412,144.73677846153836,151.37575353805664,138.0978033850201,140.1821285000002,143.15874970000002,144.4874996,143.82734349999996,146.65625,6551500,6642734.85,57.19656110172109,NaN,1.5,2.75,NaN,NaN,2.8610080063450822,0.9862654686570849,NaN,0.5099115907634958,0.9700018696433688,0.46009027887987297,19.884083051591503,3.3479212253829322,NaN,NaN,NaN,-64101046
960989400,148.25,148.875,147.1875,147.84375,NaN,NaN,138.05555555555554,163.1184210526316,140.2585347500002,143.19281220000002,144.4193746,143.89140599999996,144.29085350675317,145.04484879509752,145.50600923076914,150.98868378286244,140.02333467867584,140.2585347500002,143.19281220000002,144.4193746,143.89140599999996,147.96875,6407102,6553489.95,57.685417279049716,NaN,1.5,2.75,NaN,NaN,2.777186005891862,0.9776625964002584,NaN,0.5015332670171134,1.0870068626512648,0.5854735956341514,19.841525608828444,1.7419354838709677,NaN,NaN,NaN,-57693944
961075800,148.125,148.75,146.84375,148.15625,NaN,NaN,138.16666666666666,163.25,140.3390035000002,143.27093720000002,144.4674996,144.04140599999997,144.4424376829589,145.34117271937396,146.28725923076914,149.81486997344967,142.7596484880886,140.3390035000002,143.27093720000002,144.4674996,144.04140599999997,147.91666666666666,5776199,6546955,58.326126552677714,NaN,1.5,2.75,NaN,NaN,2.714976291185301,0.8822725984828061,NaN,0.48459606233522323,1.1912186735531805,0.7066226112179572,17.760483371159644,0.2113718030014796,NaN,NaN,NaN,-51917745
961162200,148.3125,148.3125,145.875,146.59375,NaN,NaN,138.27777777777777,163.3815789473684,140.4035347500002,143.3174997,144.4156246,144.18046849999996,144.5268028718625,145.4604657937193,146.58533615384607,149.4487796122427,143.72189269544944,140.4035347500002,143.3174997,144.4156246,144.18046849999996,146.92708333333334,5526199,6606999.9,53.92919623684615,NaN,1.5,2.75,NaN,NaN,2.695156556100636,0.8364157838113483,NaN,0.3424195810449492,1.1346470875241437,0.7922275064791945,16.083786011494595,-0.3610875106202209,NaN,NaN,NaN,-57443944
961421400,146.46875,149.15625,146.25,148.46875,NaN,NaN,138.38888888888889,149.15625,140.4853316500002,143.3940622,144.3753122,144.54765599999996,144.68138903375024,145.74696905146033,147.0204323076922,149.05850793700407,144.98235667838034,140.4853316500002,143.3940622,144.3753122,144.54765599999996,147.95833333333334,5090500,6535605,58.0190230456178,NaN,1.5,2.75,NaN,NaN,2.710234659236305,0.7788873409577232,NaN,0.34779144943294016,1.2269668182703697,0.8791753688374295,17.566761454081625,1.3654789844250053,NaN,NaN,NaN,-52353444
961507800,148.1875,148.875,147,147.9375,NaN,NaN,138.5,149.04449152542372,140.5451754000002,143.4709372,144.3053122,144.94140599999997,144.80907965987768,145.95559104655933,147.2223553846153,149.05317085552758,145.391539913703,140.5451754000002,143.4709372,144.3053122,144.94140599999997,147.9375,5662301,6276750.15,56.488906022716215,NaN,1.5,2.75,NaN,NaN,2.6505750407194264,0.9021071198763583,NaN,0.29100822206971233,1.24293564642457,0.9519274243548577,17.474838790807038,0.3072393366157969,NaN,NaN,NaN,-58015745
961594200,146.9375,148.4375,146.89062,147.84375,NaN,NaN,138.61111111111111,148.93273305084745,140.60705040000022,143.5906247,144.2453122,145.43359349999997,144.92808633988247,146.13541570879178,147.2223553846153,149.05317085552758,145.391539913703,140.60705040000022,143.5906247,144.2453122,145.43359349999997,147.72395666666668,3112700,6033425.2,56.20719543624191,NaN,1.5,2.75,NaN,NaN,2.571739680668038,0.5159092715693235,NaN,0.22550101675938583,1.2338036953040898,1.008302678544704,17.07353705120826,0.6381620931716656,NaN,NaN,NaN,-61128445
961680600,147.5625,147.6875,145,145.625,NaN,NaN,138.72222222222223,148.8209745762712,140.6611129000002,143.6506247,144.14968720000002,145.70234349999996,144.95541628733807,146.08680468890685,147.10697076923068,149.12707102710604,145.08687051135533,140.6611129000002,143.6506247,144.14968720000002,145.70234349999996,146.10416666666666,7486500,5853525.2,49.868652788029856,NaN,1.5,2.75,NaN,NaN,2.5911689891917495,1.2789728828706504,NaN,0.021833288987344712,1.035594289778885,1.0137610007915403,19.15065444492978,-0.6608399062033682,NaN,NaN,NaN,-68614945
961767000,145.8125,146.125,143.875,144.375,NaN,NaN,138.83333333333334,148.70921610169492,140.7092379000002,143.68499970000002,144.1115622,146.02890599999995,144.9326548643052,145.92377567091572,146.94591307692298,149.42547509835651,144.46635105548944,140.7092379000002,143.68499970000002,144.1115622,146.02890599999995,144.79166666666666,4469898,5663075.2,46.675134517726896,NaN,1.5,2.75,NaN,NaN,2.566799775678053,0.7893057821305286,NaN,-0.1959805794734908,0.7687852764496768,0.9647658559231675,19.660347622843144,-0.3451251078515962,NaN,NaN,NaN,-73084843
962026200,145.375,146.25,144.875,146.23437,NaN,NaN,138.94444444444446,148.59745762711864,140.7610347500002,143.7367184,144.1512496,146.44062449999996,144.98370251668538,145.95335608320946,146.84975923076914,149.33528073886748,144.3642377226708,140.7610347500002,143.7367184,144.1512496,146.44062449999996,145.78645666666668,5194801,5682115.25,51.63648716304089,NaN,1.5,2.75,NaN,NaN,2.517385505986763,0.9142371760234888,NaN,-0.21236340322855563,0.699311601887473,0.9116750051160286,20.020860464360343,-0.921028160067745,NaN,NaN,NaN,-67890042
962112600,145.98437,146.71875,145.01562,145.15625,NaN,NaN,139.05555555555554,148.48569915254237,140.8120504000002,143.7564059,144.2868746,146.56249949999997,144.9904690846585,145.87744121814188,146.71514384615375,149.35840006518194,144.07188762712556,140.8120504000002,143.7564059,144.2868746,146.56249949999997,145.63020666666668,4076600,5617815.15,48.80126327507427,NaN,1.5,2.75,NaN,NaN,2.459224398416279,0.7256557738465281,NaN,-0.28861406597236894,0.5509074226505675,0.8395214886229364,16.96209526543943,-1.8177975058127245,NaN,NaN,NaN,-71966642
962199000,145.625,146.98437,145.3125,145.5625,NaN,NaN,139.16666666666666,148.3739406779661,140.8695504000002,143.7860934,144.3831246,146.69999949999996,145.01290166957386,145.84744681641408,146.63581692307682,149.3498350432442,143.92179880290942,140.8695504000002,143.7860934,144.3831246,146.69999949999996,145.95312333333334,5320102,5580995.25,49.917176512552174,NaN,1.5,2.75,NaN,NaN,2.414145512815117,0.953253275031904,NaN,-0.30300470914427335,0.46076560219259477,0.7637703113368681,17.053268959777416,-1.7506855093862055,NaN,NaN,NaN,-66646540
962285400,144.75,145.75,143.51562,144.1875,NaN,NaN,143.51562,148.26218220338984,140.9308004000002,143.8042184,144.37749960000002,146.64374949999996,144.98053297664939,145.68935664342226,146.5829323076922,149.45436068475976,143.71150393062464,140.9308004000002,143.8042184,144.37749960000002,146.64374949999996,144.48437333333334,6339199,5449875.1,46.24338263398009,NaN,1.5,2.75,NaN,NaN,2.401305119042608,1.1631824369699777,NaN,-0.3908529138332921,0.2752041690452529,0.666057082878545,17.435054532592062,-1.6414410573438498,NaN,NaN,NaN,-72985739
962371800,143.9375,145.59375,143.89062,145.28125,NaN,NaN,143.7962448,148.15042372881356,140.99494105000022,143.8139059,144.4206246,146.51562449999997,144.9923258010945,145.6504893440487,146.4050476923076,149.29044030684204,143.51965507777314,140.99494105000022,143.8139059,144.4206246,146.51562449999997,144.92187333333334,7396602,5371595.25,49.43157317021923,NaN,1.5,2.75,NaN,NaN,2.351435467682421,1.3769842394584737,NaN,-0.36169705651779493,0.2139357622313014,0.5756328187490963,17.54294031964077,-2.146916438644496,NaN,NaN,NaN,-65589137
962631000,145.4375,147.4375,145.1875,147.28125,NaN,NaN,144.0768696,148.0386652542373,141.06259730000022,143.8739059,144.4899996,146.52343699999997,145.0820875343849,145.80579988271074,146.36177846153836,149.17555618315075,143.54800073992598,141.06259730000022,143.8739059,144.4899996,146.52343699999997,146.63541666666666,1431900,5093285.15,54.719878608140796,NaN,1.5,2.75,NaN,NaN,2.344190077133677,0.28113485851071973,NaN,-0.2020745795111314,0.32303959436018204,0.5251141738713134,17.822118173847418,-0.4435994930291508,NaN,NaN,NaN,-64157237
962803800,146.375,146.65625,144.375,144.625,NaN,NaN,144.3574944,147.926906779661,141.1179098000002,143.9045309,144.53749960000002,146.43124949999998,145.06416253303647,145.693342751024,146.09014384615375,148.83960158587408,143.34068610643342,141.1179098000002,143.9045309,144.53749960000002,146.43124949999998,145.21875,2714800,4986080.25,47.60007007098677,NaN,1.5,2.75,NaN,NaN,2.3843372144812713,0.5444757933849942,NaN,-0.2657362551576151,0.19294385492429456,0.4586801100819097,20.43217862612339,-2.17712957091524,NaN,NaN,NaN,-66872037
962890200,144.9375,146.46875,144.21875,145.75,NaN,NaN,144.6381192,147.81514830508473,141.19290980000022,143.9751559,144.48937460000002,146.34453099999996,145.09105811997622,145.69873867949792,146.0252399999999,148.76389486975683,143.286585130243,141.19290980000022,143.9751559,144.48937460000002,146.34453099999996,145.47916666666666,5382898,5009250.15,50.53558520342799,NaN,1.5,2.75,NaN,NaN,2.3747416991611803,1.0745915733515523,NaN,-0.22409465373194354,0.17856179291698027,0.4026564466489238,21.225812518878453,0.08583690987124463,NaN,NaN,NaN,-61489139
962976600,146.6875,148.78125,146.25,148.09375,NaN,NaN,144.918744,147.70338983050848,141.28037075000023,144.0610934,144.5215622,146.40390599999995,145.20881074272225,145.92683499573621,145.99639384615375,148.6376595277886,143.3551281645189,141.28037075000023,144.0610934,144.5215622,146.40390599999995,147.70833333333334,3021300,4874160.05,56.05854064691287,NaN,1.5,2.75,NaN,NaN,2.421635149221096,0.6198606465538611,NaN,-0.04034538503382612,0.3522247153566411,0.39257010039046725,21.37936036969441,2.5757575757575757,NaN,NaN,NaN,-58467839
963235800,147.875,148.90625,147.53125,147.84375,NaN,NaN,145.1993688,147.5916313559322,141.38021450000022,144.1285934,144.55843720000001,146.46640599999995,145.31214169398805,146.10939832947562,145.9891823076922,148.6096391017015,143.3687255136829,141.38021450000022,144.1285934,144.55843720000001,146.46640599999995,148.09375,2814500,4860620.05,55.34863765454436,NaN,1.5,2.75,NaN,NaN,2.3468754957053037,0.5790413509074835,NaN,0.057406665897694165,0.46432843276258495,0.4069217668648908,20.511797569459542,1.1005483868122024,NaN,NaN,NaN,-61282339
963322200,147.46875,149.125,147.15625,148.15625,NaN,NaN,145.47999360000003,147.47987288135593,141.48224575000023,144.2182809,144.61968720000002,146.63046849999995,145.42367535304734,146.30433658381128,146.01322076923068,148.70602193693242,143.32041960152895,141.48224575000023,144.2182809,144.61968720000002,146.63046849999995,148.14583333333334,5420699,4959815,56.09705792256388,NaN,1.5,2.75,NaN,NaN,2.319866531726354,1.09292362719174,NaN,0.1318995972322849,0.5717962634052469,0.439896666172962,19.415036634061217,2.0667384284176533,NaN,NaN,NaN,-55861640
963408600,149.28125,150.125,148.6875,149.125,NaN,NaN,145.76061840000003,147.36811440677965,141.58490200000023,144.3267184,144.6609372,146.70703099999997,145.56882533920236,146.57297119487686,146.28245153846143,149.42797220426,143.13693087266287,141.58490200000023,144.3267184,144.6609372,146.70703099999997,149.3125,5800699,4922274.95,58.423565370157824,NaN,1.5,2.75,NaN,NaN,2.294786779460186,1.1784589562596457,NaN,0.2294888364709956,0.7267577117617066,0.49726887529071095,18.765022104738385,2.4474023185916702,NaN,NaN,NaN,-50060941
963495000,149.98437,150.375,149.1875,149.78125,NaN,NaN,146.04124320000003,147.25635593220338,141.6920895000002,144.4714059,144.7740622,146.80390599999996,145.73401846315522,146.87852155726955,146.69831692307682,150.14065168125182,143.2559821649018,141.6920895000002,144.4714059,144.7740622,146.80390599999996,149.78125,5354102,4869624.95,59.971053296232256,NaN,1.5,2.75,NaN,NaN,2.2201591523558872,1.099489602376873,NaN,0.3159725334525235,0.8922345421063653,0.5762620086538418,18.79033049802339,3.87949718248808,NaN,NaN,NaN,-44706839
963581400,150.4375,151.25,149.67187,151.25,NaN,NaN,146.32186800000002,147.14459745762713,141.81427700000023,144.6342184,144.9665622,146.95859349999995,145.9503314646001,147.2948528375296,147.0841346153845,151.27492584606267,142.89334338470633,141.81427700000023,144.6342184,144.9665622,146.95859349999995,150.72395666666668,5335199,4847574.95,63.26643934903567,NaN,1.5,2.75,NaN,NaN,2.174299927187609,1.100591337943109,NaN,0.44209355992749133,1.128878958563206,0.6867853986357146,17.35749161288583,4.108410410841041,NaN,NaN,NaN,-39371640
963840600,150.98437,151.98437,150.6875,151,NaN,NaN,146.60249280000002,151.98437,141.92552700000022,144.7785934,145.1503122,147.17890599999996,146.1483576816746,147.6477239958601,147.53365384615375,152.04242344865864,143.02488424364887,141.92552700000022,144.7785934,145.1503122,147.17890599999996,151.22395666666668,3933000,4767915,62.32589885210732,NaN,1.5,2.75,NaN,NaN,2.1116263609599235,0.8248888665171255,NaN,0.4757527936773205,1.2814763907323652,0.8057235970550447,17.620865413017775,2.5249310417992787,NaN,NaN,NaN,-43304640
963927000,150.625,150.625,149.34375,149.76562,NaN,NaN,146.88311760000002,152.13321842105265,142.0320113500002,144.9381246,145.2749996,147.24374949999998,146.29021110592268,147.84942837720675,147.85697076923068,152.35676722338007,143.3571743150813,142.0320113500002,144.9381246,145.2749996,147.24374949999998,149.91145666666668,4245602,4725670.1,57.760014067681475,NaN,1.5,2.75,NaN,NaN,2.0790994780342147,0.8984126928369376,NaN,0.38578912561672873,1.2879600040759556,0.9021708784592268,17.636580441246632,3.5544477095937856,NaN,NaN,NaN,-47550242
964013400,149.46875,149.90625,148.25,148.6875,NaN,NaN,147.16374240000002,152.28206684210528,142.1216988500002,145.09171840000002,145.39968720000002,147.28124949999997,146.38422243510217,147.92924472223467,148.20312461538452,152.18282762663702,144.22342160413203,142.1216988500002,145.09171840000002,145.39968720000002,147.28124949999997,148.94791666666666,8294199,4857265,54.03655197669693,NaN,1.5,2.75,NaN,NaN,2.0488959438889136,1.707586265110098,NaN,0.23214991850634603,1.1923582765921594,0.9602083580858134,13.834816039062707,2.0154373927958833,NaN,NaN,NaN,-55844441
964099800,149,150.625,148.8125,150.625,NaN,NaN,147.44436720000002,152.4309152631579,142.22169885000022,145.2367184,145.58593720000002,147.42031199999997,146.5505274376472,148.1859833201171,148.6141823076922,152.4010079218867,144.8273566934977,142.22169885000022,145.2367184,145.58593720000002,147.42031199999997,150.02083333333334,4283000,4915780,59.134921148426166,NaN,1.5,2.75,NaN,NaN,2.0409390907539913,0.8712757690539447,NaN,0.23857484497164716,1.2584269143003723,1.0198520693287252,14.804314658944142,1.7092213547161847,NaN,NaN,NaN,-51561441
964186200,149.75,149.75,147.6875,147.6875,NaN,NaN,147.72499200000001,152.57976368421055,142.29701135000022,145.33921840000002,145.77718720000001,147.52343699999997,146.59511459695514,148.13850871820117,148.6454323076922,152.39425747771554,144.89660713766887,142.29701135000022,145.33921840000002,145.77718720000001,147.52343699999997,148.375,5370398,4809974.9,50.06729414338772,NaN,1.5,2.75,NaN,NaN,2.1049791557001347,1.1165126869996764,NaN,0.03333319270108959,1.0615185602050872,1.0281853675039976,17.52399764698566,-0.1056859015007398,NaN,NaN,NaN,-56931839
964445400,148.125,148.85937,146.5625,146.84375,NaN,NaN,148.0056168,152.72861210526318,142.3718551000002,145.4232809,145.8884372,147.64687449999997,146.60486500491768,148.01519836408676,148.8161053846153,151.9724418838224,145.6597688854082,142.3718551000002,145.4232809,145.8884372,147.64687449999997,147.42187333333334,5625301,4867745.05,47.80004859818916,NaN,1.5,2.75,NaN,NaN,2.1186856445786977,1.1556276966477528,NaN,-0.16027560337079483,0.8278408632905041,0.9881164666612989,17.793945351413353,-0.8858890529424173,NaN,NaN,NaN,-62557140
964531800,147.75,147.84375,146.78125,147.3125,NaN,NaN,148.2862416,152.87746052631582,142.43904260000022,145.51109340000002,145.9784372,147.70078099999995,146.6326153968817,147.94827471036422,148.9362976923076,151.71257199459887,146.1600233900163,142.43904260000022,145.51109340000002,145.9784372,147.70078099999995,147.3125,4488801,4832445.05,49.17699475016541,NaN,1.5,2.75,NaN,NaN,2.0432438128230763,0.928888161904707,NaN,-0.25231787324860533,0.6727191251005422,0.9250369983491475,17.866038784183015,-1.2154233025984913,NaN,NaN,NaN,-58068339
964618200,146.96875,147.15625,145.64062,145.875,NaN,NaN,148.5668664,153.02630894736845,142.50013635000022,145.5585934,145.9903122,147.73671849999997,146.60290498916086,147.75081997604383,148.76562461538452,151.96817157355918,145.56307765720987,142.50013635000022,145.5585934,145.9903122,147.73671849999997,146.22395666666668,11773301,5217280.1,45.23619654768036,NaN,1.5,2.75,NaN,NaN,2.016717826192856,2.2565974558276065,NaN,-0.3969525424795547,0.42884632024970415,0.8257988627292588,17.951550632287933,-2.6079699561861047,NaN,NaN,NaN,-69841640
964704600,145.9375,146.625,144.6875,145.375,NaN,NaN,148.84749120000004,153.17515736842108,142.56904260000022,145.6142184,145.9665622,147.72734349999996,146.55475185233104,147.5245514068968,148.57572076923068,152.23466787160933,144.91677366685204,142.56904260000022,145.6142184,145.9665622,147.72734349999996,145.5625,7640000,5333275,43.91790737818201,NaN,1.5,2.75,NaN,NaN,2.011059410036223,1.4325156681401203,NaN,-0.5062353254137985,0.1930047059620108,0.6992400313758093,17.45574008602879,-3.884297520661157,NaN,NaN,NaN,-77481640
964791000,145.71875,145.90625,141.51562,142.09375,NaN,NaN,141.51562,153.32400578947372,142.6385738500002,145.6646872,145.9053122,147.62265599999995,146.37981060322002,147.00733222528757,148.10937461538452,153.14840446516686,143.0703447656022,142.6385738500002,145.6646872,145.9053122,147.62265599999995,143.17187333333334,6217102,5327170.15,36.41744446272771,NaN,1.5,2.75,NaN,NaN,2.181028737890778,1.1670552704234536,NaN,-0.7639705116198464,-0.2557231081489988,0.5082474034708476,18.718613831095027,-5.89817880794702,NaN,NaN,NaN,-83698742
965050200,142.9375,144.125,142.0625,142.90625,NaN,NaN,141.41562000000002,153.47285421052632,142.71232385000022,145.7249997,145.8871872,147.50390599999997,146.24359254034866,146.61675296573637,147.63100923076914,153.33093087782927,141.931087583709,142.71232385000022,145.7249997,145.8871872,147.50390599999997,143.03125,5235000,5219090.05,39.187009221708244,NaN,1.5,2.75,NaN,NaN,2.172562399470008,1.0030484145411518,NaN,-0.8382470792626697,-0.5395614456074895,0.2986856336551802,19.81949195974953,-4.58006984513536,NaN,NaN,NaN,-78463742
965136600,143.625,144.71875,143.125,143.875,NaN,NaN,141.31562000000002,153.62170263157896,142.80732385000022,145.7549997,145.9421872,147.33359349999995,146.1507065583742,146.35563363566624,147.1766823076922,153.0572971010381,141.2960675143463,142.80732385000022,145.7549997,145.9421872,147.33359349999995,143.90625,3939600,5344475.05,42.408135235129755,NaN,1.5,2.75,NaN,NaN,2.1468436566507214,0.7371350718533152,NaN,-0.7817595939369862,-0.6785138587660526,0.1032457351709336,20.901862283803325,-3.2366540563261874,NaN,NaN,NaN,-74524142
965223000,143.875,145.40625,143.625,144.59375,NaN,NaN,141.21562,153.7705510526316,142.90138635000022,145.7990622,146.0328122,147.33203099999997,146.08964943843796,146.18783519417423,146.66466307692298,152.18558253515596,141.14374361869,142.90138635000022,145.7990622,146.0328122,147.33203099999997,144.54166666666666,7432898,5580379.95,44.74655017582096,NaN,1.5,2.75,NaN,NaN,2.120729824032813,1.3319698777858306,NaN,-0.6604455285593789,-0.72231117552829,-0.06186564696891114,21.382707619656,-4.004149377593361,NaN,NaN,NaN,-67091244
965309400,142.875,145.8125,142.625,145.59375,NaN,NaN,141.11562,153.91939947368422,142.9943551000002,145.8690622,146.1846872,147.32421849999997,146.07020240163646,146.13125565187192,146.2487976923076,151.1842340538152,141.31336133079998,142.9943551000002,145.8690622,146.1846872,147.32421849999997,144.67708333333334,4544801,5538475.1,47.91522762167359,NaN,1.5,2.75,NaN,NaN,2.196927693744755,0.8205870601458514,NaN,-0.48540489557113936,-0.6686217664328353,-0.18321687086169597,19.992561554269127,-1.417689377909437,NaN,NaN,NaN,-62546443
965395800,146.3125,146.71875,145.40625,146.375,NaN,NaN,141.01562,154.06824789473686,143.08498010000022,145.9665622,146.30718720000002,147.23828099999997,146.08215524863112,146.1544693993127,145.98798076923066,150.4919546063585,141.48400693210283,143.08498010000022,145.9665622,146.30718720000002,147.23828099999997,146.16666666666666,3679600,5571390.1,50.31262170730785,NaN,1.5,2.75,NaN,NaN,2.1337542870487014,0.6604455861024703,NaN,-0.29871918809912146,-0.5566158559855978,-0.25789666788647636,17.5441548574726,-0.3192168546499255,NaN,NaN,NaN,-58866843
965655000,146.71875,148.4375,146.375,148.125,NaN,NaN,140.91562000000002,154.2170963157895,143.1806051000002,146.0496872,146.5128122,147.25234349999997,146.16226680750833,146.34213898033053,145.94471153846143,150.35392895484378,141.5354941220791,143.1806051000002,146.0496872,146.5128122,147.25234349999997,147.64583333333334,4134500,5637390.1,55.27831116467261,NaN,1.5,2.75,NaN,NaN,2.1286646951166515,0.7334067585636836,NaN,-0.05201674353471131,-0.32291759730486547,-0.27090085377015416,18.642001607821808,0.5515485787017395,NaN,NaN,NaN,-54732343
965741400,147.5,148.8125,147.5,148.6875,NaN,NaN,140.81562000000002,154.36594473684212,143.27357385000022,146.0731247,146.72656220000002,147.27890599999995,146.26129556015508,146.56550669648954,145.79567307692298,149.65922746568077,141.9321186881652,143.27357385000022,146.0731247,146.72656220000002,147.27890599999995,148.33333333333334,3591700,5545940.15,56.77368856774679,NaN,1.5,2.75,NaN,NaN,2.0703672168940335,0.6476268951441894,NaN,0.14370556021818565,-0.09126890349742212,-0.23497446371560776,18.672562261038394,1.9280205655526992,NaN,NaN,NaN,-51140643
965827800,149.14062,149.21875,147.375,147.4375,NaN,NaN,140.71562,154.51479315789476,143.36357385000022,146.07812470000002,146.8209372,147.19453099999996,146.30742122446273,146.64855367777625,145.7764423076922,149.60446447302886,141.94842014235556,143.36357385000022,146.07812470000002,146.8209372,147.19453099999996,148.01041666666666,5350898,5523450.1,52.56720072075344,NaN,1.5,2.75,NaN,NaN,2.054180272830174,0.9687600871057024,NaN,0.18121736307149824,-0.00845275987623495,-0.1896701229477332,18.40078572647084,1.418744625967326,NaN,NaN,NaN,-56491541
965914200,147.53125,147.85937,146.28125,146.71875,NaN,NaN,140.61562,154.6636415789474,143.4581051000002,146.0774997,146.8990622,147.04140599999997,146.32355176467988,146.65523904179756,145.76682692307682,149.5846916373407,141.94896220881293,143.4581051000002,146.0774997,146.8990622,147.04140599999997,146.95312333333334,4188398,5465164.9,50.26120776724161,NaN,1.5,2.75,NaN,NaN,2.0201759676280195,0.7663809009678738,NaN,0.15108956119301087,-0.0008081714564696085,-0.15189773264948048,18.548747656870216,3.2548933362656696,NaN,NaN,NaN,-60679939
966000600,146.625,148,145.5625,147.32812,NaN,NaN,140.51562,154.81249000000003,143.5441207000002,146.0589059,146.9393746,146.84531199999998,146.36294659743754,146.71932294257874,145.76802846153836,149.5878475356509,141.94820938742583,143.5441207000002,146.0589059,146.9393746,146.84531199999998,146.96354,5080898,5452449.85,52.17665829674033,NaN,1.5,2.75,NaN,NaN,2.049984827083161,0.9318559802984708,NaN,0.16455906662109204,0.05380110062688459,-0.11075796599420745,10.743224327406372,3.09424535315986,NaN,NaN,NaN,-55599041
966259800,147.78125,149.5625,147.0625,149.28125,NaN,NaN,140.41562000000002,154.96133842105266,143.6177144500002,146.0507809,146.9681246,146.75937449999998,146.47738986812627,146.96331599566648,146.0300476923076,150.28570771993924,141.77438766467594,143.6177144500002,146.0507809,146.9681246,146.75937449999998,148.63541666666666,2917200,5401659.85,57.787768293413095,NaN,1.5,2.75,NaN,NaN,2.0821287680057923,0.5400562199413576,NaN,0.2900289864488149,0.25177826706681117,-0.03825071938200372,12.045792034673925,3.7576020851433536,NaN,NaN,NaN,-52681841
966346200,149.34375,149.8125,148.5625,149.15625,NaN,NaN,140.31562000000002,155.1101868421053,143.6784957000002,146.01734340000002,147.00874960000002,146.72890599999997,146.58244320663113,147.17216685322205,146.32091307692298,150.8648458375936,141.77698031625235,143.6784957000002,146.01734340000002,147.00874960000002,146.72890599999997,149.17708333333334,5547602,5466759.85,57.324203507943736,NaN,1.5,2.75,NaN,NaN,2.0226909988625215,1.01478794609937,NaN,0.34583881925070536,0.394047804681378,0.04820898543067263,12.279483380692742,3.1553922628052735,NaN,NaN,NaN,-58229443
966432600,149.3125,149.9375,147.84375,148.625,NaN,NaN,140.21562,155.25903526315793,143.74380820000022,145.96796840000002,147.05187460000002,146.72578099999996,146.66254347303774,147.31053191481996,146.82331692307682,150.79484597501985,142.85178787113378,143.74380820000022,145.96796840000002,147.05187460000002,146.72578099999996,148.80208333333334,5136898,5308894.8,55.29406059082173,NaN,1.5,2.75,NaN,NaN,2.027766641800913,0.9676021457422739,NaN,0.32834725283708244,0.45864305147702567,0.13029579863994323,12.89198748396426,2.0819918437432925,NaN,NaN,NaN,-63366341
966519000,148.6875,150.4375,148.34375,150.1875,NaN,NaN,140.11562,155.40788368421056,143.8217769500002,145.9504684,147.1059372,146.70390599999996,146.80077706233038,147.5845288753133,147.38341307692298,151.02752335807293,143.73930279577303,143.8217769500002,145.9504684,147.1059372,146.70390599999996,149.65625,5612801,5375384.85,59.803126883886236,NaN,1.5,2.75,NaN,NaN,2.0324797388151334,1.0441672841340839,NaN,0.39869859010533915,0.6286690362716172,0.22997044616627804,13.459717579196969,2.604611443210931,NaN,NaN,NaN,-57753540
966605400,150.375,150.375,149.21875,149.6875,NaN,NaN,140.01562,155.5567321052632,143.8927144500002,145.93671840000002,147.16156220000002,146.80390599999996,146.91398188341546,147.7848118395692,147.83052846153836,151.0439378762642,144.61711904681252,143.8927144500002,145.93671840000002,147.16156220000002,146.80390599999996,149.76041666666666,4620801,5337905,57.79430646803803,NaN,1.5,2.75,NaN,NaN,1.9698919003283382,0.8656581561492758,NaN,0.3878875778926377,0.7148299185320752,0.3269423406394375,13.84605988192082,1.0548523206751055,NaN,NaN,NaN,-62374341
966864600,150.03125,150.71875,149.40625,150.5625,NaN,NaN,139.91562000000002,155.70558052631583,143.9628707000002,145.93015590000002,147.24093720000002,146.98984349999995,147.0570610252423,148.049353569134,148.28966307692298,151.2146732233304,145.36465293051555,143.9628707000002,145.93015590000002,147.24093720000002,146.98984349999995,150.22916666666666,2359900,5174634.95,60.307078113817276,NaN,1.5,2.75,NaN,NaN,1.922935336019171,0.45605149402857875,NaN,0.41363752202351795,0.843989243168835,0.430351721145317,12.693021477195668,1.2610340479192939,NaN,NaN,NaN,-60014441
966951000,150.5625,151.3125,150.09375,150.3125,NaN,NaN,139.81562000000002,155.85442894736846,144.02505820000022,145.9464059,147.3496872,147.13984349999996,147.1847252987622,148.2648913244546,148.65264384615375,151.3080928479152,145.9971948443923,144.02505820000022,145.9464059,147.3496872,147.13984349999996,150.57291666666666,3017900,5101089.9,59.2221945798825,NaN,1.5,2.75,NaN,NaN,1.872636383446373,0.5916186656502563,NaN,0.388215675288186,0.9156213152555495,0.5274056399673634,12.739241430531875,1.9499788045782112,NaN,NaN,NaN,-63032341
967037400,149.8125,151.28125,149.28125,150.84375,NaN,NaN,139.71562,156.0032773684211,144.0892769500002,145.95109340000002,147.4146872,147.38828099999995,147.32821646351664,148.51049691260178,148.99639384615375,151.53800039006492,146.45478730224258,144.0892769500002,145.95109340000002,147.4146872,147.38828099999995,150.46875,5477500,4786299.85,60.83455280629387,NaN,1.5,2.75,NaN,NaN,1.881733784628775,1.1444122122854465,NaN,0.3810257244193217,1.0036877954915155,0.6226620710721938,11.228876671660522,2.8115015974440896,NaN,NaN,NaN,-57554841
967123800,151.15625,151.54687,150.5,151.3125,NaN,NaN,139.61562,156.15212578947373,144.1623238500002,145.9517184,147.4840622,147.68515599999995,147.48446287671206,148.77735434949685,149.24158615384607,152.0049565835429,146.47821572414924,144.1623238500002,145.9517184,147.4840622,147.68515599999995,151.11979,4522398,4630419.75,62.252792191058596,NaN,1.5,2.75,NaN,NaN,1.822100657155292,0.9766712834187441,NaN,0.3807830430862663,1.0986408749300267,0.7178578318437604,10.258338644708463,2.704426011816337,NaN,NaN,NaN,-53032443
967210200,151.15625,151.625,150.9375,151.25,NaN,NaN,139.51562,156.30097421052633,144.2299801000002,146.0067184,147.5459372,148.14296849999997,147.63213099919395,149.01284441144952,149.43870153846143,152.37595870834068,146.50144436858218,144.2299801000002,146.0067184,147.5459372,148.14296849999997,151.27083333333334,2820400,4460584.65,61.93077696996433,NaN,1.5,2.75,NaN,NaN,1.7410577530727713,0.6322937958368304,NaN,0.3501364819809838,1.15552843431999,0.8053919523390063,10.417538862155784,1.3188193426836927,NaN,NaN,NaN,-55852843
967469400,151.25,152.90625,151.25,151.76562,NaN,NaN,139.41562000000002,156.44982263157897,144.2963082000002,146.03249960000002,147.64937460000002,148.58593699999997,147.7942286070687,149.275013515121,149.77163384615375,152.70725486110118,146.83601283120632,144.2963082000002,146.03249960000002,147.64937460000002,148.58593699999997,151.97395666666668,5497398,4473704.55,63.60345423612063,NaN,1.5,2.75,NaN,NaN,1.7350000564247163,1.2288245543617762,NaN,0.3381361373681683,1.2280621240492167,0.8899259866810484,8.043257974566515,1.749420490257708,NaN,NaN,NaN,-50355445
967555800,151.4375,151.875,150.90625,151.79687,NaN,NaN,139.31562000000002,156.5986710526316,144.3565425500002,146.0456246,147.71593700000003,148.98203049999998,147.95119493620325,149.5151903232047,150.16225846153839,152.69244075627904,147.63207616679773,144.3565425500002,146.0456246,147.71593700000003,148.98203049999998,151.52604,3528200,4453134.55,63.70753239223443,NaN,1.5,2.75,NaN,NaN,1.6802679095372366,0.7922958447325604,NaN,0.306769915431506,1.273388380970431,0.9666184655389249,7.947086840083462,2.1341429772918503,NaN,NaN,NaN,-46827245
967642200,151.3125,151.5,150.34375,150.34375,NaN,NaN,139.21562,156.74751947368424,144.40787070000022,146.0346871,147.76406200000002,149.26953049999997,148.0450206249796,149.59410076861377,150.3942299999999,152.3243141730435,148.46414582695633,144.40787070000022,146.0346871,147.76406200000002,149.26953049999997,150.72916666666666,3948600,4278919.65,55.727492460007774,NaN,1.5,2.75,NaN,NaN,1.6640430588560062,0.9228030257590838,NaN,0.16948158962028703,1.1784704525642837,1.0089888629439967,9.934563237786245,0.10403662089055347,NaN,NaN,NaN,-50775845
967728600,151.0625,153.09375,150.90625,152.34375,NaN,NaN,139.11562,156.89636789473687,144.4633394500002,146.0496871,147.854062,149.60703049999998,148.21359824752943,149.8559721239839,150.62980692307684,152.7014046265941,148.5582092195596,144.4633394500002,146.0496871,147.854062,149.60703049999998,152.11458333333334,4820801,4292719.65,62.660154055768636,NaN,1.5,2.75,NaN,NaN,1.7416114117948631,1.1230178984551202,NaN,0.1929839905066253,1.2502188510772783,1.057234860570653,10.951093358687604,1.7745302713987474,NaN,NaN,NaN,-45955044
967815000,153.25,153.59375,152,152.375,NaN,NaN,139.01562,153.59375,144.5174019500002,146.0693746,147.98906200000002,149.90703049999996,148.3767904731165,150.09587954074732,150.877403076923,152.95473932590912,148.8000668279369,144.5174019500002,146.0693746,147.98906200000002,149.90703049999996,152.65625,3152900,4266384.65,62.75828371203271,NaN,1.5,2.75,NaN,NaN,1.7310498823809444,0.739009784314689,NaN,0.18995399397055568,1.2946773530338476,1.1047233590632919,10.570804176965336,1.2038190120381902,NaN,NaN,NaN,-42802144
968160600,151.875,152.20312,150.8125,151.28125,NaN,NaN,138.91562000000002,153.64108470588235,144.5606832000002,146.11937460000001,148.12718700000002,150.06484299999997,148.4906908467198,150.20877196543805,151.0817299999999,152.70576471673925,149.45769528326056,144.5606832000002,146.11937460000001,148.12718700000002,150.06484299999997,151.43229,3450400,4232179.65,57.10199267450769,NaN,1.5,2.75,NaN,NaN,1.7190106050680198,0.8152773004331231,NaN,0.09822502680248779,1.2275046425664016,1.1292796157639138,11.358456722516658,0.6444906444906445,NaN,NaN,NaN,-46252544
968247000,151.1875,151.78125,149.53125,149.78125,NaN,NaN,138.81562000000002,153.6884194117647,144.5971090000002,146.1746871,148.1981246,150.11953049999997,148.54130100959352,150.16805558777727,151.0504799999999,152.75574281293615,149.34521718706367,144.5971090000002,146.1746871,148.1981246,150.11953049999997,150.36458333333334,4164102,4260799.75,50.39393432890567,NaN,1.5,2.75,NaN,NaN,1.7569384189917325,0.9773052582440656,NaN,-0.07043995337011832,1.0412296740512659,1.1116696274213842,12.830442443319184,-0.7043712450797597,NaN,NaN,NaN,-50416646
968333400,150.25,151.07812,149.82812,150.84375,NaN,NaN,138.71562,153.73575411764705,144.6389840000002,146.29937460000002,148.3118746,150.28984299999996,148.63159312686437,150.23240743656038,151.13942230769223,152.6618623904394,149.61698222494505,144.6389840000002,146.29937460000002,148.3118746,150.28984299999996,150.58333000000002,4078800,4197194.85,54.47365747096848,NaN,1.5,2.75,NaN,NaN,1.7240763890637525,0.9717919100181875,NaN,-0.1147919285943595,0.9681797166784349,1.0829716452727944,13.370564364375895,-0.3097893432465923,NaN,NaN,NaN,-46337846
968419800,150.28125,150.5,149.32812,149.8125,NaN,NaN,138.61562,153.7830888235294,144.6819527500002,146.3899996,148.39687460000002,150.44453049999998,148.67790320032069,150.19241625212607,151.0817299999999,152.73818976512757,149.42527023487224,144.6819527500002,146.3899996,148.39687460000002,150.44453049999998,149.88020666666668,3476100,4161579.95,50.1615775580329,NaN,1.5,2.75,NaN,NaN,1.7091873612734836,0.835283724394145,NaN,-0.21225851642363014,0.8176484997432567,1.0299070161668868,13.740896762686797,-0.9504132231404959,NaN,NaN,NaN,-49813946
968679000,149.75,151.1875,148.6875,149.59375,NaN,NaN,138.51562,153.83042352941177,144.7196090000002,146.44124960000002,148.50499960000002,150.55781199999996,148.71381876109243,150.13540041859025,151.02644153846146,152.82389038910063,149.22899268782228,144.7196090000002,146.44124960000002,148.50499960000002,150.55781199999996,149.82291666666666,3933800,4104225.05,49.27061987999553,NaN,1.5,2.75,NaN,NaN,1.7656739783253776,0.9584757054197114,NaN,-0.2855713228965092,0.6729428625462504,0.9585141854427596,13.737792348175711,-1.4310685120912183,NaN,NaN,NaN,-53747746
968765400,149.75,150.25,148.4375,148.46875,NaN,NaN,138.41562000000002,153.87775823529412,144.7550777500002,146.49468710000002,148.56874960000002,150.51718699999998,148.70420822144175,149.97667180729593,150.84374923076913,153.1020459532195,148.58545250831878,144.7550777500002,146.49468710000002,148.56874960000002,150.51718699999998,149.05208333333334,4742500,4195490.05,44.857829585823396,NaN,1.5,2.75,NaN,NaN,1.7690186941592791,1.1303804665202342,NaN,-0.3970857117174721,0.46215704579591943,0.8592427575133915,13.860644309810228,-2.192482624971129,NaN,NaN,NaN,-58490246
968851800,148,149.34375,147.65625,148.89062,NaN,NaN,138.31562000000002,153.92509294117647,144.79484335000018,146.5454683,148.60093700000002,150.50390549999997,148.71151848726757,149.87323830183917,150.6574507692307,153.12062459875014,148.19427693971127,144.79484335000018,146.5454683,148.60093700000002,150.50390549999997,148.63020666666668,4555102,4145865.05,46.78264613157396,NaN,1.5,2.75,NaN,NaN,1.7631959302907592,1.0987096649467643,NaN,-0.4270756754469679,0.3253981632046816,0.7524738386516495,14.106984559831547,-0.9665383496154561,NaN,NaN,NaN,-53935144
968938200,149.875,149.9375,148.15625,148.46875,NaN,NaN,138.21562,153.97242764705882,144.8402340000002,146.6076558,148.67781200000002,150.49609299999997,148.70199815443354,149.73947751118783,150.44350846153839,153.13610524617278,147.750911676904,144.8402340000002,146.6076558,148.67781200000002,150.49609299999997,148.85416666666666,3391400,4058590.15,45.08772876598387,NaN,1.5,2.75,NaN,NaN,1.764485506698562,0.8356103658311003,NaN,-0.45726770928157223,0.18088920204968417,0.6381569113312564,13.268984936821706,-2.5435897435897434,NaN,NaN,NaN,-57326544
969024600,148.1875,148.25,146.03125,146.09375,NaN,NaN,138.11562,154.01976235294117,144.8686715000002,146.5870308,148.68468700000003,150.29140549999997,148.5997139130832,149.39226536726517,150.00721076923068,153.43831499411127,146.5761065443501,144.8686715000002,146.5870308,148.68468700000003,150.29140549999997,146.79166666666666,4075700,3981735.1,36.967726608455806,NaN,1.5,2.75,NaN,NaN,1.8125579705058077,1.02359898326737,NaN,-0.6096056685667394,-0.12385017437716783,0.48575549418957154,12.203933920008705,-4.122231337161608,NaN,NaN,NaN,-61402244
969283800,146.375,146.96875,144.20312,144.65625,NaN,NaN,138.01562,154.06709705882352,144.8857027500002,146.56874960000002,148.615937,150.03984299999996,148.44506826943288,148.94121628466849,149.4579323076922,153.74631589702338,145.16954871836103,144.8857027500002,146.56874960000002,148.615937,150.03984299999996,145.27604,5104301,4005910.1,33.084031450760406,NaN,1.5,2.75,NaN,NaN,1.8806345440411063,1.2741925985807818,NaN,-0.7692980455539635,-0.47586706275288293,0.2934309828010806,12.248479844726361,-4.379260483371204,NaN,NaN,NaN,-66506545
969370200,145.125,146.3125,144.70312,145.96875,NaN,NaN,137.91562000000002,154.11443176470587,144.8963277500002,146.5684371,148.578437,149.81015549999998,148.34795774906297,148.6581242575572,149.12139384615375,153.7519154749583,144.4908722173492,144.8963277500002,146.5684371,148.578437,149.81015549999998,145.66145666666668,6547801,4215305.15,39.34923015822784,NaN,1.5,2.75,NaN,NaN,1.8646070766095986,1.553339738642646,NaN,-0.7479767294398671,-0.6415399289987533,0.10643680044111381,14.589484963149662,-2.5453786772376383,NaN,NaN,NaN,-59958744
969456600,145.6875,146.03125,143.15625,144.89062,NaN,NaN,137.81562000000002,154.16176647058822,144.90687460000018,146.5664058,148.5131244,149.53906149999997,148.2123758765507,148.29931432826604,148.54807615384607,153.28511453943005,143.81103776826208,144.90687460000018,146.5664058,148.5131244,149.53906149999997,144.69270666666668,6498500,4389335.15,36.3394169839135,NaN,1.5,2.75,NaN,NaN,1.936777999708913,1.480520347141867,NaN,-0.7651768673162657,-0.8500342837042183,-0.08485741638795263,14.250971051871735,-3.9465539672674455,NaN,NaN,NaN,-66457244
969543000,144.46875,145.5625,143.75,145.1875,NaN,NaN,137.71562,154.2091011764706,144.9246871000002,146.5476558,148.43437440000002,149.25624899999997,148.09375329315657,148.00295105890737,147.99519153846146,152.48801483977323,143.50236823714968,144.9246871000002,146.5476558,148.43437440000002,149.25624899999997,144.83333333333334,5346602,4382790.25,37.75139334963101,NaN,1.5,2.75,NaN,NaN,1.9279009997297047,1.219908253651883,NaN,-0.7161259278340896,-0.9800148261805646,-0.263888898346475,13.164043374656925,-3.0871923237380057,NaN,NaN,NaN,-61110642
969629400,142.625,145.3125,142.42187,145.28125,NaN,NaN,137.61562,154.25643588235295,144.94749960000019,146.5592183,148.34437440000002,148.95468649999998,147.9834590463661,147.74374143424953,147.533653076923,151.80883428394475,143.25847186990126,144.94749960000019,146.5592183,148.34437440000002,148.95468649999998,144.33854,7587398,4536040.25,38.21740628387343,NaN,1.5,2.75,NaN,NaN,1.9966673568918678,1.672691947563737,NaN,-0.639452514065048,-1.063204540927785,-0.42375202686273705,13.234469482959131,-2.882807603927303,NaN,NaN,NaN,-53523244
969888600,145.9375,146.0625,143.71875,144.15625,NaN,NaN,137.51562,154.3037705882353,144.9612496000002,146.5845308,148.20249940000002,148.59999899999997,147.83337241709685,147.40207558336863,147.10096076923068,151.5149971927496,142.68692434571176,144.9612496000002,146.5845308,148.20249940000002,148.59999899999997,144.64583333333334,9715398,4880790.15,34.84616912300058,NaN,1.5,2.75,NaN,NaN,2.0214589742567344,1.9905379459922077,NaN,-0.6258055517461054,-1.2060089665453688,-0.5802034147992634,13.446997948040572,-2.9046516522837296,NaN,NaN,NaN,-63238642
969975000,144.375,145,142.40625,142.40625,NaN,NaN,137.41562000000002,154.35110529411764,144.9639058500002,146.5904683,148.03062440000002,148.13203049999998,147.62054408701462,146.92628267066686,146.45192230769223,150.95414938029225,141.9496952350922,144.9639058500002,146.5904683,148.03062440000002,148.13203049999998,143.27083333333334,5281199,4869980.2,30.35978011759302,NaN,1.5,2.75,NaN,NaN,2.0623369046669677,1.084439521951239,NaN,-0.690837446932273,-1.4437502234646047,-0.7529127765323317,14.179895130650376,-4.35512324416408,NaN,NaN,NaN,-68519841
970061400,143.5625,143.96875,142.125,143.15625,NaN,NaN,137.31562000000002,154.39844,144.9690621000002,146.5867183,147.898437,147.69999949999996,147.44547373066112,146.56723194012716,145.939903076923,150.308937595226,141.57086855862,144.9690621000002,146.5867183,147.898437,147.69999949999996,143.08333333333334,6049301,4996035.25,34.265857031541145,NaN,1.5,2.75,NaN,NaN,2.046723554333613,1.2108203199727223,NaN,-0.6406559285063355,-1.553732687165251,-0.9130767586589156,14.674461933127356,-3.578194064407493,NaN,NaN,NaN,-62470540
970147800,143.1875,146.32812,142.89062,146.125,NaN,NaN,137.21562,154.44577470588234,144.9959371000002,146.62343710000002,147.84718700000002,147.48906199999996,147.39369044710577,146.525114612496,145.67307615384607,149.5079610148664,141.83819129282574,144.9959371000002,146.62343710000002,147.84718700000002,147.48906199999996,145.11458000000002,6842801,5140745.3,46.95004628457746,NaN,1.5,2.75,NaN,NaN,2.146064729024069,1.331091233016349,NaN,-0.3778358465521263,-1.3853715668490736,-1.0075357202969473,20.32828136634538,0.0213903743315508,NaN,NaN,NaN,-55627739
970234200,145.46875,145.96875,143.625,143.625,NaN,NaN,137.11562,154.4931094117647,145.0066402500002,146.6465621,147.707187,147.05312449999997,147.24589866486633,146.2489132208297,145.3004799999999,148.9111339882306,141.6898260117692,145.0066402500002,146.6465621,147.707187,147.05312449999997,144.40625,8311699,5315290.2,39.957695515187886,NaN,1.5,2.75,NaN,NaN,2.171345819808064,1.5637338108086742,NaN,-0.3436571801377759,-1.4371071954691672,-1.0934500153313913,20.63144258041878,-0.712896953985742,NaN,NaN,NaN,-63939438
970493400,144.28125,144.90625,143.14062,143.84375,NaN,NaN,137.01562,154.54044411764704,145.0152340000002,146.7037496,147.630312,146.62656199999998,147.1124810701657,146.01985005694115,144.91225923076914,147.93236261888742,141.89215584265085,145.0152340000002,146.7037496,147.630312,146.62656199999998,143.96354,5517801,5433535.25,40.788664425059004,NaN,1.5,2.75,NaN,NaN,2.1423661183932015,1.0155084574080935,NaN,-0.28029068790202194,-1.4438133752089186,-1.1635226873068967,20.00640810841403,-1.4557910511667738,NaN,NaN,NaN,-58421637
970579800,144.53125,145.75,142.28125,142.5,NaN,NaN,136.91562000000002,154.5877788235294,145.0142965000002,146.71593710000002,147.543437,146.18749949999997,146.93159945957098,145.68462624199438,144.45312461538452,146.9383571730096,141.96789205775946,145.0142965000002,146.71593710000002,147.543437,146.18749949999997,143.51041666666666,9347199,5728375.2,37.36748111029405,NaN,1.5,2.75,NaN,NaN,2.2371078242222584,1.6317365175381668,NaN,-0.30102786867511044,-1.5398075231507846,-1.2387796544756742,19.562129862389757,-1.6499480780743518,NaN,NaN,NaN,-67768836
970666200,142.875,144.25,141.75,143.6875,NaN,NaN,136.81562000000002,154.63511352941177,145.0244527500002,146.7246871,147.47093700000002,145.88281199999997,146.80437987292115,145.49442374275682,144.26802846153836,146.5899891444127,141.94606777866403,145.0244527500002,146.7246871,147.47093700000002,145.88281199999997,143.22916666666666,6149000,5827620.1,41.99750626408375,NaN,1.5,2.75,NaN,NaN,2.255885836777811,1.0551477094397421,NaN,-0.21116796010569816,-1.5027396046077968,-1.2915716445020986,20.157612630402706,-1.0331467929401636,NaN,NaN,NaN,-61619836
970752600,143.40625,144.84375,143.3125,144.1875,NaN,NaN,136.71562,154.68244823529412,145.0263277500002,146.7137496,147.43718700000002,145.54999949999996,146.7017571328066,145.36995481487523,144.23197076923068,146.54323059342798,141.9207109450334,145.0263277500002,146.7137496,147.43718700000002,145.54999949999996,144.11458333333334,4566898,5852025,43.87869472073446,NaN,1.5,2.75,NaN,NaN,2.2041261341508247,0.7803961876444478,NaN,-0.10009189283042619,-1.4166865105401314,-1.3165946177097052,20.248423782217362,-0.7528500752850076,NaN,NaN,NaN,-57052938
970839000,143.875,144.64062,139.75,141.0625,NaN,NaN,136.61562,154.72978294117647,145.0107027500002,146.65874960000002,147.35093700000002,145.11249949999996,146.48060979426515,144.95972102298234,143.85456692307682,146.48800583644098,141.22112800971266,145.0107027500002,146.65874960000002,147.35093700000002,145.11249949999996,141.81770666666668,10014898,6178964.9,36.01638036206319,NaN,1.5,2.75,NaN,NaN,2.3960185531400526,1.6208051287036764,NaN,-0.21265164096344535,-1.5824091689140118,-1.3697575279505665,23.561305736374198,-2.1461088228918275,NaN,NaN,NaN,-67067836
971098200,141.3125,141.3125,139.375,140,NaN,NaN,136.51562,154.77711764705882,144.97828090000021,146.6071871,147.309062,144.63281199999997,146.22646823370573,144.48736663984116,143.47836538461527,146.73569666968436,140.2210340995462,144.97828090000021,146.6071871,147.309062,144.63281199999997,140.22916666666666,4508000,6207674.9,33.7988852013421,NaN,1.5,2.75,NaN,NaN,2.363267227915763,0.7261978232784065,NaN,-0.3273728099266593,-1.7789735403588907,-1.4516007304322314,23.545681963054744,-1.6897081413210446,NaN,NaN,NaN,-71575836
971184600,140.09375,141.25,137.6875,137.6875,NaN,NaN,136.41562000000002,154.82445235294117,144.93531215000021,146.5459371,147.204687,144.09374949999997,145.89160673434472,143.8397602931896,142.9014423076922,147.2255867146417,138.5772979007427,144.93531215000021,146.5459371,147.204687,144.09374949999997,138.875,6104699,6275784.85,29.53644477774904,NaN,1.5,2.75,NaN,NaN,2.448926711636066,0.9727387324312115,NaN,-0.5164607732653406,-2.097176697013907,-1.5807159237485666,24.310470174577944,-3.8201266099105,NaN,NaN,NaN,-77680535
971271000,137.625,138.625,135.125,136.53125,NaN,NaN,136.31562000000002,154.87178705882351,144.8870309000002,146.49999960000002,147.057812,143.47578099999996,145.52453392123317,143.1437116938382,142.22836538461527,147.48473655396052,136.97199421527003,144.8870309000002,146.49999960000002,147.057812,143.47578099999996,136.76041666666666,10366000,6566329.75,27.658271452302174,NaN,1.5,2.75,NaN,NaN,2.5240033750906323,1.5786596766633598,NaN,-0.6672818067423723,-2.414818182176532,-1.7475363754341597,23.798805002524297,-6.565440547476475,NaN,NaN,NaN,-88046535
971357400,137.28125,137.59375,132.78125,133.125,NaN,NaN,136.21562,154.91912176470586,144.8185934000002,146.43062460000002,146.828437,142.70859349999995,145.03827768902795,142.18954867537744,141.3798076923076,148.38726620821424,134.37234917640095,144.8185934000002,146.43062460000002,146.828437,142.70859349999995,134.5,12336801,7013599.8,23.015232984308028,NaN,1.5,2.75,NaN,NaN,2.687467419727016,1.7589827409314116,NaN,-0.9282804555158626,-2.907886944828988,-1.9796064893131253,20.265036144487944,-7.310704960835509,NaN,NaN,NaN,-100383336
971443800,132.9375,137.65625,132.875,137.5625,NaN,NaN,136.11562,154.9664564705882,144.7732028000002,146.4262496,146.66781200000003,142.28203099999996,144.74510993651705,141.74887737296055,141.00721153846143,148.26728220681954,133.74714087010332,144.7732028000002,146.4262496,146.66781200000003,142.28203099999996,136.03125,11776801,7398654.85,37.69028206043968,NaN,1.5,2.75,NaN,NaN,2.8370233183179434,1.5917489379843148,NaN,-0.7419687791137806,-2.907067463205351,-2.1650986840915705,30.714757403460624,-4.366717358244623,NaN,NaN,NaN,-88606535
971703000,137.40625,138.23437,136.6875,138.1875,NaN,NaN,136.01562,155.0137911764706,144.72976530000022,146.4056246,146.504062,141.95859349999995,144.48794876253598,141.40969857553574,140.6249999999999,147.91537992310165,133.33462007689812,144.72976530000022,146.4056246,146.504062,141.95859349999995,137.70312333333334,5659000,7426389.8,39.44124923689339,NaN,1.5,2.75,NaN,NaN,2.7448695098666627,0.7620122498821702,NaN,-0.5266721690475755,-2.82343889540104,-2.2967667263534643,30.970961811616302,-3.026315789473684,NaN,NaN,NaN,-82947535
971789400,138.4375,138.5625,134.40625,134.75,NaN,NaN,135.91562000000002,155.06112588235294,144.67632780000022,146.37468710000002,146.23656200000002,141.39765599999996,144.1060684189071,140.77544156834188,139.7499999999999,146.9193541845228,132.58064581547697,144.67632780000022,146.37468710000002,146.23656200000002,141.39765599999996,135.90625,7831699,7490584.7,33.813222469191444,NaN,1.5,2.75,NaN,NaN,2.845682402019044,1.0455390752073066,NaN,-0.5625534350037724,-2.99995852010818,-2.4374050851044076,33.21531437267222,-6.220095693779904,NaN,NaN,NaN,-90779234
971875800,132.625,136.125,130.15625,134.25,NaN,NaN,130.15625,155.1084605882353,144.64882780000022,146.33718710000002,145.947812,140.86562499999997,143.71955593189114,140.15397094278552,139.02884615384605,146.3777840324692,131.67990827522289,144.64882780000022,146.33718710000002,145.947812,140.86562499999997,133.51041666666666,10897301,7710524.75,33.07395165591093,NaN,1.5,2.75,NaN,NaN,3.0687586590176834,1.4133021231791,NaN,-0.5652406117387114,-3.1439558497777966,-2.578715238039085,32.07554114589091,-6.8920676202860855,NaN,NaN,NaN,-101676535
971962200,136.84375,139.45312,136.4375,139.28125,NaN,NaN,129.95696280701753,155.15579529411764,144.64523405000023,146.3028121,145.78468700000002,140.57031249999994,143.5455047188758,140.07085466252022,138.6778846153845,145.48967377270236,131.86609545806664,144.64523405000023,146.3028121,145.78468700000002,140.57031249999994,138.39062333333334,8767301,7881559.7,45.89312515675706,NaN,1.5,2.75,NaN,NaN,3.221213040516421,1.1123814744434404,NaN,-0.1927017594992968,-2.819592437413206,-2.6268906779139094,40.53671125510468,-1.2627381479840496,NaN,NaN,NaN,-92909234
972048600,138.375,141.1875,138.375,139.90625,NaN,NaN,129.7576756140351,155.20313,144.6560153000002,146.2737496,145.648437,140.30156249999996,143.40278884754733,140.0551780279945,138.47836538461527,144.97533142097276,131.98139934825778,144.6560153000002,146.2737496,145.648437,140.30156249999996,139.82291666666666,7373500,7870864.8,47.2449416881843,NaN,1.5,2.75,NaN,NaN,3.1920192519081048,0.9368093833856732,NaN,0.11473502123228929,-2.483471901373548,-2.5982069226058373,38.94320214976335,-0.06696428571428571,NaN,NaN,NaN,-85535734
972307800,139.9375,141.03125,138.9375,140.53125,NaN,NaN,129.55838842105263,155.25046470588234,144.6299215500002,146.2259371,145.5124996,140.12031249999995,143.29017948097683,140.10051821580453,138.23557692307682,144.1450815404325,132.32607230572114,144.6299215500002,146.2259371,145.5124996,140.12031249999995,140.16666666666666,5290000,7649594.9,48.62718144446186,NaN,1.5,2.75,NaN,NaN,3.113571448200383,0.6915398879488376,NaN,0.36498923639642067,-2.1419703771103116,-2.5069596135067322,38.79315846732873,2.06536541080345,NaN,NaN,NaN,-80245734
972394200,140.96875,141.9375,139,139.59375,NaN,NaN,129.3591012280702,155.2977994117647,144.59664030000022,146.1434371,145.31874960000002,139.97968749999995,143.145221462115,140.0522545762041,137.88221153846143,142.79039212666936,132.9740309502535,144.59664030000022,146.1434371,145.31874960000002,139.97968749999995,140.17708333333334,5750699,7673069.9,46.65261737814847,NaN,1.5,2.75,NaN,NaN,3.10099491618607,0.7494652173050059,NaN,0.4657368037743099,-1.9247886087888446,-2.3905254125631545,37.59824949038498,2.243076218814374,NaN,NaN,NaN,-85996433
972480600,138.75,139.5625,136.125,136.3125,NaN,NaN,129.15981403508772,155.34513411764704,144.55664030000023,146.0353121,145.0618746,139.63749999999996,142.87727160085558,139.69608747370847,137.51682692307682,142.12142168260613,132.91223216354751,144.55664030000023,146.0353121,145.0618746,139.63749999999996,137.33333333333334,9136102,7827409.95,40.46004339537791,NaN,1.5,2.75,NaN,NaN,3.127263136458494,1.1671934980229315,NaN,0.3168609888281173,-1.9944491765280077,-2.311310165356125,40.01238898931342,2.3943661971830985,NaN,NaN,NaN,-95132535
972567000,137.125,137.65625,134.03125,136.6875,NaN,NaN,128.96052684210525,155.39246882352938,144.5247653000002,145.93749960000002,144.8231246,139.16562499999995,142.63453545964555,139.40955533335529,137.2620192307691,141.65029157551635,132.87374688602188,144.5247653000002,145.93749960000002,144.8231246,139.16562499999995,136.125,9345801,7952559.95,41.41711097548018,NaN,1.5,2.75,NaN,NaN,3.162815769568602,1.175194032960418,NaN,0.2519415331202417,-1.9963832489558229,-2.2483247820760646,36.67965788541379,-0.6360745115856429,NaN,NaN,NaN,-85786734
972653400,137.875,139.28125,136.625,139.28125,NaN,NaN,128.7612396491228,155.43980352941176,144.4961715500002,145.8554684,144.6049996,138.94843749999995,142.50303406907122,139.39733577779765,137.38461538461527,141.9007712534313,132.86845951579926,144.4961715500002,145.8554684,144.6049996,138.94843749999995,138.39583333333334,9762898,8025119.9,47.68139932979777,NaN,1.5,2.75,NaN,NaN,3.1266325003137014,1.2165423223147107,NaN,0.3840686978994512,-1.7682389097017506,-2.1523076076012018,33.192852891673496,0.7914970601537765,NaN,NaN,NaN,-76023836
972916200,138.4375,141.09375,138.15625,140.53125,NaN,NaN,128.56195245614035,155.4871382352941,144.46398405000022,145.7917184,144.42187460000002,138.78281249999995,142.42570920361746,139.50532760848358,137.6923076923076,142.4713714932731,132.9132438913421,144.46398405000022,145.7917184,144.42187460000002,138.78281249999995,139.92708333333334,10154102,8256934.95,50.432248368724956,NaN,1.5,2.75,NaN,NaN,3.1131230360055797,1.2297665007037508,NaN,0.5461441866584322,-1.4696273742781614,-2.0157715609365936,33.44705165087964,4.290352504638219,NaN,NaN,NaN,-65869734
973002600,141.01562,143.6875,140.0625,142.95312,NaN,NaN,128.36266526315788,155.53447294117646,144.44968715000022,145.7553121,144.269687,138.80546849999996,142.44639197994618,139.833688788628,138.44831692307682,143.20756419012378,133.68906965602986,144.44968715000022,145.7553121,144.269687,138.80546849999996,142.23437333333334,7752398,8177194.9,55.33259558047429,NaN,1.5,2.75,NaN,NaN,3.1496856762908956,0.9480510241965737,NaN,0.7920356723776831,-1.0257269704644898,-1.817762642842173,29.606025937560442,6.482770949720679,NaN,NaN,NaN,-58117336
973089000,142.25,143.25,141.21875,142.46875,NaN,NaN,128.16337807017544,155.5818076470588,144.4307809000002,145.7312496,144.11281200000002,138.74453099999997,142.44726876504635,140.08464699923485,138.82572076923068,144.0038251199774,133.64761641848398,144.4307809000002,145.7312496,144.11281200000002,138.74453099999997,142.3125,6753602,8207425,54.17895805561335,NaN,1.5,2.75,NaN,NaN,3.0697974136986885,0.8228649058626792,NaN,0.8902967064049707,-0.7048917598359594,-1.5951884662409301,29.5681973718865,2.2885348889387482,NaN,NaN,NaN,-64870938
973175400,143.15625,143.90625,142.51562,142.70312,NaN,NaN,127.96409087719297,155.62914235294116,144.4205465000002,145.6823433,143.94999940000002,138.67031199999997,142.45730214680924,140.3340253802601,139.17307615384607,144.7256184486624,133.62053385902973,144.4205465000002,145.6823433,143.94999940000002,138.67031199999997,143.04166333333333,11395102,8548835.2,54.67141690010233,NaN,1.5,2.75,NaN,NaN,2.953204741291639,1.3329420597556965,NaN,0.9347139690264181,-0.42679600495790737,-1.3615099739843255,22.10338874831362,1.9991029707393433,NaN,NaN,NaN,-53475836
973261800,143.46875,143.75,142.375,142.78125,NaN,NaN,127.76480368421052,155.6764770588235,144.4122652500002,145.63171830000002,143.77937440000002,138.75624949999997,142.47000598418927,140.56709439166391,139.79086461538452,145.01487903257387,134.56685019819517,144.4122652500002,145.63171830000002,143.77937440000002,138.75624949999997,142.96875,5187102,8307445.4,54.84563976949955,NaN,1.5,2.75,NaN,NaN,2.8404758311993796,0.6243919460487817,NaN,0.930953298551719,-0.1978183507946767,-1.1287716493463957,22.08509973658468,1.601067378252168,NaN,NaN,NaN,-48288734
973521000,143.15625,144.29687,143.03125,143.78125,NaN,NaN,127.56551649122807,144.29687,144.4294527500002,145.5879683,143.6299994,138.94531199999997,142.52142731814263,140.87320444960068,140.52403769230762,145.06199726405129,135.98607812056395,144.4294527500002,145.5879683,143.6299994,138.94531199999997,143.70312333333334,4042500,8284170.4,57.11749187454945,NaN,1.5,2.75,NaN,NaN,2.7458432718279964,0.48797885663964613,NaN,0.9539025323982102,0.06360651615136703,-0.8902960162468432,22.232909311002683,2.9997761361092454,NaN,NaN,NaN,-44246234
973607400,143.14062,144,142.5625,143.75,NaN,NaN,127.36622929824561,144.0902726666667,144.4385152500002,145.5595308,143.46968700000002,139.24843699999997,142.56960663899977,141.14718497821013,140.86778769230762,145.64767115541778,136.08790422919745,144.4385152500002,145.5595308,143.46968700000002,139.24843699999997,143.4375,5231301,8240500.5,57.020942501258574,NaN,1.5,2.75,NaN,NaN,2.6523901809831396,0.6348280665719273,NaN,0.9244038774184389,0.2652088305262055,-0.6591950468922334,21.578394637625287,5.456212746446584,NaN,NaN,NaN,-49477535
973693800,144.0625,144.0625,140.5625,140.5625,NaN,NaN,127.16694210526316,143.88367533333334,144.4372652500002,145.4804683,143.2449996,139.44999949999996,142.49089657472527,141.09150069457107,140.9182684615384,145.6702460929154,136.1662908301614,144.4372652500002,145.4804683,143.2449996,139.44999949999996,141.72916666666666,6123301,8028365.55,48.09134109103807,NaN,1.5,2.75,NaN,NaN,2.712933739484344,0.7627082949654678,NaN,0.6600468651962137,0.1658635346030337,-0.49418333059318,20.96788885106593,2.83493369913123,NaN,NaN,NaN,-55600836
973780200,140,141.21875,137.25,140.03125,NaN,NaN,126.9676549122807,143.67707800000002,144.4361715000002,145.40140580000002,143.03874960000002,139.79531199999997,142.39443984630466,140.99052443794525,140.87980692307684,145.6517436294684,136.10787021668528,144.4361715000002,145.40140580000002,143.03874960000002,139.79531199999997,139.5,10635301,7943290.55,46.77654249144465,NaN,1.5,2.75,NaN,NaN,2.802634900949748,1.338903686457749,NaN,0.4303545052230156,0.04375980093558951,-0.3865947042874261,21.33581417547894,0.5384787973973525,NaN,NaN,NaN,-66236137
973866600,139,139.46875,136.53125,136.625,NaN,NaN,126.76836771929824,143.47048066666667,144.4399215000002,145.28921830000002,142.7243746,139.74843699999997,142.16818730331232,140.57476020576,140.65144153846146,145.9073090165818,135.39557406034112,144.4399215000002,145.28921830000002,142.7243746,139.74843699999997,137.54166666666666,8569500,7782925.5,39.34837904864051,NaN,1.5,2.75,NaN,NaN,2.8524466937390516,1.1010641178564538,NaN,0.049973482327022256,-0.3241278513786483,-0.37410133370567056,23.566303244229328,-2.779630865021125,NaN,NaN,NaN,-74805637
974125800,135.625,136.98437,133.01562,135.5625,NaN,NaN,126.56908052631579,143.26388333333335,144.4196090000002,145.1885933,142.3881246,139.61718699999997,141.9091407423981,140.0974020909257,140.59374923076913,146.0514497230574,135.13604873848087,144.4196090000002,145.1885933,142.3881246,139.61718699999997,135.18749666666668,17285296,8364240.3,37.355656613078786,NaN,1.5,2.75,NaN,NaN,2.932182644186262,2.0665709472741955,NaN,-0.25545732349656597,-0.693422988076378,-0.43796566457981206,22.68739071546467,-5.169960613661326,NaN,NaN,NaN,-92090933
974212200,137.46875,139.625,137,139.125,NaN,NaN,126.36979333333333,143.057286,144.4105465000002,145.1360933,142.1449996,139.83593699999997,141.79995875250015,140.0047923679804,140.78124923076913,145.84233812718008,135.72016033435818,144.4105465000002,145.1360933,142.1449996,139.83593699999997,138.58333333333334,7668898,8356100.25,47.04015794014241,NaN,1.5,2.75,NaN,NaN,3.0129195981729575,0.9177604110242694,NaN,-0.20216066367377838,-0.6906664941720351,-0.4885058304982567,25.96455918487714,-2.347005922351393,NaN,NaN,NaN,-84422035
974298600,139.0625,140.10937,137.75,139.5625,NaN,NaN,126.17050614035087,142.85068866666668,144.4030465000002,145.0693746,141.9406246,140.10156199999997,141.71221527200996,139.9626692853156,140.80288384615375,145.84048965465823,135.76527803764927,144.4030465000002,145.0693746,141.9406246,140.10156199999997,139.14062333333334,8837699,8253120.15,48.10126700526194,NaN,1.5,2.75,NaN,NaN,2.9662374840177472,1.0708312540439628,NaN,-0.12578391145094525,-0.6457357198119382,-0.519951808360993,26.171364245027096,-2.20080682188309,NaN,NaN,NaN,-75584336
974385000,139.5625,139.875,137.3125,137.375,NaN,NaN,125.97121894736841,142.64409133333334,144.3739840000002,144.9915621,141.6712496,140.00624949999997,141.5421283985978,139.71622459147602,140.5600953846153,145.92055135117812,135.19963941805247,144.3739840000002,144.9915621,141.6712496,140.00624949999997,138.1875,6684102,8148960.2,43.41713434227851,NaN,1.5,2.75,NaN,NaN,2.937399092302194,0.8202398632404659,NaN,-0.20617948054929802,-0.7776761590476156,-0.5714966784983175,27.16072829117603,-3.786386517837601,NaN,NaN,NaN,-82268438
974471400,137.3125,139,135.75,136.64062,NaN,NaN,125.77193175438596,142.43749400000002,144.3442183500002,144.9023433,141.407812,139.84296799999998,141.34991238296652,139.4233098684783,140.0745184615384,145.6203444097236,134.52869251335318,144.3442183500002,144.9023433,141.407812,139.84296799999998,137.13020666666668,6551102,8107840.3,41.9405303081591,NaN,1.5,2.75,NaN,NaN,2.9597277285663233,0.8079959345030513,NaN,-0.287417786498977,-0.9307689116220388,-0.6433511251230618,27.025896459752794,-4.966315148880669,NaN,NaN,NaN,-88819540
974730600,135.75,136.375,134.3125,134.6875,NaN,NaN,125.57264456140351,142.2308966666667,144.3057808500002,144.8073433,141.109687,139.55078049999997,141.0886413091247,138.97228035719465,139.47596076923068,145.51653381658798,133.43538772187338,144.3057808500002,144.8073433,141.109687,139.55078049999997,135.125,5458500,8116265.3,38.217801770739165,NaN,1.5,2.75,NaN,NaN,2.9146128908115867,0.6725383902864782,NaN,-0.44204771366979645,-1.1959107672103073,-0.7538630535405109,26.51411776836162,-6.304347826086956,NaN,NaN,NaN,-94278040
974817000,134.875,136.1875,133.51562,135.375,NaN,NaN,125.37335736842104,142.02429933333335,144.26109335000018,144.7082808,140.847812,139.33984299999997,140.86457694406099,138.62968222793802,138.91225923076914,145.01043421421932,132.81408424731896,144.26109335000018,144.7082808,140.847812,139.33984299999997,135.02604,7684301,8212945.4,40.22896215834852,NaN,1.5,2.75,NaN,NaN,2.8972748271821867,0.9356327877207122,NaN,-0.46504641530720137,-1.3351710726745125,-0.8701246573673111,27.142855466922065,-3.6905291240551357,NaN,NaN,NaN,-86593739
974903400,134.34375,134.875,132.125,132.14062,NaN,NaN,125.17407017543859,141.81770200000003,144.21539020000017,144.55687450000002,140.51281200000003,139.13124899999997,140.52246098547036,138.01167630146773,138.09374923076913,144.72784983427042,131.45964862726785,144.21539020000017,144.55687450000002,140.51281200000003,139.13124899999997,133.04687333333334,5736898,8042985.2,34.53352251961368,NaN,1.5,2.75,NaN,NaN,2.922469482383459,0.7132796912270832,NaN,-0.6535608694809996,-1.6870757442185607,-1.033514874737561,27.546889203602575,-5.634906494086133,NaN,NaN,NaN,-92330637
975076200,133.625,134.96875,133.625,134.84375,NaN,NaN,124.97478298245613,141.61110466666668,144.18179645000018,144.45906200000002,140.24031200000002,139.03906149999997,140.29976643702054,137.70996903466127,137.40624923076913,143.35751267533368,131.4549857862046,144.18179645000018,144.45906200000002,140.24031200000002,139.03906149999997,134.47916666666666,3411600,7746275.15,41.93265747562467,NaN,1.5,2.75,NaN,NaN,2.915730947927497,0.44041812793081586,NaN,-0.555527537061131,-1.727924296063975,-1.172396759002844,31.47374126757287,-1.303751143641354,NaN,NaN,NaN,-88919037
975335400,136.46875,136.6875,135.3125,136.03125,NaN,NaN,124.77549578947368,141.40450733333336,144.16851520000017,144.3618745,140.039062,138.87656149999998,140.13237363556874,137.5500910313602,136.81249923076913,141.52488667587272,132.10011178566555,144.16851520000017,144.3618745,140.039062,138.87656149999998,136.01041666666666,5992000,7557730.25,44.87994809637491,NaN,1.5,2.75,NaN,NaN,2.83916088021839,0.7928306253057921,NaN,-0.37848847881865,-1.6455073575261565,-1.2670188787075065,29.131276671227194,0.3457814661134163,NaN,NaN,NaN,-82927037
975421800,135.125,136.59375,133.64062,133.6875,NaN,NaN,124.57620859649123,141.19791,144.1394527000002,144.217812,139.81968700000002,138.53437399999999,139.8796334929974,137.1822252188497,136.283653076923,140.72952349518414,131.83778265866187,144.1394527000002,144.217812,139.81968700000002,138.53437399999999,134.64062333333334,5336102,7316830.25,40.50964281305105,NaN,1.5,2.75,NaN,NaN,2.8473015316313615,0.7292914852028992,NaN,-0.3857043157546376,-1.7491492734008034,-1.3634449576461658,30.499917187655644,-3.908355795148248,NaN,NaN,NaN,-88263139
975508200,134.375,135.90625,133.26562,133.4375,NaN,NaN,124.37692140350876,140.9913126666667,144.10117145000018,144.07374950000002,139.569062,138.05859299999997,139.62700080699753,136.8255847218164,135.77644153846146,139.888353346464,131.66452973045892,144.10117145000018,144.07374950000002,139.569062,138.05859299999997,134.20312333333334,6914102,7274915.45,40.061516728718075,NaN,1.5,2.75,NaN,NaN,2.8325392793719777,0.9504030730693921,NaN,-0.37353195350837076,-1.8303598995316293,-1.4568279460232585,25.088067623345868,-4.38871473354232,NaN,NaN,NaN,-95177241
975594600,132.5,133.5,129.75,132.28125,NaN,NaN,129.75,140.78471533333334,144.0666402000002,143.91499950000002,139.3168746,137.54921799999997,139.33893214789958,136.39279093878628,135.44230692307684,139.91428208545062,130.97033176070306,144.0666402000002,143.91499950000002,139.3168746,137.54921799999997,131.84375,11201602,7497315.45,37.96946367839897,NaN,1.5,2.75,NaN,NaN,2.898072187988265,1.4940817249459604,NaN,-0.40682894192429586,-1.9653641234286283,-1.5585351815043325,24.743783327649275,-3.707916287534122,NaN,NaN,NaN,-106378843
975681000,133.1875,134.0625,131,132.21875,NaN,NaN,129.73645833333333,140.57811800000002,144.0363277000002,143.74593700000003,139.0574996,137.02499949999998,139.05970931857019,135.99526323033044,135.1850953846153,139.97329073442225,130.39690003480834,144.0363277000002,143.74593700000003,139.0574996,137.02499949999998,132.42708333333334,7587199,7306920.3,37.854390391783994,NaN,1.5,2.75,NaN,NaN,2.909817031703389,1.0383579796265192,NaN,-0.3961519400419149,-2.053725106556726,-1.6575731665148112,23.929321570341145,-3.236131393431918,NaN,NaN,NaN,-113966042
975940200,131.875,133.875,131.5,133.34375,NaN,NaN,129.72291666666666,140.3715206666667,144.02648395000017,143.58156200000002,138.81874960000002,136.55312449999997,138.83555405117528,135.74273816077516,134.74038384615375,139.03022385271495,130.45054383959254,144.02648395000017,143.58156200000002,138.81874960000002,136.55312449999997,132.90625,6996398,7397385.1,41.302768361047555,NaN,1.5,2.75,NaN,NaN,2.8716158151531475,0.9457933993459392,NaN,-0.2817862128517481,-2.0098059325794964,-1.7280197197277483,24.899286145178227,-0.9976798143851509,NaN,NaN,NaN,-106969644
976026600,134.875,138.25,134.40625,137.71875,NaN,NaN,129.709375,140.16492333333335,144.0402339500002,143.44624950000002,138.68999960000002,136.24999949999997,138.79175781387428,135.93092976451086,134.59855692307684,138.32642416328136,130.87068968287232,144.0402339500002,143.44624950000002,138.68999960000002,136.24999949999997,136.79166666666666,8883398,7639430,52.37116236546805,NaN,1.5,2.75,NaN,NaN,3.0169468283564944,1.162835185347598,NaN,0.09962401336316096,-1.6034897030237971,-1.703113716386958,30.469941482590386,1.7313019390581716,NaN,NaN,NaN,-98086246
976113000,137.78125,138.34375,135.03125,135.51562,NaN,NaN,129.69583333333333,139.95832600000003,144.03499955000018,143.2914057,138.552187,135.83828049999997,138.66328182117334,135.89137645360506,134.4555276923076,137.87635322732655,131.03470215728868,144.03499955000018,143.2914057,138.552187,135.83828049999997,136.29687333333334,12888000,8022264.95,47.51245022631254,NaN,1.5,2.75,NaN,NaN,3.0380577691881734,1.6065288394644706,NaN,0.20839045157920788,-1.4426256519129481,-1.651016103492156,32.12353297808469,2.5540972942309486,NaN,NaN,NaN,-110974246
976199400,134.875,135.875,133.65625,133.65625,NaN,NaN,129.68229166666666,139.75172866666668,144.03421830000016,143.130312,138.362187,135.49296799999996,138.4669276321077,135.67850726754745,134.22596076923068,137.42263007704685,131.02929146141452,144.03421830000016,143.130312,138.362187,135.49296799999996,134.39583333333334,6529102,8042555,43.817669963930875,NaN,1.5,2.75,NaN,NaN,2.979535785674732,0.8118193782945843,NaN,0.16203032516795202,-1.448478197032216,-1.610508522200168,29.722730956512358,-0.880648899188876,NaN,NaN,NaN,-117503348
976285800,137.0625,139.125,133.875,133.96875,NaN,NaN,129.66875,139.54513133333336,144.03742145000018,142.9831245,138.119062,135.18984299999997,138.29052850927997,135.51567324206673,134.17067230769223,137.3583484804646,130.98299613491986,144.03742145000018,142.9831245,138.119062,135.18984299999997,135.65625,10276102,8024595.05,44.59746366014802,NaN,1.5,2.75,NaN,NaN,3.1573368009836797,1.2805757718577961,NaN,0.15910451741146203,-1.4116278754358405,-1.5707323928473025,27.183788535126382,-1.516195727084769,NaN,NaN,NaN,-107227246
976545000,137.375,139.5625,136.71875,138.625,NaN,NaN,129.65520833333332,139.5625,144.04992145000017,142.86312450000003,138.01906200000002,135.28984299999996,138.3036450383278,135.81179959996513,134.42067230769223,138.3665479731275,130.47479664225696,144.04992145000017,142.86312450000003,138.01906200000002,135.28984299999996,138.30208333333334,6405602,7916400.15,54.68894838132102,NaN,1.5,2.75,NaN,NaN,3.331366315199131,0.8091559141309955,NaN,0.4604012206317276,-0.9952308670576429,-1.4556320876893705,33.54834083477654,3.6933146330060778,NaN,NaN,NaN,-100821644
976631400,138.1875,138.8125,137.375,138.03125,NaN,NaN,129.64166666666668,139.36523458333335,144.05289020000018,142.76656200000002,137.902812,135.41328049999998,138.292962879962,136.02317582853988,134.8737976923076,139.0162877184805,130.73130766613468,144.05289020000018,142.76656200000002,137.902812,135.41328049999998,138.07291666666666,5022898,7303280.25,53.354359967647255,NaN,1.5,2.75,NaN,NaN,3.1960901498277643,0.6877591750638352,NaN,0.6004921463566266,-0.7050169047435872,-1.3055090511002139,31.58591996628171,3.442622950819672,NaN,NaN,NaN,-105844542
976717800,139.25,139.40625,136.03125,136.14062,NaN,NaN,129.628125,139.16796916666667,144.04140580000018,142.6595307,137.77562440000003,135.26406149999997,138.20855727682624,136.03436098772656,134.97355692307684,139.17045276852014,130.77666107763355,144.04140580000018,142.6595307,137.77562440000003,135.26406149999997,137.19270666666668,6070500,7223360.35,49.234303381004224,NaN,1.5,2.75,NaN,NaN,3.208869424840067,0.840398333443243,NaN,0.5480661210860698,-0.6204263997426267,-1.1684925208286965,32.99176779917852,2.9175487833687788,NaN,NaN,NaN,-111915042
976804200,135.875,136.5,134.03125,134.40625,NaN,NaN,129.61458333333334,138.97070374999998,144.02078080000018,142.5304682,137.5899994,135.00624899999997,138.05944718753895,135.87930279841927,134.84855692307684,139.00863404502638,130.6884798011273,144.02078080000018,142.5304682,137.5899994,135.00624899999997,134.97916666666666,7778398,7170395.3,45.74456656966275,NaN,1.5,2.75,NaN,NaN,3.156003751637205,1.084793470173116,NaN,0.38644545407508146,-0.6854357032348446,-1.071881157309926,33.55925867090661,1.6544552115339164,NaN,NaN,NaN,-119693440
976890600,133.125,133.125,130.5625,130.96875,NaN,NaN,129.60104166666667,138.77343833333333,143.96999955000018,142.38140570000002,137.3256244,134.68593649999997,137.78138063116486,135.41163110333173,134.63942230769223,139.25983018988734,130.01901442549712,143.96999955000018,142.38140570000002,137.3256244,134.68593649999997,131.55208333333334,9065301,7289455.25,39.73331005379501,NaN,1.5,2.75,NaN,NaN,3.205128483663119,1.2436184446018788,NaN,0.055285558365660625,-1.0027742093528502,-1.0580597677185108,37.10955943749508,-1.781110850714788,NaN,NaN,NaN,-128758741
977149800,132.0625,133.46875,131.76562,132.71875,NaN,NaN,129.5875,138.57617291666668,143.93453080000018,142.2548432,137.1587494,134.48984299999998,137.5828460966094,135.15516623634775,134.58413384615375,139.27737532205296,129.89089237025453,143.93453080000018,142.2548432,137.1587494,134.48984299999998,132.65104,7235398,7323670.05,43.7834493799648,NaN,1.5,2.75,NaN,NaN,3.1547621634014678,0.9879470198141982,NaN,-0.033850168338898534,-1.100372478142134,-1.0665223098032355,37.65253142978524,-3.6305877013841616,NaN,NaN,NaN,-121523343
977236200,132.46875,134.96875,130.01562,130.01562,NaN,NaN,129.57395833333334,138.3789075,143.89937455000018,142.1340619,136.95906180000003,134.25624899999997,137.28609213203646,134.66568564240987,134.40985461538455,139.5765934481965,129.2431157825726,143.89937455000018,142.1340619,136.95906180000003,134.25624899999997,131.66666333333333,9616699,7531580,39.38101312769265,NaN,1.5,2.75,NaN,NaN,3.2832170088727906,1.2768501429978836,NaN,-0.25072839451039286,-1.3799328029412266,-1.1292044084308337,32.73749857141179,-4.058572731320567,NaN,NaN,NaN,-131140042
977322600,128.625,128.9375,126.09375,126.25,NaN,NaN,129.56041666666667,138.18164208333332,143.84624955000018,141.9674994,136.7303118,133.79999899999999,136.85330420528993,133.86419177170416,133.95071999999993,140.64862314407608,127.25281685592378,143.84624955000018,141.9674994,136.7303118,133.79999899999999,127.09375,9994199,7647074.9,34.219149190899955,NaN,1.5,2.75,NaN,NaN,3.328835079667592,1.3069309678135883,NaN,-0.6035381984755106,-1.8836271565252218,-1.2800889580497112,35.07068793033428,-5.541267243394903,NaN,NaN,NaN,-141134241
977409000,126,128.85937,125.53125,127.125,NaN,NaN,125.53125,137.98437666666666,143.7774995500002,141.79999940000002,136.54218680000002,133.54921799999997,136.4718020795923,133.2223639839228,133.47235461538455,141.09919794699624,125.84551128377285,143.7774995500002,141.79999940000002,136.54218680000002,133.54921799999997,127.17187333333334,14331500,8076805,36.30824858814754,NaN,1.5,2.75,NaN,NaN,3.328784002548479,1.7744021305454323,NaN,-0.725523296351928,-2.186993078489621,-1.4614697821376932,35.62525630476116,-5.108467459762071,NaN,NaN,NaN,-126802741
977495400,129,131.10937,128.84375,130.9375,NaN,NaN,125.25,137.78711125,143.73124955000017,141.66343690000002,136.4984368,133.35390549999997,136.25477062549064,133.00475789021587,132.95071999999993,140.26571370290716,125.6357262970927,143.73124955000017,141.66343690000002,136.4984368,133.35390549999997,130.29687333333334,10182898,8415369.9,44.56865668098011,NaN,1.5,2.75,NaN,NaN,3.375611573795017,1.2100356990843621,NaN,-0.50731927805305,-2.0956188797040056,-1.5882996016509556,40.72308183848481,-5.545536519386835,NaN,NaN,NaN,-116619843
977841000,130.84375,132.34375,130.28125,132.34375,NaN,NaN,124.96875,137.58984583333333,143.69999955000017,141.53093690000003,136.39406180000003,133.16953049999998,136.10139726762827,132.94180475781437,132.7067299999999,139.87332940490384,125.54013059509599,143.69999955000017,141.53093690000003,136.39406180000003,133.16953049999998,131.65625,4665301,8349034.95,47.28443635182294,NaN,1.5,2.75,NaN,NaN,3.281817889952516,0.5587832639268087,NaN,-0.23973489780458146,-1.8879682239066824,-1.648233326102101,34.85101018979682,-4.120443740095087,NaN,NaN,NaN,-111954542
977927400,132,133.73437,131.25,133.3125,NaN,NaN,124.6875,137.39258041666665,143.68343705000018,141.40031190000002,136.2965618,133.15078049999997,135.99202874732913,132.97710906659395,132.68028769230762,139.83520547107491,125.52536991354033,143.68343705000018,141.40031190000002,136.2965618,133.15078049999997,132.76562333333334,4854102,8324934.95,49.133306872613744,NaN,1.5,2.75,NaN,NaN,3.22485732638448,0.583079871392869,NaN,0.017399097687723408,-1.6264844539924468,-1.6438835516801702,35.51902569370215,-2.0773520790488633,NaN,NaN,NaN,-107100440
978013800,132.8125,133.875,132.59375,133.71875,NaN,NaN,124.40625,137.195315,143.65296830000017,141.2562494,136.2759368,133.16484299999996,135.90288056115935,133.04774153644215,132.66105692307684,139.80335171745543,125.51876212869827,143.65296830000017,141.2562494,136.2759368,133.16484299999996,133.39583333333334,8358699,8397164.8,49.92643346397707,NaN,1.5,2.75,NaN,NaN,3.0860282316427314,0.9954191919634588,NaN,0.2185665135744057,-1.3706754097121632,-1.5892419232865689,35.04219243250618,-0.5115089514066496,NaN,NaN,NaN,-98741741
978100200,134.0625,134.28125,131.1875,131.1875,NaN,NaN,124.125,136.99804958333334,143.57718705000016,141.08124940000002,136.2146868,133.11015549999996,135.717963676408,132.8705756758286,132.08894153846146,138.36803660627334,125.80984647064957,143.57718705000016,141.08124940000002,136.2146868,133.11015549999996,132.21875,8774602,8275814.8,45.19763242429685,NaN,1.5,2.75,NaN,NaN,3.0865797865253937,1.0602704642448015,NaN,0.1861470885026537,-1.3565580626582516,-1.5427051511609053,35.938541404559906,0.16702457647339536,NaN,NaN,NaN,-107516343
978445800,132,132.15625,127.5625,128.8125,NaN,NaN,123.84375,136.80078416666666,143.48656205000017,140.89499940000002,136.00531180000002,132.93984299999997,135.44716117929397,132.48409227813065,131.37980692307684,136.84366208212256,125.91595176403112,143.48656205000017,140.89499940000002,136.00531180000002,132.93984299999997,129.51041666666666,8737398,8333324.75,41.24982577491037,NaN,1.5,2.75,NaN,NaN,3.1942348017735798,1.048488839943505,NaN,0.018566679783228013,-1.5194968014318704,-1.5380634812150984,34.3481534606238,-2.943254061690605,NaN,NaN,NaN,-116253741
978532200,128.3125,136,127.65625,135,NaN,NaN,123.5625,136.60351874999998,143.42765580000017,140.77781190000002,135.9071868,133.02265549999998,135.42962544677263,132.7237025373563,131.29206692307682,136.4768062655019,126.10732758065174,143.42765580000017,140.77781190000002,135.9071868,133.02265549999998,132.88541666666666,19431600,8955084.85,52.81346550199603,NaN,1.5,2.75,NaN,NaN,3.5620573159326097,2.169895687811378,NaN,0.3214512561752665,-1.1362494109960153,-1.4577006671712818,43.79934564266143,3.833677830402214,NaN,NaN,NaN,-96822141
978618600,134.9375,135.46875,133,133.54687,NaN,NaN,123.28125,136.40625333333332,143.34945265000016,140.63999940000002,135.76749920000003,132.81406149999998,135.35579189984037,132.80209943856048,131.22596076923068,136.27020004347605,126.18172149498531,143.34945265000016,140.63999940000002,135.76749920000003,132.81406149999998,134.00520666666668,9219000,8971864.95,50.30905512450248,NaN,1.5,2.75,NaN,NaN,3.4839639362231374,1.0275455606361976,NaN,0.41499665169542443,-0.9389548525520013,-1.3539515042474257,42.31981338665916,5.779699009901,NaN,NaN,NaN,-106041141
978705000,133.46875,133.625,129.1875,129.1875,NaN,NaN,123,136.20898791666667,143.24492140000018,140.4390619,135.5593742,132.49765549999998,135.11389809984664,132.4578518729833,131.08894153846146,136.24912151309726,125.92876156382566,143.24492140000018,140.4390619,135.5593742,132.49765549999998,130.66666666666666,12911398,8973034.85,43.62553125884574,NaN,1.5,2.75,NaN,NaN,3.5520736550643415,1.4389109388112986,NaN,0.1860131914014853,-1.1214350149955692,-1.3074482063970545,43.41196855157802,1.6224188790560472,NaN,NaN,NaN,-118952539
978964200,129.875,130.1875,127.6875,130.1875,NaN,NaN,122.71875,136.0117225,143.13335890000016,140.24937440000002,135.43687420000003,132.32421799999997,134.9207060174997,132.24162788508013,130.8942299999999,135.98427138108593,125.80418861891388,143.13335890000016,140.24937440000002,135.43687420000003,132.32421799999997,129.35416666666666,6625301,8977844.8,45.416874042741696,NaN,1.5,2.75,NaN,NaN,3.47692553684546,0.7379611864085688,NaN,0.10847709531606098,-1.1718518372519782,-1.2803289325680391,43.44554640094205,-0.5727923627684964,NaN,NaN,NaN,-112327238
979050600,131.04687,131.5,129.42187,129.84375,NaN,NaN,122.4375,135.8144570833333,143.01476515000016,140.06156190000002,135.29999920000003,132.11796799999996,134.72160970308795,132.01325856269156,130.88100923076914,135.98099337986918,125.7810250816691,143.01476515000016,140.06156190000002,135.29999920000003,132.11796799999996,130.25520666666668,5702398,8749159.6,44.88883989601779,NaN,1.5,2.75,NaN,NaN,3.377011569927926,0.651765227828282,NaN,0.043927616374775935,-1.2254194120995692,-1.269347028474345,39.86827481091943,-1.8890200708382527,NaN,NaN,NaN,-118029636
979137000,129,132.125,128.8125,132.125,NaN,NaN,122.15625,135.61719166666666,142.91570265000016,139.88093690000002,135.15687420000003,131.79296799999997,134.6197818715943,132.02390060433999,131.3329323076922,135.69987783429548,126.96598678108893,142.91570265000016,139.88093690000002,135.15687420000003,131.79296799999997,131.02083333333334,8746102,8866184.6,49.11682842744084,NaN,1.5,2.75,NaN,NaN,3.37240360064736,0.9864561132643235,NaN,0.15832293541390263,-1.0714433592069668,-1.2297662946208694,40.75553435123457,-0.8907641819034224,NaN,NaN,NaN,-109283534
979223400,131.09375,133.48437,131.09375,132.25,NaN,NaN,121.875,135.41992625,142.82164015000018,139.70656190000003,134.99124920000003,131.50390549999997,134.52684924917884,132.04543388011712,131.72716307692298,135.3684679638642,128.08585818998176,142.82164015000018,139.70656190000003,134.99124920000003,131.50390549999997,132.27604,7245301,8977304.75,49.34614138510777,NaN,1.5,2.75,NaN,NaN,3.302276200601121,0.8070686249121709,NaN,0.24091290783494212,-0.9286251598271917,-1.1695380676621339,40.4930562932068,-1.0983874737088104,NaN,NaN,NaN,-102038233
979309800,132.6875,133.71875,131.28125,132,NaN,NaN,121.59375,135.22266083333332,142.72554640000016,139.5209369,134.77218680000001,131.29687449999997,134.42775712176007,132.0411068439155,131.80889384615375,135.42322908359972,128.19455860870778,142.72554640000016,139.5209369,134.77218680000001,131.29687449999997,132.33333333333334,7244000,9035979.75,48.87176060341907,NaN,1.5,2.75,NaN,NaN,3.2405064719867553,0.8016839568503903,NaN,0.2747576891596757,-0.8260909562125391,-1.1008486453722148,40.42083172005932,0.6193425440686041,NaN,NaN,NaN,-109282233
979655400,132,133.1875,131.51562,132.84375,NaN,NaN,121.3125,135.02539541666664,142.64632765000016,139.3462494,134.57968680000002,131.21874949999997,134.36563919541655,132.11754904925687,131.8473553846153,135.4941342715315,128.2005764976991,142.64632765000016,139.3462494,134.57968680000002,131.21874949999997,132.51562333333334,8542199,9074169.8,50.59790727312005,NaN,1.5,2.75,NaN,NaN,3.1284617239877006,0.9413752649856739,NaN,0.3454500711428561,-0.6690360564436446,-1.0144861275865007,38.93218330840764,3.1295487627365355,NaN,NaN,NaN,-100740034
979741800,134.84375,135.04687,132.64062,133.45312,NaN,NaN,121.03125,134.82813,142.56171825000015,139.1723431,134.39468680000002,131.34296799999998,134.32985412892964,132.24474628266097,131.85817230769223,135.5230596705537,128.19328494483076,142.56171825000015,139.1723431,134.39468680000002,131.34296799999998,133.71353666666667,7851398,9013474.65,51.86193741730903,NaN,1.5,2.75,NaN,NaN,3.0768751722742933,0.871073398980492,NaN,0.41978706924982667,-0.48975229102421736,-0.909539360274044,36.899235788310264,-1.1458370370370277,NaN,NaN,NaN,-92888636
979828200,133.4375,135.70312,132.9375,134.78125,NaN,NaN,120.75,134.63086458333333,142.47937450000015,139.0070306,134.23468680000002,131.44609299999996,134.34755592779516,132.4863180652647,131.939903076923,135.80882631797763,128.07097983586837,142.47937450000015,139.0070306,134.23468680000002,131.44609299999996,134.47395666666668,8106898,9057049.65,54.589131778997896,NaN,1.5,2.75,NaN,NaN,3.0546426599689873,0.8950925868006034,NaN,0.5374243782589971,-0.2377588874502976,-0.7751832657092947,25.289037863626085,0.9243047029106615,NaN,NaN,NaN,-84781738
979914600,136.1875,136.1875,133.875,134.01562,NaN,NaN,120.46875,134.43359916666665,142.42070260000014,138.83468680000001,134.03937420000003,131.64609299999998,134.3345388325875,132.63196586857282,132.1574507692307,136.14879071280515,128.16611082565626,142.42070260000014,138.83468680000001,134.03937420000003,131.64609299999998,134.69270666666668,7782500,8965339.7,52.73438589923902,NaN,1.5,2.75,NaN,NaN,3.0016324699712027,0.8680652669524614,NaN,0.5411909704878269,-0.0986945525995111,-0.639885523087338,24.66331630507552,3.7372965650701597,NaN,NaN,NaN,-92564238
980173800,134.25,135.78125,133.5625,134.90625,NaN,NaN,120.1875,134.23633374999997,142.34929635000015,138.6660931,133.86249920000003,132.07890549999996,134.35695887836837,132.84856435728017,132.6262007692307,136.359042067835,128.89335947062642,142.34929635000015,138.6660931,133.86249920000003,132.07890549999996,134.75,7050898,8818174.65,54.66405976888372,NaN,1.5,2.75,NaN,NaN,2.945712293544688,0.7995870211075939,NaN,0.5778533126737284,0.08243111775482248,-0.49542219491890593,12.419372536607419,3.624579932789246,NaN,NaN,NaN,-85513340
980260200,134.46875,136.65625,134.15625,135.96875,NaN,NaN,119.90625,134.03906833333332,142.27671825000016,138.5078119,133.77062420000001,132.52109299999998,134.42016637333433,133.14572489468205,132.70071999999993,136.65240359793486,128.749036402065,142.27671825000016,138.5078119,133.77062420000001,132.52109299999998,135.59375,8463102,8524754.75,56.92347264020251,NaN,1.5,2.75,NaN,NaN,2.913875701148639,0.9927677978067345,NaN,0.6428634703701309,0.30815714304375774,-0.3347063273263732,12.432922067243027,4.717208182912154,NaN,NaN,NaN,-77050238
980346600,136.25,137.3125,135.84375,136.375,NaN,NaN,119.625,133.84180291666667,142.20140575000016,138.36812440000003,133.6974992,132.79296799999997,134.4968265155565,133.45327490471232,132.9182684615384,137.31828485852,128.51825206455678,142.20140575000016,138.36812440000003,133.6974992,132.79296799999997,136.51041666666666,6199898,8325604.75,57.78967778217032,NaN,1.5,2.75,NaN,NaN,2.8106524367808796,0.7446783970858093,NaN,0.6788879919822082,0.5139036626513871,-0.1649843293308211,11.673488159294518,3.216650898770104,NaN,NaN,NaN,-70850340
980433000,136.25,137.25,135.65625,136.03125,NaN,NaN,119.34375,133.64453749999998,142.12734325000017,138.20499940000002,133.6856242,132.97734299999996,134.55699998553467,133.69879634235878,133.44471076923068,137.56182888589888,129.3275926525625,142.12734325000017,138.20499940000002,133.6856242,132.97734299999996,136.3125,10818301,8633254.75,56.74980911223888,NaN,1.5,2.75,NaN,NaN,2.723730834153674,1.2530964639958064,NaN,0.6454458425692339,0.6418229738807213,-0.0036228686885126093,9.208785072240559,2.8591682419659734,NaN,NaN,NaN,-81668641
980519400,135.15625,136.125,134.45312,135.875,NaN,NaN,119.0625,133.4472720833333,142.05468700000017,138.03999940000003,133.69187420000003,133.10546799999997,134.60868626061173,133.9060538335627,133.88221076923068,137.72121114619026,130.0432103922711,142.05468700000017,138.03999940000003,133.69187420000003,133.10546799999997,135.48437333333334,7136801,8747389.7,56.25430644358099,NaN,1.5,2.75,NaN,NaN,2.648598631714125,0.8158777926631073,NaN,0.5807111326139103,0.7222660470788753,0.141554914464965,9.447382798185469,2.9356060606060606,NaN,NaN,NaN,-88805442
980778600,135.5,136.89999,135.37,136.60001,NaN,NaN,118.78125,133.25000666666665,142.00628080000016,137.893187,133.64137440000002,133.249531,134.68677738764657,134.1626210875091,134.401923076923,137.70526443680262,131.09858171704337,142.00628080000016,137.893187,133.64137440000002,133.249531,136.29,6705898,8664749.65,58.08315939739162,NaN,1.5,2.75,NaN,NaN,2.5686980151631156,0.7739286500908886,NaN,0.5546727486920846,0.8348958503300707,0.28022310163798614,9.063306690953404,2.8275775111738395,NaN,NaN,NaN,-82099544
980865000,136.3,137.92,135.78999,137.8,NaN,NaN,118.5,133.05274125,141.97403080000015,137.77337450000002,133.60612440000003,133.580156,134.80886454891532,134.50903812679397,134.83846153846144,138.31804598590097,131.35887709102192,141.97403080000015,137.77337450000002,133.60612440000003,133.580156,137.16999666666666,7069102,8579474.65,60.99010295454074,NaN,1.5,2.75,NaN,NaN,2.537363156937179,0.8239551124496882,NaN,0.5833013499343112,1.0093497890558751,0.426048439121564,9.439442908059206,3.2572337012428023,NaN,NaN,NaN,-75030442
980951400,137.39999,138.7,136.60001,137.02,NaN,NaN,118.21875,138.7,141.96725580000015,137.63513700000001,133.59902440000005,133.99053099999998,134.8955757430755,134.7481773528136,135.20538461538453,138.51774629242817,131.8930229383409,141.96725580000015,137.63513700000001,133.59902440000005,133.99053099999998,137.44000333333335,9706898,8627949.65,58.166382050827075,NaN,1.5,2.75,NaN,NaN,2.506122217155951,1.1250526942980015,NaN,0.5170056018696597,1.0723054414586386,0.5552998395889789,10.807331630312513,1.6610248087178374,NaN,NaN,NaN,-84737340
981037800,137.10001,137.95,136.25,137.92999,NaN,NaN,117.9375,138.67463235294116,141.95315575000015,137.5163119,133.62481180000003,134.13703049999998,135.01457238060198,135.0512071287361,135.6615376923076,138.7049242368398,132.61815114777542,141.95315575000015,137.5163119,133.62481180000003,134.13703049999998,137.3766633333333,8239602,8068349.75,60.46602087209022,NaN,1.5,2.75,NaN,NaN,2.4485420587876683,1.0212251892030337,NaN,0.5013612966408719,1.1820014603900688,0.6806401637491969,10.14523517570713,2.9208311687846464,NaN,NaN,NaN,-76497738
981124200,137.39999,137.99001,134.75,134.8,NaN,NaN,117.65625,138.64926470588233,141.90481200000013,137.36837440000002,133.62706180000004,134.19968699999998,135.0061577774411,135.02728264028505,135.81201846153837,138.44962210031682,133.17441482275993,141.90481200000013,137.36837440000002,133.62706180000004,134.19968699999998,135.84667,8276500,8021224.75,50.236709376499775,NaN,1.5,2.75,NaN,NaN,2.5050754831599784,1.0318249716167098,NaN,0.2593196455510387,1.0047897206879952,0.7454700751369565,17.36711681833442,-0.07875839703496956,NaN,NaN,NaN,-84774238
981383400,134.8,135.94,134.75,135.78999,NaN,NaN,117.375,138.62389705882353,141.86813695000015,137.2415868,133.63536160000004,134.5298115,135.03689629597284,135.09992143644837,135.9917776923076,138.25357455814077,133.72998082647445,141.86813695000015,137.2415868,133.63536160000004,134.5298115,135.49333,4352898,7593299.75,52.94805649843213,NaN,1.5,2.75,NaN,NaN,2.411141520077123,0.5732551253491606,NaN,0.15040120407429125,0.9334715802298206,0.7830703761555293,17.45946542286868,-0.13147138588830973,NaN,NaN,NaN,-80421340
981469800,135.3,136.7,135.22,135.39,NaN,NaN,117.09375,138.5985294117647,141.82602445000015,137.1065806,133.70034920000003,134.7899365,135.05074350005233,135.12754796631043,136.03860461538454,138.22206409062787,133.85514514014122,141.82602445000015,137.1065806,133.70034920000003,134.7899365,135.76999999999998,7106699,7617369.65,51.7218790203076,NaN,1.5,2.75,NaN,NaN,2.3446314115001847,0.9329597126745713,NaN,0.0415834249188769,0.8350496573041255,0.7934662323852486,16.924474421432876,-0.7222731439046847,NaN,NaN,NaN,-87528039
981556200,134.72,135.39999,133.67999,134.69,NaN,NaN,116.8125,138.57316176470587,141.78822445000014,136.9687931,133.69727420000004,135.032249,135.03659669612873,135.08587673142372,136.0904799999999,138.10470965559472,134.07625034440508,141.78822445000014,136.9687931,133.69727420000004,135.032249,134.58999333333333,5748699,7619684.7,49.558870163569736,NaN,1.5,2.75,NaN,NaN,2.3000148821073148,0.7544536586927277,NaN,-0.08070756760628739,0.6925817728773893,0.7732893404836767,16.971127609741202,-0.9859866758557333,NaN,NaN,NaN,-93276738
981642600,134.8,135.39999,133.10001,133.12,NaN,NaN,116.53125,138.54779411764704,141.71304320000013,136.83905560000002,133.63904920000002,135.081999,134.9614360413786,134.89865037605003,135.95307615384607,138.45609320779448,133.45005909989766,141.71304320000013,136.83905560000002,133.63904920000002,135.081999,133.87333333333333,5943301,7479544.65,45.01213258690064,NaN,1.5,2.75,NaN,NaN,2.300012390528221,0.7946073294715875,NaN,-0.2603700319969716,0.44782680048746215,0.7081968324844338,18.01196674008258,-2.027598896044155,NaN,NaN,NaN,-99220039
981729000,133.35001,133.35001,131.25999,131.84,NaN,NaN,116.25,138.52242647058821,141.63982135000015,136.71089310000002,133.60209920000003,135.061499,134.83902678485393,134.60735034023574,135.6354799999999,138.96217535114542,132.30878464885436,141.63982135000015,136.71089310000002,133.60209920000003,135.061499,132.15,9913000,7612929.6,41.65662966059938,NaN,1.5,2.75,NaN,NaN,2.2850129340619203,1.3021268448351342,NaN,-0.44747306174382495,0.14885550530465252,0.5963285670484775,18.491455421002303,-3.484633712691525,NaN,NaN,NaN,-109133039
981988200,131.7,133.5,131.7,133.35001,NaN,NaN,115.96875,138.4970588235294,141.57657140000015,136.5847057,133.60034940000003,135.12899950000002,134.78063396976162,134.48760364116566,135.40278846153836,138.90838947799955,131.89718744507718,141.57657140000015,136.5847057,133.60034940000003,135.12899950000002,132.85000333333332,5804398,7540949.5,46.70412754506785,NaN,1.5,2.75,NaN,NaN,2.2503691530574983,0.7697171291227981,NaN,-0.4503596418657169,0.03337901471633131,0.48373865658204823,19.772254881288372,-3.229310595065322,NaN,NaN,NaN,-103328641
982074600,133.7,134.17,132,132.25999,NaN,NaN,115.6875,138.47169117647059,141.51240260000014,136.45839940000002,133.59992420000003,135.09981150000002,134.6817851866337,134.27544996105465,135.11269153846143,138.96888385826858,131.25649921865428,141.51240260000014,136.45839940000002,133.59992420000003,135.09981150000002,132.80999666666665,6587602,7443219.65,43.76098658339286,NaN,1.5,2.75,NaN,NaN,2.244628499267676,0.8850473732828776,NaN,-0.5025329806621472,-0.14442756924563582,0.3581054114165114,18.636396073645805,-3.4739527076339383,NaN,NaN,NaN,-109916243
982161000,132.64999,132.64999,130.66,132.06,NaN,NaN,115.40625,138.44632352941176,141.43739010000013,136.3271244,133.59674920000003,135.0301555,134.57897008127551,134.0644547266685,134.8192299999999,138.96824167446118,130.6702183255386,141.43739010000013,136.3271244,133.59674920000003,135.0301555,131.78999666666667,8400102,7470654.85,43.22280694351486,NaN,1.5,2.75,NaN,NaN,2.2264400350342712,1.1244130760504885,NaN,-0.5249182826779999,-0.2980424419309884,0.22687584074701145,18.660871109423837,-4.255774976856013,NaN,NaN,NaN,-118316345
982247400,132.84,133.52,132.5,133.34,NaN,NaN,115.125,138.42095588235293,141.38346510000014,136.20771190000002,133.59667420000002,134.95809300000002,134.53038301926472,133.99545903841434,134.5684599999999,138.65016022529716,130.48675977470265,141.38346510000014,136.20771190000002,133.59667420000002,134.95809300000002,133.12,5928602,7361740.05,47.65954722865256,NaN,1.5,2.75,NaN,NaN,2.1716943182461095,0.805326181002547,NaN,-0.43181364658856736,-0.31289121748869775,0.1189224290998696,19.33928572502909,-1.0830860534124687,NaN,NaN,NaN,-112387743
982333800,131,131.28999,129.3,130.39999,NaN,NaN,114.84375,138.3955882352941,141.32734005000015,136.07014930000003,133.45029900000003,134.7773115,134.3684068224308,133.65303341570822,133.99922846153834,138.1822296536282,129.81622726944846,141.32734005000015,136.07014930000003,133.45029900000003,134.7773115,130.32999333333333,6434898,7294359.95,39.939555464803554,NaN,1.5,2.75,NaN,NaN,2.3051447240856726,0.8821744531540426,NaN,-0.5395298424182228,-0.5554898739229088,-0.015960031504686098,19.098303733462867,-3.9693647521440916,NaN,NaN,NaN,-118822641
982679400,131.03999,131.14,128.10001,128.39,NaN,NaN,114.5625,138.37022058823527,141.26022755000014,135.9299868,133.30778660000004,134.45149899999998,134.13395949606098,133.15179213802173,133.3353823076922,138.09017786588862,128.5805867494958,141.26022755000014,135.9299868,133.30778660000004,134.45149899999998,129.21000333333333,5760000,7229815.05,35.6838776707761,NaN,1.5,2.75,NaN,NaN,2.3576336723652664,0.796700878261056,NaN,-0.7068885828205485,-0.8995707600303717,-0.19268217720982322,18.943622145358376,-5.170248910554695,NaN,NaN,NaN,-124582641
982765800,127.89999,128.84,125.5,125.62,NaN,NaN,114.28125,138.34485294117644,141.17067130000015,135.75462430000002,133.14706160000003,133.93406149999998,133.80007873150956,132.43447860106727,132.38845999999987,137.94201361686498,126.83490638313474,141.17067130000015,135.75462430000002,133.14706160000003,133.93406149999998,126.65333333333335,10910801,7352200,30.811422835866793,NaN,1.5,2.75,NaN,NaN,2.4278026957677477,1.4840185250673268,NaN,-0.9497478135827877,-1.3798669441883078,-0.43011913060552015,20.956700454376588,-6.733981735837845,NaN,NaN,NaN,-135493442
982852200,126.35001,126.53999,123.02,125.81,NaN,NaN,114,138.31948529411764,141.08745570000016,135.5514743,132.98388660000003,133.40581149999997,133.48674231066605,131.8035758771561,131.69692153846142,138.05737732282705,125.33646575409581,141.08745570000016,135.5514743,132.98388660000003,133.40581149999997,125.12333000000001,21281600,8106285.1,31.502314877801425,NaN,1.5,2.75,NaN,NaN,2.5058160746414804,2.6253209377005504,NaN,-1.0361332545509514,-1.7252856987942096,-0.689152444243258,21.568001246759295,-5.491286057692309,NaN,NaN,NaN,-114211842
982938600,125.08,125.53999,121.8,124.96001,NaN,NaN,113.71875,138.2941176470588,141.00569325000015,135.3648244,132.71058680000004,132.85224949999997,133.15236065142423,131.15180769837934,130.86384615384603,137.68216132342738,124.04553098426469,141.00569325000015,135.3648244,132.71058680000004,132.85224949999997,124.10000000000001,20173008,8574020.45,30.056352590143376,NaN,1.5,2.75,NaN,NaN,2.6132577835956607,2.3528061447532473,NaN,-1.0839236628349491,-2.0440570227869443,-0.9601333599519952,21.342598087780527,-5.218439016990296,NaN,NaN,NaN,-134384850
983197800,125.8,127.62,124.5,127.62,NaN,NaN,113.4375,138.26874999999998,140.95316825000015,135.20258690000003,132.50236180000005,132.43949949999995,132.93540533176053,130.81544506043846,130.26615384615374,136.74649146065522,123.78581623165225,140.95316825000015,135.20258690000003,132.50236180000005,132.43949949999995,126.58000000000001,11502602,8792310.5,39.42653016221171,NaN,1.5,2.75,NaN,NaN,2.6494536561959707,1.3082570275469685,NaN,-0.8785489952408292,-2.0583196040030316,-1.1797706087622024,26.282979153354304,-4.296970056470181,NaN,NaN,NaN,-122882248
983284200,126.8,127.84,125.50999,126.44,NaN,NaN,113.15625,138.24338235294115,140.87896200000014,135.04198690000004,132.30834940000003,131.93149899999997,132.68068355404444,130.39873600706338,129.63153846153836,135.86584755857905,123.39722936449766,140.87896200000014,135.04198690000004,132.30834940000003,131.93149899999997,126.59666333333331,11415000,9027765.6,37.05497743439965,NaN,1.5,2.75,NaN,NaN,2.626636252181973,1.2644324748529139,NaN,-0.7683182421605541,-2.140168411462895,-1.3718501693023408,24.703066252003076,-4.40041618028248,NaN,NaN,NaN,-134297248
983370600,126.75,126.84,123.27,123.95,NaN,NaN,112.875,138.21801470588233,140.78464950000014,134.84461190000005,132.09922440000003,131.23899899999995,132.338303806827,129.78457067305735,128.92615384615374,135.4884850616991,122.3638226306084,140.78464950000014,134.84461190000005,132.09922440000003,131.23899899999995,124.68666666666668,14831102,9415865.6,32.59893188860946,NaN,1.5,2.75,NaN,NaN,2.6940193770261187,1.5751182769643612,NaN,-0.8053503165902445,-2.3785380650401464,-1.573187748449902,26.07084046038593,-6.1411479630471,NaN,NaN,NaN,-149128350
983457000,124.05,124.60001,121.75,124.60001,NaN,NaN,112.59375,138.19264705882352,140.68124330000012,134.64873700000004,131.9718496,130.61799949999994,132.0348413045985,129.29080298990903,128.36923153846143,135.07517677497273,121.66328630195012,140.68124330000012,134.64873700000004,131.9718496,130.61799949999994,123.65000666666666,14672000,9664120.7,34.80305421448669,NaN,1.5,2.75,NaN,NaN,2.7051615643813958,1.5181929588275942,NaN,-0.7305189369726761,-2.486336419665747,-1.755817482693071,26.816481203512037,-6.554664766761666,NaN,NaN,NaN,-134456350
983543400,122.5,125.64999,122.3,123.61,NaN,NaN,112.3125,138.1672794117647,140.56648080000014,134.47421200000005,131.7896746,129.90199999999996,131.70445537108483,128.74977413372721,127.61999999999989,134.10539514248168,121.1346048575181,140.56648080000014,134.47421200000005,131.7896746,129.90199999999996,123.85333000000001,12564301,9880355.65,33.03131806894068,NaN,1.5,2.75,NaN,NaN,2.7512207383541534,1.2716446092707199,NaN,-0.6924937406741525,-2.6214346585357617,-1.9289409178616093,24.94489612281084,-5.2070479453257645,NaN,NaN,NaN,-147020651
983802600,124.14999,124.78,123.81,124.74001,NaN,NaN,112.03125,138.14191176470587,140.46439960000015,134.32161210000004,131.68416240000002,129.39900049999994,131.4313398663364,128.367891835277,127.04153999999988,133.09542535303703,120.98765464696275,140.46439960000015,134.32161210000004,131.68416240000002,129.39900049999994,124.44333666666667,5293199,9731190.6,36.975171347822645,NaN,1.5,2.75,NaN,NaN,2.638276399900285,0.5439415604499618,NaN,-0.542658233690577,-2.6072637099748306,-2.0646054762842536,24.672154936847335,-2.842892748656429,NaN,NaN,NaN,-141727452
983889000,126.35001,127.75,125.49001,126.08,NaN,NaN,111.75,138.11654411764704,140.37573710000015,134.20553710000004,131.68076240000002,128.91350099999994,131.22148340098988,128.14999737477441,126.58153999999989,131.90492192014392,121.25815807985587,140.37573710000015,134.20553710000004,131.68076240000002,128.91350099999994,126.44000333333332,6917000,9859395.7,41.383489338396316,NaN,1.5,2.75,NaN,NaN,2.664827371335979,0.7015642956697641,NaN,-0.31595955403130604,-2.459554918823386,-2.14359536479208,24.94296157752652,0.3661837287056151,NaN,NaN,NaN,-134810452
983975400,126.89999,127.03999,125.75999,126.98,NaN,NaN,111.46875,138.0911764705882,140.30501210000014,134.11002460000003,131.6778624,128.49300099999996,131.05515071859813,128.03856905336733,126.09230923076913,129.7495576743085,122.43506078722976,140.30501210000014,134.11002460000003,131.6778624,128.49300099999996,126.59332666666667,6371699,9822645.7,44.206239928240514,NaN,1.5,2.75,NaN,NaN,2.5659111305262665,0.6486744197645243,NaN,-0.08032744438301931,-2.2440046702708543,-2.163677225887835,21.789436416264888,0.9299737699705919,NaN,NaN,NaN,-128438753
984061800,126.60001,127.24001,126.14,127.12,NaN,NaN,111.1875,138.06580882352938,140.24029960000016,134.04997460000004,131.60151240000002,128.11450099999996,130.90083108257468,127.95108628637996,125.84000230769222,128.62140956637626,123.05859504900816,140.24029960000016,134.04997460000004,131.60151240000002,128.11450099999996,126.83333666666664,6055000,9837960.75,44.652737294341875,NaN,1.5,2.75,NaN,NaN,2.4612039069172473,0.6154730796217092,NaN,0.1002333995546314,-2.038385476444546,-2.1386188759991773,21.787719678772604,1.7285449961151633,NaN,NaN,NaN,-122383753
984148200,126.10001,126.10001,123.11,123.36,NaN,NaN,110.90625,138.04044117647058,140.16709960000014,133.90794960000005,131.42183740000002,127.62650099999996,130.60511221659135,127.5138399733914,125.45307923076913,128.1043161403097,122.80184232122858,140.16709960000014,133.90794960000005,131.42183740000002,127.62650099999996,124.19000333333334,10020301,10041810.75,36.25996965102422,NaN,1.5,2.75,NaN,NaN,2.5718321992803013,0.9978579809423316,NaN,-0.012305997830919235,-2.1540013732878265,-2.1416953754569072,28.014729388554162,-3.338034790785147,NaN,NaN,NaN,-132404054
984407400,122.34,122.5,117.75,118.08,NaN,NaN,110.625,138.01507352941175,140.05624960000014,133.70687460000005,131.1171874,126.93850099999995,130.11393134535248,126.6153790235446,124.87307923076914,129.6061273798249,120.14003108171336,140.05624960000014,133.70687460000005,131.1171874,126.93850099999995,119.44333333333331,13972898,10244805.65,28.23453571255206,NaN,1.5,2.75,NaN,NaN,2.788844185045994,1.3639007392980655,NaN,-0.39963024815361736,-2.641233185648929,-2.2416029374953115,33.27276366396632,-6.6118316988294845,NaN,NaN,NaN,-146376952
984493800,119.39999,120.44,117.53,120.02,NaN,NaN,110.34375,137.98970588235292,139.96713085000016,133.55957460000005,130.8432124,126.27200049999995,129.7180909004367,125.98724768796893,124.42769461538452,129.77419458073715,119.08119465003189,139.96713085000016,133.55957460000005,130.8432124,126.27200049999995,119.33000000000001,12887199,10598945.7,34.01348362398332,NaN,1.5,2.75,NaN,NaN,2.797498171828423,1.215894426178634,NaN,-0.47720577266923403,-2.8381101533318542,-2.36090438066262,35.968458358297255,-3.170633319887057,NaN,NaN,NaN,-133489753
984580200,117.05,119.28999,115.75,117.64999,NaN,NaN,110.0625,137.9643382352941,139.86538080000017,133.39357450000006,130.57246220000002,125.54150049999994,129.24483204159603,125.19322314625761,123.86538538461528,130.29715460095815,117.43361616827242,139.86538080000017,133.39357450000006,130.57246220000002,125.54150049999994,117.56332666666665,19883392,11263735.2,30.7552265725878,NaN,1.5,2.75,NaN,NaN,2.9026768738406785,1.7652574076847973,NaN,-0.6305372802424563,-3.1490759809656907,-2.5185387007232345,35.97662444657169,-5.577864720877627,NaN,NaN,NaN,-153373145
984666600,118.45,118.86,117.36,117.67999,NaN,NaN,109.78125,137.93897058823526,139.74018700000016,133.17756190000006,130.34981200000001,124.82249999999995,128.79130882427853,124.47767713232831,123.10076923076912,129.9171877017726,116.28435075976564,139.74018700000016,133.17756190000006,130.34981200000001,124.82249999999995,117.96666333333332,10370301,11362245.15,30.8455312485613,NaN,1.5,2.75,NaN,NaN,2.8024856685663444,0.9126982267232634,NaN,-0.6687131260183428,-3.354430108246163,-2.68571698222782,35.559888934367414,-4.79735458296254,NaN,NaN,NaN,-143002844
984753000,117.13,117.39999,114.81,115.00999,NaN,NaN,109.5,137.91360294117644,139.60117445000017,132.92859930000006,129.9500118,123.90599949999994,128.25086494881663,123.57599264353514,122.22153769230758,129.9728094224553,114.47026596215986,139.60117445000017,132.92859930000006,129.9500118,123.90599949999994,115.73999333333335,58515392,13991584.65,27.418334756537234,NaN,1.5,2.75,NaN,NaN,2.8073074065258914,4.182184753461788,NaN,-0.803493952824121,-3.6900844232579715,-2.8865904704338505,36.91730987969515,-7.800239874920642,NaN,NaN,NaN,-201518236
985012200,115.75999,117.69,114.82001,117.35001,NaN,NaN,109.21875,137.88823529411764,139.46136200000015,132.69678690000006,129.62607459999998,123.25350049999994,127.82338044101989,122.98304191557942,121.71384615384605,129.80297722239214,113.62471508529995,139.46136200000015,132.69678690000006,129.62607459999998,123.25350049999994,116.62000666666665,10067801,14173229.8,34.30734105791309,NaN,1.5,2.75,NaN,NaN,2.811784734631185,0.7103392199285444,NaN,-0.6702003792056597,-3.7243409444409252,-3.0541405652352656,39.171645149328896,-6.9241671954314725,NaN,NaN,NaN,-191450435
985098600,117.89999,118.46001,114.11,114.2,NaN,NaN,108.9375,137.8628676470588,139.29314325000016,132.44284940000006,129.3263246,122.54400049999995,127.28913022764657,122.14656173314329,120.91384538461527,129.72762063388726,112.10007013534329,139.29314325000016,132.44284940000006,129.3263246,122.54400049999995,115.59000333333334,15086898,14639574.7,30.15774715995262,NaN,1.5,2.75,NaN,NaN,2.921657967871815,1.0305557578800428,NaN,-0.7247038009087925,-3.9600203163712564,-3.235316515462464,39.26354464090424,-10.06457709875571,NaN,NaN,NaN,-206537333
985185000,114.17999,115.25999,111.89999,112.25999,NaN,NaN,108.65625,137.83749999999998,139.11881820000016,132.20232430000007,128.96777439999997,121.87599999999995,126.69975217950356,121.20498347284392,120.04076769230758,129.81009305661422,110.27144232800094,139.11881820000016,132.20232430000007,128.96777439999997,121.87599999999995,113.13999000000003,19004704,15044269.85,27.918092788775766,NaN,1.5,2.75,NaN,NaN,2.9529681130238283,1.2632520015585869,NaN,-0.8151864618446618,-4.254299592768291,-3.439113130923629,37.86399800771786,-11.689749842668347,NaN,NaN,NaN,-225542037
985271400,112.02,112.60001,108.03999,111.12,NaN,NaN,108.03999,137.81213235294115,138.94207445000015,131.94664930000008,128.59329939999998,121.14149999999995,126.08878150579754,120.2445088563826,118.99307461538453,129.4209471989001,108.56520203186895,138.94207445000015,131.94664930000008,128.59329939999998,121.14149999999995,110.58666666666666,28625600,15411469.85,26.66493876327607,NaN,1.5,2.75,NaN,NaN,3.067757533522126,1.8574217954947367,NaN,-0.8705635800469174,-4.527317605982276,-3.6567540259353586,36.9442865324946,-9.922178988326845,NaN,NaN,NaN,-254167637
985357800,113.25,114.66,111.5,114.48,NaN,NaN,107.75324803278689,137.78676470588232,138.77705260000016,131.6986368000001,128.24039939999997,120.61749949999997,125.63353517223685,119.69550801291759,118.10076692307683,127.91753865242268,108.28399519373099,138.77705260000016,131.6986368000001,128.24039939999997,120.61749949999997,113.54666666666665,12861699,15045904.4,35.81041257588605,NaN,1.5,2.75,NaN,NaN,3.1014891382705447,0.8548305677124999,NaN,-0.6118712246299292,-4.42159305672277,-3.809721832092841,42.62081995250309,-3.048780487804873,NaN,NaN,NaN,-241305938
985617000,115.7,116.27,114.77,115.94,NaN,NaN,107.46650606557377,137.76139705882352,138.62222135000013,131.45272430000009,127.91419939999996,120.03349949999998,125.25339653803148,119.3378405831159,117.25153615384608,125.65761269816318,108.84545960952897,138.62222135000013,131.45272430000009,127.91419939999996,120.03349949999998,115.66000000000001,9943801,14967964.35,39.349776492306,NaN,1.5,2.75,NaN,NaN,3.007811342679791,0.6643389019028496,NaN,-0.28974627138883857,-4.171904671328889,-3.8821583999400504,36.989108051062644,-3.3994334277620384,NaN,NaN,NaN,-231362137
985703400,115.62,118.64999,115.28,118.31,NaN,NaN,107.17976409836066,137.7360294117647,138.48080260000015,131.20629310000007,127.64039939999996,119.62699949999997,124.98110647771652,119.23995100377154,116.57384384615376,122.83520759841586,110.31248009389166,138.48080260000015,131.20629310000007,127.64039939999996,119.62699949999997,117.41333000000003,12881199,15041274.3,44.68198805208244,NaN,1.5,2.75,NaN,NaN,3.0336812467740915,0.8563901397636235,NaN,0.11398514737584042,-3.7396769657202498,-3.85366211309609,37.75468146996488,0.5609945228214637,NaN,NaN,NaN,-218480938
985789800,116.89999,116.95,114.89999,115.03999,NaN,NaN,106.89302213114755,137.71066176470586,138.33162755000015,130.93200550000006,127.28432419999997,119.18149899999999,124.59125877270803,118.83995471769806,115.93384307692301,120.84509159751741,111.02259455632861,138.33162755000015,130.93200550000006,127.28432419999997,119.18149899999999,115.62999333333333,10953301,14847384.25,39.51936577846634,NaN,1.5,2.75,NaN,NaN,3.0605618720045134,0.7377259735161767,NaN,0.1875095923286021,-3.6192751226853375,-3.8067847150139396,39.44763356758958,-2.2433720465136004,NaN,NaN,NaN,-229434239
985876200,114.7,116.5,109.34,115.48,NaN,NaN,106.60628016393443,137.68529411764703,138.17105880000017,130.65977430000007,126.92486179999996,118.72549849999999,124.23395450711163,118.51995903029825,115.73384307692301,120.48847355195636,110.97921260188966,138.17105880000017,130.65977430000007,126.92486179999996,118.72549849999999,113.77333333333333,12061398,14716854.15,40.515323980596854,NaN,1.5,2.75,NaN,NaN,3.353378881147048,0.8195636021846421,NaN,0.2865498671969986,-3.4485973810176915,-3.73514724821469,39.58260527268688,0.40866884694103706,NaN,NaN,NaN,-217372841
985962600,115.55,116.69,114.5,116.69,NaN,NaN,106.31953819672131,137.6599264705882,138.01529005000015,130.39886180000008,126.56303679999995,118.37949849999998,123.93811315389156,118.34567721788889,115.47768923076917,119.59748247373118,111.35789598780717,138.01529005000015,130.39886180000008,126.56303679999995,118.37949849999998,115.96,9183602,14547819.2,43.281361581579596,NaN,1.5,2.75,NaN,NaN,3.2702803896365444,0.6312700119341599,NaN,0.4448769729203854,-3.1790510320642085,-3.623928004984594,37.67646741214851,-0.5624285843691021,NaN,NaN,NaN,-208189239
986218200,116.3,117.38,113.8,114.2,NaN,NaN,106.0327962295082,137.63455882352937,137.84550880000015,130.10304930000007,126.16672439999995,117.85249799999997,123.55622636354288,117.95085081618518,115.21230538461532,119.17983865076394,111.2447721184667,137.84550880000015,130.10304930000007,126.16672439999995,117.85249799999997,115.12666666666668,10561000,14811209.25,39.23786561223749,NaN,1.5,2.75,NaN,NaN,3.2924032189482197,0.7130410368079838,NaN,0.3949248264057377,-3.1302719719774217,-3.5251967983831594,37.708124615871625,0,NaN,NaN,NaN,-218750239
986304600,113.98,114.14999,110.06,110.39,NaN,NaN,105.74605426229509,137.60919117647057,137.66449005000015,129.76944930000008,125.67639939999995,117.06799799999996,123.039903761051,117.2307697860723,114.65153692307686,119.09732857510267,110.20574527105106,137.66449005000015,129.76944930000008,125.67639939999995,117.06799799999996,111.53332999999999,12836000,15107159.25,34.00322864845714,NaN,1.5,2.75,NaN,NaN,3.3529458461662043,0.8496633806253151,NaN,0.13190642388647955,-3.36031376852506,-3.4922201924115397,39.457756694557574,-1.6657671179197515,NaN,NaN,NaN,-231586239
986391000,110.578,112.10001,109.3,110.85001,NaN,NaN,105.45931229508197,137.58382352941175,137.47639635000013,129.47232440000008,125.17402459999995,116.26149849999997,122.56186871159801,116.62307837787493,114.33153846153839,119.2062262142688,109.45685070880798,137.47639635000013,129.47232440000008,125.17402459999995,116.26149849999997,110.75000666666666,14884500,15532799.3,35.12851235344924,NaN,1.5,2.75,NaN,NaN,3.313450428582904,0.9582625586361628,NaN,0.02133150041630838,-3.465555816891154,-3.4868873173074624,38.62989026293496,-0.24297156227502434,NaN,NaN,NaN,-216701739
986477400,113.3,115.49001,112.5,115.05,NaN,NaN,105.17257032786885,137.55845588235292,137.31195885000014,129.22251190000006,124.74752459999996,115.65799849999999,122.26728562486868,116.4732613895059,114.15461461538455,118.73640053422751,109.57282869654158,137.31195885000014,129.22251190000006,124.74752459999996,115.65799849999999,114.34667,21517600,16305929.3,44.442721224652104,NaN,1.5,2.75,NaN,NaN,3.4082039693984107,1.3196181342451914,NaN,0.25072988401826635,-3.1734749622846294,-3.424204846302896,43.82670204403831,0.4979035639412938,NaN,NaN,NaN,-195184139
986563800,113.991,114.39999,112.06,113.3,NaN,NaN,104.88582836065574,137.5330882352941,137.13924010000014,128.98926190000006,124.29289959999997,115.15499849999999,121.91562736506991,116.17104601907675,114.08538384615377,118.6894782041144,109.48128948819316,137.13924010000014,128.98926190000006,124.29289959999997,115.15499849999999,113.25333,14937801,16551804.3,41.752726479998906,NaN,1.5,2.75,NaN,NaN,3.378332257298524,0.9024877728889049,NaN,0.3009055821227178,-3.0480728686494984,-3.3489784507722162,41.506628245240464,-2.277039848197344,NaN,NaN,NaN,-210121940
986823000,114,114.99001,112.78,114.56,NaN,NaN,104.59908639344263,137.50772058823526,136.98391510000013,128.77923690000006,123.86659959999997,114.97899849999999,121.62717138996913,116.01761306487897,114.26230769230762,118.74745401424266,109.77716137037257,136.98391510000013,128.77923690000006,123.86659959999997,114.97899849999999,114.11000333333334,9034301,16304874.45,44.36383633813961,NaN,1.5,2.75,NaN,NaN,3.2948806674914866,0.5540858979137985,NaN,0.42752302347425486,-2.8145746714293978,-3.2420976949036526,41.32204761840578,-3.1696390837629953,NaN,NaN,NaN,-201087639
986909400,115.45,117.75,115.17,116.64999,NaN,NaN,104.31234442622952,137.48235294117643,136.84529005000016,128.55448680000006,123.46759919999997,114.81049799999998,121.43198780604878,116.07783943965241,114.68769153846145,118.9431245444974,110.43225853242551,136.84529005000016,128.55448680000006,123.46759919999997,114.81049799999998,116.52333,17873296,16554179.3,48.48870704652544,NaN,1.5,2.75,NaN,NaN,3.2873891912420947,1.0796848140940456,NaN,0.647408784411883,-2.432836714388799,-3.0802454988006818,40.930452147351374,1.3995133344500459,NaN,NaN,NaN,-183214343
986995800,118.78,118.99001,116.14,116.73,NaN,NaN,104.0256024590164,137.45698529411763,136.69776820000016,128.32616180000005,123.04619919999996,114.76449849999999,121.2475961273802,116.13994996920933,114.86076846153838,119.24927697718826,110.47225994588851,136.69776820000016,128.32616180000005,123.04619919999996,114.76449849999999,117.28666999999999,12722301,16196124.75,48.64567641943469,NaN,1.5,2.75,NaN,NaN,3.256147820439088,0.7855151276233532,NaN,0.7844787427288704,-2.0996470703895938,-2.884125813118464,37.259303257983206,1.0824385174922064,NaN,NaN,NaN,-170492042
987082200,116.3,118.94,115.96001,118.85001,NaN,NaN,103.73886049180328,137.4316176470588,136.56623700000014,128.14091190000005,122.68279939999995,114.8229995,121.15357314199275,116.39805092452272,115.0846153846153,119.94227177673554,110.22695899249507,136.56623700000014,128.14091190000005,122.68279939999995,114.8229995,117.91667333333334,9233199,16139269.65,52.75392339785593,NaN,1.5,2.75,NaN,NaN,3.2364222618362963,0.5720952186953515,NaN,0.9908559751092225,-1.6455558442319358,-2.6364118193411583,38.45440714512306,1.8510669294712485,NaN,NaN,NaN,-161258843
987427800,118.28999,118.89,116.91,117.60001,NaN,NaN,103.45211852459016,137.40624999999997,136.42642455000015,127.95050580000004,122.27619979999996,114.9525005,121.0142177246597,116.51252321742533,115.03000076923071,119.7555454786007,110.30445605986073,136.42642455000015,127.95050580000004,122.27619979999996,114.9525005,117.80000333333334,7348699,13580935,50.203734546941796,NaN,1.5,2.75,NaN,NaN,3.1466778145622754,0.5411040550595375,NaN,1.0125305021848896,-1.3707486916100464,-2.383279193794936,38.83151640017316,2.977241681260941,NaN,NaN,NaN,-168607542
987514200,117.31,119.66,117.02,119.25999,NaN,NaN,103.16537655737706,137.38088235294114,136.30178700000013,127.79623070000005,121.96539959999994,115.04799949999999,120.9454244805554,116.77418672052768,115.3546161538461,120.59052306332705,110.11870924436514,136.30178700000013,127.79623070000005,121.96539959999994,115.04799949999999,118.64666333333332,10924699,13623779.9,53.42376156435857,NaN,1.5,2.75,NaN,NaN,3.110486542093541,0.8018845783026779,NaN,1.1007011008646277,-1.0074028177141514,-2.108103918578779,36.65215025045012,8.035139052450404,NaN,NaN,NaN,-157682843
987600600,121.06,126,120.69,124,NaN,NaN,102.87863459016394,137.3555147058823,136.19538075000014,127.68248070000006,121.72959979999995,115.5379995,121.06521175582775,117.46235941381076,116.0100007692307,122.98778766989166,109.03221386856974,136.19538075000014,127.68248070000006,121.72959979999995,115.5379995,123.56333333333333,32491008,14493985.4,61.14920976398063,NaN,1.5,2.75,NaN,NaN,3.3697382176582877,2.241689025021372,NaN,1.4199796991355371,-0.3331292946593578,-1.753108993794895,32.44758552267826,11.862867671369631,NaN,NaN,NaN,-125191835
987687000,124.25,125.84,123.58,125.64999,NaN,NaN,102.59189262295082,137.3301470588235,136.08722445000015,127.61757440000005,121.53479959999993,116.2074995,121.2450069810894,118.2421337553526,116.69923076923071,125.37337283913051,108.02508869933091,136.08722445000015,127.61757440000005,121.53479959999993,116.2074995,125.02333,13810398,14234270.1,63.423511190468204,NaN,1.5,2.75,NaN,NaN,3.2904712021112674,0.9702217186394405,NaN,1.666940924023412,0.33056716123437013,-1.336373762789042,32.10016041388627,9.213376792698831,NaN,NaN,NaN,-111381437
987773400,124.89999,125.39999,123.66,124.5,NaN,NaN,102.3051506557377,137.30477941176468,135.98659945000014,127.51413690000005,121.33099959999994,116.8764995,121.37265376614472,118.83812101674759,117.4915384615384,126.95364887878796,108.02942804428884,135.98659945000014,127.51413690000005,121.33099959999994,116.8764995,124.51999666666666,7626699,13184325.05,60.754066339450404,NaN,1.5,2.75,NaN,NaN,3.197579687674749,0.5784671548279219,NaN,1.673141426912961,0.7550530208521593,-0.9180884060608017,30.038163048806023,9.885260370697265,NaN,NaN,NaN,-119008136
988032600,123.64999,123.89,121.91,122.24001,NaN,NaN,102.0184086885246,137.27941176470586,135.86904950000016,127.37622450000005,121.11339979999995,117.2645,121.40666773609983,119.16211044372402,118.40307769230762,127.21376819982606,109.59238718478917,135.86904950000016,127.37622450000005,121.11339979999995,117.2645,122.68000333333333,8451801,12963830.15,55.78489019890716,NaN,1.5,2.75,NaN,NaN,3.154181138555124,0.6519524632926481,NaN,1.4534616983656503,0.8987387168962613,-0.554722981469389,30.918362184375834,6.703919343575414,NaN,NaN,NaN,-127459937
988119000,122.52,123.64999,121.10001,121.58,NaN,NaN,101.73166672131148,137.25404411764703,135.73648075000017,127.25514950000004,120.90819979999995,117.5465,121.4134650797822,119.39238563955982,119.22846153846146,127.0037579578779,111.45316511904502,135.73648075000017,127.25514950000004,120.90819979999995,117.5465,122.10999999999999,10045301,12968905.15,54.38587057400097,NaN,1.5,2.75,NaN,NaN,3.1110239143726157,0.7745681600578288,NaN,1.202514843694331,0.9484205731485247,-0.25409427054580624,31.67688821034283,4.226326980396651,NaN,NaN,NaN,-137505238
988205400,121.42,123.67,120.95,123.17,NaN,NaN,101.44492475409837,137.2286764705882,135.61311200000014,127.15247450000004,120.70459959999995,117.7895,121.48234880214368,119.75215843579221,119.85307692307684,127.48869829266502,112.21745555348866,135.61311200000014,127.15247450000004,120.70459959999995,117.7895,122.59666666666668,8249000,12737295.2,57.17239168797967,NaN,1.5,2.75,NaN,NaN,3.0830936347745714,0.6476257219821678,NaN,1.085975016099121,1.103374499578095,0.01739948347897402,31.094676215711072,5.517005054399038,NaN,NaN,NaN,-129256238
988291800,123.73,125.22,123.5,123.72,NaN,NaN,101.15818278688525,137.20330882352937,135.49093075000016,127.06686200000004,120.53379979999995,118.22350049999997,121.5700998295106,120.1300481085739,120.65461538461531,127.51906260148633,113.7901681677443,135.49093075000016,127.06686200000004,120.53379979999995,118.22350049999997,124.14666666666666,10590398,12719150.05,58.12532958378516,NaN,1.5,2.75,NaN,NaN,3.0093012322906736,0.8326340957035883,NaN,0.9909425924116428,1.2560777239935277,0.2651351315818848,30.959119108507025,4.097593260614788,NaN,NaN,NaN,-118665840
988378200,124.92,125.84,124.2,125.78,NaN,NaN,100.87144081967213,137.17794117647057,135.37420575000016,127.00247450000005,120.40819979999995,118.73850049999999,121.73519395384352,120.66813876490019,121.51769230769224,127.90478442010033,115.13060019528416,135.37420575000016,127.00247450000005,120.40819979999995,118.73850049999999,125.27333333333335,8048898,12518525.05,61.57402533694329,NaN,1.5,2.75,NaN,NaN,2.9457797156984826,0.6429589722313173,NaN,1.0084784632587125,1.5257332106552752,0.5172547473965629,30.75682275495054,6.955773218046498,NaN,NaN,NaN,-110616942
988637400,126.45,127.27,124.67,124.91,NaN,NaN,100.58469885245903,137.15257352941174,135.24984950000015,126.91813700000004,120.23959979999994,119.14950049999997,121.85969615173201,121.0721255491954,122.15307769230762,128.10541425905294,116.20074112556232,135.24984950000015,126.91813700000004,120.23959979999994,119.14950049999997,125.61666666666666,10764898,12597589.85,59.35088245097791,NaN,1.5,2.75,NaN,NaN,2.921081164577162,0.8545204382884398,NaN,0.9063664195855614,1.6502127718785147,0.7438463522929533,30.12065345676349,4.737556996273431,NaN,NaN,NaN,-121381840
988723800,125.07001,127.14999,124.60001,127.05,NaN,NaN,100.29795688524591,137.1272058823529,135.12884950000014,126.81144950000004,120.17259999999995,119.7920005,122.06323747911507,121.6414469254625,122.94692384615377,128.53609176511102,117.35775592719651,135.12884950000014,126.81144950000004,120.17259999999995,119.7920005,126.26666666666667,10578102,12598444.95,62.89927330286416,NaN,1.5,2.75,NaN,NaN,2.894573938535937,0.8396355297802052,NaN,0.9246396387997906,1.8996459007926916,0.975006261992901,30.4543944699896,2.4596774193548363,NaN,NaN,NaN,-110803738
988810200,127.41,127.69,126,126.82001,NaN,NaN,100.01121491803279,137.10183823529408,135.00794955000015,126.72449340000003,120.14120019999994,120.613501,122.2497775779733,122.13464340875178,123.5600007692307,128.96244932523706,118.15755221322435,135.00794955000015,126.72449340000003,120.14120019999994,120.613501,126.83667,9572898,12435289.85,62.27014378696999,NaN,1.5,2.75,NaN,NaN,2.808532942926227,0.7698170380805398,NaN,0.8640554303520402,2.055075549932951,1.191020119580911,22.40254131215284,0.931173969850689,NaN,NaN,NaN,-120376636
988896600,126.13,126.14999,124.22,125.21001,NaN,NaN,99.72447295081967,137.07647058823525,134.88517150000015,126.64003100000004,120.13300039999994,121.33150099999997,122.36586512393514,122.42753546506114,124.14538538461532,128.35534527370478,119.93542549552586,134.88517150000015,126.64003100000004,120.13300039999994,121.33150099999997,125.19333333333331,9926199,12187374.8,57.903938571590636,NaN,1.5,2.75,NaN,NaN,2.7936384470029245,0.8144657207063165,NaN,0.6671824669342539,2.024998203248728,1.3578157363144743,22.708729398822037,0.5702891566265036,NaN,NaN,NaN,-130302835
988983000,123.64999,127.35001,123.44,127.34,NaN,NaN,99.43773098360657,137.05110294117642,134.77843400000015,126.57374350000003,120.16360039999994,121.94600099999998,122.56092923672199,122.89538923029342,124.76692461538454,128.2274118486193,121.30643738214977,134.77843400000015,126.57374350000003,120.16360039999994,121.94600099999998,126.04333666666665,12145301,11718759.85,61.72733517026387,NaN,1.5,2.75,NaN,NaN,2.8733792722170013,1.036398147539477,NaN,0.6323635390148556,2.148270160083044,1.5159066210681882,23.886545724744153,4.1721118969149344,NaN,NaN,NaN,-118157534
989242200,126.86,127.38,126.23,126.24001,NaN,NaN,99.15098901639345,137.02573529411762,134.65650905000015,126.44989360000004,120.18920039999995,122.59300149999997,122.70520691371328,123.21392454169404,124.939233076923,128.45248242342691,121.4259837304191,134.65650905000015,126.44989360000004,120.18920039999995,122.59300149999997,126.61667,7185199,11331129.75,58.75922641243571,NaN,1.5,2.75,NaN,NaN,2.7502807527729294,0.6341114397706019,NaN,0.4933711445773681,2.1326205517898984,1.6392494072125303,21.360580912081872,3.832875472939628,NaN,NaN,NaN,-125342733
989328600,126.86,127.10001,125.56,126.17999,NaN,NaN,98.86424704918034,137.0003676470588,134.54897150000016,126.33138100000004,120.16040019999996,123.17400099999998,122.84147291709708,123.49640696629461,124.98000230769223,128.53732142794937,121.42268318743511,134.54897150000016,126.33138100000004,120.16040019999996,123.17400099999998,126.28000000000002,6952602,11227044.8,58.593670413061375,NaN,1.5,2.75,NaN,NaN,2.6638328418605766,0.6192726691533287,NaN,0.36161501369545124,2.0912681743318444,1.7296531606363932,20.812516885620667,2.4437687748640107,NaN,NaN,NaN,-132295335
989415000,125.25,126.55,125.06,125.64999,NaN,NaN,98.57750508196722,136.97499999999997,134.44300270000016,126.22647470000004,120.14459999999995,123.62400099999998,122.9516108419168,123.70151011236179,125.068463076923,128.63082789620336,121.50609825764263,134.44300270000016,126.22647470000004,120.14459999999995,123.62400099999998,125.75332999999999,9507398,10808749.9,57.064693579607265,NaN,1.5,2.75,NaN,NaN,2.5799876388705347,0.8796019972670475,NaN,0.21048408731353074,1.9927582697783066,1.7822741824647759,20.343130437093198,1.5599660523763366,NaN,NaN,NaN,-141802733
989501400,127.25999,127.5,125.77,126.02,NaN,NaN,98.2907631147541,136.94963235294114,134.33654020000017,126.14261220000004,120.18599999999996,124.08850099999998,123.0719398285083,123.92231867308924,125.35923153846146,128.54816017090076,122.17030290602216,134.33654020000017,126.14261220000004,120.18599999999996,124.08850099999998,126.42999999999999,6872398,10516254.75,57.890825129592905,NaN,1.5,2.75,NaN,NaN,2.5278463789512107,0.6535024268026599,NaN,0.11208874715831518,1.92238511641267,1.8102963692543548,20.294682357622335,0.19080934965812918,NaN,NaN,NaN,-134930335
989587800,126,126.49001,124.39999,125.14999,NaN,NaN,98.00402114754098,136.9242647058823,134.23291515000017,126.08442460000003,120.19699959999997,124.40349999999997,123.15343199209622,124.03923975184264,125.63384615384606,127.9761614773865,123.29153083030563,134.23291515000017,126.08442460000003,120.19699959999997,124.40349999999997,125.34666333333332,7736602,10441424.9,55.20127752004261,NaN,1.5,2.75,NaN,NaN,2.496573066168981,0.7409527027292989,NaN,-0.027485555301719256,1.7759394251272056,1.8034249804289249,18.47491100839025,0.19213033384036982,NaN,NaN,NaN,-142666937
989847000,124.89999,125.44,124.46001,125.39999,NaN,NaN,97.71727918032788,136.8988970588235,134.1330401000002,126.01123700000004,120.23279939999996,124.79349899999995,123.24153230613166,124.16883501357192,125.80538384615375,127.68093972157135,123.92982797073614,134.1330401000002,126.01123700000004,120.23279939999996,124.79349899999995,125.10000000000001,7914000,10469689.95,55.83622259168413,NaN,1.5,2.75,NaN,NaN,2.388245704299768,0.7558963099953118,NaN,-0.11401425120208986,1.6609071664263126,1.7749214176284025,18.043078324201183,-1.2987091696182564,NaN,NaN,NaN,-134752937
989933400,125.55,126.5,124.85001,125.98,NaN,NaN,97.43053721311476,136.87352941176468,134.0524713500002,125.97088080000003,120.25759919999994,125.12949949999995,123.34892319608728,124.34132691704126,125.9792299999999,127.41731951187755,124.54114048812225,134.0524713500002,125.97088080000003,120.25759919999994,125.12949949999995,125.77667000000002,9782199,10412564.95,57.346663341175656,NaN,1.5,2.75,NaN,NaN,2.335513153992642,0.9394610306848555,NaN,-0.14143868257636738,1.5981230644079432,1.7395617469843105,15.031541606908078,-0.6623639282160539,NaN,NaN,NaN,-124970738
990019800,124.84,129.2,124.62,128.95,NaN,NaN,97.14379524590164,136.84816176470585,133.98269010000018,125.99788080000003,120.31499919999995,125.37699949999994,123.56857326682896,124.78024816303733,126.22307615384605,128.3522955258488,124.09385678184331,133.98269010000018,125.99788080000003,120.31499919999995,125.37699949999994,127.58999999999999,14916199,9533824.5,64.11466081974649,NaN,1.5,2.75,NaN,NaN,2.495833642993166,1.5645556513023708,NaN,0.022465873739051734,1.767644089158125,1.7451782154190734,20.381746103563756,2.986973645317968,NaN,NaN,NaN,-110054539
990106200,129.005,130.08,128.56,129.14999,NaN,NaN,96.85705327868853,136.82279411764702,133.90906505000018,126.01813070000004,120.35839899999995,125.55199949999994,123.7874523544043,125.19641405227186,126.54922923076914,129.04191941043254,124.05653905110574,133.90906505000018,126.01813070000004,120.35839899999995,125.55199949999994,129.26333,11828898,9434749.5,64.52287873882943,NaN,1.5,2.75,NaN,NaN,2.4261312399222263,1.2537585656089756,NaN,0.12087281397623473,1.8962692328893667,1.775396418913132,18.215392652193344,1.4213836971886282,NaN,NaN,NaN,-98225641
990192600,129.09,129.74001,128.10001,129.74001,NaN,NaN,96.57031131147542,136.7974264705882,133.8347963500002,126.00615580000003,120.41079919999997,125.81399999999994,124.02088598756491,125.62913747586502,126.75615307692298,129.7723948758852,123.73991127796076,133.8347963500002,126.00615580000003,120.41079919999997,125.81399999999994,129.19334333333333,6683301,9387579.6,65.76038393594612,NaN,1.5,2.75,NaN,NaN,2.3699790084992114,0.7119301550316548,NaN,0.19768377276398086,2.022501134868108,1.824817362104127,16.057330223200157,2.7724966118111163,NaN,NaN,NaN,-91542340
990451800,129.84,131.84,129.14999,131.64999,NaN,NaN,96.2835693442623,136.77205882352936,133.7650775500002,125.99921820000003,120.57659899999997,126.28449899999994,124.32006653707217,126.20255200197312,127.1276899999999,131.11685295951622,123.1385270404836,133.7650775500002,125.99921820000003,120.57659899999997,126.28449899999994,130.87999333333335,11532102,9541594.65,69.47261524498767,NaN,1.5,2.75,NaN,NaN,2.392838365034982,1.208613698549854,NaN,0.34071843360646925,2.2507154041122135,1.9099969705057442,16.02425441481216,4.335077217869489,NaN,NaN,NaN,-80010238
990538200,131.83,132.09,131.07001,131.48,NaN,NaN,95.99682737704919,132.09,133.6906025500002,125.98089320000003,120.84459899999996,126.77949899999994,124.60084824150071,126.7051660970233,127.60999692307684,132.0461999010675,123.17379394508617,133.6906025500002,125.98089320000003,120.84459899999996,126.77949899999994,131.54666999999998,8343199,9456489.55,68.75810366599737,NaN,1.5,2.75,NaN,NaN,2.294777767532484,0.8822723227140878,NaN,0.38424732221435587,2.390306123273689,2.006058801059333,16.117702040077347,4.639880990042249,NaN,NaN,NaN,-88353437
990624600,131.05,131.05,129.25,129.25,NaN,NaN,95.71008540983607,132.00415584415586,133.5962275500002,125.93620570000003,121.02919899999995,127.08349899999993,124.78316791830461,126.94753123064012,127.75691999999991,132.27341126843984,123.24042873155997,133.5962275500002,125.93620570000003,121.02919899999995,127.08349899999993,129.85,12331000,9660589.55,60.03508282825509,NaN,1.5,2.75,NaN,NaN,2.2901507841373063,1.276423135066327,NaN,0.2307852612502579,2.2945403776221553,2.0637551163718975,19.81886782784455,2.563085224567532,NaN,NaN,NaN,-100684437
990711000,129.47,130,128.55,129.63,NaN,NaN,95.42334344262295,131.9183116883117,133.5009400500002,125.92063070000002,121.26879919999996,127.37899899999995,124.97323976464561,127.20300444676964,128.0176884615384,132.54518271636962,123.49019420670719,133.5009400500002,125.92063070000002,121.26879919999996,127.37899899999995,129.39333333333335,7905398,9526339.55,60.94434753453904,NaN,1.5,2.75,NaN,NaN,2.2301400138417837,0.829846339037957,NaN,0.12793592053373848,2.2236750170390707,2.095739096505332,19.818857973542983,3.5797126312195413,NaN,NaN,NaN,-92779039
990797400,129.64999,129.7,127.89999,128.10001,NaN,NaN,95.13660147540985,131.83246753246755,133.4042526000002,125.91350580000002,121.47719959999996,127.49499949999995,125.09585820524775,127.28843354707729,128.16538230769223,132.56696348516775,123.7638011302167,133.4042526000002,125.91350580000002,121.47719959999996,127.49499949999995,128.56666666666666,7425000,9495144.65,55.471985668029305,NaN,1.5,2.75,NaN,NaN,2.1994164414245128,0.7819786084038225,NaN,-0.059981506828858056,2.0207622129692595,2.0807437197981176,20.88123868392771,2.1531261685108545,NaN,NaN,NaN,-100204039
991143000,128.226,128.35001,126.89999,127.08,NaN,NaN,94.84985950819673,131.74662337662338,133.3060588500002,125.83430580000002,121.71859979999998,127.60349949999996,125.1736676873949,127.26858273306993,128.275383076923,132.4874092253333,124.06335692851269,133.3060588500002,125.83430580000002,121.71859979999998,127.60349949999996,127.44333333333334,9012301,9407514.8,52.11241997390498,NaN,1.5,2.75,NaN,NaN,2.1458881241799044,0.9579895638325224,NaN,-0.2586845786165295,1.7573879965274557,2.016072575143985,21.70825786680153,0.8731544689633229,NaN,NaN,NaN,-109216340
991229400,126.59,127.09,125,125.3,NaN,NaN,94.56311754098361,131.66077922077923,133.1959182500002,125.75183710000002,121.87759959999998,127.51599949999995,125.17862189573235,127.08109866325375,128.21999846153838,132.56599781022766,123.8739991128491,133.1959182500002,125.75183710000002,121.87759959999998,127.51599949999995,125.79666666666668,10041801,9380699.75,46.787208971758815,NaN,1.5,2.75,NaN,NaN,2.1418961153099114,1.0704746199770439,NaN,-0.501642731856434,1.3890191603234427,1.8906618921798768,23.270111634121175,-2.8305544784800247,NaN,NaN,NaN,-119258141
991315800,125.42999,126.75999,125.25999,125.95,NaN,NaN,94.2763755737705,131.57493506493506,133.07926200000023,125.71946210000002,122.11259959999998,127.47249899999994,125.20887201746834,126.97337498103911,128.28153769230764,132.4717742438305,124.09130114078475,133.07926200000023,125.71946210000002,122.11259959999998,127.47249899999994,125.98999333333335,9875199,9395814.8,48.84299872085819,NaN,1.5,2.75,NaN,NaN,2.0960463927877746,1.0510210354508052,NaN,-0.6033825765903191,1.1364336714419778,1.739816248032297,18.27380944323411,-2.4777315120194743,NaN,NaN,NaN,-109382942
991402200,126.2,127.10001,125.12,126.73,NaN,NaN,93.98963360655739,131.48909090909092,132.96713075000022,125.68488710000001,122.40199979999997,127.54849849999997,125.26852409521467,126.95019641141634,128.3838461538461,132.34642683949014,124.42126546820205,132.96713075000022,125.68488710000001,122.40199979999997,127.54849849999997,126.31666999999999,8848301,9341919.9,51.2756221734714,NaN,1.5,2.75,NaN,NaN,2.087758079017219,0.947160872145778,NaN,-0.6016046233877423,0.987810468797619,1.5894150921853614,18.81843770331,-2.32003219361553,NaN,NaN,NaN,-100534641
991661400,126.8,127.42999,126.08,127.34,NaN,NaN,93.70289163934427,131.40324675324675,132.86070575000022,125.65984960000002,122.72639979999998,127.54849849999997,125.34975844442194,126.98732056271002,128.48846153846148,132.25881186014794,124.71811121677503,132.86070575000022,125.65984960000002,122.72639979999998,127.54849849999997,126.94999666666668,5634699,9016389.8,53.15183587232711,NaN,1.5,2.75,NaN,NaN,2.035060359087418,0.6249395961119604,NaN,-0.5445147473766148,0.9087716579645928,1.4532864053412076,18.849423382119443,-3.273824783427632,NaN,NaN,NaN,-94899942
991747800,127.49001,129.23,127.27,128.8,NaN,NaN,93.41614967213116,131.3174025974026,132.7537682500002,125.6265996,123.0127998,127.67649799999997,125.48506203483676,127.15995669959479,128.47692307692301,132.2424679950575,124.71137815878853,132.7537682500002,125.6265996,123.0127998,127.67649799999997,128.43333333333334,9115602,9112909.95,57.38181881325503,NaN,1.5,2.75,NaN,NaN,2.029698904866888,1.0002954105784838,NaN,-0.40026310185784664,0.9529575280188993,1.353220629876746,17.889200547892766,-2.0383328262853504,NaN,NaN,NaN,-85784340
991834200,128.83,128.83,127.36,127.73,NaN,NaN,93.12940770491804,131.23155844155843,132.6439807500002,125.5813996,123.2485998,127.75399849999997,125.57309881778434,127.21424653772861,128.367693076923,132.13118520387593,124.60420094997005,132.6439807500002,125.5813996,123.2485998,127.75399849999997,127.97333333333334,12064898,9368524.75,53.56466190318959,NaN,1.5,2.75,NaN,NaN,1.989720411662111,1.287811936452428,NaN,-0.36948846632307175,0.8913600469729062,1.260848513295978,18.21365136478918,-1.1760154738878112,NaN,NaN,NaN,-97849238
991920600,127.05,128.35001,127,128.19,NaN,NaN,92.84266573770492,131.1457142857143,132.5321182500002,125.54329960000001,123.44619979999997,127.88099899999997,125.6757223935575,127.30717543889732,128.24846153846147,131.9277632377461,124.56915983917683,132.5321182500002,125.54329960000001,123.44619979999997,127.88099899999997,127.84667,7355301,9260919.9,54.952054674665064,NaN,1.5,2.75,NaN,NaN,1.9440268108291028,0.7942300634735,NaN,-0.3129691148830449,0.8696371196921717,1.1826062345752166,16.054053955866564,-1.1108539689886583,NaN,NaN,NaN,-90493937
992007000,127.7,127.87,126.14,127,NaN,NaN,92.55592377049182,131.05987012987015,132.4155557500002,125.48486210000002,123.68539999999997,127.92999899999998,125.72765484871212,127.27792063519281,127.89076999999995,131.04433191743473,124.73720808256516,132.4155557500002,125.48486210000002,123.68539999999997,127.92999899999998,127.00333333333334,8170602,9325830.1,50.729410882033534,NaN,1.5,2.75,NaN,NaN,1.9515963243413095,0.8761259761744963,NaN,-0.3478621374471109,0.747778562766328,1.095640700213439,16.53710877414364,-0.8587118767594144,NaN,NaN,NaN,-98664539
992266200,126.71001,126.99001,125.41,126.10001,NaN,NaN,92.2691818032787,130.97402597402598,132.2918370500002,125.411331,123.89780019999998,127.97749999999999,125.74225701150772,127.16573866993636,127.47692461538456,129.98346141386352,124.9703878169056,132.2918370500002,125.411331,123.89780019999998,127.97749999999999,126.16667333333334,7012199,9289609.95,47.741471913126574,NaN,1.5,2.75,NaN,NaN,1.9257680154597876,0.7548432106129495,NaN,-0.41892090632388934,0.5719895673085773,0.9909104736324666,15.709245846375618,-0.7711598992760472,NaN,NaN,NaN,-105676738
992352600,124.86,126.74001,124.03999,125.88,NaN,NaN,91.98243983606558,130.88818181818183,132.1646745500002,125.3223185,124.0816002,128.0015005,125.74765869733095,127.04328736803765,127.21769384615381,129.63249602389513,124.8028916684125,132.1646745500002,125.3223185,124.0816002,128.0015005,125.55333333333333,9368500,9362334.95,47.01249359518551,NaN,1.5,2.75,NaN,NaN,1.981071728641231,1.000658494919582,NaN,-0.4645731057317438,0.41019409146778685,0.8747671971995307,15.176237911961914,0.4628890662410202,NaN,NaN,NaN,-115045238
992439000,126.17,126.58,124.64999,124.8,NaN,NaN,91.69569786885246,130.80233766233766,132.0324245500002,125.23016229999999,124.2936002,127.94250050000001,125.71049561116111,126.82964095203407,126.84615538461534,129.14552773020725,124.54678303902345,132.0324245500002,125.23016229999999,124.2936002,127.94250050000001,125.34333000000001,7629398,9254694.9,43.5010584717747,NaN,1.5,2.75,NaN,NaN,1.9774244623097144,0.824381363452619,NaN,-0.5457314924989866,0.1926028315757975,0.738334324074784,13.692816580491849,-0.9130607383882537,NaN,NaN,NaN,-122674636
992525400,124.17999,124.3,121.75,122,NaN,NaN,91.40895590163936,130.71649350649352,131.8835964500002,125.10109979999999,124.52580019999999,127.59500050000001,125.56498597935087,126.36967514707844,126.3769238461538,129.71591823116793,123.03792946113965,131.8835964500002,125.10109979999999,124.52580019999999,127.59500050000001,122.68333333333334,12603301,9139050,35.99470602839354,NaN,1.5,2.75,NaN,NaN,2.0540370007161632,1.379060296201465,NaN,-0.7534125621965694,-0.20343137867092764,0.5499811835256417,18.14344917646745,-3.732344354138723,NaN,NaN,NaN,-135277937
992611800,120.91,122.39999,120.39999,121.85001,NaN,NaN,120.39999,130.63064935064935,131.7338621500002,124.9599124,124.74580019999999,127.23000150000003,125.4193006468273,125.93923084735668,125.9746169230769,130.0556591388698,121.89357470728399,131.7338621500002,124.9599124,124.74580019999999,127.23000150000003,121.54999666666667,16821296,9388669.9,35.639929466661926,NaN,1.5,2.75,NaN,NaN,2.050177214950723,1.7916591145674425,NaN,-0.8586739866305693,-0.5233612997625698,0.3353126868679994,17.222122912077204,-4.31128474948956,NaN,NaN,NaN,-152099233
992871000,121.64999,122.44,120.91,121.25999,NaN,NaN,120.60948152542373,130.5448051948052,131.5884433500002,124.8087623,124.86999999999998,126.80600050000002,125.25619042538308,125.49358886189414,125.66384692307689,130.456325909546,120.8713679366078,131.5884433500002,124.8087623,124.86999999999998,126.80600050000002,121.53666333333332,11368801,9622944.9,34.2114409056084,NaN,1.5,2.75,NaN,NaN,2.0130216995971,1.1814263843493482,NaN,-0.9203473787087934,-0.8151215365179922,0.10522584219080108,16.300405799338417,-5.854045031055907,NaN,NaN,NaN,-163468034
992957400,122.38,122.89,120.89,121.78999,NaN,NaN,120.81897305084746,130.45896103896104,131.43567455000021,124.6663497,125.03979979999998,126.31300050000004,125.1202609969367,125.14086516076136,125.34384615384612,130.5544627036111,120.13322960408112,131.43567455000021,124.6663497,125.03979979999998,126.31300050000004,121.85666333333334,7732301,9432954.85,36.6670730539728,NaN,1.5,2.75,NaN,NaN,2.012091578197307,0.8197114396238205,NaN,-0.8778928977514593,-0.9921402799985231,-0.11424738224706374,14.080546745663845,-4.650442339309482,NaN,NaN,NaN,-155735733
993043800,121.19,122.86,121.10001,122.42999,NaN,NaN,121.02846457627119,130.3731168831169,131.2859495000002,124.5318996,125.19719959999996,125.86050000000004,125.0147601735274,124.88268657402219,125.01307615384613,130.3735016991114,119.65265060858087,131.2859495000002,124.5318996,125.19719959999996,125.86050000000004,122.13,8787199,9455154.85,39.59895304803795,NaN,1.5,2.75,NaN,NaN,1.9940843226117855,0.9293553769772476,NaN,-0.7633777787986625,-1.068469605745392,-0.3050918269467294,15.219875589012018,-4.493338013885634,NaN,NaN,NaN,-146948534
993130200,122.22,124.31,122.14999,123.82001,NaN,NaN,121.23795610169492,130.28727272727272,131.1486433000002,124.4040996,125.34059999999998,125.58900050000004,124.96790722554594,124.78147928125817,124.74230769230766,129.95890123364134,119.52571415097397,131.1486433000002,124.4040996,125.34059999999998,125.58900050000004,123.42666666666668,12259102,9451559.95,45.5001204097733,NaN,1.5,2.75,NaN,NaN,2.0059361567109435,1.297045362337251,NaN,-0.5600951031697771,-1.0052107059089508,-0.4451156027391737,17.17827025224365,-2.5039291338582705,NaN,NaN,NaN,-134689432
993216600,123.49001,123.599,122.16,122.85001,NaN,NaN,121.44744762711865,130.20142857142858,131.0139871000002,124.2545997,125.46300019999998,125.25000100000004,124.88485243238728,124.59752982590025,124.28461615384614,129.01859870835744,119.55063359933484,131.0139871000002,124.2545997,125.46300019999998,125.25000100000004,122.86967,12212000,9666890.05,42.387897406388625,NaN,1.5,2.75,NaN,NaN,1.9812271455173047,1.2632811521426168,NaN,-0.4611654494220644,-1.0215724145167542,-0.5604069650946898,17.016000230808896,-2.5773193832419206,NaN,NaN,NaN,-146901432
993475800,123.28,123.44,121.5,121.72,NaN,NaN,121.65693915254238,130.11558441558444,130.8683683500002,124.1015997,125.5204,124.93100050000002,124.76074057229366,124.3234793662907,123.82230846153844,128.28626797073807,119.35834895233882,130.8683683500002,124.1015997,125.5204,124.93100050000002,122.21999999999998,8406801,9715980.1,39.03793285771725,NaN,1.5,2.75,NaN,NaN,1.9782823494089257,0.8652550657241466,NaN,-0.4419886791025044,-1.1128928139728202,-0.6709041348703159,17.2314567646669,-3.304734667937716,NaN,NaN,NaN,-155308233
993562200,120.89999,122.39,120.571,121.55,NaN,NaN,121.86643067796611,130.02974025974027,130.7270558500002,123.93779979999998,125.59939979999999,124.65450050000004,124.63482917730175,124.05933847426301,123.31153923076921,127.13284330947268,119.49023515206575,130.7270558500002,123.93779979999998,125.59939979999999,124.65450050000004,121.50366666666666,8006398,9665684.95,38.54440575333483,NaN,1.5,2.75,NaN,NaN,1.9669050387368596,0.8283321918122316,NaN,-0.41153177198748103,-1.1853188498546672,-0.7737870778671861,17.245820077420326,-2.6041666666666665,NaN,NaN,NaN,-163314631
993648600,121.60001,122.24001,120.91,121.48,NaN,NaN,122.07592220338984,129.94389610389612,130.5864871000002,123.80459979999998,125.6438,124.46350050000004,124.51111038603501,123.81368719099987,122.88692384615382,126.16217378310289,119.61167390920475,130.5864871000002,123.80459979999998,125.6438,124.46350050000004,121.54333666666668,10105102,9668850,38.329527992649375,NaN,1.5,2.75,NaN,NaN,1.9214125359699412,1.0451193264969463,NaN,-0.3682815645258052,-1.2341390335244427,-0.8658574689986375,16.988980849342752,-0.42622950819671807,NaN,NaN,NaN,-173419733
993735000,122,123.94,121.92999,122.14999,NaN,NaN,122.28541372881357,129.85805194805195,130.4548933000002,123.66819979999998,125.60679979999999,124.27350000000004,124.41851742971991,123.65523983947608,122.58307615384614,125.29388337883061,119.87226892886166,130.4548933000002,123.66819979999998,125.60679979999999,124.27350000000004,122.67332666666667,10271000,9688640.05,41.680704829564405,NaN,1.5,2.75,NaN,NaN,1.959883069114945,1.0601075018779338,NaN,-0.2712161903672864,-1.2048777069577454,-0.933661516590459,11.7562166896212,0.24618791578269467,NaN,NaN,NaN,-163148733
993821400,122.8,124.00999,122.25999,122.60001,NaN,NaN,122.4949052542373,129.7722077922078,130.3234402500002,123.5402999,125.54580019999999,124.06700050000003,124.34720341286815,123.55474175952598,122.3307692307692,124.26710694043291,120.3944315211055,130.3234402500002,123.5402999,125.54580019999999,124.06700050000003,122.95666333333334,9824199,9737434.95,43.88635548708192,NaN,1.5,2.75,NaN,NaN,1.9527485641781632,1.0089103599095162,NaN,-0.1589286545532581,-1.1323223347820317,-0.9733936802287736,11.885830765250303,1.1050800845357116,NaN,NaN,NaN,-153324534
994080600,122.8,124.32001,122.62,124.13,NaN,NaN,122.70439677966102,129.68636363636364,130.2017465000002,123.43469989999998,125.5384002,123.90650050000004,124.33868563197136,123.60952825861874,122.27923076923076,123.97003504841084,120.5884264900507,130.2017465000002,123.43469989999998,125.5384002,123.90650050000004,123.69000333333334,8522301,9881815.05,50.71149546562203,NaN,1.5,2.75,NaN,NaN,1.9361236667368658,0.8624226376307255,NaN,0.026296932055270728,-0.9405225151596852,-0.9668194472149559,13.046752284311589,1.921348380109065,NaN,NaN,NaN,-144802233
994167000,123.98,124.10001,123.05,124.10001,NaN,NaN,122.91388830508475,129.6005194805195,130.0917778000002,123.34449999999997,125.5756002,123.67150100000003,124.3293258032666,123.65624080541696,122.44076999999999,124.37739635240982,120.50414364759015,130.0917778000002,123.34449999999997,125.5756002,123.67150100000003,123.75000666666666,3303100,9591189.95,50.58162558965491,NaN,1.5,2.75,NaN,NaN,1.874971976255661,0.34438896708536154,NaN,0.14791462930641908,-0.7819261605819321,-0.9298407898883512,13.053098533746187,1.364061207552164,NaN,NaN,NaN,-148105333
994339800,123.07001,123.64999,121.66,121.67999,NaN,NaN,123.12337983050848,129.51467532467532,129.9768965000002,123.24289989999997,125.57759999999999,123.36900050000004,124.22543028156987,123.46802644299629,122.42769153846152,124.38231214099818,120.47307093592485,129.9768965000002,123.24289989999997,125.57759999999999,123.36900050000004,122.32999333333333,5517801,9263835.1,41.373843236599235,NaN,1.5,2.75,NaN,NaN,1.9153318350945425,0.5956281540460495,NaN,0.07042547472994332,-0.841808946475922,-0.9122344212058653,17.703674816114333,-1.7283313092932175,NaN,NaN,NaN,-153623134
994426200,121.31,121.49001,119.05,119.05,NaN,NaN,123.33287135593221,129.42883116883118,129.8423027500002,123.09989979999996,125.49519999999998,122.91200050000005,124.02247223131224,123.04726201985379,122.25769230769228,124.8645670750146,119.65081754036996,129.8423027500002,123.09989979999996,125.49519999999998,122.91200050000005,119.86333666666667,11666199,9479380,34.10727838334134,NaN,1.5,2.75,NaN,NaN,1.9663788468735042,1.2306921971690132,NaN,-0.14135819647803005,-1.0889321668034029,-0.9475739703253728,19.652481417874352,-3.0932109814236077,NaN,NaN,NaN,-165289333
994685400,119.491,120.53999,119.2,119.7,NaN,NaN,123.54236288135593,129.342987012987,129.7163496500002,122.97429989999996,125.41479999999997,122.54700050000004,123.85296351635881,122.7284751608201,122.09692384615383,125.03596488211218,119.15788281019547,129.7163496500002,122.97429989999996,125.41479999999997,122.54700050000004,119.81333000000001,8339301,9487814.95,37.04995978260278,NaN,1.5,2.75,NaN,NaN,1.9323510720968256,0.8789485296611946,NaN,-0.21656953592395745,-1.2182858902303195,-1.001716354306362,20.153634702340383,-1.6595465001643084,NaN,NaN,NaN,-156950032
994771800,120.28999,120.64,118.21001,118.25999,NaN,NaN,123.75185440677966,129.25714285714287,129.5817121000002,122.83629979999998,125.26439979999998,122.15499950000003,123.63363122159964,122.3029051455039,121.77615461538458,125.34296304743162,118.20934618333754,129.5817121000002,122.83629979999998,125.26439979999998,122.15499950000003,119.03666666666668,8630699,9568739.95,33.48248942467136,NaN,1.5,2.75,NaN,NaN,1.9678967098041955,0.9019681844316398,NaN,-0.33512323074823347,-1.4206203927416539,-1.0854971619934204,20.560666805593982,-2.706713286713283,NaN,NaN,NaN,-165580731
994858200,118.10001,118.89,117.09,118.38,NaN,NaN,123.96134593220339,129.17129870129872,129.44720585000022,122.68669979999997,125.13379979999998,121.77999950000003,123.42760646781142,121.92929513164638,121.35769230769228,125.13727225873245,117.5781123566521,129.44720585000022,122.68669979999997,125.13379979999998,121.77999950000003,118.12,15329699,9866799.9,34.052401981055795,NaN,1.5,2.75,NaN,NaN,1.955904087675324,1.5536647297367405,NaN,-0.3743076481191532,-1.5533817221423618,-1.1790740740232086,20.670478197988658,-2.5518603885413307,NaN,NaN,NaN,-150251032
994944600,119.5,121.47,119.31,121.19,NaN,NaN,124.17083745762712,129.08545454545455,129.3323746000002,122.59459989999998,125.01659979999997,121.59949950000002,123.3398571945639,121.85888607148958,121.2299992307692,124.91013789041192,117.54986057112647,129.3323746000002,122.59459989999998,125.01659979999997,121.59949950000002,120.65666666666668,12004801,10085570.05,45.76882004124269,NaN,1.5,2.75,NaN,NaN,2.0369109385556583,1.190294741941731,NaN,-0.18916882777539024,-1.4155351087424464,-1.2263662809670561,25.559925326616238,-0.7859108297921308,NaN,NaN,NaN,-138246231
995031000,120.84,122.32001,120.62,122.24001,NaN,NaN,124.38032898305084,128.9996103896104,129.23154340000022,122.53309999999998,124.92499979999997,121.61150000000002,123.29672593203199,121.89518358849057,121.26999999999997,124.98174174338817,117.55825825661177,129.23154340000022,122.53309999999998,124.92499979999997,121.61150000000002,121.72667333333334,10433602,9977085.1,49.38730785785459,NaN,1.5,2.75,NaN,NaN,2.012846585801682,1.0457565406553464,NaN,0.014978873095810474,-1.207642689597293,-1.2226215626931034,25.877038521390933,-0.29363782270490796,NaN,NaN,NaN,-127812629
995290200,121.77,122.28,120.28999,120.71001,NaN,NaN,124.58982050847457,128.91376623376624,129.1193122000002,122.48400009999997,124.83499979999996,121.5545,123.19528609156015,121.78230991339623,121.20538538461535,124.92461814960477,117.48615261962594,129.1193122000002,122.48400009999997,124.83499979999996,121.5545,121.09333333333335,6915301,9481785.35,44.70639661355168,NaN,1.5,2.75,NaN,NaN,2.0112154011015617,0.7293247784817234,NaN,0.05565486149273258,-1.1530529858271876,-1.2087078473199202,26.71702904031974,-2.755167969064689,NaN,NaN,NaN,-134727930
995376600,120.2,121.95,119.83,121.84,NaN,NaN,124.7993120338983,128.8279220779221,128.9978872000002,122.44430009999998,124.72499979999996,121.58350050000001,123.14213761738132,121.78780420735849,121.23307769230766,124.96541469839914,117.50074068621618,128.9978872000002,122.44430009999998,124.72499979999996,121.58350050000001,121.20666666666665,7470301,9286860.35,48.582487637778414,NaN,1.5,2.75,NaN,NaN,2.018985729594308,0.8043946735992429,NaN,0.16136514384965528,-1.0070014175078512,-1.1683665613575065,26.182046037085374,-1.8211199177179713,NaN,NaN,NaN,-127257629
995463000,120.56,121.64,120.06,121.00999,NaN,NaN,125.00880355932203,128.74207792207793,128.8848121500002,122.40479989999999,124.62039939999995,121.5445005,123.05852398532716,121.71372666380054,121.14538538461535,124.84081600053568,117.44995476869502,128.8848121500002,122.40479989999999,124.62039939999995,121.5445005,120.90333,7709301,9285710.35,46.03005674424438,NaN,1.5,2.75,NaN,NaN,2.0019153203375715,0.8302327672755806,NaN,0.17684574917168838,-0.947309374892896,-1.1241551240645844,26.305564620568326,-0.5506246343379891,NaN,NaN,NaN,-134966930
995549400,122.17999,122.98,120.75999,122.07001,NaN,NaN,125.21829508474576,128.65623376623378,128.7759434500002,122.34929999999997,124.53819979999997,121.5265015,123.0197587310006,121.74765841010526,121.10461615384611,124.74625840324295,117.46297390444927,128.7759434500002,122.34929999999997,124.53819979999997,121.5265015,121.93666666666667,10082898,9350495.3,49.66704649284221,NaN,1.5,2.75,NaN,NaN,2.017493511742031,1.0783276902989298,NaN,0.25517485396683104,-0.8051865566060457,-1.0603614105728767,24.515792647705375,2.5367576648467023,NaN,NaN,NaN,-124884032
995635800,121.14999,121.94,120.92,121.34,NaN,NaN,125.42778661016949,128.5703896103896,128.67014345000018,122.29829999999997,124.45199999999997,121.402501,122.95388583958882,121.70883379961904,120.89000076923072,124.09594455689087,117.68405698157058,128.67014345000018,122.29829999999997,124.45199999999997,121.402501,121.40000000000002,6705801,9072830.25,47.30288480002952,NaN,1.5,2.75,NaN,NaN,1.955530403760457,0.7391079536619789,NaN,0.2539729116755973,-0.74289527097838,-0.9968681826539774,20.664098262179873,1.3700918964076862,NaN,NaN,NaN,-131589833
995895000,121.8,121.88,118.95,118.95,NaN,NaN,125.63727813559322,128.48454545454547,128.5464559500002,122.24829999999996,124.31059999999997,121.2075005,122.79687070862455,121.44608772346484,120.49384615384612,123.2575108943676,117.73018141332464,128.5464559500002,122.24829999999996,124.31059999999997,121.2075005,119.92666666666666,8065199,8865490.2,40.505034150738105,NaN,1.5,2.75,NaN,NaN,2.0251353749204237,0.9097296165303979,NaN,0.09646991824421958,-0.8762807848487029,-0.9727507030929224,23.92566562001277,0.5834686777835859,NaN,NaN,NaN,-139655032
995981400,119,119.2,116.75,117.8,NaN,NaN,116.75,128.3987012987013,128.4145184500002,122.18029989999995,124.16360019999996,121.01150050000001,122.60091499456084,121.09884127361104,120.19538538461535,123.20893602083062,117.18183474840008,128.4145184500002,122.18029989999995,124.16360019999996,121.01150050000001,117.91666666666667,12271000,9058700.15,37.69776401424347,NaN,1.5,2.75,NaN,NaN,2.0554828481403935,1.3546093586064882,NaN,-0.07182895013384438,-1.062536890760228,-0.9907079406263836,23.543722558915324,-0.4899476262882229,NaN,NaN,NaN,-151926032
996067800,117.92,119.48,117.46001,119.10001,NaN,NaN,116.60961576923077,128.31285714285715,128.30470600000018,122.13519999999995,124.03760059999996,120.88900100000001,122.46362460261727,120.90847639040999,120.19923230769226,123.2070468140265,117.19141780135801,128.30470600000018,122.13519999999995,124.03760059999996,120.88900100000001,118.68000666666667,12088898,9262825.15,42.54543647813555,NaN,1.5,2.75,NaN,NaN,2.0529476447017947,1.3050983694753213,NaN,-0.08155433175978355,-1.092650855326113,-1.0110965235663294,24.435843811535307,-1.7245564815578844,NaN,NaN,NaN,-139837134
996154200,119.06,120.85001,118.56,120.35001,NaN,NaN,116.46923153846154,128.227012987013,128.20645605000018,122.09129999999996,123.92500079999998,120.8325015,122.38073775545581,120.85528911513285,120.24923307692302,123.24377073766269,117.25469541618335,128.20645605000018,122.09129999999996,123.92500079999998,120.8325015,119.92000666666667,12930000,9404070.05,46.82943136274999,NaN,1.5,2.75,NaN,NaN,2.0698806700802375,1.3749365892909313,NaN,0.005615254058130237,-1.0040774559936665,-1.0096927100517967,20.870863962564624,-1.5461386169716451,NaN,NaN,NaN,-126907134
996240600,120.83,121.35001,119.91,120.81,NaN,NaN,116.32884730769231,128.14116883116884,128.1220685500002,122.03859999999995,123.76220079999999,120.76550200000001,122.31914019641833,120.85097586607257,120.44538769230763,123.218930644362,117.67184474025326,128.1220685500002,122.03859999999995,123.76220079999999,120.76550200000001,120.69000333333334,8481801,9314610.1,48.35549141505517,NaN,1.5,2.75,NaN,NaN,2.024889907931649,0.9105910938773487,NaN,0.09851776368044685,-0.8865455054512381,-0.985063269131685,20.259617845485582,0.08283488668421563,NaN,NaN,NaN,-118425333
996499800,121.19,121.35001,120.3,120.85001,NaN,NaN,116.18846307692307,128.0553246753247,128.04366235000018,121.97730009999995,123.5962012,120.67800200000002,122.26152724753918,120.85088387882756,120.63538846153838,123.14256865755063,118.12820826552614,128.04366235000018,121.97730009999995,123.5962012,120.67800200000002,120.83334,8547699,9250785.1,48.493963838126014,NaN,1.5,2.75,NaN,NaN,1.955255628793674,0.9239971426857597,NaN,0.16311677144800485,-0.781167304821679,-0.9442840762696838,18.91011975729796,-0.8125328299409109,NaN,NaN,NaN,-109877634
996586200,121,122.67999,120.8,121.35001,NaN,NaN,116.04807884615384,127.96948051948053,127.98478740000017,121.91960019999995,123.4284012,120.53900250000001,122.22578147312588,120.8984196998916,120.64769692307685,123.16718809560136,118.12820575055234,127.98478740000017,121.91960019999995,123.4284012,120.53900250000001,121.61,11918602,9420600.15,50.287821875720276,NaN,1.5,2.75,NaN,NaN,1.9498795124512693,1.265163769847508,NaN,0.23557301691319188,-0.649817805128194,-0.8853908220413859,18.20940406295265,0.28098506577844984,NaN,NaN,NaN,-97959032
996672600,121.97,122.7,121.55,122.11,NaN,NaN,115.90769461538461,127.88363636363637,127.90752490000017,121.90710019999995,123.23760139999999,120.43950200000002,122.22124102319937,121.01380829990192,120.63769615384606,123.13273957268841,118.14265273500372,127.90752490000017,121.90710019999995,123.23760139999999,120.43950200000002,122.12,11940801,9852485.2,52.96906451118875,NaN,1.5,2.75,NaN,NaN,1.9070302615618933,1.2119582783032246,NaN,0.32521078649060553,-0.4788773389281289,-0.8040881254187344,18.065394916805634,0.032759889181628706,NaN,NaN,NaN,-86018231
996759000,123.23,123.25,121.89,122.61,NaN,NaN,115.76731038461539,123.25,127.82963740000018,121.95240019999996,123.06020139999998,120.48600250000001,122.23648647326998,121.16582655705412,120.78384923076914,123.49218957899024,118.07550888254804,127.82963740000018,121.95240019999996,123.06020139999998,120.48600250000001,122.58333333333333,11070199,10130105.1,54.70014379042989,NaN,1.5,2.75,NaN,NaN,1.8679566714503295,1.0928019887967402,NaN,0.40358546693774233,-0.2996062917465565,-0.7031917586842988,17.520463710435006,1.0466457886929257,NaN,NaN,NaN,-74948032
996845400,122.36,122.36,120.89999,121.94,NaN,NaN,115.62692615384616,123.0732,127.76558740000017,121.97160019999995,122.91400139999998,120.6305025,122.22485955274959,121.23955736114421,120.79154153846146,123.5123762581685,118.07070681875442,127.76558740000017,121.97160019999995,122.91400139999998,120.6305025,121.73333000000001,10816500,10087620.15,51.94124856643282,NaN,1.5,2.75,NaN,NaN,1.8566747663467342,1.0722548865997894,NaN,0.3952056114804925,-0.20918474433368317,-0.6043903558141757,17.45326556667381,2.513661202185788,NaN,NaN,NaN,-85764532
997104600,121.35001,121.50999,120.10001,120.3,NaN,NaN,115.48654192307693,122.8964,127.69583740000016,121.99810029999995,122.72740139999998,120.66050250000004,122.14937486440647,121.1500757077019,120.73692692307684,123.46651847504107,118.0073353711126,127.69583740000016,121.99810029999995,122.72740139999998,120.66050250000004,120.63666666666667,8550398,10098175,45.84586996120565,NaN,1.5,2.75,NaN,NaN,1.8554829973219675,0.8467270571167562,NaN,0.2700850920695762,-0.2667839907272054,-0.5368690827967816,14.944254007022648,2.1222410865874366,NaN,NaN,NaN,-94314930
997191000,120.27,121.2,119.911,120.77,NaN,NaN,115.34615769230768,122.7196,127.60328115000017,122.02900039999994,122.58080119999998,120.78600300000002,122.09528173246896,121.1138780212541,120.63692615384608,123.25688851236956,118.0169637953226,127.60328115000017,122.02900039999994,122.58080119999998,120.78600300000002,120.627,8865102,10109895.15,47.73868142480713,NaN,1.5,2.75,NaN,NaN,1.8150199260846842,0.8768737824150431,NaN,0.21239250261221326,-0.271378454531515,-0.48377095714372825,13.283462472300766,1.402174525426151,NaN,NaN,NaN,-85449828
997277400,120.12,121.16,118.42999,118.53,NaN,NaN,115.20577346153846,122.5428,127.49639990000016,122.06420049999996,122.40980119999999,120.79350300000003,121.95546676256822,120.86779440018228,120.42077230769223,123.2298833988044,117.61166121658006,127.49639990000016,122.06420049999996,122.40980119999999,120.79350300000003,119.37333000000001,15183801,10102600.25,40.477258837584216,NaN,1.5,2.75,NaN,NaN,1.8803763599357777,1.5029596959456057,NaN,0.026556819803598364,-0.4505749323892303,-0.47713175219282866,16.79904959551485,-1.5122641036756013,NaN,NaN,NaN,-100633629
997363800,118.7,118.97,117.86,118.88,NaN,NaN,115.06538923076923,122.366,127.38814365000016,122.07950039999994,122.28140119999998,120.67800300000003,121.83486022285966,120.67848064778397,120.4153876923076,123.2359998924748,117.59477549214041,127.38814365000016,122.07950039999994,122.28140119999998,120.67800300000003,118.57,14118500,10208285.2,41.96272583852492,NaN,1.5,2.75,NaN,NaN,1.8253494770832221,1.383043255883956,NaN,-0.06462743687806399,-0.5579160482904086,-0.49328861141234465,15.521616759439032,-1.5975498716993684,NaN,NaN,NaN,-86515129
997450200,118.8,119.84,117.34,119.28999,NaN,NaN,114.925005,122.1892,127.28662485000017,122.13040029999993,122.14820099999999,120.53050200000004,121.73506139059066,120.54624344323312,120.53000230769223,123.0176341998983,118.04237041548616,127.28662485000017,122.13040029999993,122.14820099999999,120.53050200000004,118.82333,11173301,10245270.15,43.734119585113284,NaN,1.5,2.75,NaN,NaN,1.8735388001487063,1.090581393795653,NaN,-0.08773026330224654,-0.6029514405401528,-0.5152211772379063,15.478902832651393,-1.2908728762206925,NaN,NaN,NaN,-75341828
997709400,119.60001,119.85001,118.819,119.32001,NaN,NaN,114.78462076923077,122.0124,127.20166240000017,122.20100049999992,122.0000012,120.46100200000005,121.64035349292044,120.42945930578234,120.5469253846153,122.99814145385996,118.09570931537066,127.20166240000017,122.20100049999992,122.0000012,120.46100200000005,119.32967333333333,7435398,10271275,43.86921211846327,NaN,1.5,2.75,NaN,NaN,1.8133581715666556,0.7239021445730934,NaN,-0.09099872256549468,-0.6289695804447746,-0.5379708578792799,15.47597517733967,-1.6728469985292964,NaN,NaN,NaN,-67906430
997795800,120.14,120.35001,118.8,119.27,NaN,NaN,114.64423653846154,121.8356,127.11457490000016,122.28250049999991,121.83860120000001,120.33250200000005,121.54739845398238,120.31903460999355,120.4638476923076,123.00759016473604,117.92010521987915,127.11457490000016,122.28250049999991,121.83860120000001,120.33250200000005,119.47333666666667,13178102,10556665.05,43.68105951109618,NaN,1.5,2.75,NaN,NaN,1.7945475878833232,1.2483205574472593,NaN,-0.08656396985181247,-0.6461758201940455,-0.559611850342233,15.111670687734305,-2.3257718450577376,NaN,NaN,NaN,-81084532
997882200,119.23,119.61,118.08,118.24001,NaN,NaN,114.50385230769231,121.6588,127.00936870000018,122.32010059999992,121.62740140000001,120.19400300000004,121.41769694598307,120.12103226618464,120.26615615384607,123.05884447126384,117.4734678364283,127.00936870000018,122.32010059999992,121.62740140000001,120.19400300000004,118.64333666666666,8520602,10597230.1,39.88669303702161,NaN,1.5,2.75,NaN,NaN,1.775651331605943,0.8040404822388447,NaN,-0.13987620756297714,-0.7344571097959545,-0.5945809022329773,14.650776473486225,-3.564138324769596,NaN,NaN,NaN,-89605134
997968600,117.8,118.75,117,118.64999,NaN,NaN,114.36346807692307,121.482,126.89996240000019,122.34720049999991,121.44580120000002,120.02300200000005,121.30915941868962,119.98093300273848,120.09692384615374,122.99232573859675,117.20152195371074,126.89996240000019,122.34720049999991,121.44580120000002,120.02300200000005,118.13333,10734699,10629820.15,42.044703704677616,NaN,1.5,2.75,NaN,NaN,1.77381909363409,1.0098664745517825,NaN,-0.13437409699361036,-0.7625485234749902,-0.6281744264813799,14.5409781342459,-2.6980564211907456,NaN,NaN,NaN,-78870435
998055000,117.64999,117.87,116.00999,116.75,NaN,NaN,114.22308384615384,121.3052,126.7689468000002,122.33160049999991,121.21700120000003,119.79350200000003,121.13036885325081,119.67322509771577,119.74307692307681,123.03642076152862,116.44973308462501,126.7689468000002,122.33160049999991,121.21700120000003,119.79350200000003,116.87666333333334,11604602,10874760.2,35.6562972957221,NaN,1.5,2.75,NaN,NaN,1.8356891583745123,1.0671133695435417,NaN,-0.23940734521388518,-0.9274336079987364,-0.6880262627848512,16.306186027639836,-2.9509559434746446,NaN,NaN,NaN,-90475037
998314200,116.8,117.89999,116.55,117.83,NaN,NaN,114.08269961538461,121.1284,126.64575305000021,122.35950059999992,121.03360120000004,119.73750200000003,121.00094262371157,119.49767985031427,119.41384615384604,122.54671409987479,116.28097820781728,126.64575305000021,122.35950059999992,121.03360120000004,119.73750200000003,117.42666333333334,10417398,10992370.15,41.131743744287014,NaN,1.5,2.75,NaN,NaN,1.8009963613477618,0.9476935235846292,NaN,-0.21749434069997253,-0.9598941886598169,-0.7423998479598444,16.830267986250533,-2.43437939885733,NaN,NaN,NaN,-80057639
998400600,117.8,118.53999,115.8,115.82001,NaN,NaN,113.94231538461538,120.9516,126.51133750000021,122.36290069999991,120.82800120000003,119.63850250000003,120.79776879533073,119.14742557885577,118.89153923076911,121.98257342172494,115.80050503981329,126.51133750000021,122.36290069999991,120.82800120000003,119.63850250000003,116.71999999999998,14481398,11102890.05,35.138622737253755,NaN,1.5,2.75,NaN,NaN,1.868067335537208,1.3042908589372186,NaN,-0.3138628296589111,-1.1347283850334833,-0.8208655553745722,18.372264959538356,-2.2863325740318947,NaN,NaN,NaN,-94539037
998487000,116.75,117.42999,115.78,117.02,NaN,NaN,113.80193115384616,120.7748,126.38253125000021,122.36620069999992,120.65080120000005,119.53450200000002,120.6496209994354,118.94481361896474,118.51307769230758,121.19633721775267,115.82981816686248,126.38253125000021,122.36620069999992,120.65080120000005,119.53450200000002,116.74333,11752898,11086090.05,40.69434405073571,NaN,1.5,2.75,NaN,NaN,1.8524903829988362,1.0601481628773166,NaN,-0.2737472904225643,-1.1630496684027776,-0.8893023779802133,17.50180695794626,-1.564602960969044,NaN,NaN,NaN,-82786139
998573400,116.96001,117.52,116.49001,116.60001,NaN,NaN,113.66154692307693,120.598,126.2466250500002,122.39020079999992,120.48680140000005,119.34700200000002,120.49081272494773,118.72149898858714,118.22846307692296,120.8778915141972,115.57903463964873,126.2466250500002,122.39020079999992,120.48680140000005,119.34700200000002,116.87000666666665,8745301,10876855.1,39.42161855530854,NaN,1.5,2.75,NaN,NaN,1.7937403556417764,0.8040284548793888,NaN,-0.2529485428860666,-1.2054880565877966,-0.95253951370173,17.325436755543752,-2.254992225248745,NaN,NaN,NaN,-91531440
998659800,117.21001,119.13,116.74001,119.02,NaN,NaN,113.52116269230768,120.4212,126.1229750500002,122.47650079999993,120.42720140000004,119.25750200000002,120.43313379455762,118.74992765634074,118.09384769230759,120.36370534558223,115.82399003903295,126.1229750500002,122.47650079999993,120.42720140000004,119.25750200000002,118.29666999999999,11688301,11037180.1,49.267341623718,NaN,1.5,2.75,NaN,NaN,1.846329615953078,1.0589934108260135,NaN,-0.06353008108841884,-1.0319521150622535,-0.9684220339738346,21.525987035003563,-0.2514330999469413,NaN,NaN,NaN,-79843139
998919000,118.97,119.2,118.25999,118.31,NaN,NaN,113.38077846153845,120.2444,126.01171255000021,122.55110069999992,120.35640120000005,119.13050150000001,120.34987364575144,118.7080297843083,118.07692461538451,120.33678129209564,115.81706793867339,126.01171255000021,122.55110069999992,120.35640120000005,119.13050150000001,118.58999666666666,7428102,10981200.25,46.860927902337444,NaN,1.5,2.75,NaN,NaN,1.7815925005278583,0.6764380787974429,NaN,0.02204247046778174,-0.9408689458891075,-0.9629114163568893,21.770657929055304,-0.8048964534249968,NaN,NaN,NaN,-87271241
999005400,118.28,118.49001,116.58,116.58,NaN,NaN,113.24039423076923,120.0676,125.89445630000021,122.56640069999992,120.26280140000006,118.89200100000001,120.20203546356511,118.50536028104084,117.90000153846141,120.23939822606808,115.56060485085474,125.89445630000021,122.56640069999992,120.26280140000006,118.89200100000001,117.21667000000001,12046602,10987600.25,41.53714598533455,NaN,1.5,2.75,NaN,NaN,1.7907651790615826,1.0963815324460862,NaN,-0.027103693583216626,-0.99679103333591,-0.9696873397526934,23.167690410354776,-1.4039325605605073,NaN,NaN,NaN,-99317843
999091800,117.13,117.17999,115.17,115.53999,NaN,NaN,113.10001,119.8908,125.78903125000022,122.58880059999993,120.13780140000006,118.5635005,120.01921015126844,118.22294406379885,117.61153999999988,120.11337812860722,115.10970187139253,125.78903125000022,122.58880059999993,120.13780140000006,118.5635005,115.96332666666666,16181801,11199650.25,38.69137692282407,NaN,1.5,2.75,NaN,NaN,1.8064240948428982,1.4448487799875716,NaN,-0.11401729085408951,-1.1122089533203052,-0.9981916624662157,23.19723548926127,-2.6211548774677516,NaN,NaN,NaN,-115499644
999178200,114.85001,115.74001,112.03999,113.32001,NaN,NaN,112.95962576923077,119.714,125.67781880000022,122.57640069999992,119.95560180000008,118.099001,119.75649641984614,117.75599796248467,117.15000153846141,120.3399622231234,113.96004085379943,125.67781880000022,122.57640069999992,119.95560180000008,118.099001,113.70000333333333,17693104,11530795.5,33.426898882478,NaN,1.5,2.75,NaN,NaN,1.9416809452112622,1.534421801167144,NaN,-0.295089689509322,-1.3670537743528683,-1.0719640848435463,24.768790491696887,-2.937892933618847,NaN,NaN,NaN,-133192748
999264600,113.39999,114.77,113.13,114.14999,NaN,NaN,112.81924153846154,119.5372,125.55294375000022,122.55140069999992,119.76220140000007,117.70950049999999,119.53663342298944,117.41256863272423,116.75615461538449,120.06398613238636,113.44832309838262,125.55294375000022,122.55140069999992,119.76220140000007,117.70950049999999,114.01666333333333,15985699,11789255.45,36.884541657541575,NaN,1.5,2.75,NaN,NaN,1.9201323062676006,1.3559549258897432,NaN,-0.33037299533747033,-1.4849303290153841,-1.1545573336779138,24.42142843463857,-3.123151998642108,NaN,NaN,NaN,-117207049
999610200,113.85001,116.17,113.37,113.42,NaN,NaN,112.67885730769231,119.3604,125.42223125000022,122.51830069999993,119.57360120000007,117.36550049999998,119.29676544561731,117.03232400103622,116.3853846153845,120.01015712085692,112.76061210991207,125.42223125000022,122.51830069999993,119.57360120000007,117.36550049999998,114.32000000000001,24475392,12585505.15,35.15510864111559,NaN,1.5,2.75,NaN,NaN,1.9829799986770575,1.9447286150449035,NaN,-0.3712295671329575,-1.6185942925941106,-1.247364725461153,23.364203935133446,-2.0721894256441478,NaN,NaN,NaN,-141682441
999696600,113.7,114.19,111.95,113.7,NaN,NaN,112.53847307692307,119.1836,125.30385625000022,122.46680059999993,119.41320120000006,117.01200049999997,119.07728444774996,116.71495981046134,116.00461615384603,119.63778489099704,112.37144741669502,125.30385625000022,122.46680059999993,119.41320120000006,117.01200049999997,113.27999999999999,21477696,13216134.85,36.38716314928811,NaN,1.5,2.75,NaN,NaN,2.0013385702001245,1.625111747403213,NaN,-0.34813627550413484,-1.6825350698413217,-1.3343987943371869,21.925010974742758,-2.837121859511189,NaN,NaN,NaN,-120204745
999783000,112.64999,113.3,110.77,110.77,NaN,NaN,112.39808884615384,119.0068,125.17450315000023,122.39850049999994,119.19760120000007,116.62400049999997,118.75150858705388,116.14877316184597,115.54461615384602,120.0848477028712,111.00438460482084,125.17450315000023,122.39850049999994,119.19760120000007,116.62400049999997,111.61333333333334,21654096,13539649.6,29.970096269988744,NaN,1.5,2.75,NaN,NaN,2.0676715294715446,1.5993099260116748,NaN,-0.4902322647648387,-1.9471891252932352,-1.4569568605283965,24.355697002883307,-5.000008147512167,NaN,NaN,NaN,-141858841
999869400,110.02,111.25,108.63,108.72,NaN,NaN,112.25770461538461,118.83,125.04466565000024,122.29310059999993,118.94240120000008,116.11600049999996,118.35811609344393,115.44127095595587,114.8438469230768,120.44502624441189,109.2426676017417,125.04466565000024,122.29310059999993,118.94240120000008,116.11600049999996,109.53333333333335,33133904,14490419.8,26.45478684721614,NaN,1.5,2.75,NaN,NaN,2.1071235630807204,2.2866075971104713,NaN,-0.6711399058246319,-2.295881742809186,-1.6247418369845543,25.438159650261095,-8.65400772979331,NaN,NaN,NaN,-174992745
1000128600,107.7,110.35001,107.7,110.05,NaN,NaN,112.11732038461538,118.6532,124.91804065000024,122.15360059999992,118.70040140000009,115.65400099999995,118.03230761919123,114.92781657919816,114.39999999999988,120.51253452659714,108.28746547340262,124.91804065000024,122.15360059999992,118.70040140000009,115.65400099999995,109.36667,23408704,15102189.95,32.02541830429291,NaN,1.5,2.75,NaN,NaN,2.1459011657178113,1.5500204988482482,NaN,-0.649657093538679,-2.436813203907903,-1.787156110369224,22.397596035571205,-6.981658355168628,NaN,NaN,NaN,-151584041
1000733400,101,106.39999,100,104.3,NaN,NaN,111.97693615384615,118.4764,124.77883755000025,121.94010069999992,118.33440120000009,114.90300049999996,117.49378575177197,113.91564357165548,113.42153846153835,121.34675767873416,105.49631924434253,124.77883755000025,121.94010069999992,118.33440120000009,114.90300049999996,103.56666333333334,32393808,16350110.45,23.675957147855655,NaN,1.5,2.75,NaN,NaN,2.7104796538808245,1.9812592764472732,NaN,-0.9527943904697285,-2.9781490984563845,-2.025354707986656,34.409127943878616,-10.53353920054898,NaN,NaN,NaN,-183977849
1000819800,104.33,105.3,103.36,104.05,NaN,NaN,111.83655192307693,118.2996,124.62486880000024,121.7356006999999,117.93280120000009,114.14200049999997,116.96657846738876,112.97605846959306,112.45615307692294,121.56636762166474,103.34593853218115,124.62486880000024,121.7356006999999,117.93280120000009,114.14200049999997,104.23666666666668,22029200,16792665.35,23.390422671008253,NaN,1.5,2.75,NaN,NaN,2.655445392889337,1.3118346338033824,NaN,-1.0903375627621203,-3.3882766614393063,-2.297939098677186,34.85384872428423,-9.944600133685322,NaN,NaN,NaN,-206007049
1000906200,104.10001,104.5,98.56,101.95,NaN,NaN,111.69616769230768,118.1228,124.45446255000024,121.53270059999991,117.48980100000009,113.32749999999996,116.37769303729507,111.92595766296515,111.14307615384602,120.98205628213299,101.30409602555906,124.45446255000024,121.53270059999991,117.48980100000009,113.32749999999996,101.66999999999999,42772096,18505240.05,21.089599171398547,NaN,1.5,2.75,NaN,NaN,2.890056436254384,2.3113505085279886,NaN,-1.2324568836559626,-3.8385102032471394,-2.606053319591177,35.17941024342479,-10.03354129601647,NaN,NaN,NaN,-248779145
1000992600,100.39999,101.81,98.569,98.71001,NaN,NaN,111.55578346153845,117.946,124.27957510000024,121.30400069999992,117.03040140000009,112.33050099999996,115.68484272210704,110.667295980778,109.6353846153845,120.56570335066391,98.70506588010508,124.27957510000024,121.30400069999992,117.03040140000009,112.33050099999996,99.69633666666668,36212800,19779145.1,18.1269570162532,NaN,1.5,2.75,NaN,NaN,2.9251238336647853,1.8308576946533446,NaN,-1.439936796233399,-4.405974314882926,-2.9660375186495265,36.83818009469041,-13.52604586299132,NaN,NaN,NaN,-284991945
1001079000,94.05,98.99001,93.8,97.28,NaN,NaN,93.8,117.7692,124.09878760000024,121.04510069999994,116.59500140000007,111.35700099999997,114.96308418398519,109.39231541118009,108.15076923076911,120.10012826229335,96.20141019924488,124.09878760000024,121.04510069999994,116.59500140000007,111.35700099999997,96.69000333333334,49783504,21688090.2,16.992352594628414,NaN,1.5,2.75,NaN,NaN,3.086901416974444,2.2954305123648,NaN,-1.5587164191868643,-4.914433042633107,-3.3557166234462423,34.31151429363201,-14.230294480691235,NaN,NaN,NaN,-334775449
1001338200,99.729,101.16,99.06,100.7,NaN,NaN,93.19605263157895,117.5924,123.94088135000024,120.81490069999994,116.21500140000008,110.50050099999996,114.4037475493191,108.56447584821056,107.00923153846142,118.7504319714412,95.26803110548164,123.94088135000024,120.81490069999994,116.21500140000008,110.50050099999996,100.30666666666667,25549808,22444710.7,28.516232309257873,NaN,1.5,2.75,NaN,NaN,3.143551315761983,1.1383442781465658,NaN,-1.3026048571973883,-4.9839726949429775,-3.681367837745589,44.889013796160754,-11.433597185576078,NaN,NaN,NaN,-309225641
1001424600,100.75101,102,99.89999,101.75,NaN,NaN,92.59210526315789,117.4156,123.78853760000024,120.57460069999993,115.88480160000009,109.79700049999997,113.90752215522816,107.91547814838098,106.11923076923065,117.56230167912202,94.6761598593393,123.78853760000024,120.57460069999993,115.88480160000009,109.79700049999997,101.21666333333333,25466192,22993950.4,31.653452965565762,NaN,1.5,2.75,NaN,NaN,3.069012650350413,1.1075170450050202,NaN,-0.9732235179070647,-4.89789723512942,-3.9246737172223556,46.02672873316046,-8.142999006951337,NaN,NaN,NaN,-283759449
1001511000,102.35001,102.39999,100.42999,101.39,NaN,NaN,91.98815789473684,117.2388,123.62876885000023,120.33940069999993,115.54500160000009,109.01550049999996,113.41663893345451,107.29400403901137,105.13769307692299,115.82075950815846,94.45462664568751,123.62876885000023,120.33940069999993,115.54500160000009,109.01550049999996,101.40666,18587504,23335680.7,31.14870393100793,NaN,1.5,2.75,NaN,NaN,2.990511746753955,0.7965271825132575,NaN,-0.7029495484812225,-4.8033606528238835,-4.100411104342661,45.150659666409574,-6.742089771891094,NaN,NaN,NaN,-302346953
1001597400,101.25,102.28999,100,102.27,NaN,NaN,91.38421052631578,117.062,123.45152510000024,120.09160069999994,115.1666016000001,108.29899999999995,112.97951583802492,106.81552746386743,104.28000076923067,113.90336158630579,94.65663995215554,123.45152510000024,120.09160069999994,115.1666016000001,108.29899999999995,101.51999666666666,20536800,23925255.65,33.922489788702876,NaN,1.5,2.75,NaN,NaN,2.9404744791286723,0.8583732730145353,NaN,-0.40315507412328255,-4.604354946996764,-4.201199872873482,45.69140901175888,-7.069513857337575,NaN,NaN,NaN,-281810153
1001683800,102.98,109.92,102.5,104.44,NaN,NaN,90.78026315789474,116.8852,123.29614700000023,119.86780059999995,114.81060140000008,107.56999999999996,112.64463286398473,106.5892867530229,103.56769307692298,111.52281206005159,95.61257409379436,123.29614700000023,119.86780059999995,114.81060140000008,107.56999999999996,105.62,21787696,24430225.4,40.308572242275375,NaN,1.5,2.75,NaN,NaN,3.2768691591909103,0.8918336054320646,NaN,-0.01732978262525009,-4.2228621011550445,-4.205532318529794,47.23617962106286,0.13422818791946364,NaN,NaN,NaN,-260022457
1001943000,103.89999,104.32001,102.83,104.27,NaN,NaN,90.17631578947368,116.7084,123.14921575000024,119.65840049999996,114.4818012000001,106.86799999999997,112.31621588892651,106.36840230035405,103.06769307692298,109.88492787876261,96.25045827508335,123.14921575000024,119.65840049999996,114.4818012000001,106.86799999999997,103.80667,20457600,25081700.3,39.98256639541295,NaN,1.5,2.75,NaN,NaN,3.1578070763915593,0.8156384836477772,NaN,0.25289852378263333,-3.8894091638015027,-4.142307687584136,35.79148288977936,0.2114368092263324,NaN,NaN,NaN,-280480057
1002029400,104,105.58,103.64999,105.58,NaN,NaN,89.57236842105263,116.5316,123.00727200000024,119.44080049999995,114.1566012000001,106.31799999999996,112.052050559949,106.293316366987,102.82615461538451,109.01913886855326,96.63317036221576,123.00727200000024,119.44080049999995,114.1566012000001,106.31799999999996,104.93666333333333,19833600,25471050.2,43.75742124230702,NaN,1.5,2.75,NaN,NaN,3.0701072852207334,0.7786722512132618,NaN,0.5303808006270971,-3.479331686800265,-4.009712487427362,36.442427877004796,3.560568906326626,NaN,NaN,NaN,-260646457
1002115800,104.60001,107.881,104.35001,107.35001,NaN,NaN,88.96842105263157,116.3548,122.85089705000024,119.25190049999996,113.88340160000011,105.90850099999996,111.86765681250002,106.39395385584538,102.61846307692298,107.9495904131254,97.28733574072055,122.85089705000024,119.25190049999996,113.88340160000011,105.90850099999996,106.52700666666665,32070192,26265469.75,48.473117369863004,NaN,1.5,2.75,NaN,NaN,3.103027479133538,1.2210020344296335,NaN,0.8260115645416457,-2.977198031750305,-3.8032095962919508,34.46380894477769,8.752911685451151,NaN,NaN,NaN,-228576265
1002202200,108.28999,108.97,106.75,107.44,NaN,NaN,88.36447368421052,116.178,122.69794080000024,119.06450059999996,113.59080140000009,105.61450049999996,111.69402321200982,106.49357729814582,102.86000153846145,108.73116200036793,96.98884107655496,122.69794080000024,119.06450059999996,113.59080140000009,105.61450049999996,107.71999999999998,32675504,27014589.75,48.70858352634948,NaN,1.5,2.75,NaN,NaN,3.039954087766857,1.2095502579305317,NaN,1.0084223963985446,-2.5426816007937703,-3.551103997192315,25.3454089484807,10.444078947368418,NaN,NaN,NaN,-195900761
1002288600,107.25,107.62,105.521,107.23,NaN,NaN,87.76052631578948,116.0012,122.55338770000024,118.88030069999995,113.30860140000009,105.26850099999997,111.51896347820552,106.56371279356051,103.10461692307685,109.40314227168663,96.80609157446706,122.55338770000024,118.88030069999995,113.30860140000009,105.26850099999997,106.79033333333335,29830192,27706814.4,48.15555095688773,NaN,1.5,2.75,NaN,NaN,2.9727430814977964,1.076637377698679,NaN,1.0888638314578096,-2.190024207870053,-3.2788880393278625,21.955759573331974,6.484607745779544,NaN,NaN,NaN,-225730953
1002547800,106.27901,107.3,105.87,106.53,NaN,NaN,87.15657894736842,115.8244,122.41400645000023,118.68540069999996,113.06020140000008,104.92400099999998,111.32331785160923,106.56050205131666,103.45692461538452,109.96653076787841,96.94731846289064,122.41400645000023,118.68540069999996,113.06020140000008,104.92400099999998,106.56666666666668,12971199,27131604.75,46.269708534963556,NaN,1.5,2.75,NaN,NaN,2.8625471471050963,0.4780844745278106,NaN,1.0674235549337672,-1.9446085956606538,-3.012032150594421,17.102016152261776,4.697788697788699,NaN,NaN,NaN,-238702152
1002634200,106.61,106.75,105.60001,105.96001,NaN,NaN,86.55263157894737,115.6476,122.28896275000022,118.49350089999996,112.82340160000007,104.53700149999997,111.11299205350691,106.50331233214365,104.01461692307683,110.0250598529495,98.00417399320416,122.28896275000022,118.49350089999996,112.82340160000007,104.53700149999997,106.10334,15976301,26856535,44.73351494392682,NaN,1.5,2.75,NaN,NaN,2.7402216365975893,0.594875735086451,NaN,0.989113790363489,-1.7756399126400595,-2.7647537030035485,17.86978709386567,4.507357727586544,NaN,NaN,NaN,-254678453
1002720600,105.8,108.55,105.52,108.32001,NaN,NaN,85.94868421052631,115.4708,122.16696905000022,118.32270109999996,112.60780160000007,104.41450199999997,111.00346334552626,106.67633115765378,104.86384846153837,109.86272367232836,99.86497325074838,122.16696905000022,118.32270109999996,112.60780160000007,104.41450199999997,107.46333666666665,19987392,26773199.8,51.86013353330507,NaN,1.5,2.75,NaN,NaN,2.760920091126333,0.7465447592857392,NaN,1.0639951860941546,-1.4347597203858555,-2.49875490648001,19.806608205340844,5.915723085948959,NaN,NaN,NaN,-234691061
1002807000,108.95,110.3,108.95,110,NaN,NaN,85.34473684210526,115.294,122.06689095000023,118.16290109999996,112.40080140000008,104.47850199999998,110.96411184178012,106.99287104740104,105.57923307692297,110.65110999106585,100.5073561627801,122.06689095000023,118.16290109999996,112.40080140000008,104.47850199999998,109.75,23008608,26266935,56.19090558027253,NaN,1.5,2.75,NaN,NaN,2.705139370331595,0.8759532849949947,NaN,1.1851467169697862,-1.0173215102677773,-2.2024682272375635,20.427067576977333,5.323630792799696,NaN,NaN,NaN,-211682453
1002893400,109.14999,109.89,107.3,109.5,NaN,NaN,84.7407894736842,115.1172,121.98314095000023,117.96840109999995,112.17460140000007,104.45100199999997,110.90669569112208,107.23164523336284,106.17538692307683,111.12721596059917,101.22355788555448,121.98314095000023,117.96840109999995,112.17460140000007,104.45100199999997,108.89666666666666,31361504,26664575,54.616092335061815,NaN,1.5,2.75,NaN,NaN,2.704772272450767,1.1761486541600608,NaN,1.1871254506665223,-0.7185614139044105,-1.9056868645709328,19.39108100496214,5.015824302292131,NaN,NaN,NaN,-243043957
1003152600,108.63,109.45,108.06,109.3,NaN,NaN,84.13684210526316,114.9404,121.89401595000022,117.76990119999995,111.94360120000006,104.70100199999997,110.84368801696043,107.428631401614,106.78384846153835,111.14247680125965,102.42522012181706,121.89401595000022,117.76990119999995,111.94360120000006,104.70100199999997,108.93666666666667,16875008,25888635,53.964589099619126,NaN,1.5,2.75,NaN,NaN,2.6144313958471406,0.6518307357649409,NaN,1.1307448554746269,-0.4922557952276492,-1.623000650702276,19.415237719511236,3.523394582307254,NaN,NaN,NaN,-259918965
1003239000,109.8,110.619,108.95,109.99001,NaN,NaN,83.5328947368421,114.7636,121.78927850000024,117.57240119999994,111.71640120000008,104.99800249999996,110.81021044766786,107.6725722205079,107.37769538461528,111.18305488263556,103.572335886595,121.78927850000024,117.57240119999994,111.71640120000008,104.99800249999996,109.85300333333333,15883602,25581355.1,55.918317490554536,NaN,1.5,2.75,NaN,NaN,2.5469005818580586,0.6209054187281893,NaN,1.0949624902304627,-0.25429753791419785,-1.3492600281446605,18.825687487805737,2.4592452296930394,NaN,NaN,NaN,-244035363
1003325400,111.07001,111.14999,107.64999,107.64999,NaN,NaN,82.92894736842105,114.5868,121.66580970000024,117.33240119999995,111.42720100000008,105.28300199999997,110.68628023403382,107.67042153284048,107.6246176923076,111.03112481391886,104.21811057069633,121.66580970000024,117.33240119999995,111.42720100000008,105.28300199999997,108.81665666666667,28601696,24872835.1,48.414287271049396,NaN,1.5,2.75,NaN,NaN,2.61497911172534,1.1499170032289563,NaN,0.8781013902763486,-0.25163329029922465,-1.1297346805755732,21.9804747672171,0.19544862248697392,NaN,NaN,NaN,-272637059
1003411800,107.82001,108.16,106.75,107.42,NaN,NaN,82.32499999999999,114.41,121.53634720000024,117.09180119999995,111.12340100000009,105.71850149999997,110.55819081309131,107.64657186304615,107.86692538461529,110.6811247821134,105.05272598711717,121.53634720000024,117.09180119999995,111.12340100000009,105.71850149999997,107.44333333333333,16517398,23888065,47.73623571744645,NaN,1.5,2.75,NaN,NaN,2.52890917517353,0.6914498097690206,NaN,0.6917676791847664,-0.26502508159461513,-0.9567927607793816,22.019026938424524,0.17718921943485752,NaN,NaN,NaN,-289154457
1003498200,107,107.91,106.00999,107.35001,NaN,NaN,81.72105263157894,114.2332,121.40450350000023,116.87280129999995,110.8316012000001,106.22200199999997,110.43237980081322,107.61832787608937,108.00307999999993,110.51675111722453,105.48940888277532,121.40450350000023,116.87280129999995,110.8316012000001,106.22200199999997,107.08999999999999,21916096,22494694.6,47.5181334057637,NaN,1.5,2.75,NaN,NaN,2.483987805518278,0.9742784416375228,NaN,0.5429700127954353,-0.2780802447850874,-0.8210502575805227,21.989793711881315,0.769745611564814,NaN,NaN,NaN,-311070553
1003757400,107.3,109.57001,107.21001,109.47,NaN,NaN,81.1171052631579,114.0564,121.29591600000023,116.67120129999995,110.6150012000001,106.66050199999998,110.39463941646761,107.7946776021761,108.16615615384609,110.7628935816572,105.56941872603498,121.29591600000023,116.67120129999995,110.6150012000001,106.66050199999998,108.75000666666665,17570896,22095749,54.325353551236965,NaN,1.5,2.75,NaN,NaN,2.4751315336955435,0.7952161295822106,NaN,0.564021300496767,-0.116023631959564,-0.680044932456331,24.09308668787293,3.3125610312796328,NaN,NaN,NaN,-293499657
1003843800,109.96001,110.28,108.379,108.91,NaN,NaN,80.51315789473684,113.8796,121.19640350000023,116.47930119999995,110.37780120000008,107.01850199999997,110.33641826288064,107.90089878292123,108.279233076923,110.86764957859994,105.69081657524607,121.19640350000023,116.47930119999995,110.37780120000008,107.01850199999997,109.18966666666664,22064496,21925664.2,52.39220126789777,NaN,1.5,2.75,NaN,NaN,2.434122138431576,1.0063319313263952,NaN,0.5181108593258654,-0.032406358298999294,-0.5505172176248647,24.064512273786985,0.5446731402628197,NaN,NaN,NaN,-315564153
1003930200,108.98,109.45,108.22,108.62,NaN,NaN,79.90921052631579,113.7028,121.06450350000023,116.29470119999996,110.17960120000009,107.38000199999996,110.26910774276767,107.9693846131192,108.38615615384609,110.90630779301144,105.86600451468074,121.06450350000023,116.29470119999996,110.17960120000009,107.38000199999996,108.76333333333334,16065398,21799558.9,51.37269359870221,NaN,1.5,2.75,NaN,NaN,2.348113414257892,0.7369597739888214,NaN,0.4486866947310146,0.01034115078890352,-0.43834554394211106,20.78045290950485,-1.2545454545454504,NaN,NaN,NaN,-331629551
1004016600,107.45,110.60001,106.74001,110.57001,NaN,NaN,79.30526315789473,113.526,120.94961920000023,116.14740129999997,110.01340140000009,107.79500249999997,110.28090783128658,108.21706322139356,108.69692615384609,111.22124918391596,106.17260312377623,120.94961920000023,116.14740129999997,110.01340140000009,107.79500249999997,109.30334333333333,27504000,22147918.9,57.37855789907478,NaN,1.5,2.75,NaN,NaN,2.4561053132394712,1.2418322517877742,NaN,0.5100934706475231,0.19927129436729274,-0.3108221762802303,21.453093708274096,0.9771780821917775,NaN,NaN,NaN,-304125551
1004103000,109.95,111.78999,109.67,110.32001,NaN,NaN,78.70131578947368,113.3492,120.85528175000023,115.99110139999995,109.8340018000001,108.08900299999996,110.2824412496675,108.41734386697513,109.03231076923069,111.13659842036563,106.92802311809575,120.85528175000023,115.99110139999995,109.8340018000001,108.08900299999996,110.59333333333332,18623296,21989698.9,56.41652595096132,NaN,1.5,2.75,NaN,NaN,2.432097076579509,0.8469100047568182,NaN,0.5087213960202156,0.3250795687450392,-0.1836418272751764,21.294905481874753,0.9332204940530643,NaN,NaN,NaN,-322748847
1004365800,110.16,110.55,107.45,107.45,NaN,NaN,78.09736842105262,113.1724,120.74159425000023,115.79830139999996,109.59660160000008,108.24800299999995,110.17136512222956,108.32521587964416,108.96538692307686,111.20689718009227,106.72387666606146,120.74159425000023,115.79830139999996,109.59660160000008,108.24800299999995,108.48333333333333,18733808,21903509.3,46.73007971281722,NaN,1.5,2.75,NaN,NaN,2.4798044282524008,0.8552879697683877,NaN,0.2997102841754855,0.19099602794418047,-0.10871425623130501,26.40573160072862,-2.3093097273106853,NaN,NaN,NaN,-341482655
1004452200,107.35001,107.7,105.56,106.16,NaN,NaN,105.56,112.9956,120.62317550000023,115.58650139999996,109.33440160000008,108.27700299999995,110.0140566860637,108.11900484348757,108.67000230769226,111.27146292707498,106.06854168830954,120.62317550000023,115.58650139999996,109.33440160000008,108.27700299999995,106.4733333333333,26197904,22221724.5,43.14438432465586,NaN,1.5,2.75,NaN,NaN,2.4555326833772293,1.1789320851313767,NaN,0.07166120094264802,-0.019137755052994976,-0.090798955995643,26.473421273645332,-1.3841060273205839,NaN,NaN,NaN,-367680559
1004538600,106.89999,107.86,105.8,105.8,NaN,NaN,105.99555555555555,112.8188,120.49155050000023,115.35650139999996,109.08560140000007,108.19950249999995,109.84879956112002,107.8981472393459,108.38538692307687,111.34613690888484,105.42463693726889,120.49155050000023,115.35650139999996,109.08560140000007,108.19950249999995,106.48666666666666,28130496,22024739.7,42.17186738061312,NaN,1.5,2.75,NaN,NaN,2.4272803488502848,1.27722263160277,NaN,-0.09717870717525587,-0.21227233996471284,-0.11509363278945697,23.89863293586551,-1.5080990504561576,NaN,NaN,NaN,-395811055
1004625000,106.60001,109.00999,105.69901,108.50999,NaN,NaN,106.43111111111111,112.642,120.37285045000023,115.16430129999998,108.88280140000006,108.25300199999995,109.79629722538982,107.95641797845582,108.32461692307687,111.23986234056431,105.40937150558943,120.37285045000023,115.16430129999998,108.88280140000006,108.25300199999995,107.73966333333334,29807296,21881329.3,51.106451280744004,NaN,1.5,2.75,NaN,NaN,2.4904017525038356,1.3622251002821844,NaN,-0.023915504750729052,-0.1449880137278683,-0.12107250897713924,28.46405796471825,1.0805588187649022,NaN,NaN,NaN,-366003759
1004711400,108.44,109.38,107.87,109.25,NaN,NaN,106.86666666666667,112.4652,120.25910045000022,114.97490129999997,108.73280140000006,108.35400199999995,109.7748738047863,108.07961626622193,108.26769307692302,111.07763734226793,105.45774881157811,120.25910045000022,114.97490129999997,108.73280140000006,108.35400199999995,108.83333333333333,17577904,21268714.9,53.23137969979798,NaN,1.5,2.75,NaN,NaN,2.4203730558964183,0.8264676113553058,NaN,0.07158764581775176,-0.031587951704949546,-0.1031755975227013,28.625056453748453,-0.2009683018178486,NaN,NaN,NaN,-348425855
1004970600,110.12,111.09,109.95,110.67999,NaN,NaN,107.30222222222223,112.2884,120.14828165000023,114.81170119999997,108.58980120000005,108.56150149999993,109.81036855753977,108.32727090753413,108.50076999999996,111.55880875276007,105.44273124723985,120.14828165000023,114.81170119999997,108.58980120000005,108.56150149999993,110.57333000000001,15991301,21419720,57.11042280289202,NaN,1.5,2.75,NaN,NaN,2.3789178376181033,0.7465690961413127,NaN,0.2198936810146005,0.1716915037455493,-0.048202177269051176,27.356073527342716,1.6251859333394612,NaN,NaN,NaN,-332434554
1005057000,110.35001,112.48,109.85001,112.39999,NaN,NaN,107.73777777777778,112.1116,120.04301600000025,114.67470099999997,108.52140080000005,108.88350049999994,109.91192233959704,108.7151489163404,108.88384615384611,112.50093553593815,105.26675677175406,120.04301600000025,114.67470099999997,108.52140080000005,108.88350049999994,111.57666666666667,23245904,21783200.15,61.27128441109314,NaN,1.5,2.75,NaN,NaN,2.396851563502525,1.067148253696783,NaN,0.41152767241032134,0.4662074132438505,0.054679740833529174,28.171758253687567,3.480012888970722,NaN,NaN,NaN,-309188650
1005143400,111.77,113.12,111.64,112.25,NaN,NaN,108.17333333333333,111.9348,119.93035975000025,114.53840099999998,108.42600080000004,109.07999999999996,110.00361165961284,109.05180140049845,109.2607684615384,113.16942802025568,105.35210890282113,119.93035975000025,114.53840099999998,108.42600080000004,109.07999999999996,112.33666666666664,19716800,21769670.55,60.718102161165284,NaN,1.5,2.75,NaN,NaN,2.331362166109488,0.9057004310062928,NaN,0.4999966688890756,0.6796755769448737,0.17967890805579806,28.08157083626439,1.5193902939865915,NaN,NaN,NaN,-328905450
1005229800,112.87,114.08,111.89999,112.60001,NaN,NaN,108.6088888888889,111.758,119.82328170000024,114.41640109999999,108.34600080000004,109.21000049999995,110.10543120237313,109.3897260290224,109.5015384615384,113.79842131138251,105.20465561169429,119.82328170000024,114.41640109999999,108.34600080000004,109.21000049999995,112.86,22747808,21756630.55,61.589593325053265,NaN,1.5,2.75,NaN,NaN,2.320551297101667,1.0455574886801577,NaN,0.5499353925699499,0.8670981487682354,0.3171627561982855,26.531387404639297,2.0667148235392667,NaN,NaN,NaN,-306157642
1005316200,112.25,112.96001,111.44,112.72,NaN,NaN,109.04444444444445,111.5812,119.71235045000024,114.32360109999998,108.22000080000004,109.37100049999995,110.20796331208399,109.70689497863931,109.79461538461533,114.3988729821118,105.19035778711886,119.71235045000024,114.32360109999998,108.22000080000004,109.37100049999995,112.37333666666666,15897500,20983430.35,61.90164465551342,NaN,1.5,2.75,NaN,NaN,2.2633697758801192,0.7576215964135721,NaN,0.5571734642698634,1.0136295865356146,0.45645612226575133,26.412748360147656,4.904606793857604,NaN,NaN,NaN,-290260142
1005575400,111,112.64999,110,112.03,NaN,NaN,109.48,111.4044,119.59265670000025,114.22540099999998,108.09440080000002,109.50750049999995,110.27941573121795,109.92814307591176,110.05692307692303,114.75127696625576,105.3625691875903,119.59265670000025,114.22540099999998,108.09440080000002,109.50750049999995,111.55999666666666,26071600,21443259.95,58.936471983593655,NaN,1.5,2.75,NaN,NaN,2.2959862204601107,1.2158412508542107,NaN,0.48430658233302015,1.0618393501820265,0.5775327678490063,20.275390289833073,5.529389600602868,NaN,NaN,NaN,-316331742
1005661800,113.44,114.55,113.17999,114.55,NaN,NaN,109.91555555555556,111.2276,119.48353170000024,114.15830109999997,108.05380080000003,109.73549999999996,110.44688962411136,110.36831992582493,110.36307615384611,115.63494958485556,105.09120272283666,119.48353170000024,114.15830109999997,108.05380080000003,109.73549999999996,114.09333,15347102,21416434.95,65.44641323729468,NaN,1.5,2.75,NaN,NaN,2.3119872047129597,0.7166039555990621,NaN,0.5688021378938408,1.2885354402163074,0.7197333023224666,19.77046125743599,8.2703213610586,NaN,NaN,NaN,-300984640
1005748200,115.17,115.39999,113.71001,114.66,NaN,NaN,110.35111111111111,111.0508,119.37667545000023,114.08700119999997,108.03620100000002,110.08600049999995,110.61210963885209,110.77705136146065,110.69692153846151,116.4438652078211,104.94997786910191,119.37667545000023,114.08700119999997,108.03620100000002,110.08600049999995,114.58999999999999,17591392,20865919.75,65.70201640163604,NaN,1.5,2.75,NaN,NaN,2.2675581186620346,0.8430681326664261,NaN,0.5924030390867306,1.46023710118088,0.8678340620941493,19.029232505313768,5.6676901361800835,NaN,NaN,NaN,-283393248
1005834600,114.37,115.17999,113.92999,114.87,NaN,NaN,110.78666666666668,110.874,119.27165045000024,114.01140129999997,108.06720080000001,110.45850049999994,110.77908573144613,111.1668559937025,111.26769076923073,117.08479821003543,105.45058332842602,119.27165045000024,114.01140129999997,108.06720080000001,110.45850049999994,114.65999333333333,19472400,21013669.85,66.21582072805985,NaN,1.5,2.75,NaN,NaN,2.194875395900461,0.9266539418863097,NaN,0.5816307124329891,1.5948724526353857,1.0132417402023965,15.732133254163276,5.144164759725404,NaN,NaN,NaN,-263920848
1005921000,115.08,115.10001,113.39999,114.36,NaN,NaN,111.22222222222223,110.6972,119.16045040000024,113.9168012,108.07140100000001,110.80899999999994,110.91951374197765,111.47096494668321,111.89845999999994,117.11020606413595,106.68671393586393,119.16045040000024,113.9168012,108.07140100000001,110.80899999999994,114.28666666666668,18135392,20824634.65,63.71929694011651,NaN,1.5,2.75,NaN,NaN,2.1595285819075705,0.8708624331135625,NaN,0.5026042436545306,1.64149704477056,1.1388928011160293,16.733550153156013,3.324909949847299,NaN,NaN,NaN,-282056240
1006180200,114.92,115.85001,114.45,115.77,NaN,NaN,111.65777777777778,110.5204,119.05030040000025,113.8460011,108.118401,111.12399999999995,111.10972888935108,111.8803968565229,112.66538307692302,116.90544294201209,108.42532321183396,119.05030040000025,113.8460011,108.118401,111.12399999999995,115.35667,13682500,20630214.85,67.38096271877049,NaN,1.5,2.75,NaN,NaN,2.1117058260570296,0.6632262484653667,NaN,0.5063244767654278,1.7717983970728142,1.2654739203073864,16.600562310539406,2.9982298041129662,NaN,NaN,NaN,-268373740
1006266600,115.37,115.8,114.64,114.8,NaN,NaN,112.09333333333333,110.3436,118.93920040000025,113.7768011,108.14040100000003,111.41849999999997,111.25444540349417,112.15845429875883,113.14922999999993,116.77285953164281,109.52560046835706,118.93920040000025,113.7768011,108.14040100000003,111.41849999999997,115.08,16223000,20338140.05,62.69324892170942,NaN,1.5,2.75,NaN,NaN,2.0437268384815273,0.7976638945408383,NaN,0.4086736629959997,1.776315999052386,1.3676423360563863,16.495997454050308,2.271714922048995,NaN,NaN,NaN,-284596740
1006353000,114.50101,114.67,113.50999,114.03999,NaN,NaN,112.5288888888889,110.1668,118.81975040000025,113.701701,108.20580080000002,111.68949949999998,111.36368244649441,112.33764817506751,113.51769076923071,116.37314606517168,110.66223547328974,118.81975040000025,113.701701,108.20580080000002,111.68949949999998,114.07332666666667,11471102,20108425.25,59.217063000838095,NaN,1.5,2.75,NaN,NaN,1.989889921447132,0.570462473186457,NaN,0.26507407922454584,1.6989849350870685,1.4339108558625226,17.16764584531639,1.2788453571185345,NaN,NaN,NaN,-296067842
1006525800,114.03999,115.75,114,115.67999,NaN,NaN,112.96444444444445,109.99,118.72415035000026,113.6437009,108.3450006,111.9449985,111.53294940937698,112.6559664441087,113.90230615384608,116.45628925497299,111.34832305271918,118.72415035000026,113.6437009,108.3450006,111.9449985,115.14333,6716898,19069070.15,63.87220468863848,NaN,1.5,2.75,NaN,NaN,1.972754927058051,0.3522404578285114,NaN,0.2527612979532923,1.7498624783041379,1.4971011803508456,18.659042768459017,2.6259669978708344,NaN,NaN,NaN,-289350944
1006785000,115.75,116.34,115.07001,115.92999,NaN,NaN,113.4,109.8132,118.62485035000026,113.58150090000001,108.46260039999999,112.2254975,111.70538237371514,112.96777821133644,114.17384461538457,116.78124318025858,111.56644605051055,118.62485035000026,113.58150090000001,108.46260039999999,112.2254975,115.78000000000002,13729199,18824365.3,64.5367337558308,NaN,1.5,2.75,NaN,NaN,1.9225574322681909,0.729331309778609,NaN,0.23409935054833708,1.789725368536267,1.55562601798793,18.63460749433491,3.481201463893602,NaN,NaN,NaN,-275621745
1006871400,115.62,116.89999,114.09,115.42999,NaN,NaN,113.83555555555556,109.6364,118.52505030000026,113.50980070000001,108.68520019999998,112.62449700000002,111.85144541788317,113.20227457216154,114.41845923076919,116.84865800324796,111.98826045829041,118.52505030000026,113.50980070000001,108.68520019999998,112.62449700000002,115.47332666666665,19266400,18850994.9,62.0773822984327,NaN,1.5,2.75,NaN,NaN,1.9859454728204629,1.0220362427661578,NaN,0.1640393512983589,1.7606752071108787,1.5966358558125198,18.34283066607981,0.768214753382808,NaN,NaN,NaN,-294888145
1006957800,114.74001,115.17,113.25,113.34,NaN,NaN,114.27111111111111,109.4596,118.41830030000027,113.40190070000003,108.87100019999998,112.98349700000003,111.90982010737795,113.21539127957473,114.4753815384615,116.76302456526948,112.18773851165354,118.41830030000027,113.40190070000003,108.87100019999998,112.98349700000003,113.92,20247200,18553459.7,52.98772024308232,NaN,1.5,2.75,NaN,NaN,1.9998057961904299,1.0912897285674434,NaN,-0.03640661632980291,1.5511275854002662,1.587534201730069,17.499115090887635,-1.1512297226582882,NaN,NaN,NaN,-315135345
1007044200,113.662,114.92,113,114.87,NaN,NaN,114.70666666666668,109.2828,118.32705030000027,113.30960060000002,109.12940019999998,113.43699700000002,112.02590559336313,113.37297306247238,114.6407661538461,116.69593165123347,112.58560065645874,118.32705030000027,113.30960060000002,109.12940019999998,113.43699700000002,114.26333333333334,17265104,18010190.1,57.85305119573822,NaN,1.5,2.75,NaN,NaN,1.994105382176828,0.9586297481668447,NaN,-0.07696599121090086,1.4913267127164431,1.568292703927344,19.37790334481849,0,NaN,NaN,NaN,-297870241
1007130600,114.39999,114.912,114.02,114.05,NaN,NaN,115.14222222222223,109.106,118.23810030000026,113.23330070000002,109.43619999999999,113.71399750000003,112.1052818446038,113.43745181842739,114.79615076923072,116.25808518696839,113.33421635149305,118.23810030000026,113.23330070000002,109.43619999999999,113.71399750000003,114.32733333333334,13680398,17203845.2,54.592144764178464,NaN,1.5,2.75,NaN,NaN,1.9153835691641983,0.7951942046072351,NaN,-0.16498144673263626,1.3620658955115488,1.527047342244185,19.78037664774663,-0.27107380202868336,NaN,NaN,NaN,-311550639
1007389800,113.64999,114.08,113.00999,113.37,NaN,NaN,115.57777777777778,108.9292,118.13820025000027,113.17650070000003,109.758,113.91999750000002,112.15487863501149,113.43102783572002,114.7053815384615,116.3520357601452,113.05872731677779,118.13820025000027,113.17650070000003,109.758,113.91999750000002,113.48666333333333,15220398,17085969.9,51.975811338926604,NaN,1.5,2.75,NaN,NaN,1.8549997427953266,0.8908126427168762,NaN,-0.26881703958187897,1.1910260427668362,1.4598430823487152,19.904865819412173,-2.073075926405797,NaN,NaN,NaN,-326771037
1007476200,113.918,115.3,113.35001,115.28999,NaN,NaN,116.01333333333334,108.7524,118.05335025000028,113.13240060000003,110.0497998,114.15049750000003,112.27782417873652,113.60807185136574,114.75384230769227,116.42913384862074,113.0785507667638,118.05335025000028,113.13240060000003,110.0497998,114.15049750000003,114.64666666666666,17245808,17148695.25,58.0840621089971,NaN,1.5,2.75,NaN,NaN,1.861784761167089,1.0056629818528031,NaN,-0.21058717850507058,1.196609109217377,1.4071962877224475,21.12971724197653,0.4268205574912944,NaN,NaN,NaN,-309525229
1007562600,115.61,118,115.56,117.39999,NaN,NaN,116.4488888888889,118,117.98005020000028,113.12380060000001,110.3627996,114.40049750000003,112.4786934266292,113.96920691314043,114.94845692307689,117.14058884270077,112.75632500345301,117.98005020000028,113.12380060000001,110.3627996,114.40049750000003,116.98666333333334,25204000,17246600.05,63.568169894406935,NaN,1.5,2.75,NaN,NaN,1.9223722782265824,1.4613894870252992,NaN,-0.041224371095726964,1.3556658238527888,1.3968901949485157,22.869299827301564,2.946334877791553,NaN,NaN,NaN,-284321229
1007649000,117.349,117.94,116.92999,117.34,NaN,NaN,116.88444444444445,117.9367469879518,117.90005020000028,113.11340060000002,110.68179959999999,114.65499750000004,112.66933290009473,114.29023482617467,115.17768769230767,117.67739701038964,112.6779783742257,117.90005020000028,113.11340060000002,110.68179959999999,114.65499750000004,117.40333,17969200,17159220.05,63.31453366038671,NaN,1.5,2.75,NaN,NaN,1.8572035440675403,1.0472037742764422,NaN,0.050526402221597655,1.4600481977255129,1.4095217955039152,22.262089180316732,1.4350018529565916,NaN,NaN,NaN,-302290429
1007735400,116.89999,117.09,115.7,116.56,NaN,NaN,117.32000000000001,117.87349397590361,117.83085025000028,113.06710060000002,110.9675996,114.85299700000003,112.82190808048317,114.50640293796755,115.2384569230769,117.82954950209279,112.647364344061,117.83085025000028,113.06710060000002,110.9675996,114.85299700000003,116.45,18908000,16967229.65,59.964375379717346,NaN,1.5,2.75,NaN,NaN,1.8416890052055732,1.1143834550503653,NaN,0.04275721300029267,1.462968311754281,1.4202110987539884,21.564515161684273,0.5434400537772829,NaN,NaN,NaN,-321198429
1007994600,115.85001,116.39,114.35001,114.38,NaN,NaN,117.75555555555556,117.81024096385542,117.76080025000029,112.98850050000001,111.1663996,114.93599700000004,112.88300972438579,114.49436456292302,115.20614923076921,117.8285883204458,112.58371014109262,117.76080025000029,112.98850050000001,111.1663996,114.93599700000004,115.04000333333333,13862801,16865494.7,51.726395874518474,NaN,1.5,2.75,NaN,NaN,1.8679962191194612,0.8219623110136224,NaN,-0.11642406866325827,1.2746810129249155,1.3911050815881738,24.267578907969064,-0.90963362294323,NaN,NaN,NaN,-335061230
1008081000,114.89999,115.72,113.89999,114.14999,NaN,NaN,118.19111111111113,117.74698795180723,117.7034502000003,112.9229003,111.3639994,115.04199650000002,112.93269522539026,114.46156698550179,115.21461076923076,117.82261449928602,112.6066070391755,117.7034502000003,112.9229003,111.3639994,115.04199650000002,114.58999333333333,20833296,16603579.5,50.93135847147813,NaN,1.5,2.75,NaN,NaN,1.8645686320394996,1.2547472669974569,NaN,-0.23745381044006542,1.094287818538092,1.3317416289781574,24.200204244292607,0.7146550202929232,NaN,NaN,NaN,-355894526
1008167400,114.55,114.78,113.11,114.28,NaN,NaN,118.62666666666668,117.68373493975903,117.64580020000028,112.8473003,111.53799939999999,115.02849650000003,112.98553070674751,114.44427489164448,115.10691923076921,117.74461190643267,112.46922655510575,117.64580020000028,112.8473003,111.53799939999999,115.02849650000003,114.05666666666666,16172398,16644844.3,51.38618913107023,NaN,1.5,2.75,NaN,NaN,1.850670872608107,0.971616057712237,NaN,-0.30470948648431295,0.9508547708727662,1.255564257357079,21.594203958225055,-0.5136240968050869,NaN,NaN,NaN,-339722128
1008253800,113.45,113.7,112.03999,112.06,NaN,NaN,119.06222222222223,117.62048192771084,117.5813001500003,112.7578004,111.6321992,114.89849650000004,112.94923538491427,114.21720109244025,114.80922769230766,117.85077748184845,111.76767790276686,117.5813001500003,112.7578004,111.6321992,114.89849650000004,112.59999666666666,19031904,16716869.9,43.90279282213196,NaN,1.5,2.75,NaN,NaN,1.8784808102789563,1.1384849026072759,NaN,-0.4840126198232495,0.6505484825780172,1.1345611024012667,22.830860846739665,-1.7448487505480008,NaN,NaN,NaN,-358754032
1008340200,112.33,113.49001,112,113.13,NaN,NaN,112,117.55722891566265,117.50885015000031,112.66840029999999,111.7459992,114.81149650000005,112.956324193349,114.11365813125546,114.63230538461536,117.77473814670633,111.4898726225244,117.50885015000031,112.66840029999999,111.7459992,114.81149650000005,112.87333666666666,16722699,16579384.85,47.8452053039915,NaN,1.5,2.75,NaN,NaN,1.8507328952590307,1.008644117456505,NaN,-0.5130822855141353,0.49320824550859754,1.0062905310227328,23.568456180473408,-0.21169621593014826,NaN,NaN,NaN,-342031333
1008599400,112.99001,114.36,112.89999,114.3,NaN,NaN,112.20125,117.49397590361446,117.44815015000032,112.59800029999998,111.88739920000002,114.80849650000005,113.00901736223727,114.1314049758978,114.70615153846151,117.76771741547205,111.64458566145098,117.44815015000032,112.59800029999998,111.88739920000002,114.80849650000005,113.85333000000001,13947301,16369980.3,51.83151109534357,NaN,1.5,2.75,NaN,NaN,1.8228241170262425,0.852004751648968,NaN,-0.43891345958195804,0.4576487065452852,0.8965621661272433,24.10429649435027,-0.8586955380948562,NaN,NaN,NaN,-328084032
1008685800,114.63,115.14999,114.34,114.98,NaN,NaN,112.4025,117.43072289156626,117.4033001500003,112.55830029999997,112.05639920000002,114.76899650000004,113.08631079901228,114.21222354962181,114.71461307692306,117.77855067193826,111.65067548190785,117.4033001500003,112.55830029999997,112.05639920000002,114.76899650000004,114.82333000000001,13663898,16369050.2,54.03064906252999,NaN,1.5,2.75,NaN,NaN,1.7533359658100827,0.8347398189297508,NaN,-0.3341950822891394,0.47881831326581903,0.8130133955549584,22.205615810580944,-2.0613204481533587,NaN,NaN,NaN,-314420134
1008772200,114.09,115.92,114,115.78999,NaN,NaN,112.60375,117.36746987951807,117.35925005000031,112.53820019999998,112.25299880000003,114.81849600000005,113.19233743434513,114.3624870210864,114.84845846153846,117.93649515466754,111.76042176840937,117.35925005000031,112.53820019999998,112.25299880000003,114.81849600000005,115.23666333333333,20147392,16565269.8,56.57393594186773,NaN,1.5,2.75,NaN,NaN,1.765240539680791,1.2162429132304262,NaN,-0.20676099211031918,0.5545621554170594,0.7613231475273786,19.604193892277642,-1.3209561956707008,NaN,NaN,NaN,-294272742
1008858600,115.5,115.8,114.55,114.64999,NaN,NaN,112.805,117.30421686746988,117.31445000000032,112.49369999999998,112.37959840000002,114.84899600000003,113.24950028005709,114.3898682571734,114.94691923076923,117.91958578903224,111.97425267250621,117.31445000000032,112.49369999999998,112.37959840000002,114.84899600000003,114.99999666666668,14867898,16735109.6,52.196886475088085,NaN,1.5,2.75,NaN,NaN,1.7284376439893059,0.8884254931918701,NaN,-0.1957419948964122,0.5166456539068633,0.7123876488032755,20.18139679663841,-1.6386496225120109,NaN,NaN,NaN,-309140640
1008945000,115.03,115.07001,114.2,114.95,NaN,NaN,113.00625,117.24096385542168,117.26549995000032,112.43969989999998,112.47859840000001,114.81249650000002,113.31618654358427,114.44321413744261,114.92076615384615,117.88687451694614,111.95465779074615,117.26549995000032,112.43969989999998,112.47859840000001,114.81249650000002,114.74000333333335,14042199,17101374.65,53.22257832268804,NaN,1.5,2.75,NaN,NaN,1.667121383704355,0.8211152195300278,NaN,-0.16592314698478094,0.5049837150722993,0.6709068620570803,20.152318910476236,0.49833887043190017,NaN,NaN,NaN,-295098441
1009204200,114.83,115.03999,114.61,114.73,NaN,NaN,113.2075,117.17771084337349,117.20874995000031,112.37889989999998,112.5831984,114.75249700000002,113.37163020854175,114.47052707673379,114.71538230769231,117.31326986379825,112.11749475158636,117.20874995000031,112.37889989999998,112.5831984,114.75249700000002,114.79333000000003,5728801,16701354.75,52.33576756905987,NaN,1.5,2.75,NaN,NaN,1.5787548562969014,0.3430141497952434,NaN,-0.15869172109732965,0.47254221068541824,0.6312339317827479,16.854411075895985,0.5081121776708009,NaN,NaN,NaN,-300827242
1009377000,114.64999,116.21001,114.64999,115.36,NaN,NaN,113.40875,117.1144578313253,117.15064995000031,112.32399979999998,112.70439839999999,114.74899750000002,113.44960549448129,114.55523878371152,114.56307461538462,116.72282238618108,112.40332684458816,117.15064995000031,112.32399979999998,112.70439839999999,114.74899750000002,115.4066666666667,10307898,16253429.65,54.66529784852166,NaN,1.5,2.75,NaN,NaN,1.5774166522756938,0.6341983336421553,NaN,-0.11139003226050126,0.49199639145712126,0.6033864237176225,17.02411023694472,0.9450472523626167,NaN,NaN,NaN,-290519344
1009463400,115.30099,116.08,115.259,116.06,NaN,NaN,113.61,117.0512048192771,117.09534995000033,112.27109969999998,112.8257982,114.88499750000001,113.55197390646242,114.69854937573899,114.52461307692307,116.55465686234521,112.49456929150094,117.09534995000033,112.27109969999998,112.8257982,114.88499750000001,115.79966666666667,9407301,15711434.7,57.170054027477214,NaN,1.5,2.75,NaN,NaN,1.5233868913988584,0.5987550583143117,NaN,-0.03673159470551979,0.5574719303357227,0.5942035250412425,17.263973418080415,3.569516330537212,NaN,NaN,NaN,-281112043
1009549800,116.28999,116.75,115.92,116,NaN,NaN,113.81125,116.98795180722891,117.05854995000033,112.20999969999997,112.9927984,114.94149750000001,113.64797492973841,114.82249705424005,114.64922846153846,116.82231414164991,112.476142781427,117.05854995000033,112.20999969999997,112.9927984,114.94149750000001,116.22333333333334,10593801,15377869.55,56.87996459991035,NaN,1.5,2.75,NaN,NaN,1.4738592562989399,0.6888991329751526,NaN,0.0027420985268081788,0.5976311481997527,0.5948890496729445,11.082109656160464,2.536904446212326,NaN,NaN,NaN,-291705844
1009809000,116.14999,116.39,114.23,114.3,NaN,NaN,114.0125,116.92469879518072,117.03964995000031,112.12689969999995,113.13039839999999,114.95399750000001,113.6735445403369,114.77273543002671,114.66076769230767,116.824700716967,112.49683466764834,117.03964995000031,112.12689969999995,113.13039839999999,114.95399750000001,114.97333333333334,14619500,15424824.65,49.25411595583498,NaN,1.5,2.75,NaN,NaN,1.5228693094204437,0.9477903530008686,NaN,-0.08657381902514871,0.4866717758915087,0.5732455949166574,14.461247659877959,0,NaN,NaN,NaN,-306325344
1009981800,115.11,115.75,113.81,115.53,NaN,NaN,114.21375,116.86144578313252,117.0171999500003,112.06279969999996,113.29399819999999,115.06199750000003,113.74634671522566,114.84485586526226,114.75692153846151,116.95544260786711,112.55840046905591,117.0171999500003,112.06279969999996,113.29399819999999,115.06199750000003,115.03000000000002,18651904,15596399.95,54.053866908860485,NaN,1.5,2.75,NaN,NaN,1.5526643587475546,1.1959108550560094,NaN,-0.06474740733027684,0.49231133575381136,0.5570587430840882,14.559788909034387,0.4783440598364908,NaN,NaN,NaN,-287673440
1010068200,115.64999,116.95,115.53999,116.84,NaN,NaN,114.41499999999999,116.79819277108433,117.0131500000003,112.02819969999997,113.44139819999998,115.13949800000003,113.86766645188348,115.03486959238015,115.12461384615382,116.96577729625876,113.28345039604888,117.0131500000003,112.02819969999997,113.44139819999998,115.13949800000003,116.44333,15731801,15520699.6,58.550505532041434,NaN,1.5,2.75,NaN,NaN,1.5431883331227294,1.0136012812205966,NaN,0.03084967212807599,0.5956208332441832,0.5647711611161073,15.502596374390633,0.9068227745766282,NaN,NaN,NaN,-271941639
1010154600,117.17,117.98,116.55,117.62,NaN,NaN,114.61625,116.73493975903614,117.01285005000028,111.99669969999997,113.61559819999998,115.15049850000003,114.01481678710374,115.28107248834394,115.46999846153844,117.36856553262251,113.57143139045436,117.01285005000028,111.99669969999997,113.61559819999998,115.15049850000003,117.38333333333331,20140608,15267530,60.998064534427414,NaN,1.5,2.75,NaN,NaN,1.5351034521853921,1.3191791992548894,NaN,0.13377974562695716,0.7319958431498037,0.5982160975228465,15.45724834089787,2.5905017523333425,NaN,NaN,NaN,-251801031
1010413800,117.7,117.99001,116.56,116.78999,NaN,NaN,114.8175,117.99001,117.0217500500003,111.97929959999996,113.77899799999999,115.12299800000002,114.12364710917811,115.42477891802547,115.66153615384613,117.55170214771384,113.77137015997842,117.0217500500003,111.97929959999996,113.77899799999999,115.12299800000002,117.11333333333333,13106500,15024395,57.132019463229966,NaN,1.5,2.75,NaN,NaN,1.5275967770292922,0.8723479381366105,NaN,0.13285824516583844,0.7642889039801446,0.6314306588143062,14.764540871816795,1.6006872553284037,NaN,NaN,NaN,-264907531
1010500200,116.798,117.06,115.97,116.52,NaN,NaN,115.01875,117.98953428571429,117.01760000000031,111.95569959999997,113.8979978,115.12099800000003,114.2176217323476,115.52908568773732,115.77999769230767,117.67747798113687,113.88251740347847,117.01760000000031,111.95569959999997,113.8979978,115.12099800000003,116.51666666666667,12687000,14713345,55.89110291834122,NaN,1.5,2.75,NaN,NaN,1.4963398643843429,0.8622784281888313,NaN,0.10232925393875403,0.7593422262377487,0.6570129722989947,14.940559619982245,1.5601847816612848,NaN,NaN,NaN,-277594531
1010586600,116.67999,117.78,115.34,115.57001,NaN,NaN,115.22,117.98905857142857,117.02445005000031,111.91849979999998,114.00299779999999,115.18049850000003,114.27065656637318,115.53298324128615,115.76307615384613,117.66381890630342,113.86233340138884,117.02445005000031,111.91849979999998,114.00299779999999,115.18049850000003,116.23000333333334,16616898,14851049.85,51.640871289610644,NaN,1.5,2.75,NaN,NaN,1.563744159785461,1.1189039271859962,NaN,0.011214000794056989,0.671030473291566,0.659816472497509,15.846668308133161,0.1820475034674037,NaN,NaN,NaN,-294211429
1010673000,115.69501,116.35001,115.3,116.08,NaN,NaN,115.42125,117.98858285714286,117.04355010000032,111.88609969999997,114.17559779999999,115.27699900000002,114.34161121082913,115.58508007544937,115.87307692307688,117.66587040504679,114.08028344110697,117.04355010000032,111.88609969999997,114.17559779999999,115.27699900000002,115.91000333333334,12823398,14450554.95,53.677398291438145,NaN,1.5,2.75,NaN,NaN,1.5270488626579282,0.8873983071494428,NaN,-0.019952181594645513,0.6348762455042021,0.6548284270988476,15.740936093557046,0.017232465965876288,NaN,NaN,NaN,-281388031
1010759400,116.21001,116.28,114.7,114.94,NaN,NaN,115.6225,117.98810714285715,117.06265010000033,111.84279969999997,114.3511978,115.30999900000002,114.36507743785543,115.52364387778752,115.87230769230766,117.66669264117594,114.07792274343937,117.06265010000033,111.84279969999997,114.3511978,115.30999900000002,115.30666666666667,13708398,14327354.95,48.73662392730194,NaN,1.5,2.75,NaN,NaN,1.5308310867537904,0.9567989379644706,NaN,-0.11716269712425065,0.5083750556935343,0.6255377528177849,16.36924398598196,-0.9137931034482778,NaN,NaN,NaN,-295096429
1011018600,114.64999,114.84,113.96001,114.22,NaN,NaN,115.82375,117.98763142857143,117.06135010000033,111.80259959999998,114.51959779999999,115.41799900000001,114.35938812656698,115.39948731799824,115.83307692307689,117.74415012332277,113.92200372283101,117.06135010000033,111.80259959999998,114.51959779999999,115.41799900000001,114.34000333333331,12301301,13990824.8,45.865188374907525,NaN,1.5,2.75,NaN,NaN,1.4914852948428055,0.8792405863019598,NaN,-0.22360212902864895,0.34603509153197365,0.5696372205606226,16.64245108533681,-0.0699912510936118,NaN,NaN,NaN,-307397730
1011105000,114.55,115.39,113.89999,115.14999,NaN,NaN,116.025,117.9871557142857,117.05740005000034,111.76759959999998,114.6523978,115.5189985,114.39039212160357,115.37572566866507,115.81692230769227,117.74717265915108,113.88667195623346,117.05740005000034,111.76759959999998,114.6523978,115.5189985,114.81332666666667,20221392,14165759.45,49.96573384262092,NaN,1.5,2.75,NaN,NaN,1.4913799166397477,1.427483790853162,NaN,-0.22443819441507473,0.28908947754177916,0.5135276719568539,15.104316753176285,-0.3289275512853792,NaN,NaN,NaN,-287176338
1011191400,114.3,114.39999,112.69,112.82001,NaN,NaN,116.22625,117.98667999999999,117.02995010000033,111.72829969999997,114.723798,115.44499899999998,114.32880850899167,115.13232417641126,115.56769230769227,118.06223772769886,113.07314688768568,117.02995010000033,111.72829969999997,114.723798,115.44499899999998,113.30333333333333,17076704,14322229.6,41.486924968970236,NaN,1.5,2.75,NaN,NaN,1.5605663511654804,1.1923216200918885,NaN,-0.36657241708755023,0.05531215059741612,0.42188456768496635,17.896464100546957,-3.440593974666216,NaN,NaN,NaN,-304253042
1011277800,113.75999,114.24001,113.39999,113.67,NaN,NaN,116.4275,117.98620428571428,117.02310015000032,111.68669969999998,114.78359820000001,115.37949899999998,114.30297288118807,114.99305520722923,115.3884615384615,118.06144306201551,112.71548001490748,117.02310015000032,111.68669969999998,114.78359820000001,115.37949899999998,113.77,17391104,14508589.9,45.14399327170917,NaN,1.5,2.75,NaN,NaN,1.5505258975108034,1.1986763786052013,NaN,-0.38604492742977947,-0.06067159160225799,0.3253733358275215,16.952681418923113,-3.3582724026526125,NaN,NaN,NaN,-286861938
1011364200,113,113.85001,112.67,113.14999,NaN,NaN,116.62875,117.98572857142857,117.01145010000033,111.65999949999997,114.79859820000001,115.24749899999998,114.25775786623952,114.81752518749312,115.2999992307692,118.17936732390993,112.42063113762848,117.01145010000033,111.65999949999997,114.79859820000001,115.24749899999998,113.22333333333334,17028192,14352629.9,43.358583933569804,NaN,1.5,2.75,NaN,NaN,1.5240604762600314,1.1864161563867817,NaN,-0.41416499661846745,-0.19233290994556285,0.2218320866729046,15.866042378501673,-3.1167054642268575,NaN,NaN,NaN,-303890130
1011709800,113.75,113.92999,112.02,112.37,NaN,NaN,116.83,117.98525285714285,116.98985010000033,111.61349949999997,114.80099820000001,115.13349949999997,114.18372814599483,114.58442755058901,115.05692230769229,118.32489481783308,111.7889497975515,116.98985010000033,111.61349949999997,114.80099820000001,115.13349949999997,112.77333000000002,11689801,14193725.05,40.754948345072634,NaN,1.5,2.75,NaN,NaN,1.5516268708128869,0.8235893649355988,NaN,-0.4618784381030424,-0.35551596095589844,0.10636247714714397,15.854185104568838,-3.5616203226913763,NaN,NaN,NaN,-315579931
1011796200,112.63,113.55,112.02,113.23,NaN,NaN,117.03125,117.98477714285714,116.98500010000032,111.57979939999997,114.813598,115.04749949999999,114.14632704223033,114.45543445053292,114.77923,118.00721598288908,111.55124401711092,116.98500010000032,111.57979939999997,114.813598,115.04749949999999,112.93333333333334,12438898,14113560,44.698064244530215,NaN,1.5,2.75,NaN,NaN,1.550082094326252,0.8813437573510865,NaN,-0.41365836343746887,-0.4107104771496921,0.0029478862877767575,17.175622782364414,-2.024755384203906,NaN,NaN,NaN,-303141033
1011882600,113.64,114.25,113.32001,113.58,NaN,NaN,117.2325,117.98430142857143,117.00095010000034,111.52539939999997,114.830798,114.98999949999998,114.12411813861345,114.37205974095835,114.46846076923076,117.29565424585361,111.6412672926079,117.00095010000034,111.52539939999997,114.830798,114.98999949999998,113.71667000000001,12162398,14435239.85,46.26551823267752,NaN,1.5,2.75,NaN,NaN,1.5122190875886623,0.8425490761762439,NaN,-0.33944099284613466,-0.42135335476989155,-0.08191236192375691,17.115740701506933,-2.15368711233632,NaN,NaN,NaN,-290978635
1011969000,113.12,114.17999,113.03999,113.55,NaN,NaN,117.43375,117.98382571428571,117.01445005000033,111.47779939999997,114.861198,114.89949949999998,114.10160370180509,114.29376833705756,114.21923076923076,116.73832059930525,111.70014093915627,117.01445005000033,111.47779939999997,114.861198,114.89949949999998,113.58999333333334,12810699,14560379.9,46.14478828308195,NaN,1.5,2.75,NaN,NaN,1.4856320099037579,0.8798327439244906,NaN,-0.2762966755908215,-0.4272832064122838,-0.1509865308214623,16.708821177833105,-1.2093266051853147,NaN,NaN,NaN,-303789334
1012228200,113.89999,114.19,112.92,113.86,NaN,NaN,117.63499999999999,117.98335,117.00850005000035,111.45059939999997,114.847398,114.78949949999999,114.09212904683234,114.2524570668616,114.01461538461537,116.1568733507068,111.87235741852393,117.00850005000035,111.45059939999997,114.847398,114.78949949999999,113.65666666666668,10589500,14619489.85,47.664560790289194,NaN,1.5,2.75,NaN,NaN,1.4702297234820605,0.7243412806227298,NaN,-0.201075121386629,-0.40233043255474854,-0.20125531116811954,16.14981607984528,-0.3151812292067934,NaN,NaN,NaN,-293199834
1012314600,113.851,114.13,110.05,110.28,NaN,NaN,117.83624999999999,117.98287428571429,116.99340005000035,111.39799949999998,114.75979799999999,114.5034995,113.94263379009382,113.87412782239859,113.60769153846152,116.34155852775274,110.87382454917031,116.99340005000035,111.39799949999998,114.75979799999999,114.5034995,111.48666666666668,27735296,15476564.6,35.28200866699207,NaN,1.5,2.75,NaN,NaN,1.6566418860904846,1.7920834963593923,NaN,-0.3700194485827118,-0.6637796218965093,-0.2937601733137975,24.02504235139355,-4.229257857512624,NaN,NaN,NaN,-320935130
1012401000,110.39,113.39,108.39999,111.87,NaN,NaN,118.0375,117.98239857142856,116.97995005000034,111.3834994,114.69979799999999,114.38199949999998,113.86135403361955,113.68325850597968,113.28384538461538,115.75425262419199,110.81343814503876,116.97995005000034,111.3834994,114.69979799999999,114.38199949999998,111.21999666666666,34711808,16481180,42.434767954650354,NaN,1.5,2.75,NaN,NaN,1.8947396085125927,2.1061482248237082,NaN,-0.35236520805455196,-0.7342166833819874,-0.38185147532743546,25.347436965492005,-0.8420580710815323,NaN,NaN,NaN,-286223322
1012487400,112.14999,113.3,111.62,113.17999,NaN,NaN,118.23875,117.98192285714285,116.96260005000033,111.37379940000001,114.6761978,114.26449899999997,113.83463387543839,113.63532817207685,113.14845999999999,115.42638901695128,110.8705309830487,116.96260005000033,111.37379940000001,114.6761978,114.26449899999997,112.69999666666668,19909200,16544044.8,47.57564498712762,NaN,1.5,2.75,NaN,NaN,1.8794010650474071,1.2034058321698935,NaN,-0.23574653721282307,-0.6765346468434643,-0.44078810963064124,23.865271885064818,-0.4310811999648087,NaN,NaN,NaN,-266314122
1012573800,113.09,113.3,112.17,112.64999,NaN,NaN,118.44,117.98144714285714,116.94220000000034,111.3660993,114.61379759999998,114.05499849999997,113.78817725287217,113.54148644140287,113.02768999999998,115.2308196782248,110.82456032177515,116.94220000000034,111.3660993,114.61379759999998,114.05499849999997,112.70666333333334,15838500,16549379.75,45.79377515056109,NaN,1.5,2.75,NaN,NaN,1.8258724175440206,0.957044930943711,NaN,-0.18009877134184415,-0.6659115738079464,-0.48581280246610226,23.54643431400392,-0.44189133379508033,NaN,NaN,NaN,-282152622
1012833000,112.23,112.23,109.44901,109.85001,NaN,NaN,118.64125,117.98097142857142,116.89720000000034,111.3275994,114.51479779999998,113.66649899999997,113.633739321387,113.18991725650736,112.61999923076921,115.05105004511512,110.1889484164233,116.89720000000034,111.3275994,114.51479779999998,113.66649899999997,110.50967333333334,24243904,16754544.55,37.74981573928041,NaN,1.5,2.75,NaN,NaN,1.9240943877194479,1.4470046576109405,NaN,-0.31003787432704066,-0.8733601453749031,-0.5633222710478625,27.367541002391636,-2.2425825398238026,NaN,NaN,NaN,-306396526
1012919400,109.39999,110.49899,108.53,109.17,NaN,NaN,118.8425,117.98049571428571,116.85504995000034,111.31159939999999,114.41739799999998,113.28549949999997,113.45869072054829,112.80706799398284,112.33922923076922,115.3797354273899,109.29872303414854,116.85504995000034,111.31159939999999,114.41739799999998,113.28549949999997,109.39966333333335,33614000,17779919.55,36.0916964459384,NaN,1.5,2.75,NaN,NaN,1.9273012171680592,1.8905597354066768,NaN,-0.4134894370101423,-1.0801840673105403,-0.666694630300398,27.33317280332184,-3.5856221849333236,NaN,NaN,NaN,-340010526
1013005800,109.64999,109.74001,108.06,108.7,NaN,NaN,119.04375,117.98002,116.80225000000036,111.31139940000001,114.27779819999998,112.89449949999997,113.27207539817385,112.41591866122258,111.95692153846153,115.44836922590805,108.465473851015,116.80225000000036,111.31139940000001,114.27779819999998,112.89449949999997,108.83333666666665,29581008,18624619.95,34.949071196052714,NaN,1.5,2.75,NaN,NaN,1.9096375587989118,1.5882744495948762,NaN,-0.48057124707377186,-1.2674086891426128,-0.786837442068841,26.500923017228423,-4.296531079415386,NaN,NaN,NaN,-369591534
1013092200,108.72,109.86,108,108.02,NaN,NaN,119.245,117.97954428571428,116.72235000000035,111.29109940000002,114.1195984,112.51699899999997,113.066111657069,111.99725974110613,111.5623069230769,115.54958447574101,107.57502937041279,116.72235000000035,111.29109940000002,114.1195984,112.51699899999997,108.62666666666668,23450000,18966275.05,33.306150144143274,NaN,1.5,2.75,NaN,NaN,1.906092018884704,1.236405142189478,NaN,-0.5336470517838076,-1.4538962567986005,-0.9202492050147929,26.11693630302279,-4.870101276970499,NaN,NaN,NaN,-393041534
1013178600,108.63,110.75,108.3,110.09,NaN,NaN,119.44624999999999,117.97906857142857,116.64455005000035,111.34899940000003,114.01279860000001,112.21749899999998,112.94940139600747,111.81561595623889,111.38692230769227,115.41700858516492,107.35683603021963,116.64455005000035,111.34899940000003,114.01279860000001,112.21749899999998,109.71333333333332,19278096,19289009.95,42.21181285450219,NaN,1.5,2.75,NaN,NaN,1.9649425889643681,0.9994341881709694,NaN,-0.3984469772178201,-1.418307926537068,-1.0198609493192479,29.50556186198898,-3.31108378710697,NaN,NaN,NaN,-373763438
1013437800,110.05,111.64,109.82001,111.44,NaN,NaN,119.6475,117.97859285714286,116.57925005000034,111.42289940000005,113.9747986,112.04249899999998,112.89020918439934,111.77984300802567,111.24922999999997,115.13785632235022,107.36060367764972,116.57925005000034,111.42289940000005,113.9747986,112.04249899999998,110.96667000000001,18792096,19543194.85,47.16672641390066,NaN,1.5,2.75,NaN,NaN,1.9545888326097707,0.961567243443822,NaN,-0.1973672170379166,-1.2665699706166436,-1.069202753578727,30.66255539324988,1.0518679724338018,NaN,NaN,NaN,-354971342
1013524200,110.96001,111.71001,110.03,111.09,NaN,NaN,119.84875,117.97811714285714,116.52350000000033,111.51429940000004,113.8991986,111.885999,112.81961274579544,111.71414367392798,111.05769153846151,114.70610667695706,107.40927639996596,116.52350000000033,111.51429940000004,113.8991986,111.885999,110.94333666666665,13942500,19625254.8,46.063975596050646,NaN,1.5,2.75,NaN,NaN,1.9349760588519298,0.7104366359615366,NaN,-0.07357646819310326,-1.161173338820106,-1.0875968706270027,24.21097618314172,-0.6972378653794593,NaN,NaN,NaN,-368913842
1013610600,111.481,112.53999,111.35001,112.27,NaN,NaN,120.05,117.97764142857143,116.47695000000033,111.64989930000003,113.8635986,111.74199949999999,112.79805930478385,111.76708237164912,110.95922999999996,114.39624981343584,107.52221018656408,116.47695000000033,111.64989930000003,113.8635986,111.74199949999999,112.05333333333333,16783808,19453375.6,50.284192720773504,NaN,1.5,2.75,NaN,NaN,1.9003341975053634,0.8627709835613311,NaN,0.09309043136990436,-0.9712338314146223,-1.0643242627845266,23.52903370383882,-0.8040202159410048,NaN,NaN,NaN,-352130034
1013697000,112.50999,112.97,111.591,112.06,NaN,NaN,120.25125,117.9771657142857,116.42140000000035,111.79769930000002,113.83739860000001,111.703999,112.76911580263547,111.79497928863492,110.82076846153844,113.90624756030873,107.73528936276814,116.42140000000035,111.79769930000002,113.83739860000001,111.703999,112.207,20458000,19622440.4,49.541267759127024,NaN,1.5,2.75,NaN,NaN,1.8630960405406949,1.0425818391070256,NaN,0.18897559264502428,-0.8281047719782464,-1.0170803646232707,22.411605636201177,-0.5237372857290091,NaN,NaN,NaN,-372588034
1013783400,112.14999,112.24001,110.71001,110.89,NaN,NaN,120.4525,117.97668999999999,116.35725000000033,111.8995993,113.74939880000002,111.56499899999999,112.69542498684584,111.7087907849554,110.86769153846151,113.93736095308942,107.7980221238336,116.35725000000033,111.8995993,113.74939880000002,111.56499899999999,111.28000666666667,18392096,19672490,45.50718596611654,NaN,1.5,2.75,NaN,NaN,1.8393034662163597,0.9349144922681368,NaN,0.173774002168263,-0.799862861912942,-0.973636864081205,23.000134336309156,0.9467363726230003,NaN,NaN,NaN,-390980130
1014129000,110.14999,110.298,108.61,108.75999,NaN,NaN,120.65375,117.97621428571428,116.27214995000033,111.96969920000001,113.57659880000001,111.34549899999999,112.54109420304796,111.42795261495965,110.62845999999998,113.83029118616464,107.42662881383531,116.27214995000033,111.96969920000001,113.57659880000001,111.34549899999999,109.22266333333334,15988102,19620485.5,39.2423083252855,NaN,1.5,2.75,NaN,NaN,1.8707817900580483,0.8148678074250507,NaN,0.028080618750247255,-0.9385360906433959,-0.9666167093936432,20.988043807912046,-0.37557021159659226,NaN,NaN,NaN,-406968232
1014215400,109.05,110.59,107.82001,110.59,NaN,NaN,107.82001,117.97573857142856,116.20054995000034,112.06169920000002,113.44159880000001,111.256499,112.46458070488922,111.34814760401112,110.42922999999996,113.27356416263159,107.58489583736834,116.20054995000034,112.06169920000002,113.44159880000001,111.256499,109.66667,29242896,20498140.25,46.107006171074225,NaN,1.5,2.75,NaN,NaN,1.9350109479110453,1.426612153265953,NaN,0.06089021912941539,-0.890503935481874,-0.9513941546112894,22.92561397370873,1.7387304507819692,NaN,NaN,NaN,-377725336
1014301800,109.931,110.63,108.25999,108.3,NaN,NaN,107.72501022727272,117.97526285714285,116.10679995000034,112.1219992,113.27639880000001,111.00999900000002,112.3012638145014,111.05784783220054,110.09461538461535,112.83685169143138,107.35237907779933,116.10679995000034,112.1219992,113.27639880000001,111.00999900000002,109.06333000000001,26292608,21190825.75,40.01439918975593,NaN,1.5,2.75,NaN,NaN,1.9660823087745416,1.2407542919841148,NaN,-0.05920609612359462,-1.0254017747657826,-0.966195678642188,26.157200130563215,0.25921125717459836,NaN,NaN,NaN,-404017944
1014388200,108.35001,109.94,107.87,109.64,NaN,NaN,107.63001045454546,117.97478714285714,116.02089990000033,112.1739992,113.18159880000002,110.81299900000002,112.1969005276582,110.9228147053243,110.07846076923076,112.82873323689667,107.32818830156485,116.02089990000033,112.1739992,113.18159880000002,110.81299900000002,109.14999999999999,26572896,21911350.65,44.62545531092882,NaN,1.5,2.75,NaN,NaN,1.9735050010049309,1.2127456871308844,NaN,-0.037052167392350954,-1.0125108878826268,-0.9754587204902758,26.784850782994745,-0.40875647197747556,NaN,NaN,NaN,-377445048
1014647400,109.748,111.81,109.7,111.45,NaN,NaN,107.53501068181818,117.97431142857143,115.95209985000034,112.24579920000001,113.127599,110.707999,112.1676103108873,110.97302282862675,110.25384538461536,113.04056871939733,107.46712204983339,115.95209985000034,112.24579920000001,113.127599,110.707999,110.98666666666666,17458704,22143750.9,50.19459753205992,NaN,1.5,2.75,NaN,NaN,1.9875403580760074,0.7884257765923478,NaN,0.10317886424998812,-0.8464851401777906,-0.9496640044277788,26.198433925355832,0.00897343862168442,NaN,NaN,NaN,-359986344
1014733800,111.60001,112.03999,110.57001,111.22,NaN,NaN,107.4400109090909,117.97383571428571,115.87149985000035,112.30219919999999,113.06639900000002,110.57599899999998,112.13044912222504,110.99654446399563,110.44769153846151,113.1234783831347,107.77190469378833,115.87149985000035,112.30219919999999,113.06639900000002,110.57599899999998,111.27666666666669,22362000,22732375.9,49.51314966143891,NaN,1.5,2.75,NaN,NaN,1.9505717610705788,0.9837071187970282,NaN,0.17964399437329726,-0.7251090114611571,-0.9047530058344544,25.27952746225145,0.11702223422449856,NaN,NaN,NaN,-382348344
1014820200,111.961,112.86,110.64999,111.64999,NaN,NaN,107.34501113636364,117.97336,115.79854975000035,112.345199,113.05819880000001,110.64449849999997,112.11160758802014,111.05877737218653,110.72692153846153,113.0677102156074,108.38613286131564,115.79854975000035,112.345199,113.05819880000001,110.64449849999997,111.71999333333333,28597904,22775506.3,50.8564026316716,NaN,1.5,2.75,NaN,NaN,1.9691030638512517,1.255642953588259,NaN,0.2538430392431936,-0.5874492067804624,-0.841292246023656,25.30014048703839,-0.5522490424868562,NaN,NaN,NaN,-353750440
1014906600,111.834,112.75,111.03,111.14999,NaN,NaN,107.25001136363636,117.97288428571429,115.72339975000035,112.38229889999998,113.0185986,110.60849799999997,112.07389709437228,111.06746428912115,110.80845923076922,113.12857769852799,108.48834076301044,115.72339975000035,112.38229889999998,113.0185986,110.60849799999997,111.64332999999999,23755504,22227691.1,49.21661500641081,NaN,1.5,2.75,NaN,NaN,1.9513099878618765,1.0687346649333271,NaN,0.26280376043001774,-0.5127875454861339,-0.7755913059161517,24.575497634461648,-0.8120738889880419,NaN,NaN,NaN,-377505944
1014993000,111.72,113.85001,111.50999,113.74001,NaN,NaN,107.15501159090908,117.97240857142856,115.66384985000035,112.44739899999999,113.0073988,110.63649899999996,112.1392348553773,111.32199245206199,110.98538307692306,113.7745272022457,108.19623895160042,115.66384985000035,112.44739899999999,113.0073988,110.63649899999996,113.03333666666667,26179504,22541206.3,56.95850675678069,NaN,1.5,2.75,NaN,NaN,2.0047892744431706,1.1614065215311924,NaN,0.427003503017261,-0.2418369271445755,-0.6688404301618365,28.141250497541012,2.5701235458562515,NaN,NaN,NaN,-351326440
1015252200,113.901,115.99001,113.64999,115.75,NaN,NaN,107.06001181818182,117.97193285714285,115.61249985000035,112.53959899999998,113.02279880000002,110.79149949999996,112.28083348849975,111.74370745662752,111.3438446153846,115.11837484788781,107.56931438288139,115.61249985000035,112.53959899999998,113.02279880000002,110.79149949999996,115.13,27184800,23108521.3,61.82265332736196,NaN,1.5,2.75,NaN,NaN,2.028734326268658,1.1763972106687761,NaN,0.6419070480035659,0.13354337984262088,-0.508363668160945,28.366394634553927,6.4270050043219,NaN,NaN,NaN,-324141640
1015338600,115.33,116.39999,114.97,115.38,NaN,NaN,106.96501204545454,117.97145714285713,115.56364990000034,112.63379889999996,113.01459900000002,111.06799899999996,112.40236943012721,112.0900210321868,111.58307538461538,115.91513063844516,107.2510201307856,115.56364990000034,112.63379889999996,113.01459900000002,111.06799899999996,115.58333,22733008,23032976.5,60.46797171804881,NaN,1.5,2.75,NaN,NaN,1.9859668743923253,0.9869765637975622,NaN,0.7239767173820202,0.39660722856658026,-0.3273694888154399,24.714630807243175,4.331313862012833,NaN,NaN,NaN,-346874648
1015425000,115.10001,117.14999,115.07899,116.75,NaN,NaN,106.87001227272727,117.97098142857142,115.52039995000034,112.71809879999996,113.05659920000002,111.44699899999996,112.57286474659281,112.53382855293091,111.94384461538462,117.08102220166734,106.8066670291019,115.52039995000034,112.71809879999996,113.05659920000002,111.44699899999996,116.32632666666666,20143808,22359466.9,63.64457074101835,NaN,1.5,2.75,NaN,NaN,1.9920406690785877,0.9009073467668409,NaN,0.8278791049251518,0.7074793923409999,-0.12039971258415194,24.088005977445718,7.80240073868883,NaN,NaN,NaN,-326730840
1015511400,117.36099,117.5,115.57001,116.5,NaN,NaN,106.7750125,117.97050571428571,115.47299995000034,112.78309879999998,113.08759920000003,111.83699899999996,112.726870050648,112.9115591669375,112.37538307692307,118.00487852346079,106.74588763038535,115.47299995000034,112.78309879999998,113.08759920000003,111.83699899999996,116.52333666666668,19331808,21847006.9,62.655165274799884,NaN,1.5,2.75,NaN,NaN,1.9876084784301173,0.8848721515257086,NaN,0.8347475630708397,0.9230347412543978,0.08828717818355802,18.300529071986478,6.256840569135352,NaN,NaN,NaN,-346062648
1015597800,117.381,117.907,116.48,116.99001,NaN,NaN,106.68001272727273,117.907,115.41320000000034,112.85799889999997,113.13279940000004,112.28549949999997,112.89405200944611,113.2999830558006,113.00846153846153,118.71971703378847,107.2972060431346,115.41320000000034,112.85799889999997,113.13279940000004,112.28549949999997,117.12567,19930304,21671022.1,63.84167384470391,NaN,1.5,2.75,NaN,NaN,1.9475650156851085,0.91967531148427,NaN,0.8257601290576118,1.1204873395055728,0.294727210447961,18.080537188050016,4.970847913862714,NaN,NaN,NaN,-326132344
1015857000,116.89101,117.89999,116.42999,117.24001,NaN,NaN,106.58501295454545,117.90502357142857,115.35365010000034,112.93739899999997,113.17039960000005,112.64299999999996,113.06448173456587,113.67522371715292,113.52000076923076,119.45983327143372,107.5801682670278,115.35365010000034,112.93739899999997,113.17039960000005,112.64299999999996,117.18999666666667,15622102,21488222.4,64.46204629581925,NaN,1.5,2.75,NaN,NaN,1.9134532288504578,0.7270076467562995,NaN,0.7901067132997797,1.2823606020726857,0.492253888772906,17.051633034646223,5.412704549541449,NaN,NaN,NaN,-310510242
1015943400,116.10899,117.25,115.94,117.17,NaN,NaN,106.49001318181817,117.90304714285713,115.29080005000033,113.00919889999997,113.19259960000005,112.92949999999996,113.22548245085741,114.00805955361454,114.20230846153846,119.59995040036478,108.80466652271215,115.29080005000033,113.00919889999997,113.19259960000005,112.92949999999996,116.78666666666668,17154896,21406362.4,64.13021933939507,NaN,1.5,2.75,NaN,NaN,1.870349426789711,0.8013923935063344,NaN,0.7173854841387778,1.3889857439463782,0.6716002598076004,16.84703453748661,4.944030895121442,NaN,NaN,NaN,-327665138
1016029800,116.631,116.75,115.64,116.03999,NaN,NaN,106.39501340909091,117.90107071428571,115.21275005000032,113.09309889999997,113.19339940000005,113.17699949999997,113.33585529592183,114.20157673898458,114.69461538461539,119.46951468047658,109.9197160887542,115.21275005000032,113.09309889999997,113.19339940000005,113.17699949999997,116.14332999999999,17175504,21568012.6,58.86327320701517,NaN,1.5,2.75,NaN,NaN,1.8460387534475888,0.7963415229087912,NaN,0.5559612443810612,1.3665518152839269,0.8105905709028657,18.9080638172737,4.399460584746792,NaN,NaN,NaN,-344840642
1016116200,116.03999,116.42999,115.63,115.88,NaN,NaN,106.30001363636363,117.89909428571428,115.13475005000033,113.17769889999995,113.22499940000006,113.35749949999997,113.43562567647392,114.361426573367,115.0353846153846,119.45446581742537,110.61630341334383,115.13475005000033,113.17769889999995,113.22499940000006,113.35749949999997,115.97999666666666,11169602,21287302.3,58.13527366263343,NaN,1.5,2.75,NaN,NaN,1.77132098534419,0.5247072570581196,NaN,0.40803906355428843,1.3206394003457262,0.9126003367914378,18.486540147811898,1.8814751291124359,NaN,NaN,NaN,-356010244
1016202600,115.97,116.95,115.89999,116.64999,NaN,NaN,106.20501386363635,117.89711785714286,115.07175000000034,113.27069869999995,113.24739920000006,113.58699899999996,113.5616791793573,114.5793849949511,115.45307615384614,119.34581636276839,111.56033594492389,115.07175000000034,113.27069869999995,113.24739920000006,113.58699899999996,116.49999333333332,21221904,21325497.5,60.657180884550016,NaN,1.5,2.75,NaN,NaN,1.721226629248177,0.995142270420655,NaN,0.334753184269315,1.3310418171280816,0.9962886328587666,14.289557457684449,0.7775291576673887,NaN,NaN,NaN,-334788340
1016461800,117.10001,117.567,116.10001,116.67,NaN,NaN,106.11001409090909,117.89514142857142,115.00695000000033,113.34269869999997,113.24399920000005,113.87599899999998,113.68357411350014,114.77849118590814,115.83923076923075,119.08920472931254,112.58925680914896,115.00695000000033,113.34269869999997,113.24399920000005,113.87599899999998,116.77900333333334,17557504,21283767.9,60.723396658335965,NaN,1.5,2.75,NaN,NaN,1.703066870016164,0.8249246130897716,NaN,0.26346471800608073,1.3256195303663674,1.0621548123602866,10.639761326084377,1.118044721788877,NaN,NaN,NaN,-317230836
1016548200,117.30099,117.74001,116.82001,117.45,NaN,NaN,106.01501431818181,117.893165,114.95369995000034,113.42809869999998,113.24059920000005,114.31049949999996,113.83127708944131,115.03292059677403,116.3238469230769,118.2357599253179,114.4119339208359,114.95369995000034,113.42809869999998,113.24059920000005,114.31049949999996,117.33667333333334,17913008,21380013.2,63.31526850596428,NaN,1.5,2.75,NaN,NaN,1.6578485221578663,0.8378389588646279,NaN,0.2450655476676875,1.368486746944896,1.1234211992772085,10.789601967652677,0.5995717344753771,NaN,NaN,NaN,-299317828
1016634600,116.5,116.58,115.19,115.24001,NaN,NaN,105.92001454545453,117.89118857142857,114.89450000000033,113.49429879999997,113.20959960000006,114.54299999999996,113.88652151730636,115.05264339708127,116.43923153846153,117.8210362807814,115.05742679614166,114.89450000000033,113.49429879999997,113.20959960000006,114.54299999999996,115.67000333333333,17115008,20773618.8,52.703262416147126,NaN,1.5,2.75,NaN,NaN,1.7008593420037332,0.823881874639964,NaN,0.06940814769839809,1.2101813839002062,1.1407732362018081,14.234483548581492,-1.081536480686697,NaN,NaN,NaN,-316432836
1016721000,115.3,115.83,114.12,115.28999,NaN,NaN,105.82501477272727,117.88921214285713,114.84444995000034,113.54149859999995,113.18499940000005,114.89249949999996,113.94155949701984,115.07524783545448,116.40384615384613,117.87510281121479,114.93258949647748,114.84444995000034,113.54149859999995,113.18499940000005,114.89249949999996,115.07999666666666,26886704,20803323.6,52.89554574877118,NaN,1.5,2.75,NaN,NaN,1.7015122461463232,1.2924234856395733,NaN,-0.05153960234929289,1.076348733265192,1.1278883356144849,14.255477988879324,-1.4531326221785903,NaN,NaN,NaN,-289546132
1016807400,115.5,115.94,114.7,115.03999,NaN,NaN,105.730015,117.88723571428571,114.78989990000035,113.58869839999996,113.17439900000005,115.16249899999998,113.98463520301907,115.07188994636357,116.3776915384615,117.93064280564874,114.82474027127427,114.78989990000035,113.58869839999996,113.17439900000005,115.16249899999998,115.22666333333332,15235398,20236448.7,51.761972180767934,NaN,1.5,2.75,NaN,NaN,1.6685470857072997,0.7528691533707691,NaN,-0.1508826764268738,0.9392849900808926,1.0901676665077664,13.86270961824567,-1.8765095635866929,NaN,NaN,NaN,-304781530
1017066600,115.091,115.36,113.3,113.61,NaN,NaN,105.63501522727272,117.88525928571428,114.72429990000035,113.65029839999995,113.12499900000005,115.270499,113.96994362643008,114.93266233242419,116.13615307692304,118.25572918960144,114.01657696424463,114.72429990000035,113.65029839999995,113.12499900000005,115.270499,114.08999999999999,17499600,20238493.5,45.72570206319672,NaN,1.5,2.75,NaN,NaN,1.6965080081567785,0.8646691019763897,NaN,-0.3064369430469349,0.7071214876990979,1.0135584307460328,14.893780784485207,-3.038320389178119,NaN,NaN,NaN,-322281130
1017153000,113.521,115.02,113.47,114.27,NaN,NaN,105.54001545454545,117.88328285714286,114.65894990000035,113.73139839999996,113.11159900000006,115.422999,113.98171054304066,114.86955163409807,115.96461461538458,118.28963381269403,113.63959541807512,114.65894990000035,113.73139839999996,113.11159900000006,115.422999,114.25333333333334,19948608,20117823.9,48.69926449348312,NaN,1.5,2.75,NaN,NaN,1.686043150431294,0.9915887572711083,NaN,-0.35499217348208456,0.5698182138934271,0.9248103873755117,15.720119258074256,-1.525327604733512,NaN,NaN,NaN,-302332522
1017239400,114.033,115.00999,113.75999,114.57001,NaN,NaN,105.44501568181818,117.88130642857142,114.58779995000036,113.81909849999997,113.11859920000006,115.569,114.00478110998024,114.84102385942207,115.77846076923073,118.1326103234182,113.42431121504326,114.58779995000036,113.81909849999997,113.11859920000006,115.569,114.44666333333333,19020496,19638953.5,50.03921446437156,NaN,1.5,2.75,NaN,NaN,1.654897211114773,0.9685086326010192,NaN,-0.356101757366022,0.47968319066798415,0.8357849480340062,15.242879493984997,-1.1304711770797369,NaN,NaN,NaN,-283312026
1017325800,114.97,115.77,114.5,114.52,NaN,NaN,105.3500159090909,117.87933,114.52174995000036,113.87919859999997,113.10599940000007,115.73750050000001,114.02498577233396,114.81045015852473,115.5692292307692,117.84890875467809,113.2895497068603,114.52174995000036,113.87919859999997,113.10599940000007,115.73750050000001,114.92999999999999,17535904,19327973.5,49.805680700512376,NaN,1.5,2.75,NaN,NaN,1.6274045531780033,0.9072810452684034,NaN,-0.3489409936983313,0.399608705911092,0.7485496996094233,15.250094825104037,-1.8259667231861798,NaN,NaN,NaN,-300847930
1017671400,114.23,115.10001,113.5,114.57001,NaN,NaN,105.25501613636364,117.87735357142857,114.45365000000037,113.93239869999996,113.14099940000007,115.77900050000001,114.04635927145812,114.78755109580808,115.36922999999994,117.50363871968565,113.23482128031424,114.45365000000037,113.93239869999996,113.14099940000007,115.77900050000001,114.39000666666668,17711808,18904588.7,50.05669654974805,NaN,1.5,2.75,NaN,NaN,1.6254477993795742,0.9369052287289382,NaN,-0.32979356562940143,0.3363077425726715,0.6661013082020729,14.487846926164961,-1.7999400017142413,NaN,NaN,NaN,-283136122
1017757800,113.98,114.95,113.77,113.94,NaN,NaN,105.16001636363636,117.87537714285713,114.38835000000036,113.96499879999996,113.14639940000006,115.6885005,114.04218831963622,114.70683194382636,115.20769230769226,117.43062029853,112.98476431685451,114.38835000000036,113.96499879999996,113.14639940000006,115.6885005,114.21999999999998,15594500,18325073.7,46.876341846333396,NaN,1.5,2.75,NaN,NaN,1.5936300994238908,0.8509924846850685,NaN,-0.3467824898559001,0.23262319588219782,0.5794056857380979,14.571802677392272,-2.988505747126441,NaN,NaN,NaN,-298730622
1017844200,114.011,114.217,112.16,113.14,NaN,NaN,105.06501659090908,117.87340071428571,114.32354995000036,113.97239889999996,113.14619960000007,115.5765005,114.00680838553285,114.55760985393813,114.99692307692304,117.43416142101945,112.55968473282663,114.32354995000036,113.97239889999996,113.14619960000007,115.5765005,113.17233333333331,25660704,18471458.5,43.12910576577738,NaN,1.5,2.75,NaN,NaN,1.6267279494650417,1.3892083291636121,NaN,-0.3955883693739815,0.08492022402062105,0.48050859339460256,13.553477592026145,-1.8222924486035688,NaN,NaN,NaN,-324391326
1017930600,112.60001,113.39999,112.23,112.67,NaN,NaN,104.97001681818182,117.87142428571428,114.25749995000035,113.97659889999996,113.15219960000007,115.3725005,113.95438452727666,114.37783748689641,114.69076999999999,117.21869888735523,112.16284111264474,114.25749995000035,113.97659889999996,113.15219960000007,115.3725005,112.76666333333334,23561008,18642318.5,41.05279376481815,NaN,1.5,2.75,NaN,NaN,1.5941038102175387,1.2638453741684543,NaN,-0.43981656024678795,-0.06926210691388235,0.3705544533329056,9.52723065568973,-2.2725216647169466,NaN,NaN,NaN,-347952334
1018017000,113.19,113.63,112.17999,112.69,NaN,NaN,104.87501704545454,117.86944785714286,114.19694995000035,113.97749879999996,113.14139960000007,115.1820005,113.90480082032464,114.21709105957294,114.38461615384614,116.84264014983307,111.9265921578592,114.19694995000035,113.97749879999996,113.14139960000007,115.1820005,112.83333000000002,19404896,18645972.9,41.182555049430626,NaN,1.5,2.75,NaN,NaN,1.5838113952019996,1.0407017163475552,NaN,-0.44658394353494224,-0.18767547608577217,0.25890846744917007,9.501943295601485,-2.0427592179032747,NaN,NaN,NaN,-328547438
1018272600,111.32001,113.03,111.23,112.92999,NaN,NaN,104.78001727272726,117.86747142857142,114.15159990000035,113.97959869999997,113.12839940000008,114.97899950000001,113.8665729450178,114.09451000628027,114.03692307692306,115.8584946151916,112.21535153865452,114.15159990000035,113.97959869999997,113.12839940000008,114.97899950000001,112.39666333333332,16471102,18473012.8,42.80942998445808,NaN,1.5,2.75,NaN,NaN,1.5992534384018566,0.8916305195219699,NaN,-0.4144597579457433,-0.2591662299830091,0.1552935279627342,9.833692426377588,-0.5985476630578257,NaN,NaN,NaN,-312076336
1018359000,113.189,113.189,111.92999,112.14,NaN,NaN,104.68501749999999,117.865495,114.10304985000035,113.98069869999996,113.10019940000008,114.723999,113.79886420207592,113.90836619615834,113.79846076923076,115.73559289220957,111.86132864625195,114.10304985000035,113.98069869999996,113.10019940000008,114.723999,112.41966333333333,15122699,18448042.65,38.986667950600456,NaN,1.5,2.75,NaN,NaN,1.574950335658866,0.8197454487129561,NaN,-0.4244293730843601,-0.37524318839271587,0.049186184691644194,7.993695157233692,-1.8640063008663652,NaN,NaN,NaN,-327199035
1018445400,112.101,113.53999,112.092,113.41,NaN,NaN,104.59001772727272,117.86351857142857,114.06379990000036,113.96929869999997,113.09119940000008,114.53599899999999,113.78361462552392,113.86090274890516,113.65384615384616,115.39475052477398,111.91294178291834,114.06379990000036,113.96929869999997,113.09119940000008,114.53599899999999,113.01399666666667,17204096,18450502.65,47.1562242553769,NaN,1.5,2.75,NaN,NaN,1.5658817402546616,0.9324459244474839,NaN,-0.32782883364491955,-0.3605998573645053,-0.03277102371958571,10.101953675432013,-1.0124900923025142,NaN,NaN,NaN,-309994939
1018531800,112.89301,113.052,110.5,110.59,NaN,NaN,104.49501795454545,117.86154214285713,114.00779995000035,113.92859869999997,113.09739940000009,114.2634995,113.65837483628769,113.54938820139039,113.31153923076923,115.51590044652443,111.10717801501403,114.00779995000035,113.92859869999997,113.09739940000009,114.2634995,111.38066666666668,25459104,18864682.65,35.719350023811586,NaN,1.5,2.75,NaN,NaN,1.6618901873793284,1.3495643935467954,NaN,-0.429763202614587,-0.5699750269878194,-0.14021182437323246,16.95333158843247,-3.431714984282215,NaN,NaN,NaN,-335454043
1018618200,111.02901,111.64999,110.03999,111.42,NaN,NaN,104.40001818181817,117.85956571428571,113.95275000000034,113.89409869999996,113.08839940000009,114.04049949999998,113.57059543094307,113.3465893250675,113.1430776923077,115.55537556027899,110.73077982433641,113.95275000000034,113.89409869999996,113.08839940000009,114.04049949999998,111.03666,14950602,19053732.65,40.30812939478906,NaN,1.5,2.75,NaN,NaN,1.6581837454236619,0.7846547589718595,NaN,-0.4168778476494077,-0.6613091339349921,-0.24443128628558441,18.05247976987948,-2.7494193288453013,NaN,NaN,NaN,-320503441
1018877400,111.62,111.86,110.2,110.57001,NaN,NaN,104.3050184090909,117.85758928571428,113.88650000000034,113.85619879999994,113.0361998000001,113.73650049999999,113.45292541404335,113.0821531988706,112.85846307692307,115.5308282346814,110.18609791916475,113.88650000000034,113.85619879999994,113.0361998000001,113.73650049999999,110.87666999999999,17402896,18862782.25,37.36630038778779,NaN,1.5,2.75,NaN,NaN,1.6583134778934,0.9226049354410588,NaN,-0.43896407384541314,-0.7931363785923509,-0.3541723047469377,18.12788277219851,-2.9576882569773577,NaN,NaN,NaN,-337906337
1018963800,111.702,113.32001,111.67,113.2,NaN,NaN,104.21001863636363,117.85561285714286,113.83824995000036,113.83049879999994,113.0472000000001,113.56300049999997,113.44300677035538,113.09337670374006,112.7530776923077,115.2494052141134,110.256750170502,113.83824995000036,113.83049879999994,113.0472000000001,113.56300049999997,112.73000333333333,15097000,18739757.05,49.61865376623995,NaN,1.5,2.75,NaN,NaN,1.7362910866152999,0.8056134324324125,NaN,-0.2587273314783952,-0.6775814690949318,-0.41885413761653656,23.743718232399626,0.05303164221318921,NaN,NaN,NaN,-322809337
1019050200,113.39,113.67,112.60001,112.96001,NaN,NaN,104.11501886363635,117.85363642857142,113.79445000000034,113.81209889999997,113.1094000000001,113.33850099999998,113.42406572053753,113.08067511290767,112.63307846153847,114.91925599020998,110.34690093286697,113.79445000000034,113.81209889999997,113.1094000000001,113.33850099999998,113.07667333333336,12920398,18490126.55,48.682794212792835,NaN,1.5,2.75,NaN,NaN,1.6886981518570645,0.6987728269496348,NaN,-0.1436925068051308,-0.5984697711229501,-0.4547772643178193,23.425295016338975,0.2573977101269151,NaN,NaN,NaN,-335729735
1019136600,112.89999,113.46001,111.14999,112.47,NaN,NaN,104.02001909090909,117.85166,113.74905000000035,113.79639899999997,113.1754000000001,113.20000049999996,113.38665137855567,113.02251557834504,112.47153923076925,114.46554037272026,110.47753808881825,113.74905000000035,113.79639899999997,113.1754000000001,113.20000049999996,112.36,25211008,18894926.55,46.74418713597614,NaN,1.5,2.75,NaN,NaN,1.7330782838672738,1.3342739350315178,NaN,-0.0911834845853206,-0.56875662004947,-0.4775731354641494,23.437043094131482,-0.19522584080219973,NaN,NaN,NaN,-360940743
1019223000,113.2,113.24001,112.56,112.88,NaN,NaN,103.92501931818181,117.84968357142857,113.70605000000036,113.76839909999995,113.2590000000001,113.07950099999996,113.36678269704367,113.0089426661217,112.3900007692308,114.21682350079482,110.56317803766677,113.70605000000036,113.76839909999995,113.2590000000001,113.07950099999996,112.89333666666666,10602500,18080716.35,48.58892465836721,NaN,1.5,2.75,NaN,NaN,1.6642876921624683,0.5863982264176164,NaN,-0.022972672510643333,-0.5062889761024536,-0.48331630359181027,23.53992361634943,-0.04426636361165727,NaN,NaN,NaN,-350338243
1019482200,112.38,112.42999,110.84,111,NaN,NaN,103.83001954545453,117.84770714285713,113.65030005000035,113.71909919999995,113.3186000000001,112.87750149999995,113.27396768931648,112.81761479315773,112.22538538461541,114.13596246779424,110.31480830143657,113.65030005000035,113.71909919999995,113.3186000000001,112.87750149999995,111.42333,13923301,18015111.5,41.49171512858854,NaN,1.5,2.75,NaN,NaN,1.6911242855794342,0.7728678781699464,NaN,-0.09458609700603482,-0.6015489248493537,-0.5069628278433189,25.390776262186677,-1.0165864098448374,NaN,NaN,NaN,-364261544
1019568600,111.09,111.48,110.17,110.52,NaN,NaN,103.73501977272727,117.84573071428571,113.58990000000036,113.66999929999994,113.3272000000001,112.72300149999994,113.16596895640211,112.59879433666651,112.06000076923078,114.15163765497103,109.96836388349054,113.58990000000036,113.66999929999994,113.3272000000001,112.72300149999994,110.72333333333334,16968608,17988561.9,39.889655428939,NaN,1.5,2.75,NaN,NaN,1.6639011223237605,0.9432998643432414,NaN,-0.16052423989770404,-0.707618127715449,-0.5470938878177449,25.232444682045486,-2.5482761661229176,NaN,NaN,NaN,-381230152
1019655000,110.56,111.81,109.39999,109.41,NaN,NaN,103.64001999999999,117.84375428571428,113.51630000000036,113.63069929999995,113.2866000000001,112.48000149999993,113.01867605615105,112.29509963793637,111.80769307692309,114.28941745362233,109.32596870022384,113.51630000000036,113.63069929999995,113.2866000000001,112.48000149999993,110.20666333333334,18903296,17936296.3,36.39043736020864,NaN,1.5,2.75,NaN,NaN,1.717194613586349,1.0539130087854314,NaN,-0.2592879008123248,-0.8712037638331509,-0.6119158630208261,24.25377832212451,-1.0670042499321881,NaN,NaN,NaN,-400133448
1019741400,109.21001,109.741,108.72,109.47,NaN,NaN,103.54502022727272,117.84177785714286,113.44314995000038,113.57669929999993,113.25420000000011,112.22500099999993,112.87951228924317,112.02604252956148,111.54154000000001,114.21913812977961,108.86394187022042,113.44314995000038,113.57669929999993,113.25420000000011,112.22500099999993,109.31033333333335,25455504,18258046.7,36.71360956753676,NaN,1.5,2.75,NaN,NaN,1.66746642690161,1.3942074099306583,NaN,-0.29819096994225447,-0.9846545754486442,-0.6864636055063897,20.00535315547076,-1.7501346257404442,NaN,NaN,NaN,-374677944
1019827800,109.78999,110.00999,107.28999,107.39,NaN,NaN,103.45002045454545,117.83980142857142,113.37170000000036,113.51009929999992,113.15660000000011,111.86850099999992,112.66423729750814,111.58451466960324,111.1761553846154,114.61540983185769,107.73690093737311,113.37170000000036,113.51009929999992,113.15660000000011,111.86850099999992,108.22999333333333,19769904,18369746.7,30.860220548217427,NaN,1.5,2.75,NaN,NaN,1.7426473964086377,1.0762208278027046,NaN,-0.433425379697303,-1.2282453301280185,-0.7948199504307155,21.64197249968142,-2.8760149338866805,NaN,NaN,NaN,-394447848
1020087000,107.931,108.25999,106.63,106.86,NaN,NaN,103.35502068181817,117.837825,113.31075000000037,113.44499929999992,113.0526000000001,111.48300049999993,112.43662014858624,111.13456089154579,110.67230923076923,114.54654263296175,106.79807582857671,113.31075000000037,113.44499929999992,113.0526000000001,111.48300049999993,107.24999666666668,17725008,18370406.7,29.566679898864635,NaN,1.5,2.75,NaN,NaN,1.734600439522307,0.9648674789546168,NaN,-0.522043953253733,-1.4473748919978817,-0.9253309387441487,21.515698911417452,-5.600706713780921,NaN,NaN,NaN,-412172856
1020173400,107.02,108.64,106.64,107.86,NaN,NaN,103.2600209090909,117.83584857142857,113.25155000000036,113.37069939999994,112.99200000000008,111.17900049999994,112.25714484864169,110.82269794949381,110.46230923076922,114.61739815428952,106.30722030724893,113.25155000000036,113.37069939999994,112.99200000000008,111.17900049999994,107.71333333333332,19474496,18564406.5,35.094704894123055,NaN,1.5,2.75,NaN,NaN,1.7535575509849992,1.0490233555271482,NaN,-0.47796822230946323,-1.5227912166309778,-1.0448229943215146,15.817208670020168,-4.514880974249204,NaN,NaN,NaN,-392698360
1020259800,107.97,109.25,106.8,109.17999,NaN,NaN,103.16502113636363,117.83387214285713,113.20615000000038,113.28849939999995,113.00040000000008,110.98099999999995,112.13647210947927,110.66624957335155,110.29000076923077,114.45770374111123,106.12229779735031,113.20615000000038,113.28849939999995,113.00040000000008,110.98099999999995,108.4099966666667,24580496,18510396.1,41.609346081968795,NaN,1.5,2.75,NaN,NaN,1.8033034402003565,1.3279292278353783,NaN,-0.3315223941611345,-1.4592259870229327,-1.1277035928617982,18.58732875349594,-2.9252333955721483,NaN,NaN,NaN,-368117864
1020346200,109.10001,109.91,107.78,108.75999,NaN,NaN,103.07002136363636,117.83189571428571,113.15804995000036,113.20269929999995,112.96379980000007,110.78549949999994,112.00406104636244,110.48470104255617,110.15076846153846,114.39203807275769,105.90949885031924,113.15804995000036,113.20269929999995,112.96379980000007,110.78549949999994,108.81666333333334,15667301,18115710.75,40.22584691790612,NaN,1.5,2.75,NaN,NaN,1.8266389087574735,0.864846056343663,NaN,-0.2388763948951642,-1.4262990864807534,-1.1874226915855892,18.580338161126132,-3.649902551381993,NaN,NaN,NaN,-383785165
1020432600,108.60001,108.75999,107.2,107.58,NaN,NaN,102.97502159090908,117.82991928571428,113.08999995000039,113.11289929999995,112.94939980000007,110.52999949999995,111.83056845630901,110.20806284802701,109.71846076923076,113.76981055383344,105.66711098462808,113.08999995000039,113.11289929999995,112.94939980000007,110.52999949999995,107.84666333333332,18186000,18054765.95,36.54898707387397,NaN,1.5,2.75,NaN,NaN,1.8075925581319396,1.0072686652578844,NaN,-0.23276408116965341,-1.478377793047656,-1.2456137118780026,18.45224349584143,-3.0810810810810825,NaN,NaN,NaN,-401971165
1020691800,107.647,107.998,105.31,105.47,NaN,NaN,102.88002181818182,117.82794285714286,113.00614990000038,113.02379929999995,112.86599980000007,110.15699999999993,111.58113439919886,109.75681876726253,109.14230615384615,113.314375836216,104.9702364714763,113.00614990000038,113.02379929999995,112.86599980000007,110.15699999999993,106.25933333333334,23636000,18413010.85,31.078556294530046,NaN,1.5,2.75,NaN,NaN,1.8704788039796585,1.283657528502461,NaN,-0.34003037179317475,-1.670651676619471,-1.3306213048262963,19.23100941650216,-4.569308722403183,NaN,NaN,NaN,-425607165
1020778200,106.10899,106.32201,104.89999,105.10001,NaN,NaN,104.89999,117.82596642857142,112.92809990000038,112.93329949999996,112.73900000000008,109.80500049999993,111.3269726580538,109.31331317038038,108.57538384615385,112.78739735279845,104.36337033950926,112.92809990000038,112.93329949999996,112.73900000000008,109.80500049999993,105.44067,21921200,18752935.9,30.22428764288516,NaN,1.5,2.75,NaN,NaN,1.8384460322668261,1.1689476312879628,NaN,-0.40091872769271375,-1.8317697144421885,-1.4308509867494748,19.24881785936063,-3.9393017091673515,NaN,NaN,NaN,-447528365
1020864600,107.05299,109.36,106.78999,109.00999,NaN,NaN,104.84489528301887,117.82399,112.86394985000037,112.88059939999995,112.69479980000006,109.58499999999995,111.23611059303208,109.28442524939177,108.27769076923079,111.7045316502727,104.85084988818888,112.86394985000037,112.88059939999995,112.69479980000006,109.58499999999995,108.38666,27918496,19288655.9,46.8507544836462,NaN,1.5,2.75,NaN,NaN,2.0114134585334815,1.4474049485221,NaN,-0.15549496288003994,-1.6252196903495246,-1.4697247274694847,30.20134888613384,-0.4202155841783109,NaN,NaN,NaN,-419609869
1020951000,108.64999,109.10001,107.58,107.75,NaN,NaN,104.78980056603774,117.82201357142857,112.79764990000038,112.83749939999996,112.61680000000005,109.44299999999994,111.09940037369749,109.13828951135446,108.02769076923079,111.07705463116051,104.97832690730107,112.79764990000038,112.83749939999996,112.61680000000005,109.44299999999994,108.14333666666666,18087008,18920051.1,43.272395744042846,NaN,1.5,2.75,NaN,NaN,1.9763132114953756,0.9559703567608229,NaN,-0.06052721728549271,-1.5453837490763505,-1.4848565317908577,30.865517947366563,0.3352267436446591,NaN,NaN,NaN,-437696877
1021037400,107.97,108.05,105.60001,105.72,NaN,NaN,104.73470584905661,117.82003714285713,112.71589985000038,112.76339939999997,112.50820020000006,109.15799999999993,110.88844349629758,108.8127381293207,107.65846000000002,110.57061165339749,104.74630834660255,112.71589985000038,112.76339939999997,112.50820020000006,109.15799999999993,106.45666999999999,18959504,19120496.2,38.20895150494305,NaN,1.5,2.75,NaN,NaN,2.0101472678171346,0.9915801243693666,NaN,-0.11384304141489254,-1.6271603335594733,-1.5133172921445808,30.831544349457715,-1.0668163952835492,NaN,NaN,NaN,-456656381
1021296600,106.22,107.95,105.799,107.87,NaN,NaN,104.67961113207548,117.8180607142857,112.64854985000038,112.69909939999998,112.39080000000006,109.02299949999993,110.77007316310944,108.72295354557588,107.53999846153849,110.27756979400417,104.80242712907281,112.64854985000038,112.69909939999998,112.39080000000006,109.02299949999993,107.20633333333336,14686898,18984696.3,45.48474323335988,NaN,1.5,2.75,NaN,NaN,2.0258510344016254,0.7736177481016644,NaN,0.009712075361269612,-1.5011771979429938,-1.5108892733042634,33.09576337113833,0.00927127758205555,NaN,NaN,NaN,-441969483
1021383000,109.62,110.37,109,110.22,NaN,NaN,104.62451641509435,117.81608428571428,112.60489985000038,112.65149939999998,112.28020000000006,108.87399949999993,110.74850166651692,108.86552939837817,107.5976907692308,110.52084489701213,104.67453664144946,112.60489985000038,112.65149939999998,112.28020000000006,108.87399949999993,109.86333333333334,34212304,19940461.5,52.12087478751932,NaN,1.5,2.75,NaN,NaN,2.059718817658652,1.7157227780309898,NaN,0.2503909049301498,-1.197900642141576,-1.448291547071726,34.918826072246084,0.9525646595131536,NaN,NaN,NaN,-407757179
1021469400,109.5,110.91,109.28999,109.78999,NaN,NaN,104.56942169811322,117.81410785714286,112.56484980000039,112.59149939999998,112.16839980000006,108.71549849999994,110.71091297371233,108.9535732651993,107.7823053846154,110.92460561552447,104.64000515370633,112.56484980000039,112.59149939999998,112.16839980000006,108.71549849999994,109.99666,29537808,20771332,50.89989304180344,NaN,1.5,2.75,NaN,NaN,2.028311044968748,1.4220468865453597,NaN,0.3738793915542886,-0.9809423076288653,-1.3548216991831539,34.45089414370435,0.9470394397792802,NaN,NaN,NaN,-437294987
1021555800,109.7,110.48,109.33,110.36,NaN,NaN,104.51432698113207,117.81213142857142,112.5211497500004,112.54859949999998,112.04059980000005,108.60999849999996,110.69715168062557,109.08751866851365,108.05153615384617,111.42301013071047,104.68006217698188,112.5211497500004,112.54859949999998,112.04059980000005,108.60999849999996,110.05666666666667,28095008,20915532,52.48874197856111,NaN,1.5,2.75,NaN,NaN,1.9655745417566948,1.3432605013346062,NaN,0.4804085644605425,-0.7543109936074757,-1.2347195580680181,34.41769615161196,2.5841234430191498,NaN,NaN,NaN,-409199979
1021642200,110.66,111.25,110.10001,110.89999,NaN,NaN,104.45923226415094,111.25,112.47389965000042,112.50809939999998,111.92859960000006,108.51099799999994,110.7051061245226,109.26013498579806,108.28538153846156,111.9777160140508,104.59304706287233,112.47389965000042,112.50809939999998,111.92859960000006,108.51099799999994,110.75,27823696,21776591.8,54.00711591113568,NaN,1.5,2.75,NaN,NaN,1.9073185030597881,1.2776882744342022,NaN,0.567712778247218,-0.5250785852589956,-1.0927913635062136,33.52468586921261,5.14837394519769,NaN,NaN,NaN,-381376283
1021901400,110.64,110.69,109.492,109.7,NaN,NaN,104.40413754716981,111.11414285714285,112.41834965000042,112.45779939999998,111.78279940000004,108.44599799999995,110.66569019807073,109.30202689191253,108.32538230769234,112.06656087152693,104.58420374385774,112.41834965000042,112.45779939999998,111.78279940000004,108.44599799999995,109.96066666666667,13833801,21772116.8,50.170016540343454,NaN,1.5,2.75,NaN,NaN,1.8716521814126603,0.6353907214019723,NaN,0.5260551380094327,-0.43522244099442275,-0.9612775790038555,31.641314865185205,4.376774084036724,NaN,NaN,NaN,-395210084
1021987800,110.11,110.487,108.32001,108.7,NaN,NaN,104.34904283018868,110.97828571428572,112.35759960000043,112.39119939999999,111.61199920000003,108.35499799999994,110.58860430795032,109.24469099744468,108.32076769230773,112.05993802971476,104.5815973549007,112.35759960000043,112.39119939999999,111.61199920000003,108.35499799999994,109.16900333333332,16877296,21767551.2,47.162839078441145,NaN,1.5,2.75,NaN,NaN,1.8927477398831845,0.7753419686455131,NaN,0.41731437693001117,-0.43963460784134156,-0.8569489847713527,32.28485491618988,-0.2843684326546577,NaN,NaN,NaN,-412087380
1022074200,108.22,109.12,108,108.94,NaN,NaN,104.29394811320755,110.84242857142857,112.29554955000043,112.3199994,111.44739920000002,108.33149799999994,110.52395315861894,109.21567280721185,108.42538307692311,112.15187732934405,104.69888882450218,112.29554955000043,112.3199994,111.44739920000002,108.33149799999994,108.68666666666667,15844301,21614601.45,47.96891074593522,NaN,1.5,2.75,NaN,NaN,1.8375514727486717,0.7330369258323752,NaN,0.350410344959314,-0.4189360535722102,-0.7693463985315242,24.46383417935528,1.1044083526682114,NaN,NaN,NaN,-396243079
1022160600,109.261,110.36,108.48,110.10001,NaN,NaN,104.23885339622642,110.70657142857142,112.23549960000042,112.2609995,111.32859960000002,108.36299849999996,110.50732793671231,109.2998953970012,108.78153769230772,112.18077085753768,105.38230452707776,112.23549960000042,112.2609995,111.32859960000002,108.36299849999996,109.64667000000001,13880199,21035836.2,51.79668456452441,NaN,1.5,2.75,NaN,NaN,1.8405835104094805,0.6598358566796598,NaN,0.371150217023398,-0.3054086272522767,-0.6765588442756747,23.939901696823732,4.14302875520242,NaN,NaN,NaN,-382362880
1022247000,109.98,110.2,108.61,108.69,NaN,NaN,104.18375867924529,110.57071428571429,112.16589960000042,112.20489950000001,111.1847996,108.42799849999997,110.4360601744883,109.24181012109632,109.0576907692308,111.71888778607483,106.39649375238677,112.16589960000042,112.20489950000001,111.1847996,108.42799849999997,109.16666666666669,11875898,20641135.9,47.24679508982749,NaN,1.5,2.75,NaN,NaN,1.822684688237375,0.5753509912213698,NaN,0.2808777730420726,-0.325461627973084,-0.6063394010151566,22.15160791563178,0.7601742838601957,NaN,NaN,NaN,-394238778
1022592600,109.05,109.13,107.45,108.10001,NaN,NaN,104.12866396226416,110.43485714285714,112.0966996500004,112.13059960000001,111.0138,108.48999899999997,110.34445036372405,109.13306725242047,108.98769230769236,111.69765006894623,106.27773454643848,112.0966996500004,112.13059960000001,111.0138,108.48999899999997,108.22667,24237104,20966740.7,45.447844175622286,NaN,1.5,2.75,NaN,NaN,1.8124929247918478,1.1559786209403544,NaN,0.17744877413433158,-0.38452843334724207,-0.5619772074815736,19.52985576157397,-1.9234168027581213,NaN,NaN,NaN,-418475882
1022679000,107.629,108.02,107.13,107.3,NaN,NaN,104.07356924528302,110.299,112.0316996500004,112.0351996,110.8264,108.46199899999996,110.22506015338193,108.95848941885662,108.95307692307696,111.73590487730134,106.17024896885259,112.0316996500004,112.0351996,110.8264,108.46199899999996,107.48333333333333,14779102,20731971,43.05399980691884,NaN,1.5,2.75,NaN,NaN,1.7523155730210018,0.7128652649572006,NaN,0.0573879931091581,-0.4902422160951261,-0.5476302092042842,14.348379117682573,-2.267957215407348,NaN,NaN,NaN,-433254984
1022765400,106.55099,107.50999,105.89999,107,NaN,NaN,104.0184745283019,110.16314285714286,111.96284965000041,111.92899959999998,110.61740000000002,108.35299949999997,110.09858720619049,108.77196661706074,109.0515384615385,111.43120355962078,106.67187336345621,111.96284965000041,111.92899959999998,110.61740000000002,108.35299949999997,106.80332666666668,18218096,20413851,42.15726187056641,NaN,1.5,2.75,NaN,NaN,1.742150174948073,0.8924379824267357,NaN,-0.03502481096289911,-0.591411222907908,-0.5563864119450089,14.327910637753462,-3.044581370061616,NaN,NaN,NaN,-451473080
1022851800,107.39999,108.56,106.85001,107.22,NaN,NaN,103.96337981132076,110.02728571428571,111.90629965000042,111.83329969999998,110.4569998,108.27599999999995,109.9857014333987,108.62416027257876,109.0015384615385,111.50262249923594,106.50045442384106,111.90629965000042,111.83329969999998,110.4569998,108.27599999999995,107.54333666666666,19826304,20621801.15,43.09331698383505,NaN,1.5,2.75,NaN,NaN,1.7398530195946396,0.9614244583092588,NaN,-0.07199895300252923,-0.6463851031981704,-0.5743861501956412,13.813538301125561,-3.318296061162858,NaN,NaN,NaN,-431646776
1023111000,107.09,107.60001,104.13,104.37,NaN,NaN,103.90828509433963,109.89142857142858,111.83374965000041,111.71179969999999,110.2386,108.11549999999995,109.76547784777523,108.21900215138079,108.55153846153848,111.95579459543639,105.14728232764058,111.83374965000041,111.71179969999999,110.2386,108.11549999999995,105.36667,26073904,21016196.35,35.15622110507127,NaN,1.5,2.75,NaN,NaN,1.8634356610521654,1.2406576130984805,NaN,-0.2680430978254621,-0.9094400224774688,-0.6413969246520067,18.52076824088605,-4.85870556061987,NaN,NaN,NaN,-457720680
1023197400,104.14999,105.2,103.55,104.63,NaN,NaN,103.8531903773585,109.75557142857143,111.76044970000041,111.60239959999998,110.0304002,108.07349999999997,109.56408655962719,107.87719242267787,108.15461615384616,112.05572865732452,104.2535036503678,111.76044970000041,111.60239959999998,110.0304002,108.07349999999997,104.46,25859808,21127386.75,36.308731294957035,NaN,1.5,2.75,NaN,NaN,1.8481902566912969,1.223994633411063,NaN,-0.35442842176326517,-1.0844324518560882,-0.730004030092823,18.8354309695627,-3.744250229990807,NaN,NaN,NaN,-431860872
1023283800,104.95,105.67,104.35001,105.61,NaN,NaN,103.79809566037736,109.61971428571428,111.69189965000041,111.49769959999999,109.8704002,108.09899949999996,109.40902434160259,107.66126933480378,107.78923153846155,111.6854420257503,103.8930210511728,111.69189965000041,111.49769959999999,109.8704002,108.09899949999996,105.21000333333335,19718304,21017241.95,40.594608566265876,NaN,1.5,2.75,NaN,NaN,1.8104616669276332,0.9381965553287072,NaN,-0.3207967277734429,-1.1309999398096267,-0.8102032120361837,20.180645171649278,-3.056728474389571,NaN,NaN,NaN,-412142568
1023370200,105.543,105.60001,103.14999,103.46001,NaN,NaN,103.74300094339623,109.48385714285715,111.61284970000041,111.3828997,109.6542004,107.82150049999996,109.17572966153975,107.2611493981558,107.21692538461541,111.2985493867673,103.13530138246351,111.61284970000041,111.3828997,109.6542004,107.82150049999996,104.07000333333335,23364704,20789552.35,35.02601404520284,NaN,1.5,2.75,NaN,NaN,1.8568579764328021,1.1238675853450975,NaN,-0.41272120997484907,-1.326104724504745,-0.913383514529896,22.204033482541924,-6.0308804694931455,NaN,NaN,NaN,-435507272
1023456600,101.789,103.92,101.72,103.34,NaN,NaN,103.6879062264151,109.348,111.5383496500004,111.27409970000001,109.42960019999998,107.60100049999997,108.94687751794996,106.88770659833143,106.72769461538464,111.02070361244087,102.4346856183284,111.5383496500004,111.27409970000001,109.42960019999998,107.60100049999997,102.99333333333335,24011600,21085781.95,34.73955197245337,NaN,1.5,2.75,NaN,NaN,1.8813681209733166,1.1387578633288484,NaN,-0.4480337814115398,-1.4734257412943208,-1.025391959882781,20.080866343837712,-4.922255957309775,NaN,NaN,NaN,-459518872
1023715800,103.243,104.46001,103.02,103.74001,NaN,NaN,103.63281150943396,109.21214285714285,111.4637997500004,111.1599999,109.21400039999999,107.50200099999998,108.74268663489309,106.58792596991891,106.34615692307693,110.75038943286849,101.94192441328538,111.4637997500004,111.1599999,109.21400039999999,107.50200099999998,103.74000666666666,18760192,21075816.35,36.600775169252586,NaN,1.5,2.75,NaN,NaN,1.849842540903794,0.8901288419131627,NaN,-0.4118043394356854,-1.5401473841773878,-1.1283430447417024,20.37884523037134,-4.0333021245788965,NaN,NaN,NaN,-440758680
1023802200,104.131,104.53999,101.73,101.96001,NaN,NaN,103.57771679245283,109.07628571428572,111.38984980000039,111.05139990000002,108.96180039999997,107.20650149999997,108.47669931587768,106.14717206802187,105.80923461538463,110.5095998576783,101.10886937309095,111.38984980000039,111.05139990000002,108.96180039999997,107.20650149999997,102.74333333333334,19990800,21341011.45,32.199920364376766,NaN,1.5,2.75,NaN,NaN,1.9184245022678088,0.9367316093164835,NaN,-0.4708175165767745,-1.7168649404626706,-1.246047423885896,21.64041962136561,-4.976691519105312,NaN,NaN,NaN,-460749480
1023888600,101.71001,102.81,100.78,102.58,NaN,NaN,103.5226220754717,108.94042857142857,111.31359980000039,110.94049990000002,108.73460039999998,106.82450149999997,108.2454562054511,105.80744139487693,105.2307723076923,109.50847187088684,100.95307274449777,111.31359980000039,110.94049990000002,108.73460039999998,106.82450149999997,102.05666666666666,31268304,21193811.45,35.12587530598884,NaN,1.5,2.75,NaN,NaN,1.926394180677251,1.4753506736514823,NaN,-0.4321985106211983,-1.786295562162394,-1.3540970515411956,22.639060159334793,-4.130841121495329,NaN,NaN,NaN,-429481176
1023975000,102.13,103,101.34,101.55,NaN,NaN,103.46752735849057,108.80457142857144,111.2422497500004,110.8245,108.50280039999998,106.41250199999998,107.98288929543341,105.40197078584103,104.68154153846152,108.87425095834658,100.48883211857645,111.2422497500004,110.8245,108.50280039999998,106.41250199999998,101.96333333333332,21050896,20769465.85,32.60819053306936,NaN,1.5,2.75,NaN,NaN,1.9073660249145898,1.0135501871850017,NaN,-0.4387234551494259,-1.902501370477978,-1.4637779153285522,22.82435771504653,-5.288192501398995,NaN,NaN,NaN,-450532072
1024061400,100.31,101.56,98.5,101.39999,NaN,NaN,103.41243264150944,108.66871428571429,111.1641497000004,110.7147999,108.27740019999997,105.96450149999995,107.724736381887,105.02082975861808,104.16615538461537,108.19530670763005,100.13700406160068,111.1641497000004,110.7147999,108.27740019999997,105.96450149999995,100.48666333333334,39267504,21328090.65,32.24568596153564,NaN,1.5,2.75,NaN,NaN,1.9896970231349764,1.8411167058688398,NaN,-0.4160428594013159,-1.9838314895801972,-1.5677886301788813,22.50052625106306,-2.84565488167098,NaN,NaN,NaN,-489799576
1024320600,101.92101,104.34,101.85001,104.12,NaN,NaN,103.35733792452831,108.53285714285714,111.1017496500004,110.6236999,108.10600019999998,105.62550199999995,107.58337417083261,104.9350364482735,103.92153999999998,107.52341846590666,100.3196615340933,111.1017496500004,110.6236999,108.10600019999998,105.62550199999995,103.43667,17648496,20819330.65,44.33047964470022,NaN,1.5,2.75,NaN,NaN,2.057576521482478,0.8476975699504538,NaN,-0.19213953377698134,-1.8079630474001078,-1.6158235136231265,24.710318831570476,-0.48743190289591026,NaN,NaN,NaN,-472151080
1024407000,103.74001,105.03,103.631,104.97,NaN,NaN,103.30224320754718,108.397,111.0314996500004,110.5375999,107.94680039999999,105.38900199999996,107.48088890923134,104.93836631034269,103.76538615384614,106.97447553642724,100.55629677126504,111.0314996500004,110.5375999,107.94680039999999,105.38900199999996,104.54366666666665,21775104,21216395.8,47.482845281949906,NaN,1.5,2.75,NaN,NaN,2.010535341376587,1.0263337941687531,NaN,0.027247173637396926,-1.5817645465763803,-1.6090117202137773,25.145467911460173,-0.6060032193921036,NaN,NaN,NaN,-450375976
1024493400,103.5,104.42999,102.24001,102.52,NaN,NaN,103.24714849056605,108.26114285714286,110.9525496500004,110.42729990000002,107.7544004,105.08000199999996,107.28634424612423,104.70804570935766,103.40384769230766,105.96910231991382,100.83859306470151,110.9525496500004,110.42729990000002,107.7544004,105.08000199999996,103.06333333333333,21541392,21449600.6,40.384381327169265,NaN,1.5,2.75,NaN,NaN,2.061924959849688,1.0042793990299288,NaN,0.02164194611864767,-1.5819592875654678,-1.6036012336841154,27.791141906224723,-0.9085732738668795,NaN,NaN,NaN,-471917368
1024579800,102.265,103.05,100.96001,101.21001,NaN,NaN,103.19205377358492,108.12528571428571,110.87569970000038,110.30080000000002,107.5104006,104.69350249999995,107.04805662862917,104.3748994513236,103.16077153846153,105.90628996015793,100.41525311676513,110.87569970000038,110.30080000000002,107.5104006,104.69350249999995,101.74000666666666,25692000,21941985.55,37.183534477525114,NaN,1.5,2.75,NaN,NaN,2.0639296055747103,1.1709058845861833,NaN,-0.051986583553492505,-1.6685844631259812,-1.6165978795724887,26.321932316285118,-2.0611476678924,NaN,NaN,NaN,-497609368
1024666200,100.47,100.92999,98.687,99.28,NaN,NaN,103.13695905660379,107.98942857142858,110.79439975000038,110.19080000000002,107.28420059999999,104.15250199999996,106.74342695691823,103.88967093214993,102.74923307692308,106.04015797637086,99.45830817747529,110.79439975000038,110.19080000000002,107.28420059999999,104.15250199999996,99.63232999999998,31190704,22807510.8,33.029843024607246,NaN,1.5,2.75,NaN,NaN,2.0967210623193737,1.36756282934655,NaN,-0.20384081197473125,-1.8713988945409028,-1.6675580825661716,28.047606835392134,-4.2992187874283,NaN,NaN,NaN,-528800072
1024925400,98.61,100.69,97.25,99.8,NaN,NaN,103.08186433962265,107.85357142857143,110.72679970000037,110.0701,107.05180059999999,103.70800199999996,106.47113570370574,103.50017846242136,102.30231,105.49439020102467,99.11022979897534,110.72679970000037,110.0701,107.05180059999999,103.70800199999996,99.24666666666667,37173296,24072380.7,35.13236289945557,NaN,1.5,2.75,NaN,NaN,2.1926695578679896,1.544230147539998,NaN,-0.23994643433406027,-1.9674911254837468,-1.7275446911496866,28.19743245679711,-2.1184874344363047,NaN,NaN,NaN,-491626776
1025011800,100.30299,100.89,97.53999,97.56,NaN,NaN,103.02676962264151,107.7177142857143,110.64384975000037,109.91390009999999,106.7916004,103.18100149999995,106.12167940159964,102.93444718028599,101.84846307692307,105.83254700765931,97.86437914618682,110.64384975000037,109.91390009999999,106.7916004,103.18100149999995,98.66333000000002,33389200,24529985.5,30.666078321617377,NaN,1.5,2.75,NaN,NaN,2.2753367323059903,1.3611585705992366,NaN,-0.3772002221278643,-2.199044968809517,-1.8218447466816525,29.28392148239641,-4.893741470072135,NaN,NaN,NaN,-525015976
1025098200,95.2,98.14999,95.19501,97.72,NaN,NaN,102.97167490566038,107.58185714285715,110.5653497500004,109.76460019999999,106.4820004,102.70200149999994,105.7922017780075,102.4378331631159,101.4161553846154,105.85295815747492,96.97935261175587,110.5653497500004,109.76460019999999,106.4820004,102.70200149999994,97.02166666666666,37918496,25686955.2,31.3375305169058,NaN,1.5,2.75,NaN,NaN,2.32388267999842,1.4761771375690336,NaN,-0.4166345413247394,-2.342637923337577,-1.9260033820128375,28.81239984023537,-3.7715411127523373,NaN,NaN,NaN,-487097480
1025184600,98.5,99.49001,96.57001,99.42999,NaN,NaN,102.91658018867925,107.446,110.49399970000039,109.6604,106.2114,102.32350099999994,105.54270327690917,102.15137190948582,101.08461538461539,105.42024841896719,96.74898235026359,110.49399970000039,109.6604,106.2114,102.32350099999994,98.49667,31728800,26362490.4,38.22329756991949,NaN,1.5,2.75,NaN,NaN,2.3664624885699617,1.2035585226803915,NaN,-0.2928239653717466,-2.2920333387275207,-1.999209373355774,31.185971427915774,-1.9428009805523638,NaN,NaN,NaN,-455368680
1025271000,99.243,100.5,98.88,98.96001,NaN,NaN,102.86148547169812,107.31014285714286,110.43494975000038,109.5583001,105.94120019999998,101.91050149999992,105.28455844252058,101.84743268001098,100.85384615384616,105.29657208397354,96.41112022371878,110.43494975000038,109.5583001,105.94120019999998,101.91050149999992,99.44667,28184304,26780390.4,37.12143321871093,NaN,1.5,2.75,NaN,NaN,2.3131437393863936,1.0524231939501525,NaN,-0.2116381942400105,-2.2637571161557872,-2.0521189219157767,31.21782601156213,-4.955810603150218,NaN,NaN,NaN,-483552984
1025530200,99.187,99.8,96.89,97.03,NaN,NaN,102.80639075471699,107.17428571428572,110.37649975000036,109.4416001,105.62420019999998,101.54350149999993,104.96085026830409,101.38862956762898,100.42692307692309,105.17991933754972,95.67392681629646,110.37649975000036,109.4416001,105.62420019999998,101.54350149999993,97.90666666666668,20282896,26490840,32.92405447953105,NaN,1.5,2.75,NaN,NaN,2.3557763294302227,0.7656569591602229,NaN,-0.25411805471542337,-2.369766490310056,-2.1156484355946326,26.466916973338353,-7.564065923597216,NaN,NaN,NaN,-503835880
1025616600,96.869,97.2,94.77,94.97,NaN,NaN,102.75129603773586,107.03842857142857,110.30109975000038,109.31110009999999,105.30360019999998,101.06050149999992,104.56905221856667,100.77733151356908,99.92076923076925,105.42899745654722,94.41254100499128,110.30109975000038,109.31110009999999,105.30360019999998,101.06050149999992,95.64666666666666,34218400,26908769.6,29.13708451177166,NaN,1.5,2.75,NaN,NaN,2.3610780201852073,1.2716449138573767,NaN,-0.37959874447019804,-2.59014686618238,-2.210548121712182,25.69353536329958,-7.364416699180646,NaN,NaN,NaN,-538054280
1025703000,94.62,95.84,93.72701,95.50999,NaN,NaN,102.69620132075472,106.90257142857143,110.25714970000037,109.16529999999999,105.00339999999997,100.55550099999992,104.21379487666209,100.27567994084822,99.46769230769233,105.3695860160421,93.56579859934256,110.25714970000037,109.16529999999999,105.00339999999997,100.55550099999992,95.02566666666667,30566896,27451199.2,31.365639334059352,NaN,1.5,2.75,NaN,NaN,2.3433574473148346,1.1134994787404406,NaN,-0.3837343708471712,-2.690216085271146,-2.306481714423975,25.515510964714604,-5.631873764265012,NaN,NaN,NaN,-507487384
1025875800,96.78,99.53,96.668,99.31,NaN,NaN,102.6411066037736,106.76671428571429,110.23344970000038,109.04399999999998,104.80139999999997,100.34800049999993,104.02148919522436,100.1837104226722,99.09769230769234,104.35437553720381,93.84100907818087,110.23344970000038,109.04399999999998,104.80139999999997,100.34800049999993,98.50266666666668,19014800,27233704,44.57529265562642,NaN,1.5,2.75,NaN,NaN,2.4631183439352036,0.6982083671027636,NaN,-0.10267499732349794,-2.434825461078347,-2.332150463754849,36.28045889661343,0.030217566478647397,NaN,NaN,NaN,-488472584
1026135000,98.98,99.7,97.56,98.07001,NaN,NaN,102.58601188679246,106.63085714285714,110.21404975000037,108.91380009999997,104.57340019999998,100.08450099999995,103.78809785423518,99.98240562051295,98.56692384615387,102.59437471337515,94.5394729789326,110.21404975000037,108.91380009999997,104.57340019999998,100.08450099999995,98.44333666666667,19120896,26989168.8,41.75145595168245,NaN,1.5,2.75,NaN,NaN,2.4400384622255467,0.7084655382199099,NaN,0.020998471650789607,-2.305902374191362,-2.3269008458421516,35.301704361780466,-1.733456913827656,NaN,NaN,NaN,-507593480
1026221400,97.73,98.34,95.00999,95.60001,NaN,NaN,102.53091716981133,106.495,110.19849975000038,108.74710019999996,104.33760039999997,99.67750099999994,103.46699636975536,99.56503460903552,98.03461692307694,101.63839185386979,94.43084199228409,110.19849975000038,108.74710019999996,104.33760039999997,99.67750099999994,96.31666666666666,28623296,27482324,36.75638540618438,NaN,1.5,2.75,NaN,NaN,2.5036078577808647,1.0415165762546137,NaN,-0.039001887315972095,-2.375653204987117,-2.3366513176711448,37.57348944782208,-2.0090098400984058,NaN,NaN,NaN,-536216776
1026307800,96,96.07001,92.03999,92.12,NaN,NaN,102.4758224528302,106.35914285714286,110.17269975000038,108.54770019999998,104.04280039999998,99.18550049999993,103.02201611996104,98.85598369388929,97.33538538461539,101.65891422005052,93.01185654918027,110.17269975000038,108.54770019999998,104.04280039999998,99.18550049999993,93.41000000000001,50525392,29009053.6,31.109254807803538,NaN,1.5,2.75,NaN,NaN,2.6126372965108025,1.7417111463436366,NaN,-0.27534771076192,-2.680835956123545,-2.405488245361625,40.900670046876755,-5.7306590257879595,NaN,NaN,NaN,-586742168
1026394200,91.763,93.35001,90.32001,92.87,NaN,NaN,102.42072773584907,106.22328571428572,110.13354975000037,108.3675002,103.74300039999999,98.70000049999994,102.62389784074688,98.28589000875698,96.84230846153848,101.60593499614897,92.07868192692798,110.13354975000037,108.3675002,103.74300039999999,98.70000049999994,92.18000666666667,59532896,30422283.2,33.48120129736306,NaN,1.5,2.75,NaN,NaN,2.6424489181886024,1.9568845509925437,NaN,-0.3392568871007593,-2.829559354237574,-2.490302467136815,41.49040807382425,-6.597596962445635,NaN,NaN,NaN,-527209272
1026480600,93.33299,93.89,91.52,91.85001,NaN,NaN,102.36563301886794,106.08742857142857,110.08404980000036,108.1984004,103.3964008,98.21500099999994,102.20139243522739,97.67294905554203,96.23077076923079,101.34674376122051,91.11479777724107,110.08404980000036,108.1984004,103.3964008,98.21500099999994,92.42000333333333,39026096,31321043.2,31.87389559893431,NaN,1.5,2.75,NaN,NaN,2.6229882811751315,1.2460024320007324,NaN,-0.4039192807675702,-2.9952015680962774,-2.591282287328707,39.00259714906673,-7.184720373411442,NaN,NaN,NaN,-566235368
1026739800,91.64301,92.39999,87.89,92.34,NaN,NaN,102.3105383018868,105.95157142857143,110.03879980000036,108.01590039999999,103.06800100000001,97.76200149999995,101.81467116325769,97.16504914549041,95.82923230769232,101.27372281686468,90.38474179851997,110.03879980000036,108.01590039999999,103.06800100000001,97.76200149999995,90.87666333333334,77320192,33223677.6,33.524841417744554,NaN,1.5,2.75,NaN,NaN,2.7577741182340505,2.3272616876104046,NaN,-0.3683800571810272,-3.0517573588049913,-2.683377301623964,39.722456482013015,-4.833556631969492,NaN,NaN,NaN,-488915176
1026826200,91.127,92.38,89.87,90.56,NaN,NaN,102.25544358490566,105.8157142857143,109.98024980000037,107.83850039999999,102.727601,97.08400149999996,101.3733115097966,96.5359968459199,95.27846307692309,101.2677958738054,89.28913028004078,109.98024980000037,107.83850039999999,102.727601,97.08400149999996,90.93666666666667,53282400,35005372.8,30.621713191253704,NaN,1.5,2.75,NaN,NaN,2.7400759669316175,1.52212062715127,NaN,-0.4159252719776978,-3.2032838915960866,-2.787358619618389,39.69557969159378,-4.643571654206588,NaN,NaN,NaN,-542197576
1026912600,92.46001,93.3,89.75,90.74001,NaN,NaN,102.20034886792453,105.67985714285714,109.91174985000038,107.64950049999999,102.43300120000002,96.37250199999995,100.95631929372614,95.98399809868943,94.61000307692308,100.53615957946465,88.6838465743815,109.91174985000038,107.64950049999999,102.43300120000002,96.37250199999995,91.26333666666666,48996096,36366422.4,31.269911217136,NaN,1.5,2.75,NaN,NaN,2.797927683579359,1.347289416074098,NaN,-0.38702256732841445,-3.271136828778907,-2.8841142614504927,38.82189919475842,-4.994221023371486,NaN,NaN,NaN,-493201480
1026999000,90.703,91.10001,87.75,87.8,NaN,NaN,102.1452541509434,105.544,109.82939985000037,107.41300049999998,102.08700100000001,95.63650199999995,100.44038520377609,95.20456970833806,93.75154076923076,100.1248253743844,87.37825616407711,109.82939985000037,107.41300049999998,102.08700100000001,95.63650199999995,88.88333666666666,32701808,36924443.2,26.856534815683517,NaN,1.5,2.75,NaN,NaN,2.8373621347522615,0.8856411949903147,NaN,-0.5099492000967181,-3.5215507615713904,-3.0116015614746723,41.3347463963976,-11.589970798509722,NaN,NaN,NaN,-525903288
1027085400,86.767,87.55299,84.3,84.71001,NaN,NaN,102.09015943396227,105.40814285714286,109.72504990000036,107.1479006,101.60100140000003,94.81150199999995,99.82350774480447,94.20508783135348,92.80384923076923,100.47670633749203,85.13099212404643,109.72504990000036,107.1479006,101.60100140000003,94.81150199999995,85.521,77690624,39524374.4,23.157202374277745,NaN,1.5,2.75,NaN,NaN,2.8846934108413858,1.9656382973641704,NaN,-0.7300045987591868,-3.924107309923656,-3.194102711164469,30.938043066290287,-13.622921013263893,NaN,NaN,NaN,-603593912
1027344600,84.10699,85.91299,81.45,82.2,NaN,NaN,102.03506471698114,105.27228571428572,109.59929985000036,106.85340070000001,101.09000140000002,93.95750199999995,99.13238979402783,93.06174613312935,91.82154153846153,101.21125330119877,82.4318297757243,109.59929985000036,106.85340070000001,101.09000140000002,93.95750199999995,83.18766333333333,78249376,41877308,20.666901530794732,NaN,1.5,2.75,NaN,NaN,2.997428881495572,1.8685388277584605,NaN,-0.960725961758754,-4.395010163362912,-3.4342842016041577,31.863238192479475,-14.016745395737924,NaN,NaN,NaN,-681843288
1027431000,82.55,83.24001,79.75,79.95,NaN,NaN,101.97997000000001,105.13642857142858,109.46184985000038,106.5414008,100.5746014,92.96500199999996,98.38013921386988,91.81300840616464,90.62461923076923,101.65250667775723,79.59673178378122,109.46184985000038,106.5414008,100.5746014,92.96500199999996,80.98000333333333,74499632,43743624.8,18.723167667723104,NaN,1.5,2.75,NaN,NaN,3.0326132471030305,1.7030969047631372,NaN,-1.167254829902367,-4.8933527389821165,-3.7260979090797495,32.09046217794214,-13.211029092488062,NaN,NaN,NaN,-756342920
1027517400,78.13699,85.12,77.67999,84.72,NaN,NaN,77.67999,105.00057142857143,109.34929985000039,106.25120070000001,100.11160140000001,92.32300199999996,97.84444747999264,91.13748379605373,89.50231153846154,99.7048858733159,79.29973720360718,109.34929985000039,106.25120070000001,100.11160140000001,92.32300199999996,82.50666333333334,106946000,47421464.8,33.090326297252545,NaN,1.5,2.75,NaN,NaN,3.3474273008813853,2.2552234615915956,NaN,-0.8971333165471989,-4.847514554763748,-3.9503812382165493,51.61627259662654,-8.775707978895236,NaN,NaN,NaN,-649396920
1027603800,84.27499,85.85001,81.60001,84,NaN,NaN,77.17591592592593,104.86471428571429,109.23664985000039,105.9337007,99.58720140000001,91.63700199999997,97.30152797097332,90.45772343452481,88.4200030769231,97.70096099168654,79.13904516215965,109.23664985000039,105.9337007,99.58720140000001,91.63700199999997,83.81667333333333,87194880,49885284,32.16605240943389,NaN,1.5,2.75,NaN,NaN,3.4118967793898576,1.7479078599612663,NaN,-0.6907310204648649,-4.81379501379763,-4.1230639933327655,50.54677250864185,-8.546553233908192,NaN,NaN,NaN,-736591800
1027690200,84.653,85.92999,83.8,85.60001,NaN,NaN,76.67184185185185,104.72885714285715,109.13484985000039,105.63590080000002,99.10340180000001,90.94550299999996,96.8426449132881,89.99508405980816,87.6507723076923,96.0384948049706,79.26304981041402,109.13484985000039,105.63590080000002,99.10340180000001,90.94550299999996,85.11,41210496,50359368.8,36.41635581550814,NaN,1.5,2.75,NaN,NaN,3.3203320094334394,0.8183282869105382,NaN,-0.38545471079726035,-4.604882381829341,-4.219427671032081,53.16905170953524,-7.299101147931563,NaN,NaN,NaN,-695381304
1027949400,87.508,90.34,87.3,89.77,NaN,NaN,76.16776777777778,104.593,109.0420998000004,105.36610080000003,98.69160180000003,90.48600249999996,96.56528628923759,89.97364748268357,87.47000307692308,95.56069022850879,79.37931592533737,109.0420998000004,105.36610080000003,98.69160180000003,90.48600249999996,89.13666666666666,53496304,51624968.8,45.92588958366063,NaN,1.5,2.75,NaN,NaN,3.421736151616766,1.0362486456359854,NaN,0.13067947539317526,-4.056078326790612,-4.186757802183787,61.60036061408582,-0.8723498233215616,NaN,NaN,NaN,-641885000
1028035800,89.323,91.39999,88.72,90.94,NaN,NaN,75.66369370370371,104.45714285714286,108.94679980000039,105.11050080000003,98.29240200000002,90.18150249999997,96.34468682691455,90.06568105576133,87.32154153846156,95.0741955060421,79.56888757088102,108.94679980000039,105.11050080000003,98.29240200000002,90.18150249999997,90.35332999999999,47559008,52988774.4,48.26388242134247,NaN,1.5,2.75,NaN,NaN,3.36875428364414,0.8975298737990816,NaN,0.560168488446319,-3.4865471916258883,-4.046715680072207,61.204229558056745,0.2203989177431209,NaN,NaN,NaN,-594325992
1028122200,90.49699,91.55,89.25,91.16,NaN,NaN,75.15961962962963,104.32128571428572,108.85509980000039,104.85220070000003,97.92160200000002,89.99100249999996,96.1413657748787,90.16990190759358,87.26846384615388,94.90495426284572,79.63197342946204,108.85509980000039,104.85220070000003,97.92160200000002,89.99100249999996,90.65333333333335,44707696,53513239.2,48.712920595941966,NaN,1.5,2.75,NaN,NaN,3.2924146919552726,0.8354511270175549,NaN,0.8509319438893583,-2.9830507502105092,-3.8339826940998676,61.20874971402844,3.8268792710706143,NaN,NaN,NaN,-549618296
1028208600,90.88,91.35001,88.33,88.78,NaN,NaN,74.65554555555556,104.18542857142857,108.7524998000004,104.56760060000005,97.52320200000003,89.65450299999996,95.85268476409914,90.03753029734658,86.99461769230773,94.12238192048656,79.8668534641289,108.7524998000004,104.56760060000005,97.52320200000003,89.65450299999996,89.48667,66576320,55313710.4,44.239510614096766,NaN,1.5,2.75,NaN,NaN,3.2729572139584673,1.203613345019791,NaN,0.8716372346330172,-2.744436150808596,-3.6160733854416134,60.01894706725673,4.804615180661653,NaN,NaN,NaN,-616194616
1028295000,88.5,88.91701,85.62,86.78999,NaN,NaN,74.15147148148148,104.04957142857143,108.63649970000039,104.26380050000003,97.08020180000003,89.02850249999997,95.49728496942858,89.72824074521833,86.70461692307696,93.5288484119154,79.8803854342385,108.63649970000039,104.26380050000003,97.08020180000003,89.02850249999997,87.109,51775696,56951755.2,40.86070379678161,NaN,1.5,2.75,NaN,NaN,3.2746752701042907,0.9091150188115712,NaN,0.7448915072249664,-2.684959001410405,-3.4298505086353717,57.48352717920966,5.583929440389294,NaN,NaN,NaN,-667970312
1028554200,86.498,86.933,83.55,83.77,NaN,NaN,73.64739740740741,103.91371428571429,108.51709975000038,103.94110060000004,96.55360160000004,88.31350199999997,95.03739144121569,89.16078924567373,86.16846230769235,92.73043940802525,79.60648520735946,108.51709975000038,103.94110060000004,96.55360160000004,88.31350199999997,84.75099999999999,47196400,58355530.4,36.32640256555029,NaN,1.5,2.75,NaN,NaN,3.2824127508111274,0.8087733874834252,NaN,0.4649418829085019,-2.8486731549997444,-3.3136150379082463,58.65469485796019,4.777986241400867,NaN,NaN,NaN,-715166712
1028640600,85.233,87.89999,85.05,86.59,NaN,NaN,73.14332333333334,103.77785714285714,108.4129497500004,103.64820060000005,96.11160160000004,87.86300149999997,94.706121188619,88.91595217465718,86.07538538461542,92.57619413832364,79.57457663090719,108.4129497500004,103.64820060000005,96.11160160000004,87.86300149999997,86.51333,65087696,60178750.4,42.718550426900315,NaN,1.5,2.75,NaN,NaN,3.3429539828960473,1.08157274066628,NaN,0.47527726788334546,-2.7195184530540644,-3.19479572093741,57.79340895558208,2.207271010387163,NaN,NaN,NaN,-650079016
1028727000,87.879,88.5,85.77,88.10001,NaN,NaN,72.63924925925926,103.64200000000001,108.3166997500004,103.36270080000006,95.71160160000005,87.66200199999999,94.44705800475158,88.8382433961184,86.33615461538464,92.86885388479836,79.80345534597093,108.3166997500004,103.36270080000006,95.71160160000005,87.66200199999999,87.45666999999999,43696496,59837305.6,45.85310872254149,NaN,1.5,2.75,NaN,NaN,3.29917155554633,0.730255073517214,NaN,0.5823321205112988,-2.4668805702982866,-3.0492126908095853,48.98866063467423,4.880964285714283,NaN,NaN,NaN,-606382520
1028813400,88.423,91.10001,87.8,90.95,NaN,NaN,72.13517518518519,103.50614285714286,108.22409975000039,103.10550080000006,95.38460160000004,87.56600199999998,94.30991847515348,89.03936307267855,87.00923153846156,93.50154392309219,80.51691915383094,108.22409975000039,103.10550080000006,95.38460160000004,87.56600199999998,89.95000333333331,48373600,59279340.8,51.272883725976826,NaN,1.5,2.75,NaN,NaN,3.299231444435878,0.8160279677064156,NaN,0.8285840098883135,-2.0134826784491935,-2.842066688337507,50.68018230983231,6.249987587618278,NaN,NaN,NaN,-558008920
1028899800,90.10001,91.94,89.35001,91.28999,NaN,NaN,71.63110111111112,103.37028571428571,108.1359997000004,102.84390070000005,95.07040140000005,87.53800099999998,94.1914899075004,89.25370849432822,87.88153846153848,93.3047955479311,82.45828137514586,108.1359997000004,102.84390070000005,95.07040140000005,87.53800099999998,90.86,41880400,59422056,51.891522073948856,NaN,1.5,2.75,NaN,NaN,3.248571341261887,0.7047955392186362,NaN,0.9871021275056222,-1.6081890289554792,-2.5952911564611014,50.23039047111845,1.6932048568564189,NaN,NaN,NaN,-516128520
1029159000,89.99699,91.27,89.55,90.62,NaN,NaN,71.12702703703704,103.23442857142858,108.0459997000004,102.59770060000007,94.73840140000004,87.45200099999998,94.05143147975528,89.38383149486839,88.33538461538464,93.60982911337545,83.06094011739383,108.0459997000004,102.59770060000007,94.73840140000004,87.45200099999998,90.48,25855696,56848831.2,50.530068382486625,NaN,1.5,2.75,NaN,NaN,3.1408155311717527,0.4548149091937707,NaN,1.0156162654839136,-1.3257708246062094,-2.341387090090123,43.18592658507234,-0.3518803606773622,NaN,NaN,NaN,-541984216
1029245400,90.14999,91.66,88.64999,88.97,NaN,NaN,70.62295296296297,103.09857142857143,107.9379996500004,102.33450070000006,94.43040140000005,87.37250099999999,93.85215965701978,89.34441897154758,88.71769230769233,93.36266786182472,84.07271675355994,107.9379996500004,102.33450070000006,94.43040140000005,87.37250099999999,89.75999666666667,49637104,56666566.4,47.242748776536445,NaN,1.5,2.75,NaN,NaN,3.1314722789451985,0.875950444034668,NaN,0.8962949257648463,-1.2210184328840654,-2.1173133586489117,43.73561912408593,-2.402369460289598,NaN,NaN,NaN,-591621320
1029331800,89.02,92.63,88.02,92.22,NaN,NaN,70.1188788888889,102.96271428571428,107.8474996000004,102.10630080000006,94.18220140000005,87.44650049999998,93.78815339596018,89.61828383140019,89.22692230769235,93.84449615824488,84.60934845713982,107.8474996000004,102.10630080000006,94.18220140000005,87.44650049999998,90.95666666666666,57431904,57088356.8,53.64033869354458,NaN,1.5,2.75,NaN,NaN,3.2370814018776843,1.0060178155276664,NaN,1.0012319097403726,-0.865773471473446,-1.8670053812138185,48.919687531157976,3.8747465645415606,NaN,NaN,NaN,-534189416
1029418200,92.847,93.99001,92.2,93.5,NaN,NaN,69.61480481481482,102.82685714285715,107.7777496000004,101.90520080000006,93.94000140000006,87.7315005,93.77685326278527,89.98797108555256,89.51384538461542,94.66361754895308,84.36407322027776,107.7777496000004,101.90520080000006,93.94000140000006,87.7315005,93.23000333333334,45552096,57730871.2,55.9081347828287,NaN,1.5,2.75,NaN,NaN,3.133719158886421,0.7890422412333178,NaN,1.1132258885303288,-0.4754730205509077,-1.5886989090812365,45.978056522100594,7.73131786280883,NaN,NaN,NaN,-488637320
1029504600,92.82001,94.08,92,93.22,NaN,NaN,69.11073074074075,102.691,107.71304960000042,101.69470080000005,93.73520120000006,88.157,93.75501587993094,90.29578336311899,89.68923000000004,95.16623891118869,84.21222108881139,107.71304960000042,101.69470080000005,93.73520120000006,88.157,93.09999999999998,36517296,55672204.8,55.27119939085136,NaN,1.5,2.75,NaN,NaN,3.058453504680248,0.6559340721494114,NaN,1.1216793229858741,-0.18659975534889384,-1.308279078334768,42.90887563707683,11.280888146114364,NaN,NaN,NaN,-525154616
1029763800,93.46001,95.75,93.10001,95.39999,NaN,NaN,68.60665666666667,102.55514285714287,107.66104955000043,101.50300060000005,93.57640100000006,88.81699949999998,93.81952466895325,90.78189828091718,90.01538307692311,96.25567439391658,83.77509175992965,107.66104955000043,101.50300060000005,93.57640100000006,88.81699949999998,94.75,33672304,53443351.2,59.17122846397211,NaN,1.5,2.75,NaN,NaN,3.0292775400602303,0.6300559984344694,NaN,1.2192266879088076,0.21575428155124143,-1.0034724063575662,33.88139167522782,10.174373484236053,NaN,NaN,NaN,-491482312
1029850200,94.82201,95.39999,93.62,94.39,NaN,NaN,68.1025825925926,102.41928571428572,107.59044960000043,101.30170060000005,93.38940080000006,89.53899949999999,93.84189625056293,91.12552701606792,90.4469215384616,97.05109707544639,83.8427460014768,107.59044960000043,101.30170060000005,93.38940080000006,89.53899949999999,94.46999666666666,30512096,51243974.4,56.70436921300305,NaN,1.5,2.75,NaN,NaN,2.940042715770214,0.595427976796429,NaN,1.1611468728827898,0.44796118474592106,-0.7131856881368688,33.6826998830442,7.139601913779582,NaN,NaN,NaN,-521994408
1029936600,95.063,95.78,93.57001,95.75,NaN,NaN,67.59850851851853,102.28342857142857,107.52294960000043,101.11350050000004,93.26520060000006,90.09049949999999,93.91672384858006,91.56595301453764,91.13615307692314,97.93712944610512,84.33517670774116,107.52294960000043,101.11350050000004,93.26520060000006,90.09049949999999,95.03333666666667,39632608,47878304.8,59.17263355942218,NaN,1.5,2.75,NaN,NaN,2.887896093215199,0.827778012725296,NaN,1.1571683328123366,0.7332747278785519,-0.42389360493378464,33.445226674488815,5.2776250687190736,NaN,NaN,NaN,-482361800
1030023000,95.493,97.14999,95.07001,96.67999,NaN,NaN,67.09443444444445,97.14999,107.45294960000042,100.94090040000005,93.14720040000006,90.724499,94.02508722706712,92.05300415601025,92.1292292307693,98.05119543433743,86.20726302720117,107.45294960000042,100.94090040000005,93.14720040000006,90.724499,96.29999666666667,38403808,45438751.2,60.81762051619575,NaN,1.5,2.75,NaN,NaN,2.8301878008426855,0.8451774528521814,NaN,1.1572283310930773,1.022641808932562,-0.1345865221605153,29.992407301744063,5.904261792557979,NaN,NaN,NaN,-443957992
1030109400,96.017,96.14999,94.14999,94.60001,NaN,NaN,66.59036037037038,96.93954208955225,107.36394970000042,100.75550050000005,93.00820060000005,91.174499,94.04763321816253,92.29557614115213,92.74538384615393,97.84327977971057,87.64748791259728,107.36394970000042,100.75550050000005,93.00820060000005,91.174499,94.96666333333333,33717504,45064101.6,55.43763224506561,NaN,1.5,2.75,NaN,NaN,2.808745815068208,0.7482120535606106,NaN,0.9650896507528137,1.071775541280502,0.10668589052768815,34.0155580897621,4.391977488413146,NaN,NaN,NaN,-477675496
1030368600,94.91,95.64,93.5,95.25999,NaN,NaN,66.0862862962963,96.72909417910448,107.2789996500004,100.58140040000006,92.88540060000005,91.44899849999999,94.09517662137185,92.57790127056622,93.29615153846163,97.777326688673,88.81497638825026,107.2789996500004,100.58140040000006,92.88540060000005,91.44899849999999,94.79999666666667,33831104,44080841.6,56.74513661310181,NaN,1.5,2.75,NaN,NaN,2.76097825684905,0.7674786318054326,NaN,0.8352150008998119,1.1507046416524531,0.3154896407526412,33.31941947720904,7.0697875688434335,NaN,NaN,NaN,-443844392
1030455000,95.7,96.25,93.505,94.16,NaN,NaN,65.58221222222222,96.51864626865672,107.18679960000041,100.39610040000005,92.68620060000005,91.60999849999999,94.09771871465138,92.7285773400361,93.54307461538471,97.82944689931654,89.25670233145289,107.18679960000041,100.39610040000005,92.68620060000005,91.60999849999999,94.63833333333332,35340704,43469926.4,53.906196535269736,NaN,1.5,2.75,NaN,NaN,2.759836952788404,0.8129920367198966,NaN,0.6369536851316556,1.1116817471672107,0.47472806203555507,31.77824613744101,2.103665148557794,NaN,NaN,NaN,-479185096
1030541400,93.287,93.49001,91.8,92.10001,NaN,NaN,65.07813814814816,96.30819835820895,107.0836996500004,100.18780060000005,92.42880080000005,91.65699899999998,94.01937719642976,92.66871378384218,93.60538384615394,97.78105633498748,89.4297113573204,107.0836996500004,100.18780060000005,92.42880080000005,91.65699899999998,92.46334,38973808,43183232,48.965596595246325,NaN,1.5,2.75,NaN,NaN,2.731277170446375,0.9025217936443479,NaN,0.34350541426575565,0.9041098298677497,0.560604415601994,28.911730952037214,-1.4973155080213931,NaN,NaN,NaN,-518158904
1030627800,91.27,93.058,90.81,92.14,NaN,NaN,64.57406407407407,96.0977504477612,106.98424965000041,99.98780060000004,92.22120080000005,91.82499899999999,93.9456761299031,92.61836009014293,93.72230692307704,97.63382413476087,89.81078971139321,106.98424965000041,99.98780060000004,92.22120080000005,91.82499899999999,92.00266666666666,42967104,42002771.2,49.06319521421828,NaN,1.5,2.75,NaN,NaN,2.696757372557349,1.0229587899190804,NaN,0.1390117466221279,0.7343690988796538,0.595357352257526,27.54685202942461,-1.1585496674533344,NaN,NaN,NaN,-475191800
1030714200,91.686,93.39,91.39999,91.78,NaN,NaN,64.06999,95.88730253731343,106.8703996500004,99.77150060000005,92.03260060000004,92.07449949999999,93.86074765422063,92.53851627203407,93.93846076923089,96.99211609212209,90.88480544633968,106.8703996500004,99.77150060000005,92.03260060000004,92.07449949999999,92.18999666666666,30370896,40932531.2,48.170107680293455,NaN,1.5,2.75,NaN,NaN,2.646275417374681,0.7419745398007538,NaN,-0.0248502663313529,0.5642945193433349,0.5891447856746878,27.57044988850721,-3.794539181817526,NaN,NaN,NaN,-505562696
1031059800,90.735,91,88.14999,88.28,NaN,NaN,63.565915925925935,95.67685462686568,106.73849965000039,99.54840060000006,91.81260060000004,92.29999949999998,93.6418948050355,92.13294329374511,93.63538384615396,97.86628056818026,89.40448712412766,106.73849965000039,99.54840060000006,91.81260060000004,92.29999949999998,89.14332999999999,76682192,42406820.8,40.45919680841601,NaN,1.5,2.75,NaN,NaN,2.7165421732764896,1.8082513745053015,NaN,-0.35498605340663736,0.1454122189163911,0.5003982723230285,30.10177922955728,-6.473143341455662,NaN,NaN,NaN,-582244888
1031146200,88.61501,90.25,88.06,89.53999,NaN,NaN,63.06184185185186,95.46640671641791,106.61184960000041,99.32960050000005,91.60740040000005,92.447499,93.48103579307333,91.88599536100749,93.3307676923078,98.09357946492166,88.56795591969394,106.61184960000041,99.32960050000005,91.60740040000005,92.447499,89.28332999999999,51099504,41707411.2,43.93838113342313,NaN,1.5,2.75,NaN,NaN,2.6789320180424547,1.2251900209044861,NaN,-0.4674522307437227,-0.08391701610662494,0.3835352146370978,32.49782294047309,-6.4856501305483,NaN,NaN,NaN,-531145384
1031232600,88.49001,89.42999,87.5,88.78,NaN,NaN,62.557767777777784,95.25595880597015,106.4839496000004,99.11170040000006,91.43180040000003,92.4814985,93.29668144824693,91.59018627900677,92.98922923076933,98.3358315531036,87.64262690843505,106.4839496000004,99.11170040000006,91.43180040000003,92.4814985,88.56999666666667,67318320,42888502.4,42.331613644383864,NaN,1.5,2.75,NaN,NaN,2.633293302467994,1.5696122791174913,NaN,-0.5654366371691184,-0.3232605818243002,0.24217605534481818,30.016645879897105,-8.171277220860286,NaN,NaN,NaN,-598463704
1031319000,89.75,90.57001,89.347,90,NaN,NaN,62.05369370370371,95.0455108955224,106.3550996000004,98.87970040000006,91.27740040000002,92.4339985,93.16739982282549,91.43873996672042,92.57384538461548,97.94572841129552,87.20196235793544,106.3550996000004,98.87970040000006,91.27740040000002,92.4339985,89.97233666666666,38622896,42400967.2,45.76056093838269,NaN,1.5,2.75,NaN,NaN,2.5730587808631364,0.9108965797365113,NaN,-0.5215605649946873,-0.4097746508985409,0.11178591409614633,30.92380373711662,-4.8625893379926675,NaN,NaN,NaN,-559840808
1031578200,89.10001,91.351,88.8,90.66,NaN,NaN,61.54961962962963,94.83506298507463,106.2343996000004,98.65670030000005,91.10200060000003,92.402499,93.0690704180088,91.36457425560418,92.2869223076924,97.63855260026921,86.93529201511558,106.2343996000004,98.65670030000005,91.10200060000003,92.402499,90.27033333333334,34074896,42010692,47.57656684820953,NaN,1.5,2.75,NaN,NaN,2.571483153658627,0.811100564589605,NaN,-0.4256182990426401,-0.4202369597071538,0.00538133933548629,30.40006330316892,-4.82887936477844,NaN,NaN,NaN,-525765912
1031664600,91.14,91.78,90.56,91.7,NaN,NaN,61.04554555555556,94.62461507462687,106.1226996500004,98.44900030000007,90.95680040000003,92.45649900000001,93.01538138200846,91.39651956459426,91.97538384615395,96.94203159304243,87.00873609926546,106.1226996500004,98.44900030000007,90.95680040000003,92.45649900000001,91.34666666666668,41426704,42789242.4,50.39496236074065,NaN,1.5,2.75,NaN,NaN,2.4749486426830107,0.9681569870468191,NaN,-0.2768506211908975,-0.34068193715313555,-0.06383131596223808,31.098481924886176,-2.6125743415462974,NaN,NaN,NaN,-484339208
1031751000,92.47,93.33,91.10001,91.13,NaN,NaN,60.54147148148149,94.4141671641791,105.9999497000004,98.23150030000006,90.83880040000004,92.56449900000001,92.94144485722381,91.37113674891862,91.54846153846162,95.7135770039044,87.38334607301884,105.9999497000004,98.23150030000006,90.83880040000004,92.56449900000001,91.85333666666666,27745600,41694667.2,48.84499432188387,NaN,1.5,2.75,NaN,NaN,2.4574515967770814,0.6654472109565128,NaN,-0.2048870862382572,-0.31994017376005957,-0.11505308752180238,30.756620964133788,-1.0532137835815676,NaN,NaN,NaN,-512084808
1031837400,90.75301,90.843,88.99001,89.45,NaN,NaN,60.03739740740741,94.20371925373135,105.86754975000039,98.01600030000007,90.72840040000003,92.42599900000002,92.80452545105817,91.1881713442597,91.15230692307702,95.05232663963622,87.25228720651782,105.86754975000039,98.01600030000007,90.72840040000003,92.42599900000002,89.76100333333333,43631504,41004647.2,44.50067877439157,NaN,1.5,2.75,NaN,NaN,2.4347757684358613,1.0640624168082098,NaN,-0.25520597525127076,-0.4340605565858908,-0.17885458133462007,30.02802707494316,-2.9194703711742975,NaN,NaN,NaN,-555716312
1031923800,88.698,89.89999,88.25,89.67,NaN,NaN,59.53332333333334,93.99327134328358,105.73874980000039,97.80750030000007,90.61160060000003,92.23449900000001,92.68160288435,91.04358359718735,90.7223076923078,93.87744913591513,87.56716624870046,105.73874980000039,97.80750030000007,90.61160060000003,92.23449900000001,89.27333,41131008,40783592.8,45.18818019959253,NaN,1.5,2.75,NaN,NaN,2.3787196421190138,1.0085185040392028,NaN,-0.2576960919976264,-0.500974696331653,-0.24327860433402665,30.13265588450195,-2.2989758117236865,NaN,NaN,NaN,-514585304
1032183000,89.317,89.89,88.466,89.89,NaN,NaN,59.02924925925927,93.78282343283583,105.62149980000038,97.61230030000006,90.42320060000003,92.06799900000001,92.57212826143432,90.93371849269332,90.39384615384625,92.86372369007381,87.9239686176187,105.62149980000038,97.61230030000006,90.42320060000003,92.06799900000001,89.41533333333332,28167600,40366108,45.90976845354964,NaN,1.5,2.75,NaN,NaN,2.3105253819676563,0.6978032165003374,NaN,-0.22949018332974147,-0.5301413334962035,-0.30065115016646204,30.260902461313545,1.823742637063887,NaN,NaN,NaN,-486417704
1032269400,90.89,91.19,87.75,87.83,NaN,NaN,58.52517518518519,93.57237552238806,105.4862998000004,97.39590030000006,90.21840040000002,91.68949950000001,92.38616244726042,90.63812625529395,90.06538384615394,92.67222299229664,87.45854470001123,105.4862998000004,97.39590030000006,90.21840040000002,91.68949950000001,88.92333333333333,47762096,41070597.6,40.52937141541921,NaN,1.5,2.75,NaN,NaN,2.3912021403985375,1.1629267356947346,NaN,-0.3285044199088337,-0.7112816750525042,-0.38277725514367045,23.978618885111274,-1.9097500457616812,NaN,NaN,NaN,-534179800
1032355800,87.017,88.5,86.283,86.95,NaN,NaN,58.02110111111112,93.3619276119403,105.3507998000004,97.19150030000009,90.04540020000002,91.31749950000001,92.17297960619138,90.28687613574215,89.66615307692315,92.46259643430139,86.86970971954491,105.3507998000004,97.19150030000009,90.04540020000002,91.31749950000001,87.24433333333333,54829504,42286468,38.45601648879006,NaN,1.5,2.75,NaN,NaN,2.378759130370071,1.2966205642902122,NaN,-0.4260137176427933,-0.9152944021971621,-0.4892806845543688,22.542999116580983,-2.0612750619508877,NaN,NaN,NaN,-589009304
1032442200,85.995,86.8,84.7,84.7,NaN,NaN,57.51702703703704,93.15147970149255,105.20744980000042,96.96990030000008,89.89700020000002,90.76499950000002,91.87992158241917,89.7547926942429,89.12153769230778,92.70585227594201,85.53722310867356,105.20744980000042,96.96990030000008,89.89700020000002,90.76499950000002,85.39999999999999,48514000,42730537.6,33.70791297754066,NaN,1.5,2.75,NaN,NaN,2.3695620496293515,1.1353472884928084,NaN,-0.6039273783444208,-1.2441899074848948,-0.640262529140474,26.13839291525986,-5.888888888888887,NaN,NaN,NaN,-637523304
1032528600,84.92,85.2,84.05,84.35001,NaN,NaN,57.01295296296297,92.94103179104478,105.05274990000039,96.73480040000008,89.72660040000002,90.1485005,91.58463093212822,89.24005148526739,88.81923076923087,93.20890356265355,84.4295579758082,105.05274990000039,96.73480040000008,89.72660040000002,90.1485005,84.53333666666667,46325696,43126632,33.024859568069175,NaN,1.5,2.75,NaN,NaN,2.282450474655827,1.0741783870347215,NaN,-0.7002797358930575,-1.515612199006796,-0.8153324631137384,23.427322696943737,-6.960059563203176,NaN,NaN,NaN,-683849000
1032787800,83.64999,84.06599,82.69,83.66,NaN,NaN,56.508878888888894,92.73058388059702,104.88404995000039,96.47960050000007,89.56280020000003,89.60150000000002,91.2738610916526,88.70861801048001,88.36692384615395,93.5129035042518,83.22094418805611,104.88404995000039,96.47960050000007,89.56280020000003,89.60150000000002,83.47199666666667,46904896,43786001.6,31.662618226274546,NaN,1.5,2.75,NaN,NaN,2.2379904407518394,1.0712303998088741,NaN,-0.7605633018141551,-1.7660365903814323,-1.0054732885672772,21.71933932214229,-8.767720828789539,NaN,NaN,NaN,-730753896
1032874200,82.44,83.64999,81.85001,82.31,NaN,NaN,56.00480481481482,92.52013597014925,104.7088999500004,96.21510060000006,89.36220020000002,88.9540005,90.92233712727408,88.09922581900572,87.86923153846163,93.92942249568466,81.8090405812386,104.7088999500004,96.21510060000006,89.36220020000002,88.9540005,82.60333333333334,69554496,45572171.2,29.13082127533211,NaN,1.5,2.75,NaN,NaN,2.2074189806981366,1.526249335252212,NaN,-0.8354650261043131,-2.0498045711976687,-1.2143395450933556,18.181106779946056,-9.678481290464164,NaN,NaN,NaN,-800308392
1032960600,83.373,84.77,82.03999,84.35001,NaN,NaN,55.50073074074075,92.3096880597015,104.54785000000038,95.98280070000006,89.23800040000002,88.46350100000001,90.66459880855744,87.74215764576708,87.43461692307703,93.6301090732144,81.23912477293966,104.54785000000038,95.98280070000006,89.23800040000002,88.46350100000001,83.72,59294496,46769860.8,37.29092458053428,NaN,1.5,2.75,NaN,NaN,2.2447469106482694,1.2677928688639588,NaN,-0.6973559443926749,-2.0860344755841993,-1.3886785311915244,27.25694602820124,-5.701498043599782,NaN,NaN,NaN,-741013896
1033047000,85.02,85.97,84.45,85.73,NaN,NaN,54.996656666666674,92.09924014925373,104.40460000000037,95.78540070000007,89.1378002,88.14500050000001,90.47108512979048,87.55052358426545,87.05538615384626,93.01373943337903,81.09703287431348,104.40460000000037,95.78540070000007,89.1378002,88.14500050000001,85.38333333333334,53670800,47504710.4,42.14397883653151,NaN,1.5,2.75,NaN,NaN,2.200121417030536,1.1297995408893178,NaN,-0.473507241677003,-1.980562583287778,-1.507055341610775,29.41084554409274,-4.39388870302219,NaN,NaN,NaN,-687343096
1033133400,85,85.63,82.75,82.75,NaN,NaN,54.4925825925926,91.88879223880598,104.24760005000036,95.56190060000006,89.0368002,87.67550050000001,90.16829747764183,87.09333086195446,86.36692461538472,92.08285636517122,80.65099286559821,104.24760005000036,95.56190060000006,89.0368002,87.67550050000001,83.71,64776608,48595185.6,35.71602341557754,NaN,1.5,2.75,NaN,NaN,2.2558270300997836,1.3329840641662247,NaN,-0.4848182817412332,-2.1130781937873166,-1.6282599120460834,33.912843275078274,-7.943041495160752,NaN,NaN,NaN,-752119704
1033392600,82,82.8,80.00999,81.78999,NaN,NaN,53.98850851851853,91.67834432835821,104.08515000000038,95.28970060000005,88.9783998,87.17600000000002,89.83973640008725,86.58825077986356,85.64846230769241,91.13227329198601,80.16465132339881,104.08515000000038,95.28970060000005,88.9783998,87.17600000000002,81.53332666666667,73095312,50731406.4,33.92107840606033,NaN,1.5,2.75,NaN,NaN,2.2939829565212273,1.440829600182344,NaN,-0.5129139077000384,-2.2694022966711316,-1.7564883889710932,33.27963325941845,-6.876932710918815,NaN,NaN,NaN,-825215016
1033479000,82.438,85.77,81.47,85.72,NaN,NaN,53.48443444444445,91.46789641791045,103.95345000000037,95.06940060000005,89.04879980000001,87.04800000000002,89.67817810988775,86.50556022940036,85.36153923076934,90.39122954699549,80.33184891454319,103.95345000000037,95.06940060000005,89.04879980000001,87.04800000000002,84.32000000000001,67274816,50261037.6,45.90610234506632,NaN,1.5,2.75,NaN,NaN,2.437269888198282,1.3385083001151572,NaN,-0.23681828081841982,-2.052511239994118,-1.815692959175698,44.935347224477674,-1.4146060954571638,NaN,NaN,NaN,-757940200
1033565400,84.69,85.53,82.60001,83.14999,NaN,NaN,52.98036037037038,91.2574485074627,103.80354995000037,94.84370050000005,89.11279960000002,86.72850000000003,89.4221707330294,86.1859821123146,84.8600000000001,89.34161630186776,80.37838369813244,103.80354995000037,94.84370050000005,89.11279960000002,86.72850000000003,83.76,56846800,50548402.4,40.7065484951546,NaN,1.5,2.75,NaN,NaN,2.4860356104698336,1.1246013187550314,NaN,-0.19881119321050367,-2.0642069506888276,-1.865395757478324,47.634825784774534,-1.8300000000000003,NaN,NaN,NaN,-814787000
1033651800,83.14,84.60001,81.95,82.31,NaN,NaN,52.47628629629631,91.04700059701493,103.6435999500004,94.58810050000004,89.06459960000002,86.40500000000002,89.14326207683217,85.81684095876084,84.27692307692315,87.8742619277041,80.67958422614221,103.6435999500004,94.58810050000004,89.06459960000002,86.40500000000002,82.95333666666666,55548896,49959931.2,39.14589713081635,NaN,1.5,2.75,NaN,NaN,2.497748066864845,1.1118689450877386,NaN,-0.2011668181314583,-2.116854280142647,-1.9156874620111886,45.81268763239638,-2.418505937343689,NaN,NaN,NaN,-870335896
1033738200,82.8,82.92,79.58,80.8,NaN,NaN,51.972212222222225,90.83655268656717,103.47269995000039,94.29390050000003,89.00059960000003,85.94500000000002,88.81607532872111,85.339046581736,83.73615384615393,87.14296976961276,80.32933792269509,103.47269995000039,94.29390050000003,89.00059960000003,85.94500000000002,81.10000000000001,68628368,51460204.8,36.44118167721016,NaN,1.5,2.75,NaN,NaN,2.557908919231642,1.3336201880020502,NaN,-0.2709974966230704,-2.2544343327900265,-1.983436836166956,46.691523839652426,-3.41859909156108,NaN,NaN,NaN,-938964264
1033997400,80.065,81.2,78.55,79.13,NaN,NaN,51.46813814814816,90.6261047761194,103.28940000000038,93.98730060000004,88.87119940000002,85.36850000000001,88.43622923739872,84.74770881204685,83.13461538461547,86.81008911766827,79.45914165156267,103.28940000000038,93.98730060000004,88.87119940000002,85.36850000000001,79.62666666666667,53211104,52417015.2,33.67036753174983,NaN,1.5,2.75,NaN,NaN,2.5644868535722396,1.015149447120751,NaN,-0.38905276002635913,-2.469752786199905,-2.0807000261735458,47.63449481932684,-3.8634430810351192,NaN,NaN,NaN,-992175368
1034083800,79.81,81.31,78.2,80.37,NaN,NaN,50.96406407407408,90.41565686567165,103.11800005000038,93.68740060000003,88.6831994,84.802,88.11990652220662,84.33078416328048,82.80153846153856,86.63077997838141,78.9722969446957,103.11800005000038,93.68740060000003,88.6831994,84.802,79.96,79531632,54322261.6,37.47207634460888,NaN,1.5,2.75,NaN,NaN,2.60345207831708,1.4640707079839252,NaN,-0.34454947535536995,-2.511386870367758,-2.1668373950123883,48.508137620529546,-4.718446387854599,NaN,NaN,NaN,-912643736
1034170200,79.09,79.7,77.78,78.10001,NaN,NaN,50.459990000000005,90.20520895522388,102.93375010000037,93.35940080000005,88.42639960000002,84.15050049999999,87.72696940368871,83.73737710011092,82.3207692307693,86.77072489203276,77.87081356950584,102.93375010000037,93.35940080000005,88.42639960000002,84.15050049999999,78.52667000000001,79893872,56929675.2,33.66779305262767,NaN,1.5,2.75,NaN,NaN,2.6024912155801454,1.4033783210482815,NaN,-0.4237046416283121,-2.6964681970477784,-2.2727635554194663,47.31091891057409,-8.900023329056348,NaN,NaN,NaN,-992537608
1034256600,77.94,81.07001,77.07001,80.63,NaN,NaN,77.07001,89.99476104477613,102.76325010000036,93.06870080000003,88.21579960000003,83.7095005,87.44865687805387,83.44143642390988,82.08769230769238,86.5500401191876,77.62534449619716,102.76325010000036,93.06870080000003,88.21579960000003,83.7095005,79.59000666666667,76752128,58585706.4,40.872763694876554,NaN,1.5,2.75,NaN,NaN,2.702313271610135,1.3100828293503346,NaN,-0.2689278661204697,-2.6089233880700533,-2.3399955219495836,50.913672623513165,-2.5619335347432077,NaN,NaN,NaN,-915785480
1034343000,82.10001,84.73,81.82001,84.16,NaN,NaN,77.05891945454545,89.78431313432836,102.60725010000037,92.82330080000001,88.12339960000003,83.4340005,87.3196899416596,83.50987105020417,82.23000000000009,86.82757629127101,77.63242370872916,102.60725010000037,92.82330080000001,88.12339960000003,83.4340005,83.57000333333333,82321680,60645240,49.168932547406456,NaN,1.5,2.75,NaN,NaN,2.8021480379236974,1.3574301956757036,NaN,0.08879050715183423,-2.2290073880097907,-2.317797895161625,54.151434760815306,2.897677331908212,NaN,NaN,NaN,-833463800
1034602200,83.2,84.85001,83.03999,84.63,NaN,NaN,77.04782890909091,89.5738652238806,102.45010010000037,92.5802008,88.08019980000003,83.1710005,87.21421190473177,83.61654999780377,82.25153769230778,86.89106941476965,77.61200596984591,102.45010010000037,92.5802008,88.08019980000003,83.1710005,84.17333333333333,40638400,61268780,50.17141412601821,NaN,1.5,2.75,NaN,NaN,2.7312817495005755,0.6632807116446582,NaN,0.3594721312339795,-1.8684577311191504,-2.22792986235313,53.49662469357082,-1.271581894540368,NaN,NaN,NaN,-792825400
1034688600,86.991,88.72,86.856,88.7,NaN,NaN,77.03673836363636,89.36341731343283,102.31360010000037,92.36620070000001,88.17879980000002,83.21450050000001,87.27247810454621,84.10068809325104,82.47999923076932,87.99254472126648,76.96745374027216,102.31360010000037,92.36620070000001,88.17879980000002,83.21450050000001,88.092,82538320,63007591.2,57.912193623222485,NaN,1.5,2.75,NaN,NaN,2.8283330531076776,1.3099742178367866,NaN,0.7903355091339739,-1.2400104759356623,-2.030345985069636,53.508436474729166,6.674697134659907,NaN,NaN,NaN,-710287080
1034775000,87.41701,87.8,85.924,86.55,NaN,NaN,77.02564781818181,89.15296940298508,102.17485010000037,92.14480069999999,88.17799980000001,83.1945005,87.24414562985812,84.3339558938938,82.77230692307701,88.69859125427055,76.84602259188347,102.17485010000037,92.14480069999999,88.17799980000001,83.1945005,86.758,63526896,63442460.8,53.20972523631837,NaN,1.5,2.75,NaN,NaN,2.8245949778857002,1.0013308941509407,NaN,0.9002639334136169,-0.9050160683026149,-1.8052800017162318,52.23707650936123,5.1512574413801415,NaN,NaN,NaN,-773813976
1034861400,88.87,89.3,87.85001,88.27,NaN,NaN,77.01455727272727,88.94252149253731,102.03855010000038,91.9465006,88.18139960000002,83.3730005,87.28437521300094,84.70881723733248,83.27076923076932,89.83811013530402,76.70342832623462,102.03855010000038,91.9465006,88.18139960000002,83.3730005,88.47333666666667,68584368,64445979.2,56.26900963633218,NaN,1.5,2.75,NaN,NaN,2.8192667651795786,1.0642148486433425,NaN,1.048196392023878,-0.49503451168638435,-1.5432309037102623,52.083242550163895,9.245049504950494,NaN,NaN,NaN,-705229608
1034947800,87.64999,89.11,86.92999,88.64,NaN,NaN,77.00346672727272,88.73207358208955,101.89755010000037,91.7599006,88.13519960000004,83.5875,87.33753696935385,85.08321559568176,83.49538461538471,90.5631102222964,76.42765900847301,101.89755010000037,91.7599006,88.13519960000004,83.5875,88.22666333333332,47559104,64507649.6,56.921512857934864,NaN,1.5,2.75,NaN,NaN,2.7736055676667513,0.737263011362299,NaN,1.1236512814053374,-0.13866680195359038,-1.2623180833589278,49.591082921755344,12.018197902186282,NaN,NaN,NaN,-657670504
1035207000,88.121,90.5,87.57001,90.17,NaN,NaN,76.99237618181817,88.5216256716418,101.76030010000036,91.5916006,88.11279980000003,83.913,87.44861395094782,85.56767125323589,84.03538538461547,91.9383897669744,76.13238100225654,101.76030010000036,91.5916006,88.11279980000003,83.913,89.41333666666667,45970704,64460940,59.60555530536904,NaN,1.5,2.75,NaN,NaN,2.7847758842619834,0.7131559670088584,NaN,1.2211906260002425,0.2641701991413754,-0.9570204268588671,45.79725045327909,12.19360457882294,NaN,NaN,NaN,-611699800
1035293400,89.05,90.00999,88.52,89.52,NaN,NaN,76.98128563636364,88.31117776119403,101.62395015000037,91.41460060000001,88.09079980000004,84.2735,87.52984477640085,85.94408351483247,84.59000076923085,92.93067165537003,76.24932988309168,101.62395015000037,91.41460060000001,88.09079980000004,84.2735,89.34999666666666,41214704,63043950.4,57.953534642215836,NaN,1.5,2.75,NaN,NaN,2.7037204639575565,0.6537455812730923,NaN,1.1855530580755205,0.5249208957355336,-0.6606321623399869,47.18604196459768,14.6222644529751,NaN,NaN,NaN,-652914504
1035379800,88.77,90.27,87.67999,90.2,NaN,NaN,76.97019509090909,88.10072985074628,101.49235015000036,91.27290060000001,88.11539980000003,84.5659995,87.63455674595376,86.34940889437223,85.31307769230779,93.84181883238404,76.78433655223154,101.49235015000036,91.27290060000001,88.11539980000003,84.5659995,89.38332999999999,55112496,62834850.4,59.226700072859835,NaN,1.5,2.75,NaN,NaN,2.6955982879605878,0.8771007752729527,NaN,1.150486339293349,0.7774757617766994,-0.3730105775166496,40.18529185792871,11.869031377899054,NaN,NaN,NaN,-597802008
1035466200,90.75,90.89999,88.10001,88.36,NaN,NaN,76.95910454545454,87.89028194029851,101.35630010000037,91.11020060000003,88.03819980000002,84.69749949999999,87.6630055010144,86.54089376157488,86.0230776923078,93.8854147584821,78.16074062613349,101.35630010000037,91.11020060000003,88.03819980000002,84.69749949999999,89.12,55149808,62908800.8,54.42446812607064,NaN,1.5,2.75,NaN,NaN,2.7030541245348316,0.876662840471758,NaN,0.9541729691308981,0.819705633896973,-0.13446733523392507,43.01498486365082,4.990494296577951,NaN,NaN,NaN,-652951816
1035552600,88.215,90.39,87.944,90.2,NaN,NaN,76.948014,87.67983402985075,101.22690010000036,90.95610060000003,87.97219980000001,85.0699995,87.76249548136677,86.88938006999632,86.77923153846163,94.19977513711643,79.35868793980683,101.22690010000036,90.95610060000003,87.97219980000001,85.0699995,89.51133333333333,43724496,61856195.2,58.0845004940558,NaN,1.5,2.75,NaN,NaN,2.684693115639486,0.7068733513049958,NaN,0.8997586426494224,0.9902309680778529,0.09047232542843053,38.285130236215046,6.581590452558203,NaN,NaN,NaN,-609227320
1035815400,91.14999,91.28999,88.85001,89.61,NaN,NaN,76.93692345454545,87.46938611940298,101.10025010000038,90.81760050000003,87.8999998,85.46099999999998,87.83494663896023,87.14848672999668,87.66461538461547,93.25177437306678,82.07745639616417,101.10025010000038,90.81760050000003,87.8999998,85.46099999999998,89.91666666666667,39427008,60172780,56.517198526172145,NaN,1.5,2.75,NaN,NaN,2.6672136073795234,0.6552299561363129,NaN,0.780008721589461,1.0654832274152568,0.2854745058257958,39.06608844209016,1.0259301014656106,NaN,NaN,NaN,-648654328
1035901800,89.08,89.49001,87,88.57001,NaN,NaN,76.9258329090909,87.25893820895523,100.97200015000037,90.66990060000002,87.76340020000002,85.60350049999998,87.86377265311866,87.28386989856843,88.27538538461546,92.11595941902007,84.43481135021085,100.97200015000037,90.66990060000002,87.76340020000002,85.60350049999998,88.35334,59529808,59785529.6,53.76334681259479,NaN,1.5,2.75,NaN,NaN,2.663126921138129,0.995722684038915,NaN,0.5950900961504831,1.0293371260138997,0.43424702986341657,29.830492846895602,2.3339225880993637,NaN,NaN,NaN,-708184136
1035988200,88.67999,89.96001,88.23,89.42999,NaN,NaN,76.91474236363636,87.04849029850746,100.84340015000036,90.52680040000003,87.6642,85.91750049999999,87.92519294123166,87.48826228918095,88.68076923076931,91.72899065964606,85.63254780189257,100.84340015000036,90.52680040000003,87.6642,85.91750049999999,89.20666666666666,41703008,59028340,55.68618583892554,NaN,1.5,2.75,NaN,NaN,2.5964757124854048,0.7064912887606191,NaN,0.4989140452635732,1.057889586442883,0.5589755411793098,25.79035391368659,1.3141384388807156,NaN,NaN,NaN,-666481128
1036074600,89.66,90.3,88.19,88.52,NaN,NaN,76.90365181818181,86.8380423880597,100.72190010000037,90.39240030000002,87.51960000000001,86.22800049999998,87.94851870824218,87.58652302354467,88.98000000000009,90.9529698660834,87.00703013391679,100.72190010000037,90.39240030000002,87.51960000000001,86.22800049999998,89.00333333333333,41621104,58331950.4,53.16660432631772,NaN,1.5,2.75,NaN,NaN,2.561727447307876,0.7135215557613174,NaN,0.349309351930968,0.9956122310930198,0.6463028791620518,24.511292913632296,-0.13537906137184627,NaN,NaN,NaN,-708102232
1036161000,88.35001,90.82001,88.05,90.27,NaN,NaN,76.89256127272726,86.62759447761195,100.60490010000038,90.26930030000003,87.39140020000002,86.70150049999998,88.03955719027189,87.84209225939756,89.10076923076932,91.17975382820596,87.02178463333267,100.60490010000038,90.26930030000003,87.39140020000002,86.70150049999998,89.71333666666665,51889504,57495007.2,57.179169833741426,NaN,1.5,2.75,NaN,NaN,2.5766047725001706,0.9025045221665786,NaN,0.3430173467400197,1.0750745625870763,0.7320572158470566,26.878882896661874,0.11090163025395842,NaN,NaN,NaN,-656212728
1036420200,91.8,92.94,90.89999,91.13,NaN,NaN,76.88147072727273,86.41714656716418,100.49480015000037,90.16510030000003,87.32200000000003,87.30150049999997,88.1607510259475,88.15522632993112,89.453076923077,91.21112301712573,87.69503082902828,100.49480015000037,90.16510030000003,87.32200000000003,87.30150049999997,91.65666333333333,49081808,57288542.4,59.03657985259677,NaN,1.5,2.75,NaN,NaN,2.58327586017873,0.8567473694356029,NaN,0.36930126864106705,1.1936838016483904,0.8243825330073233,25.62063534902855,1.7984807864164427,NaN,NaN,NaN,-607130920
1036506600,90.84,92.07001,90.84,91.85001,NaN,NaN,76.87038018181818,86.20669865671643,100.39220020000037,90.06960050000004,87.25380040000003,87.87550099999999,88.30542784845937,88.5071104889853,89.72846230769238,91.75934650028728,87.69757811509749,100.39220020000037,90.06960050000004,87.25380040000003,87.87550099999999,91.58667333333334,37282192,55176070.4,60.57832481048783,NaN,1.5,2.75,NaN,NaN,2.486614013023106,0.6756949476416502,NaN,0.4048497568735685,1.330444729099284,0.9255949722257155,25.296521975716185,1.829279379157422,NaN,NaN,NaN,-569848728
1036593000,92.48,93.07001,90.78999,93.03999,NaN,NaN,76.85928963636363,85.99625074626866,100.29125015000038,89.95880040000002,87.23140020000004,88.62249999999999,88.49109695244135,88.93881329955813,90.06692307692313,92.65070896491983,87.48313718892643,100.29125015000038,89.95880040000002,87.23140020000004,88.62249999999999,92.29999666666667,65270000,54444876.8,63.05333711407754,NaN,1.5,2.75,NaN,NaN,2.4718572978071696,1.1988272145378425,NaN,0.4734112382797162,1.5173590200753608,1.0439477817956446,25.855654571755892,5.296502942507926,NaN,NaN,NaN,-504578728
1036679400,92.02699,92.22,90.22,90.75999,NaN,NaN,76.84819909090909,85.7858028358209,100.17715010000036,89.81670030000004,87.20459980000004,89.12899949999999,88.58007315038483,89.11225869960022,90.11230692307699,92.72233355519482,87.50228029095915,100.17715010000036,89.81670030000004,87.20459980000004,89.12899949999999,91.06666333333334,51574096,53185975.2,55.8218682239123,NaN,1.5,2.75,NaN,NaN,2.4967239193923723,0.9696935292821329,NaN,0.33654550102403946,1.464629658075694,1.1280841570516544,27.331679754819707,0.6208314855875822,NaN,NaN,NaN,-556152824
1036765800,90.53,91.57001,89.52,89.64999,NaN,NaN,76.83710854545454,85.57535492537313,100.05765005000038,89.68800020000002,87.15479960000002,89.40349899999998,88.62203067389916,89.1634712044002,90.12230615384621,92.72416267814975,87.52044962954267,100.05765005000038,89.68800020000002,87.15479960000002,89.40349899999998,90.24666666666667,37911104,50965446.4,52.655681670584485,NaN,1.5,2.75,NaN,NaN,2.464815782292917,0.7438589608821714,NaN,0.15199630239824713,1.3180795350494634,1.1660832326512163,25.924828971632678,0.04462671576833286,NaN,NaN,NaN,-594063928
1037025000,89.515,89.56,87.8,88.25999,NaN,NaN,76.82601799999999,85.36490701492538,99.92965000000036,89.55850000000002,87.08439940000002,89.58499849999998,88.60783300041292,89.0774253754097,89.97307461538466,92.75621401091782,87.1899352198515,99.92965000000036,89.55850000000002,87.08439940000002,89.58499849999998,88.53999666666668,33580800,50612566.4,48.91420023388821,NaN,1.5,2.75,NaN,NaN,2.4208996549862802,0.6634873982600495,NaN,-0.07098096827493117,1.0773570223075524,1.1483379905824835,27.174567455200584,-0.3500281867417588,NaN,NaN,NaN,-627644728
1037111400,88.66,89.92999,88.37,88.96001,NaN,NaN,76.81492745454545,85.15445910447761,99.82305005000036,89.45530010000002,87.09799960000002,89.59799899999999,88.62164386314183,89.06624295870402,90.01922923076928,92.71227771089515,87.32618075064342,99.82305005000036,89.45530010000002,87.09799960000002,89.59799899999999,89.08666666666666,37769392,48374120,50.80984467079874,NaN,1.5,2.75,NaN,NaN,2.3672639653444034,0.7807768286017399,NaN,-0.1728133993339216,0.9323212414150817,1.1051346407490032,26.81797154043748,-0.5255284049567787,NaN,NaN,NaN,-589875336
1037197800,88.32001,89.74899,87.45,89.05,NaN,NaN,76.8038369090909,84.94401119402986,99.70895005000037,89.34780010000003,87.08819980000003,89.72299899999999,88.63844214301862,89.06469601025601,89.93076769230774,92.66941723820548,87.19211814641,99.70895005000037,89.34780010000003,87.08819980000003,89.72299899999999,88.74966333333333,63905008,48393025.6,51.06125205243507,NaN,1.5,2.75,NaN,NaN,2.362387253534089,1.3205416939254155,NaN,-0.23191318034711483,0.8152431653151098,1.0471563456622246,26.182814680953523,0.5987347492092195,NaN,NaN,NaN,-525970328
1037284200,90.07001,91,89.759,90.73,NaN,NaN,76.79274636363635,84.7335632835821,99.59670010000036,89.27950010000002,87.12719980000001,89.84599899999998,88.72046401976299,89.22329639023164,90.0169215384616,92.78014387151363,87.25369920540957,99.59670010000036,89.27950010000002,87.12719980000001,89.84599899999998,90.49633333333334,31938704,46560742.4,55.62134485885927,NaN,1.5,2.75,NaN,NaN,2.332931021138797,0.6859577909135745,NaN,-0.15913155530618694,0.8482419015294909,1.0073734568356778,27.446805179870655,0.5095823640190628,NaN,NaN,NaN,-494031624
1037370600,90,91.55,89.95,91.39999,NaN,NaN,76.78165581818182,84.52311537313433,99.49045010000036,89.21630000000003,87.15519960000002,89.98399849999997,88.82554346996835,89.43060054354291,90.23461230769236,92.95311343583951,87.5161111795452,99.49045010000036,89.21630000000003,87.15519960000002,89.98399849999997,90.96666333333333,39166192,46141096.8,57.328989415396755,NaN,1.5,2.75,NaN,NaN,2.280578805343168,0.8488353055361268,NaN,-0.07159833859745801,0.9178755335888553,0.9894738721863133,25.49012679692513,0.29626906616921656,NaN,NaN,NaN,-454865432
1037629800,92.14999,92.14999,90.35001,90.48,NaN,NaN,76.77056527272727,84.31266746268658,99.39360005000037,89.12680010000003,87.15159960000001,89.99949849999997,88.89042411820489,89.53054334891978,90.31538230769236,92.99558298909665,87.63518162628807,99.39360005000037,89.12680010000003,87.15159960000001,89.99949849999997,90.99333333333334,29019392,45293531.2,54.24251535785903,NaN,1.5,2.75,NaN,NaN,2.2462503192472276,0.640696170759148,NaN,-0.08071336789911687,0.8885821623124173,0.9692955302115341,25.65277669197569,-1.4915730548096766,NaN,NaN,NaN,-483884824
1037716200,90.02,91.10001,89.75999,90.36,NaN,NaN,76.75947472727272,84.10221955223881,99.29955005000038,89.04080000000002,87.1247996,90.04149849999996,88.94805454494195,89.60953922045123,90.45692076923082,92.92919523366947,87.98464630479216,99.29955005000038,89.04080000000002,87.1247996,90.04149849999996,90.40666666666668,32813696,44873480.8,53.83537987917392,NaN,1.5,2.75,NaN,NaN,2.1815195821581397,0.731249179136556,NaN,-0.09869036554499222,0.8459325732802938,0.944622938825286,25.064085969593922,-2.8804710748571702,NaN,NaN,NaN,-516698520
1037802600,89.98,92.42,89.95,92.37,NaN,NaN,76.74838418181817,83.89177164179105,99.21790005000037,88.99420000000002,87.1495996,90.14999849999995,89.082248484356,89.87244024707492,90.61845923076929,93.28737778671672,87.94954067482186,99.21790005000037,88.99420000000002,87.1495996,90.14999849999995,91.58,36815296,43958620.8,59.34043142410481,NaN,1.5,2.75,NaN,NaN,2.202125326289701,0.8374988871352398,NaN,0.014877069895741224,0.9632192761949625,0.9483422062992213,27.427243153898775,1.7739204246276388,NaN,NaN,NaN,-479883224
1037889000,92.60001,94.19,92.42999,94.09,NaN,NaN,76.73729363636363,83.68132373134328,99.14825005000037,88.98540000000003,87.24239960000001,90.43649849999996,89.2786308967342,90.27411260449635,90.8461515384616,94.09321470680824,87.59908837011496,99.14825005000037,88.98540000000003,87.24239960000001,90.43649849999996,93.56999666666665,55170800,43959670.4,63.366219718096566,NaN,1.5,2.75,NaN,NaN,2.1748306601261507,1.255032157838927,NaN,0.18639958457016115,1.1813416870119227,0.9949421024417615,24.623629749277267,4.952605125778598,NaN,NaN,NaN,-424712424
1037975400,93.48,94.27,93.27299,93.42,NaN,NaN,76.72620309090908,83.47087582089553,99.06490005000036,88.96450010000002,87.3173996,90.59749849999996,89.44103752823482,90.57372092787766,90.96692000000006,94.46168405180035,87.47215594819977,99.06490005000036,88.96450010000002,87.3173996,90.59749849999996,93.65433,32514096,43399150.4,60.83923313021949,NaN,1.5,2.75,NaN,NaN,2.090700612974283,0.749187385013878,NaN,0.2323066676028307,1.2853254369452998,1.053018769342469,23.561652644619947,5.846375010919443,NaN,NaN,NaN,-457226520
1038234600,93.42999,94.25999,92.77,93.48,NaN,NaN,76.71511254545453,83.26042791044776,98.97510005000036,88.90620010000002,87.3891996,90.79099849999997,89.59942821340208,90.85050941093694,91.00076692307698,94.58262420471591,87.41890964143805,98.97510005000036,88.90620010000002,87.3891996,90.79099849999997,93.50333,34059296,43130764.8,60.98926736776801,NaN,1.5,2.75,NaN,NaN,2.0477927120475488,0.7896752157754457,NaN,0.2431313272079616,1.3569329283524212,1.1138016011444596,20.18904829971878,5.080923439644406,NaN,NaN,NaN,-423167224
1038321000,93.07401,93.45,91.62,91.7,NaN,NaN,76.704022,83.04998,98.87815005000037,88.84250000000003,87.4665996,90.94749799999997,89.68180357758239,90.931413276562,91.07307538461545,94.67048953484421,87.47566123438669,98.87815005000037,88.84250000000003,87.4665996,90.94749799999997,92.25666666666666,42290400,42268794.4,54.33811097926017,NaN,1.5,2.75,NaN,NaN,2.034378946901295,1.000511147770044,NaN,0.11342091002517196,1.2555777386759246,1.1421568286507526,24.630224226319648,2.9758562605278,NaN,NaN,NaN,-465457624
1038407400,92.52,94.64999,92.42999,94.28,NaN,NaN,76.69293145454544,82.83953208955225,98.78820005000036,88.82929990000004,87.61319959999999,91.18999849999997,89.86212500591249,91.25032629784181,91.42923000000005,95.29902255627312,87.55943744372698,98.78820005000036,88.82929990000004,87.61319959999999,91.18999849999997,93.78666,37773008,42072294.4,60.98031079166395,NaN,1.5,2.75,NaN,NaN,2.0997797364083453,0.8978119339267602,NaN,0.18041196878197274,1.3676717896282184,1.1872598208462457,28.319341046369725,3.912708034828609,NaN,NaN,NaN,-427684616
1038580200,94.8,94.95,93.77,93.98,NaN,NaN,76.6818409090909,82.62908417910448,98.69780005000035,88.84789990000003,87.79879959999998,91.46299849999997,90.02361029979828,91.51029522185688,91.86923076923082,95.49033317290609,88.24812836555556,98.69780005000035,88.84789990000003,87.79879959999998,91.46299849999997,94.23333333333333,19385696,40960524,59.889387620277205,NaN,1.5,2.75,NaN,NaN,2.0340811838077495,0.4732775391252319,NaN,0.1829738527540523,1.4159771367888112,1.233003284034759,27.420184101700436,2.822768361353214,NaN,NaN,NaN,-447070312
1038839400,95.47,96.05,93.22,94.13,NaN,NaN,76.67075036363636,96.05,98.61400005000036,88.86049990000001,87.99439939999998,91.65599849999997,90.18464519000227,91.75979091501337,92.26692230769237,95.65044319857645,88.88340141680828,98.61400005000036,88.86049990000001,87.99439939999998,91.65599849999997,94.46666666666665,49794400,40855768.8,60.27208456790576,NaN,1.5,2.75,NaN,NaN,2.0909325278214816,1.2187850446226336,NaN,0.17331939427620524,1.4496525268800156,1.2763331326038103,27.32453356760259,4.034040671971697,NaN,NaN,NaN,-397275912
1038925800,93.25,93.39999,92.35001,92.87,NaN,NaN,76.65965981818181,96.03428585714285,98.53455010000036,88.87069980000003,88.17859939999998,91.74299849999996,90.2899532217669,91.86552511358353,92.56076846153853,95.39459248970171,89.72694443337535,98.53455010000036,88.87069980000003,88.17859939999998,91.74299849999996,92.87333333333333,34433296,40123343.2,55.48333391136531,NaN,1.5,2.75,NaN,NaN,2.068722347262804,0.8581861144611698,NaN,0.06613613574588695,1.359003302286169,1.292867166540282,27.970822063072074,2.7777777777777835,NaN,NaN,NaN,-431709208
1039012200,91.77,93.14,91.42999,92.45,NaN,NaN,76.64856927272726,96.01857171428571,98.44385010000036,88.87179980000002,88.38139939999998,91.77299799999996,90.37466093856035,91.92118938848034,92.69307615384622,95.3261382954464,90.06001401224604,98.44385010000036,88.87179980000002,88.38139939999998,91.77299799999996,92.33999666666666,64137200,41466093.6,53.94475882156606,NaN,1.5,2.75,NaN,NaN,2.043100036744032,1.5467384176261059,NaN,-0.043101461710880695,1.2389903394016812,1.282091801112562,28.19484019326273,0.08660820612752873,NaN,NaN,NaN,-495846408
1039098600,92.7,92.80099,91.10001,91.42999,NaN,NaN,76.63747872727272,96.00285757142856,98.35950005000036,88.88049970000003,88.52299899999997,91.69249799999997,90.41604639195015,91.87440849433936,92.69538384615393,95.32395750939237,90.06681018291549,98.35950005000036,88.88049970000003,88.52299899999997,91.69249799999997,91.77699666666668,36778192,40041503.2,50.296906527719834,NaN,1.5,2.75,NaN,NaN,2.0186628912623155,0.9185017809221507,NaN,-0.1860932631597887,1.049475222162826,1.2355684853226148,26.047498729355407,-2.8270910830056324,NaN,NaN,NaN,-532624600
1039185000,90.12,92.17,89.98,92.03,NaN,NaN,76.62638818181817,95.98714342857143,98.27145005000037,88.89339960000005,88.64899899999996,91.75599849999996,90.47933869030504,91.88922673297371,92.8146146153847,95.15526217664572,90.47396705412368,98.27145005000037,88.89339960000005,88.64899899999996,91.75599849999996,91.39333333333333,50132096,39969403.2,52.338613462754616,NaN,1.5,2.75,NaN,NaN,2.03090125617215,1.254261809943662,NaN,-0.23893564330124795,0.9368989311960547,1.1758345744973027,23.57499459751094,-1.487904089060159,NaN,NaN,NaN,-482492504
1039444200,91.07001,91.46001,89.48,89.5,NaN,NaN,76.61529763636362,95.97142928571428,98.16170005000036,88.91039960000006,88.78399899999997,91.74849899999997,90.44093325146954,91.66168132983336,92.74846076923086,95.39189650561937,90.10502503284235,98.16170005000036,88.91039960000006,88.78399899999997,91.74849899999997,90.14667000000001,36804096,39914052.8,44.11052540316973,NaN,1.5,2.75,NaN,NaN,2.067979737874139,0.9220836627244228,NaN,-0.43170937102993423,0.6361978607098848,1.067907231739819,27.777445530856255,-4.257595207531026,NaN,NaN,NaN,-519296600
1039530600,90.02,91.10001,89.75999,90.7,NaN,NaN,76.60420709090909,95.95571514285714,98.05910005000037,88.97029950000005,88.96219919999996,91.87049949999997,90.45109273180407,91.570092631754,92.61999923076931,95.47811177634516,89.76188668519346,98.05910005000037,88.97029950000005,88.96219919999996,91.87049949999997,90.52,33449104,39907468,48.26491562767261,NaN,1.5,2.75,NaN,NaN,2.034553328025986,0.8381665306353187,NaN,-0.46306000013228954,0.4890822315744572,0.9521422317067467,29.49552902480325,-1.0905125408942202,NaN,NaN,NaN,-485847496
1039617000,90.42,91.62,90.16,90.78,NaN,NaN,76.59311654545454,95.940001,97.95475010000035,89.05609950000006,89.06339919999995,91.96149899999998,90.46399105604705,91.4948457144441,92.36538384615393,95.24398082197573,89.48678687033214,97.95475010000035,89.05609950000006,89.06339919999995,91.96149899999998,90.85333333333334,39206096,39979303.2,48.53954331588412,NaN,1.5,2.75,NaN,NaN,1.9935138045955594,0.9806598130004426,NaN,-0.462010682586835,0.37462887847320303,0.836639561060038,27.65719645313975,-3.7123462028001697,NaN,NaN,NaN,-446641400
1039703400,91.2,91.49001,90.2,90.77,NaN,NaN,76.58202599999998,95.92428685714286,97.85285015000034,89.16429950000006,89.21579939999997,92.04749899999997,90.4759914067903,91.42581278925894,92.16153769230777,95.08746338997321,89.23561199464234,97.85285015000034,89.16429950000006,89.21579939999997,92.04749899999997,90.82000333333333,34480496,38508077.6,48.50488245763292,NaN,1.5,2.75,NaN,NaN,1.9432635328387333,0.8954094348246561,NaN,-0.44539928707629217,0.2798904522146728,0.725289739290965,20.858805325075465,-3.4156203447542115,NaN,NaN,NaN,-481121896
1039789800,89.91,90.48,89.27,89.34,NaN,NaN,76.57093545454545,95.90857271428571,97.73085010000034,89.21049950000005,89.35639939999996,91.97799899999997,90.43144272417108,91.22716395218666,91.84307615384623,95.01641146231715,88.6697408453753,97.73085010000034,89.21049950000005,89.35639939999996,91.97799899999997,89.69666666666667,36873392,38754812,43.69937183806498,NaN,1.5,2.75,NaN,NaN,1.9116018519216809,0.951453254372644,NaN,-0.5095106069372779,0.08840148061936759,0.5979120875566455,21.963306378289374,-5.088707107192173,NaN,NaN,NaN,-517995288
1040049000,89.82001,91.78999,89.66,91.64999,NaN,NaN,76.5598449090909,95.89285857142856,97.61035005000035,89.28699940000006,89.57339919999995,91.99049899999997,90.47922889185064,91.26743309959745,91.8392292307693,95.01337014554683,88.66508831599178,97.61035005000035,89.28699940000006,89.57339919999995,91.99049899999997,91.03332666666667,37112304,38652117.6,51.9762880040281,NaN,1.5,2.75,NaN,NaN,1.9500581482129893,0.9601622447718103,NaN,-0.38101783737018446,0.12163979084391485,0.5026576282140993,28.0511380970116,-1.3136750296112867,NaN,NaN,NaN,-480882984
1040135400,91.37199,91.74001,90.74001,90.85001,NaN,NaN,76.54875436363635,95.87714442857143,97.48770010000032,89.33949940000007,89.80779939999995,92.00899949999999,90.49376932746434,91.2276785186834,91.57538384615393,94.4502355472206,88.70053214508725,97.48770010000032,89.33949940000007,89.80779939999995,92.00899949999999,91.11000999999999,32399904,38821143.2,49.27461803432242,NaN,1.5,2.75,NaN,NaN,1.8821968519120615,0.8345942785116126,NaN,-0.33614296243547753,0.08247892516975242,0.41862188760522995,27.51368728793604,-1.7306544077879993,NaN,NaN,NaN,-513282888
1040221800,90.32001,90.39999,89.33,89.8,NaN,NaN,76.53766381818181,95.86143028571428,97.35295010000033,89.33979940000005,89.99639939999996,91.98099949999998,90.46656268717162,91.09170913595165,91.25384538461546,93.90750979849129,88.60018097073963,97.35295010000033,89.33979940000005,89.99639939999996,91.98099949999998,89.84333,35643104,38962613.6,45.90206890569268,NaN,1.5,2.75,NaN,NaN,1.8563263624897712,0.9148026969114823,NaN,-0.3612207716830112,-0.03290407699853404,0.32831669468447716,28.028706223081322,-1.7827739016486892,NaN,NaN,NaN,-548925992
1040308200,89.35001,90.7,88.60001,89.16,NaN,NaN,76.52657327272726,95.84571614285714,97.21625010000032,89.32199940000004,90.21759919999995,91.82049949999998,90.41532493473352,90.90773683728959,90.87153769230778,93.16521744073007,88.57785794388549,97.21625010000032,89.32199940000004,90.21759919999995,91.82049949999998,89.48667,39287200,39086208.8,43.92849860632099,NaN,1.5,2.75,NaN,NaN,1.8737309080262166,1.0051422536534165,NaN,-0.4018397724194323,-0.1739830208398132,0.2278567515796191,27.69758776622341,-3.11854829946757,NaN,NaN,NaN,-588213192
1040394600,89.2,90.02,89.10001,89.99001,NaN,NaN,76.51548272727271,95.830002,97.08125010000032,89.31029950000004,90.40479939999996,91.61549999999998,90.39864591768514,90.82033428135725,90.65000000000009,92.66863283518312,88.63136716481706,97.08125010000032,89.31029950000004,90.40479939999996,91.61549999999998,89.70333999999998,31181104,37886724,47.104820234539744,NaN,1.5,2.75,NaN,NaN,1.8056065574529152,0.8230087140814815,NaN,-0.355341897646062,-0.21632062047795841,0.13902127716810359,28.064379944464868,0.5474972067039084,NaN,NaN,NaN,-557032088
1040653800,89.59,90.47,89.31,90.02,NaN,NaN,76.50439218181818,95.81428785714286,96.94515005000032,89.32269950000004,90.52199939999997,91.44549999999998,90.38379705816808,90.74411196884704,90.46307692307701,92.21245326238534,88.71370058376868,96.94515005000032,89.32269950000004,90.52199939999997,91.44549999999998,89.93333333333334,22645504,37393294.4,47.221157799648864,NaN,1.5,2.75,NaN,NaN,1.7594918033491354,0.6056033404748633,NaN,-0.30692385981160897,-0.24463354759640765,0.06229031221520133,22.828370765479093,-0.7497243660419038,NaN,NaN,NaN,-534386584
1040740200,89.59,89.86,89.25,89.355,NaN,NaN,76.49330163636363,95.79857371428571,96.80607505000033,89.34834960000003,90.61649939999995,91.23924999999998,90.34345207549482,90.61181559086161,90.30346230769239,92.04946847228733,88.55745614309744,96.80607505000033,89.34834960000003,90.61649939999995,91.23924999999998,89.48833333333334,10937000,36237179.6,44.86480909722343,NaN,1.5,2.75,NaN,NaN,1.6888138173956253,0.3018170873320395,NaN,-0.30349355113632237,-0.31707662670520165,-0.013583075568879263,21.668693535450945,-1.569729015201583,NaN,NaN,NaN,-545323584
1040913000,89.7,90.61,88.84,89.39,NaN,NaN,76.48221109090908,95.78285957142857,96.67282510000032,89.40454960000002,90.63029939999997,91.12374999999999,90.30606179802444,90.49545220125574,90.10038538461548,91.59139483820653,88.60937593102443,96.67282510000032,89.40454960000002,90.63029939999997,91.12374999999999,89.61333333333333,17489200,34997119.6,45.0203112078436,NaN,1.5,2.75,NaN,NaN,1.6946128304387946,0.4997325551329087,NaN,-0.2830764141241009,-0.36742859322400534,-0.08435217909990447,21.650897240712126,-1.52032609893136,NaN,NaN,NaN,-527834384
1040999400,88.96001,89.28999,87.38,87.38,NaN,NaN,76.47112054545454,95.76714542857142,96.53032510000031,89.41244960000002,90.64689939999997,90.77874999999997,90.19131427653329,90.19874246780282,89.93730846153855,92.00682463120351,87.86779229187358,96.53032510000031,89.41244960000002,90.64689939999997,90.77874999999997,88.01666333333333,22213008,34219119.6,38.333768568112085,NaN,1.5,2.75,NaN,NaN,1.7171404854074523,0.6491402543272913,NaN,-0.38294449635859934,-0.5630327995481537,-0.18008830318955432,24.765944235035704,-2.1938661293933377,NaN,NaN,NaN,-550047392
1041258600,87.797,88.47,87.22,88.11,NaN,NaN,76.46002999999999,95.75143128571428,96.38762515000032,89.41254950000003,90.64369939999995,90.48524999999998,90.1096941088261,89.99981461372636,89.73807769230777,91.96799772965399,87.50815765496155,96.38762515000032,89.41254950000003,90.64369939999995,90.48524999999998,87.93333333333334,29972192,34748444.4,41.719318572482685,NaN,1.5,2.75,NaN,NaN,1.6837733078783486,0.8625477346548498,NaN,-0.3772365669807716,-0.6516340119155188,-0.2743974449347472,24.340132323350826,-3.862509968631751,NaN,NaN,NaN,-520075200
1041345000,87.99001,88.42999,87.11,88.23,NaN,NaN,87.11,95.73571714285714,96.24542515000032,89.38534950000002,90.63549939999993,90.19024999999996,90.03598061436233,89.83126084099051,89.54192384615392,91.81884956604603,87.26499812626182,96.24542515000032,89.38534950000002,90.63549939999993,90.19024999999996,87.92333,34037504,33960599.6,42.280300608187936,NaN,1.5,2.75,NaN,NaN,1.6577887858870384,1.002264518321402,NaN,-0.34372383444699756,-0.7040522379934941,-0.3603284035464966,17.592327364117917,-2.8838852081579227,NaN,NaN,NaN,-486037696
1041517800,88.85001,91.3,88.53999,91.07001,NaN,NaN,87.28928553571428,95.72000299999999,96.11352520000031,89.38314970000002,90.65349959999995,90.10025049999997,90.07653078634812,89.94923695137237,89.5650015384616,91.89667130005468,87.23333177686852,96.11352520000031,89.38314970000002,90.65349959999995,90.10025049999997,90.30333333333333,44641392,34471004.4,53.65101744965707,NaN,1.5,2.75,NaN,NaN,1.7586610154665352,1.2950418120105605,NaN,-0.12017228287261905,-0.5105437571372704,-0.39037147426465135,26.46447763790225,1.4142650334075715,NaN,NaN,NaN,-441396304
1041604200,90.91,91.38699,90.5,91.35001,NaN,NaN,87.46857107142857,95.70428885714286,95.9940752000003,89.3904498,90.69009979999993,90.04525099999998,90.1264711476678,90.08264390838453,89.71961769230776,92.23076650085532,87.2084688837602,95.9940752000003,89.3904498,90.69009979999993,90.04525099999998,91.079,32226000,32875444.4,54.60060860415673,NaN,1.5,2.75,NaN,NaN,1.6963988000760681,0.9802453043037801,NaN,0.04767301646887512,-0.3307802036785574,-0.37845322014743255,25.37728073360509,2.456269627635712,NaN,NaN,NaN,-409170304
1041863400,91.24001,93.49001,91.17599,92.96001,NaN,NaN,87.64785660714286,95.6885747142857,95.88242530000029,89.43034990000002,90.74529999999993,90.12175199999997,90.2375903183475,90.35667877425267,89.82038846153854,92.70993809048697,86.93083883259011,95.88242530000029,89.43034990000002,90.74529999999993,90.12175199999997,92.54200333333334,41005696,33086819.6,59.711849127606314,NaN,1.5,2.75,NaN,NaN,1.7405146000706346,1.2393362824150074,NaN,0.2565728246072562,-0.05773718938836225,-0.3143100139956185,26.15058045399347,3.3003663406638126,NaN,NaN,NaN,-368164608
1041949800,92.89999,93.37,92.2,92.73,NaN,NaN,87.82714214285714,95.67286057142857,95.77087535000028,89.43544990000002,90.83269999999993,90.15675199999997,90.33533187449073,90.58270936718098,89.96500307692314,93.21223670195438,86.7177694518919,95.77087535000028,89.43544990000002,90.83269999999993,90.15675199999997,92.76666666666667,38655104,32512970,58.69516937880325,NaN,1.5,2.75,NaN,NaN,1.6997635572084466,1.1889133475040883,NaN,0.36224400940058865,0.1384949977551173,-0.2237490116454713,26.18205117589948,3.0104421239724597,NaN,NaN,NaN,-406819712
1042036200,92.2,92.39999,91.05,91.39,NaN,NaN,88.00642767857143,95.65714642857142,95.65977535000027,89.41434990000002,90.85649999999994,90.25125199999998,90.37669140882443,90.65959418935422,90.08731076923085,93.41914469181991,86.7554768466418,95.65977535000027,89.41434990000002,90.85649999999994,90.25125199999998,91.61333,38736704,32609600.4,53.03029292916783,NaN,1.5,2.75,NaN,NaN,1.698351874550701,1.1878926305395634,NaN,0.3260114387989612,0.18376528685323024,-0.14224615194573098,28.058915750149016,2.277432712215317,NaN,NaN,NaN,-445556416
1042122600,91.821,93.17999,91.41,92.81,NaN,NaN,88.18571321428571,95.64143228571429,95.55247535000028,89.41024990000001,90.92049999999996,90.35675199999997,90.47211527514504,90.86439474274906,90.36808000000006,93.94608782032097,86.79007217967916,95.55247535000028,89.41024990000001,90.92049999999996,90.35675199999997,92.46666333333333,34851200,32679705.2,57.69039358065322,NaN,1.5,2.75,NaN,NaN,1.704897454939937,1.066447808715239,NaN,0.37812942079316675,0.33041562404572744,-0.047713796747439294,28.456997233352,3.82593131222732,NaN,NaN,NaN,-410705216
1042209000,91.95,93.64,91.8,93.06,NaN,NaN,88.36499875,95.62571814285714,95.44492530000029,89.38685000000001,91.01029979999996,90.47075199999998,90.57360095062955,91.07350000534439,90.60423307692314,94.4467268046318,86.76173934921448,95.44492530000029,89.38685000000001,91.01029979999996,90.47075199999998,92.83333333333333,37771600,32607980.4,58.471587973963736,NaN,1.5,2.75,NaN,NaN,1.7145476367299417,1.1583544744770518,NaN,0.4073632066784241,0.4614902116005908,0.054127004922166724,28.387107178047337,6.500343327992684,NaN,NaN,NaN,-372933616
1042468200,93.53999,93.86,92.44,93.03,NaN,NaN,88.54428428571428,93.86,95.33747530000028,89.37325000000003,91.08229999999996,90.58375199999998,90.66993032511466,91.25983333816873,90.8357715384616,94.86762737234626,86.80391570457694,95.33747530000028,89.37325000000003,91.08229999999996,90.58375199999998,93.11000000000001,31676096,32467760.4,58.332401856441884,NaN,1.5,2.75,NaN,NaN,1.6935085198206603,0.9756169076571108,NaN,0.40192372940241383,0.5565316666751841,0.1546079372727702,23.08425627664147,5.5839291794348,NaN,NaN,NaN,-404609712
1042554600,92.69,93.83,92.41,93.33,NaN,NaN,88.72356982142857,93.78178571428572,95.2312752500003,89.34905000000002,91.17849999999994,90.78325199999998,90.7742467829533,91.45699206786695,91.14154076923083,95.27934428685207,87.00373725160959,95.2312752500003,89.34905000000002,91.17849999999994,90.78325199999998,93.19,30902800,32169230.8,59.37385872822188,NaN,1.5,2.75,NaN,NaN,1.6739721969763275,0.9606322324623316,NaN,0.3951806324764915,0.6485837278683846,0.2534030953918931,23.103679425521467,5.780346820809242,NaN,NaN,NaN,-373706912
1042641000,93.53999,93.57001,91.91,92.39999,NaN,NaN,88.90285535714285,93.70357142857142,95.1235752000003,89.30625000000002,91.22109979999993,90.82075199999997,90.83800141891591,91.54680139473676,91.3730784615385,95.42897565339992,87.31718126967708,95.1235752000003,89.30625000000002,91.22109979999993,90.82075199999997,92.62666666666667,33542000,31990715.6,54.801052783639655,NaN,1.5,2.75,NaN,NaN,1.6729748971923042,1.0484917067625708,NaN,0.3085768750220005,0.6391241891693937,0.33054731414739325,24.754472898617763,1.4603929438461754,NaN,NaN,NaN,-407248912
1042727400,92.5,92.92999,91.455,92.02,NaN,NaN,89.08214089285714,93.62535714285714,95.01797520000031,89.28044990000002,91.23889979999994,90.87925149999997,90.88435430444862,91.59186792857136,91.7300015384616,95.07117546392269,88.3888276130005,95.01797520000031,89.28044990000002,91.23889979999994,90.87925149999997,92.13499666666667,45374496,32639445.2,53.004782095676255,NaN,1.5,2.75,NaN,NaN,1.6588331188214256,1.390173629544414,NaN,0.21085559711413165,0.5941168105400578,0.3832612134259262,18.070241249582704,0.7334317752127214,NaN,NaN,NaN,-452623408
1042813800,90.99001,92.3,90.14999,90.66,NaN,NaN,89.26142642857143,93.54714285714286,94.90792520000032,89.23445000000001,91.21509959999995,90.92225149999997,90.87555609643103,91.50311860204076,91.92615538461544,94.6334952795482,89.21881548968268,94.90792520000032,89.23445000000001,91.21509959999995,90.92225149999997,91.03666333333335,35621008,32638340.4,47.0593888175253,NaN,1.5,2.75,NaN,NaN,1.6939171817627519,1.0913853940931384,NaN,0.04826625235744947,0.443594028872738,0.39532777651528855,20.14566660470754,-2.4741929352202097,NaN,NaN,NaN,-488244416
1043159400,90.87,90.92,88.95,89.25,NaN,NaN,89.44071196428571,93.46892857142858,94.79072520000032,89.18535000000001,91.13929979999993,90.92675149999997,90.81180879853177,91.28853587803688,92.00461692307698,94.30790570839633,89.70132813775763,94.79072520000032,89.18535000000001,91.13929979999993,90.92675149999997,89.70666666666666,42370304,32792495.6,41.82178132834833,NaN,1.5,2.75,NaN,NaN,1.7136373830654124,1.2920731778645111,NaN,-0.1497588296217494,0.2081292394881018,0.3578880691098512,18.046344358223156,-3.7528307990941485,NaN,NaN,NaN,-530614720
1043245800,88.77,89.8,88,88.17,NaN,NaN,89.6199975,93.39071428571428,94.66692525000032,89.14604990000002,91.08749999999995,90.83575099999997,90.70820845349131,90.991532461081,91.78153923076931,94.84123111070667,88.72184735083195,94.66692525000032,89.14604990000002,91.08749999999995,90.83575099999997,88.65666666666668,42808608,33373870.8,38.3051031334726,NaN,1.5,2.75,NaN,NaN,1.7198061414178827,1.2826983197885455,NaN,-0.33821238344378635,-0.06487741019488169,0.27333497324890466,18.58138051105314,-3.523361418098259,NaN,NaN,NaN,-573423328
1043332200,88.75,89.38,87.95,88.71001,NaN,NaN,89.79928303571428,93.3125,94.5497753000003,89.11175000000003,91.06870039999994,90.77025149999997,90.62984772982499,90.7742446076447,91.57846230769239,95.04866616169281,88.10825845369197,94.5497753000003,89.11175000000003,91.06870039999994,90.77025149999997,88.68000333333333,56080800,35045635.6,40.97755580106266,NaN,1.5,2.75,NaN,NaN,1.6991057027451764,1.6002220830031115,NaN,-0.4066315341556879,-0.23495444444570524,0.1716770897099827,18.493677257184775,-4.417616636138352,NaN,NaN,NaN,-517342528
1043418600,88.59,88.67999,86.17,86.38,NaN,NaN,89.97856857142857,93.23428571428572,94.41462530000031,89.05775000000001,91.03110059999996,90.62150149999998,90.46318703453774,90.35574512120235,91.07230769230779,95.40189665732949,86.74271872728609,94.41462530000031,89.05775000000001,91.03110059999996,90.62150149999998,87.07666333333333,68700816,37933826.4,34.11156666946387,NaN,1.5,2.75,NaN,NaN,1.759170295406235,1.8110700269351157,NaN,-0.5784599775039014,-0.5513978821698942,0.02706209533400733,18.92100699677668,-7.178164624973142,NaN,NaN,NaN,-586043344
1043677800,85.73,86.8,84.5,85.2,NaN,NaN,90.15785410714285,93.15607142857142,94.28767530000032,89.02695000000001,90.95590039999996,90.41200149999997,90.25678754298724,89.86472177632594,90.49307692307701,95.70539378939608,85.28076005675794,94.28767530000032,89.02695000000001,90.95590039999996,90.41200149999997,85.5,58287504,39973741.6,31.25535491676503,NaN,1.5,2.75,NaN,NaN,1.7978009885915038,1.4581448137444306,NaN,-0.7313864523062001,-0.8871709700487429,-0.1557845177425427,18.12060284481473,-8.41663979361496,NaN,NaN,NaN,-644330848
1043764200,85.63,86.39999,85.13,85.83,NaN,NaN,90.33713964285714,93.07785714285714,94.15972530000033,88.98985010000003,90.89150039999996,90.33450149999996,90.08318803149754,89.480462559533,90.0653846153847,95.79945685010888,84.33131238066052,94.15972530000033,88.98985010000003,90.89150039999996,90.33450149999996,85.78666333333332,46956704,41210926.4,34.412905755731956,NaN,1.5,2.75,NaN,NaN,1.7601002036921112,1.1394236456669413,NaN,-0.7472719317286902,-1.0898744324034055,-0.34260250067471526,19.887302130618007,-8.036001285760205,NaN,NaN,NaN,-597374144
1043850600,85.44,87.17999,84.77,86.48,NaN,NaN,90.51642517857142,92.99964285714286,94.03927525000034,88.96685010000002,90.80650039999995,90.25300149999997,89.94188654006626,89.19470422052986,89.57846153846162,95.37231757956113,83.78460549736212,94.03927525000034,88.96685010000002,90.80650039999995,90.25300149999997,86.14333,53780192,42401326.4,37.59761756950124,NaN,1.5,2.75,NaN,NaN,1.8065209034283893,1.268361076553492,NaN,-0.6734504899252216,-1.1844156130812422,-0.5109651231560206,20.91045968200405,-6.40691627780479,NaN,NaN,NaN,-543593952
1043937000,86.78999,86.88,84.39999,84.42999,NaN,NaN,90.69571071428571,92.92142857142858,93.89542520000033,88.91115000000002,90.66710039999994,90.06300099999997,89.72573373457347,88.74092191381273,88.9146146153847,94.93394601116455,82.89528321960486,93.89542520000033,88.91115000000002,90.66710039999994,90.06300099999997,85.23666,49883392,43193620.8,32.274789134313025,NaN,1.5,2.75,NaN,NaN,1.8546272674692184,1.1548786852340012,NaN,-0.7180457303654226,-1.4085222861127988,-0.6904765557473762,22.93062287280036,-8.248217778743744,NaN,NaN,NaN,-593477344
1044023400,84.14999,86.215,84.14999,86.06,NaN,NaN,90.87499625,92.84321428571428,93.76092515000035,88.86515000000001,90.57870039999996,89.81250049999997,89.58197947047255,88.48559601725914,88.37846076923087,94.06868381205389,82.68823772640785,93.76092515000035,88.86515000000001,90.57870039999996,89.81250049999997,85.47499666666667,55321600,43727631.2,39.59726153381047,NaN,1.5,2.75,NaN,NaN,1.8696546055071315,1.2651405640285402,NaN,-0.5980376462620862,-1.438023613574984,-0.8399859673128978,28.043049833702486,-5.073902492830349,NaN,NaN,NaN,-538155744
1044282600,86.14,86.817,85.92,86.23,NaN,NaN,91.05428178571428,92.765,93.62972515000034,88.81045,90.49610039999996,89.55649999999999,89.4505292951599,88.27077734894874,87.83230692307703,92.8384884870073,82.82612535914676,93.62972515000034,88.81045,90.49610039999996,89.55649999999999,86.32233333333333,39799200,44106291.2,40.32197306163259,NaN,1.5,2.75,NaN,NaN,1.8001792765423357,0.9023474637559187,NaN,-0.4729617878878465,-1.4311882021727058,-0.9582264142848593,27.909906753073237,-3.3837535014005558,NaN,NaN,NaN,-498356544
1044369000,85.31,85.75,84.3,85.38,NaN,NaN,91.23356732142857,92.68678571428572,93.49222515000034,88.75295,90.35630039999997,89.17749949999998,89.2909006953497,87.99546522047743,87.29230769230782,91.68847092752343,82.8961444570922,93.49222515000034,88.75295,90.35630039999997,89.17749949999998,85.14333333333333,43757296,44243871.2,37.87507048407024,NaN,1.5,2.75,NaN,NaN,1.8094521853607408,0.9890024270751425,NaN,-0.4152822714628366,-1.477329253613405,-1.0620469821505685,27.29438132250996,-3.164341612793474,NaN,NaN,NaN,-542113840
1044455400,85.754,86.53999,84.489,84.85001,NaN,NaN,91.41285285714285,92.60857142857142,93.36147520000033,88.7069501,90.17150059999996,88.78349999999998,89.11674811906148,87.69589805662244,86.74077000000013,90.35567674814446,83.12586325185579,93.36147520000033,88.7069501,90.17150059999996,88.78349999999998,85.293,55297904,45076011.2,36.39215595196461,NaN,1.5,2.75,NaN,NaN,1.8267048864064022,1.2267701273443643,NaN,-0.3815003291514423,-1.5389223935898713,-1.157422064438429,26.888484615525797,-4.351256414016862,NaN,NaN,NaN,-597411744
1044541800,84.37,84.89,83.64999,84.45,NaN,NaN,91.59213839285714,92.53035714285714,93.23112520000033,88.6547501,89.99210059999996,88.43649999999998,88.93373838890221,87.38676490837268,86.26307769230782,89.27026570986202,83.25588967475362,93.23112520000033,88.6547501,89.99210059999996,88.43649999999998,84.32999666666667,53655904,45821971.2,35.269742615180874,NaN,1.5,2.75,NaN,NaN,1.7847981088059446,1.170964552480885,NaN,-0.35530329219674806,-1.601551179684364,-1.246247887487616,26.132403046863455,-2.2343134984950135,NaN,NaN,NaN,-651067648
1044628200,84.91,84.99001,82.97,83.42,NaN,NaN,91.77142392857142,92.45214285714286,93.10117520000033,88.59005010000001,89.79090059999997,87.96699999999998,88.7175133540433,87.00897777424196,85.81461615384629,88.63962476568173,82.98960754201084,93.10117520000033,88.59005010000001,89.79090059999997,87.96699999999998,83.79333666666668,43168192,46237820.8,32.49093604912311,NaN,1.5,2.75,NaN,NaN,1.8015989581769485,0.9336121653899399,NaN,-0.3746283008964242,-1.7145332636081463,-1.339904962711722,22.875998793502607,-2.0892018779342734,NaN,NaN,NaN,-694235840
1044887400,83.466,84.13,82.64999,84.00999,NaN,NaN,91.95070946428572,92.37392857142858,92.97387515000031,88.55185000000002,89.63710039999997,87.51449949999999,88.53290459506121,86.72335989098082,85.49461538461551,88.11493982004694,82.87429094918409,92.97387515000031,88.55185000000002,89.63710039999997,87.51449949999999,83.59666,45470400,46622760.8,35.619894659088246,NaN,1.5,2.75,NaN,NaN,1.778628318307166,0.9752832998255222,NaN,-0.31723476612934753,-1.7364484203734065,-1.419213654244059,22.572992064275216,-2.1204823488290767,NaN,NaN,NaN,-648765440
1044973800,84.37,84.707,82.834,83.42999,NaN,NaN,92.12999500000001,92.29571428571428,92.85407510000032,88.5166499,89.42010019999996,87.034499,88.33279029721568,86.40970561564932,85.08846000000014,87.17093134025951,83.00598865974077,92.85407510000032,88.5166499,89.42010019999996,87.034499,83.65699666666667,46468704,47362391.2,33.95382021414788,NaN,1.5,2.75,NaN,NaN,1.7853691527137965,0.9811308682404531,NaN,-0.2887071848213183,-1.7800976352707067,-1.4913904504493884,22.025238391586342,-3.5268385753931546,NaN,NaN,NaN,-695234144
1045060200,83.16,83.62,82.09,82.10001,NaN,NaN,92.3092805357143,92.2175,92.73027515000031,88.49065,89.18250039999997,86.47299949999999,88.08836754046213,85.9992584141589,84.75923000000012,87.23669080263636,82.28176919736387,92.73027515000031,88.49065,89.18250039999997,86.47299949999999,82.60333666666666,35906304,47612566.4,30.438050610339232,NaN,1.5,2.75,NaN,NaN,1.7671284989485254,0.7541350260001948,NaN,-0.3269716363030386,-1.9001049958281868,-1.5731333595251482,22.12120767001771,-2.7596592158781568,NaN,NaN,NaN,-731140448
1045146600,82.14999,82.66,81,82.35001,NaN,NaN,81,92.13928571428572,92.6027252000003,88.47065,88.94690059999998,85.9705005,87.8633339114244,85.65171094614377,84.54000000000012,87.30979025036142,81.77020974963882,92.6027252000003,88.47065,88.94690059999998,85.9705005,82.00333666666667,58064496,48838691.2,31.866201020814643,NaN,1.5,2.75,NaN,NaN,1.7594764633093447,1.1889036043619448,NaN,-0.3035182872076656,-1.9525312185347303,-1.6490129313270647,18.935126493491314,-4.310934231931216,NaN,NaN,NaN,-673075952
1045233000,82.37,84.2,81.82899,84.14999,NaN,NaN,80.79633333333334,92.06107142857142,92.4775752000003,88.4755499,88.77250039999997,85.577,87.71771258156463,85.50868990365389,84.4107684615386,87.0827913842815,81.73874553879568,92.4775752000003,88.4755499,88.77250039999997,85.577,83.39299333333334,59588304,49549381.6,41.22290104375447,NaN,1.5,2.75,NaN,NaN,1.8031574302158198,1.2026043933512987,NaN,-0.14300299756135892,-1.8277666782787634,-1.6847636807174045,20.001127309237763,-2.4121651397425508,NaN,NaN,NaN,-613487648
1045578600,84.53,85.8,84.39,85.63,NaN,NaN,80.59266666666667,91.98285714285714,92.36192525000031,88.5087499,88.63610039999998,85.3255,87.63584149993464,85.52024324616305,84.345383846154,86.8478918549282,81.84287583737978,92.36192525000031,88.5087499,88.63610039999998,85.3255,85.27333333333333,39512896,49743976,47.595418214640496,NaN,1.5,2.75,NaN,NaN,1.7922183280575463,0.7943252465383949,NaN,0.07491177923524939,-1.5911239566733428,-1.6660357359085922,22.938640312598636,0.29280862028578125,NaN,NaN,NaN,-573974752
1045665000,85.32001,85.47,84.28,85.17999,NaN,NaN,80.389,91.90464285714286,92.2499252000003,88.5170497,88.51110039999998,85.1219995,87.53953359797642,85.4878381750999,84.4030761538463,86.94499642043037,81.86115588726223,92.2499252000003,88.5170497,88.51110039999998,85.1219995,84.97666333333333,31440304,49197476,45.96364598906997,NaN,1.5,2.75,NaN,NaN,1.760631304624864,0.6390633535752932,NaN,0.19403988325869825,-1.4234858818352194,-1.6175257650939177,22.40702724809929,0.38889800955828546,NaN,NaN,NaN,-605415056
1045751400,85.21001,85.42,84.05,84.33,NaN,NaN,80.18533333333333,91.82642857142858,92.1442252000003,88.5030497,88.35710039999998,84.9299995,87.41366953531067,85.37756787270943,84.26999923076937,86.62529676224614,81.9147016992926,92.1442252000003,88.5030497,88.35710039999998,84.9299995,84.60000000000001,29299296,48522010.4,42.9671914608504,NaN,1.5,2.75,NaN,NaN,1.7327290685802315,0.6038351617846404,NaN,0.21903747722308387,-1.3437289185650627,-1.5627663957881466,22.879145996703844,-0.14209591474245653,NaN,NaN,NaN,-634714352
1045837800,84.38,85.74001,83.46001,85.17999,NaN,NaN,79.98166666666667,91.74821428571428,92.04462510000032,88.52734960000002,88.27070019999998,84.7534985,87.32607425941613,85.3587509324514,84.18922923076937,86.33261310304641,82.04584535849233,92.04462510000032,88.52734960000002,88.27070019999998,84.7534985,84.79333666666668,60965200,48766230.4,46.70859919795619,NaN,1.5,2.75,NaN,NaN,1.7718198493959292,1.2501519904232745,NaN,0.2917149973307356,-1.198122649124727,-1.4898376464554626,23.466815619427994,2.109793814432992,NaN,NaN,NaN,-573749152
1046097000,84.92999,85,83.59,83.8,NaN,NaN,79.778,91.67,91.91857515000032,88.54744970000002,88.13270019999999,84.6244985,87.18779683747825,85.21029846269413,84.06769076923092,86.10370047736745,82.03168106109439,91.91857515000032,88.54744970000002,88.13270019999999,84.6244985,84.13,30648800,46863629.6,41.90245738890097,NaN,1.5,2.75,NaN,NaN,1.7588320030105056,0.6539997064162525,NaN,0.24749050428644592,-1.180474516097405,-1.427965020383851,24.39368713779489,-0.24995836804647253,NaN,NaN,NaN,-604397952
1046183400,82.95,84.49001,82.22,84.47,NaN,NaN,79.57433333333333,91.59178571428572,91.80217515000032,88.53494970000001,88.00650019999999,84.5879985,87.08121656934185,85.13979384719944,84.03845923076939,86.03930993747473,82.03760852406405,91.80217515000032,88.53494970000001,88.00650019999999,84.5879985,83.72667000000001,56901296,46794319.2,44.868536990290195,NaN,1.5,2.75,NaN,NaN,1.7953447170811836,1.215987260265558,NaN,0.26257390689788696,-1.0997476367614922,-1.3623215436593792,24.489492323762914,1.2465661328737965,NaN,NaN,NaN,-547496656
1046269800,84.024,84.53,83.08,83.24001,NaN,NaN,79.37066666666666,91.51357142857142,91.68977520000033,88.53584990000002,87.8559004,84.458499,86.93058101760295,84.95886205222807,83.94538307692324,85.97338669497445,81.91737945887202,91.68977520000033,88.53584990000002,87.8559004,84.458499,83.61667,37799392,46336453.6,40.7549828731273,NaN,1.5,2.75,NaN,NaN,1.7706772372896709,0.8157592794283246,NaN,0.19218827050844056,-1.1220862055238285,-1.314274476032269,25.722535414997726,1.3885503789829021,NaN,NaN,NaN,-585296048
1046356200,83.7,84.75,83.16,84.34,NaN,NaN,79.167,91.43535714285714,91.57212520000034,88.55614990000002,87.75590039999999,84.351499,86.82898960514792,84.89992280915872,84.01615230769245,86.03004124660013,82.00226336878477,91.57212520000034,88.55614990000002,87.75590039999999,84.351499,84.08333333333333,51829008,46238894.4,45.56173189109462,NaN,1.5,2.75,NaN,NaN,1.757771720340409,1.1208963508435443,NaN,0.2201778720476697,-1.0390521359726819,-1.2592300080203516,24.577270834573955,2.4165024387975254,NaN,NaN,NaN,-533467040
1046442600,84.47,85.23,84.16,84.89999,NaN,NaN,78.96333333333334,91.35714285714286,91.44552515000034,88.59714980000003,87.6209004,84.374999,86.7533425618088,84.89992920828647,84.08461384615399,86.15278907027474,82.01643862203323,91.44552515000034,88.59714980000003,87.6209004,84.374999,84.76333,43888800,45939164.8,47.88008474209979,NaN,1.5,2.75,NaN,NaN,1.7086451688875233,0.9553678259296522,NaN,0.27339653734287483,-0.917484336341758,-1.1908808736846328,24.68109534576181,0.8912657030618779,NaN,NaN,NaN,-489578240
1046701800,85.25999,85.78,83.72,84.09,NaN,NaN,78.75966666666666,91.27892857142858,91.31702520000033,88.64674980000004,87.4857002,84.276499,86.64889775546335,84.82279309321156,84.13538384615397,86.16890079850856,82.10186689379938,91.31702520000033,88.64674980000004,87.4857002,84.276499,84.53,42935392,45319854.4,44.901434436568756,NaN,1.5,2.75,NaN,NaN,1.7337419425384144,0.9473859209927206,NaN,0.2515864315697276,-0.8763978342224732,-1.1279842657922008,22.49398561702946,-1.7984351278757353,NaN,NaN,NaN,-532513632
1046788200,83.95,84.00999,82.64999,82.75,NaN,NaN,78.556,91.20071428571428,91.17897520000034,88.67054980000003,87.34470019999999,84.102499,86.4959998042687,84.6253842271914,84.18538307692322,86.04038994757474,82.3303762062717,91.17897520000034,88.67054980000003,87.34470019999999,84.102499,83.13666,31475392,44903664,40.42135883262404,NaN,1.5,2.75,NaN,NaN,1.7127610894999563,0.7009537573593103,NaN,0.1494956510556622,-0.9411147019726229,-1.0906103530282851,21.13080089773525,-2.852770938338926,NaN,NaN,NaN,-563989024
1046874600,82.61,83.53999,82.36,83.45,NaN,NaN,78.35233333333333,91.1225,91.04172525000033,88.72404970000004,87.2305002,84.005999,86.37654883155228,84.51344287222079,84.26999769230784,85.86446242531122,82.67553295930446,91.04172525000033,88.72404970000004,87.2305002,84.005999,83.11666333333334,44105200,44921059.2,43.587832214969815,NaN,1.5,2.75,NaN,NaN,1.674706011678531,0.9818379349345351,NaN,0.13228556968007554,-0.9252533909281908,-1.0575389606082664,22.127586236371183,-1.0435195066998642,NaN,NaN,NaN,-519883824
1046961000,82.87,83.52,82.47,82.75,NaN,NaN,78.14866666666667,91.04428571428572,90.90697525000033,88.74524970000004,87.08569999999997,83.90099849999999,86.23433123031494,84.34549593200929,84.1623061538463,85.95182752192007,82.37278478577254,90.90697525000033,88.74524970000004,87.08569999999997,83.90099849999999,82.91333333333334,41412400,44226784,41.22809727419015,NaN,1.5,2.75,NaN,NaN,1.630084153701493,0.9363647151011477,NaN,0.07953301209947528,-0.9581226954839224,-1.0376557075833976,21.934651364160473,-2.852770938338926,NaN,NaN,NaN,-561296224
1047047400,81.61,83.99001,81.42999,83.32001,NaN,NaN,77.945,90.96607142857142,90.78007530000032,88.73684980000003,86.95170019999998,83.84449899999998,86.12004412324376,84.24783060515126,83.98461461538476,85.60682856028762,82.36240067048189,90.78007530000032,88.73684980000003,86.95170019999998,83.84449899999998,82.91333666666667,63582704,44723124,43.89184480694975,NaN,1.5,2.75,NaN,NaN,1.6965081427228146,1.4216963913343799,NaN,0.08813629464621076,-0.9274853392756341,-1.015621633921845,21.374847179208903,-0.5727804295942731,NaN,NaN,NaN,-497713520
1047306600,82.60001,82.86,81.10001,81.32001,NaN,NaN,77.74133333333333,90.88785714285714,90.64197535000032,88.70374990000003,86.79100039999999,83.73949949999998,85.93180749095968,83.9689905475178,83.6876930769232,85.69366209394232,81.68172405990407,90.64197535000032,88.70374990000003,86.79100039999999,83.73949949999998,81.76000666666667,41027504,44616089.6,37.474045987909946,NaN,1.5,2.75,NaN,NaN,1.7339004182426134,0.9195674557727264,NaN,-0.029467683794411892,-1.0524562386648597,-1.0229885548704478,23.660690714980575,-3.7291227654788712,NaN,NaN,NaN,-538741024
1047393000,81.48,82,80.48,80.52,NaN,NaN,77.53766666666667,90.80964285714286,90.49407530000033,88.62194990000003,86.6136004,83.56499999999997,85.71957974621617,83.64051525727801,83.39461615384629,85.97160373241155,80.81762857528102,90.49407530000033,88.62194990000003,86.6136004,83.56499999999997,81,48114496,44748294.4,35.25352483836956,NaN,1.5,2.75,NaN,NaN,1.7186218169395693,1.0752252492555336,NaN,-0.14336321228311433,-1.2021925702243408,-1.0588293579412265,22.83819724176039,-3.2676713998472633,NaN,NaN,NaN,-586855520
1047479400,80.38,81.10001,79.383,81.06,NaN,NaN,79.383,90.73142857142858,90.35592530000035,88.56704990000004,86.4872004,83.44650049999997,85.5368511287175,83.39475189944201,83.07769384615396,85.71120377439965,80.44418391790828,90.35592530000035,88.56704990000004,86.4872004,83.44650049999997,80.51433666666667,62475392,45548628.8,37.927200299686184,NaN,1.5,2.75,NaN,NaN,1.7185066871581716,1.3716195996661924,NaN,-0.16312070292725145,-1.2627302366002908,-1.0996095336730394,22.745638366722027,-3.8890206307801765,NaN,NaN,NaN,-524380128
1047565800,82.17999,83.91,81.53,83.86,NaN,NaN,79.29316666666666,90.65321428571428,90.23472525000035,88.52294990000004,86.4022004,83.53449999999995,85.47109226092466,83.4390612423523,83.08230923076934,85.72107159086434,80.44354687067434,90.23472525000035,88.52294990000004,86.4022004,83.53449999999995,83.10000000000001,72161184,47361372.8,49.55852745704753,NaN,1.5,2.75,NaN,NaN,1.7993276380754446,1.5236294839832007,NaN,0.021761130405804074,-1.0724081206657843,-1.0941692510715884,29.998346291862585,-1.2249589193120083,NaN,NaN,NaN,-452218944
1047652200,84.2,84.77,83.35001,84.13,NaN,NaN,79.20333333333333,90.575,90.11887525000037,88.47784990000004,86.32020040000002,83.62349949999995,85.41850040755507,83.50486493355683,83.05615538461551,85.645663508188,80.46664726104302,90.11887525000037,88.47784990000004,86.32020040000002,83.62349949999995,84.08333666666665,63963808,47656338.4,50.521328134336244,NaN,1.5,2.75,NaN,NaN,1.772232092498627,1.3421888912892226,NaN,0.16370682880247855,-0.8895357150684902,-1.0532425438709687,29.763176152388095,0.04756808181709126,NaN,NaN,NaN,-388255136
1047911400,83.46001,86.95,83.22,86.78,NaN,NaN,79.11349999999999,90.49678571428572,90.01777525000035,88.44394990000005,86.2344002,83.75499999999995,85.47189254843526,83.81678255893237,83.32846230769243,86.59424281103107,80.0626818043538,90.01777525000035,88.44394990000005,86.2344002,83.75499999999995,85.65000000000002,88287008,49091273.6,58.827846140401896,NaN,1.5,2.75,NaN,NaN,1.9120726573201539,1.798425698208001,NaN,0.422812880476809,-0.5247264432749574,-0.9475393237517664,34.20820558940739,4.870090634441089,NaN,NaN,NaN,-299968128
1047997800,87.15401,87.35001,86.28,87.28999,NaN,NaN,79.02366666666666,90.41857142857143,89.91812520000036,88.42164980000003,86.1531998,83.83799949999995,85.54319048771231,84.14756421998644,83.55538461538474,87.42492531869763,79.68584391207185,89.91812520000036,88.42164980000003,86.1531998,83.83799949999995,86.97333333333334,51081008,49669679.2,60.21221311498976,NaN,1.5,2.75,NaN,NaN,1.8519253246544285,1.028414292637509,NaN,0.6042358896038399,-0.19224446174696652,-0.7964803513508064,31.94701432085647,4.601545835829838,NaN,NaN,NaN,-248887120
1048084200,87.28,88.16,86.67999,87.96001,NaN,NaN,78.93383333333333,90.34035714285714,89.83607525000036,88.39924990000003,86.0531998,83.97700049999995,85.6379677234883,84.51065429427344,83.79077076923089,88.28130258208824,79.30023895637353,89.83607525000036,88.39924990000003,86.0531998,83.97700049999995,87.6,49659200,50580624,62.0190710816405,NaN,1.5,2.75,NaN,NaN,1.8253599443219688,0.9817830638072002,NaN,0.7362937436310726,0.12388682818803431,-0.6124069154430383,31.92274089063856,6.296084592145012,NaN,NaN,NaN,-199227920
1048170600,87.33,88.59,86.35001,88.14999,NaN,NaN,78.844,90.26214285714286,89.75367520000036,88.39714980000002,85.96159960000001,84.16799999999996,85.73647840099856,84.85725769481883,84.1030776923078,89.16214839025454,79.04400699436107,89.75367520000036,88.39714980000002,85.96159960000001,84.16799999999996,87.69666666666667,67461632,52488740.8,62.53854491257249,NaN,1.5,2.75,NaN,NaN,1.8549763768704,1.2852591045582866,NaN,0.7981745901626877,0.3853113222603213,-0.4128632679023664,30.823985024691375,5.796902808821082,NaN,NaN,NaN,-131766288
1048257000,88.8,89.88,87.92999,89.67,NaN,NaN,78.75416666666666,90.18392857142858,89.67397520000036,88.39184980000002,85.92719960000001,84.39250049999995,85.89073414997901,85.31561410483609,84.6353853846155,90.41751630854765,78.85325446068336,89.67397520000036,88.39184980000002,85.92719960000001,84.39250049999995,89.15999666666666,71263632,53003662.4,66.48787394800814,NaN,1.5,2.75,NaN,NaN,1.8617644928082278,1.3445039224308395,NaN,0.8958861577844798,0.7069944293282333,-0.18889172845624647,31.441455344769487,10.268063174119144,NaN,NaN,NaN,-60502656
1048516200,88.02,88.14,86.35001,86.69,NaN,NaN,78.66433333333333,90.10571428571428,89.59012515000035,88.36264980000001,85.80479959999998,84.53700049999996,85.92207790880336,85.4465079996136,84.88461615384628,90.71995065972116,79.0492816479714,89.59012515000035,88.36264980000001,85.80479959999998,84.53700049999996,87.06000333333333,65430400,54742742.4,54.383089635839205,NaN,1.5,2.75,NaN,NaN,1.9659234576076403,1.1952342380275052,NaN,0.7217114942648821,0.7132476393748561,-0.008463854890025935,35.180641925862716,7.662692498758076,NaN,NaN,NaN,-125933056
1048602600,86.74001,88.25999,86.44,87.52,NaN,NaN,78.5745,90.0275,89.51102515000035,88.35214970000003,85.69399959999998,84.68950049999997,85.98474152022284,85.64398342822183,85.25153923076935,91.10368170236755,79.39939675917115,89.51102515000035,88.35214970000003,85.69399959999998,84.68950049999997,87.40666333333333,61177600,54956557.6,56.74517547328759,NaN,1.5,2.75,NaN,NaN,1.9554996392070947,1.113199273602246,NaN,0.627754704711789,0.7762295259997103,0.14847482128792133,33.62664695369399,7.969405378731795,NaN,NaN,NaN,-64755456
1048689000,87.56,87.85001,86.8,87.08,NaN,NaN,78.48466666666666,89.94928571428572,89.42772510000036,88.32864980000002,85.5749996,84.88149999999996,86.02769283315527,85.78074691124833,85.54076923076936,91.354005297863,79.72753316367572,89.42772510000036,88.32864980000002,85.5749996,84.88149999999996,87.24333666666666,45757808,55354478.4,55.115858242193156,NaN,1.5,2.75,NaN,NaN,1.8908218078351593,0.8266324482248215,NaN,0.5065230816448307,0.7816286733439597,0.275105591699129,34.497036194144826,3.8397328881469104,NaN,NaN,NaN,-110513264
1048775400,86.39999,87.66,85.99001,87.14999,NaN,NaN,78.39483333333332,89.87107142857143,89.35367500000037,88.31494970000001,85.45139939999999,85.02199949999996,86.07170448675703,85.91115101493897,85.98922923076935,91.30943279186509,80.66902566967362,89.35367500000037,88.31494970000001,85.45139939999999,85.02199949999996,86.93333333333334,53291392,55427597.6,55.335546443242066,NaN,1.5,2.75,NaN,NaN,1.875048107275505,0.9614595311271438,NaN,0.40594318514787464,0.7825345731339723,0.3765913879860977,30.043633512090906,3.5896707476524514,NaN,NaN,NaN,-57221872
1048861800,86.47,87.28,86.25,86.71001,NaN,NaN,78.30499999999999,89.79285714285714,89.27432505000036,88.27934980000002,85.33759979999999,85.11250049999997,86.09673607551166,85.98723282304002,86.46538384615397,90.7495045793936,82.18126311291434,89.27432505000036,88.27934980000002,85.33759979999999,85.11250049999997,86.74667,32600704,54863192.8,53.56077558232344,NaN,1.5,2.75,NaN,NaN,1.8146875281843975,0.5942181330722699,NaN,0.2901096344994117,0.7392284311103623,0.4491187966109506,30.478631804887407,-0.0806522240147548,NaN,NaN,NaN,-89822576
1049121000,85.35001,86.59,84.39999,84.74001,NaN,NaN,78.21516666666666,89.71464285714286,89.19027510000036,88.21544990000002,85.192,85.14500099999997,86.04353113137394,85.86844969703621,86.74846153846167,89.90423795792977,83.59268511899357,89.19027510000036,88.21544990000002,85.192,85.14500099999997,85.24333333333334,60785904,55755718.4,46.38693475839095,NaN,1.5,2.75,NaN,NaN,1.8500684190283685,1.0902182905063242,NaN,0.07248405453758217,0.5397238647829283,0.46723981024534617,27.987690915447835,-2.921274249200859,NaN,NaN,NaN,-150608480
1049207400,85.25,86.39,84.91,86.03999,NaN,NaN,78.12533333333333,89.63642857142858,89.11347510000036,88.15734970000001,85.0995998,85.30950049999997,86.04339226347692,85.88478686874704,86.91615307692321,89.64264203448994,84.18966411935648,89.11347510000036,88.15734970000001,85.0995998,85.30950049999997,85.77999666666666,53780096,56870953.6,51.046483912143266,NaN,1.5,2.75,NaN,NaN,1.835777103383485,0.9456513843298734,NaN,0.010982773660441203,0.48096827732089764,0.46998550366045644,29.46929858006715,-2.182832857795257,NaN,NaN,NaN,-96828384
1049293800,87.53999,88.77,87.5,88.12,NaN,NaN,78.03549999999998,89.55821428571429,89.03347510000036,88.10814980000004,85.0769998,85.54300049999996,86.12482786098762,86.09766430981875,87.22307615384628,89.48456898859996,84.9615833190926,89.03347510000036,88.10814980000004,85.0769998,85.54300049999996,88.13,50498096,57190598.4,57.42272280366402,NaN,1.5,2.75,NaN,NaN,1.8996508817132356,0.8829789757891395,NaN,0.1003158379338262,0.5953803010777392,0.495064463143913,32.60125962869313,-0.03402155802853518,NaN,NaN,NaN,-46330288
1049380200,88.87,88.99001,87.64999,87.7,NaN,NaN,77.94566666666665,89.48,88.94712510000036,88.07754990000004,85.06759979999998,85.79050049999996,86.18659931741948,86.25026770888364,87.29384538461552,89.5530262552269,85.03466451400415,88.94712510000036,88.07754990000004,85.06759979999998,85.79050049999996,88.11333333333334,49009392,57570448,55.841098983207736,NaN,1.5,2.75,NaN,NaN,1.859677247305147,0.851294261250147,NaN,0.11973252294836145,0.6447301168293649,0.5249975938810034,32.69004388510456,-2.196944351511095,NaN,NaN,NaN,-95339680
1049466600,88.42999,88.59,87.62,88.22,NaN,NaN,77.85583333333332,89.40178571428572,88.87562510000036,88.06325000000002,85.0577996,86.03549999999997,86.26634052065793,86.43786126041853,87.36538461538476,89.67781819713716,85.05295103363235,88.87562510000036,88.06325000000002,85.0577996,86.03549999999997,88.14333333333333,36261808,56204403.2,57.40537348702961,NaN,1.5,2.75,NaN,NaN,1.7961288724976365,0.6451773515139824,NaN,0.15402483058520067,0.7175286321125043,0.5635038015273036,31.079980437436433,1.7649094474564553,NaN,NaN,NaN,-59077872
1049722200,90.34,90.85001,87.97,88.05,NaN,NaN,77.76599999999999,89.32357142857143,88.80982505000037,88.06115010000002,85.0911996,86.37199949999997,86.33628795122037,86.59139828323582,87.37230692307706,89.69234541187782,85.0522684342763,88.80982505000037,88.06115010000002,85.0911996,86.37199949999997,88.95666999999999,69821184,57644087.2,56.69825102385295,NaN,1.5,2.75,NaN,NaN,1.8735489530335196,1.2112462420950607,NaN,0.15145798908220087,0.7528262878800547,0.6013682987978538,23.478608642077305,0.6055758683729446,NaN,NaN,NaN,-128899056
1049808600,88.3,88.64999,87.71001,88.19,NaN,NaN,77.67616666666666,89.24535714285715,88.75437505000036,88.05345000000001,85.15099959999999,86.75549949999997,86.40898254136859,86.74364606578479,87.37538461538476,89.69964385402668,85.05112537674285,88.75437505000036,88.05345000000001,85.15099959999999,86.75549949999997,88.18333333333334,39741392,57225432,57.16619359179159,NaN,1.5,2.75,NaN,NaN,1.8068654563882685,0.694470808014171,NaN,0.1453613774413932,0.7830700205995953,0.6377086431582021,22.929163691995154,1.2746899402847949,NaN,NaN,NaN,-89157664
1049895000,88.36,89.10001,86.77,87.03,NaN,NaN,77.58633333333333,89.16714285714286,88.69052505000036,88.03325000000002,85.17499959999999,87.05399949999997,86.43333616719727,86.77091786904337,87.17230769230784,89.08381100481886,85.26080437979682,88.69052505000036,88.03325000000002,85.17499959999999,87.05399949999997,87.63333666666664,55678000,56885562.4,52.138589922976145,NaN,1.5,2.75,NaN,NaN,1.8442329237891066,0.9787720759178079,NaN,0.054077697771859445,0.7053057653730264,0.6512280676011669,24.136604423770454,-0.13768217299852975,NaN,NaN,NaN,-144835664
1049981400,87.095,87.63,85.71001,87.50999,NaN,NaN,77.4965,89.08892857142858,88.64027500000034,88.00104990000004,85.19559939999999,87.23649899999998,86.47555788613072,86.84130569103924,87.23538384615398,89.13313010342024,85.33763758888772,88.64027500000034,88.00104990000004,85.19559939999999,87.23649899999998,86.95,42126000,55383803.2,53.94356400487984,NaN,1.5,2.75,NaN,NaN,1.849644143518456,0.7606194873955495,NaN,0.018722732009394005,0.6746314826129094,0.6559087506035154,24.346938014774693,0.9225924434791382,NaN,NaN,NaN,-102709664
1050067800,88.16,88.701,86.86,87.14999,NaN,NaN,77.40666666666665,89.01071428571429,88.58742495000035,87.95854990000004,85.2499994,87.38749849999996,86.50200620432167,86.87070419665454,87.20692153846169,89.09782585614715,85.31601722077622,88.58742495000035,87.95854990000004,85.2499994,87.38749849999996,87.57033,47735504,54572388,52.3489753824887,NaN,1.5,2.75,NaN,NaN,1.8490267046957087,0.8747189879248092,NaN,-0.0333727059924398,0.6141928681129656,0.6475655741054054,24.275728605491427,2.8439694543345047,NaN,NaN,NaN,-150445168
1050327000,87.47,89,87,88.95,NaN,NaN,77.31683333333332,88.9325,88.53502500000035,87.94324990000004,85.30779939999998,87.49599849999997,86.59800596101495,87.06873236840173,87.35076769230785,89.45378079362801,85.2477545909877,88.53502500000035,87.94324990000004,85.30779939999998,87.49599849999997,88.31666666666666,36947504,52005412.8,58.8921809030262,NaN,1.5,2.75,NaN,NaN,1.859810511503158,0.7104549701795656,NaN,0.04469303643696332,0.7034318696516095,0.6587388332146462,21.545608207283657,3.382159853807514,NaN,NaN,NaN,-113497664
1050413400,88.84,89.78,88.42,89.78,NaN,NaN,77.22699999999999,88.85428571428572,88.48912495000035,87.93744990000005,85.37879939999999,87.62049899999997,86.72279004097514,87.32694833331584,87.55307615384632,90.0152479897001,85.09090431799254,88.48912495000035,87.93744990000005,85.37879939999999,87.62049899999997,89.32666666666667,49957008,51949212.8,61.51629691501154,NaN,1.5,2.75,NaN,NaN,1.8241097606815038,0.9616509145640029,NaN,0.13824331335360607,0.8315429749066539,0.6932996615530478,20.756342396767845,1.8837948252383074,NaN,NaN,NaN,-63540656
1050499800,89.91,90.06599,88.03,88.25,NaN,NaN,77.13716666666666,88.77607142857143,88.44522495000035,87.89624990000004,85.43619939999999,87.63499849999997,86.78268062760357,87.41485801585719,87.67153692307708,90.10811440248267,85.2349594436715,88.44522495000035,87.89624990000004,85.43619939999999,87.63499849999997,88.78199666666669,51809296,52056717.6,54.597517104612955,NaN,1.5,2.75,NaN,NaN,1.8392440634899676,0.9952470764311118,NaN,0.08567016531652083,0.8003873681986988,0.714717202882178,19.90971909750949,0.6271379703534745,NaN,NaN,NaN,-115349952
1050586200,88.3,89.72,88.194,89.56,NaN,NaN,77.04733333333333,88.69785714285715,88.41817495000036,87.85094990000003,85.53039919999999,87.70549899999996,86.89159511279559,87.61915725244222,88.04230538461555,90.00192067715656,86.08269009207453,88.41817495000036,87.85094990000003,85.53039919999999,87.70549899999996,89.158,37483392,50557805.6,58.86360770221039,NaN,1.5,2.75,NaN,NaN,1.8168694875263982,0.741396734988039,NaN,0.12531256229884136,0.8713579057557297,0.7460453434568883,21.24425487832468,1.5189299478576326,NaN,NaN,NaN,-77866560
1050931800,89.86,90.16,89.06,89.64999,NaN,NaN,76.95749999999998,88.61964285714286,88.38887495000037,87.81324980000004,85.63439899999999,87.70449849999996,86.99976746131341,87.81256989506677,88.31999769230787,90.07877462750132,86.56122075711441,88.38887495000037,87.81324980000004,85.63439899999999,87.70449849999996,89.62333000000001,32082800,48598764,59.147579949895196,NaN,1.5,2.75,NaN,NaN,1.765664524131655,0.6601567068660429,NaN,0.1425319557197866,0.9242102881066216,0.781678332386835,21.108516190579305,1.8171379897785411,NaN,NaN,NaN,-45783760
1051018200,89.10001,91.56,88.89,91.34,NaN,NaN,76.86766666666665,88.54142857142858,88.34902495000037,87.79184980000004,85.792799,87.93699849999994,87.16997265890896,88.14851561934613,88.56769000000017,90.94295086865516,86.19242913134518,88.34902495000037,87.79184980000004,85.792799,87.93699849999994,90.59666666666665,59860608,48320274.4,64.15241033438372,NaN,1.5,2.75,NaN,NaN,1.8302599152651085,1.2388300510147765,NaN,0.2465790551605982,1.0899021513375828,0.8433230961769846,23.061558666179717,3.5718335412178317,NaN,NaN,NaN,14076848
1051104600,91.62,92.35001,91.24001,92.17999,NaN,NaN,76.77783333333332,88.46321428571429,88.31957485000038,87.79664970000003,85.956199,88.16999799999995,87.36644392718704,88.53246556036078,88.91230461538478,91.90398610574007,85.9206231250295,88.31957485000038,87.79664970000003,85.956199,88.16999799999995,91.92333666666666,44250608,47473924.8,66.35846801950993,NaN,1.5,2.75,NaN,NaN,1.7788127784604577,0.932103427016424,NaN,0.3447854635772869,1.2743049256485932,0.9295194620713063,23.219653843457923,5.917488222452031,NaN,NaN,NaN,58327456
1051191000,91.53,92.08,90.96001,91.36,NaN,NaN,76.68799999999999,88.385,88.29837480000039,87.76744970000003,86.1147992,88.38399799999995,87.52305396925813,88.80175455461213,89.15384307692324,92.38072584041497,85.92696031343151,88.29837480000039,87.76744970000003,86.1147992,88.38399799999995,91.46667000000001,50017296,47686899.2,62.326223668460266,NaN,1.5,2.75,NaN,NaN,1.7388961514275683,1.0488687006094957,NaN,0.3274610164069758,1.338845732580026,1.0113847161730503,22.129615674837453,4.399509130329003,NaN,NaN,NaN,8310160
1051277400,91.3,91.47,90.02,90.23,NaN,NaN,76.59816666666666,88.30678571428572,88.28892480000039,87.72994970000003,86.27739899999999,88.53799849999996,87.62920871556173,88.93777793036335,89.32153538461556,92.52804727590161,86.1150234933295,88.28892480000039,87.72994970000003,86.27739899999999,88.53799849999996,90.57333333333334,43923696,47218514.4,57.17063698945709,NaN,1.5,2.75,NaN,NaN,1.7182607120398852,0.9302218961806219,NaN,0.21810177945224396,1.2840119404883552,1.0659101610361112,24.22952984814504,3.5341484261788225,NaN,NaN,NaN,-35613536
1051536600,90.44,92.19,90.3,91.78999,NaN,NaN,76.50833333333333,88.22857142857143,88.2835247500004,87.70654960000003,86.46619859999998,88.79199749999995,87.79237660906911,89.20941717509065,89.59845769230786,92.98310917884456,86.21380620577116,88.2835247500004,87.70654960000003,86.46619859999998,88.79199749999995,91.42666333333334,46469104,47911934.4,61.860982484941545,NaN,1.5,2.75,NaN,NaN,1.7355278040370357,0.969885782778998,NaN,0.22796149059960547,1.3508620242856182,1.1229005336860127,24.981942889260843,3.1927937043282744,NaN,NaN,NaN,10855568
1051623000,92.14,92.8,91.39999,91.78999,NaN,NaN,76.4185,88.15035714285715,88.2832246500004,87.69574950000002,86.6189986,89.14449649999996,87.94914576165463,89.45518601555821,89.96461076923093,93.18447782005197,86.7447437184099,88.2832246500004,87.69574950000002,86.6189986,89.14449649999996,91.99666,52340192,47489648.8,61.860982484941545,NaN,1.5,2.75,NaN,NaN,1.7115622466058185,1.1021389570688929,NaN,0.21195397868390953,1.3878430070408996,1.17588902835699,23.10207850364379,2.238794831811096,NaN,NaN,NaN,10855568
1051709400,91.91,92.57001,91.41,91.91,NaN,NaN,76.32866666666665,88.07214285714286,88.2810746500004,87.69034950000001,86.74459859999999,89.43799699999997,88.10447337884465,89.68897782360028,90.30307307692325,93.33950093929911,87.2666452145474,88.2810746500004,87.69034950000001,86.74459859999999,89.43799699999997,91.96333666666666,48912496,47246268.8,62.230023740431676,NaN,1.5,2.75,NaN,NaN,1.6721656575625459,1.035266852649325,NaN,0.1877482045529073,1.4105742840481241,1.2228260794952168,22.777824038191238,4.147308781869684,NaN,NaN,NaN,59768064
1051795800,91.92,92.731,90.5,91.89999,NaN,NaN,76.23883333333332,87.99392857142858,88.28777460000042,87.69504950000001,86.87899859999999,89.62699649999998,88.25331716790956,89.89955041182883,90.66845769230787,93.20054651547396,88.13636886914178,88.28777460000042,87.69504950000001,86.87899859999999,89.62699649999998,91.71033,50405808,47241654.4,62.17598199141447,NaN,1.5,2.75,NaN,NaN,1.712082396308078,1.0669780438510639,NaN,0.1509473363848799,1.4115102499763168,1.260562913591437,19.264308201041743,2.61276239392586,NaN,NaN,NaN,9362256
1051882200,91.56,93.47,91.491,93.21001,NaN,NaN,76.14899999999999,87.91571428571429,88.3001246000004,87.7068496,87.05659879999999,89.90249699999997,88.44769727897193,90.21483227736894,90.99615076923094,93.65337345959757,88.3389280788643,88.3001246000004,87.7068496,87.05659879999999,89.90249699999997,92.72367000000001,50236608,47303015.2,66.30056950758029,NaN,1.5,2.75,NaN,NaN,1.7311479394289295,1.0620170360725758,NaN,0.19207846085798108,1.5006609896639134,1.3085825288059323,19.149269106261347,3.971021078753042,NaN,NaN,NaN,59598864
1052141400,93.47,93.78,92.5,93.03,NaN,NaN,76.05916666666666,87.8375,88.3262746000004,87.7421496,87.21359899999999,90.14299699999997,88.6273954248946,90.4829434890481,91.24615076923094,94.00813029264188,88.48417124582,88.3262746000004,87.7421496,87.21359899999999,90.14299699999997,93.10333333333334,35453296,47262589.6,65.24768351462706,NaN,1.5,2.75,NaN,NaN,1.6989230866125775,0.7501344361376254,NaN,0.18437166773010993,1.5390471134685697,1.3546754457384598,19.3891998346726,1.8502299102255284,NaN,NaN,NaN,24145568
1052227800,93.03999,94.38,93,93.91,NaN,NaN,75.96933333333332,87.75928571428572,88.3722745500004,87.7742496,87.41579899999999,90.43599699999997,88.83455638862422,90.80932982342446,91.68153538461556,94.18983678684533,89.17323398238578,88.3722745500004,87.7742496,87.41579899999999,90.43599699999997,93.76333333333332,44584096,46000735.2,67.92899564848639,NaN,1.5,2.75,NaN,NaN,1.6761428661402502,0.9692039878527854,NaN,0.21368535832632896,1.6217821436463709,1.408096785320042,17.403394475123513,1.8767739072221563,NaN,NaN,NaN,68729664
1052314200,93.42,94.14,92.972,93.39,NaN,NaN,75.87949999999998,87.68107142857143,88.4282245500004,87.80034959999999,87.59419899999999,90.69599699999998,89.01320123612915,91.05510793547927,91.97615076923096,94.31230038147856,89.64000115698335,88.4282245500004,87.80034959999999,87.59419899999999,90.69599699999998,93.50066666666667,41442000,46085765.6,64.74986876032492,NaN,1.5,2.75,NaN,NaN,1.6398469471302328,0.8992364444955646,NaN,0.17483433731475673,1.6266397069634877,1.451805369648731,17.47684381951679,2.22197898423818,NaN,NaN,NaN,27287664
1052400600,92.52,93.33701,92.28,92.45,NaN,NaN,75.78966666666665,87.60285714285715,88.4907245500004,87.8171496,87.77839879999998,90.96699699999998,89.14797765824173,91.18795479876695,92.19153615384633,94.108874992607,90.27419731508566,88.4907245500004,87.8171496,87.77839879999998,90.96699699999998,92.68900333333333,40754800,45339605.6,59.34316508479674,NaN,1.5,2.75,NaN,NaN,1.6020007366209303,0.8988785733945599,NaN,0.06809372873352149,1.5369225305656329,1.4688288018321114,17.74051415832995,2.46037903136429,NaN,NaN,NaN,-13467136
1052487000,92.83,93.8,92.61,93.73,NaN,NaN,75.69983333333332,87.52464285714287,88.53577455000038,87.86104959999999,87.96619879999997,91.27799749999998,89.32766480889892,91.43005434174152,92.37538230769249,94.38688588618302,90.36387872920196,88.53577455000038,87.86104959999999,87.96619879999997,91.27799749999998,93.38,33639696,44915290.4,63.77850442964247,NaN,1.5,2.75,NaN,NaN,1.5840006840051493,0.7489586664233168,NaN,0.0659167752793044,1.551224770931242,1.4853079956519375,16.717399951693555,2.1135311159746295,NaN,NaN,NaN,20172560
1052746200,93.5,95.12,93.28,94.88,NaN,NaN,75.60999999999999,87.44642857142858,88.5901745500004,87.89334969999999,88.16579899999996,91.66449799999998,89.54540344384405,91.758620594909,92.58307538461555,94.98974143773486,90.17640933149625,88.5901745500004,87.89334969999999,88.16579899999996,91.66449799999998,94.42666666666666,35680704,44312550.4,67.23672829968534,NaN,1.5,2.75,NaN,NaN,1.602286349433353,0.8052053803700724,NaN,0.12094588066063272,1.6364903464777285,1.5155444658170958,15.471064342961046,3.3663910411146056,NaN,NaN,NaN,55853264
1052832600,94.534,95.189,94.25999,94.71001,NaN,NaN,75.52016666666665,87.36821428571429,88.63572455000039,87.93194969999999,88.37819919999997,91.95249849999998,89.74793703428153,92.03970530015576,92.84076846153864,95.38204602780027,90.29949089527702,88.63572455000039,87.93194969999999,88.37819919999997,91.95249849999998,94.71966666666667,39295904,44429970.4,66.23013831515277,NaN,1.5,2.75,NaN,NaN,1.5541951816166844,0.8844458739499859,NaN,0.12443158062964521,1.6710839416041523,1.546652360974507,15.644310803530612,3.046469372211947,NaN,NaN,NaN,16557360
1052919000,95.09,95.24001,93.91,94.50999,NaN,NaN,75.43033333333332,87.29,88.65942450000038,87.9790496,88.61339899999996,92.18899799999998,89.93468420940775,92.27497050966474,93.16999846153864,95.35736677145972,90.98263015161756,88.65942450000038,87.9790496,88.61339899999996,92.18899799999998,94.55333333333334,32232096,43543724.8,64.99710509177575,NaN,1.5,2.75,NaN,NaN,1.53818195435835,0.7402236751229881,NaN,0.09322809730907555,1.6631874826108515,1.569959385301776,15.910556809752494,2.8400438346075982,NaN,NaN,NaN,-15674736
1053005400,94.89,95.33,94.25,95.11,NaN,NaN,75.34049999999999,87.21178571428572,88.6802745000004,88.03854960000001,88.84659899999996,92.53199799999997,90.13763776982313,92.54497331826809,93.42538384615402,95.68276053910232,91.16800715320572,88.6802745000004,88.03854960000001,88.84659899999996,92.53199799999997,94.89666666666666,43932096,43149864.8,66.98287152473222,NaN,1.5,2.75,NaN,NaN,1.505454671904182,1.0181282422001934,NaN,0.09276140399288924,1.6859111402928875,1.5931497362999982,15.910318029984966,2.0383969489972187,NaN,NaN,NaN,28257360
1053091800,94.89,95.45,94.25999,94.87,NaN,NaN,75.25066666666665,87.13357142857143,88.6988245000004,88.08734950000002,89.08899899999994,92.79749799999998,90.32322060237908,92.76640443081399,93.66230769230786,95.82804515559317,91.49657022902255,88.6988245000004,88.08734950000002,89.08899899999994,92.79749799999998,94.85999666666667,38905904,43220990.4,65.38500751216156,NaN,1.5,2.75,NaN,NaN,1.4829229096253118,0.9001622507937718,NaN,0.05776550222881904,1.665356614086022,1.607591111857203,14.628568421176045,1.9778566053961124,NaN,NaN,NaN,-10648544
1053351000,94.14999,94.8905,92.33,92.64999,NaN,NaN,75.16083333333331,87.05535714285715,88.7181744500004,88.11364940000001,89.27559859999994,92.94749799999997,90.41446646110931,92.75531734216504,93.71923000000017,95.73118992411116,91.70727007588917,88.7181744500004,88.11364940000001,89.27559859999994,92.94749799999997,93.29016333333334,43235296,43778615.2,52.830746033108156,NaN,1.5,2.75,NaN,NaN,1.5598927017949327,0.9875893927316366,NaN,-0.12352936724995467,1.4531794027947598,1.5767087700447144,20.689164374164957,-1.341720796507288,NaN,NaN,NaN,-53883840
1053437400,92.82001,93.03,91.597,92.46001,NaN,NaN,75.07099999999998,86.97714285714287,88.7465245500004,88.14469950000003,89.49839859999993,93.00349849999998,90.4946838547913,92.72719283338742,93.76230846153864,95.63583413203182,91.88878279104546,88.7465245500004,88.14469950000003,89.49839859999993,93.00349849999998,92.36233666666669,55450896,43558129.6,51.912160229056056,NaN,1.5,2.75,NaN,NaN,1.5508289373810094,1.2730320725249873,NaN,-0.25718449828150103,1.2552281471928382,1.5124126454743392,19.723072260152886,-0.9958132562372884,NaN,NaN,NaN,-109334736
1053523800,92.11,92.88,91.91,92.64999,NaN,NaN,74.98116666666665,86.89892857142858,88.7909245000004,88.17729940000002,89.74099839999991,93.02699849999996,90.57920566440733,92.71984018258861,93.71923000000017,95.66589688649924,91.77256311350109,88.7909245000004,88.17729940000002,89.74099839999991,93.02699849999996,92.47999666666665,49848400,43838019.2,52.796045810796876,NaN,1.5,2.75,NaN,NaN,1.5093411561395087,1.1371042969021739,NaN,-0.32913920632731575,1.1009886375651945,1.4301278438925102,19.642092319767787,0.21632233639805262,NaN,NaN,NaN,-59486336
1053610200,92.95,94.05,92.67999,93.57001,NaN,NaN,74.89133333333332,86.82071428571429,88.82582455000039,88.23919950000003,89.99119859999992,93.13749899999996,90.69649210894038,92.80080873662779,93.7607692307694,95.66951113686312,91.85202732467567,88.82582455000039,88.23919950000003,89.99119859999992,93.13749899999996,93.43333333333332,38456704,43259989.6,56.925174140187366,NaN,1.5,2.75,NaN,NaN,1.5015317878438292,0.8889670190766759,NaN,-0.311309677763532,1.0409907466880952,1.3523004244516272,19.522090581316256,-0.1706924143817429,NaN,NaN,NaN,-21029632
1053696600,93.53,93.98,93.14,93.75999,NaN,NaN,74.80149999999998,86.7425,88.8541244500004,88.29569940000003,90.18919839999991,93.31399849999997,90.81662928113879,92.89215933313943,93.74923000000015,95.6560364879415,91.8424235120588,88.8541244500004,88.29569940000003,90.18919839999991,93.31399849999997,93.62666333333333,26157696,42371689.6,57.74709846992171,NaN,1.5,2.75,NaN,NaN,1.454279517283556,0.6173389885306816,NaN,-0.2840196920181257,0.9972758094289702,1.281295501447096,17.85753002864166,-1.1804489881956088,NaN,NaN,NaN,5128064
1054042200,93.3,95.84,93.17999,95.39999,NaN,NaN,74.71166666666664,86.66428571428573,88.8763744000004,88.36739930000003,90.41459819999992,93.49449849999998,90.99636891717256,93.13100034903091,93.90384461538477,95.98688228237957,91.82080694838997,88.8763744000004,88.36739930000003,90.41459819999992,93.49449849999998,94.80666000000001,43732608,42234864.8,64.11307708873325,NaN,1.5,2.75,NaN,NaN,1.5404031231918736,1.0354622468212566,NaN,-0.1590464339198594,1.0824874590472717,1.2415338929671311,19.320347905039053,0.7285185589147395,NaN,NaN,NaN,48860672
1054128600,95.85001,96.47,95.42999,95.67,NaN,NaN,74.62183333333331,86.58607142857143,88.89827445000039,88.41339920000004,90.59239819999992,93.68849899999998,91.17964856747952,93.3728098395994,94.15153692307709,96.24988577528391,92.05318807087026,88.89827445000039,88.41339920000004,90.59239819999992,93.68849899999998,95.85666333333334,37749808,41505345.6,65.04679633289791,NaN,1.5,2.75,NaN,NaN,1.5068036143924537,0.9095167731840305,NaN,-0.06646556010719373,1.158451942833139,1.2249175029403327,19.297556254005404,1.227394056437843,NaN,NaN,NaN,86610480
1054215000,95.88,96.82001,95.08,95.42,NaN,NaN,74.53199999999998,86.50785714285715,88.92227445000039,88.45409910000004,90.75499839999992,93.86399899999998,91.3459368589509,93.56778033106612,94.28153692307708,96.46691320773505,92.09616063841912,88.92227445000039,88.45409910000004,90.75499839999992,93.86399899999998,95.77333666666668,50978400,41608640.8,63.40194182073765,NaN,1.5,2.75,NaN,NaN,1.523461213364421,1.2251878220448864,NaN,-0.03207518251360009,1.1848235247983325,1.2168987073119326,19.32935271799477,0.3259383871306932,NaN,NaN,NaN,35632080
1054301400,95.901,97.09,95.56,96.95,NaN,NaN,74.44216666666665,86.42964285714287,88.96217445000039,88.49399900000004,90.93479819999992,94.11649949999999,91.56570404095284,93.8898964900122,94.44076769230787,97.03985068676096,91.84168469785479,88.96217445000039,88.49399900000004,90.93479819999992,94.11649949999999,96.53333333333335,52537600,41715230.4,68.63012166732672,NaN,1.5,2.75,NaN,NaN,1.5339282695526768,1.2594344918205223,NaN,0.07770826639079575,1.3140340403004274,1.2363257739096316,21.007496719980466,2.192473911668597,NaN,NaN,NaN,88169680
1054560600,97.53,98.45,96.67,97.35001,NaN,NaN,74.35233333333332,86.35142857142858,88.98782450000037,88.54019910000005,91.11879859999992,94.3234995,91.79253956875861,94.21943111001104,94.64384461538481,97.67240515931587,91.61528407145374,88.98782450000037,88.54019910000005,91.11879859999992,94.3234995,97.49000333333333,50700608,41738430.4,69.84307376600316,NaN,1.5,2.75,NaN,NaN,1.5515048217274856,1.214722439586516,NaN,0.15670116719098437,1.4322022328983621,1.2755010657073778,20.83910201547497,5.072876964152932,NaN,NaN,NaN,138870288
1054647000,97.14999,97.84,96.85001,97.75,NaN,NaN,74.26249999999999,86.27321428571429,89.00907450000037,88.60379910000005,91.28039859999991,94.55949949999999,92.02616546802298,94.55567576620047,94.89307615384634,98.34081133844902,91.44534096924366,89.00907450000037,88.60379910000005,91.28039859999991,94.55949949999999,97.48000333333334,39551808,41943356,71.04856452748875,NaN,1.5,2.75,NaN,NaN,1.5113966201755227,0.9429814819777416,NaN,0.21189578055128466,1.5403707913964837,1.328475010845199,12.46036201661318,5.721381600542768,NaN,NaN,NaN,178422096
1054733400,97.66,99.35001,97.569,99.16,NaN,NaN,74.17266666666664,86.19500000000001,89.03877450000036,88.66729910000005,91.52979859999992,94.82199949999999,92.30592368496326,94.99418283608614,95.20461461538481,99.33816237710279,91.07106685366684,89.03877450000036,88.66729910000005,91.52979859999992,94.82199949999999,98.69300333333337,49432704,42185786.4,74.86311170203402,NaN,1.5,2.75,NaN,NaN,1.5306547187344137,1.171785765264293,NaN,0.3132542208430753,1.720042786899043,1.4067885660559678,12.43986592091951,7.026455156660021,NaN,NaN,NaN,227854800
1054819800,98.584,99.64999,98.27,99.64999,NaN,NaN,74.08283333333331,86.11678571428573,89.06002450000037,88.73319900000006,91.77239839999991,95.13499899999998,92.59392628555294,95.43759304217318,95.57230615384637,100.32534693155046,90.81926537614228,89.06002450000037,88.73319900000006,91.77239839999991,95.13499899999998,99.18999333333333,46407104,42434041.6,76.04433993230775,NaN,1.5,2.75,NaN,NaN,1.5198929531105276,1.0936291300614647,NaN,0.3788070179635932,1.8802973385104593,1.5014903205468662,12.127989578628734,6.497787058054184,NaN,NaN,NaN,274261904
1054906200,100.39999,101.39999,99.13,99.25999,NaN,NaN,73.99299999999998,86.03857142857143,89.08437445000035,88.79549890000006,92.0159981999999,95.47549849999999,92.85534054886459,95.8016308476805,96.08076769230792,100.88845988580451,91.27307549881132,89.08437445000035,88.79549890000006,92.0159981999999,95.47549849999999,99.92999333333334,60397600,43416181.6,73.09991003732229,NaN,1.5,2.75,NaN,NaN,1.5734713136026333,1.391131089243463,NaN,0.36145886186738907,1.9533138978811024,1.5918550360137134,13.546120014118982,5.866041581275765,NaN,NaN,NaN,213864304
1055165400,98.769,99.10001,97.77,98.25,NaN,NaN,73.90316666666665,85.96035714285715,89.09687445000036,88.84469890000005,92.23799839999991,95.70149849999999,93.06689582145813,96.03480886218712,96.52615153846176,100.96850376576126,92.08379931116227,89.09687445000036,88.84469890000005,92.23799839999991,95.70149849999999,98.37333666666666,38388800,43653636.8,65.97542215825541,NaN,1.5,2.75,NaN,NaN,1.567508362631017,0.8793952305939376,NaN,0.2526692621102131,1.9076916136514797,1.6550223515412665,16.355606931321837,2.9874321789761167,NaN,NaN,NaN,175475504
1055251800,98.46001,99.25999,98.19,99.25,NaN,NaN,73.81333333333332,85.88214285714287,89.10972450000035,88.91319900000006,92.4887981999999,95.91999849999998,93.30937049512644,96.34101754197883,97.03384461538484,101.07901442437478,92.9886748063949,89.10972450000035,88.91319900000006,92.4887981999999,95.91999849999998,98.89999666666667,30105504,43374876.8,69.17843784527462,NaN,1.5,2.75,NaN,NaN,1.5319713367288017,0.6940769915915934,NaN,0.21996584930583052,1.9299796631735546,1.710013813867724,14.762103289128477,3.7420298944287635,NaN,NaN,NaN,205581008
1055338200,99.16,100.39,98.71001,100.3,NaN,NaN,73.72349999999997,85.80392857142857,89.13822445000037,88.99599900000004,92.7999979999999,96.19949799999998,93.5835128286509,96.7180634903618,97.55153615384637,101.40925999144602,93.69381231624672,89.13822445000037,88.99599900000004,92.7999979999999,96.19949799999998,99.80000333333334,37617296,43290946.4,72.14370394236744,NaN,1.5,2.75,NaN,NaN,1.5425440983910303,0.8689414098833377,NaN,0.23935568791390072,2.0092084237601,1.7698527358461993,15.199795571436583,5.114231817229087,NaN,NaN,NaN,243198304
1055424600,100.754,100.89999,99.62,100.61,NaN,NaN,73.63366666666664,85.72571428571429,89.16497450000037,89.09549900000006,93.0913981999999,96.50449849999997,93.8590613451744,97.08872411032735,98.0784600000002,101.5750760858956,94.58184391410481,89.16497450000037,89.09549900000006,93.0913981999999,96.50449849999997,100.37666333333334,36488608,43503772,72.97051056379757,NaN,1.5,2.75,NaN,NaN,1.5237902342202425,0.8387458448430632,NaN,0.24260950865876874,2.07311462166966,1.8305051130108914,14.530996088160503,3.7751418256833382,NaN,NaN,NaN,279686912
1055511000,100.61,100.74899,98.95,99.56,NaN,NaN,73.54383333333331,85.64750000000001,89.19197450000038,89.19859900000004,93.32019819999991,96.72699849999997,94.08262756693226,97.3240837188676,98.39846076923098,101.60542943138714,95.19149210707482,89.19197450000038,89.19859900000004,93.32019819999991,96.72699849999997,99.75299666666666,48635296,43738932,65.84204321691355,NaN,1.5,2.75,NaN,NaN,1.5434473603473684,1.1119452116480577,NaN,0.14823403641637078,2.015797658531355,1.867563622114984,15.349053355792748,2.2701487139035783,NaN,NaN,NaN,231051616
1055770200,99.96001,101.7,99.8,101.66,NaN,NaN,73.45399999999998,85.56928571428573,89.23977445000038,89.33349900000005,93.59939819999991,97.06649849999997,94.37977942705257,97.7370281265945,98.85923000000022,102.08691020017655,95.6315497998239,89.23977445000038,89.33349900000005,93.59939819999991,97.06649849999997,101.05333333333333,36338608,43610567.2,71.77981289427186,NaN,1.5,2.75,NaN,NaN,1.5860582631796993,0.833252359075027,NaN,0.19830151859826084,2.11544052036281,1.9171390017645493,18.592851365563618,3.9999999999999964,NaN,NaN,NaN,267390224
1055856600,102.07001,102.179,101.23,101.66,NaN,NaN,73.36416666666665,102.179,89.28737445000039,89.46299890000004,93.8681981999999,97.51699899999997,94.6652782730505,98.11064449549026,99.33923000000021,102.21507357617175,96.46338642382868,89.28737445000039,89.46299890000004,93.8681981999999,97.51699899999997,101.68966666666665,36818192,43289712,71.77981289427186,NaN,1.5,2.75,NaN,NaN,1.5405541015240065,0.8505067439580102,NaN,0.20180936284943174,2.169400705326339,1.9675913424769074,18.759287247286,2.5211778943122227,NaN,NaN,NaN,267390224
1055943000,101.28999,102.14,101,101.57001,NaN,NaN,73.27433333333332,102.25674766355141,89.33632450000039,89.61489900000004,94.1385983999999,97.97249899999996,94.93605206626421,98.44010787687215,99.69461538461559,102.44052833506487,96.94870243416631,89.33632450000039,89.61489900000004,94.1385983999999,97.97249899999996,101.57000333333333,35550096,42294672,71.16500102021622,NaN,1.5,2.75,NaN,NaN,1.5119430942722918,0.840533672893834,NaN,0.16974772513689285,2.179775998898023,2.0100282737611304,17.675756819361176,1.9267638662081088,NaN,NaN,NaN,231840128
1056029400,101.64,101.73,99.84,100.02,NaN,NaN,73.18449999999999,102.3344953271028,89.3950245000004,89.76309900000004,94.37519839999992,98.34099949999998,95.13542257346954,98.59057379336052,99.89999923076945,102.29007172404754,97.50992673749137,89.3950245000004,89.76309900000004,94.37519839999992,98.34099949999998,100.53,43559904,41980247.2,61.40851451698017,NaN,1.5,2.75,NaN,NaN,1.538947158967128,1.037628573087583,NaN,0.023510594324039236,2.0394165166661793,2.01590592234214,20.259028301965113,0.7656760795563188,NaN,NaN,NaN,188280224
1056115800,100.39,100.5,99.42,99.44,NaN,NaN,73.09466666666664,102.4122429906542,89.44452455000038,89.89919900000004,94.62339839999991,98.63449899999998,95.3042295313727,98.67147152732619,100.02999923076945,102.10066272905095,97.95933573248794,89.44452455000038,89.89919900000004,94.62339839999991,98.63449899999998,99.78666666666668,41551696,42134996.8,58.19352311487533,NaN,1.5,2.75,NaN,NaN,1.5061652190409043,0.9861563820030954,NaN,-0.1247733448950139,1.8599392412233726,1.9847125861183865,20.43385266952925,1.2111959287531784,NaN,NaN,NaN,146728528
1056375000,99.45,99.66,97.92,98.42,NaN,NaN,73.00483333333331,102.48999065420561,89.49272455000039,90.01859900000005,94.84159859999993,98.86749949999998,95.42641660857377,98.64752185805703,99.97307615384638,102.1729313648005,97.77322094289225,89.49272455000039,90.01859900000005,94.84159859999993,98.86749949999998,98.66666666666667,34317808,42543002.4,52.94394520126478,NaN,1.5,2.75,NaN,NaN,1.522867703395125,0.8066616379665766,NaN,-0.2943622832360311,1.6167597320733478,1.9111220153093789,20.44935113485574,-0.8362720403022653,NaN,NaN,NaN,112410720
1056461400,98.22301,99.09,98.02,98.52,NaN,NaN,72.91499999999998,102.567738317757,89.53532455000038,90.15949910000005,95.06899879999993,99.02349999999998,95.54773360431598,98.63537691919446,99.88615384615406,102.21568030132437,97.55662739098375,89.53532455000038,90.15949910000005,95.06899879999993,99.02349999999998,98.54333333333334,36220896,42167416.8,53.38789408801068,NaN,1.5,2.75,NaN,NaN,1.4905200102954737,0.8589783000413723,NaN,-0.39626795523737823,1.4157870712626561,1.8120550265000344,19.474129668264585,-1.77467597208375,NaN,NaN,NaN,148631616
1056547800,98.53,99.44,97.53,97.53,NaN,NaN,72.82516666666665,102.64548598130841,89.56967455000039,90.27419910000006,95.24059879999993,99.1165,95.62546954140163,98.53010292689022,99.7530776923079,102.3881029154545,97.1180524691613,89.56967455000039,90.27419910000006,95.24059879999993,99.1165,98.16666666666669,47856800,42672766.4,48.508609370658235,NaN,1.5,2.75,NaN,NaN,1.5204828667029395,1.1214834199265789,NaN,-0.5190670821568242,1.1632211738040041,1.6822882559608283,18.692511492986835,-3.0613259119371814,NaN,NaN,NaN,100774816
1056634200,97.78,98.979,96.96001,98.8,NaN,NaN,72.73533333333332,102.72323364485982,89.60517455000037,90.39989910000006,95.42099879999995,99.2855,95.7499609319349,98.55580741004353,99.79538538461559,102.3489204045876,97.24185036464357,89.60517455000037,90.39989910000006,95.42099879999995,99.2855,98.24633666666666,33543504,41801021.6,54.2810895735911,NaN,1.5,2.75,NaN,NaN,1.5560905190813012,0.8024565600568958,NaN,-0.5031135095917769,1.0533963689711072,1.5565098785628841,20.58218674690524,-0.7633587786259594,NaN,NaN,NaN,134318320
1056720600,98.74699,99.19,97.58,97.66,NaN,NaN,72.64549999999997,102.80098130841122,89.63782455000037,90.52269910000007,95.60919879999994,99.321,95.8248644248002,98.47049241861082,99.6730776923079,102.46094783946032,96.88520754515548,89.63782455000037,90.52269910000007,95.60919879999994,99.321,98.14333333333332,54211104,41884696.8,48.97374857384797,NaN,1.5,2.75,NaN,NaN,1.5599411962897796,1.294293814728056,NaN,-0.5536826180550345,0.8644066059940911,1.4180892240491256,20.762754786538988,-3.9346842415896126,NaN,NaN,NaN,80107216
1056979800,98.22,98.67,97.47,97.63,NaN,NaN,72.55566666666664,102.87872897196262,89.67872455000037,90.65049900000005,95.77059879999993,99.33499949999998,95.89565405520018,98.39044552160026,99.46769307692328,102.42859069629539,96.50679545755118,89.67872455000037,90.65049900000005,95.77059879999993,99.33499949999998,97.92333333333333,33863696,41042851.2,48.838419495752916,NaN,1.5,2.75,NaN,NaN,1.5342311108405098,0.825081469973509,NaN,-0.5711963764785648,0.7040937534509197,1.2752901299294845,15.030920400645114,-3.964194373401536,NaN,NaN,NaN,46243520
1057066200,97.25301,98.85001,96.42999,98.53,NaN,NaN,96.42999,102.95647663551402,89.72302455000037,90.79129900000005,95.94819899999993,99.3739995,95.99896173930998,98.403736424305,99.30769307692329,102.22891916383763,96.38646699000894,89.72302455000037,90.79129900000005,95.94819899999993,99.3739995,97.93666666666667,51416400,41636080.8,53.03156385485868,NaN,1.5,2.75,NaN,NaN,1.597501745780473,1.2349000917492696,NaN,-0.5064212822955116,0.6422635270600949,1.1486848093556066,16.753653100966734,-2.993019297723802,NaN,NaN,NaN,97659920
1057152600,98.77,99.78999,98.57001,99.77,NaN,NaN,96.65137948051948,103.03422429906543,89.77242455000038,90.95479900000005,96.11679899999994,99.40449949999999,96.14684559267037,98.53385676484737,99.32384692307713,102.25278753572228,96.39490631043198,89.77242455000038,90.95479900000005,96.11679899999994,99.40449949999999,99.37666666666667,34678000,40898345.6,58.12399289191634,NaN,1.5,2.75,NaN,NaN,1.5733937639390108,0.847907158376597,NaN,-0.37061250473263296,0.6854191784398154,1.0560316831724483,19.013566189861148,-0.2499500099980004,NaN,NaN,NaN,132337920
1057239000,99.07001,99.85001,97.90401,98.74001,NaN,NaN,96.87276896103897,103.11197196261682,89.82697460000037,91.10209920000005,96.24799939999996,99.35900050000001,96.24853831452644,98.55349040629048,99.09923230769252,101.7073931414824,96.49107147390264,89.82697460000037,91.10209920000005,96.24799939999996,99.35900050000001,98.83134333333334,30868400,40121410.4,52.98510987569054,NaN,1.5,2.75,NaN,NaN,1.6000084950862241,0.7693747476035887,NaN,-0.34142126893559566,0.6292550970029538,0.9706763659385494,17.891864922082632,-0.7039320193081252,NaN,NaN,NaN,101469520
1057584600,99.653,100.89999,99.64999,100.7,NaN,NaN,97.09415844155845,103.18971962616823,89.89572460000038,91.27479930000005,96.43479939999996,99.431001,96.42310543944697,98.75791989140568,99.02538615384636,101.38153478841531,96.6692375192774,89.89572460000038,91.27479930000005,96.43479939999996,99.431001,100.41666,31426608,38672860.8,60.196796519156536,NaN,1.5,2.75,NaN,NaN,1.6400064597229227,0.8126269262190192,NaN,-0.18899438901319576,0.7344333796720548,0.9234277686852506,21.190951829527464,2.3166023166023177,NaN,NaN,NaN,132896128
1057671000,100.5,101.28999,100.17,101.14999,NaN,NaN,97.31554792207793,103.26746728971963,89.97797455000038,91.46529910000005,96.65319919999996,99.57600049999999,96.60847346142944,98.98573609222419,98.99307692307713,101.21654813325577,96.76960571289848,89.97797455000038,91.46529910000005,96.65319919999996,99.57600049999999,100.86999333333334,33158192,38411330.4,61.65120640864947,NaN,1.5,2.75,NaN,NaN,1.6028624268855711,0.8632398736181239,NaN,-0.06325017966567525,0.8443650441031565,0.9076152237688317,19.899107843633942,2.669498578968744,NaN,NaN,NaN,166054320
1057757400,100.92,101.39999,100.03,100.58,NaN,NaN,97.5369374025974,103.34521495327103,90.0591245000004,91.64759900000004,96.82899939999996,99.64250049999998,96.76421960019691,99.1375707501076,99.03615384615404,101.35709924320734,96.71520844910073,90.0591245000004,91.64759900000004,96.82899939999996,99.64250049999998,100.66999666666668,36629296,38737520,58.7241275527018,NaN,1.5,2.75,NaN,NaN,1.5862286821080305,0.9455766915383329,NaN,-0.02577045132880118,0.8754021596078303,0.9011726109366315,20.468196875445877,3.1272428996206267,NaN,NaN,NaN,129425024
1057843800,99.84,100.03999,98.63,99.3,NaN,NaN,97.7583268831169,103.42296261682243,90.13732450000039,91.79909910000003,96.97919959999996,99.5925005,96.86366196881664,99.15304020247831,99.02538461538481,101.34002530037505,96.71074393039457,90.13732450000039,91.79909910000003,96.97919959999996,99.5925005,99.32333,49815600,39347435.2,52.67584875674163,NaN,1.5,2.75,NaN,NaN,1.612212347671743,1.266044400271355,NaN,-0.09083038242975305,0.7876346328994401,0.8784650153291932,21.10486672060217,0.5060728744939271,NaN,NaN,NaN,79609424
1057930200,99.39,100.45,99.39,100.24001,NaN,NaN,97.97971636363637,103.50071028037384,90.22697455000039,91.94519920000005,97.14579979999996,99.57400100000001,96.99606777396109,99.25656113557561,99.16538538461556,101.53611045185488,96.79466031737624,90.22697455000039,91.94519920000005,97.14579979999996,99.57400100000001,100.02667000000001,40076400,39526824.8,56.240330914034836,NaN,1.5,2.75,NaN,NaN,1.5791971799809044,1.0139038539721006,NaN,-0.07486676378176393,0.7848815606019883,0.8597483243837523,20.515544883723685,2.641828793774321,NaN,NaN,NaN,119685824
1058189400,101.2,101.89999,99.91499,100.73,NaN,NaN,98.20110584415585,101.89999,90.3088745000004,92.10069930000003,97.32239999999996,99.632501,97.1424964887077,99.39688864647317,99.33538538461556,101.81123134536581,96.85953942386531,90.3088745000004,92.10069930000003,97.32239999999996,99.632501,100.84832666666667,42141504,39202135.2,58.01550900876762,NaN,1.5,2.75,NaN,NaN,1.608183095696554,1.074979813854629,NaN,-0.03750458167887183,0.8128675972851624,0.8503721789640343,18.790429959044232,3.1752535081429976,NaN,NaN,NaN,161827328
1058275800,101.38,101.46001,99.95,100.50999,NaN,NaN,98.42249532467532,101.88448944444444,90.3827744500004,92.26249920000004,97.46839959999996,99.5750005,97.27455505777799,99.50289829919001,99.56461538461556,101.87573029885657,97.25350047037456,90.3827744500004,92.26249920000004,97.46839959999996,99.5750005,100.64,63620400,40566224.8,56.89937766355483,NaN,1.5,2.75,NaN,NaN,1.6011707317182282,1.568309605186628,NaN,-0.03391384266793507,0.8079798756291154,0.8418937182970505,18.944872337535887,2.0095300923576582,NaN,NaN,NaN,98206928
1058362200,100.81,100.87,99.23,99.92,NaN,NaN,98.64388480519482,101.8689888888889,90.46862445000039,92.40989930000003,97.60619959999997,99.48800049999998,97.37829799668866,99.54262227069572,99.65076923076943,101.92465027142674,97.37688819011211,90.46862445000039,92.40989930000003,97.60619959999997,99.48800049999998,100.00666666666667,40194192,40735024.8,53.9044735658751,NaN,1.5,2.75,NaN,NaN,1.6039442508812118,0.9867231503440745,NaN,-0.07521258514955742,0.7478779868601038,0.8230905720096612,19.092184430335756,0.15034579532926298,NaN,NaN,NaN,58012736
1058448600,99.14999,99.88,98.16,98.5,NaN,NaN,98.86527428571429,101.85348833333333,90.55217450000038,92.55689930000004,97.69799959999996,99.3345,97.42228631054401,99.44332491158184,99.7153846153848,101.79909945466555,97.63166977610406,90.55217450000038,92.55689930000004,97.69799959999996,99.3345,98.84666666666665,48913600,41403200,47.433246601061384,NaN,1.5,2.75,NaN,NaN,1.6150910901039828,1.181396607025544,NaN,-0.19528011110295407,0.5789904331309685,0.7742705442339226,19.57988075812818,-0.2430726916069768,NaN,NaN,NaN,9099136
1058535000,99.02,99.8,98.46001,99.50999,NaN,NaN,99.08666376623377,101.83798777777778,90.62112445000037,92.70729920000005,97.82039939999996,99.3089995,97.50415704346385,99.44967396762166,99.85999923076942,101.5726268476129,98.14737161392594,90.62112445000037,92.70729920000005,97.82039939999996,99.3089995,99.25666666666666,35701696,41010289.6,51.85996259018633,NaN,1.5,2.75,NaN,NaN,1.5954410122394125,0.8705545936939689,NaN,-0.20290287864425616,0.5206419459286025,0.7235448245728586,19.64279109447142,-1.1817378351539234,NaN,NaN,NaN,44800832
1058794200,99.45,99.494,97.85001,98.28,NaN,NaN,99.30805324675325,101.82248722222222,90.69677450000036,92.85769910000006,97.93699939999995,99.2509995,97.53458225744566,99.33827644689579,99.84076846153864,101.61712993925921,98.06440698381807,90.69677450000036,92.85769910000006,97.93699939999995,99.2509995,98.54133666666667,35092304,40687320,46.70203223843015,NaN,1.5,2.75,NaN,NaN,1.6000509399365976,0.8624874776711762,NaN,-0.2821356858541352,0.3708752172551897,0.6530109031093249,16.789629254259683,-2.8373606364172663,NaN,NaN,NaN,9708528
1058880600,98.69,99.41,97.91,99.17,NaN,NaN,99.52944272727274,101.80698666666667,90.78107450000034,93.00599910000007,98.04579939999996,99.28849950000001,97.59871628656545,99.32225011862,99.7946146153848,101.60675106546852,97.98247816530109,90.78107450000034,93.00599910000007,98.04579939999996,99.28849950000001,98.83,50006704,41471764.8,50.53564903139491,NaN,1.5,2.75,NaN,NaN,1.5929044442268407,1.2058012057398628,NaN,-0.2661629105162594,0.32030726496400064,0.58647017548026,17.653111387590346,-1.4018691588785013,NaN,NaN,NaN,59715232
1058967000,99.21001,99.45,98.28,99.24001,NaN,NaN,99.75083220779221,101.79148611111111,90.87327455000035,93.14939930000006,98.13299959999996,99.32450000000001,97.66308074591582,99.31441772637048,99.83307615384635,101.57386640631121,98.09228590138149,90.87327455000035,93.14939930000006,98.13299959999996,99.32450000000001,98.99000333333333,37298304,41525635.2,50.83522492263574,NaN,1.5,2.75,NaN,NaN,1.5626969839249238,0.898199481365188,NaN,-0.24307764679462174,0.28262311698698284,0.5257007637816046,17.545850178907965,-0.06041289023162044,NaN,NaN,NaN,97013536
1059053400,99.99001,100.34,98.37,98.49001,NaN,NaN,99.97222168831169,101.77598555555556,90.97007460000036,93.29339940000006,98.20859959999999,99.37250050000002,97.6955093441152,99.23590270481138,99.66307692307711,101.46266772473568,97.86348612141855,90.97007460000036,93.29339940000006,98.20859959999999,99.37250050000002,99.06667,41173296,41191460,47.51525979261303,NaN,1.5,2.75,NaN,NaN,1.591790056501715,0.9995590348096426,NaN,-0.2685216801972422,0.1900486635350518,0.458570343732294,16.52587858417767,-1.7458098817029248,NaN,NaN,NaN,55840240
1059139800,98.66,100.28999,98.03999,100.23,NaN,NaN,100.19361116883117,101.760485,91.06937460000036,93.46819940000005,98.32299979999998,99.4440005,97.79490113454204,99.33057863768649,99.59230846153864,101.2162256556626,97.96839126741467,91.06937460000036,93.46819940000005,98.32299979999998,99.4440005,99.51999333333335,43325104,41680540,54.87782232544934,NaN,1.5,2.75,NaN,NaN,1.6388050524658782,1.039456398597523,NaN,-0.16353175863852404,0.25415564543413893,0.41768740407266297,18.843869671323855,-0.4963764519011218,NaN,NaN,NaN,99165344
1059399000,100.37,100.98,99.67,99.86,NaN,NaN,100.41500064935066,101.74498444444444,91.17817455000036,93.63229940000005,98.41799979999998,99.5540005,97.87588540377568,99.38099971981158,99.53692384615402,101.06882514695184,98.00502254535621,91.17817455000036,93.63229940000005,98.41799979999998,99.5540005,100.17,34416304,40690800,53.16977300889337,NaN,1.5,2.75,NaN,NaN,1.6153189772897443,0.8458006232367021,NaN,-0.11657401673302037,0.2719698831563875,0.38854389988940785,18.672405514095836,-0.6466919357966332,NaN,NaN,NaN,64749040
1059485400,100.14,100.27,98.67999,99.39999,NaN,NaN,100.63639012987014,101.7294838888889,91.27202450000037,93.79879930000004,98.50859959999998,99.6425,97.93565421147075,99.38280831792477,99.54461538461557,101.07268043331297,98.01655033591817,91.27202450000037,93.79879930000004,98.50859959999998,99.6425,99.44999333333334,53569808,41676105.6,51.042676438284495,NaN,1.5,2.75,NaN,NaN,1.6135111931976192,1.2853842082596123,NaN,-0.1139298553442658,0.2461315807090756,0.3600614360533414,18.786699890708352,-0.5204263410728575,NaN,NaN,NaN,11179232
1059571800,99.60001,99.78999,98.92999,99.16,NaN,NaN,100.85777961038961,101.71398333333333,91.34702450000037,93.95719920000005,98.63879979999997,99.67399999999999,97.98366777180523,99.36158847812241,99.46153769230789,100.94615882107384,97.97691656354193,91.34702450000037,93.95719920000005,98.63879979999997,99.67399999999999,99.29332666666669,28417600,40526165.6,49.92062448261066,NaN,1.5,2.75,NaN,NaN,1.5596889651120749,0.7012161051821789,NaN,-0.12489836745681837,0.20393847673231846,0.32883684418913683,18.56867261266541,0.6700507614213164,NaN,NaN,NaN,-17238368
1059658200,99.98,100.94,99.05,99.39,NaN,NaN,101.07916909090909,101.69848277777778,91.42082450000036,94.13789910000006,98.7773996,99.655,98.03881805526385,99.36429433734885,99.35846076923097,100.65000994043805,98.06691159802389,91.42082450000036,94.13789910000006,98.7773996,99.655,99.79333333333334,59112000,41747865.6,51.03162583335743,NaN,1.5,2.75,NaN,NaN,1.5832826104612125,1.4159286744470116,NaN,-0.11354571960772236,0.1869046946794839,0.30045041428720626,16.466676201747063,-0.12058085826357873,NaN,NaN,NaN,41873632
1059744600,99.19,99.53,98.24001,98.50999,NaN,NaN,101.30055857142858,101.68298222222222,91.46987445000035,94.31779900000005,98.89459959999998,99.64349899999999,98.05729538642997,99.2829320195061,99.20461461538481,100.38229334519058,98.02693588557905,91.46987445000035,94.31779900000005,98.89459959999998,99.64349899999999,98.76,49324496,42670670.4,46.75746288912529,NaN,1.5,2.75,NaN,NaN,1.562333138285412,1.1559344050052704,NaN,-0.1593771770382953,0.10122894298933716,0.26060612002763245,16.163699216791752,0.23401505901505984,NaN,NaN,NaN,-7450864
1060003800,98.31,99,97,98.50999,NaN,NaN,101.52194805194806,101.66748166666667,91.52967440000035,94.49229890000007,98.99339919999997,99.5339985,98.07504811637389,99.20931849383886,99.0961523076925,100.24978303635832,97.94252157902669,91.52967440000035,94.49229890000007,98.99339919999997,99.5339985,98.16999666666668,55544400,43876560,46.757462889125286,NaN,1.5,2.75,NaN,NaN,1.5935950569793111,1.2659242201302927,NaN,-0.18212452792522602,0.03295046012109992,0.21507498804632594,14.433532884126524,-0.6655339316325499,NaN,NaN,NaN,-7450864
1060090200,98.411,98.75999,96.34,96.42,NaN,NaN,96.34,101.65198111111111,91.57042440000033,94.61789890000006,99.04659939999998,99.29749899999999,98.01014426867296,98.94366911347326,98.93615230769251,100.75899042775777,97.11331418762725,91.57042440000033,94.61789890000006,99.04659939999998,99.29749899999999,97.17333,61736704,45305485.6,37.992738960990316,NaN,1.5,2.75,NaN,NaN,1.6526232671950747,1.3626761347416172,NaN,-0.3221739348854845,-0.18764243056052976,0.13453150432495478,17.8282178805099,-2.8416059208377713,NaN,NaN,NaN,-69187568
1060176600,96.69,98.06,96.423,96.98,NaN,NaN,96.33625041666667,101.63648055555556,91.61212440000034,94.74639890000006,99.07819959999998,99.117499,97.9697464542152,98.75665300742818,98.7415376923079,100.80243893368848,96.68063645092732,91.61212440000034,94.74639890000006,99.07819959999998,99.117499,97.15433333333333,51180000,46033020.8,41.17459642556374,NaN,1.5,2.75,NaN,NaN,1.6517216052525694,1.111810589671317,NaN,-0.35855390623363564,-0.3136608784670898,0.04489302776654587,18.422825781808,-1.533160571310729,NaN,NaN,NaN,-18007568
1060263000,97.17,98.07001,96.758,98,NaN,NaN,96.33250083333334,101.62098,91.65127440000035,94.85859890000005,99.12479959999997,99.052499,97.97093286777539,98.68459081624455,98.71999923076943,100.80545071115058,96.63454775038828,91.65127440000035,94.85859890000005,99.12479959999997,99.052499,97.60933666666666,43546800,45719580.8,46.5541809747551,NaN,1.5,2.75,NaN,NaN,1.6274564905916715,0.9524759247136405,NaN,-0.297875443301289,-0.32745127636006544,-0.029575833058776396,19.41166324584332,-2.2248827696298554,NaN,NaN,NaN,25539232
1060349400,98.32001,98.547,97.75999,98.28,NaN,NaN,96.32875125000001,101.60547944444444,91.69507440000034,94.96849900000007,99.18199959999997,98.9544985,97.98305314747047,98.6460583575546,98.65153769230788,100.73183119688585,96.57124418772992,91.69507440000034,94.96849900000007,99.18199959999997,98.9544985,98.19566333333334,27359504,45083736,47.96105385544042,NaN,1.5,2.75,NaN,NaN,1.5674245984065518,0.6068597331862647,NaN,-0.2260896522253764,-0.31218789834049687,-0.08609824611512049,15.958151129170432,-1.5822151011415966,NaN,NaN,NaN,52898736
1060608600,98.25999,99.03999,97.84,98.64999,NaN,NaN,96.32500166666667,101.5899788888889,91.73732435000035,95.07539880000006,99.21599939999996,98.85049799999999,98.00920753384418,98.64643279969225,98.60615153846175,100.65866912664359,96.5536339502799,91.73732435000035,95.07539880000006,99.21599939999996,98.85049799999999,98.50999333333334,34633904,44708356,49.840003983208696,NaN,1.5,2.75,NaN,NaN,1.541179269948941,0.7746628840478947,NaN,-0.14484687722475126,-0.26715684264605954,-0.1223099654213083,16.23232159851746,-0.7545272388860401,NaN,NaN,NaN,87532640
1060695000,98.71001,99.59,98.42,99.55,NaN,NaN,96.32125208333333,101.57447833333333,91.79327435000033,95.18939890000006,99.25999919999997,98.8024985,98.06963076781108,98.73248681876917,98.68768923076944,100.79865870435076,96.57671975718812,91.79327435000033,95.18939890000006,99.25999919999997,98.8024985,99.18666666666668,43347008,43694686.4,54.17447625731531,NaN,1.5,2.75,NaN,NaN,1.5146664649525883,0.9920430050277235,NaN,-0.02778075491586407,-0.1570359090661384,-0.12925515415027433,17.063242989303482,0.3933037515127073,NaN,NaN,NaN,130879648
1060781400,99.82001,99.849,98.53,99.03999,NaN,NaN,96.3175025,101.55897777777778,91.83747430000034,95.28309880000005,99.28579899999997,98.758498,98.10768407103417,98.76177283602925,98.59615000000021,100.52719874717391,96.6651012528265,91.83747430000034,95.28309880000005,99.28579899999997,98.758498,99.13966333333333,36155504,43492752,51.46072120849097,NaN,1.5,2.75,NaN,NaN,1.5006902888845466,0.8312995231941175,NaN,0.015681083521987826,-0.10965379974778955,-0.12533488326977738,17.282368754551772,-0.35215816480530987,NaN,NaN,NaN,94724144
1060867800,99.10001,99.75,98.45,99.31,NaN,NaN,96.31375291666667,101.54347722222222,91.88597430000034,95.40929880000003,99.28879899999998,98.79899800000001,98.15483371530735,98.81398494688361,98.55384230769252,100.39425036253724,96.7134342528478,91.88597430000034,95.40929880000003,99.28879899999998,98.79899800000001,99.17,36247392,42859441.6,52.80852090149733,NaN,1.5,2.75,NaN,NaN,1.486355268249936,0.8457271174526921,NaN,0.06047415516298252,-0.049742189316049235,-0.11021634447903175,17.304810947069107,0.8121105280794367,NaN,NaN,NaN,130971536
1060954200,99.36,99.78999,99.12,99.62,NaN,NaN,96.31000333333334,101.52797666666667,91.94122425000035,95.53029880000004,99.28819919999998,98.8044985,98.21229121666785,98.89074828527565,98.57076615384638,100.44570892379836,96.69582338389439,91.94122425000035,95.53029880000004,99.28819919999998,98.8044985,99.50999666666667,12567199,41702716.75,54.37491922148787,NaN,1.5,2.75,NaN,NaN,1.4280434633749404,0.30135204560743634,NaN,0.1061677266967567,0.022493313891914113,-0.08367441280484259,16.418687694847055,1.1267994240990205,NaN,NaN,NaN,143538735
1061213400,99.92999,100.60001,99.74001,100.48,NaN,NaN,96.30625375,101.51247611111111,91.99647430000033,95.66429880000004,99.31259939999998,98.91449850000001,98.30122097287695,99.04210559143988,98.67230461538483,100.79101469857905,96.55359453219062,91.99647430000033,95.66429880000004,99.31259939999998,98.91449850000001,100.27334000000002,22882096,41092206.35,58.49115901743986,NaN,1.5,2.75,NaN,NaN,1.3960410731338726,0.556847588204521,NaN,0.18488811896792437,0.14743573590506287,-0.03745238306286149,16.93558887518338,4.210744658784487,NaN,NaN,NaN,166420831
1061299800,100.687,100.94,100,100.86,NaN,NaN,96.30250416666667,101.49697555555557,92.05817430000033,95.80139890000004,99.36479939999998,98.9989985,98.4015652484504,99.21523839225513,98.78538153846173,101.18369708246352,96.38706599445995,92.05817430000033,95.80139890000004,99.36479939999998,98.9989985,100.60000000000001,37456800,40464711.15,60.19980484756968,NaN,1.5,2.75,NaN,NaN,1.3634667107671672,0.9256658193147637,NaN,0.24912855354471478,0.27395830886803196,0.024829755323317194,8.031159624772098,4.000824912353058,NaN,NaN,NaN,203877631
1061386200,100.28999,100.89,100.164,100.45,NaN,NaN,96.29875458333333,101.481475,92.10907430000034,95.93879880000004,99.38879939999997,99.05949799999999,98.48189602302097,99.33283473584989,98.93461307692328,101.48257365831547,96.3866524955311,92.10907430000034,95.93879880000004,99.38879939999997,99.05949799999999,100.50133333333333,23206192,39760105.55,57.45190547642209,NaN,1.5,2.75,NaN,NaN,1.3179333742837982,0.5836551910260208,NaN,0.2499418726462352,0.3372570961311112,0.087315223484876,9.337118625817084,2.500000000000003,NaN,NaN,NaN,180671439
1061472600,101.05,101.52,100.39999,100.77,NaN,NaN,96.295005,101.46597444444444,92.15727430000034,96.09909870000006,99.39819939999998,99.17349749999998,98.57162559074564,99.4697076181499,99.1084600000002,101.81996141601404,96.39695858398638,92.15727430000034,96.09909870000006,99.39819939999998,99.17349749999998,100.89666333333332,46550496,40028965.55,59.02402598084814,NaN,1.5,2.75,NaN,NaN,1.3037959904063836,1.1629202843589348,NaN,0.25697489552512937,0.4085338428912877,0.15155894736615833,8.226243709027193,2.533577533577528,NaN,NaN,NaN,227221935
1061559000,101.75,101.81799,99.73,99.77,NaN,NaN,96.29125541666667,101.4504738888889,92.19687425000035,96.23639880000006,99.38139939999999,99.15049749999999,98.61862066561837,99.49830689261181,99.3661523076925,101.60162359089993,97.13068102448507,92.19687425000035,96.23639880000006,99.38139939999999,99.15049749999999,100.43933,52045008,40464960.75,52.4962037315893,NaN,1.5,2.75,NaN,NaN,1.3598098482344985,1.2861746813877732,NaN,0.18271261154827428,0.37994971180150117,0.19723710025322688,11.004439256135026,1.1353371652647846,NaN,NaN,NaN,175176927
1061818200,99.71001,100,99.28,99.92999,NaN,NaN,96.28750583333334,101.43497333333333,92.23132425000034,96.35449870000006,99.38879919999998,99.15399699999999,98.67004691402549,99.53941956950592,99.59307461538482,101.36430626925608,97.82184296151357,92.23132425000034,96.35449870000006,99.38879919999998,99.15399699999999,99.73666333333334,23485808,39918435.95,53.38447896963473,NaN,1.5,2.75,NaN,NaN,1.314109144789177,0.5883448948104391,NaN,0.13500036867589427,0.3659875610980947,0.23098719242220045,10.9123350544438,0.38170768458061927,NaN,NaN,NaN,198662735
1061904600,99.5,100.39,98.83,100.11,NaN,NaN,96.28375625000001,101.41947277777778,92.27807430000036,96.47859870000006,99.35779919999997,99.18949749999999,98.72651566249507,99.59376056288632,99.7553823076925,101.28286953541357,98.22789507997143,92.27807430000036,96.47859870000006,99.35779919999997,99.18949749999999,99.77666666666664,45076608,39493775.95,54.41725974361883,NaN,1.5,2.75,NaN,NaN,1.331672777304236,1.1413597944412301,NaN,0.10740026830178895,0.36523752779943663,0.2578372594976477,9.75055900826521,1.0803817730595453,NaN,NaN,NaN,243739343
1061991000,100.05,100.36,99.57001,100.14,NaN,NaN,96.28000666666667,101.40397222222222,92.33052435000035,96.59779870000006,99.32739919999999,99.23849749999998,98.7819464208286,99.64578336642096,99.89845923076943,101.17402978047836,98.6228886810605,92.33052435000035,96.59779870000006,99.32739919999999,99.23849749999998,100.02333666666665,18987808,39022286.35,54.59779575616081,NaN,1.5,2.75,NaN,NaN,1.2929811503539337,0.4865888131129456,NaN,0.08403483739167611,0.36288080623724284,0.2788459688455667,9.06489079696454,0.835766790856911,NaN,NaN,NaN,262727151
1062077400,100.39999,101,99.66,100.75999,NaN,NaN,96.27625708333333,101.38847166666667,92.39302435000035,96.72489860000007,99.31119879999997,99.30699699999997,98.8595167572667,99.75189828390468,100.06076692307713,101.1879282799077,98.93360556624656,92.39302435000035,96.72489860000007,99.31119879999997,99.30699699999997,100.47332999999999,27426400,37438006.35,58.275701331377775,NaN,1.5,2.75,NaN,NaN,1.2963396396143672,0.7325817444336215,NaN,0.1020087208431329,0.40635686989948283,0.30434814905634994,9.495037783298603,1.1443384862477388,NaN,NaN,NaN,290153551
1062163800,100.61,101.48,100.48,101.44,NaN,NaN,96.2725075,101.37297111111111,92.45542430000035,96.85739860000007,99.33959879999995,99.45349749999995,98.96071217855037,99.91266987591376,100.20615153846174,101.5065331938899,98.90576988303359,92.45542430000035,96.85739860000007,99.33959879999995,99.45349749999995,101.13333333333333,28721200,36407841.55,61.919402019629,NaN,1.5,2.75,NaN,NaN,1.275172522499055,0.7888740111263202,NaN,0.14854890266315307,0.49003427738529126,0.3414853747221382,9.94124464425556,0.9554140127388473,NaN,NaN,NaN,318874751
1062509400,101.64,102.88,101.05,102.8,NaN,NaN,96.26875791666667,101.35747055555557,92.52417430000034,97.01509860000006,99.40679879999996,99.66799799999997,99.11127248527389,100.18765369725531,100.49538307692328,102.22977093989395,98.7609952139526,92.52417430000034,97.01509860000006,99.40679879999996,99.66799799999997,102.24333333333335,50860608,36173651.95,67.94800878522167,NaN,1.5,2.75,NaN,NaN,1.3148030566062654,1.4060125328319248,NaN,0.2536109738662632,0.6584990920549672,0.40488811818870396,11.381704871128122,1.9234582589728313,NaN,NaN,NaN,369735359
1062595800,103.03,103.7,102.78,103.36,NaN,NaN,96.26500833333334,101.34197,92.58732430000035,97.17359870000006,99.50559879999996,100.01499799999996,99.27788925055727,100.48978191656433,100.80692153846174,102.97774168834033,98.63610138858314,92.58732430000035,97.17359870000006,99.50559879999996,100.01499799999996,103.28000000000002,44923904,35333011.95,70.05051079180735,NaN,1.5,2.75,NaN,NaN,1.2866028382772465,1.2714428100149553,NaN,0.3382137424341784,0.827655296231427,0.4894415537972486,11.500089924701253,2.8969636635141827,NaN,NaN,NaN,414659263
1062682200,103.10001,103.55,102.75999,103.41,NaN,NaN,96.26125875,101.32646944444444,92.64737435000033,97.33619880000006,99.60339879999994,100.33649799999996,99.43993280935894,100.76789792451058,101.09846000000019,103.55283125706063,98.64408874293974,92.64737435000033,97.33619880000006,99.60339879999994,100.33649799999996,103.23999666666667,28404400,34194231.95,70.23822918693077,NaN,1.5,2.75,NaN,NaN,1.2511319212574428,0.8306781109028535,NaN,0.37224013346552787,0.9547417206291584,0.5825015871636305,10.834132042451124,2.6198273295623706,NaN,NaN,NaN,443063663
1062768600,102.94,103.549,102.39999,102.83,NaN,NaN,96.25750916666667,101.3109688888889,92.70912435000035,97.47499880000005,99.70939879999995,100.57799799999995,99.57287662075663,100.96428859836671,101.27922923076942,103.8672923424148,98.69116611912403,92.70912435000035,97.47499880000005,99.70939879999995,100.57799799999995,102.92633000000001,31654496,33599616.75,65.1379475821921,NaN,1.5,2.75,NaN,NaN,1.243837498310483,0.9421088411670648,NaN,0.3317289724746756,0.997162802756975,0.6654338302822994,11.877298693981896,3.067054224716851,NaN,NaN,NaN,411409167
1063027800,103.03999,103.88,102.92999,103.67999,NaN,NaN,96.25375958333333,101.29546833333333,92.77572430000035,97.61399870000005,99.80699859999993,100.84799749999996,99.73393989053088,101.22292682709369,101.49615153846175,104.3648103010034,98.62749277592009,92.77572430000035,97.61399870000005,99.80699859999993,100.84799749999996,103.49666,32655392,33864411.15,68.72241265983249,NaN,1.5,2.75,NaN,NaN,1.229991962716877,0.9642982379157655,NaN,0.33712532356177904,1.0868404847345232,0.7497151611727442,9.513651943312723,3.7526272143127404,NaN,NaN,NaN,444064559
1063114200,103.37,103.46001,102.67999,103,NaN,NaN,96.25001,101.27996777777778,92.82887430000035,97.76149870000005,99.91379859999994,101.06549799999998,99.86202067913752,101.39217189118,101.69230538461558,104.59651161313974,98.78809915609142,92.82887430000035,97.76149870000005,99.91379859999994,101.06549799999998,103.04666666666667,35083504,33886891.15,63.13022032332485,NaN,1.5,2.75,NaN,NaN,1.2135639653799573,1.0353119690060444,NaN,0.27260460210842474,1.090470913808275,0.8178663116998504,11.220272144083777,2.886824493057637,NaN,NaN,NaN,408981055
1063200600,102.53999,102.8,101.55,101.96001,NaN,NaN,96.24626041666667,101.26446722222222,92.86822435000035,97.88549880000006,100.00039879999993,101.18599849999997,99.94429477015173,101.44625171106762,101.78384461538482,104.64062768226613,98.92706154850352,92.86822435000035,97.88549880000006,100.00039879999993,101.18599849999997,102.10333666666666,45944704,34016775.95,55.66902153873783,NaN,1.5,2.75,NaN,NaN,1.2304522535671032,1.3506483997052636,NaN,0.14404781693470592,0.9979260828682328,0.8538782659335269,13.545649312521157,1.8174655482324709,NaN,NaN,NaN,363036351
1063287000,102.10001,102.75999,101.84,102.25999,NaN,NaN,96.24251083333334,101.24896666666667,92.91242430000035,98.01159880000006,100.07499859999993,101.34699849999996,100.03510634779283,101.52375059572785,101.97538230769251,104.59002440412029,99.36074021126474,92.91242430000035,98.01159880000006,100.07499859999993,101.34699849999996,102.28666,38797008,34148851.15,57.23890684880241,NaN,1.5,2.75,NaN,NaN,1.2082763783123103,1.1361145893190612,NaN,0.06727906758768876,0.9379771004181379,0.8706980328304491,13.521151472274914,1.4886861342483262,NaN,NaN,NaN,401833359
1063373400,101.91,102.64,101.35001,102.45,NaN,NaN,96.23876125000001,101.23346611111111,92.95727430000035,98.12269880000007,100.12859859999992,101.50399849999997,100.12980805964409,101.61196482470615,102.16922923076943,104.50762343832118,99.83083502321769,92.95727430000035,98.12269880000007,100.12859859999992,101.50399849999997,102.14666999999997,42441200,34458541.55,58.24749074613777,NaN,1.5,2.75,NaN,NaN,1.2141130655757169,1.231659788572799,NaN,0.019823029396773495,0.895476819576416,0.8756537901796425,13.270072182253823,0.9956624605678284,NaN,NaN,NaN,444274559
1063632600,102.52,102.63,101.95,102.09,NaN,NaN,96.23501166666667,101.21796555555557,93.00922430000035,98.22179890000007,100.19559839999991,101.62749849999997,100.20667833181491,101.65749198425794,102.32153692307712,104.33957613079126,100.30349771536298,93.00922430000035,98.22179890000007,100.19559839999991,101.62749849999997,102.22333333333331,21321904,34896276.8,55.57301939115764,NaN,1.5,2.75,NaN,NaN,1.175962132320308,0.6110079915459635,NaN,-0.041918179353878426,0.8232560659872945,0.8651742453411729,13.14207430757093,-0.6906614785992157,NaN,NaN,NaN,422952655
1063719000,102.23199,103.64,102.17,103.58,NaN,NaN,96.23126208333333,101.202465,93.05572430000036,98.34399890000006,100.25319839999992,101.78249849999997,100.33896545605747,101.84058798575718,102.5861523076925,104.26405542571332,100.90824918967168,93.05572430000036,98.34399890000006,100.25319839999992,101.78249849999997,103.13,37946496,35649496.8,63.120675991296494,NaN,1.5,2.75,NaN,NaN,1.2026791228688574,1.0644328645895502,NaN,0.008781737996201744,0.8761514178364251,0.8673696798402234,13.565002918624725,0.2128482972136212,NaN,NaN,NaN,460899151
1063805400,103.48,103.785,103.05,103.38,NaN,NaN,96.2275125,101.18696444444444,93.10272430000038,98.47549890000006,100.29779859999991,101.90849849999998,100.45822171268266,101.98719865378031,102.78769153846171,104.13701694521687,101.43836613170656,93.10272430000038,98.47549890000006,100.29779859999991,101.90849849999998,103.40499999999999,32072400,35380276.8,61.60771120696714,NaN,1.5,2.75,NaN,NaN,1.1692734712353676,0.9065050615997443,NaN,0.01942793418536426,0.8916545975719288,0.8722266633865645,13.292262891420345,-0.02901073397157058,NaN,NaN,NaN,428826751
1063891800,103.39999,104.7,103.17,104.60001,NaN,NaN,96.22376291666667,104.7,93.15507435000036,98.60359910000007,100.37819879999992,102.11599899999997,100.62064478277354,102.23603782961075,103.03076923076941,104.45768680242838,101.60385165911043,93.15507435000036,98.60359910000007,100.37819879999992,102.11599899999997,104.15667,30295008,35734717.6,66.83062174862783,NaN,1.5,2.75,NaN,NaN,1.1950396518614128,0.8477752179018199,NaN,0.09498858333000038,0.9909623925490649,0.8959738092190646,14.901722573182756,1.7212972867840117,NaN,NaN,NaN,459121759
1063978200,104.27,104.60001,103.39999,103.67,NaN,NaN,96.22001333333334,104.75957468085106,93.20907435000035,98.72239920000007,100.46559879999991,102.26099899999997,100.74022734031183,102.37260565536211,103.0976923076925,104.55629471247664,101.63908990290835,93.20907435000035,98.72239920000007,100.46559879999991,102.26099899999997,103.89,34381600,35126272.8,60.1167507254064,NaN,1.5,2.75,NaN,NaN,1.1953953910141686,0.9788001190949016,NaN,0.06984958814210263,0.9832857943966928,0.9134362062545902,15.556016565759803,-0.009635417596010514,NaN,NaN,NaN,424740159
1064237400,102.85001,102.96001,102.03,102.55,NaN,NaN,96.21626375,104.81914936170213,93.25957435000035,98.82879920000006,100.5117985999999,102.39999899999998,100.81119881716235,102.38950035485144,103.03538461538481,104.51292263802863,101.557846592741,93.25957435000035,98.82879920000006,100.5117985999999,102.39999899999998,102.51333666666666,36700608,34359052.8,53.1869934742948,NaN,1.5,2.75,NaN,NaN,1.2271528630845852,1.0681495853110363,NaN,-0.02937208485837106,0.8767211001816264,0.9060931850399975,16.07338799370876,-0.4368932038834979,NaN,NaN,NaN,388039551
1064323800,102.59,103.28999,102.36,102.94,NaN,NaN,96.21251416666667,104.87872404255319,93.31712440000034,98.93919930000007,100.55599859999991,102.55049949999997,100.89468121648932,102.44192889248463,102.99923076923096,104.46125304707546,101.53720849138647,93.31712440000034,98.93919930000007,100.55599859999991,102.55049949999997,102.86333,32513200,34810422.4,55.1267247121857,NaN,1.5,2.75,NaN,NaN,1.2059269442928293,0.9340076264055905,NaN,-0.07339436374964348,0.8143502303529431,0.8877445941025865,15.880171734678518,0.9611513376666017,NaN,NaN,NaN,420552751
1064410200,103.118,103.22,101.07001,101.11,NaN,NaN,96.20876458333333,104.93829872340426,93.36252440000035,99.01819920000007,100.56799879999991,102.60049949999998,100.90312509035248,102.31507852177181,102.86692307692327,104.64368671414913,101.09015943969742,93.36252440000035,99.01819920000007,100.56799879999991,102.60049949999998,101.80000333333334,41717504,34642467.2,45.58243319410963,NaN,1.5,2.75,NaN,NaN,1.2733600197004846,1.204230165223336,NaN,-0.22201894427447633,0.6102209137594912,0.8322398580339675,18.151598196417467,-1.1245747237018138,NaN,NaN,NaN,378835247
1064496600,101.41,101.88,100.2,100.28,NaN,NaN,96.205015,104.99787340425532,93.41642440000034,99.09069920000007,100.57519879999991,102.60749949999999,100.87868881229943,102.12126151969831,102.60538538461557,104.78231031314473,100.42846045608641,93.41642440000034,99.09069920000007,100.57519879999991,102.60749949999999,100.78666666666668,53174496,36351801.6,42.02829007019048,NaN,1.5,2.75,NaN,NaN,1.302405732579021,1.4627747088056289,-2.7098771823524297,-0.3640913849768215,0.3771256268129406,0.7412170117897621,18.431875759903736,-2.1181063933626176,NaN,NaN,NaN,325660751
1064583000,100.44,100.66,99.84599,99.95,NaN,NaN,96.20126541666667,105.05744808510639,93.46267440000034,99.15109920000008,100.6041987999999,102.56699999999998,100.84226964318965,101.91447470829847,102.37077000000019,104.94768114395885,99.79385885604154,93.46267440000034,99.15109920000008,100.6041987999999,102.56699999999998,100.15199666666666,42916096,37126286.4,40.67048540897676,NaN,1.5,2.75,NaN,NaN,1.2675203231090908,1.1559490636262506,-4.965305417020767,-0.4618707294459605,0.16387859998231136,0.6257493294282719,18.278909146743093,-2.0961896365951618,NaN,NaN,NaN,282744655
1064842200,100.3,100.99001,99.78999,100.92999,NaN,NaN,96.19751583333334,105.11702276595744,93.51342435000035,99.2264991000001,100.63259879999991,102.54149949999999,100.84570965718221,101.82071425988909,102.29153769230788,104.97522306087245,99.60785232374332,93.51342435000035,99.2264991000001,100.63259879999991,102.54149949999999,100.56999666666667,36785200,37529486.4,46.226417546225534,NaN,1.5,2.75,NaN,NaN,1.262698871458441,0.9801679566816561,-2.246762389868872,-0.4421090662424815,0.07311299662517001,0.5152220628676515,19.54108834499736,-2.55841861363197,NaN,NaN,NaN,319529855
1064928600,100.48,100.75999,99.25,99.95,NaN,NaN,99.25,105.17659744680851,93.55932435000035,99.30149910000009,100.66599879999991,102.39899949999997,100.8105837882731,101.6425509970425,102.11384615384635,105.07401148667358,99.15368082101912,93.55932435000035,99.30149910000009,100.66599879999991,102.39899949999997,99.98666333333334,70775872,38525249.6,41.99161293550314,NaN,1.5,2.75,NaN,NaN,1.2925053806399813,1.8371294861124015,-3.3030717544416803,-0.4737846043551495,-0.0770086925762854,0.3967759117788641,17.2709892150548,-3.3178564519249303,NaN,NaN,NaN,248753983
1065015000,100.24001,102.17999,100.2,102.08,NaN,NaN,99.32461538461538,105.23617212765957,93.62302435000036,99.3849991000001,100.7241987999999,102.3349995,100.86036481618396,101.68421280684798,102.0853846153848,105.03918250842752,99.13158672234208,93.62302435000036,99.3849991000001,100.7241987999999,102.3349995,101.48666333333334,65802816,39569195.2,52.23406743504477,NaN,1.5,2.75,NaN,NaN,1.3594685677371257,1.662980903892632,0.32551842173785994,-0.33648735245300565,-0.023833278787392942,0.3126540736656127,22.35683077286013,-2.4091871501733118,NaN,NaN,NaN,314556799
1065101400,101.92999,102.56,101.63,102.45,NaN,NaN,99.39923076923077,105.29574680851064,93.67702440000035,99.46069910000011,100.7883985999999,102.2869995,100.92270345084341,101.75714492048151,102.11307692307712,105.07327183989914,99.1528820062551,93.67702440000035,99.46069910000011,100.7883985999999,102.2869995,102.21333333333334,44638800,40380915.2,53.761369775931136,NaN,1.5,2.75,NaN,NaN,1.3287922414701885,1.105442998973931,2.1821698353168104,-0.21203074371260316,0.04761564402485874,0.2596463877374619,21.082395621443098,-1.17681103501495,NaN,NaN,NaN,359195599
1065187800,103.67,104.28,103.08,103.39,NaN,NaN,99.47384615384615,105.3553214893617,93.73972435000036,99.5474990000001,100.88639839999989,102.3149995,101.01946017826133,101.91265492805469,102.09846153846175,105.03129123693334,99.16563183999016,93.73972435000036,99.5474990000001,100.88639839999989,102.3149995,103.58333333333331,48820496,41239215.2,57.48100663954544,NaN,1.5,2.75,NaN,NaN,1.3645927956508892,1.1838366895013075,4.6942764436538225,-0.06528729309596898,0.1780372713675007,0.24332456446346967,21.477420373728,0.8191126279863514,NaN,NaN,NaN,408016095
1065447000,103.48199,103.99001,103.2,103.86,NaN,NaN,99.54846153846154,105.41489617021277,93.81002435000036,99.6409991000001,100.95899839999989,102.324,101.13085389676088,102.09811636347806,102.13538461538481,105.14295437169103,99.12781485907858,93.81002435000036,99.6409991000001,100.95899839999989,102.324,103.68333666666666,20242496,40618570.4,59.246301664440985,NaN,1.5,2.75,NaN,NaN,1.323551167390111,0.4983556979149616,6.804343018997111,0.05788708503035411,0.3156834207514123,0.2577963357210582,20.49653975062094,0.8937244997085698,NaN,NaN,NaN,428258591
1065533400,103.25999,104.31,102.91,104.25999,NaN,NaN,99.62307692307692,105.47447085106383,93.88552430000036,99.7324990000001,101.04699819999989,102.3869995,101.25356511649575,102.30400909076586,102.10922923076942,105.03542249831483,99.183035963224,93.88552430000036,99.7324990000001,101.04699819999989,102.3869995,103.82666333333334,42619392,40995364.8,60.74019112567947,NaN,1.5,2.75,NaN,NaN,1.3290117982908178,1.0396148981213604,8.767682229296964,0.15523200967117728,0.4518363478100298,0.2966043381388525,20.498719289208033,3.1154089605380304,NaN,NaN,NaN,470877983
1065619800,104.33,104.39,103.41,104,NaN,NaN,99.69769230769231,105.5340455319149,93.95557425000035,99.8237990000001,101.13899839999989,102.488999,101.36126844526062,102.46553203450244,102.13461384615402,105.11965886122343,99.14956883108462,93.95557425000035,99.8237990000001,101.13899839999989,102.488999,103.93333333333334,30943808,40245320,59.220635188080614,NaN,1.5,2.75,NaN,NaN,1.3040823841271882,0.7688796610388487,7.581720988344862,0.18881236454578515,0.5326197938210839,0.3438074292752988,16.792034057355053,3.7096130833665724,NaN,NaN,NaN,439934175
1065706200,104.88,105.22,103.83,104.28,NaN,NaN,99.77230769230769,105.59362021276596,94.02687425000035,99.9400991000001,101.2413983999999,102.58999950000002,101.4757285062308,102.63833850740697,102.26769076923095,105.46186901563607,99.07351252282584,94.02687425000035,99.9400991000001,101.2413983999999,102.58999950000002,104.44333333333334,40094800,40310209.6,60.37049592806882,NaN,1.5,2.75,NaN,NaN,1.310219356689532,0.9946562024326462,9.675836816306017,0.2146965434377784,0.6121781085725218,0.39748156513474336,15.263064811648892,4.3321660830415185,NaN,NaN,NaN,480028975
1065792600,104.27,104.60001,103.91,104.57001,NaN,NaN,99.84692307692308,105.65319489361703,94.10294930000035,100.06119910000008,101.34499859999988,102.69600000000003,101.59707287853547,102.82230722098726,102.39307615384632,105.80361693590297,98.98253537178968,94.10294930000035,100.06119910000008,101.34499859999988,102.69600000000003,104.36000666666666,22686000,39322449.6,61.578905473635125,NaN,1.5,2.75,NaN,NaN,1.2659186883545654,0.5769223492119372,9.548321473693349,0.23454949485816035,0.6906684337074438,0.45611893884928345,14.598732631206204,3.606480095757458,NaN,NaN,NaN,502714975
1066051800,104.715,105.28999,104.50999,104.89999,NaN,NaN,99.92153846153846,105.71276957446808,94.18049925000035,100.18369910000008,101.47279859999989,102.83649950000002,101.72659904016153,103.02018177136942,102.68461384615401,106.250983258906,99.11824443340201,94.18049925000035,100.18369910000008,101.47279859999989,102.83649950000002,104.89999000000002,23829504,39447829.6,62.9627692614613,NaN,1.5,2.75,NaN,NaN,1.2312102106149538,0.6040764280729909,12.062460595219456,0.2515976715042394,0.7706160282295826,0.5190183567253432,14.219608872877007,4.952466233116557,NaN,NaN,NaN,526544479
1066138200,104.8,105.42999,104.36,105.27,NaN,NaN,99.99615384615385,105.77234425531915,94.26994925000035,100.3006990000001,101.60799879999992,102.92099950000002,101.86555594054735,103.23445017409614,103.06846000000017,106.59084475028617,99.54607524971418,94.26994925000035,100.3006990000001,101.60799879999992,102.92099950000002,105.01999666666666,38504400,39475724.8,64.50653888249772,NaN,1.5,2.75,NaN,NaN,1.2196944812853145,0.9753943770527046,13.809507793506748,0.2679753551650238,0.853987550681623,0.5860121955165992,11.32003957574885,3.124999999999998,NaN,NaN,NaN,565048879
1066224600,105.86,105.89,104.64,104.99001,NaN,NaN,100.07076923076923,105.83191893617021,94.35434930000037,100.41299920000009,101.77939899999993,103.00150000000001,101.98808355072197,103.40164634799174,103.45615307692324,106.61048910193244,100.30181705191404,94.35434930000037,100.41299920000009,101.77939899999993,103.00150000000001,105.17333666666667,39881200,39866164.8,62.387422688635176,NaN,1.5,2.75,NaN,NaN,1.2218591611935063,1.0003771418714449,11.478061125800957,0.2409819900501613,0.8872396830793008,0.6462576930291395,6.144576193498755,2.479267935578326,NaN,NaN,NaN,525167679
1066311000,104.67999,105.73,104.64999,105.41,NaN,NaN,100.14538461538461,105.89149361702128,94.44024930000036,100.51309930000008,101.94799899999992,103.0419995,102.12227635265444,103.59291812437348,103.80076923076939,106.74795042943927,100.85358803209951,94.44024930000036,100.51309930000008,101.94799899999992,103.0419995,105.26333,32793504,39991089.6,64.2828574860531,NaN,1.5,2.75,NaN,NaN,1.2117270782511131,0.8200202677148362,13.127211503934186,0.23234137022142443,0.93668440580592,0.7043430355844956,6.166227476462648,1.95376728890608,NaN,NaN,NaN,557961183
1066397400,105.47,105.63,103.98,104.25999,NaN,NaN,100.22,105.95106829787234,94.50619920000035,100.5989992000001,102.07319879999991,103.07149899999999,102.20610826039348,103.65644877919506,104.13230692307708,106.06841215032233,102.19620169583183,94.50619920000035,100.5989992000001,102.07319879999991,103.07149899999999,104.62333000000001,32801200,39912069.6,55.96619815774215,NaN,1.5,2.75,NaN,NaN,1.2430322869474615,0.8218366105475021,10.576863781706194,0.1349335659813543,0.8730099930611885,0.7380764270798342,8.862607185879364,0.38512420566146977,NaN,NaN,NaN,525159983
1066656600,104.44701,105.03999,103.94,105.03999,NaN,NaN,100.29461538461538,106.01064297872341,94.57464910000037,100.69519910000008,102.20839859999992,103.1959985,102.31724087763295,103.78821460974791,104.35999846153862,105.94070875955204,102.77928816352521,94.57464910000037,100.69519910000008,102.20839859999992,103.1959985,104.67332666666665,27778096,39465944,59.76810840399663,NaN,1.5,2.75,NaN,NaN,1.2328149807369289,0.7038497799520518,11.780862287976355,0.10985567676901686,0.8753960230411053,0.7655403462720884,9.445567748536412,0.7481297475666371,NaN,NaN,NaN,552938079
1066743000,104.82001,105.28,104.32001,104.86,NaN,NaN,100.36923076923077,106.07021765957447,94.63414905000037,100.77429910000008,102.33259879999993,103.2919985,102.41695692164735,103.89028940881954,104.54538307692323,105.69238276073511,103.39838339311135,94.63414905000037,100.77429910000008,102.33259879999993,103.2919985,104.82000333333333,26763696,39178468.8,58.51264554758674,NaN,1.5,2.75,NaN,NaN,1.2133274821128628,0.6831225624621655,12.917824436347736,0.06991269902732822,0.8529312200562487,0.7830185210289204,9.399781845211026,0.8269230769230764,NaN,NaN,NaN,526174383
1066829400,104.03,104.19,103.19,103.53999,NaN,NaN,100.44384615384615,106.12979234042554,94.68819900000038,100.83619890000007,102.41239859999992,103.413498,102.46099743452393,103.85692756036053,104.55692076923091,105.65935186443,103.45448967403183,94.68819900000038,100.83619890000007,102.41239859999992,103.413498,103.63999666666666,34121696,38798678.4,50.186651351163526,NaN,1.5,2.75,NaN,NaN,1.2459469476762297,0.8794551105122179,9.950993916528086,-0.05016630961246071,0.7203106340133445,0.7704769436258052,12.04747647316457,-0.709637514384348,NaN,NaN,NaN,492052687
1066915800,102.89,103.95,102.84,103.35001,NaN,NaN,100.51846153846154,106.1893670212766,94.74799905000037,100.89219900000008,102.49859899999993,103.5669985,102.49586067238575,103.80864969746905,104.51769076923094,105.74567594547538,103.2897055929865,94.74799905000037,100.89219900000008,102.49859899999993,103.5669985,103.38000333333333,46399808,38459944,49.1036829577929,NaN,1.5,2.75,NaN,NaN,1.236236451413642,1.206445022384848,9.18179519924713,-0.14194807606114335,0.593041848549376,0.7349899246105194,11.896316407125191,-1.1666824933840965,NaN,NaN,NaN,445652879
1067002200,102.83,103.58,102.17999,103.58,NaN,NaN,102.17999,106.24894170212767,94.80184905000038,100.93639900000008,102.5839989999999,103.74849850000001,102.53837594013532,103.78687353580533,104.465383846154,105.78716769734397,103.14359999496402,94.80184905000038,100.93639900000008,102.5839989999999,103.74849850000001,103.11333,51735104,38900894.4,50.49636010475551,NaN,1.5,2.75,NaN,NaN,1.2479345620269526,1.329920681720881,7.565502187205318,-0.18405729480171185,0.5049183061083795,0.6889756009100914,11.83794531920699,-1.2583318644739663,NaN,NaN,NaN,497387983
1067265000,103.74001,104.17999,103.27,103.63,NaN,NaN,102.34276722222222,106.30851638297872,94.85469905000038,100.97619910000007,102.66419899999991,103.883499,102.58118472679668,103.77193319906196,104.43692230769246,105.81240757165766,103.06143704372725,94.85469905000038,100.97619910000007,102.66419899999991,103.883499,103.69333,32499008,38686584.8,50.81147838406406,NaN,1.5,2.75,NaN,NaN,1.2237956647393136,0.840058851615147,10.202238987187629,-0.20389232563215443,0.43411019386989835,0.6380025195020528,11.596822309326399,-1.5578987365821229,NaN,NaN,NaN,529886991
1067351400,103.98,105.14999,103.82001,105.03999,NaN,NaN,102.50554444444445,106.3680910638298,94.9147490000004,101.03399910000006,102.75539879999992,104.13799850000002,102.67760846300072,103.89270051343702,104.49538307692322,105.90343743479637,103.08732871905006,94.9147490000004,101.03399910000006,102.75539879999992,104.13799850000002,104.66999666666668,35035200,36899551.2,58.77996013783015,NaN,1.5,2.75,NaN,NaN,1.2449524029722203,0.9494749627198718,12.918556048647572,-0.12147044544261731,0.4861644626987811,0.6076349081413984,14.20787695655369,0.047604529230928755,NaN,NaN,NaN,564922191
1067437800,104.77,105.42999,103.87,105.17999,NaN,NaN,102.66832166666667,106.42766574468085,94.9739989500004,101.10329900000006,102.84179859999993,104.29299800000004,102.7757410722948,104.0152995121573,104.54230461538478,105.99705828252945,103.08755094824011,94.9739989500004,101.10329900000006,102.84179859999993,104.29299800000004,104.82666,30965296,35157675.2,59.48183274345924,NaN,1.5,2.75,NaN,NaN,1.2674550884742044,0.8807549368338211,14.933457798070869,-0.06004754478224672,0.53257547716359,0.5926230219458367,14.141346396303616,-0.2182051038800806,NaN,NaN,NaN,595887487
1067524200,105.78999,105.97,104.8,105.39999,NaN,NaN,102.83109888888889,106.48724042553192,95.03899895000039,101.16479890000006,102.94079839999993,104.44049750000003,102.87865279494991,104.14717479671374,104.58076615384631,106.09647430209246,103.06505800560016,95.03899895000039,101.16479890000006,102.94079839999993,104.44049750000003,105.38999666666666,39144800,34882975.2,60.616690477766824,NaN,1.5,2.75,NaN,NaN,1.2604940107260472,1.1221749227399616,14.304304928464973,-0.009764014015726685,0.5804180044261784,0.5901820184419051,13.995450569300338,1.0934204002896994,NaN,NaN,NaN,635032287
1067610600,105.39999,105.74001,105.22,105.3,NaN,NaN,102.99387611111112,106.54681510638298,95.10539895000038,101.21479890000006,103.03139839999993,104.53599750000005,102.97360758730483,104.25696767321719,104.58307384615401,106.10305777011898,103.06308992218904,95.10539895000038,101.21479890000006,103.03139839999993,104.53599750000005,105.42000333333334,25764704,33730185.6,59.796926068702184,NaN,1.5,2.75,NaN,NaN,1.2076022956741868,0.7638470865692479,15.581468794608861,0.010502869652386893,0.6033106055073887,0.5928077358550018,12.19355385338298,0.24753429622374684,NaN,NaN,NaN,609267583
1067869800,105.75,106.61,105.71001,105.99001,NaN,NaN,103.15665333333334,106.60638978723405,95.18204900000039,101.26859900000005,103.15579859999993,104.64249800000005,103.09189787799876,104.42201932338698,104.65999692307709,106.34664953884175,102.97334430731243,95.18204900000039,101.26859900000005,103.15579859999993,104.64249800000005,106.10334,37599200,34598020.8,63.468465929085156,NaN,1.5,2.75,NaN,NaN,1.214916417411745,1.0867442452083849,18.429872217906844,0.0612854931584953,0.6694146023031209,0.6081291091446256,12.025528778116811,1.0776368491321748,NaN,NaN,NaN,646866783
1067956200,105.99001,106.27,105.58,105.75999,NaN,NaN,103.31943055555556,106.66596446808511,95.26459895000038,101.33059890000006,103.27239859999992,104.71749800000005,103.19652894160666,104.54944510211203,104.68691923076939,106.43080066779802,102.94303779374076,95.26459895000038,101.33059890000006,103.27239859999992,104.71749800000005,105.86999666666665,31433760,34038739.2,61.453667107538806,NaN,1.5,2.75,NaN,NaN,1.1774223875966203,0.9234701619030589,19.408638376535816,0.06967883489059123,0.6952276527578647,0.6255488178672735,12.064646390441427,2.144099106055543,NaN,NaN,NaN,615433023
1068042600,105.53999,105.97,104.89999,105.84,NaN,NaN,103.48220777777779,106.72553914893618,95.3529489500004,101.37239890000006,103.38699859999993,104.80949800000005,103.30019447330835,104.67235509238708,104.8084584615386,106.6346728316478,102.98224409142941,95.3529489500004,101.37239890000006,103.38699859999993,104.80949800000005,105.56999666666667,33637008,34173399.2,61.906654543653936,NaN,1.5,2.75,NaN,NaN,1.1697500741968614,0.98430383829069,18.959549663396743,0.07068998133474569,0.7139112945357056,0.6432213132009599,8.499113989372063,2.409278915406013,NaN,NaN,NaN,649070031
1068129000,105.60001,106.44,105.10001,106.39999,NaN,NaN,103.644985,106.78511382978724,95.44139885000041,101.41979880000007,103.51219839999993,104.91549750000004,103.42175508219822,104.83689175025498,104.913073846154,106.92656911326402,102.89957857904399,95.44139885000041,101.41979880000007,103.51219839999993,104.91549750000004,105.98000000000002,28409392,33589128.8,65.00631060033336,NaN,1.5,2.75,NaN,NaN,1.1819100688970856,0.8457912728001449,20.564230316984865,0.09749119033450104,0.7650853011190861,0.6675941107845851,8.240860848215315,2.7225236532149104,NaN,NaN,NaN,677479423
1068215400,106.64,106.72,105.57001,105.61,NaN,NaN,103.80776222222222,106.8446885106383,95.5375488500004,101.46019870000008,103.60919859999993,104.96749700000005,103.50756860838652,104.91052110737355,104.97076615384631,107.01757608223856,102.92395622545406,95.5375488500004,101.46019870000008,103.60919859999993,104.96749700000005,105.96667000000001,31737008,34041679.2,57.85433091646749,NaN,1.5,2.75,NaN,NaN,1.1796300639758655,0.9322985453667044,21.580491545826103,0.05267737530111227,0.7334408299109754,0.6807634546098631,10.17374140256925,1.9106436360127415,NaN,NaN,NaN,645742415
1068474600,105.74001,105.84,105.00999,105.17999,NaN,NaN,103.97053944444446,106.90426319148936,95.6374488000004,101.51179860000008,103.68399839999992,104.98149700000006,103.57315376099882,104.93618481143322,105.09692000000017,106.97024795414622,103.22359204585412,95.6374488000004,101.51179860000008,103.68399839999992,104.98149700000006,105.34332666666668,25538304,34127119.2,54.34919006224987,NaN,1.5,2.75,NaN,NaN,1.1546572022633037,0.748328736754317,19.201300410436684,-0.011821114920078757,0.6659870609597647,0.6778081758798434,10.733152298249566,0.13328257171387828,NaN,NaN,NaN,620204111
1068561000,105.09,105.33,104.8,105.14999,NaN,NaN,104.13331666666667,106.96383787234043,95.7340487500004,101.56889850000007,103.73099819999992,104.97549650000005,103.63499047625378,104.95654721034434,105.23538000000015,106.81479653524192,103.65596346475837,95.7340487500004,101.56889850000007,103.73099819999992,104.97549650000005,105.09333,26809008,33542349.6,54.10291657512597,NaN,1.5,2.75,NaN,NaN,1.1100388306730677,0.7992584991720436,17.39962570449453,-0.05972181434159196,0.6031559079528535,0.6628777222944454,7.521520215615788,-0.028522535512696984,NaN,NaN,NaN,593395103
1068647400,105.23,106.47,105.16,106.33,NaN,NaN,104.29609388888889,107.02341255319149,95.83329875000041,101.64799850000007,103.79039819999993,105.04249600000006,103.74067712424383,105.08735223793059,105.44691846153862,106.80378001607723,104.090056907,95.83329875000041,101.64799850000007,103.79039819999993,105.04249600000006,105.98666666666666,28053696,32950974.4,61.49391436171042,NaN,1.5,2.75,NaN,NaN,1.125036771339277,0.8513768260522214,20.301445951798545,-0.017352176735282998,0.6411875013753416,0.6585396781106246,9.854231118038232,0.8823625125581092,NaN,NaN,NaN,621448799
1068733800,106.00999,106.53999,105.78,106.36,NaN,NaN,104.45887111111112,107.08298723404256,95.94294880000041,101.72639850000007,103.84939819999992,105.08999600000007,103.84339566839112,105.2085567866991,105.65691846153861,106.60846996451322,104.705366958564,95.94294880000041,101.72639850000007,103.84939819999992,105.08999600000007,106.22666333333335,29723600,32797479.2,61.66294172577634,NaN,1.5,2.75,NaN,NaN,1.0989620019579003,0.9062769677737916,21.712441731703322,0.0060246704309890875,0.666070516149361,0.6600458457183719,9.841589627155017,1.0066476733143421,NaN,NaN,NaN,651172399
1068820200,106.39999,106.95,105.28999,105.46001,NaN,NaN,104.62164833333334,107.14256191489362,96.0399488500004,101.80569860000007,103.90199839999993,105.14999700000006,103.90679230884638,105.23250471177538,105.68922769230784,106.58147033722612,104.79698504738955,96.0399488500004,101.80569860000007,103.90199839999993,105.14999700000006,105.89999999999999,49162704,33615554.4,54.004217423924544,NaN,1.5,2.75,NaN,NaN,1.1390368589609075,1.4624986818602046,19.942002864780036,-0.04309176907228207,0.6061811343780192,0.6492729034503013,11.216142003021544,-0.5000471270830158,NaN,NaN,NaN,602009695
1069079400,104.91,105.14,104.03999,104.92999,NaN,NaN,104.78442555555556,107.20213659574469,96.13344880000041,101.86699850000008,103.92699839999992,105.14449700000004,103.94691770849946,105.20369378684438,105.66999692307708,106.61455643791115,104.72543740824301,96.13344880000041,101.86699850000008,103.92699839999992,105.14449700000004,104.70332666666665,44438704,34448584.8,50.06082955779448,NaN,1.5,2.75,NaN,NaN,1.1591070833208421,1.2900008594837835,17.4067808967168,-0.11136199537094615,0.5100704092366186,0.6214324046075648,10.765385525575239,-0.7847958381993023,NaN,NaN,NaN,557570991
1069165800,105.24001,105.45,103.7,103.84,NaN,NaN,104.94720277777779,107.26171127659575,96.2257488000004,101.92879850000008,103.94379839999992,105.09349700000004,103.94272485718575,105.0738181880973,105.54999769230783,106.90741759791158,104.19257778670408,96.2257488000004,101.92879850000008,103.94379839999992,105.09349700000004,104.33,41167600,35168780,43.09208886578368,NaN,1.5,2.75,NaN,NaN,1.2013137202264963,1.1705723087351907,15.538339988212753,-0.22354076678298396,0.3420064461288348,0.5655472129118188,12.058423039079562,-1.8896447467876039,NaN,NaN,NaN,516403391
1069252200,104.03,105.00999,103.92,104.72,NaN,NaN,105.10998000000001,107.32128595744682,96.32509875000042,101.99969850000008,103.99899819999993,105.15249750000002,103.97320623533533,105.04012121780232,105.50538230769244,106.92923774552052,104.08152686986436,96.32509875000042,101.99969850000008,103.99899819999993,105.15249750000002,104.54999666666669,29836704,34954530.4,49.23615162049106,NaN,1.5,2.75,NaN,NaN,1.1990763116388894,0.8535861777733967,17.242057942352062,-0.23113031288885,0.2766343218007563,0.5077646346896063,13.390698447016666,-1.5789381183212552,NaN,NaN,NaN,546240095
1069338600,103.91,105.24001,103.75,103.78,NaN,NaN,105.27275722222222,107.38086063829788,96.4217487500004,102.05219850000009,104.02939839999993,105.17399700000003,103.96562952022414,104.92010967324973,105.33538153846168,106.99534545910194,103.67541761782141,96.4217487500004,102.05219850000009,104.02939839999993,105.17399700000003,104.25666999999999,53631696,35316124.8,43.79670965839644,NaN,1.5,2.75,NaN,NaN,1.2198572893789685,1.5186178071270153,14.983959206470459,-0.28838885766702926,0.14727856260581973,0.435667420272849,13.426266824951362,-1.732790455449293,NaN,NaN,NaN,492608399
1069425000,104.24001,104.33,103.62,104.21001,NaN,NaN,103.62,107.44043531914895,96.52569880000041,102.09659860000009,104.06459859999994,105.20549750000002,103.97521306845064,104.85248113294023,105.21615230769245,106.95765268105036,103.47465193433455,96.52569880000041,102.09659860000009,104.06459859999994,105.20549750000002,104.05333666666667,30025504,34230644.8,46.69773356528234,NaN,1.5,2.75,NaN,NaN,1.1834389115661845,0.877152743555681,16.742254703090726,-0.2856892468835547,0.07855586166840567,0.36424510855196035,13.506387041233003,-0.9222096332201655,NaN,NaN,NaN,522633903
1069684200,104.69,105.78,104.67999,105.59,NaN,NaN,103.6920005,107.50001,96.63359885000041,102.1650985000001,104.13459859999993,105.30349750000002,104.03853804615846,104.92272102504116,105.19692153846168,106.91581608485896,103.4780269920644,96.63359885000041,102.1650985000001,104.13459859999993,105.30349750000002,105.34999666666664,28967104,34054049.6,54.766889167969055,NaN,1.5,2.75,NaN,NaN,1.2110497035971715,0.8506214191923888,19.909521497563276,-0.18427389597855326,0.13390273857876878,0.31817663455732204,15.66727625837533,0.4184593835910026,NaN,NaN,NaN,551601007
1069770600,105.71001,106.42,105.45,105.99001,NaN,NaN,103.76400100000001,107.55958468085106,96.74639895000043,102.21799860000009,104.18279879999994,105.35099850000002,104.11506635807382,105.02436759408485,105.16538461538477,106.80819000928987,103.52257922147966,96.74639895000043,102.21799860000009,104.18279879999994,105.35099850000002,105.95333666666666,37582304,34181404.8,56.80799431894834,NaN,1.5,2.75,NaN,NaN,1.193831867625945,1.09949559475098,22.48460750800352,-0.08842182858675507,0.2076493488238782,0.29607117741063327,15.776370444570675,-0.3197498354180384,NaN,NaN,NaN,589183311
1069857000,106.42,106.45,105.39,106.37,NaN,NaN,103.83600150000001,107.61915936170213,96.86774890000042,102.2701987000001,104.24259879999994,105.410499,104.20349512834544,105.15252306131487,105.2238461538463,106.9762173555373,103.47147495215529,96.86774890000042,102.2701987000001,104.24259879999994,105.410499,106.07000000000001,33076304,34286955.2,58.71388900988693,NaN,1.5,2.75,NaN,NaN,1.1842724485098064,0.9646906179642337,24.70946705413222,-0.0021575416794078484,0.29337425031137343,0.2955317919907813,14.505792065399786,0.00940203083866596,NaN,NaN,NaN,622259615
1070029800,106.31,106.66,106.201,106.45,NaN,NaN,103.90800200000001,107.67873404255319,96.98824885000043,102.3288987000001,104.27959859999993,105.4629995,104.2915933586064,105.2760922935706,105.32153923076937,107.19093439418634,103.4521440673524,96.98824885000043,102.3288987000001,104.27959859999993,105.4629995,106.437,10507801,32855105.25,59.12284697596726,NaN,1.5,2.75,NaN,NaN,1.132467273616249,0.31982247264296926,26.32609840744544,0.05443545020705304,0.36357610474959756,0.3091406545425445,14.51117883604427,0.9387349764142882,NaN,NaN,NaN,632767416
1070289000,106.92999,107.67999,106.8,107.60001,NaN,NaN,103.98000250000001,107.73830872340426,97.10549895000042,102.4118988000001,104.35819879999994,105.578,104.42133518768067,105.49741778942102,105.51000230769247,107.7328096802365,103.28719493514845,97.10549895000042,102.4118988000001,104.35819879999994,105.578,107.36,38710704,33502405.25,64.55775537107365,NaN,1.5,2.75,NaN,NaN,1.13943318264366,1.1554604426498603,29.612433752476434,0.1576258201121059,0.5061729296826769,0.348547109570571,14.548434136763152,2.5445728146929145,NaN,NaN,NaN,671478120
1070375400,107.42999,107.77,107.07001,107.33,NaN,NaN,104.052003,107.79788340425532,97.21399895000042,102.48279870000012,104.45379879999993,105.6449995,104.53540047443829,105.67194942852377,105.58692538461554,107.9805649248514,103.19328584437969,97.21399895000042,102.48279870000012,104.45379879999993,105.6449995,107.39000333333333,35369904,33390940.45,62.45802864745368,NaN,1.5,2.75,NaN,NaN,1.1080443838833984,1.0592664813668045,29.013692935396342,0.19363149401075663,0.5905864770840168,0.39695498307326016,14.168912321957457,3.360939907550072,NaN,NaN,NaN,636108216
1070461800,107.64999,108.08,107.07001,107.16,NaN,NaN,104.1240035,107.85745808510639,97.32389900000042,102.54709870000012,104.53819879999993,105.71499999999999,104.63832594602894,105.81366853056913,105.64846384615402,108.15682505945058,103.14010263285745,97.32389900000042,102.54709870000012,104.53819879999993,105.71499999999999,107.43667,39108096,33774657.25,61.11036052561428,NaN,1.5,2.75,NaN,NaN,1.1010404993202987,1.1579124463209765,27.555114524616805,0.19158070433004254,0.6364308634858133,0.4448501591557708,12.016296573570141,2.3300229182582104,NaN,NaN,NaN,597000120
1070548200,107.17,107.72,106.94,107.60001,NaN,NaN,104.196004,107.91703276595744,97.4402490500004,102.61799890000012,104.66799899999995,105.80300049999998,104.75447041873369,105.98379628956255,105.81307923076942,108.52313671177183,103.10302174976701,97.4402490500004,102.61799890000012,104.66799899999995,105.80300049999998,107.42000333333333,36094896,33897551.65,63.31664754699633,NaN,1.5,2.75,NaN,NaN,1.0781090350831346,1.0648230991042682,27.10790092911685,0.20427712826528305,0.7001965694873746,0.4959194412220916,11.567737963791707,3.6808730005781425,NaN,NaN,NaN,633095016
1070634600,107.12,107.8,106.62,106.85001,NaN,NaN,104.2680045,107.97660744680852,97.54859915000038,102.68729900000011,104.79939919999995,105.8255015,104.83664844152845,106.06629283341374,105.96077307692325,108.67150055412068,103.25004559972581,97.54859915000038,102.68729900000011,104.79939919999995,105.8255015,107.09000333333334,28842704,33919217.25,57.344839560672916,NaN,1.5,2.75,NaN,NaN,1.0853869611486244,0.8503351886753814,25.65904843361601,0.1491420054554915,0.6823469480414559,0.5332049425859644,10.855425329472768,2.533345884910673,NaN,NaN,NaN,604252312
1070893800,106.74001,107.64,106.67999,107.57001,NaN,NaN,104.340005,108.03618212765957,97.66744920000039,102.7779991000001,104.95179939999997,105.92350199999998,104.94383909088027,106.20950399213623,106.24769692307709,108.78376762375424,103.71162622239993,97.66744920000039,102.7779991000001,104.95179939999997,105.92350199999998,107.29666666666667,32493104,33957022.05,61.13456202232598,NaN,1.5,2.75,NaN,NaN,1.0764314639237225,0.9568890921045888,28.110252905165567,0.1478536985187049,0.7180220657343455,0.5701683672156406,11.060120971240618,1.8751870442276664,NaN,NaN,NaN,636745416
1070980200,107.89999,107.92999,106.53999,106.74001,NaN,NaN,104.4120055,108.09575680851064,97.77879925000039,102.8502993000001,105.06799979999998,106.00150299999999,105.01427716574771,106.26002837383754,106.40308230769247,108.78877760659029,104.01738700879466,97.77879925000039,102.8502993000001,105.06799979999998,106.00150299999999,107.06999666666667,43621504,34861182.05,55.061419051090304,NaN,1.5,2.75,NaN,NaN,1.0988292165005995,1.2512915923916585,26.090612499444525,0.08112870035937703,0.6715792426648619,0.5904505423054849,10.655033283105231,0.7076138590797378,NaN,NaN,NaN,593123912
1071066600,106.8,106.98,105.96001,106.73,NaN,NaN,104.48400600000001,108.1553314893617,97.89624920000038,102.93479930000008,105.20359979999998,106.08050349999999,105.08156041414976,106.3047875763292,106.63000538461554,108.474281602877,104.78572916635409,97.89624920000038,102.93479930000008,105.20359979999998,106.08050349999999,106.55667,36924800,35366971.65,54.990468660687775,NaN,1.5,2.75,NaN,NaN,1.0931978438934142,1.0440475471130704,23.77561286640549,0.02903202395753346,0.6267405722524018,0.5977085482948683,10.52760937312077,0.3384412898373596,NaN,NaN,NaN,556199112
1071153000,106.67999,108.10001,106.67,107.92999,NaN,NaN,104.55600650000001,108.21490617021277,98.01419915000038,103.0223992000001,105.32059959999997,106.16050299999999,105.1932635351635,106.45956875953594,106.91615769230786,108.25475678517391,105.57755859944182,98.01419915000038,103.0223992000001,105.32059959999997,106.16050299999999,107.56666666666668,45474304,36238002.05,61.41008969695113,NaN,1.5,2.75,NaN,NaN,1.1172558550438842,1.2548788958413342,26.96064731589649,0.06598829346248158,0.6801939151229703,0.6142056216604888,12.075265860367367,1.3903147017379058,NaN,NaN,NaN,601673416
1071239400,107.99001,108.2,106.64999,108.14,NaN,NaN,104.62800700000001,108.27448085106383,98.13039920000037,103.11139910000009,105.43439959999998,106.24950299999998,105.30882182790218,106.61960983005633,107.11231153846173,108.36037563181252,105.86424744511093,98.13039920000037,103.11139910000009,105.43439959999998,106.24950299999998,107.66332999999999,34144896,36459066.85,62.42028515686399,NaN,1.5,2.75,NaN,NaN,1.1481668653978925,0.9365268765785759,29.35078663347754,0.09349530400967276,0.7310747516725797,0.637579447662907,12.069222732043952,0.5018493957389066,NaN,NaN,NaN,635818312
1071498600,109.17,109.23,107.48,107.60001,NaN,NaN,104.7000075,108.3340555319149,98.24794925000036,103.2024991000001,105.51859979999998,106.356503,105.39867234445504,106.71298127481288,107.23615769230788,108.32332828639224,106.14898709822353,98.24794925000036,103.2024991000001,105.51859979999998,106.356503,108.10333666666668,38688192,35935341.25,58.20141995533516,NaN,1.5,2.75,NaN,NaN,1.1911549464409001,1.076605666016877,26.87264691373044,0.06556139658540117,0.7195311933946584,0.6539697968092573,11.03289565466174,0.25156992453181704,NaN,NaN,NaN,597130120
1071585000,107.67999,108.5,107.52,108.16,NaN,NaN,104.772008,108.39363021276596,98.37499925000037,103.2817991000001,105.60459979999997,106.51800349999999,105.50695970349601,106.85079258197355,107.37385000000019,108.44056182868994,106.30713817131044,98.37499925000037,103.2817991000001,105.60459979999997,106.51800349999999,108.05999999999999,32905296,35358670.85,61.135061979419476,NaN,1.5,2.75,NaN,NaN,1.1760724502665505,0.930614618959864,28.78848995152204,0.074391263593105,0.7469588763006385,0.6725676127075335,11.273400961568017,0.933184023889511,NaN,NaN,NaN,630035416
1071671400,108.06,108.5,107.8,108.5,NaN,NaN,104.8440085,108.45320489361703,98.50024925000037,103.3681991000001,105.68939999999999,106.75100349999998,105.62433383277067,107.00785995511893,107.53154230769249,108.6113623321564,106.45172228322858,98.50024925000037,103.3681991000001,105.68939999999999,106.75100349999998,108.26666666666665,23204896,34460535.65,62.84036048236106,NaN,1.5,2.75,NaN,NaN,1.1420672752475114,0.6733759520072927,30.309843338816474,0.09159227536209047,0.7870579569101466,0.6954656815480561,11.238196571251084,0.836421855351131,NaN,NaN,NaN,653240312
1071757800,108.55,109.73,108.39,109.72,NaN,NaN,104.916009,108.51277957446808,98.63509925000037,103.47139920000009,105.8038,107.00100349999998,105.78494819226987,107.26615900701236,107.69461846153864,109.28579375118713,106.10344317189015,98.63509925000037,103.47139920000009,105.8038,107.00100349999998,109.28000000000002,29790496,34458225.25,68.22751265881303,NaN,1.5,2.75,NaN,NaN,1.1562053270155466,0.8645394759557444,33.21476958421894,0.1690892398679591,0.906827231383005,0.7377379915150459,12.551687551309211,2.685998812728236,NaN,NaN,NaN,683030808
1071844200,109.3,109.37,108.58,108.89999,NaN,NaN,104.9880095,108.57235425531915,98.76299915000038,103.56879910000009,105.89619979999999,107.25700299999997,105.9071066945338,107.42176195872547,107.8153869230771,109.51233846620275,106.11843537995145,98.76299915000038,103.56879910000009,105.89619979999999,107.25700299999997,108.94999666666668,41466608,33849970.85,61.74783383987184,NaN,1.5,2.75,NaN,NaN,1.1550478036572933,1.2250116309922907,34.13463579522674,0.14974195953997282,0.924915440940012,0.7751734814000392,12.686238426106279,1.2363854944328871,NaN,NaN,NaN,641564200
1072103400,108.83,109.66,108.78,109.66,NaN,NaN,105.06001,108.63192893617021,98.90469910000039,103.67149910000009,105.99799959999999,107.52950249999996,106.05427898102266,107.6349274864659,108.00769461538479,109.91727700290909,106.0981122278605,98.90469910000039,103.67149910000009,105.99799959999999,107.52950249999996,109.36666666666667,27635200,33730455.65,65.05992732367139,NaN,1.5,2.75,NaN,NaN,1.1354015319674864,0.8192951879083199,36.15840756445198,0.1712006921092718,0.989174346536629,0.8179736544273571,12.720033353948768,2.7356096369112186,NaN,NaN,NaN,669199400
1072189800,109.48,109.95,109.38,109.73,NaN,NaN,105.1320105,108.69150361702128,99.05074910000037,103.78369920000009,106.09459979999998,107.73650249999996,106.19842490333549,107.83445820204058,108.17154000000018,110.26932498343892,106.07375501656144,99.05074910000037,103.78369920000009,106.09459979999998,107.73650249999996,109.68666666666667,24755808,33519890.85,65.35744983007721,NaN,1.5,2.75,NaN,NaN,1.0950157082555236,0.7385408297055955,37.95020172556242,0.1726859135801233,1.0338310464025113,0.861145132822388,11.211865102443975,2.81083106905275,NaN,NaN,NaN,693955208
1072276200,109.52,109.88,109.42999,109.62,NaN,NaN,105.20401100000001,108.75107829787234,99.19354910000037,103.89479930000009,106.18159979999997,107.91800199999996,106.33260431889096,108.00450980184624,108.38461615384631,110.4648274585556,106.30440484913701,99.19354910000037,103.89479930000009,106.18159979999997,107.91800199999996,109.64332999999999,8055801,32043565.7,64.42900358657866,NaN,1.5,2.75,NaN,NaN,1.0489438719515571,0.25140151615523865,38.03026580246497,0.1496935018669534,1.0482620101560798,0.8985685082891264,11.30810744492174,1.5658391147817219,NaN,NaN,NaN,685899407
1072449000,109.71001,110.08,109.63,109.7,NaN,NaN,105.27601150000001,108.81065297872341,99.32274910000037,104.02759930000009,106.27579959999996,108.08450199999996,106.46465905148347,108.16598505881326,108.54846153846171,110.68108862410111,106.41583445282231,99.32274910000037,104.02759930000009,106.27579959999996,108.08450199999996,109.80333333333333,8308398,30805170.4,64.82041578168159,NaN,1.5,2.75,NaN,NaN,1.0068764525264455,0.26970790591698857,39.764086718628214,0.12434845845449805,1.0540040813572489,0.9296556229027508,9.941731749521177,1.4425744405400427,NaN,NaN,NaN,694207805
1072708200,110.10001,111.27,109.7843,111.16,NaN,NaN,105.34801200000001,108.87022765957447,99.45789910000036,104.1693993000001,106.39079959999995,108.32000199999996,106.64879006907235,108.45112933892628,108.88846076923095,111.16395986240855,106.61296167605335,99.45789910000036,104.1693993000001,106.39079959999995,108.32000199999996,110.7381,22547600,31407160.35,71.07571994372378,NaN,1.5,2.75,NaN,NaN,1.0470995630602704,0.7179127227272554,43.132890246485296,0.1866424209058033,1.162958649035005,0.9763162281292017,11.967781428714346,3.3085405847081235,NaN,NaN,NaN,716755405
1072794600,111.09,111.27,110.85001,111.17999,NaN,NaN,105.42001250000001,108.92980234042554,99.57989905000036,104.3011992000001,106.52919959999996,108.49900099999995,106.82648418401068,108.71102083045712,109.23076769230786,111.44241889157179,107.01911649304394,99.57989905000036,104.3011992000001,106.52919959999996,108.49900099999995,111.09999999999997,19581696,30450709.95,71.15135580536354,NaN,1.5,2.75,NaN,NaN,1.0023060228416796,0.6430620511690237,44.830047245805595,0.20827779203004138,1.2366634681667534,1.028385676136712,11.076294103042015,2.792150517751486,NaN,NaN,NaN,736337101
1072881000,111.22,111.52,110.84,111.28,NaN,NaN,105.492013,108.9893770212766,99.69984910000035,104.4311992000001,106.65399979999995,108.69650099999997,107.00113186306909,108.95568551327072,109.48846076923094,111.81166210160627,107.1652594368556,99.69984910000035,104.4311992000001,106.65399979999995,108.69650099999997,111.21333333333332,31503392,30257384.35,71.55215777583511,NaN,1.5,2.75,NaN,NaN,0.9792841640672734,1.04118028298768,43.50038563471802,0.20792696613358075,1.288294383803688,1.0803674176701072,11.078186358317945,2.562211981566821,NaN,NaN,NaN,767840493
1073053800,111.74001,112.19,110.73,111.23,NaN,NaN,105.5640135,109.04895170212767,99.81619905000036,104.5569993000001,106.78139979999995,108.90000099999997,107.16696982922325,109.17228689295922,109.72615307692324,112.08093561565568,107.3713705381908,99.81619905000036,104.5569993000001,106.78139979999995,108.90000099999997,111.38333333333334,38075600,30205759.55,71.02090416114042,NaN,1.5,2.75,NaN,NaN,1.0136210094910392,1.2605410546612128,44.75750819948931,0.18376681339676404,1.3100759344160622,1.1263091210192981,11.233126294142076,1.3762304046664282,NaN,NaN,NaN,729764893
1073313000,111.78,112.52,111.59,112.44,NaN,NaN,105.636014,109.10852638297872,99.93764910000034,104.68589930000012,106.95939999999993,109.14200049999997,107.37375532611645,109.48349766505834,110.09846000000016,112.52039638797754,107.67652361202278,99.93764910000034,104.68589930000012,106.95939999999993,109.14200049999997,112.18333333333334,27967392,29799384.35,75.71921671719514,NaN,1.5,2.75,NaN,NaN,1.0333623659559643,0.938522476555795,47.66781394254661,0.2259413656592688,1.4087358280933842,1.1827944624341153,11.13233091519349,3.250698186473658,NaN,NaN,NaN,757732285
1073399400,112.16,112.73,112,112.55,NaN,NaN,105.7080145,109.1681010638298,100.05204910000035,104.8209994000001,107.14339979999994,109.42699999999998,107.57674531332758,109.77554550648135,110.43615230769245,112.90651344842662,107.96579116695828,100.05204910000035,104.8209994000001,107.14339979999994,109.42699999999998,112.42666666666668,20501200,29382309.15,76.09859503132994,NaN,1.5,2.75,NaN,NaN,1.0116936255305384,0.6977395784429012,48.12464613512274,0.23676796990379367,1.4787544248138573,1.2419864549100637,9.271155438703499,2.635418566478206,NaN,NaN,NaN,778233485
1073485800,112.35001,113.06,111.89,112.92999,NaN,NaN,105.780015,109.22767574468085,100.18324905000036,104.95719930000013,107.33039959999992,109.69499899999998,107.78667647751081,110.07596879157836,110.77692076923093,113.30641833797351,108.24742320048834,100.18324905000036,104.95719930000013,107.33039959999992,109.69499899999998,112.62666333333334,30180000,29266653.95,77.41158021570942,NaN,1.5,2.75,NaN,NaN,1.0230012237069286,1.0312077373641821,49.15363764597779,0.2440692281142094,1.5470729900528255,1.3030037619386161,8.97794153352724,2.9162398614781733,NaN,NaN,NaN,808413485
1073572200,113.25,113.41,112.77,113.38,NaN,NaN,105.85201550000001,109.28725042553192,100.31254905000036,105.0947993000001,107.52539959999993,110.02699849999999,108.00602249800058,110.39063843047566,111.05845923076939,113.85533509988052,108.26158336165825,100.31254905000036,105.0947993000001,107.52539959999993,110.02699849999999,113.18666666666667,37044608,28937809.15,78.89051401388294,NaN,1.5,2.75,NaN,NaN,0.995643993442148,1.2801455634729695,51.3325077080684,0.2526903533870919,1.6188667036724809,1.366176350285389,8.868994867915628,3.4300310162379044,NaN,NaN,NaN,845458093
1073658600,112.83,113.5,112.27,112.39,NaN,NaN,105.92401600000001,109.34682510638298,100.43909905000035,105.21389930000011,107.67239979999994,110.30999849999998,108.1779431843535,110.58105381804941,111.32692153846172,113.90494987272511,108.74889320419832,100.43909905000035,105.21389930000011,107.67239979999994,110.30999849999998,112.71999999999998,54092304,29796184.35,68.29653163339646,NaN,1.5,2.75,NaN,NaN,1.0123837081962805,1.8154104352626612,50.46228845213455,0.16921280562869212,1.5776923573212542,1.4084795516925621,11.077762500714055,2.4521422060164064,NaN,NaN,NaN,791365789
1073917800,112.55,113.25,112.36,113.22,NaN,NaN,105.99601650000001,109.40639978723405,100.56944910000034,105.33749930000009,107.83319999999995,110.57449899999997,108.37567090261415,110.83238202585423,111.60076769230787,114.16864464468823,109.03289073992751,100.56944910000034,105.33749930000009,107.83319999999995,110.57449899999997,112.94333333333334,33566496,29200793.95,71.72475012605281,NaN,1.5,2.75,NaN,NaN,1.003642014753689,1.1495062790921136,52.72201918359868,0.1481481027915632,1.593664680182016,1.4455165773904528,11.34038664590843,1.8531845987765405,NaN,NaN,NaN,824932285
1074004200,113.09,113.23,111.75999,112.56,NaN,NaN,106.06801700000001,109.46597446808511,100.69869905000036,105.45859930000007,107.97640019999996,110.79549899999998,108.53976223976653,110.99691707101097,111.81846000000017,114.18715063273005,109.44976936727029,100.69869905000036,105.45859930000007,107.97640019999996,110.79549899999998,112.51666333333333,54286400,30207869.15,65.64592031868489,NaN,1.5,2.75,NaN,NaN,1.0369540136998543,1.7970946487630692,51.213179979216434,0.07188082996197842,1.5353676148429258,1.4634867848809474,10.390842592945363,1.241239543194777,NaN,NaN,NaN,770645885
1074090600,112.75999,113.66,112.67,113.5,NaN,NaN,106.1400175,109.52554914893618,100.84249900000036,105.58589930000008,108.14040019999995,111.09049849999997,108.73428136761882,111.23530592139088,112.11692153846171,114.27035024635214,109.96349283057128,100.84249900000036,105.58589930000008,108.14040019999995,111.09049849999997,113.27666666666666,30141392,29780529.15,69.59796782245367,NaN,1.5,2.75,NaN,NaN,1.0414572984355785,1.0121174089346228,53.60389477638052,0.06695614333683153,1.5471819640519868,1.4802258207151553,11.106383915397721,1.9949676491732555,NaN,NaN,NaN,800787277
1074177000,113.57001,114.06,112.58,113.78,NaN,NaN,106.212018,109.58512382978724,100.98119905000034,105.72599930000007,108.29619999999994,111.37149849999999,108.93215268653573,111.47765773840126,112.43076769230787,114.24650296091028,110.61503242370546,100.98119905000034,105.72599930000007,108.29619999999994,111.37149849999999,113.47333333333333,38432608,30056894.75,70.67995792443375,NaN,1.5,2.75,NaN,NaN,1.0727817771187518,1.2786619615787156,52.64646766862418,0.06473350310544101,1.5611426995969566,1.4964091964915156,11.082602181842546,2.2925469747370286,NaN,NaN,NaN,839219885
1074263400,114.03999,114.31,113.63,114.23,NaN,NaN,106.2840185,109.6446985106383,101.11174905000034,105.86899940000006,108.46560019999994,111.65799849999999,109.1399114047108,111.73978557283924,112.66692153846171,114.55716380212868,110.77667927479473,101.11174905000034,105.86899940000006,108.46560019999994,111.65799849999999,114.05666666666667,31925808,30492940.35,72.3811945728917,NaN,1.5,2.75,NaN,NaN,1.0447259358959842,1.0469901437366633,54.24883078838436,0.07502242978116325,1.5901872337179697,1.5151648039368064,10.981846575910488,1.5919601565279315,NaN,NaN,NaN,871145693
1074609000,114.53,114.64999,113.82001,114.2,NaN,NaN,106.356019,109.70427319148936,101.24424905000035,106.00989940000007,108.63280019999993,111.88199849999998,109.3383462515849,111.97409170875932,112.89923000000016,114.74314654175875,111.05531345824157,101.24424905000035,106.00989940000007,108.63280019999993,111.88199849999998,114.22333333333334,29879504,30497390.75,72.08092321675302,NaN,1.5,2.75,NaN,NaN,1.0293869404748428,0.9797396847794266,56.373719377264145,0.06181053174153073,1.5924279686137197,1.530617436872189,9.744007418966746,1.4660151043980505,NaN,NaN,NaN,841266189
1074695400,114.13,115.3,113.72,115.10001,NaN,NaN,106.4280195,109.76384787234043,101.37864910000033,106.15949950000008,108.80680059999993,112.1919995,109.56429384956196,112.271798212687,113.1930769230771,115.12651708730351,111.25963675885069,101.37864910000033,106.15949950000008,108.80680059999993,112.1919995,114.70666999999999,30743008,29961210.75,75.38063340582599,NaN,1.5,2.75,NaN,NaN,1.0687164447266395,1.026093646766261,58.650903386146446,0.09377154840605217,1.6478318723797543,1.554060323973702,10.371781787870992,1.921562199730996,NaN,NaN,NaN,872009197
1074781800,115.14,115.38,114.58,114.8,NaN,NaN,106.50002,109.82342255319149,101.51239910000032,106.29989960000006,108.99060059999994,112.44899950000001,109.76961565938306,112.51257933528824,113.46769230769247,115.21277543722849,111.72260917815646,101.51239910000032,106.29989960000006,108.99060059999994,112.44899950000001,114.92,29914000,30075150.75,72.3125883644321,NaN,1.5,2.75,NaN,NaN,1.0495224129604508,0.9946417309313071,58.01168343140658,0.07557442629439404,1.6485283568416946,1.5729539305473006,10.695281006533019,1.252425471864528,NaN,NaN,NaN,842095197
1074868200,115,115.37,113.95,114.42999,NaN,NaN,106.57202050000001,109.88299723404256,101.64359905000033,106.42979950000006,109.17560059999994,112.68399900000001,109.95237543744648,112.69518987478459,113.62076846153863,115.32709330419567,111.91444361888159,101.64359905000033,106.42979950000006,109.17560059999994,112.68399900000001,114.58333,49968608,31335790.75,68.60395811887076,NaN,1.5,2.75,NaN,NaN,1.0759850977489902,1.59461774552474,58.669476945886856,0.022253591860964317,1.600770920373506,1.5785173285125418,10.916210839790837,1.8150992081146036,NaN,NaN,NaN,792126589
1075127400,114.44,115.92999,114.38,115.87,NaN,NaN,106.64402100000001,109.94257191489362,101.78779905000034,106.56049950000008,109.39000079999994,112.99649900000001,110.18443914578191,112.99755274385272,113.87615307692325,115.83944231189643,111.91286384195006,101.78779905000034,106.56049950000008,109.39000079999994,112.99649900000001,115.39332999999999,30474096,32456705.5,74.15856139563428,NaN,1.5,2.75,NaN,NaN,1.10984259076692,0.9389152574342458,60.20020790033377,0.06517358867909406,1.6599843143614095,1.5948107256823154,10.832094514667292,2.3405758699876396,NaN,NaN,NaN,822600685
1075213800,115.85001,116.5,114.64999,114.67999,NaN,NaN,106.71602150000001,116.5,101.92364905000035,106.67369940000007,109.55700059999994,113.24549850000002,110.36073525771204,113.1577848634858,114.01076846153863,115.9357054094127,112.08583151366456,101.92364905000035,106.67369940000007,109.55700059999994,113.24549850000002,115.27665999999999,35353008,33808936,64.07053353362122,NaN,1.5,2.75,NaN,NaN,1.1627116914264255,1.0456705292352295,58.235519629894924,-0.0018247391097763188,1.592529801795095,1.5943545409048714,12.822664998588623,1.8834310589907617,NaN,NaN,NaN,787247677
1075300200,114.98,115.28,112.94,113.37,NaN,NaN,106.78802200000001,116.63258426966293,102.05474910000034,106.77329940000008,109.69720059999995,113.35599850000003,110.47874563976255,113.1779958288681,114.0099992307694,115.93595154267732,112.08404691886147,102.05474910000034,106.77329940000008,109.69720059999995,113.35599850000003,113.86333333333333,52884096,35325760.8,55.172929515025935,NaN,1.5,2.75,NaN,NaN,1.2468037134673955,1.4970405393222275,54.87972410031276,-0.14185826459360928,1.4170317101628598,1.558889974756469,14.291154129243262,-0.1145374449339167,NaN,NaN,NaN,734363581
1075386600,113.56,113.85001,112.56,113.48,NaN,NaN,106.86002250000001,116.76516853932584,102.17739910000033,106.87979940000008,109.85760039999994,113.47099900000003,110.59644188918362,113.20675813088067,114.09384538461555,115.81433810200667,112.37335266722442,102.17739910000033,106.87979940000008,109.85760039999994,113.47099900000003,113.29667,60119904,37352671.2,55.72889076802633,NaN,1.5,2.75,NaN,NaN,1.2498898767911526,1.6095208741055176,52.06982688011774,-0.22938428014101708,1.2721596245801976,1.5015439047212147,13.461478780795,-0.26366672525926976,NaN,NaN,NaN,794483485
1075473000,113.52,113.72,113.09,113.48,NaN,NaN,106.932023,116.89775280898877,102.29589910000033,106.97779950000007,110.02860059999993,113.58099900000002,110.70952259941171,113.2327811660349,114.11384538461554,115.79892102952344,112.42876973970765,102.29589910000033,106.97779950000007,110.02860059999993,113.58099900000002,113.43,30992800,37327141.6,55.72889076802633,NaN,1.5,2.75,NaN,NaN,1.2056120284489271,0.8303019912995427,53.266312963349975,-0.28590847718074697,1.1441583082452809,1.4300667854260278,13.36945181579392,-0.6565700779129826,NaN,NaN,NaN,794483485
1075732200,113.7,114.67999,113.12,113.97,NaN,NaN,107.0040235,117.03033707865168,102.42449910000033,107.08749950000006,110.23120059999994,113.717999,110.83738445825831,113.30299248355539,114.22230692307708,115.65614362825117,112.788470217903,102.42449910000033,107.08749950000006,110.23120059999994,113.717999,113.92332999999999,38850192,37365871.2,58.39467991890349,NaN,1.5,2.75,NaN,NaN,1.230924740702575,1.0397239714298432,54.60094774485389,-0.2881159446507635,1.0699218546125735,1.358037799263337,13.412542979523579,-0.20140105078809456,NaN,NaN,NaN,833333677
1075818600,113.74001,114.14,113.44,113.78,NaN,NaN,107.076024,117.16292134831461,102.54559910000033,107.20569940000007,110.41240059999993,113.78499900000001,110.95278114616976,113.34842177083583,114.24384538461555,115.64159218345876,112.84609858577235,102.54559910000033,107.20569940000007,110.41240059999993,113.78499900000001,113.78666666666668,25155904,37225296.8,56.962374349971476,NaN,1.5,2.75,NaN,NaN,1.1930015449381055,0.6757744373444459,55.407173519683745,-0.298902356102253,0.9844098541355208,1.2833122102377739,13.438052397134353,-1.1468374329420097,NaN,NaN,NaN,808177773
1075905000,113.19,113.73,112.78999,112.85001,NaN,NaN,107.1480245,117.29550561797753,102.66159920000031,107.31159960000006,110.59380079999994,113.79999950000001,111.0271822776925,113.30095398313718,114.17230769230787,115.7422765866179,112.60233879799783,102.66159920000031,107.31159960000006,110.59380079999994,113.79999950000001,113.12333333333333,39597600,38180116.8,50.44078304030522,NaN,1.5,2.75,NaN,NaN,1.1785021488710978,1.0371262143441113,52.41391510123806,-0.36104361604472457,0.832007690181868,1.1930513062265926,12.997845955302877,-1.6985975609756094,NaN,NaN,NaN,768580173
1075991400,113.08,113.53999,112.78,113.17999,NaN,NaN,107.220025,117.42808988764045,102.77079915000031,107.41889950000007,110.77320039999994,113.81249950000002,111.11160610993986,113.28943360379078,114.09153769230787,115.74703336634134,112.43604201827439,102.77079915000031,107.41889950000007,110.77320039999994,113.81249950000002,113.16666000000002,35990704,38470652,52.51803053081733,NaN,1.5,2.75,NaN,NaN,1.1486084239517338,0.9355366267252242,53.81232689879826,-0.37088431926993026,0.7294459071391799,1.1003302264091102,13.282413088124406,-1.0923709772237156,NaN,NaN,NaN,804570877
1076077800,113.42,114.7,113.2,114.45,NaN,NaN,107.29202550000001,117.56067415730337,102.88214920000031,107.54249950000006,110.95040039999992,113.8659995,111.2425235173932,113.39996373676308,114.11076846153864,115.77663277621375,112.44490414686354,102.88214920000031,107.54249950000006,110.95040039999992,113.8659995,114.11666666666667,37237296,38480286.4,59.54599471702847,NaN,1.5,2.75,NaN,NaN,1.1751371079551813,0.9676979950960033,57.621004372198385,-0.28659234194652505,0.7420897989759538,1.028682140922479,15.01459516281006,-1.2255113489255214,NaN,NaN,NaN,841808173
1076337000,114.67,114.87,114.28999,114.48,NaN,NaN,107.36402600000001,117.6932584269663,102.99774920000031,107.65149950000006,111.12020019999991,113.9704995,111.36948337945621,113.50282433326184,114.06307538461557,115.64637774132119,112.47977302790996,102.99774920000031,107.65149950000006,111.12020019999991,113.9704995,114.54666333333336,24859904,37018666.4,59.697744808454864,NaN,1.5,2.75,NaN,NaN,1.1326280288155257,0.6715505018840981,59.152492062470344,-0.22619988823708614,0.7459322806261213,0.9721321688632074,12.769682650359078,-0.17438962106641243,NaN,NaN,NaN,866668077
1076423400,114.28,115.14,114.25999,114.85001,NaN,NaN,107.43602650000001,117.82584269662921,103.1208492500003,107.76619960000008,111.28980039999992,114.05200000000002,111.50597461947754,113.63112773009405,114.06692230769251,115.6575938119452,112.47625080343981,103.1208492500003,107.76619960000008,111.28980039999992,114.05200000000002,114.75,27933296,36737006.4,61.610489055249616,NaN,1.5,2.75,NaN,NaN,1.114583883900131,0.760358525021244,61.606060891747404,-0.16173886595995213,0.7699585864132672,0.9316974523732193,11.54137540412157,1.3054688189115224,NaN,NaN,NaN,894601373
1076509800,114.8,116.39,114.17,116.07001,NaN,NaN,107.50802700000001,117.95842696629214,103.2422493500003,107.88089960000006,111.48220059999993,114.22750050000002,111.68495639910587,113.86340223198985,114.19307769230788,116.10634403043278,112.27981135418298,103.2422493500003,107.88089960000006,111.48220059999993,114.22750050000002,115.54333666666666,42976896,36171531.2,67.14697249756402,NaN,1.5,2.75,NaN,NaN,1.1935421779072644,1.188141463029909,64.10831213038458,-0.043493885370086915,0.8773300956606107,0.9208239810306976,10.27809418099713,2.2823493126542056,NaN,NaN,NaN,937578269
1076596200,115.98,116.27,115.58,115.64999,NaN,NaN,107.58002750000001,118.09101123595505,103.3615493500003,108.00069950000007,111.64320019999992,114.33500000000001,111.84044791286642,114.03355344799081,114.17615384615405,116.03284344722671,112.31946424508139,103.3615493500003,108.00069950000007,111.64320019999992,114.33500000000001,115.83333,27828496,36055886.4,63.738810693922794,NaN,1.5,2.75,NaN,NaN,1.157574879485317,0.7718156112229153,62.39611356373877,-0.0022998726029105354,0.9179491402770594,0.92024901287997,10.826695861086796,1.9122224180472316,NaN,NaN,NaN,909749773
1076682600,115.82001,116.2,114.75,115.13,NaN,NaN,107.652028,118.22359550561798,103.4776493500003,108.12649950000007,111.79920019999992,114.4025,111.96944995549912,114.13797692913454,114.21077000000021,116.11978560558889,112.30175439441153,103.4776493500003,108.12649950000007,111.79920019999992,114.4025,115.35999999999999,44741904,36371351.2,59.698917098304875,NaN,1.5,2.75,NaN,NaN,1.1784623880935088,1.2301413756660213,60.17800626245689,-0.01793398193779505,0.8978315354577262,0.9157655173955213,11.406993520205098,1.0178117048346027,NaN,NaN,NaN,865007869
1077028200,115.85001,116.42999,115.77,116.17,NaN,NaN,107.7240285,118.35617977528089,103.59899940000028,108.25879950000007,111.97940019999993,114.49950000000001,112.13417740822464,114.33150293588363,114.42615461538483,116.52909892274856,112.3232103080211,103.59899940000028,108.25879950000007,111.97940019999993,114.49950000000001,116.12333000000002,23988000,35974460.8,64.53985497411915,NaN,1.5,2.75,NaN,NaN,1.187142931801116,0.666806380597649,63.44109180726372,0.03122850113433573,0.954801143813441,0.9235726426791052,12.129460933873796,2.1005449112322028,NaN,NaN,NaN,888995869
1077114600,116.2,116.60001,115.35001,115.66,NaN,NaN,107.796029,118.48876404494382,103.71124935000029,108.40429950000005,112.14059999999992,114.57250000000002,112.27244496084329,114.45802646579948,114.59384692307715,116.71584269018032,112.47185115597398,103.71124935000029,108.40429950000005,112.14059999999992,114.57250000000002,115.87000666666665,28660400,35913505.6,60.68994097062287,NaN,1.5,2.75,NaN,NaN,1.1916327223867504,0.7980396099232373,61.37003985273744,0.019438499420447952,0.9478707669546651,0.9284322675342171,12.51851499188322,2.490021932652021,NaN,NaN,NaN,860335469
1077201000,116.33,116.39,115.06,115.23,NaN,NaN,107.8680295,118.62134831460673,103.82224935000029,108.55379950000004,112.30819979999991,114.57899950000001,112.38842751139845,114.53154775477095,114.72846230769254,116.77129393687397,112.6856306785111,103.82224935000029,108.55379950000004,112.30819979999991,114.57899950000001,115.56,51183104,36935510.4,57.571663311327306,NaN,1.5,2.75,NaN,NaN,1.2015160993591252,1.3857424317601958,59.096388268737876,-0.024876178706345287,0.8973370441512856,0.9222132228576309,11.449702321910282,1.8112830722109097,NaN,NaN,NaN,809152365
1077287400,115.48,115.5616,114.32001,114.88,NaN,NaN,107.94003000000001,118.75393258426966,103.9270993500003,108.70309950000002,112.4543995999999,114.5829995,112.48613623644165,114.564733682888,114.79846230769252,116.79436365116531,112.80256096421972,103.9270993500003,108.70309950000002,112.4543995999999,114.5829995,114.92053666666669,46728800,37776250.4,55.09047975242533,NaN,1.5,2.75,NaN,NaN,1.2043785208334736,1.2369888357156802,56.85659661176023,-0.08209153429848659,0.8195988049845226,0.9016903392830092,11.796078430449422,0.3757099169943142,NaN,NaN,NaN,762423565
1077546600,115.22,115.25999,114.17,114.59,NaN,NaN,108.01203050000001,118.88651685393259,104.0330993500003,108.83969960000002,112.6113993999999,114.59100000000001,112.56864069775767,114.56713999880343,114.86077000000022,116.77448518599908,112.94705481400135,104.0330993500003,108.83969960000002,112.6113993999999,114.59100000000001,114.67333,36361600,37095900,53.0503716282342,NaN,1.5,2.75,NaN,NaN,1.1962079122025113,0.9802053596219529,54.49893706073117,-0.1403772980730893,0.7262187166916476,0.8665960147647369,10.202418954868605,0.09608665269042578,NaN,NaN,NaN,726061965
1077633000,114.27,114.99001,113.89999,114.39,NaN,NaN,108.08403100000001,119.0191011235955,104.1427993500003,108.98409960000001,112.76459939999991,114.51700000000001,112.64006655274757,114.55026952272691,114.97923076923098,116.53817855124586,113.4202829872161,104.1427993500003,108.98409960000001,112.76459939999991,114.51700000000001,114.42666666666665,43958896,37770140,51.630339110422604,NaN,1.5,2.75,NaN,NaN,1.188623061330903,1.1638531390140465,55.2903747565567,-0.19021499890817384,0.6288272661295196,0.8190422650376934,10.257196513246532,-0.4005310926834024,NaN,NaN,NaN,682103069
1077719400,114.46001,115.06,114.32001,114.87,NaN,NaN,108.15603150000001,119.15168539325843,104.24849935000029,109.11199960000002,112.90339959999991,114.5265005,112.72751492322806,114.58072004437196,115.10923153846173,116.27983237342971,113.93863070349374,104.24849935000029,109.11199960000002,112.90339959999991,114.5265005,114.75000333333332,31234304,37564204.8,54.76020960600288,NaN,1.5,2.75,NaN,NaN,1.1565778426644104,0.8314911540467377,57.82723178137233,-0.18831549307321804,0.5836478986961708,0.7719633917693889,10.38416556646699,-1.0338674046810126,NaN,NaN,NaN,713337373
1077805800,114.61,115.28999,114.34,114.94,NaN,NaN,108.22803200000001,119.28426966292135,104.34879935000028,109.23689960000002,113.03939959999991,114.6050005,112.81427904388578,114.6149371830032,115.14692384615404,116.26034952116314,114.03349817114494,104.34879935000028,109.23689960000002,113.03939959999991,114.6050005,114.85666333333334,29685600,36404280,55.215327814397256,NaN,1.5,2.75,NaN,NaN,1.1418215681883812,0.8154425798285256,59.967408676597856,-0.17982371671259822,0.547183745878641,0.7270074625912393,7.982552628355074,-0.6139127206150253,NaN,NaN,NaN,743022973
1077892200,115.19,115.74001,114.63,115.02,NaN,NaN,108.30003250000001,119.41685393258427,104.45034930000028,109.35319960000002,113.18779939999992,114.6820005,112.90077790490986,114.65351459414576,115.1884623076925,116.23770685081907,114.13921776456594,104.45034930000028,109.35319960000002,113.18779939999992,114.6820005,115.13000333333332,39275008,35362035.2,55.76305635462899,NaN,1.5,2.75,NaN,NaN,1.1395493133177828,1.1106546265753392,62.27490979328421,-0.16659715458565127,0.5187610193591752,0.6853581739448265,7.842535418823484,-0.09554416746286758,NaN,NaN,NaN,782297981
1078151400,115.42999,116.34,115.25,116.16,NaN,NaN,108.372033,119.54943820224719,104.55859935000029,109.47619960000002,113.34779939999991,114.8160005,113.02859053608987,114.7969893947033,115.28923076923095,116.43617328776244,114.14228825069947,104.55859935000029,109.47619960000002,113.34779939999991,114.8160005,115.91666666666667,33192800,35472035.2,62.75372022137546,NaN,1.5,2.75,NaN,NaN,1.1524386480807987,0.9357455757148098,65.54947423412634,-0.08306984644981907,0.5815208658825526,0.6645907123323717,9.369633664547987,-0.008608074373766993,NaN,NaN,NaN,815490781
1078237800,115.94,116.97,115.23,115.48,NaN,NaN,108.4440335,116.97,104.66044935000029,109.58839970000001,113.4873993999999,114.8915005,113.12472424055693,114.86203802377918,115.24384538461558,116.30726505994599,114.18042570928517,104.66044935000029,109.58839970000001,113.4873993999999,114.8915005,115.89333333333333,38607392,35459895.2,56.97047156386039,NaN,1.5,2.75,NaN,NaN,1.194407316075027,1.0887621574245374,64.042158739613,-0.07581684734697258,0.5698196531486559,0.6456365004956285,8.512045394915347,-0.15562856648797563,NaN,NaN,NaN,776883389
1078324200,115.25,115.87,114.92,115.69,NaN,NaN,108.516034,116.98958333333333,104.7645493500003,109.70529970000001,113.60679939999989,114.9870005,113.22532328994686,114.94089154532402,115.2469230769233,116.31524698673445,114.17859916711214,104.7645493500003,109.70529970000001,113.60679939999989,114.9870005,115.49333333333335,31355392,35769869.6,58.250097172783306,NaN,1.5,2.75,NaN,NaN,1.1769496506410968,0.8765867013392746,63.1135117016589,-0.059780798936084456,0.5709105018255229,0.6306913007616074,8.23935393211097,0.3992015968063818,NaN,NaN,NaN,808238781
1078410600,115.72,116.10001,115.52,115.99001,NaN,NaN,108.5880345,117.00916666666666,104.88124945000028,109.8223998,113.74859979999991,115.14400049999999,113.3337423766156,115.04080758862649,115.3130776923079,116.44864132212439,114.17751406249141,104.88124945000028,109.8223998,113.74859979999991,115.14400049999999,115.87000666666665,21073296,34843654.4,60.076699045320154,NaN,1.5,2.75,NaN,NaN,1.1343111041667329,0.6047958046558974,65.22368472505751,-0.03319986107744277,0.5891914744148039,0.6223913354922467,7.980999890696402,0.9662343314763254,NaN,NaN,NaN,829312077
1078497000,115.42,116.95,115.28,116.38,NaN,NaN,108.66003500000001,117.02875,105.00084940000029,109.9404997,113.88299979999991,115.304001,113.45320345988559,115.16834972304302,115.32923153846174,116.51783194656944,114.14063113035404,105.00084940000029,109.9404997,113.88299979999991,115.304001,116.20333333333333,55923008,35840269.6,62.38079452543837,NaN,1.5,2.75,NaN,NaN,1.172574596726252,1.5603400483349041,67.78716450290413,0.00441497510247979,0.6279100543703464,0.6234950792678666,7.737313138696421,1.5620909328911703,NaN,NaN,NaN,885235085
1078756200,116.34,116.62,114.91,114.96001,NaN,NaN,108.73203550000001,117.04833333333333,105.11239950000028,110.0410999,113.98759999999992,115.32950149999999,113.51229391243909,115.14850784465797,115.27538615384636,116.46259115351894,114.08818115417377,105.11239950000028,110.0410999,113.98759999999992,115.32950149999999,115.49667,39289600,35942884.8,50.868984901089675,NaN,1.5,2.75,NaN,NaN,1.2109621255315202,1.0931120364606906,65.80510208497391,-0.06854494465809291,0.5378138984452505,0.6063588431033434,10.876867522609583,0.4983040475566014,NaN,NaN,NaN,845945485
1078842600,115.10001,115.21001,114.24001,114.5,NaN,NaN,108.80403600000001,117.06791666666666,105.21704945000029,110.1333999,114.08519999999992,115.3305015,113.55102748450031,115.08674519278578,115.21923230769251,116.476690371033,113.96177424435201,105.21704945000029,110.1333999,114.08519999999992,115.3305015,114.65000666666666,39749504,36687364.8,47.79207184085127,NaN,1.5,2.75,NaN,NaN,1.1937505451364114,1.0834657713000964,63.502077645540524,-0.1455663909929794,0.42440085436211916,0.5699672453550986,11.108817541503328,-0.32210324714895494,NaN,NaN,NaN,806195981
1078929000,114.72,114.77,112.56,112.58,NaN,NaN,108.87603650000001,117.0875,105.3111495000003,110.20929980000001,114.14279999999991,115.21700099999998,113.51294797530421,114.84800755537762,115.04230923076942,116.93012017933724,113.1544982822016,105.3111495000003,110.20929980000001,114.14279999999991,115.21700099999998,113.30333333333333,67802816,38680840.8,37.57586309736375,NaN,1.5,2.75,NaN,NaN,1.2663397919123816,1.752878546528389,60.063447711369676,-0.3139373077580533,0.17754561065753194,0.4914829184155852,14.374251534942195,-2.0532451713937703,NaN,NaN,NaN,738393165
1079015400,112.39999,113.27,111.10001,111.12,NaN,NaN,108.94803700000001,117.10708333333334,105.38974955000029,110.26639980000002,114.14199999999991,114.96950049999998,113.41910687823346,114.49295921677023,114.77538615384634,117.59488698591218,111.9558853217805,105.38974955000029,110.26639980000002,114.14199999999991,114.96950049999998,111.83000333333332,89377632,41000877.6,31.97800838505229,NaN,1.5,2.75,NaN,NaN,1.3308862353472113,2.179895583503315,56.68170700386918,-0.5006663691953693,-0.1343500430786264,0.3663163261167429,15.549243855618817,-3.390714658320285,NaN,NaN,NaN,649015533
1079101800,111.73,112.71001,111.58,112.58,NaN,NaN,109.0200375,117.12666666666667,105.47429955000031,110.34959990000002,114.17000019999992,114.81600099999999,113.38620072614587,114.31077262469688,114.63615538461555,117.68727579654012,111.58503497269098,105.47429955000031,110.34959990000002,114.17000019999992,114.81600099999999,112.29000333333333,54026608,42310783.2,41.38230051003332,NaN,1.5,2.75,NaN,NaN,1.3493950756795527,1.2768992657172085,59.601942915191714,-0.5016246158238326,-0.26071444366304775,0.24091017216078478,18.130409474099658,-3.081955922865012,NaN,NaN,NaN,703042141
1079361000,112.27,112.35001,110.89999,111.2,NaN,NaN,109.092038,117.14625,105.55319955000031,110.41120000000002,114.16840019999992,114.61950099999997,113.30046736433623,114.01450856520194,114.35384769230785,117.90443821907904,110.80325716553666,105.55319955000031,110.41120000000002,114.16840019999992,114.61950099999997,111.48333333333333,57687296,42958052.8,36.27702333214399,NaN,1.5,2.75,NaN,NaN,1.3730104274167272,1.342875019698286,56.3879442789066,-0.5661939431116281,-0.4668322567287504,0.09936168638287773,17.204848548661143,-3.706269483893316,NaN,NaN,NaN,645354845
1079447400,111.78,112.06,110.84,111.78999,NaN,NaN,109.1640385,117.16583333333332,105.62739950000032,110.48049990000001,114.17959999999994,114.40050049999998,113.24123295789167,113.80264965423032,114.1115392307694,117.8915787177536,110.33149974378519,105.62739950000032,110.48049990000001,114.17959999999994,114.40050049999998,111.56333000000001,60105504,44763928,39.70200174334125,NaN,1.5,2.75,NaN,NaN,1.3620811111726752,1.3427218451428122,58.06172046393172,-0.5402380025033268,-0.5759358167462807,-0.03569781424295396,18.01825193288926,-3.3710865243322625,NaN,NaN,NaN,705460349
1079533800,112.17999,113.25999,112.10001,113.03999,NaN,NaN,109.236039,117.18541666666667,105.70584940000033,110.57549990000001,114.19159979999995,114.2695,113.23334107719003,113.73001540144648,113.95923076923093,117.74013886967745,110.1783226687844,105.70584940000033,110.57549990000001,114.19159979999995,114.2695,112.79999666666667,41879200,45424868,46.28883138213738,NaN,1.5,2.75,NaN,NaN,1.3697896032317696,0.921944341148113,61.44415453055501,-0.41555162305755633,-0.5551373430648994,-0.13958572000734304,19.684479361649046,-2.5433397238262114,NaN,NaN,NaN,747339549
1079620200,112.71001,113.27,111.92999,113.07001,NaN,NaN,109.3080395,117.205,105.78244945000033,110.67269990000001,114.20199999999996,114.16150049999999,113.22693593690808,113.66715774416586,113.72153923076938,117.30236331299464,110.14071514854412,105.78244945000033,110.67269990000001,114.20199999999996,114.16150049999999,112.75666666666666,60025008,45866963.2,46.44015204320383,NaN,1.5,2.75,NaN,NaN,1.367662488715214,1.308676306697366,60.07914615576463,-0.31242833061781133,-0.5301211332796072,-0.21769280266179586,19.517357289227792,-2.8441227014951016,NaN,NaN,NaN,807364557
1079706600,112.41,112.57001,111.03999,111.06,NaN,NaN,109.38004000000001,117.22458333333333,105.84194945000034,110.74749990000001,114.16460019999997,113.97050049999999,113.14195805702933,113.41885700662625,113.38153923076938,117.06774158760646,109.69533687393229,105.84194945000034,110.74749990000001,114.16460019999997,113.97050049999999,111.55666666666667,48643296,45962688,38.59896968512198,NaN,1.5,2.75,NaN,NaN,1.4149737395212696,1.0583213932135562,58.21515780957131,-0.3577041181145932,-0.6648229503050374,-0.30711883219044417,20.92991633090704,-3.3924927459557415,NaN,NaN,NaN,758721261
1079965800,110.53999,110.57001,109.10001,109.64999,NaN,NaN,109.45204050000001,117.24416666666667,105.89194945000034,110.80769980000001,114.08999999999996,113.72349999999997,113.00501813322425,113.05991729170947,112.91692307692323,116.83730248257078,108.99654367127567,105.89194945000034,110.80769980000001,114.08999999999996,113.72349999999997,109.77333666666668,62759008,47282558.4,34.23245767440636,NaN,1.5,2.75,NaN,NaN,1.4539034724126076,1.3273183627051788,54.884068821544446,-0.4545142640205053,-0.8752616622160758,-0.4207473981955705,20.998130959603916,-4.235816593886461,NaN,NaN,NaN,695962253
1080052200,110.25,110.39999,109.36,109.46001,NaN,NaN,109.52404100000001,117.26375,105.94294955000034,110.85190000000003,114.03140019999995,113.47700049999996,112.86599820643114,112.71706897821333,112.41461538461553,116.30451486038027,108.5247159088508,105.94294955000034,110.85190000000003,114.03140019999995,113.47700049999996,109.74,54104304,47789828.8,33.67962141247429,NaN,1.5,2.75,NaN,NaN,1.424338224383136,1.1321301071494947,56.200012329858225,-0.499654805237312,-1.0453159047422105,-0.5456610995048985,21.066977951021354,-2.771353704032689,NaN,NaN,NaN,641857949
1080138600,109.58,110.14,108.85001,109.55,NaN,NaN,108.85001,117.28333333333333,105.99944955000034,110.89560010000001,113.95800019999996,113.21100049999998,112.7359590610809,112.41544336124063,111.8892307692309,115.31178728147076,108.46667425699106,105.99944955000034,110.89560010000001,113.95800019999996,113.21100049999998,109.51333666666666,51594800,48807853.6,34.22151419383589,NaN,1.5,2.75,NaN,NaN,1.4147419226414837,1.0571003679620936,53.988301076853745,-0.49103765176982894,-1.1594581642171846,-0.6684205124473557,19.659047868123537,-1.4128869690424832,NaN,NaN,NaN,693452749
1080225000,110.08,111.3,109.78999,111,NaN,NaN,108.9130221686747,117.30291666666666,106.05819955000034,110.95160020000002,113.92680019999995,113.01400049999998,112.66788223515617,112.28063923159867,111.58461461538475,114.53157736838884,108.63765186238066,106.05819955000034,110.95160020000002,113.92680019999995,113.01400049999998,110.69666333333335,49982096,49822678.4,42.38968898468698,NaN,1.5,2.75,NaN,NaN,1.438688928167092,1.0031996995167567,56.67815128042402,-0.3612661070540293,-1.1200031462648923,-0.758737039210863,20.35977835869707,-1.403446438088469,NaN,NaN,NaN,743434845
1080311400,110.955,111.78999,110.8,111.03,NaN,NaN,108.97603433734939,117.32249999999999,106.11184955000033,111.00890020000003,113.87740019999994,112.81450049999998,112.60365155926769,112.16153073335117,111.31769153846167,113.74236078623618,108.89302229068717,106.11184955000033,111.00890020000003,113.87740019999994,112.81450049999998,111.20666333333334,37413104,49729583.2,42.54864587424094,NaN,1.5,2.75,NaN,NaN,1.4066390047265858,0.7523309384985957,57.69720061115415,-0.25215785995218953,-1.0739343641510999,-0.8217765041989104,18.58445283105683,-0.15287769784172814,NaN,NaN,NaN,780847949
1080570600,111.63,112.74001,111.58,112.59,NaN,NaN,109.03904650602409,117.34208333333333,106.17174955000033,111.07490010000004,113.85360019999995,112.6360005,112.60311620400229,112.20233733017487,111.3184607692309,113.74473721999271,108.89218431846908,106.17174955000033,111.07490010000004,113.85360019999995,112.6360005,112.30333666666667,44116800,50275783.2,50.23761857402995,NaN,1.5,2.75,NaN,NaN,1.4283083615318295,0.8774960267550839,60.68397011669152,-0.0635048576759556,-0.9011575762938548,-0.8376527186178993,19.03406843718617,0.7156365252380829,NaN,NaN,NaN,824964749
1080657000,112.3,113.07001,112.22,112.97,NaN,NaN,109.1020586746988,117.36166666666666,106.23879955000034,111.14700020000002,113.82840019999996,112.51050049999999,112.61750380384534,112.2754480606344,111.4607684615386,114.036219581009,108.88531734206822,106.23879955000034,111.14700020000002,113.82840019999996,112.51050049999999,112.75333666666666,39061392,50298483.2,51.92544207798137,NaN,1.5,2.75,NaN,NaN,1.3870013357081272,0.7765918476046609,63.05389445164052,0.08995565110349979,-0.7252081547385245,-0.8151638058420243,18.916324128441953,-0.06191614135847342,NaN,NaN,NaN,864026141
1080743400,112.99001,113.39999,112.38,113.10001,NaN,NaN,109.16507084337348,117.38125,106.29599960000033,111.21960030000002,113.80640039999997,112.381001,112.63642561545925,112.35397776914542,111.5007692307694,114.15932380093497,108.84221466060382,106.29599960000033,111.21960030000002,113.80640039999997,112.381001,112.96,48596496,51160538.4,52.518811687257184,NaN,1.5,2.75,NaN,NaN,1.3607862403004043,0.9498824195329423,65.03045197951997,0.19715472839657622,-0.568720395346304,-0.7658751237428802,17.809923971415422,0.026532234321020347,NaN,NaN,NaN,912622637
1080829800,113.07001,113.87,113.05,113.78,NaN,NaN,109.22808301204819,117.40083333333334,106.35659960000032,111.29340040000002,113.78000019999996,112.2705005,112.68127166975496,112.48978941017918,111.69923076923092,114.61143930509941,108.78702223336244,106.35659960000032,111.29340040000002,113.78000019999996,112.2705005,113.56666666666668,45114304,52362588.8,55.60521321656896,NaN,1.5,2.75,NaN,NaN,1.3221586517075188,0.861575125177921,67.4954449767089,0.30438756713719495,-0.3853906648213865,-0.6897782319585815,18.134574165027807,2.4491265982351873,NaN,NaN,NaN,957736941
1080916200,114.81,114.84,113.89999,114.64,NaN,NaN,109.29109518072289,117.42041666666667,106.42194955000032,111.38370040000001,113.77680019999997,112.1835005,112.75808454545084,112.6945713711145,111.91846230769247,115.22710784334701,108.60981677203792,106.42194955000032,111.38370040000001,113.77680019999997,112.1835005,114.45999666666667,50997696,52116323.2,59.21599563568685,NaN,1.5,2.75,NaN,NaN,1.3034330337284104,0.978535953204005,68.89403139021503,0.4168143011254506,-0.16876035555176827,-0.5855746566772189,14.029310114119319,4.550853128212777,NaN,NaN,NaN,1008734637
1081171800,114.46001,115.38,114.44,115.27,NaN,NaN,109.35410734939758,117.44,106.49819955000032,111.48460050000001,113.79360039999997,112.199,112.85659103386453,112.93985028815122,112.09000153846169,115.81809183120828,108.3619112457151,106.49819955000032,111.48460050000001,113.79360039999997,112.199,115.02999999999999,30280096,51665848,61.675101043065816,NaN,1.5,2.75,NaN,NaN,1.277473531319238,0.5860756606569199,68.21897864965942,0.5109748060772363,0.053143850919326496,-0.4578309551579098,9.682128759152377,5.307865402168335,NaN,NaN,NaN,1039014733
1081258200,114.83,115.17999,114.62,114.89999,NaN,NaN,109.41711951807228,117.45958333333333,106.57549950000033,111.58210050000001,113.77420019999998,112.2189995,112.93672432665416,113.12653026070825,112.23076923076941,116.22494393162042,108.2365945299184,106.57549950000033,111.58210050000001,113.77420019999998,112.2189995,114.89999333333334,28480096,51102377.6,59.409412877910704,NaN,1.5,2.75,NaN,NaN,1.2326539933678633,0.5573144995899368,66.01076885976389,0.5237674263452563,0.19687832777366054,-0.3268890985715957,10.086764648354128,4.883605659516207,NaN,NaN,NaN,1010534637
1081344600,114.98,114.98,114.11,114.63,NaN,NaN,109.48013168674699,117.47916666666666,106.65654950000035,111.66510050000001,113.7732004,112.3214995,113.00312729423635,113.26971785492651,112.5053846153848,116.62863513585062,108.38213409491898,106.65654950000035,111.66510050000001,113.7732004,112.3214995,114.57333333333334,45898400,50007156.8,57.742530409641724,NaN,1.5,2.75,NaN,NaN,1.2067501366987305,0.9178366245369104,65.08125285667411,0.490078893381267,0.285709518154988,-0.20436937522627896,10.69523314305812,3.270270270270266,NaN,NaN,NaN,964636237
1081431000,115.41,115.41,113.74001,114.37,NaN,NaN,109.54314385542169,115.41,106.73579950000034,111.74520050000001,113.79320039999999,112.48399950000001,113.05673014544277,113.3745066306478,112.8684623076925,116.7459581316931,108.99096648369189,106.73579950000034,111.74520050000001,113.79320039999999,112.48399950000001,114.50667000000001,46937808,47885165.6,56.10985731766666,NaN,1.5,2.75,NaN,NaN,1.239838698363107,0.9802160525471796,63.10489689025943,0.4285434321574263,0.3313099149705039,-0.09723351718692239,9.772768206051307,3.0081959830676426,NaN,NaN,NaN,917698429
1081776600,114.58,115.08,114.57001,114.82001,NaN,NaN,109.60615602409638,115.35222222222222,106.82224955000034,111.83880049999999,113.8200006,112.596,113.12587837503325,113.51217361820515,113.28077000000017,116.73796704573923,109.82357295426112,106.82224955000034,111.83880049999999,113.8200006,112.596,114.82333999999999,23087200,46338195.2,58.30720093327644,NaN,1.5,2.75,NaN,NaN,1.201993077051456,0.49823261135556696,62.7715635569261,0.39711428866470483,0.39915934364395866,0.0020450549792538353,9.624817800303623,1.980646593836036,NaN,NaN,NaN,940785629
1081863000,115.25999,115.3,113.02,113.21001,NaN,NaN,109.66916819277108,115.29444444444444,106.89429960000034,111.9216007,113.81460080000001,112.6965005,113.12917765444371,113.48339613075704,113.56230923076942,116.27414158757796,110.85047687396087,106.89429960000034,111.9216007,113.81460080000001,112.6965005,113.84333666666667,56235504,46265605.6,48.878765943841806,NaN,1.5,2.75,NaN,NaN,1.2789935715477807,1.215492659627047,58.247553536306484,0.2538326400727968,0.31933585507024986,0.06550321499745304,11.592549285644644,0.2124546339736196,NaN,NaN,NaN,884550125
1081949400,112.61,113.64,112.55,113.39,NaN,NaN,109.73218036144578,115.23666666666666,106.97294960000033,112.01710069999999,113.8030008,112.77650099999998,113.13940598172043,113.47450126116114,113.74615538461558,116.02822478599882,111.46408598323234,106.97294960000033,112.01710069999999,113.8030008,112.77650099999998,113.19333333333333,62334304,46377045.6,49.85499621499082,NaN,1.5,2.75,NaN,NaN,1.2654940307229394,1.3440766481252526,54.57597084208326,0.1616095131339046,0.2675151064148338,0.10590559328092919,11.478794478702465,0.25640139200695305,NaN,NaN,NaN,946884429
1082035800,113.45,113.78,112.36,112.96001,NaN,NaN,109.79519253012047,115.17888888888889,107.04959965000033,112.0995008,113.786601,112.77250199999996,113.13237084518238,113.4255020934315,113.89461769230789,115.63813078597293,112.15110459864285,107.04959965000033,112.0995008,113.786601,112.77250199999996,113.03333666666666,61621008,47364136,47.520328706744955,NaN,1.5,2.75,NaN,NaN,1.2765301713855866,1.3010056385278514,55.523022697313394,0.06692752775863439,0.18956500297922219,0.1226374752205878,11.704498122634524,-0.7206802601511726,NaN,NaN,NaN,885263421
1082122200,113.36,114.05,112.98,113.83,NaN,NaN,109.85820469879518,115.1211111111111,107.12609965000034,112.2000008,113.8062008,112.81050149999996,113.15972885125366,113.46402570358089,113.9900023076925,115.56513057111081,112.4148740442742,107.12609965000034,112.2000008,113.8062008,112.81050149999996,113.62,47059296,46715850.4,52.379385095891685,NaN,1.5,2.75,NaN,NaN,1.2632058734294733,1.0073518002360928,58.869998524983984,0.058476908915257,0.19573361136465905,0.13725670244940205,12.05878748861342,-0.706559665038383,NaN,NaN,NaN,932322717
1082381400,113.57001,113.99001,113.27,113.83,NaN,NaN,109.92121686746988,115.06333333333333,107.19639965000034,112.29620069999999,113.819201,112.94900149999997,113.18601399434175,113.49888039847795,114.05615615384635,115.52287914938974,112.58943315830295,107.19639965000034,112.29620069999999,113.819201,112.94900149999997,113.69667,28278000,45697585.6,52.379385095891685,NaN,1.5,2.75,NaN,NaN,1.224406168184511,0.6188073095923037,58.02104580502797,0.04886342538984853,0.19833598418671272,0.1494725587968642,11.085589926552586,-1.2492409126398871,NaN,NaN,NaN,932322717
1082467800,114.08,114.32001,111.78,111.92,NaN,NaN,109.98422903614457,115.00555555555555,107.26229960000033,112.35950069999998,113.76860100000002,113.06250199999997,113.13636638672051,113.34851083671815,113.96538615384634,115.76568410027649,112.16508820741619,107.26229960000033,112.35950069999998,113.76860100000002,113.06250199999997,112.67333666666669,53345104,45226890.4,42.38676124417689,NaN,1.5,2.75,NaN,NaN,1.3183778704570455,1.1794997075456686,54.34602918922379,-0.08297807202016402,0.045749968771659155,0.12872804079182318,13.657612364355426,-2.5935511395605872,NaN,NaN,NaN,878977613
1082554200,112.2,112.95,111.87,112.67,NaN,NaN,110.04724120481927,114.94777777777777,107.32214960000032,112.42630059999999,113.73240100000002,113.22300149999998,113.1180775088099,113.2838907570307,113.88000153846173,115.80812271245438,111.95188036446908,107.32214960000032,112.42630059999999,113.73240100000002,113.22300149999998,112.49666666666667,50301296,45036740,46.68766228502901,NaN,1.5,2.75,NaN,NaN,1.3013508797101137,1.1168946953087635,53.62683423699571,-0.11457426186508088,-0.014489786539527927,0.10008447532555295,14.723027429465091,-1.7098490796475563,NaN,NaN,NaN,929278909
1082640600,112.48,114.67,112.44,114.25,NaN,NaN,110.11025337349398,114.89,107.38764965000031,112.50510059999999,113.72040080000002,113.45800149999998,113.16246662611148,113.37590116112302,113.85000153846173,115.74168111779026,111.95832195913319,107.38764965000031,112.50510059999999,113.72040080000002,113.45800149999998,113.78666666666668,62142800,45564140,54.409064422294826,NaN,1.5,2.75,NaN,NaN,1.36768295973082,1.3638532407283448,57.293683447493756,-0.02845251163318563,0.06451883578407092,0.09297134741725654,17.295934480233793,-0.10492261956807253,NaN,NaN,NaN,991421709
1082727000,114.42,114.57001,113.78999,114.36,NaN,NaN,110.17326554216866,114.83222222222221,107.45654965000031,112.58420059999999,113.6862006,113.62600149999999,113.20942871920515,113.46962486006369,113.78000153846172,115.51737095582516,112.04263212109828,107.45654965000031,112.58420059999999,113.6862006,113.62600149999999,114.24000000000001,29422096,44536140,54.89881692145468,NaN,1.5,2.75,NaN,NaN,1.3257070340357608,0.6606341726067864,54.76880721290323,0.033190801624168126,0.1344598494474667,0.10126904782329857,17.262893672899118,-0.4006357428465621,NaN,NaN,NaN,1020843805
1082986200,114.5,114.94,113.60001,114.2,NaN,NaN,110.23627771084337,114.77444444444444,107.53104965000031,112.6502005,113.65720080000001,113.78450149999996,113.24827465178534,113.53918439720049,113.72615615384635,115.3617509807864,112.0905613269063,107.53104965000031,112.6502005,113.65720080000001,113.78450149999996,114.24667,35565200,44443744.8,53.9903146948053,NaN,1.5,2.75,NaN,NaN,1.3267272458903494,0.8002295972143194,52.62448194813543,0.058953642688830785,0.17496110118433705,0.11600745849550627,17.088724657066688,0.8744721425252113,NaN,NaN,NaN,985278605
1083072600,114.23,115.12,113.96001,114.3,NaN,NaN,110.29928987951807,114.71666666666667,107.6013496000003,112.71990049999998,113.64060080000002,113.87000149999997,113.28951878308787,113.61164302603854,113.70077153846174,115.28902554466036,112.11251753226311,107.6013496000003,112.71990049999998,113.64060080000002,113.87000149999997,114.46000333333335,43490496,44412429.6,54.49714936613198,NaN,1.5,2.75,NaN,NaN,1.3148174426124677,0.9792415409761775,53.97794358670508,0.07733499351951134,0.21267620039489543,0.1353412068753841,14.739033995299586,0.8025399065173265,NaN,NaN,NaN,1028769101
1083159000,113.89,114.00999,112.5,112.82001,NaN,NaN,110.36230204819276,114.65888888888888,107.6617996500003,112.77650059999998,113.57360100000001,113.86250199999998,113.27110667394717,113.53624940451105,113.58154153846174,115.18359396321905,111.97948911370442,107.6617996500003,112.77650059999998,113.57360100000001,113.86250199999998,113.11000000000001,50173504,44968035.2,46.35790131166799,NaN,1.5,2.75,NaN,NaN,1.3494733395687197,1.1157593116276514,50.39992768369434,-0.010881344258293707,0.12173952655251696,0.13262087081081067,16.755279936255032,-0.12393766608200599,NaN,NaN,NaN,978595597
1083245400,112.72,113.32001,111.16,111.83,NaN,NaN,110.42531421686746,114.60111111111111,107.71839970000032,112.81880049999998,113.49700100000001,113.79900149999996,113.21459268673355,113.37374946122429,113.35154076923097,115.03290907086225,111.67017246759968,107.71839970000032,112.81880049999998,113.49700100000001,113.79900149999996,112.10333666666666,69703376,46023379.2,41.854710732142394,NaN,1.5,2.75,NaN,NaN,1.407368815313811,1.5145210371688655,47.21113150760663,-0.12999242221659374,-0.02986965695993149,0.10012276525666224,17.351160031766074,-1.7570060616709129,NaN,NaN,NaN,908892221
1083331800,112.12,112.38,110.89999,110.96001,NaN,NaN,110.48832638554217,114.54333333333332,107.77359975000032,112.85990049999998,113.41160120000002,113.65800199999994,113.12617767941067,113.14386951253627,113.17846384615405,115.29053270599347,111.06639498631462,107.77359975000032,112.85990049999998,113.41160120000002,113.65800199999994,111.41333333333334,48683904,46201859.2,38.33095672755389,NaN,1.5,2.75,NaN,NaN,1.412557471362824,1.0537217515263975,45.45603688256297,-0.25426805022473636,-0.21771229752425825,0.03655575270047813,16.784786940512546,-2.5212949134674525,NaN,NaN,NaN,860208317
1083591000,111.37,112.28999,111.35001,112.14999,NaN,NaN,110.55133855421687,114.48555555555555,107.84184970000032,112.90570029999999,113.35700100000003,113.53350149999994,113.08789580962986,113.04921432086616,113.08307846153865,115.25934522970807,110.90681169336922,107.84184970000032,112.90570029999999,113.35700100000003,113.53350149999994,111.92999666666667,33764608,45340204.8,45.13499497055186,NaN,1.5,2.75,NaN,NaN,1.406659080551194,0.7446946512248661,47.82011997942926,-0.24322398312017293,-0.26747422619973804,-0.024250243079565102,18.41181582383139,0.2054949964260193,NaN,NaN,NaN,893972925
1083677400,112.25,113.25999,111.66,112.06,NaN,NaN,110.61435072289156,114.42777777777778,107.90459975000034,112.95890019999999,113.30640100000002,113.37300149999994,113.04758617003652,112.95500343316462,113.0138469230771,115.25758556243424,110.77010828371995,107.90459975000034,112.95890019999999,113.30640100000002,113.37300149999994,112.32666333333333,51193904,46385895.2,44.73304933996916,NaN,1.5,2.75,NaN,NaN,1.4204684319403948,1.1036523878491407,49.5881840111227,-0.2290734394441974,-0.31059204238481186,-0.08151860294061447,15.579674034840856,-0.5414041004703998,NaN,NaN,NaN,842779021
1083763800,112.41,112.96001,112.16,112.78,NaN,NaN,110.67736289156626,114.36999999999999,107.97709975000035,113.0194002,113.274201,113.26700199999996,113.03709259474097,112.93833643952989,112.93307769230788,115.12855912623156,110.73759625838419,107.97709975000035,113.0194002,113.274201,113.26700199999996,112.63333666666665,34430304,46683405.6,48.67158426884106,NaN,1.5,2.75,NaN,NaN,1.3832928296589377,0.7375276837129465,48.687364711908884,-0.16150383709690835,-0.2833983993117499,-0.12189456221484157,15.538297507756505,-1.286652078774616,NaN,NaN,NaN,877209325
1083850200,112.02,112.58949,111,111.81,NaN,NaN,110.74037506024096,114.31222222222222,108.04029975000036,113.0582003,113.21300100000002,113.12600199999994,112.98897131651583,112.83087582624132,112.77769307692326,114.98316932520478,110.57221682864173,108.04029975000036,113.0582003,113.21300100000002,113.12600199999994,111.79983,55006896,47138830.4,44.11081405100893,NaN,1.5,2.75,NaN,NaN,1.4116290561118707,1.166912618179852,45.06471436918769,-0.17147806582034336,-0.3362421444902708,-0.16476407866992743,13.450405364443089,-2.2298006295907635,NaN,NaN,NaN,822202429
1083936600,111.22,112.23,109.96001,109.96001,NaN,NaN,110.80338722891565,114.25444444444445,108.09389975000035,113.0764004,113.11340120000003,112.90550249999994,112.87018851978972,112.55746003326595,112.6269246153848,115.27073326937557,109.98311596139402,108.09389975000035,113.0764004,113.11340120000003,112.90550249999994,110.71667333333333,60957104,47839795.2,36.99137860939598,NaN,1.5,2.75,NaN,NaN,1.4729405521038805,1.2741924112584828,39.140016839665485,-0.2853004728183961,-0.5213896696929226,-0.23608919687452645,15.588534294708007,-3.7127758318739104,NaN,NaN,NaN,761245325
1084195800,109.44,109.75,108.36,108.83,NaN,NaN,110.86639939759036,114.19666666666666,108.14559970000035,113.0887003,112.98960120000001,112.60600199999995,112.71174975430777,112.20246383962157,112.33154000000016,115.65960748126905,109.00347251873127,108.14559970000035,113.0887003,112.98960120000001,112.60600199999995,108.98,75336320,50452251.2,33.440980338244074,NaN,1.5,2.75,NaN,NaN,1.4820169412393174,1.4932201875661792,33.51967563168552,-0.4116484483446504,-0.7506497573053394,-0.33900130896068903,15.898033447612322,-4.785651793525808,NaN,NaN,NaN,685909005
1084282200,109.46001,110.05,109.33,109.75,NaN,NaN,110.92941156626506,114.13888888888889,108.19319970000035,113.1046003,112.86140120000002,112.43300149999996,112.59560270511923,111.9688958548957,111.98538615384632,115.37874053974228,108.59203176795036,108.19319970000035,113.1046003,112.86140120000002,112.43300149999996,109.71000000000001,48348704,50057911.2,38.607324575245265,NaN,1.5,2.75,NaN,NaN,1.4633014454365088,0.9658554030916096,37.589073621560686,-0.40745875882203153,-0.8483247574882284,-0.4408659986661969,17.40047398990851,-2.7211573549762993,NaN,NaN,NaN,734257709
1084368600,109.61,110.53999,108.06,110.45,NaN,NaN,108.06,114.0811111111111,108.24614970000034,113.12410030000001,112.76080120000002,112.28600149999995,112.51146142256553,111.8242391068104,111.6846169230771,114.86947955712319,108.49975428903102,108.24614970000034,113.12410030000001,112.76080120000002,112.28600149999995,109.68333,90896000,51485996,42.27853012621006,NaN,1.5,2.75,NaN,NaN,1.5359220564767582,1.7654509393194997,37.04571545677608,-0.334781425337599,-0.8593427803381957,-0.5245613550005966,17.30058568439957,-1.2340159170168965,NaN,NaN,NaN,825153709
1084455000,109.75999,110.81,109.63,109.99001,NaN,NaN,108.03676441176471,114.02333333333333,108.29909980000035,113.12680040000001,112.64680140000004,112.13750149999996,112.41258097462179,111.6495506204475,111.3607715384617,114.30366609795476,108.41787697896865,108.29909980000035,113.12680040000001,112.64680140000004,112.13750149999996,110.14333666666666,57500704,51279980.8,40.56201855797244,NaN,1.5,2.75,NaN,NaN,1.5104990524427044,1.1213090001780968,35.7867850931827,-0.2962520466231038,-0.8948764132794764,-0.5986243666563726,16.84395666724572,-0.8741888181156426,NaN,NaN,NaN,767653005
1084541400,109.98,110.74001,109.27,110.03999,NaN,NaN,108.01352882352941,113.96555555555555,108.35349975000035,113.1382004,112.52780100000004,111.94800099999998,112.3195381913033,111.49625913278584,111.03307846153864,113.50485554885849,108.56130137421879,108.35349975000035,113.1382004,112.52780100000004,111.94800099999998,110.01666666666667,54131808,51633606.4,40.843056609334305,NaN,1.5,2.75,NaN,NaN,1.5076069772682257,1.0483832483179019,37.323872391496415,-0.24792540574459943,-0.9085311238371219,-0.6606057180925224,16.402639894529997,-1.881408995221488,NaN,NaN,NaN,821784813
1084800600,108.89,109.5,108.41,109.10001,NaN,NaN,107.99029323529412,113.90777777777777,108.40204980000036,113.13260050000001,112.38220120000004,111.71150149999998,112.1932821838012,111.26804492966338,110.74692461538478,113.18606717889442,108.30778205187515,108.40204980000036,113.13260050000001,112.38220120000004,111.71150149999998,109.00333666666666,55069504,52973181.6,37.273544858013786,NaN,1.5,2.75,NaN,NaN,1.5163486217490671,1.0395732772071218,34.47104679896782,-0.25860325544013296,-0.9838597873926886,-0.7252565319525557,15.13795315844402,-2.6414331608067148,NaN,NaN,NaN,766715309
1084887000,109.49001,109.94,109.33,109.64999,NaN,NaN,107.96705764705882,113.85,108.45774980000037,113.13180040000002,112.27600080000003,111.59800099999998,112.09354523541684,111.11394446017162,110.57923153846171,112.99712917093949,108.16133390598394,108.45774980000037,113.13180040000002,112.27600080000003,111.59800099999998,109.63999666666666,30203104,51816081.6,40.5475067416118,NaN,1.5,2.75,NaN,NaN,1.4680372916241338,0.5828905441587848,37.47604263923116,-0.21002905068421351,-0.9877928453078226,-0.7777637946236091,15.768545407613068,-2.7753236389430738,NaN,NaN,NaN,796918413
1084973400,110.5,111.17999,109.14999,109.27,NaN,NaN,107.94382205882353,113.79222222222222,108.51154985000038,113.1283004,112.17140080000004,111.42800099999997,111.98281797128284,110.93833070206004,110.44923076923094,112.95151504923133,107.94694648923054,108.51154985000038,113.1283004,112.17140080000004,111.42800099999997,109.86666000000001,55014304,52051732,39.031678291724326,NaN,1.5,2.75,NaN,NaN,1.5081774850795528,1.056915915881531,38.14961795328573,-0.1857329603090312,-1.009929995009898,-0.8241970347008669,14.793227355724786,-2.2717109381987357,NaN,NaN,NaN,741904109
1085059800,109.45,109.87,109.03999,109.62,NaN,NaN,107.92058647058823,113.73444444444443,108.57754985000038,113.1275004,112.11220080000004,111.19650099999997,111.89015844299723,110.81277539710194,110.25461615384634,112.58516941831219,107.9240628893805,108.57754985000038,113.1275004,112.11220080000004,111.19650099999997,109.50999666666667,38126192,50850901.6,41.21168326622375,NaN,1.5,2.75,NaN,NaN,1.4597369504310134,0.7497643266958318,39.79044326157046,-0.13091798349060402,-0.9878445140641219,-0.8569265305735179,14.749323410224365,-0.3092124127671436,NaN,NaN,NaN,780030301
1085146200,109.97,110.55,109.47,109.81,NaN,NaN,107.89735088235294,113.67666666666666,108.64169985000039,113.11400040000001,112.08600080000005,110.96900099999996,111.80858360209538,110.71727297833033,110.08153923076942,112.17189472505218,107.99118373648666,108.64169985000039,113.11400040000001,112.08600080000005,110.96900099999996,109.94333333333333,47486608,51754127.2,42.41541504275411,NaN,1.5,2.75,NaN,NaN,1.432612882543084,0.9175424370792983,42.2996854372674,-0.06976028920537325,-0.9441268920802344,-0.8743666028748611,11.45637327389802,0.9004869980703887,NaN,NaN,NaN,827516909
1085405400,110.53,110.75999,109.67999,110.27,NaN,NaN,107.87411529411764,113.61888888888889,108.70304985000038,113.1049005,112.03980080000007,110.77250099999996,111.7482469902485,110.67467555182267,109.88846230769249,111.29944763303473,108.47747698235025,108.70304985000038,113.1049005,112.03980080000007,110.77250099999996,110.23666,40976800,52024707.2,45.333825018988996,NaN,1.5,2.75,NaN,NaN,1.4074262480757207,0.7876411460130236,45.39742002821602,0.009556677157391169,-0.8624207564281221,-0.8719774335855133,9.61464820223247,0.4738041002277868,NaN,NaN,NaN,868493709
1085491800,109.89999,111.98,109.60001,111.85001,NaN,NaN,107.85087970588236,113.5611111111111,108.77089990000039,113.1106006,112.05280100000007,110.65000149999996,111.75223769651326,110.7866121659348,109.89154000000018,111.31935142580637,108.46372857419398,108.77089990000039,113.1106006,112.05280100000007,110.65000149999996,111.14334000000001,51714096,52435887.2,53.96407911509372,NaN,1.5,2.75,NaN,NaN,1.476895087498884,0.9862347861637782,49.709276387506975,0.16755223706503541,-0.662537137254219,-0.8300893743192544,11.560632801991941,1.2675509280217243,NaN,NaN,NaN,920207805
1085578200,111.66,112.28999,111.50999,112.24001,NaN,NaN,107.82764411764707,113.50333333333333,108.83885000000038,113.1207007,112.06180140000008,110.62100149999996,111.7713660221402,110.92503100727434,110.06692461538479,111.96723584874329,108.1666133820263,108.83885000000038,113.1207007,112.06180140000008,110.62100149999996,112.01333,35982704,51726347.2,55.818198810715955,NaN,1.5,2.75,NaN,NaN,1.4271168669632495,0.6956358982951728,51.697880283345825,0.290254083263071,-0.46727177024041566,-0.7575258535034867,11.269200991757561,2.0456403267896786,NaN,NaN,NaN,956190509
1085664600,112.53999,113.03,112.06,112.87,NaN,NaN,107.80440852941177,113.44555555555554,108.90545000000039,113.1250007,112.05840160000007,110.67300149999997,111.81444970754647,111.11026614943869,110.37769384615405,112.65183513546192,108.10355255684617,108.90545000000039,113.1250007,112.05840160000007,110.67300149999997,112.65333333333335,45311904,50506773.6,58.711064998014244,NaN,1.5,2.75,NaN,NaN,1.39446566218016,0.897145091049728,54.272881376671926,0.3990563332993523,-0.25870543687929626,-0.6577617701786486,10.822265783630007,2.571801396928518,NaN,NaN,NaN,1001502413
1085751000,112.73,112.88,112.36,112.86,NaN,NaN,107.78117294117648,113.38777777777777,108.97455005000037,113.12810070000002,112.05420140000005,110.76800099999998,111.85545167979956,111.27690746853976,110.6169246153848,113.20874144454895,108.02510778622066,108.97455005000037,113.12810070000002,112.05420140000005,110.76800099999998,112.7,23369008,49241028.8,58.64542476833129,NaN,1.5,2.75,NaN,NaN,1.3320038291672913,0.474584072865675,55.84552700926507,0.4516907952362401,-0.09314827613334842,-0.5448390713695885,10.865660803842571,3.4463699865838713,NaN,NaN,NaN,978133405
1086096600,112.46001,112.86,111.87,112.71001,NaN,NaN,107.75793735294118,113.33,109.04155010000036,113.12590090000002,112.08720160000004,110.79600199999997,111.88896377078781,111.41339342391693,110.79077153846173,113.60787145816772,107.97367161875573,109.04155010000036,113.12590090000002,112.08720160000004,110.79600199999997,112.48000333333334,41059200,49605758.4,57.605125603011004,NaN,1.5,2.75,NaN,NaN,1.30757498422677,0.8277103571104761,56.77400370015033,0.45639786082641187,0.025658254663426305,-0.43073960616298557,8.748534675133326,2.790716168783959,NaN,NaN,NaN,937074205
1086183000,113.03,113.48,112.46001,113.13,NaN,NaN,107.73470176470589,113.27222222222221,109.10910010000038,113.12340090000002,112.15680180000005,110.84950199999999,111.9376318582079,111.57687976449627,111.03230923076941,114.06365895186077,108.00095950967805,109.10910010000038,113.12340090000002,112.15680180000005,110.84950199999999,113.02333666666667,39780496,49035088,59.75774735880312,NaN,1.5,2.75,NaN,NaN,1.287033199639144,0.8112659245151146,58.53783790752672,0.46615277971630886,0.15195136848240054,-0.3142014112339083,8.68362974229927,3.5325340898691313,NaN,NaN,NaN,976854701
1086269400,112.81,113.19,112.07001,112.09,NaN,NaN,107.7114661764706,113.21444444444444,109.16715010000038,113.12040090000002,112.20940160000005,110.81500199999998,111.94360707945464,111.62574835835376,111.19000230769248,114.21173149173627,108.16827312364869,109.16715010000038,113.12040090000002,112.20940160000005,110.81500199999998,112.45000333333333,38719008,49249523.2,52.631235529879,NaN,1.5,2.75,NaN,NaN,1.2751015425220624,0.7861803624527272,55.4877965482042,0.3843246188187197,0.16620436228949131,-0.2181202565292284,10.680497543364586,2.2532384601350106,NaN,NaN,NaN,938135693
1086355800,112.98,113.58,112.71001,112.98,NaN,NaN,107.6882305882353,113.15666666666667,109.22775010000038,113.11800090000003,112.27800160000004,110.87350199999999,111.98424993908387,111.75472470517721,111.48846307692324,114.3895638066359,108.58736234721057,109.22775010000038,113.11800090000003,112.27800160000004,110.87350199999999,113.09000333333334,32759904,48137173.6,57.32184989982647,NaN,1.5,2.75,NaN,NaN,1.2904514323419147,0.6805531266173052,57.64453370222069,0.3716756627992222,0.24647432196979935,-0.12520134082942286,11.117454450267186,2.8868044804662616,NaN,NaN,NaN,970895597
1086615000,113.5,114.81,113.42,114.7,NaN,NaN,107.664995,113.09888888888888,109.29900010000037,113.13940090000004,112.35200160000004,111.11050149999998,112.09074994147274,112.03522711420796,111.87692538461555,115.03070213433564,108.72314863489545,109.29900010000037,113.13940090000004,112.35200160000004,111.11050149999998,114.31,31673600,46672998.4,64.61451052776803,NaN,1.5,2.75,NaN,NaN,1.3289906157460636,0.6786279237633038,60.89649022698206,0.4551715083002611,0.44376304454590354,-0.011408463754357584,13.031245953375693,4.017411807381887,NaN,NaN,NaN,1002569197
1086701400,114.37,114.92,114.17,114.86,NaN,NaN,107.64175941176471,113.0411111111111,109.36945010000038,113.15300090000004,112.42860160000004,111.4120015,112.19934798298361,112.304253103331,112.30692538461554,115.44598327895208,109.167867490279,109.36945010000038,113.15300090000004,112.42860160000004,111.4120015,114.64999999999999,32852400,44548802.4,65.21004985052346,NaN,1.5,2.75,NaN,NaN,1.2876341431927734,0.737447433603737,59.6994790236529,0.49395907907381276,0.6060403850879084,0.1120813060140956,13.142405157770856,2.69109497620966,NaN,NaN,NaN,1035421597
1086787800,114.50999,114.7,113.72,113.78999,NaN,NaN,107.61852382352942,112.98333333333332,109.43955005000038,113.15310080000003,112.45260140000003,111.614001,112.26172610129798,112.44575185539472,112.627693846154,115.43793806559705,109.81744962671095,109.43955005000038,113.15310080000003,112.45260140000003,111.614001,114.06999666666667,36802496,43971492,58.160434590647185,NaN,1.5,2.75,NaN,NaN,1.2770888472504325,0.8369626393391427,56.79686005961479,0.4230688635067922,0.6409173853975858,0.21784852189079365,13.443668451474199,1.3809514093949253,NaN,NaN,NaN,998619101
1086874200,114.03999,114.35001,113.92999,114.35001,NaN,NaN,107.59528823529412,112.92555555555555,109.51165015000036,113.15430090000004,112.48020160000004,111.80900150000002,112.34361958752159,112.62710977392855,112.97692538461556,115.40168519877382,110.55216557045729,109.51165015000036,113.15430090000004,112.48020160000004,111.80900150000002,114.21000333333332,21718608,40512622.4,60.56341676067053,NaN,1.5,2.75,NaN,NaN,1.225869643875401,0.5360948443564592,58.17381321785947,0.3902113655486176,0.7056127288265657,0.3154013632779481,13.536601218373134,1.3112518826969017,NaN,NaN,NaN,1020337709
1087219800,113.82001,113.85001,112.87,113.22,NaN,NaN,107.57205264705883,112.86777777777777,109.57720015000037,113.14450090000003,112.48260140000004,111.97050100000001,112.37798744683447,112.68357550974488,113.20384846153864,115.05778088599955,111.34991603707773,109.57720015000037,113.14450090000003,112.48260140000004,111.97050100000001,113.31333666666667,34634896,39369332,53.84355219660593,NaN,1.5,2.75,NaN,NaN,1.2440225264557292,0.8797430446622767,53.58812118409058,0.2741713454933984,0.6581155451446961,0.38394419965129767,14.836270321999361,0.3189792663476869,NaN,NaN,NaN,985702813
1087306200,113.89999,114.44501,113.50999,114.02,NaN,NaN,107.54881705882353,112.80999999999999,109.64660015000038,113.13370080000003,112.48740140000005,112.1695015,112.44238009597821,112.81085403262632,113.37077076923096,115.09315441963263,111.64838711882929,109.64660015000038,113.13370080000003,112.48740140000005,112.1695015,113.99166666666666,37446000,38535041.6,57.443593503223276,NaN,1.5,2.75,NaN,NaN,1.2426644888517484,0.9717389276154303,57.40879664474014,0.23462097908852553,0.6772204235119546,0.442599444423429,15.321247278661108,1.162265889249765,NaN,NaN,NaN,1023148813
1087392600,114,114.2,113.7,114,NaN,NaN,107.52558147058824,112.75222222222222,109.71280020000039,113.12570080000003,112.47460140000004,112.414501,112.50346322946926,112.92410602951905,113.5061546153848,115.12531897436563,111.88699025640398,109.71280020000039,113.12570080000003,112.47460140000004,112.414501,113.96666666666665,26638704,37113501.6,57.32322014502025,NaN,1.5,2.75,NaN,NaN,1.189617025362338,0.7177631549592184,58.479911401293066,0.19222090830090233,0.6828755797995569,0.4906546714986546,15.270753122260693,0.7690267833465965,NaN,NaN,NaN,996510109
1087479000,113.78999,114.07001,113.33,113.83,NaN,NaN,107.50234588235294,112.69444444444444,109.7747502000004,113.11970090000003,112.44580140000004,112.6235015,112.55548427929399,113.01038164575533,113.58000076923096,115.16355021955856,111.99645131890337,109.7747502000004,113.11970090000003,112.44580140000004,112.6235015,113.74333666666668,28473904,37027041.6,56.2443448511406,NaN,1.5,2.75,NaN,NaN,1.1575022378364566,0.7690029440537318,59.94809243766275,0.1402466198826392,0.6659629463519536,0.5257163264693144,15.241316976226074,1.5523240253367783,NaN,NaN,NaN,968036205
1087565400,113.27,114.22,113.17999,113.63,NaN,NaN,107.47911029411765,112.63666666666666,109.8289002000004,113.09730090000001,112.42040160000005,112.8415015,112.59762215069422,113.06939291758816,113.63923153846174,115.16725539282122,112.11120768410227,109.8289002000004,113.09730090000001,112.42040160000005,112.8415015,113.67666333333332,31803104,35866481.6,54.934406481644636,NaN,1.5,2.75,NaN,NaN,1.149109935133852,0.886708218405231,61.29086207651757,0.0827617950890217,0.6291685703305916,0.5464067752415699,14.031635072490925,0.5753230660293782,NaN,NaN,NaN,936233101
1087824600,113.75,114.14,113.13,113.2,NaN,NaN,107.45587470588237,112.57888888888888,109.8781002000004,113.08250100000001,112.39180160000004,113.0205015,112.6212448114513,113.08183168734168,113.67692307692329,115.13392612567847,112.2199200281681,109.8781002000004,113.08250100000001,112.39180160000004,113.0205015,113.49,24740800,35197212,52.1236085900974,NaN,1.5,2.75,NaN,NaN,1.1391735111957202,0.702919310768137,60.23538347051966,0.009969828806954628,0.5588690612502631,0.5488992324433085,13.636781734104744,-1.3077593722755012,NaN,NaN,NaN,911492301
1087911000,113.13,113.88,112.67,113.77,NaN,NaN,107.43263911764707,112.5211111111111,109.92990020000042,113.08650100000001,112.37980160000005,113.2185015,112.66629403453165,113.14737152664247,113.72615384615406,115.1487537296326,112.30355396267552,109.92990020000042,113.08650100000001,112.37980160000005,113.2185015,113.44,37337392,34689751.2,55.38258118142046,NaN,1.5,2.75,NaN,NaN,1.144232546110311,1.0763234300740674,61.210062905000555,-0.004805541494821486,0.5428923055747816,0.5476978470696031,10.467263342888288,-0.948981368622674,NaN,NaN,NaN,948829693
1087997400,113.58,114.84,113.42,114.75,NaN,NaN,107.40940352941178,112.46333333333332,109.9895002000004,113.09920100000001,112.37840140000004,113.4425015,112.74800799396178,113.30000280981938,113.93076923076946,115.09488705560985,112.76665140592907,109.9895002000004,113.09920100000001,112.37840140000004,113.4425015,114.33666666666666,35760304,34428926.4,60.376566980938506,NaN,1.5,2.75,NaN,NaN,1.1639302213881462,1.038670319966759,63.852739547610916,0.04373351088835031,0.602364735680041,0.5586312247916907,11.751216679542233,0.8436682347893667,NaN,NaN,NaN,984589997
1088083800,114.5,114.92999,114.25999,114.39,NaN,NaN,107.38616794117648,112.40555555555555,110.04305025000039,113.10830100000001,112.40200120000004,113.56950099999999,112.81239983733583,113.40381206602706,114.039230769231,115.08558760023675,112.99287393822524,110.04305025000039,113.10830100000001,112.40200120000004,113.56950099999999,114.52665999999999,39410608,33813752,57.81647494410304,NaN,1.5,2.75,NaN,NaN,1.128649491288993,1.1655201114623424,64.32731854548716,0.043796972439968274,0.613377440341651,0.5695804679016827,10.428095452547563,0.03497157542881114,NaN,NaN,NaN,945179389
1088170200,114.41,114.94,113.67999,113.84,NaN,NaN,107.36293235294119,114.94,110.0972502500004,113.10700100000003,112.41100120000004,113.6495005,112.8526978829305,113.44535377402448,113.97307692307714,114.95043413252353,112.99571971363076,110.0972502500004,113.10700100000003,112.41100120000004,113.6495005,114.15333,32872704,33658252,54.0460037878856,NaN,1.5,2.75,NaN,NaN,1.1380323847683502,0.9766610577400158,65.42203892001788,0.0012483677424635076,0.5711409275797621,0.5698925598372986,10.42625001160292,0.5476064299593751,NaN,NaN,NaN,912306685
1088429400,114.53,114.61,113.41,113.45,NaN,NaN,107.33969676470589,114.9311320754717,110.1547002000004,113.10370100000002,112.42080100000004,113.6785005,112.8761214953646,113.44579627173644,113.86461538461562,114.73082450434843,112.9984062648828,110.1547002000004,113.10370100000002,112.42080100000004,113.6785005,113.82333333333331,41277392,33456526.4,51.48218354051181,NaN,1.5,2.75,NaN,NaN,1.1424586429991825,1.2337620321516702,63.97728925751521,-0.05557020545238556,0.5004298030218166,0.5560000084742022,8.808229306976324,-0.4999122960883996,NaN,NaN,NaN,871029293
1088515800,113.5,114.17,113.42,113.92,NaN,NaN,107.3164611764706,114.92226415094339,110.2130002500004,113.11440090000002,112.42260100000004,113.7315005,112.91705790731109,113.49095853157107,113.87461615384639,114.74014979709409,113.00908251059869,110.2130002500004,113.11440090000002,112.42260100000004,113.7315005,113.83666666666666,28426896,33709420.8,54.296002229294174,NaN,1.5,2.75,NaN,NaN,1.1144258827849554,0.8432923297216665,65.09272013682222,-0.06334454832891823,0.4768193230630544,0.5401638713919726,8.114821468938915,-0.07017543859648973,NaN,NaN,NaN,899456189
1088602200,114.07001,114.78999,113.64999,114.53,NaN,NaN,107.2932255882353,114.91339622641509,110.27340025000039,113.12790100000002,112.43660100000005,113.82250000000002,112.98031053839694,113.58991486189763,113.88846153846177,114.78902020791668,112.98790286900686,110.27340025000039,113.12790100000002,112.43660100000005,113.82250000000002,114.32332666666666,52610400,34286980.8,57.723013598787645,NaN,1.5,2.75,NaN,NaN,1.116252605443173,1.5344133187720046,68.19048608120114,-0.03089252591306968,0.5015482140006355,0.5324407399137052,8.688583412731633,0.6149521215848219,NaN,NaN,NaN,952066589
1088688600,114.25,114.39999,112.58,112.94,NaN,NaN,107.26999,114.90452830188678,110.32765025000039,113.11280100000002,112.45700100000003,113.81300000000002,112.9787297329696,113.52801820838357,113.8669230769233,114.84080933200426,112.89303682184234,110.32765025000039,113.11280100000002,112.45700100000003,113.81300000000002,113.30666333333333,57778192,35186865.6,47.68600553777285,NaN,1.5,2.75,NaN,NaN,1.1758059907686607,1.6420386134080667,66.39747854271786,-0.11525703576900992,0.3883694452024429,0.5036264809714528,12.022964930201342,-0.6072340051042838,NaN,NaN,NaN,894288397
1088775000,113.16,113.28999,112.60001,112.88,NaN,NaN,107.24675441176471,114.89566037735848,110.37415025000038,113.09680100000001,112.46120100000003,113.8525,112.9748579787355,113.46630218853751,113.77923076923099,114.8793136063351,112.67914793212688,110.37415025000038,113.09680100000001,112.46120100000003,113.8525,112.92333333333333,34620496,34981940,47.35140475446822,NaN,1.5,2.75,NaN,NaN,1.1411041342851853,0.9896676971031337,68.67015285807616,-0.170513638188576,0.2904844332357328,0.4609980714243088,12.00725587135378,-0.28268551236749767,NaN,NaN,NaN,859667901
1089120600,112.37,112.45,111.63,111.89,NaN,NaN,107.22351882352942,114.88679245283019,110.41670025000037,113.0672009,112.41400100000004,113.798,112.932314528589,113.31617817058155,113.6169230769233,115.09612004440176,112.13772610944484,110.41670025000037,113.0672009,112.41400100000004,113.798,111.99,38710608,35279475.2,42.10202898866646,NaN,1.5,2.75,NaN,NaN,1.1488824104076722,1.0972557777730207,66.64013617293895,-0.26359111801248974,0.13150917390869665,0.3951002919211864,12.802603940183607,-1.6524567109079682,NaN,NaN,NaN,820957293
1089207000,111.81,112.57001,111.75,112.22,NaN,NaN,107.20028323529412,114.87792452830189,110.45480020000039,113.02870080000001,112.37120100000006,113.674,112.90438062550709,113.21178024957378,113.49307692307715,115.14023549495361,111.8459183512007,110.45480020000039,113.02870080000001,112.37120100000006,113.674,112.18000333333333,30039296,35197760,44.31794589536206,NaN,1.5,2.75,NaN,NaN,1.1253915239499812,0.8534434009436964,68.57364633284543,-0.2906546220694092,0.03178201433442496,0.32243663640383413,12.487642313215778,-2.2047930283224413,NaN,NaN,NaN,850996589
1089293400,111.75,112.32001,111.2,111.42,NaN,NaN,107.17704764705883,114.86905660377359,110.49355020000039,112.9864009,112.31560100000006,113.502,112.84616962058524,113.04113451151913,113.32307692307715,115.30148941199032,111.34466443416399,110.49355020000039,112.9864009,112.31560100000006,113.502,111.64667000000001,45292000,35819740,40.29198526633949,NaN,1.5,2.75,NaN,NaN,1.1250071293821249,1.2644424554728761,66.07585970202659,-0.34637463085270914,-0.1105316521620523,0.23584297869065685,11.089935352581527,-2.5963808025177015,NaN,NaN,NaN,805704589
1089379800,111.67,111.94,111.38,111.73,NaN,NaN,107.15381205882353,114.86018867924528,110.53945020000039,112.95240090000001,112.26420100000004,113.39900049999999,112.80239826291523,112.91626455804112,113.21000000000024,115.36388021950042,111.05611978050005,110.53945020000039,112.95240090000001,112.26420100000004,113.39900049999999,111.68333333333334,27411392,35350184.8,42.472803649993814,NaN,1.5,2.75,NaN,NaN,1.0846494772834019,0.775424291417,68.05520510371323,-0.3455079820106686,-0.19604199882267892,0.1494659831879897,11.560666991564505,-1.8534785664089946,NaN,NaN,NaN,833115981
1089639000,111.52,112.03999,111,111.78,NaN,NaN,107.13057647058824,114.85132075471698,110.58365020000039,112.90850090000002,112.24340080000003,113.2705,112.76230421338914,112.80804888584673,113.05692307692331,115.3104042760362,110.80344187781043,110.58365020000039,112.90850090000002,112.24340080000003,113.2705,111.60666333333332,35691296,36048819.2,42.83546936745988,NaN,1.5,2.75,NaN,NaN,1.081459514620302,0.9900822493514572,69.30209905491657,-0.3250244536116915,-0.2568145838266247,0.06820986978506682,11.544580767769974,-1.4720141031291332,NaN,NaN,NaN,868807277
1089725400,111.92,112.02,111.60001,111.86,NaN,NaN,107.10734088235294,114.84245283018868,110.6374002000004,112.87050090000002,112.24400080000004,113.20250000000001,112.72691973443271,112.71775851576609,112.8346153846156,114.94157988556283,110.72765088366837,110.6374002000004,112.87050090000002,112.24400080000004,113.20250000000001,111.82667,26816096,35657879.2,43.44975793046178,NaN,1.5,2.75,NaN,NaN,1.0342116921474234,0.7520384442830239,68.61356868225747,-0.2906638991646348,-0.2951200041707267,-0.004456105006091879,11.578702397724344,-1.8082865168539346,NaN,NaN,NaN,895623373
1089811800,111.25999,112.39,111.12,111.52,NaN,NaN,107.08410529411765,114.83358490566037,110.6936002000004,112.83340090000003,112.25520060000004,113.07750000000001,112.67958954876869,112.60368627616933,112.61384615384637,114.62176185022624,110.6059304574665,110.6936002000004,112.83340090000003,112.25520060000004,113.07750000000001,111.67666666666666,54236096,36497384,41.412925450980204,NaN,1.5,2.75,NaN,NaN,1.0510537141368927,1.48602694373931,67.42602651026675,-0.27554766765750305,-0.34889068957797065,-0.07334302192046763,11.042339712620352,-2.628132367065402,NaN,NaN,NaN,841387277
1089898200,111.74001,111.91,110.7,110.8,NaN,NaN,107.06086970588237,114.82471698113207,110.7478502000004,112.79260090000004,112.22820080000005,112.91750000000002,112.60588015469934,112.43190663081987,112.38000000000021,114.46870957585938,110.29129042414104,110.7478502000004,112.79260090000004,112.22820080000005,112.91750000000002,111.13666666666667,38432800,37087088.8,37.41319261805731,NaN,1.5,2.75,NaN,NaN,1.0624070202699714,1.0362851667127888,68.40719243260821,-0.296908506157181,-0.4444786546169439,-0.1475701484597629,10.167146718653896,-1.8948114042854618,NaN,NaN,NaN,802954477
1089984600,111.57001,111.67,110.44,110.71001,NaN,NaN,107.03763411764707,114.81584905660377,110.79675030000038,112.75380100000004,112.20120100000004,112.76150050000001,112.53153230549545,112.26791647550368,112.16923153846174,114.33506860336604,110.00339447355745,110.79675030000038,112.75380100000004,112.20120100000004,112.76150050000001,110.94000333333335,40873200,37707053.6,36.933064810894614,NaN,1.5,2.75,NaN,NaN,1.074377947393545,1.083966953068961,69.24500092917714,-0.299130214081868,-0.521482916062098,-0.22235270198022994,7.600857798071307,-1.9223866052445062,NaN,NaN,NaN,762081277
1090243800,110.75,110.96001,109.99001,110.24001,NaN,NaN,107.01439852941178,114.80698113207546,110.84820035000038,112.71230110000005,112.15040120000005,112.59200100000001,112.4416686856721,112.07478252545572,111.88615538461559,114.02446897220041,109.74784179703077,110.84820035000038,112.71230110000005,112.15040120000005,112.59200100000001,110.39667666666666,39598096,38096803.2,34.446683174342155,NaN,1.5,2.75,NaN,NaN,1.0669223797225775,1.0394073169897886,70.11886382668244,-0.3128089923097586,-0.6133639423674282,-0.3005549500576696,7.638751754274298,-1.4746536777191908,NaN,NaN,NaN,722483181
1090330200,110.53,111.89999,110.25,111.64,NaN,NaN,106.99116294117648,114.79811320754717,110.89600035000038,112.68000110000003,112.14700120000005,112.51400100000001,112.41023069799868,112.0333746658885,111.66384769230791,113.1613800357149,110.16631534890092,110.89600035000038,112.68000110000003,112.14700120000005,112.51400100000001,111.26333,47290096,39224268,46.089047938786294,NaN,1.5,2.75,NaN,NaN,1.1092836383138223,1.2056336143736321,71.80886829647348,-0.21290042795491526,-0.5666804850013136,-0.35378005704639837,10.412153588239729,-0.5168419176617344,NaN,NaN,NaN,769773277
1090416600,111.82001,112.06,109.45,109.58,NaN,NaN,106.96792735294119,114.78924528301887,110.93165035000038,112.62640110000002,112.13940100000005,112.304501,112.29924125886149,111.79971993580388,111.40538615384637,113.08181880056233,109.7289535071304,110.93165035000038,112.62640110000002,112.13940100000005,112.304501,110.36333333333333,56264192,40170608,35.96683036691864,NaN,1.5,2.75,NaN,NaN,1.2164776641485493,1.4006308293865006,68.37432080009869,-0.26735812534812586,-0.6879777137315557,-0.42061958838342983,14.53796989176209,-1.6514090827499581,NaN,NaN,NaN,713509085
1090503000,109.36,110.39,108.77,109.88,NaN,NaN,106.9446917647059,114.78037735849057,110.9641003500004,112.57500110000001,112.16040100000005,112.061001,112.20436905263162,111.61688946572731,111.17461692307712,112.80073973917915,109.5484941069751,110.9641003500004,112.57500110000001,112.16040100000005,112.061001,109.67999999999999,72660128,42015599.2,38.09896469004051,NaN,1.5,2.75,NaN,NaN,1.2453006881379391,1.72936074656767,66.44295891527267,-0.2644957926907875,-0.7512393292469142,-0.4867435365561267,14.457312707688297,-1.655777320325793,NaN,NaN,NaN,786169213
1090589400,109.62,109.71001,108.69,108.96001,NaN,NaN,106.9214561764706,114.77150943396227,110.98960040000038,112.50300120000001,112.14460120000005,111.7895015,112.07713928586175,111.36385332613423,110.94923307692328,112.89671536115544,109.00175079269111,110.98960040000038,112.50300120000001,112.14460120000005,111.7895015,109.12000666666667,49610608,42525599.2,34.32446124338797,NaN,1.5,2.75,NaN,NaN,1.2413506389852291,1.1666057370921183,63.941719553054924,-0.3031104961463311,-0.8656316567390405,-0.5625211605927094,14.69919915219656,-2.522803721595996,NaN,NaN,NaN,736558605
1090848600,109.21001,109.42999,108.21001,108.75,NaN,NaN,106.8982205882353,114.76264150943396,111.01205045000039,112.43570120000003,112.11060120000006,111.53500149999999,111.94666323543579,111.11491491412144,110.6823100000002,112.80339738665799,108.56122261334241,111.01205045000039,112.43570120000003,112.11060120000006,111.53500149999999,108.79666666666667,49687904,43366359.2,33.50836488557171,NaN,1.5,2.75,NaN,NaN,1.239824164771999,1.1457707060637914,61.60143686138644,-0.31969784063986695,-0.962143461392543,-0.6424456207526761,14.587331779443225,-2.780261040586447,NaN,NaN,NaN,686870701
1090935000,109.05,110.11,108.97,109.77,NaN,NaN,106.87498500000001,114.75377358490566,111.0409004500004,112.37650120000002,112.10620100000006,111.35100150000001,111.86130389286969,110.9868277794432,110.55538692307711,112.68217489153956,108.42859895461466,111.0409004500004,112.37650120000002,112.10620100000006,111.35100150000001,109.61666666666666,51311392,43868059.2,40.8627100517481,NaN,1.5,2.75,NaN,NaN,1.2484081530025704,1.1696754526126836,63.91273633639133,-0.2423843065498248,-0.9454260039399571,-0.7030416973901323,16.093327997619305,-1.5692252510760403,NaN,NaN,NaN,738182093
1091021400,109.55,110.37,108.59,110.10001,NaN,NaN,106.85174941176471,114.74490566037736,111.07000050000039,112.31760120000003,112.10740140000006,111.160002,111.7922335441297,110.90236894330576,110.43000307692326,112.45475497437845,108.40525117946807,111.07000050000039,112.31760120000003,112.10740140000006,111.160002,109.68667,66079120,45750670.4,43.057169982191105,NaN,1.5,2.75,NaN,NaN,1.2863789992166725,1.4443311851447755,63.91273633639133,-0.15374953113108758,-0.8952286113039918,-0.7414790801729042,16.30619730772464,-0.6317599277978336,NaN,NaN,NaN,804261213
1091107800,110.53999,110.87,110,110.57001,NaN,NaN,106.82851382352942,114.73603773584905,111.10000050000039,112.25950130000003,112.13680140000005,110.9620025,111.74430320906579,110.87071571060997,110.3369269230771,112.21048830604161,108.46336554011259,111.10000050000039,112.25950130000003,112.13680140000005,110.9620025,110.48000333333333,52353600,45737830.4,46.12351441729931,NaN,1.5,2.75,NaN,NaN,1.2566376421297676,1.144645461801354,66.54585869080887,-0.0533809413262849,-0.8082052568307603,-0.7548243155044754,16.21846145692415,-0.12645649657153907,NaN,NaN,NaN,856614813
1091194200,110.32001,110.89999,110.10001,110.84,NaN,NaN,106.80527823529413,114.72716981132075,111.12970055000038,112.21830120000003,112.16060160000006,110.8570025,111.70884033812203,110.86779040483759,110.25846538461556,111.94657356424918,108.57035720498195,111.12970055000038,112.21830120000003,112.16060160000006,110.8570025,110.61333333333333,41589696,44928405.6,47.86044984430967,NaN,1.5,2.75,NaN,NaN,1.224019239120499,0.9256882242890008,68.72008791682731,0.03643818370811425,-0.7092765858693326,-0.7457147695774469,16.2811495046158,0.5442579332131822,NaN,NaN,NaN,898204509
1091453400,110.19,113.61,110.05,111.07001,NaN,NaN,106.78204264705883,113.61,111.15870060000037,112.18400130000002,112.19660180000007,110.76650299999999,111.6837881679996,110.88704941390068,110.22385076923094,111.8231885005526,108.62451303790927,111.15870060000037,112.18400130000002,112.19660180000007,110.76650299999999,111.57667,38802608,45137511.2,49.35832694797738,NaN,1.5,2.75,NaN,NaN,1.3908750077547491,0.859653245569286,70.47670804813467,0.11230216145736471,-0.605337067755741,-0.7176392292131057,16.063458215978443,-0.5105607309208207,NaN,NaN,NaN,937007117
1091539800,110.92999,111.06,110.16,110.21001,NaN,NaN,106.75880705882354,113.5568,111.18480060000036,112.16030140000002,112.20840200000006,110.68250349999998,111.6259929457251,110.82256946971967,110.1784669230771,111.74293600938333,108.61399783677086,111.18480060000036,112.16030140000002,112.20840200000006,110.68250349999998,110.47667,40988096,45251385.6,44.240713895148396,NaN,1.5,2.75,NaN,NaN,1.3565275072008387,0.9057865401584521,68.89158816559681,0.10562455709127805,-0.5856085328490082,-0.6912330899402862,14.76307009988056,0.5749315568534392,NaN,NaN,NaN,896019021
1091626200,109.89,110.75,109.64,110.2,NaN,NaN,106.73557147058824,113.5036,111.20875060000037,112.15110140000003,112.21620200000005,110.58150349999998,111.57007165373588,110.76327713927017,110.13923538461556,111.67371085003326,108.60475991919786,111.20875060000037,112.15110140000003,112.21620200000005,110.58150349999998,110.19666666666667,40787008,45788771.2,44.18329096027063,NaN,1.5,2.75,NaN,NaN,1.3389183995436358,0.8907644151848302,68.03168315937909,0.10156517554367173,-0.5642766205106966,-0.6658417960543683,9.810544257319743,0.2912267928649503,NaN,NaN,NaN,855232013
1091712600,110.28999,110.38,108.27,108.39999,NaN,NaN,106.71233588235295,113.4504,111.22945060000038,112.10930130000003,112.17880180000003,110.43050299999997,111.44575472613839,110.5382021736254,109.99769538461557,111.78714146602448,108.20824930320666,111.22945060000038,112.10930130000003,112.17880180000003,110.43050299999997,109.01666333333333,50819296,46065136,35.308338027768585,NaN,1.5,2.75,NaN,NaN,1.3939956567190903,1.1032051658330067,65.42348050459258,-0.015105460989398467,-0.6847236222911164,-0.6696181613017179,13.673520607832758,-0.5139683816108263,NaN,NaN,NaN,804412717
1091799000,107.63,107.965,106.62,106.85001,NaN,NaN,106.68910029411765,113.3972,111.23850070000037,112.06580140000001,112.07880180000004,110.18650349999999,111.26552944276041,110.18694577613726,109.6292346153848,111.83779952258384,107.42066970818577,111.23850070000037,112.06580140000001,112.07880180000004,110.18650349999999,107.14500333333335,74748624,48431997.6,29.764156549736,NaN,1.5,2.75,NaN,NaN,1.421566681239155,1.5433727226646543,62.99243134836393,-0.18025182406319873,-0.8949329413807163,-0.7146811173175176,15.153337886056873,-1.7471172413793126,NaN,NaN,NaN,729664093
1092058200,107.02,107.48,106.87,107,NaN,NaN,106.66586470588237,113.344,111.24920070000036,112.01790150000002,111.97400160000002,109.94750349999997,111.09825377833843,109.88342713079086,109.43077307692327,112.04735548864582,106.81419066520073,111.24920070000036,112.01790150000002,111.97400160000002,109.94750349999997,107.11666666666667,37481104,48521488,30.894969360679696,NaN,1.5,2.75,NaN,NaN,1.365025489722073,0.7724640266596935,62.21783467912245,-0.2582256438297297,-1.0374631721046796,-0.77923752827495,15.275292524591848,-2.5234581397467397,NaN,NaN,NaN,767145197
1092144600,107.31,108.41,107.25999,108.22,NaN,NaN,106.64262911764708,113.2908,111.27260075000036,111.96970160000002,111.88100160000003,109.76550349999995,110.98538108114869,109.72500549928697,109.30308076923096,111.98081424341567,106.62534729504625,111.27260075000036,111.96970160000002,111.88100160000003,109.76550349999995,107.96333,56101696,49985768,39.436317103377796,NaN,1.5,2.75,NaN,NaN,1.3682379547419248,1.1223533866679811,65.02298217239556,-0.20859979884879554,-1.0399872768359444,-0.8313874779871488,15.832354876422402,-1.7075475288331023,NaN,NaN,NaN,823246893
1092231000,107.66,108.33,107.10001,108.16,NaN,NaN,106.61939352941178,113.2376,111.29665070000037,111.92060150000003,111.78700160000004,109.59750349999995,110.87458182306443,109.57595735649772,109.24154153846173,111.98397380580963,106.49910927111384,111.29665070000037,111.92060150000003,111.78700160000004,109.59750349999995,107.86333666666667,53001200,49924023.2,39.179835951152874,NaN,1.5,2.75,NaN,NaN,1.3583631008317874,1.061637195938167,63.432569721266646,-0.16280959336679712,-1.0348994696956453,-0.8720898763288482,15.599130823008013,-2.1796235706228115,NaN,NaN,NaN,770245693
1092317400,107.62,107.95,106.63,106.98,NaN,NaN,106.59615794117649,113.1844,111.31365070000037,111.87980150000003,111.67240140000004,109.40650349999994,110.72185312412073,109.32872332254556,109.10538769230789,112.09640000597632,106.11437537863945,111.31365070000037,111.87980150000003,111.67240140000004,109.40650349999994,107.18666666666667,50037808,50504273.6,34.436407207476435,NaN,1.5,2.75,NaN,NaN,1.3706228793438027,0.9907638390427221,60.312014629993634,-0.19292859812963625,-1.1132506239908935,-0.9203220258612572,15.887164313284849,-3.4824972933958853,NaN,NaN,NaN,720207885
1092403800,107.12,107.35001,106.59,107.19,NaN,NaN,106.59,113.1312,111.33145070000035,111.85520160000004,111.55360140000002,109.23050299999996,110.58334908003756,109.12503538706503,108.90692615384636,112.03446991212009,105.77938239557263,111.33145070000035,111.85520160000004,111.55360140000002,109.23050299999996,107.04333666666665,41640800,50542653.6,35.92320704737921,NaN,1.5,2.75,NaN,NaN,1.3270076736763878,0.8238744314762294,61.86403238894086,-0.17990086126207783,-1.1451981024388544,-0.9652972411767766,15.826408517236503,-3.4933012070494986,NaN,NaN,NaN,761848685
1092663000,107.14,108.64,107.10001,108.3,NaN,NaN,106.56703125,113.078,111.34775075000034,111.84360150000002,111.47780140000003,109.13350249999996,110.49380597885963,109.04646058829692,108.76846384615405,111.83117501933435,105.70575267297374,111.34775075000034,111.84360150000002,111.47780140000003,109.13350249999996,108.01333666666666,45747008,50850099.2,43.24895528912741,NaN,1.5,2.75,NaN,NaN,1.3422206969852175,0.8996444199660479,64.82440052948674,-0.0826665902368584,-1.0686304789728496,-0.9859638887359912,17.472538004268827,-1.7330639930075316,NaN,NaN,NaN,807595693
1092749400,108.75,109.28,108.53,108.91,NaN,NaN,106.54406250000001,113.0248,111.36640080000033,111.83720150000003,111.39640140000003,108.99700249999997,110.43169594047298,109.03346434179245,108.64077076923098,111.52564598462595,105.75589555383601,111.36640080000033,111.83720150000003,111.39640140000003,108.99700249999997,108.90666666666668,40775104,50524349.6,46.84547933364205,NaN,1.5,2.75,NaN,NaN,1.316347790057702,0.8070386719040515,66.5164121209974,0.030529105859610994,-0.9478025064114775,-0.9783316122710884,17.68879258457735,-1.170598911070786,NaN,NaN,NaN,848370797
1092835800,108.53999,110.17,108.49001,110.03,NaN,NaN,106.52109375,112.9716,111.38955085000032,111.82750150000004,111.30300140000003,109.01950249999997,110.41594315849365,109.12837249971697,108.5784630769233,111.30107611435535,105.85585003949124,111.38955085000032,111.82750150000004,111.30300140000003,109.01950249999997,109.56333666666667,43204192,49871349.6,52.764507738491034,NaN,1.5,2.75,NaN,NaN,1.3423222336250091,0.8663128699448711,69.55037290399821,0.1802726350695114,-0.7529908184341991,-0.9332634535037105,18.87193233284446,1.5036994007102755,NaN,NaN,NaN,891574989
1092922200,109.81,110.02,109.17999,109.71001,NaN,NaN,106.498125,112.9184,111.41160090000032,111.81430160000004,111.20000160000004,109.01100299999996,110.38825950521938,109.18376654736298,108.47384769230793,110.8930869967052,106.05460838791066,111.41160090000032,111.81430160000004,111.20000160000004,109.01100299999996,109.63666666666667,39968800,48236783.2,51.01657551662956,NaN,1.5,2.75,NaN,NaN,1.3071570740803653,0.8285958836492231,68.24427859157618,0.25276615926355617,-0.6173057544242653,-0.8700719136878214,15.97087399354587,2.6766492581516834,NaN,NaN,NaN,851606189
1093008600,109.61,110.63,109.50999,110.48,NaN,NaN,106.47515625,112.8652,111.43405085000032,111.79320160000003,111.13380180000001,109.08700249999997,110.39185717168137,109.30721735237603,108.49461615384638,110.97692998666064,106.01230232103212,111.43405085000032,111.79320160000003,111.13380180000001,109.08700249999997,110.20666333333334,44893696,48000937.6,54.889127748009976,NaN,1.5,2.75,NaN,NaN,1.2937894259317673,0.9352670644500077,71.25414935855244,0.34202451856851734,-0.44254126547717476,-0.7845657840456921,12.7178848825904,3.2523364485981348,NaN,NaN,NaN,896499885
1093267800,110.55,110.77,110.05,110.2,NaN,NaN,106.45218750000001,112.812,111.45625090000033,111.76550160000005,111.05080160000001,109.15950249999996,110.38433336102719,109.39224427119736,108.49461615384638,110.97692998666064,106.01230232103212,111.45625090000033,111.76550160000005,111.05080160000001,109.15950249999996,110.33999999999999,33850304,47209057.6,53.24077506560837,NaN,1.5,2.75,NaN,NaN,1.252804466936641,0.7170298608121336,69.00177933306655,0.369324229150785,-0.3229104976072108,-0.6922347267579958,13.13087596912767,1.8296063574200738,NaN,NaN,NaN,862649581
1093354200,110.69,110.73,109.85001,110.35001,NaN,NaN,106.42921875,112.7588,111.47880095000032,111.73800160000005,110.99340180000002,109.18850299999997,110.38298734686926,109.48346005489284,108.64461769230792,111.31451498795148,105.97472039666435,111.47880095000032,111.73800160000005,110.99340180000002,109.18850299999997,110.31000666666667,30553600,46171168,54.03715007306181,NaN,1.5,2.75,NaN,NaN,1.226174862155453,0.6617463088653075,70.68376025717355,0.3829588321061982,-0.2135361866252481,-0.5964950187314463,12.000367998253907,2.024787352071007,NaN,NaN,NaN,893203181
1093440600,110.33,111.27,109.89999,111.10001,NaN,NaN,106.40625,112.7056,111.5023010500003,111.71120170000003,110.935002,109.23850299999997,110.41110588228615,109.6374171925221,108.971540769231,111.721984321634,106.221097216828,111.5023010500003,111.71120170000003,110.935002,109.23850299999997,110.75666666666666,38582000,44796312,57.897966289194926,NaN,1.5,2.75,NaN,NaN,1.23644880057292,0.8612762586348626,73.29144121925461,0.4247307813921684,-0.06558154199123578,-0.4903123233834042,12.176053184634627,3.8511964853243534,NaN,NaN,NaN,931785181
1093527000,110.99001,111.31,110.85001,111.10001,NaN,NaN,106.38328125000001,112.6524,111.52975110000028,111.67580180000004,110.8770022,109.26500299999998,110.43812173003964,109.77671174561523,109.2869261538464,112.0007868253675,106.57306548232529,111.52975110000028,111.67580180000004,110.8770022,109.26500299999998,111.08667333333334,26634096,43510336.8,57.897966289194926,NaN,1.5,2.75,NaN,NaN,1.1809874576748545,0.6121326093711139,74.38049884474002,0.43311762441247575,0.05108470713219049,-0.38203291728028527,8.858072378860918,3.6477376620953446,NaN,NaN,NaN,931785181
1093613400,111.23,111.63,111.05,111.45,NaN,NaN,106.3603125,112.5992,111.56110115000028,111.63760180000004,110.8294022,109.29550299999997,110.4778032308224,109.93607253174712,109.53538769230794,112.40026279745612,106.67051258715975,111.56110115000028,111.63760180000004,110.8294022,109.29550299999997,111.37666666666668,24904704,42676087.2,59.72872576217011,NaN,1.5,2.75,NaN,NaN,1.1380597821266505,0.5835751502541685,76.5642358900349,0.44148805891554804,0.1698271563641498,-0.27166090255139824,8.795149389122304,2.908587257617734,NaN,NaN,NaN,956689885
1093872600,111.23,111.34,110.45,110.53,NaN,NaN,106.33734375,112.546,111.58800120000028,111.59390190000005,110.76740219999999,109.26850249999998,110.47985016294702,109.9926370525331,109.71769538461561,112.5099868921008,106.92540387713042,111.58800120000028,111.59390190000005,110.76740219999999,109.26850249999998,110.77333333333335,26729808,42072447.2,53.182193182219095,NaN,1.5,2.75,NaN,NaN,1.128198369117604,0.6353281013803257,74.49839065492336,0.36735538140784063,0.18753332420840252,-0.17982205719943808,10.196627397812968,1.4874667156367685,NaN,NaN,NaN,929960077
1093959000,110.66,111.16,110.10001,111.11,NaN,NaN,106.314375,112.4928,111.61190120000026,111.55870190000007,110.7256022,109.313502,110.50456192126282,110.09905257133947,110.03538769230792,112.41939630395868,107.65137908065716,111.61190120000026,111.55870190000007,110.7256022,109.313502,110.79000333333332,44207808,42233432.8,56.42478631717708,NaN,1.5,2.75,NaN,NaN,1.1233263427520608,1.0467491053675373,77.34376476848976,0.3402867275999656,0.24553635230051896,-0.09475037529944666,10.149824609323476,0.9815504862310264,NaN,NaN,NaN,974167885
1094045400,110.94,111.64,110.48,111.32001,NaN,NaN,106.29140625000001,112.4396,111.63670125000026,111.52820200000005,110.6766024,109.3695025,110.53654027729173,110.2153342312119,110.35308076923098,112.16868096375748,108.53748057470449,111.63670125000026,111.52820200000005,110.6766024,109.3695025,111.14667000000001,52792608,42833712.8,57.570679498159386,NaN,1.5,2.75,NaN,NaN,1.1259458896983419,1.232501330120512,79.20846961993584,0.3197483959059061,0.30493511958293595,-0.014813276322970137,8.703592546791004,1.4675051073279453,NaN,NaN,NaN,1026960493
1094131800,111.24001,112.7,111.24001,112.58,NaN,NaN,106.2684375,112.3864,111.67230120000028,111.50580190000007,110.63320239999999,109.578503,110.61667595269206,110.440540494906,110.68231153846175,112.44065290190211,108.92397017502138,111.67230120000028,111.50580190000007,110.63320239999999,109.578503,112.17333666666667,42831392,42434317.6,63.73280311439622,NaN,1.5,2.75,NaN,NaN,1.1498061832913178,1.0093573886056788,81.86757964807163,0.370658296267358,0.44850959401122736,0.07785129774386937,9.975578551991958,1.900796524257779,NaN,NaN,NaN,1069791885
1094218200,112.27,112.82001,112.00999,112.12,NaN,NaN,106.24546875,112.3332,111.70825125000027,111.49490180000006,110.58780239999999,109.84200249999999,110.67562983690021,110.60048901920067,110.92923461538481,112.51585860602292,109.34261062474671,111.70825125000027,111.49490180000006,110.58780239999999,109.84200249999999,112.31666666666666,30491600,40221466.4,60.29020364737354,NaN,1.5,2.75,NaN,NaN,1.1255357416276517,0.7580926984800336,80.31644617941267,0.35307123437397087,0.519190340711333,0.1661191063373621,10.207451196806952,1.742286751361163,NaN,NaN,NaN,1039300285
1094563800,112.53999,113.13,112.32001,112.86,NaN,NaN,106.2225,112.28,111.75335125000026,111.48960180000007,110.56820239999998,110.1350025,110.76129141192374,110.81568054118155,111.14692692307712,112.94304528743784,109.3508085587164,111.75335125000026,111.48960180000007,110.56820239999998,110.1350025,112.77000333333332,37352496,40215036,63.688249494676576,NaN,1.5,2.75,NaN,NaN,1.1172831886542474,0.928819161071993,83.32422425832118,0.36925002221071285,0.6276816341007532,0.2584316118900403,10.237092856019943,2.2745716108226923,NaN,NaN,NaN,1076652781
1094650200,112.62,113.06,112.31,112.58,NaN,NaN,106.19953125,112.2268,111.79265125000028,111.48580170000007,110.55080239999998,110.3530025,110.83261331733848,110.98371096583092,111.36769538461557,113.10772179946176,109.62766896976939,111.79265125000028,111.48580170000007,110.55080239999998,110.3530025,112.64999999999999,33004800,39060191.2,61.54231529945017,NaN,1.5,2.75,NaN,NaN,1.091048675178944,0.8449728223552576,81.31262995829272,0.33980885912625813,0.683192685797863,0.34338382667160483,10.60796728069609,1.3321240925180842,NaN,NaN,NaN,1043647981
1094736600,112.57001,112.88,112.03,112.48,NaN,NaN,106.1765625,112.17360000000001,111.83615125000027,111.47230170000006,110.52200239999996,110.56900250000001,110.89721671665855,111.12621468337083,111.52154153846172,113.27403645520809,109.76904662171535,111.83615125000027,111.47230170000006,110.52200239999996,110.56900250000001,112.46333333333332,34332400,38126751.2,60.75496944202975,NaN,1.5,2.75,NaN,NaN,1.073830912666162,0.900480605334136,83.1088934411927,0.2940300353887838,0.7109213709075846,0.41689133551880075,10.252724465357998,1.2421150997196189,NaN,NaN,NaN,1009315581
1094823000,112.52,113.27,112.08,113.06,NaN,NaN,106.15359375,112.1204,111.88040120000029,111.46460170000006,110.49260239999998,110.87300250000001,110.98203174737782,111.31038471352599,111.74154153846172,113.49326221412208,109.98982086280135,111.88040120000029,111.46460170000006,110.49260239999998,110.87300250000001,112.80333333333333,27914608,37020591.2,63.65900052343048,NaN,1.5,2.75,NaN,NaN,1.0821287046185788,0.7540292333310982,84.5132517367221,0.2831367415225238,0.7708122624219556,0.4876755208994317,10.448599171919994,1.4445939883355758,NaN,NaN,NaN,1037230189
1095082200,113.31,113.74001,113.00999,113.42999,NaN,NaN,106.13062500000001,113.74001,111.91960115000029,111.47970160000006,110.50240219999998,111.18500200000001,111.07803011022574,111.51225188366638,111.97846307692326,113.7463381066759,110.21058804717062,111.91960115000029,111.47970160000006,110.50240219999998,111.18500200000001,113.39332999999998,44537904,37165446.4,65.41702768900632,NaN,1.5,2.75,NaN,NaN,1.0569780828601085,1.1983686007872087,85.88448537477976,0.28063239291435427,0.8384660120423746,0.5578336191280203,10.454777309385168,2.623713019089842,NaN,NaN,NaN,1081768093
1095168600,113.3,113.69,113.19,113.66,NaN,NaN,106.10765625,113.74449310344828,111.95795110000029,111.48960160000006,110.51800219999997,111.453002,111.17928383139336,111.7167993233172,112.1753853846156,114.07350261934651,110.27726814988468,111.95795110000029,111.48960160000006,110.51800219999997,111.453002,113.51333333333334,28067296,36281460.8,66.50192825977061,NaN,1.5,2.75,NaN,NaN,1.0171939340843865,0.773598840320123,85.20095548168503,0.2739445401945987,0.9002642943712686,0.62631975417667,8.28119489871284,2.2950229502295,NaN,NaN,NaN,1109835389
1095255000,113.3,113.36,112.67999,112.8,NaN,NaN,106.0846875,113.74897620689654,111.99010110000029,111.47510160000006,110.53620219999998,111.647502,111.24284132820146,111.8199612925251,112.30615384615406,114.12237693415534,110.48993075815278,111.99010110000029,111.47510160000006,110.53620219999998,111.647502,112.94666333333333,38458800,36165645.6,59.0436705508492,NaN,1.5,2.75,NaN,NaN,1.014537938792644,1.063406980905658,83.55030782662371,0.19479886967810112,0.8698183412742964,0.6750194715961952,9.989012228940878,1.3294914364452544,NaN,NaN,NaN,1071376589
1095341400,112.94,113.37,112.8,113.14,NaN,NaN,106.06171875,113.75345931034482,112.02355110000028,111.46290160000004,110.55460219999998,111.80300199999999,111.31723970748769,111.94567926466556,112.43615384615406,114.2304409762928,110.64186671601531,112.02355110000028,111.46290160000004,110.55460219999998,111.80300199999999,113.10333333333334,23917504,35201311.2,60.910187278866054,NaN,1.5,2.75,NaN,NaN,0.9827852288788843,0.6794492359705055,86.47344235092369,0.15052420009173384,0.8631747217108625,0.7126505216191287,10.025141082061012,0.49742405400604217,NaN,NaN,NaN,1095294093
1095427800,112.91,113.36,112.69,113.14999,NaN,NaN,106.03875000000001,113.7579424137931,112.0513010000003,111.45240150000004,110.58920199999997,111.97500099999999,111.38911226797836,112.0603755251736,112.63769153846175,114.08538236004536,111.19000071687815,112.0513010000003,111.45240150000004,110.58920199999997,111.97500099999999,113.06666333333334,33694496,34887596,60.96647580500238,NaN,1.5,2.75,NaN,NaN,0.960443426816107,0.9658015989407811,87.2765161558955,0.10902340732856974,0.8489297807798408,0.7399063734512711,7.933327815042391,0.9186496610774152,NaN,NaN,NaN,1128988589
1095687000,112.67,112.99001,112.28,112.47,NaN,NaN,106.01578125,113.76242551724138,112.0770010000003,111.43410150000004,110.60400199999998,112.07450099999998,111.43150002217529,112.09938737991897,112.74230692307714,113.90100385905762,111.58360998709665,112.0770010000003,111.43410150000004,110.60400199999998,112.07450099999998,112.58000333333332,37189808,34502401.6,55.145593432715316,NaN,1.5,2.75,NaN,NaN,0.9539824677578137,1.077890415605156,85.51841800991242,0.02715536887333636,0.7738505845429415,0.7466952156696052,8.405781196984632,-0.34556087187666185,NaN,NaN,NaN,1091798781
1095773400,112.75,113.47,112.53999,112.96001,NaN,NaN,105.9928125,113.76690862068965,112.10600105000029,111.43550150000004,110.62760219999998,112.21250149999999,111.49144158993312,112.1813514389743,112.86846076923099,113.68764501642903,112.04927652203295,112.10600105000029,111.43550150000004,110.62760219999998,112.21250149999999,112.99,40929392,34856356,58.23978738977996,NaN,1.5,2.75,NaN,NaN,0.9572694343465413,1.1742303756594636,88.12250134191238,-0.0011176451937909837,0.7452981591773664,0.7464158043711574,7.879463104648011,0.33754663350506187,NaN,NaN,NaN,1132728173
1095859800,112.5,112.52,111.47,111.55,NaN,NaN,105.96984375000001,113.77139172413793,112.12575100000029,111.43270150000004,110.62140219999999,112.27250099999999,111.49373799817103,112.12122273050056,112.78923000000023,113.86404314190628,111.71441685809418,112.12575100000029,111.43270150000004,110.62140219999999,112.27250099999999,111.84666666666668,49169200,35787136,47.98260313833235,NaN,1.5,2.75,NaN,NaN,0.9953223318932168,1.3739350363214313,85.31944178900544,-0.11556850843363997,0.6019551688291074,0.7175236772627474,10.694280856221688,-0.8268136557610302,NaN,NaN,NaN,1083558973
1095946200,111.60001,111.7,110.95,110.95,NaN,NaN,105.946875,113.77587482758621,112.14625095000031,111.43260140000004,110.61000219999998,112.26500049999997,111.47241493941922,112.00967770854812,112.69923000000024,114.12256021116487,111.27589978883562,112.14625095000031,111.43260140000004,110.61000219999998,112.26500049999997,111.2,44090304,36062551.2,44.39918784345171,NaN,1.5,2.75,NaN,NaN,0.9777993081865585,1.222606347384541,84.20506749579894,-0.2260779247437087,0.43492627133311146,0.6610041960768201,10.996965758311418,-1.8662656996285152,NaN,NaN,NaN,1039468669
1096032600,111.17,111.73,111.13,111.46001,NaN,NaN,105.92390625,113.78035793103449,112.1657009500003,111.42570160000005,110.62320239999997,112.28300049999996,111.47192847120671,111.95732840297211,112.5915384615387,114.15488064378741,111.02819627929,112.1657009500003,111.42570160000005,110.62320239999997,112.28300049999996,111.44000333333334,35011600,36481426.4,47.95703658229549,NaN,1.5,2.75,NaN,NaN,0.9636707861732329,0.959710281503686,85.63167580490331,-0.25697030992995695,0.339791308664374,0.596761618594331,10.880579008560874,-1.736736466255535,NaN,NaN,NaN,1074480269
1096291800,111.10001,111.2,110.58,110.75,NaN,NaN,105.9009375,113.78484103448275,112.1857509000003,111.41260160000006,110.62400219999998,112.24800049999996,111.44361755076723,111.8423447455462,112.45076923076948,114.29690024603745,110.60463821550151,112.1857509000003,111.41260160000006,110.62400219999998,112.24800049999996,110.8433333333333,39672096,37219796,43.759017886089644,NaN,1.5,2.75,NaN,NaN,0.9576950157322875,1.0658869812182743,83.46216735428754,-0.3136139914620477,0.20474412926677132,0.518358120728819,10.767732761802305,-2.5602674643674086,NaN,NaN,NaN,1034808173
1096378200,110.91,111.50999,110.41,111.28,NaN,NaN,110.41,113.78932413793103,112.20850090000029,111.39760160000006,110.64480199999997,112.28550049999997,111.43720117622733,111.78878810311323,112.3584615384618,114.3066935599523,110.4102295169713,112.20850090000029,111.39760160000006,110.64480199999997,112.28550049999997,111.06666333333332,41702304,37968420.8,47.45650822167677,NaN,1.5,2.75,NaN,NaN,0.9678589431799817,1.098341809359635,85.79421828393328,-0.3035794002383788,0.1388838704308455,0.4424632706692243,11.282156294029207,-1.3475177304964505,NaN,NaN,NaN,1076510477
1096464600,111.21001,111.85001,111,111.84,NaN,NaN,110.53322580645161,113.79380724137931,112.2280509500003,111.39790160000005,110.64880199999996,112.32200049999997,111.45299720853214,111.79366542662626,112.26461538461564,114.18598347710787,110.34324729212341,112.2280509500003,111.39790160000005,110.64880199999996,112.32200049999997,111.56333666666667,33866704,37451365.6,51.113624990579076,NaN,1.5,2.75,NaN,NaN,0.9594411615242685,0.9042848894140191,87.17195125811519,-0.2496717405020507,0.1303735950416609,0.3800453355437116,11.3625626051694,-1.1490189146190535,NaN,NaN,NaN,1110377181
1096551000,111.55,111.98,111.25999,111.75999,NaN,NaN,110.65645161290323,113.79829034482758,112.24615090000029,111.41590140000005,110.69240179999996,112.34399949999997,111.46503614153087,111.79045824313805,112.13615384615409,113.9489203585581,110.32338733375008,112.24615090000029,111.41590140000005,110.69240179999996,112.34399949999997,111.66666,43592096,36991340,50.57203422997894,NaN,1.5,2.75,NaN,NaN,0.9423389357011066,1.1784405755509262,89.12576581030478,-0.21136611060606947,0.11583769728612481,0.3272038078921943,11.09764415242053,-1.2284579079503237,NaN,NaN,NaN,1066785085
1096637400,112.25999,113.64999,112.21001,113.64999,NaN,NaN,110.77967741935484,113.80277344827586,112.2764008000003,111.46410130000005,110.76780159999994,112.39749899999997,111.55072060656887,111.96755650569632,112.13538384615407,113.94556726100963,110.32520043129851,112.2764008000003,111.46410130000005,110.76780159999994,112.39749899999997,113.16999666666668,62844304,37991985.6,61.06649797206199,NaN,1.5,2.75,NaN,NaN,1.0100290117224562,1.6541463418537408,91.95557366597272,-0.05864439315019282,0.25389831645445327,0.3125427096046461,15.185209218117233,1.049159775940254,NaN,NaN,NaN,1129629389
1096896600,114.09,114.44,113.8,113.84,NaN,NaN,110.90290322580644,113.80725655172414,112.30480080000031,111.50500130000006,110.86540139999995,112.48349899999998,111.64049626905637,112.14588445753476,112.21538384615407,114.21771207445946,110.21305561784868,112.30480080000031,111.50500130000006,110.86540139999995,112.48349899999998,114.02666666666669,33587104,38146760.8,61.94136108164333,NaN,1.5,2.75,NaN,NaN,0.9943133680279946,0.8804706689538894,93.66399375101969,0.04942945871168525,0.37432953299425265,0.3249000742825674,14.618696770213528,0.7790279055393201,NaN,NaN,NaN,1163216493
1096983000,113.85001,114.16,113.53999,113.89999,NaN,NaN,111.02612903225805,113.81173965517242,112.33180075000031,111.53950120000005,110.96840119999996,112.53549849999997,111.72910386634828,112.31294212824574,112.27384461538485,114.41995650914042,110.12773272162927,112.33180075000031,111.53950120000005,110.96840119999996,112.53549849999997,113.86666000000001,37162704,38137271.2,62.22993129223134,NaN,1.5,2.75,NaN,NaN,0.9675774131688517,0.9744458067047019,93.90063694234367,0.11544325110944537,0.4692041381693741,0.35376088705992875,14.482861964844146,2.106669654863295,NaN,NaN,NaN,1200379197
1097069400,113.77,114.67999,113.67999,114.62,NaN,NaN,111.14935483870967,114.67999,112.3563007500003,111.58580110000007,111.06540119999994,112.63749849999996,111.84247234217776,112.53266192555567,112.38692230769256,114.83888709988724,109.93495751549787,112.3563007500003,111.58580110000007,111.06540119999994,112.63749849999996,114.32666,42297808,38601921.6,65.60114709362301,NaN,1.5,2.75,NaN,NaN,0.9698933122282194,1.0957435859876985,96.24432146523857,0.19349187694563608,0.5956257332419739,0.4021338562963378,11.92733304235102,3.307796304641732,NaN,NaN,NaN,1242677005
1097155800,114.38,114.39999,113.36,113.45,NaN,NaN,111.27258064516128,114.73528294117648,112.3790508000003,111.61990120000007,111.13240099999993,112.68599849999995,111.90551264248451,112.62002745645513,112.46230692307716,114.97925148197827,109.94536236417606,112.3790508000003,111.61990120000007,111.13240099999993,112.68599849999995,113.73666333333334,39410304,38855816.8,56.73876139795737,NaN,1.5,2.75,NaN,NaN,0.9906152184976327,1.0142703781741118,93.5562805597138,0.1539352353730295,0.5945529005126247,0.44061766513959516,13.373437786500672,1.7853847312592257,NaN,NaN,NaN,1203266701
1097242200,113.14999,113.7,112.35001,112.50999,NaN,NaN,111.3958064516129,114.79057588235294,112.3933007500003,111.65400100000008,111.17120059999992,112.65849799999997,111.92921763689688,112.6095476986975,112.42769000000024,114.92862946847832,109.92675053152216,112.3933007500003,111.65400100000008,111.17120059999992,112.65849799999997,112.85333333333334,51882800,40054226.4,50.800754824487015,NaN,1.5,2.75,NaN,NaN,1.0162848457478022,1.2953139946300398,92.67545023044174,0.057066090058836005,0.5119502777131402,0.45488418765430416,14.537981350173746,1.5891557562076768,NaN,NaN,NaN,1151383901
1097501400,112.78,113.02,112.64,112.97,NaN,NaN,111.51903225806451,114.84586882352941,112.40950075000029,111.68720110000008,111.21380059999993,112.63549849999995,111.97003263152837,112.64387648929774,112.53692076923102,114.99871635775096,110.07512518071107,112.40950075000029,111.68720110000008,111.21380059999993,112.63549849999995,112.87666666666667,20246192,38839640.8,53.37246914726009,NaN,1.5,2.75,NaN,NaN,0.9801223567658158,0.5212764995499135,93.63489267338686,0.018568558928629575,0.4780948863150911,0.45952632738646154,13.833122314856347,1.5186915887850447,NaN,NaN,NaN,1171630093
1097587800,112.2,112.83,111.94,112.53,NaN,NaN,111.64225806451613,114.90116176470589,112.42405075000029,111.71980110000008,111.24300039999991,112.57899849999997,111.99199213617432,112.63303110936462,112.65845923076948,114.94461297342362,110.37230548811534,112.42405075000029,111.71980110000008,111.24300039999991,112.57899849999997,112.43333333333331,41855296,39529040.8,50.64552973390846,NaN,1.5,2.75,NaN,NaN,0.9836850455682576,1.0588492701295196,92.69208363180479,-0.03880352819549426,0.4110219171420937,0.44982544533758795,14.08608019616318,0.6169527896995688,NaN,NaN,NaN,1129774797
1097674200,113,113.07001,111.32001,111.53999,NaN,NaN,111.76548387096774,114.95645470588236,112.4332507000003,111.73900100000006,111.26959999999991,112.51599799999997,111.9742665622067,112.5289319560918,112.66461153846178,114.93822759012696,110.39099548679661,112.4332507000003,111.73900100000006,111.26959999999991,112.51599799999997,111.97667,54434304,40327816,45.06621493529766,NaN,1.5,2.75,NaN,NaN,1.0384218280276678,1.3497954860734338,90.04101422228634,-0.14001019393221564,0.2748127029223184,0.41482289685453405,14.900104887446693,-0.19685041131445954,NaN,NaN,NaN,1075340493
1097760600,111.75,111.92999,110.58,110.64,NaN,NaN,111.88870967741934,115.01174764705883,112.4306507000003,111.74730100000006,111.27839999999993,112.39099799999997,111.92194238329662,112.34903367455924,112.65615000000025,114.95883780127383,110.35346219872667,112.4306507000003,111.74730100000006,111.27839999999993,112.39099799999997,111.04999666666667,64549392,42359410.4,40.67896452356933,NaN,1.5,2.75,NaN,NaN,1.0606766974542634,1.5238501053357438,88.36310343342281,-0.2573221260224296,0.09317023932649704,0.35049236534892664,15.567380003595897,-2.648473616231732,NaN,NaN,NaN,1010791101
1097847000,111.03999,111.74001,110.57001,111.25999,NaN,NaN,112.01193548387096,115.0670405882353,112.43105070000028,111.75720090000006,111.33559999999993,112.29649799999997,111.8959834663046,112.24531522936311,112.65461076923103,114.96099983715195,110.34822170131011,112.43105070000028,111.75720090000006,111.33559999999993,112.29649799999997,111.19000333333334,63483392,43848855.2,44.674700616720244,NaN,1.5,2.75,NaN,NaN,1.068485504778959,1.4477776377614529,90.61453975658218,-0.2809907798974901,-0.0007461095229359671,0.28024467037455414,11.76042839648281,-2.266347505270556,NaN,NaN,NaN,1074274493
1098106200,110.89,111.89999,110.7,111.67999,NaN,NaN,112.13516129032257,115.12233352941178,112.4330506500003,111.75550070000007,111.43219959999992,112.25699749999998,111.88751313429266,112.19147473132853,112.64230230769257,114.96757977285925,110.3170248425259,112.4330506500003,111.75550070000007,111.43219959999992,112.25699749999998,111.42666000000001,43762608,44177495.2,47.26605963470955,NaN,1.5,2.75,NaN,NaN,1.0778786830090332,0.9906086300700905,91.59189531143262,-0.2568473509732686,-0.04081451834203165,0.21603283263123696,12.065007207404456,-1.9490783098400613,NaN,NaN,NaN,1118037101
1098192600,112.02,112.23,110.59,110.74001,NaN,NaN,112.25838709677419,115.17762647058824,112.4306007000003,111.74050070000007,111.50699979999992,112.1459975,111.84251301137922,112.05323999501152,112.56384230769257,115.06508434238391,110.06260027300122,112.4306007000003,111.74050070000007,111.50699979999992,112.1459975,111.18666999999999,56057808,44933916,42.47143359037137,NaN,1.5,2.75,NaN,NaN,1.1180302056512452,1.2475611518034617,89.44644869674593,-0.2902072126347618,-0.1467261831622153,0.14348102947254648,12.49159788173008,-3.3850898621532073,NaN,NaN,NaN,1061979293
1098279000,110.38,110.82001,109.75,110.52,NaN,NaN,112.3816129032258,115.23291941176471,112.42100070000032,111.71700070000006,111.55299979999992,112.09449749999999,111.79064975603102,111.90721713834375,112.32307384615412,114.95872643033495,109.68742126197328,112.42100070000032,111.71700070000006,111.55299979999992,112.09449749999999,110.36333666666668,57174896,45334200.8,41.41255573431553,NaN,1.5,2.75,NaN,NaN,1.1146001909618704,1.2611868079959623,90.91469176412886,-0.31125199937937953,-0.24558396975167796,0.06566802962770159,11.110978886711761,-2.5826355222565067,NaN,NaN,NaN,1004804397
1098365400,110.78999,111.32001,110.21001,111.24001,NaN,NaN,112.50483870967741,115.28821235294119,112.41445075000033,111.70080080000005,111.61459999999994,112.108998,111.76905604010823,111.84367360135863,112.1230746153849,114.66070683145598,109.5854423993138,112.41445075000033,111.70080080000005,111.61459999999994,112.108998,110.92334333333332,53261696,45792770.4,46.144702098347935,NaN,1.5,2.75,NaN,NaN,1.1142716058931652,1.1631027241802343,93.1611359828681,-0.2627754466444684,-0.26280127867788394,-0.00002583203341552376,11.607148567353933,-1.128770876257303,NaN,NaN,NaN,1058066093
1098451800,111.19,111.25,109.86,109.99001,NaN,NaN,112.62806451612903,115.34350529411765,112.39975085000033,111.67360080000005,111.67480019999995,112.035498,111.69928952873143,111.66713421075305,111.82230692307719,114.37303332434529,109.2715805218091,112.39975085000033,111.67360080000005,111.67480019999995,112.035498,110.36667,48759808,46480180.8,40.0905685260932,NaN,1.5,2.75,NaN,NaN,1.1339664911865106,1.0490451448502112,91.07175395906793,-0.298388003674529,-0.37301083662657675,-0.07462283295204776,12.307148840056655,-2.6378596087456856,NaN,NaN,NaN,1009306285
1098711000,109.75,110.12,109.35001,109.86,NaN,NaN,109.35001,115.39879823529412,112.38215085000033,111.64090080000005,111.72820019999996,111.99099800000002,111.6271605276047,111.49502619068133,111.45615307692333,113.63477906706485,109.2775270867818,112.38215085000033,111.64090080000005,111.72820019999996,111.99099800000002,109.77667000000002,44055392,46699345.6,39.50995372643194,NaN,1.5,2.75,NaN,NaN,1.1079681703874746,0.94338349786212,92.12269525711474,-0.3126838846248324,-0.46547768873308826,-0.15279380410825588,11.669860612774485,-2.372700613169823,NaN,NaN,NaN,965250893
1098797400,110.10001,111.60001,109.88,111.53999,NaN,NaN,109.29422105263157,115.4540911764706,112.37790080000033,111.63540070000005,111.79299999999995,112.00399750000001,111.62374207554177,111.49930845823549,111.30922923076947,113.16368859445598,109.45476986708297,112.37790080000033,111.63540070000005,111.79299999999995,112.00399750000001,111.00666666666666,54483296,47338395.2,49.65622143250618,NaN,1.5,2.75,NaN,NaN,1.1531140153597979,1.1509324676050698,94.66862373702487,-0.1966468309462702,-0.39860234279109363,-0.20195551184482344,15.501218343827004,0,NaN,NaN,NaN,1019734189
1098883800,111.38,113.10001,111.12,112.88,NaN,NaN,109.23843210526316,115.50938411764707,112.37620080000033,111.63440070000004,111.87239999999996,112.05599750000002,111.67300709218719,111.6308028907845,111.3376915384618,113.27452293366618,109.40086014325742,112.37620080000033,111.63440070000004,111.87239999999996,112.05599750000002,112.36667,73928496,49341484.8,55.99633804569842,NaN,1.5,2.75,NaN,NaN,1.212178014262669,1.4983030263410315,96.98660041357188,-0.026251004346266066,-0.234769267277656,-0.20851826293138995,16.17050067928459,2.0245842371655773,NaN,NaN,NaN,1093662685
1098970200,112.78,113.56,112.49001,113.22,NaN,NaN,109.18264315789473,115.56467705882353,112.37950080000033,111.61960070000003,111.93619999999997,112.128998,111.73367348072887,111.78215499642407,111.35692230769256,113.36196388118469,109.35188073420042,112.37950080000033,111.61960070000003,111.93619999999997,112.128998,113.09000333333331,54427008,49883230.4,57.46020755498847,NaN,1.5,2.75,NaN,NaN,1.2020217275296214,1.0910882788376914,97.25104335624584,0.10552494657496092,-0.0766120797126888,-0.18213702628764972,15.054602706793553,1.7616485494920473,NaN,NaN,NaN,1148089693
1099056600,113.17999,113.64,112.89999,113.2,NaN,NaN,109.12685421052632,115.61997000000001,112.37800080000034,111.60300070000002,112.00599979999997,112.1064985,111.7911764814846,111.91718785390749,111.40846076923103,113.56051999064547,109.25640154781658,112.37800080000034,111.60300070000002,112.00599979999997,112.1064985,113.24666333333334,48824800,49182255.2,57.339369918074794,NaN,1.5,2.75,NaN,NaN,1.169020889848934,0.992732029091663,98.90706999927555,0.1829719228422287,0.04657787726513618,-0.13639404557709253,14.958022155340819,1.3610405946490496,NaN,NaN,NaN,1099264893
1099319400,113.56,113.84,113.2,113.50999,NaN,NaN,109.07106526315789,115.67526294117648,112.37665075000034,111.60020070000004,112.06659959999998,112.089998,111.85858093319108,112.0688832963925,111.55999923076949,113.98756596442203,109.13243249711695,112.37665075000034,111.60020070000004,112.06659959999998,112.089998,113.51666333333334,36770896,49341444.8,58.78607942341544,NaN,1.5,2.75,NaN,NaN,1.1312336834311532,0.7452334675047863,100.64930942888576,0.2429488127121666,0.1672919703131157,-0.07565684239905088,14.918281124965821,2.501336237914376,NaN,NaN,NaN,1136035789
1099405800,113.67,114.57001,113.22,113.55,NaN,NaN,109.01527631578948,115.73055588235295,112.37325075000034,111.59220060000003,112.13359959999998,112.07249850000001,111.92491109267378,112.2099420300694,111.78384538461563,114.36274335854567,109.20494741068559,112.37325075000034,111.59220060000003,112.13359959999998,112.07249850000001,113.78000333333334,56258496,50296234.4,58.97943701881013,NaN,1.5,2.75,NaN,NaN,1.1468605631860704,1.1185429022893214,101.47145657260513,0.27104848084083705,0.2631537586519954,-0.007894722188841616,13.536899570070254,2.741585233441912,NaN,NaN,NaN,1192294285
1099492200,115.03,115.36,114.24001,114.98,NaN,NaN,108.95948736842105,115.78584882352942,112.37715075000033,111.60980060000003,112.22619939999997,112.09049850000001,112.04471850080422,112.47375707482469,112.07000000000025,115.13299525605707,109.00700474394343,112.37715075000033,111.60980060000003,112.22619939999997,112.09049850000001,114.86000333333332,77030000,52032844,65.25388751807499,NaN,1.5,2.75,NaN,NaN,1.194227665815637,1.48041110341768,104.89052077206088,0.3657832331252771,0.4493343192177548,0.08355108609247767,14.309545778283844,3.3620906722320556,NaN,NaN,NaN,1269324285
1099578600,114.78,116.67,114.67999,116.55,NaN,NaN,108.90369842105262,115.8411417647059,112.38440070000033,111.63510060000003,112.33519919999998,112.24549850000002,112.22139620665504,112.86197068674615,112.4446161538464,116.31104812402518,108.57818418366762,112.38440070000033,111.63510060000003,112.33519919999998,112.24549850000002,115.96666333333332,55456704,52835164,70.57537781270301,NaN,1.5,2.75,NaN,NaN,1.25106926111452,1.0496173343949495,108.46700071625304,0.5054181919217906,0.7153238259947159,0.20990563407292534,15.305872178963373,5.964168927705343,NaN,NaN,NaN,1324780989
1099665000,117.05,117.64,116.49001,117.28,NaN,NaN,108.84790947368421,115.89643470588237,112.39680070000033,111.66790060000002,112.45879899999996,112.48399900000004,112.4197728260019,113.28273538324652,112.94769230769255,117.44625120068328,108.44913341470182,112.39680070000033,111.66790060000002,112.45879899999996,112.48399900000004,117.13666999999998,63308496,53406448.8,72.67120480902895,NaN,1.5,2.75,NaN,NaN,1.2438493138920546,1.1854092047400837,107.82373319535036,0.6111170471207625,0.9738019429738785,0.362684895853116,11.442533431141063,6.754050609867106,NaN,NaN,NaN,1388089485
1099924200,116.98,117.23,116.72,117.11,NaN,NaN,108.79212052631578,115.95172764705883,112.41020075000033,111.70070060000003,112.57199899999996,112.69099900000006,112.6037033034136,113.64723677531828,113.45461538461562,118.22183830390995,108.6873924653213,112.41020075000033,111.70070060000003,112.57199899999996,112.69099900000006,117.02,34161200,54102199.2,71.39585800910078,NaN,1.5,2.75,NaN,NaN,1.1950029343283366,0.6314198037258345,105.6368155710096,0.6311757445852023,1.151654576584619,0.5204788319994166,11.508312465739058,4.993733637594907,NaN,NaN,NaN,1353928285
1100010600,117.08,117.5,116.75999,116.88,NaN,NaN,108.73633157894737,116.0070205882353,112.41525075000034,111.73320060000003,112.69899899999997,112.90849900000005,112.77140121308365,113.95511898719272,113.88846076923102,118.79505745282503,108.981864085637,112.41525075000034,111.73320060000003,112.69899899999997,112.90849900000005,117.04666333333334,44713200,54245094.4,69.61578722217742,NaN,1.5,2.75,NaN,NaN,1.1625034390191697,0.8242809878859756,107.10973495964693,0.5912377032160031,1.2595259610194205,0.6682882578034174,10.91011940482448,3.5435861091424523,NaN,NaN,NaN,1309215085
1100097000,117.06,117.55,116.75999,116.97,NaN,NaN,108.68054263157894,116.06231352941178,112.42670080000035,111.77090060000002,112.81619899999998,113.17999950000004,112.9360521459039,114.24225051222199,114.42538307692332,119.02615221303564,109.824613940811,112.42670080000035,111.77090060000002,112.81619899999998,113.17999950000004,117.09333,45270192,53786888.8,69.93170381162177,NaN,1.5,2.75,NaN,NaN,1.1358967648035143,0.8416584972656014,108.53830638821836,0.5348625884998518,1.3368664934282322,0.8020039049283804,10.038784693058407,3.3121356650768417,NaN,NaN,NaN,1354485277
1100183400,117.17999,118.12,117.10001,117.86,NaN,NaN,108.62475368421052,116.11760647058824,112.44915080000035,111.81180060000003,112.94699879999996,113.54099950000004,113.12914814018218,114.58679808248655,115.04076769230794,119.1479393913858,110.93359599323007,112.44915080000035,111.81180060000003,112.94699879999996,113.54099950000004,117.69333666666668,38408000,52479819.2,72.92919425111323,NaN,1.5,2.75,NaN,NaN,1.136904138746121,0.7318622774523582,111.41358748392193,0.5209753823411034,1.4532231328547596,0.9322477505136562,10.286096684463704,4.116607773851587,NaN,NaN,NaN,1392893277
1100269800,117.97,119,117.67999,118.78999,NaN,NaN,108.5689647368421,116.17289941176472,112.47570075000036,111.85220050000002,113.07119859999997,113.91749950000005,113.3511419386064,114.98710207463068,115.59846000000024,119.6207726592814,111.57614734071909,112.47570075000036,111.85220050000002,113.07119859999997,113.91749950000005,118.48999333333335,55641808,52087740,75.65972698697703,NaN,1.5,2.75,NaN,NaN,1.1499831288356834,1.0682323325988035,114.38663020995993,0.53581142453015,1.6020120311763435,1.0662006066461935,10.12028117415686,4.651572958468238,NaN,NaN,NaN,1448535085
1100529000,118.5,118.77,118.23,118.73,NaN,NaN,108.51317578947368,116.22819235294119,112.50195075000036,111.89560050000001,113.20339859999996,114.27000000000005,113.56207754885713,115.34356854371347,116.04846000000026,120.06250323955382,112.0344167604467,112.50195075000036,111.89560050000001,113.20339859999996,114.27000000000005,118.57666666666667,35299392,51664579.2,75.13326895428574,NaN,1.5,2.75,NaN,NaN,1.1078407624902773,0.6832416434352764,115.50563597984831,0.5034734790286375,1.6955424554319904,1.192068976403353,10.526173048221617,4.561867018934397,NaN,NaN,NaN,1413235693
1100615400,118.36,118.41,117.73,117.88,NaN,NaN,108.45738684210527,116.28348529411765,112.52150075000036,111.9360005,113.30379859999998,114.62699950000005,113.73140784105881,115.58513344431219,116.4069215384618,120.17111262329013,112.64273045363348,112.52150075000036,111.9360005,113.30379859999998,114.62699950000005,118.00666666666666,40136704,50868524,67.92166216112938,NaN,1.5,2.75,NaN,NaN,1.1001378508838289,0.7890282800420944,113.57212581994183,0.3916988900002898,1.681692588903715,1.2899936989034253,12.33944947738078,2.522177770046957,NaN,NaN,NaN,1373098989
1100701800,118.37,119.14,118.07001,118.58,NaN,NaN,108.40159789473684,116.33877823529413,112.54550075000037,111.9873005,113.42379859999997,115.02999950000006,113.9215487100369,115.87035883056818,116.82076769230795,120.25189754159037,113.38963784302554,112.54550075000037,111.9873005,113.42379859999997,115.02999950000006,118.59667,54935008,50756529.6,70.43815173543547,NaN,1.5,2.75,NaN,NaN,1.1115565758206987,1.0823239577829609,115.99534681687959,0.3340189783229828,1.7075174218071538,1.373498443484171,11.149765043379004,1.7417417417417427,NaN,NaN,NaN,1428033997
1100788200,118.49001,118.8,118.23,118.74001,NaN,NaN,108.34580894736843,116.3940711764706,112.57495075000038,112.03550059999999,113.54899879999999,115.40499950000006,114.11050797630996,116.14365894194263,117.22307692307717,120.20400480769523,114.24214903845912,112.57495075000038,112.03550059999999,113.54899879999999,115.40499950000006,118.59000333333334,31910704,49688980,70.99822093139522,NaN,1.5,2.75,NaN,NaN,1.072873963262077,0.6422088760928479,115.78758380856026,0.2780460416013246,1.7210559954858269,1.4430099538845023,8.938036626876551,1.2448925648021802,NaN,NaN,NaN,1459944701
1100874600,118.7,118.72,117.14,117.42,NaN,NaN,108.29002,116.44936411764708,112.59615080000037,112.06440059999998,113.63619879999999,115.77649900000006,114.24029197723898,116.2652152331862,117.52076923076949,119.61651520097325,115.42502326056572,112.59615080000037,112.06440059999998,113.63619879999999,115.77649900000006,117.76,54280096,49964994.4,60.769717396165824,NaN,1.5,2.75,NaN,NaN,1.1105265373147855,1.0863624954193931,112.75411663766107,0.1309920555709565,1.606750023348198,1.4757579677772414,11.129710515592548,0.2647083938177801,NaN,NaN,NaN,1405664605
1101133800,117.17,118.12,117.03,117.98,NaN,NaN,108.23423105263157,116.50465705882354,112.61380080000038,112.11480059999998,113.72719899999998,116.18249900000005,114.38694719381785,116.42852806812084,117.75153846153873,119.2541073623877,116.24896956068976,112.61380080000038,112.11480059999998,113.72719899999998,116.18249900000005,117.71,37566496,49640549.6,63.192405768628184,NaN,1.5,2.75,NaN,NaN,1.1090603560780152,0.756770348086557,115.26055994731644,0.054238334072169714,1.5435558853674536,1.4893175512952839,11.37618024264357,0.9411362080766672,NaN,NaN,NaN,1443231101
1101220200,117.92999,118.25999,117.37,118.16,NaN,NaN,108.17844210526316,116.55995000000001,112.63220080000038,112.16760059999999,113.81719899999999,116.51349950000004,114.53491004896225,116.59343015687124,117.87538461538489,119.21832307860153,116.53244615216825,112.63220080000038,112.16760059999999,113.81719899999999,116.51349950000004,117.92999666666665,41973008,49015035.2,63.962770992282074,NaN,1.5,2.75,NaN,NaN,1.093412473501014,0.8563292432359612,117.21457678915323,0.0011966809644738952,1.4908134025008764,1.4896167215364025,11.248314923795785,1.0173548773189687,NaN,NaN,NaN,1485204109
1101306600,118.27,118.59,118.05,118.44,NaN,NaN,108.12265315789473,116.61524294117649,112.65015075000038,112.2331006,113.92999899999997,116.79149950000003,114.68805083135588,116.76929395145493,117.96461538461566,119.29151136650972,116.63771940272159,112.65015075000038,112.2331006,113.92999899999997,116.79149950000003,118.36,29732800,46805250.4,65.18348721579805,NaN,1.5,2.75,NaN,NaN,1.0538830111080848,0.6352449724315544,119.75440044943993,-0.0278231370479336,1.4548378002264855,1.482660937274419,11.268987526890964,0.49210928219921796,NaN,NaN,NaN,1514936909
1101479400,118.50999,118.98,118.3,118.35001,NaN,NaN,108.06686421052632,116.67053588235295,112.66155075000037,112.29440070000001,114.03419919999996,117.04800000000004,114.8316570732635,116.91983833703065,118.06000076923107,119.30307447829723,116.8169270601649,112.66155075000037,112.29440070000001,114.03419919999996,117.04800000000004,118.54333666666668,15490000,44858400,64.42811732191012,NaN,1.5,2.75,NaN,NaN,1.0271770817432222,0.3453087938936743,121.08616052755474,-0.06381375026824254,1.4028937494391158,1.4667074997073584,10.54960821992374,-0.3703847436976849,NaN,NaN,NaN,1499446909
1101738600,118.78999,119.00999,117.48,117.81,NaN,NaN,108.01107526315789,116.72582882352943,112.67235080000037,112.3583007,114.12739939999997,117.27850000000005,114.9484548350963,117.00461563826583,118.13153923076953,119.18774034799748,117.07533811354159,112.67235080000037,112.3583007,114.12739939999997,117.27850000000005,118.09999666666666,61760608,45505190.4,59.93935721688045,NaN,1.5,2.75,NaN,NaN,1.0630922901901347,1.357221175367283,119.46047385944888,-0.1308606160876058,1.303131729597851,1.4339923456854569,9.721316299926768,-0.774867346079341,NaN,NaN,NaN,1437686301
1101825000,118,118.24001,117.64,117.89,NaN,NaN,107.95528631578948,116.7811217647059,112.68615080000036,112.4199007,114.23579939999998,117.49750050000004,115.06380954744546,117.08893795843099,118.20230846153876,119.03798096330705,117.36663595977048,112.68615080000036,112.4199007,114.23579939999998,117.49750050000004,117.92333666666667,54476096,46390450.4,60.37975084367735,NaN,1.5,2.75,NaN,NaN,1.030014983747982,1.174295475260141,117.73661246327819,-0.17399238432248287,1.2165018652823534,1.3904942496048363,9.759296456801456,0.008483203257554391,NaN,NaN,NaN,1492162397
1101911400,118.16,119.5,118.10001,119.23,NaN,NaN,107.89949736842105,116.83641470588238,112.70145080000037,112.49440069999999,114.36119919999997,117.78150050000004,115.2271895651927,117.2928486290566,118.30769307692339,119.27869265950552,117.33669349434125,112.70145080000037,112.49440069999999,114.36119919999997,117.78150050000004,118.94333666666665,49909904,46073020.8,66.93628408726647,NaN,1.5,2.75,NaN,NaN,1.0714424849088402,1.0832783076381223,120.44110607840945,-0.11906677389193421,1.2416607822399186,1.3607275561318528,10.960639989161573,0.5481531455557478,NaN,NaN,NaN,1542072301
1101997800,119.10001,119.87,119.00999,119.33,NaN,NaN,107.84370842105263,116.89170764705884,112.71980080000037,112.56910069999998,114.51679919999997,117.99900050000004,115.38808409204789,117.48686304533693,118.34923230769262,119.43824034445768,117.26022427092755,112.71980080000037,112.56910069999998,114.51679919999997,117.99900050000004,119.40333,60177104,45230376,67.3702451471137,NaN,1.5,2.75,NaN,NaN,1.056340164558209,1.330457743707459,118.17843992546993,-0.08442251533149703,1.2551994119674816,1.3396219272989787,10.529922695852358,0.49687548451444485,NaN,NaN,NaN,1602249405
1102084200,119.27,120.14,119.09,119.25,NaN,NaN,107.78791947368421,116.94700058823531,112.73990080000038,112.64640069999997,114.68279919999998,118.13400050000003,115.53953177471269,117.65478085054293,118.38923230769261,119.56591585294414,117.21254876244107,112.73990080000038,112.64640069999997,114.68279919999998,118.13400050000003,119.49333333333334,49073696,44911225.6,66.61696141213328,NaN,1.5,2.75,NaN,NaN,1.0558872956611938,1.0926821823361685,120.30179121285862,-0.0756010879866611,1.2451205673156522,1.3207216553023133,10.543255283075931,1.5585079202861507,NaN,NaN,NaN,1553175709
1102343400,119.21001,119.64,118.84,119.21001,NaN,NaN,107.73213052631579,117.00229352941179,112.76155085000036,112.73050079999999,114.83779919999998,118.230501,115.68347209727297,117.80289791239599,118.49154076923108,119.70406334488524,117.27901819357692,112.76155085000036,112.73050079999999,114.83779919999998,118.230501,119.23000333333334,33045104,43398056,66.21838175769595,NaN,1.5,2.75,NaN,NaN,1.037609631685394,0.7614420332560519,118.68344402543325,-0.08070168987313098,1.2198445429608995,1.3005462328340305,7.609354054319167,1.0425580606882463,NaN,NaN,NaN,1520130605
1102429800,119.49001,119.62,118.03999,118.10001,NaN,NaN,107.67634157894737,117.05758647058825,112.77910090000036,112.80440079999998,114.98479939999997,118.2800015,115.77823828953677,117.83119430169161,118.45461846153879,119.68324304685372,117.22599387622385,112.77910090000036,112.80440079999998,114.98479939999997,118.2800015,118.58666666666667,52105696,44295280.8,56.17206328478195,NaN,1.5,2.75,NaN,NaN,1.0763525151364373,1.1763261245653962,115.57565810402016,-0.1623625709740455,1.0975930191164736,1.259955590090519,9.481540679737309,-0.05077014218009403,NaN,NaN,NaN,1468024909
1102516200,118.21001,118.82001,118.00999,118.78999,NaN,NaN,107.62055263157895,117.11287941176472,112.80110085000037,112.88990059999998,115.13499919999998,118.37550100000001,115.89634619975102,117.92250817772099,118.45846307692341,119.69094254062878,117.22598361321803,112.80110085000037,112.88990059999998,115.13499919999998,118.37550100000001,118.53999666666664,43901104,44254676,60.21287946588546,NaN,1.5,2.75,NaN,NaN,1.0573287640552629,0.9920105165836035,117.48156435367638,-0.17248857788165894,1.0443448677384453,1.2168334456201042,10.0221286373559,0.29549983113813355,NaN,NaN,NaN,1511926013
1102602600,118.14,119.46001,117.73,119.21001,NaN,NaN,107.56476368421052,117.1681723529412,112.82280090000036,112.9656007,115.28239939999997,118.48750150000001,116.02629379976078,118.04512739889041,118.59615615384648,119.72979746509763,117.46251484259533,112.82280090000036,112.9656007,115.28239939999997,118.48750150000001,118.80000666666666,60953104,45038821.6,62.48061266666251,NaN,1.5,2.75,NaN,NaN,1.1053774237656007,1.3533458877174531,118.65454624817548,-0.1540821696555501,1.0242307335506666,1.1783129032062167,10.121501021598101,0.7266581557534295,NaN,NaN,NaN,1572879117
1102689000,118.88,119.56,118.85001,119.33,NaN,NaN,107.5089747368421,117.22346529411766,112.84475090000038,113.06310069999999,115.43379959999999,118.5610015,116.15585090565251,118.16749621804371,118.70000230769263,119.8361766713851,117.56382794400015,112.84475090000038,113.06310069999999,115.43379959999999,118.5610015,119.24667,47852800,45511061.6,63.127182647310526,NaN,1.5,2.75,NaN,NaN,1.077135464925201,1.0514542688672417,119.72724608107696,-0.13755311996568276,1.0063715032491132,1.143924623214796,10.082361281914885,1.290213054918934,NaN,NaN,NaN,1620731917
1102948200,119.75999,120.39999,119.35001,120.37,NaN,NaN,107.45318578947368,117.27875823529413,112.87150090000037,113.16800070000001,115.56819979999999,118.64000199999998,116.32111165445045,118.37725848299193,118.87000230769262,120.26416479687067,117.47583981851456,112.87150090000037,113.16800070000001,115.56819979999999,118.64000199999998,120.04,38708896,44664416,68.23648217082544,NaN,1.5,2.75,NaN,NaN,1.0766250745734012,0.8666607439801742,121.81586257066515,-0.06404084206011085,1.0638735706396574,1.1279144126997682,10.349835099290775,2.103655950462299,NaN,NaN,NaN,1659440813
1103034600,120.17999,120.96001,120.17999,120.78999,NaN,NaN,107.39739684210527,117.33405117647061,112.89465085000037,113.2863005,115.70719959999998,118.74300149999999,116.49636178564847,118.6070424369927,119.05077076923106,120.7508735785533,117.35066795990883,112.89465085000037,113.2863005,115.70719959999998,118.74300149999999,120.64332999999999,41736096,44986251.2,70.04182893283706,NaN,1.5,2.75,NaN,NaN,1.0554389978181578,0.9277522551156696,123.75951320228025,0.0019121565509734317,1.1303046083884851,1.1283924518375117,10.329147896602494,1.3083871508848437,NaN,NaN,NaN,1701176909
1103121000,120.7,121.11,120.31,120.88,NaN,NaN,107.34160789473684,117.38934411764708,112.92165085000039,113.40760049999999,115.84679979999999,118.8930015,116.66826916660344,118.82351458585053,119.24538538461569,121.14730967086878,117.3434610983626,112.92165085000039,113.40760049999999,115.84679979999999,118.8930015,120.76666666666668,46759296,45317380.8,70.42973251023025,NaN,1.5,2.75,NaN,NaN,1.0371933551168606,1.0318181495608414,126.15654526545012,0.03860686928037582,1.1766510384379814,1.1380441691576055,8.656084805139908,1.2989189642168752,NaN,NaN,NaN,1747936205
1103207400,120.72,121.24001,120.03999,120.81,NaN,NaN,107.28581894736843,117.44463705882355,112.9472508500004,113.51800049999999,115.9705998,119.00450149999999,116.83068998359938,119.01270367291238,119.47615461538491,121.35327655065186,117.59903268011797,112.9472508500004,113.51800049999999,115.9705998,119.00450149999999,120.69666666666666,51650192,45153140,69.67416681045947,NaN,1.5,2.75,NaN,NaN,1.0488238297513701,1.1438892621864172,123.74365614692331,0.04474000051799609,1.1939691698051007,1.1492291692871046,8.725977644570042,1.3081761006289327,NaN,NaN,NaN,1696286013
1103293800,119.46001,119.97,119.16,119.44,NaN,NaN,107.23003,117.49993000000002,112.9645008000004,113.61140039999998,116.0903998,119.039501,116.93301586659548,119.05339856120644,119.59538538461568,121.23642351472724,117.95434725450413,112.9645008000004,113.61140039999998,116.0903998,119.039501,119.52333333333333,71183008,47116755.2,56.82529238520663,NaN,1.5,2.75,NaN,NaN,1.0917649847691298,1.510779078437048,124.42524761483783,-0.05166871879531043,1.0846432707929665,1.136311989588277,11.353766455581646,0.1929284294162888,NaN,NaN,NaN,1625103005
1103553000,119.75,120.28999,119.17,119.47,NaN,NaN,107.17424105263157,117.5552229411765,112.97995080000038,113.70040029999998,116.2296,119.14200099999998,117.03250544045449,119.09307488871059,119.61384692307722,121.24338713342689,117.98430671272754,112.97995080000038,113.70040029999998,116.2296,119.14200099999998,119.64332999999999,47201392,46762820,57.01224152526702,NaN,1.5,2.75,NaN,NaN,1.0937810572856206,1.0093786473955164,123.7417177217431,-0.11783228628755582,0.9890216317288321,1.1068539180163879,11.349416262162485,1.1600253039775368,NaN,NaN,NaN,1672304397
1103639400,119.60001,120.48,119.07001,120.39,NaN,NaN,107.11845210526316,117.61051588235296,113.00710075000039,113.79590029999997,116.37800000000001,119.26250099999997,117.16417189376999,119.21659156597624,119.69538538461569,121.36552752223889,118.02524324699249,113.00710075000039,113.79590029999997,116.37800000000001,119.26250099999997,119.98000333333333,33197600,46544375.2,62.39051313310227,NaN,1.5,2.75,NaN,NaN,1.1163674103366483,0.713246227011336,126.51007338954453,-0.1045040906130712,0.9762238047500489,1.08072789536312,10.249728515276995,1.346923255065513,NaN,NaN,NaN,1705501997
1103725800,120.38,121.08,120.05,120.67999,NaN,NaN,107.06266315789473,117.66580882352943,113.0380007000004,113.89200009999999,116.54099980000001,119.38850049999999,117.30204711362215,119.35596284540708,119.80538461538494,121.53113959196067,118.07962963880921,113.0380007000004,113.89200009999999,116.54099980000001,119.38850049999999,120.60332999999999,31507904,46021120,63.92270034144557,NaN,1.5,2.75,NaN,NaN,1.1101983095983163,0.6846400956778106,128.07192931740533,-0.08201826425834757,0.9782050650401857,1.0602233292985332,9.957440412919672,1.2331011464557438,NaN,NaN,NaN,1737009901
1103812200,120.87,121.28,120.09,120.77,NaN,NaN,107.00687421052632,117.7211017647059,113.07895070000039,113.99759999999998,116.72560000000001,119.50500049999998,117.43804526602912,119.4906330506064,119.92538384615416,121.68545924531706,118.16530844699126,113.07895070000039,113.99759999999998,116.72560000000001,119.50500049999998,120.71333333333331,25647696,45816864.8,64.40739322561195,NaN,1.5,2.75,NaN,NaN,1.1158984303412935,0.5597872336301807,129.42799943893175,-0.06754667677505166,0.9757899833297188,1.0433366601047704,9.885925551281465,1.2067376183692262,NaN,NaN,NaN,1762657597
1104157800,121.2,121.36,120.39,120.52,NaN,NaN,106.95108526315789,117.77639470588238,113.12595070000039,114.10079999999998,116.92320000000001,119.61349999999997,117.55890623598876,119.5886679981677,120.11153692307722,121.54080814054348,118.68226570561097,113.12595070000039,114.10079999999998,116.92320000000001,119.61349999999997,120.75666666666666,29984304,46541580,61.91915712709061,NaN,1.5,2.75,NaN,NaN,1.105477113888344,0.6442476598344964,127.25088267624446,-0.08040157481877896,0.9428346915812966,1.0232362664000756,10.074972200560914,0.12461576804850999,NaN,NaN,NaN,1732673293
1104244200,120.64,121.33,120.60001,121.17999,NaN,NaN,106.89529631578948,117.83168764705884,113.16895065000038,114.22859999999999,117.12160000000002,119.78199949999998,117.70090952085194,119.74022247453267,120.29538307692339,121.60744148234633,118.98332467150044,113.16895065000038,114.22859999999999,117.12160000000002,119.78199949999998,121.03666666666668,23429296,44625014.4,65.68781152791829,NaN,1.5,2.75,NaN,NaN,1.0843716057534623,0.5250260714761809,130.2078746702973,-0.05145362224168326,0.9589192385979715,1.0103728608396547,9.319814482534895,0.3228744368635187,NaN,NaN,NaN,1756102589
1104330600,121.08,121.39999,120.95,121.36,NaN,NaN,106.83950736842105,117.88698058823532,113.21975065000039,114.37369989999999,117.31520020000002,119.9554995,117.84440326513226,119.89448700076765,120.46076692307723,121.72502918335618,119.19650466279828,113.21975065000039,114.37369989999999,117.31520020000002,119.9554995,121.23666333333334,23770192,43089719.2,66.65704370507375,NaN,1.5,2.75,NaN,NaN,1.0390586339139292,0.5516441610972485,131.10482019718032,-0.028335881325667334,0.9749530091825704,1.0032888905082378,9.168847143544738,0.3970880211780311,NaN,NaN,NaN,1779872781
1104417000,121.39999,121.57001,121.03999,121.13,NaN,NaN,106.78371842105263,117.94227352941179,113.26645070000039,114.51499989999998,117.52300000000001,120.0504995,117.97325019591139,120.01215490545646,120.59922846153876,121.72441907946326,119.47403784361425,113.26645070000039,114.51499989999998,117.52300000000001,120.0504995,121.24666666666667,21079696,41648208.8,64.16313324991317,NaN,1.5,2.75,NaN,NaN,1.002698731491505,0.5061369169854911,132.6604551157907,-0.03618557144448609,0.9580569262026302,0.9942424976471163,9.264550989772742,0.26487873520403377,NaN,NaN,NaN,1758793085
1104503400,121.3,121.66,120.8,120.87,NaN,NaN,106.72792947368421,117.99756647058825,113.30560075000038,114.6414999,117.73,120.1274995,118.08684822744428,120.09385443827013,120.6376900000003,121.76309126599502,119.5122887340056,113.30560075000038,114.6414999,117.73,120.1274995,121.11,28655600,40072133.6,61.367972569727705,NaN,1.5,2.75,NaN,NaN,0.9925059649563975,0.7151004307891407,133.78418716687216,-0.06486560934772145,0.9131604859624645,0.9780260953101859,9.356361702534025,1.1972538513061008,NaN,NaN,NaN,1730137485
1104762600,121.56,121.75999,119.89999,120.3,NaN,NaN,106.67214052631579,121.75999,113.34175070000038,114.7628999,117.91119979999999,120.17999950000001,118.1736384930347,120.11348734891106,120.59999846153876,121.73524994843045,119.46474697464707,113.34175070000038,114.7628999,117.91119979999999,120.17999950000001,120.65332666666667,55997600,40418328.8,55.64485794715896,NaN,1.5,2.75,NaN,NaN,1.0544698246023692,1.3854506522793195,130.89986268250976,-0.12473388465172208,0.8221087394955333,0.9468426241472554,6.808164026300369,0.6947350799363843,NaN,NaN,NaN,1674139885
1104849000,120.46001,120.53999,118.44,118.73,NaN,NaN,106.61635157894737,121.8760555737705,113.38010070000037,114.88039989999999,118.08599959999998,120.15599900000002,118.19545659134707,119.98172664901477,120.43461384615414,121.92834466955972,118.94088302274855,113.38010070000037,114.88039989999999,118.08599959999998,120.15599900000002,119.23666333333334,69258880,42229017.6,43.587283506555956,NaN,1.5,2.75,NaN,NaN,1.1291498371307718,1.640077935414723,127.4579244530364,-0.26454531908637224,0.61616097528929,0.8807062943756623,10.477883999214935,-1.3788520641249244,NaN,NaN,NaN,1604881005
1104935400,118.74001,119.25,118,118.00999,NaN,NaN,106.56056263157895,121.99212114754098,113.42190070000035,114.98859979999999,118.24899939999997,120.15149800000002,118.1881833916864,119.79394220625146,120.21922846153876,122.171450711,118.26700621207752,113.42190070000035,114.98859979999999,118.24899939999997,120.15149800000002,118.41999666666668,65871680,42917316.8,39.37358522604765,NaN,1.5,2.75,NaN,NaN,1.137781991621431,1.5348508460342518,124.56024404896525,-0.39228710212465123,0.3903474167198482,0.7826345188444994,9.416404857402993,-2.2124628946356406,NaN,NaN,NaN,1539009325
1105021800,118.44,119.14999,118.25999,118.61,NaN,NaN,106.50477368421052,122.10818672131148,113.46765065000037,115.0916998,118.39039959999997,120.14249850000002,118.2047252194634,119.68118580565609,120.15538230769259,122.25415374320228,118.0566108721829,113.46765065000037,115.0916998,118.39039959999997,120.14249850000002,118.67332666666668,48281808,43136352,44.213496678690916,NaN,1.5,2.75,NaN,NaN,1.1379404207913288,1.119283522167104,126.25849549413304,-0.4206327318956793,0.25684360397490025,0.6774763358705795,9.97847839790615,-1.7885236399768127,NaN,NaN,NaN,1587291133
1105108200,118.97,119.23,118.13,118.44,NaN,NaN,106.4489847368421,122.22425229508197,113.51210065000036,115.18699980000001,118.50159959999995,120.10399800000002,118.21395168144522,119.56297763368885,120.07615153846183,122.34343828437693,117.80886479254673,113.51210065000036,115.18699980000001,118.50159959999995,120.10399800000002,118.6,55853600,42881376.8,43.16213164064881,NaN,1.5,2.75,NaN,NaN,1.135230390734806,1.3025141487527985,124.80892113495555,-0.43337438590574473,0.1357583534883986,0.5691327393941433,9.858567911579058,-1.7258546299369386,NaN,NaN,NaN,1531437533
1105367400,118.34,119.46001,118.34,119,NaN,NaN,106.39319578947368,122.34031786885247,113.55210065000036,115.2766998,118.61719959999995,120.08749800000002,118.24477710570227,119.50936071619466,119.96922846153873,122.29750898003883,117.64094794303864,113.55210065000036,115.2766998,118.61719959999995,120.08749800000002,118.93333666666666,56796496,43328561.6,47.58381712565638,NaN,1.5,2.75,NaN,NaN,1.1341432199680337,1.310832714095914,126.98699367736548,-0.3880931891752833,0.08401625292503923,0.4721094421003225,10.569678109881705,-1.798968625100566,NaN,NaN,NaN,1588234029
1105453800,118.64,118.74001,117.99001,118.17999,NaN,NaN,106.33740684210527,122.45638344262295,113.58785060000037,115.3613996,118.71679939999994,119.97799750000004,118.24223643489042,119.38275398131898,119.77692076923105,122.24725653828591,117.3065850001762,113.58785060000037,115.3613996,118.71679939999994,119.97799750000004,118.30333666666667,63353392,44560786.4,42.384216040437614,NaN,1.5,2.75,NaN,NaN,1.12527513282746,1.4217296667816437,124.33388963889261,-0.3960025802100207,-0.022893783162203363,0.37310879704781735,10.061134996243135,-2.6203114700065884,NaN,NaN,NaN,1524880637
1105540200,118.39999,118.84,117.52,118.57001,NaN,NaN,106.28161789473684,122.57244901639345,113.61775065000036,115.4422997,118.81799979999997,119.86699850000002,118.25509030018883,119.30534979262194,119.60769076923104,122.08412984283831,117.13125169562377,113.61775065000036,115.4422997,118.81799979999997,119.86699850000002,118.31000333333334,74303376,46189150.4,45.438100766402194,NaN,1.5,2.75,NaN,NaN,1.1391840519112133,1.608675963002775,125.85721259234431,-0.3587123201026977,-0.07528160308055476,0.28343071702214295,10.371976085085436,-2.1134235944852633,NaN,NaN,NaN,1599184013
1105626600,118.64,118.73,117.5,117.62,NaN,NaN,106.22582894736843,122.68851459016393,113.64100065000035,115.5164997,118.89939979999996,119.70399850000001,118.23018479822063,119.1448402885627,119.38461384615412,122.01011731211597,116.75911038019228,113.64100065000035,115.5164997,118.89939979999996,119.70399850000001,117.95,55780000,46640185.6,39.891605328291874,NaN,1.5,2.75,NaN,NaN,1.1456709053461271,1.1959643659737065,124.81665571226054,-0.3797466174843868,-0.19125255483334058,0.18849406265104623,10.865922096959267,-2.6888392487796806,NaN,NaN,NaN,1543404013
1105713000,117.97,118.53,117.75999,118.24001,NaN,NaN,106.17004,122.80458016393443,113.66670065000037,115.5953997,118.96459999999998,119.57549900000001,118.2305701002512,119.05866597536625,119.15846153846181,121.62827820129883,116.68864487562479,113.66670065000037,115.5953997,118.96459999999998,119.57549900000001,118.17666666666666,42033600,46159356,44.64103692695599,NaN,1.5,2.75,NaN,NaN,1.1288372692499749,0.9106192902691277,127.32792065505396,-0.33517443703635813,-0.23047398364440141,0.1047004533919567,11.847693939158903,-1.7123773898586858,NaN,NaN,NaN,1585437613
1106058600,118.05,119.62,117.95,119.47,NaN,NaN,106.11425105263157,122.92064573770492,113.69515065000037,115.67909959999999,119.02299999999997,119.576999,118.279175194359,119.09784064437899,119.01307692307721,121.14708646262471,116.8790673835297,113.69515065000037,115.67909959999999,119.02299999999997,119.576999,119.01333333333332,57437008,45472056,52.63640933168749,NaN,1.5,2.75,NaN,NaN,1.1674917500178341,1.2631275788365497,130.1881570755186,-0.2121265057281452,-0.1604576787682248,0.051668826959920394,13.682742279003392,0.6232628653246819,NaN,NaN,NaN,1642874621
1106145000,119.42999,119.52,118.21001,118.22,NaN,NaN,106.05846210526316,123.03671131147541,113.71305065000038,115.75029949999998,119.04179999999998,119.514499,118.27685459850179,119.01423677348575,118.78923076923107,120.56917931714652,117.00928222131562,113.71305065000038,115.75029949999998,119.04179999999998,119.514499,118.65000333333334,54907808,45857376.8,45.451917209738625,NaN,1.5,2.75,NaN,NaN,1.1776701964451317,1.1973604211918203,128.06353506405662,-0.2041255588707898,-0.2034881216285669,0.0006374372422229407,12.871738102293866,0.17795951003808824,NaN,NaN,NaN,1587966813
1106231400,117.89,118.2,117.28999,117.5,NaN,NaN,106.00267315789473,123.1527768852459,113.72420065000038,115.81079949999997,119.0496,119.369999,118.24638971228603,118.87002374743949,118.5300000000003,119.97175239529646,117.08824760470414,113.72420065000038,115.81079949999997,119.0496,119.369999,117.66333000000002,72090000,47801996.8,41.90400762119264,NaN,1.5,2.75,NaN,NaN,1.1599801824133362,1.5080959965254004,125.36026069624037,-0.23436465062957612,-0.2923183760447472,-0.05795372541517109,12.875951288731452,-0.9358401483854645,NaN,NaN,NaN,1515876813
1106317800,117.78999,118,116.64999,116.78,NaN,NaN,105.94688421052632,123.2688424590164,113.73360070000037,115.87329949999997,119.04759999999999,119.17499950000001,118.18888423337286,118.67097386673096,118.25923076923108,119.58728367688919,116.93117786157298,113.73360070000037,115.87329949999997,119.04759999999999,119.17499950000001,117.14332999999999,63274704,49390336.8,38.65458613149464,NaN,1.5,2.75,NaN,NaN,1.1735537408123835,1.2811150540686331,124.20880826707571,-0.28645251015670103,-0.41601936311104737,-0.12956685295434633,12.729955605136086,-1.4015535292131007,NaN,NaN,NaN,1452602109
1106577000,117.09,117.34,116.37,116.55,NaN,NaN,116.37,123.38490803278688,113.74320070000036,115.92769949999996,119.03919999999998,118.96399950000003,118.12461426343667,118.46897635561372,118.09153846153876,119.66696334987866,116.51611357319887,113.74320070000036,115.92769949999996,119.03919999999998,118.96399950000003,116.75333333333332,58554800,51035692,37.65020655195103,NaN,1.5,2.75,NaN,NaN,1.1590141878972133,1.147330382039299,121.76455808054428,-0.31758068388783833,-0.5265427078141443,-0.20896202392630592,12.731820949249045,-2.058823529411767,NaN,NaN,NaN,1394047309
1106663400,116.91,117.47,116.72,116.88,NaN,NaN,116.4832256451613,123.50097360655738,113.75575070000038,115.98329939999996,119.0196,118.78199950000003,118.07580586094896,118.3176452741267,118.00461615384644,119.7079464289591,116.30128587873378,113.75575070000038,115.98329939999996,119.0196,118.78199950000003,117.02333333333333,68335312,52953242.4,40.05682571799474,NaN,1.5,2.75,NaN,NaN,1.1419417459045553,1.2904839987664287,121.35829641155578,-0.29747821995834867,-0.5808097988742418,-0.2833315789158931,12.431679508558094,-1.100008554747727,NaN,NaN,NaN,1462382621
1106749800,117.32001,117.60001,117.03999,117.23,NaN,NaN,116.59645129032259,123.61703918032786,113.76780065000037,116.02979939999996,118.98840019999997,118.58450000000002,118.04263700365685,118.21406000992417,117.89846230769261,119.60963679070665,116.18728782467858,113.76780065000037,116.02979939999996,118.98840019999997,118.58450000000002,117.29,57442896,54653922.4,42.58795404150024,NaN,1.5,2.75,NaN,NaN,1.1118037640542302,1.0510297061496907,124.52975341660625,-0.24436482290919798,-0.5887876075523906,-0.3444227846431926,12.238245591589807,-1.1301424365233608,NaN,NaN,NaN,1519825517
1106836200,117.19,117.75,116.98,117.42999,NaN,NaN,116.70967693548387,123.73310475409836,113.78890055000038,116.08289929999995,118.96239999999997,118.38799950000002,118.01861163096443,118.13938667564568,117.82076923076953,119.51819862733258,116.12333983420648,113.78890055000038,116.08289929999995,118.96239999999997,118.38799950000002,117.38666333333333,56600496,56295437.6,44.04194581814621,NaN,1.5,2.75,NaN,NaN,1.0873892094789277,1.0054188831813966,126.32827888975113,-0.18236143543569505,-0.5723745789378114,-0.39001314350211636,12.076569769362848,-0.16154565550076594,NaN,NaN,NaN,1576426013
1106922600,117.49001,117.55,116.61,117.42999,NaN,NaN,116.82290258064516,123.84917032786885,113.80910050000038,116.12859919999995,118.95339979999997,118.20299900000002,117.99552842975014,118.07182508748895,117.69999923076954,119.26270195857968,116.13729650295939,113.80910050000038,116.12859919999995,118.95339979999997,118.20299900000002,117.19666333333333,60814096,58282157.6,44.04194581814621,NaN,1.5,2.75,NaN,NaN,1.0768614088018613,1.0434427705538478,125.2253306383083,-0.13038355020664782,-0.5529925812604262,-0.42260903105377834,11.204215400475572,-0.685064218110261,NaN,NaN,NaN,1576426013
1107181800,117.97,118.25,117.71001,118.16,NaN,NaN,116.93612822580646,123.96523590163935,113.8351004500004,116.18439919999996,118.94499979999996,118.06749900000003,118.00197829525013,118.08022269820428,117.69846153846184,119.25931024557114,116.13761283135254,113.8351004500004,116.18439919999996,118.94499979999996,118.06749900000003,118.04000333333333,54141296,59556442.4,49.460458788442104,NaN,1.5,2.75,NaN,NaN,1.058514879601728,0.9090753882908225,129.26960614617886,-0.04052951894293766,-0.47327092973245044,-0.4327414107895128,11.381681246998335,-1.0965095839959842,NaN,NaN,NaN,1630567309
1107268200,118.25,119.08,118.10001,118.91,NaN,NaN,117.04935387096775,124.08130147540984,113.86050045000039,116.24869919999996,118.94839959999996,117.99799900000001,118.03758698955404,118.15924910789911,117.72461461538494,119.35293561656367,116.0962936142062,113.86050045000039,116.24869919999996,118.94839959999996,117.99799900000001,118.69667,52014000,59357262.4,54.351091495898984,NaN,1.5,2.75,NaN,NaN,1.052905959630176,0.8762870438580065,132.47021584419335,0.06972234014850337,-0.34558848560388356,-0.4153108257523869,10.211556897414761,0.5836575875486362,NaN,NaN,NaN,1682581309
1107354600,119.06,119.59,118.89999,119.27,NaN,NaN,117.16257951612904,124.19736704918033,113.88770045000038,116.31079919999996,118.98539959999997,118.02499900000001,118.08591691153232,118.26503490714681,117.851537692308,119.67320167058905,116.02987371402695,113.88770045000038,116.31079919999996,118.98539959999997,118.02499900000001,119.25333,52606304,58524633.6,56.5257533597222,NaN,1.5,2.75,NaN,NaN,1.026984819656592,0.8988745552778651,135.0388149077736,0.16193177770915218,-0.21289610361594669,-0.37482788132509887,8.073645396101886,1.5063829787234009,NaN,NaN,NaN,1735187613
1107441000,119.06,119.16,118.57001,118.96001,NaN,NaN,117.27580516129032,124.31343262295083,113.92290050000038,116.36609939999997,119.00499979999996,118.07249999999999,118.12019507186439,118.33122301122806,117.90692230769262,119.8142294760232,115.99961513936205,113.92290050000038,116.36609939999997,119.00499979999996,118.07249999999999,118.89667333333334,49143104,57688204.8,54.134290414940935,NaN,1.5,2.75,NaN,NaN,1.0036280468239782,0.8518743852469475,134.02959812307444,0.19487253205029087,-0.13123721626223528,-0.32610974831252615,7.1639331928640075,1.8667665696180817,NaN,NaN,NaN,1686044509
1107527400,119,120.42999,118.98,120.23,NaN,NaN,117.38903080645161,124.42949819672131,113.96070050000039,116.43179939999996,119.04639979999996,118.15349999999998,118.20293252002656,118.51205891492063,117.96538384615415,120.09444751791318,115.83632017439513,113.96070050000039,116.43179939999996,119.04639979999996,118.15349999999998,119.87999666666667,50015008,57774864.8,61.34895069398472,NaN,1.5,2.75,NaN,NaN,1.036938900622266,0.8656880145568078,138.60621855145328,0.2893244937594721,0.03554586888681399,-0.2537786248726581,7.30196619670861,3.157443157443163,NaN,NaN,NaN,1736059517
1107786600,120.25,120.52,119.96001,120.07001,NaN,NaN,117.50225645161291,124.54556377049181,113.98980055000038,116.50449949999997,119.07899999999998,118.23500049999998,118.27615124473141,118.66043520873771,118.10769230769262,120.51494507761683,115.7004395377684,113.98980055000038,116.50449949999997,119.07899999999998,118.23500049999998,120.18334,46212800,57292824.8,60.067087828193536,NaN,1.5,2.75,NaN,NaN,1.00287112200639,0.8066071128683465,139.55774648346863,0.3254617487179807,0.1530485610248178,-0.17241318769316294,7.153485945827767,2.729303559206024,NaN,NaN,NaN,1689846717
1107873000,120.17,120.64999,120.07001,120.21001,NaN,NaN,117.6154820967742,124.6616293442623,114.01905060000037,116.57519959999998,119.11619999999998,118.29550099999997,118.35198884297724,118.8080137602865,118.31615461538492,120.93671409584657,115.69559513492327,114.01905060000037,116.57519959999998,119.11619999999998,118.29550099999997,120.31000333333333,39454800,56425740,60.83819894661623,NaN,1.5,2.75,NaN,NaN,0.9726646132916483,0.6992340729603191,141.33624120605313,0.3415569684190672,0.25453302283067103,-0.08702394558839614,7.229073790373706,2.542019960760891,NaN,NaN,NaN,1729301517
1107959400,120.42,120.49001,119.25,119.31,NaN,NaN,117.7287077419355,124.7776949180328,114.04460060000038,116.63679969999997,119.14619999999996,118.35200149999996,118.38955790795852,118.85582197359254,118.5107700000003,121.01948770449093,116.00205229550969,114.04460060000038,116.63679969999997,119.14619999999996,118.35200149999996,119.68333666666668,55382896,56027215.2,53.66400597673154,NaN,1.5,2.75,NaN,NaN,0.9917607123422447,0.9884998888897123,138.640166799754,0.27709700471881205,0.25934731031011893,-0.017749694408693117,9.33413139362122,1.6009624117314483,NaN,NaN,NaN,1673918621
1108045800,119.66,120.02,119.25999,119.74001,NaN,NaN,117.84193338709677,124.89376049180328,114.07180065000038,116.70949979999997,119.18320019999997,118.41050149999997,118.44251681352877,118.94003035705991,118.7561553846157,121.06586997548095,116.44644079375044,114.07180065000038,116.70949979999997,119.18320019999997,118.41050149999997,119.67333333333333,46020608,54613076.8,56.314632864128434,NaN,1.5,2.75,NaN,NaN,0.975207090032084,0.8426664582281876,140.37884115274457,0.24977291959409104,0.29446645508392066,0.04469353548982964,9.392998635266416,1.9671465525969936,NaN,NaN,NaN,1719939229
1108132200,119.7,121.03999,119.46001,120.77,NaN,NaN,117.95515903225807,125.00982606557378,114.11155060000038,116.78759969999997,119.21400019999999,118.56800149999997,118.53379066397862,119.11431318019706,119.05538615384646,121.32285802710226,116.78791428059066,114.11155060000038,116.78759969999997,119.21400019999999,118.56800149999997,120.42333333333333,53271104,54487632,61.93196058092143,NaN,1.5,2.75,NaN,NaN,1.0184051550297926,0.9776733185982462,143.4864985094323,0.2848772963418563,0.40079015591715006,0.11591285957529374,10.007361300204291,2.20886932972241,NaN,NaN,NaN,1773210333
1108391400,120.69,120.86,120.48,120.67999,NaN,NaN,118.06838467741936,125.12589163934426,114.15580055000038,116.87889959999998,119.24099999999999,118.69000049999997,118.6179553438226,119.26342525827353,119.3207700000003,121.47636199028969,117.1651780097109,114.15580055000038,116.87889959999998,119.24099999999999,118.69000049999997,120.67333,32548896,54013396.8,61.191457270390636,NaN,1.5,2.75,NaN,NaN,0.9728047868133786,0.6026078330256023,145.07728832738374,0.28514531765575457,0.47234450664498695,0.18719918898923238,9.939148784472366,1.488512320242206,NaN,NaN,NaN,1740661437
1108477800,120.8,121.42999,120.67999,121.13,NaN,NaN,118.18161032258065,125.24195721311476,114.20665050000039,116.98069959999997,119.27859999999998,118.7730005,118.71646689896681,119.4411942812951,119.60538615384645,121.66201193873992,117.54876036895298,114.20665050000039,116.98069959999997,119.27859999999998,118.7730005,121.07999333333332,44440096,53363551.2,63.538712230330006,NaN,1.5,2.75,NaN,NaN,0.9568901591838516,0.8327799593667221,146.11854263172816,0.29737744711281416,0.5589209978802501,0.2615435507674359,9.643458703994375,1.559486878510941,NaN,NaN,NaN,1785101533
1108564200,120.92999,121.46001,120.67,121.21001,NaN,NaN,118.29483596774195,125.35802278688524,114.25195060000038,117.07819959999998,119.31859999999999,118.92250099999998,118.8142529029289,119.60965292117176,119.89615692307721,121.69272683440359,118.09958701175084,114.25195060000038,117.07819959999998,119.31859999999999,118.92250099999998,121.11334,51789008,53207611.2,63.956130190765265,NaN,1.5,2.75,NaN,NaN,0.9449701478135761,0.9733383407372365,147.12859313551598,0.2921769003641478,0.6267646762226207,0.3345877758584729,9.633616595880838,1.8913919055655763,NaN,NaN,NaN,1836890541
1108650600,121.23,121.33,120.22,120.23,NaN,NaN,118.40806161290324,125.47408836065574,114.29280060000038,117.17299959999997,119.36119979999998,119.059001,118.8697723969317,119.66873359534587,120.05538769230799,121.54973693030384,118.56103845431214,114.29280060000038,117.17299959999997,119.36119979999998,119.059001,120.59333333333335,58153808,52510801.6,55.56515262150842,NaN,1.5,2.75,NaN,NaN,0.9567579943983207,1.107463726091738,143.69005719535704,0.20800858089363078,0.5945985019755113,0.38658992108188056,10.94419401924171,0,NaN,NaN,NaN,1778736733
1108737000,120.17,120.48,119.89999,120.39,NaN,NaN,118.52128725806452,125.59015393442623,114.33085060000037,117.26409959999995,119.39319999999998,119.23950099999998,118.92938916567947,119.73742563388436,120.16923384615414,121.51534722230377,118.82312047000451,114.33085060000037,117.26409959999995,119.39319999999998,119.23950099999998,120.25666333333335,49544192,51824276,56.56705141777329,NaN,1.5,2.75,NaN,NaN,0.9298474233698693,0.9560035532382546,140.71750516490064,0.15103571502633978,0.5753845648648053,0.4243488498384655,9.127560561881094,0.26650285112827443,NaN,NaN,NaN,1828280925
1109082600,119.89999,120.47,118.58,118.60001,NaN,NaN,118.63451290322581,125.70621950819672,114.36480065000036,117.33169969999996,119.38099999999999,119.34200149999997,118.91647233565283,119.62910033541918,120.11769615384645,121.63765376463756,118.59773854305534,114.36480065000036,117.33169969999996,119.38099999999999,119.34200149999997,119.21667000000001,80842192,52938645.6,44.483066255203234,NaN,1.5,2.75,NaN,NaN,0.9984297502720214,1.5270921853731747,135.8805405779831,-0.010693002827712628,0.4109825963038247,0.42167559913153735,12.613332928819053,-1.339322740260981,NaN,NaN,NaN,1747438733
1109169000,118.92999,119.57001,118.62469,119.45,NaN,NaN,118.7477385483871,125.82228508196721,114.41225060000038,117.40859979999996,119.38339999999998,119.47050149999995,118.93739498915664,119.61204316061736,120.155387692308,121.57995171701529,118.7308236676007,114.41225060000038,117.40859979999996,119.38339999999998,119.47050149999995,119.2149,68308688,52937314.4,49.950622019493686,NaN,1.5,2.75,NaN,NaN,0.9963990538240198,1.2903693505086462,138.75406504406007,-0.06110084497325202,0.34529954291497233,0.40640038788822436,13.464220702545644,0.11734137959936349,NaN,NaN,NaN,1815747421
1109255400,119.24001,120.32001,118.98,120.24001,NaN,NaN,118.8609641935484,125.93835065573771,114.46930065000036,117.47449999999995,119.3808002,119.62100199999995,118.98847793075835,119.67184952627285,120.156157692308,121.580893012111,118.731422372505,114.46930065000036,117.47449999999995,119.3808002,119.62100199999995,119.84667333333333,69306368,53530488,54.44158816704457,NaN,1.5,2.75,NaN,NaN,1.0209426928365892,1.2947083165018036,142.35541159357416,-0.04278097877881781,0.3529241644147021,0.3957051431935199,13.2589326456814,0.41757136983703275,NaN,NaN,NaN,1885053789
1109341800,120.27,121.67,120.17999,121.42999,NaN,NaN,118.97418983870969,126.05441622950819,114.52770060000037,117.55039989999996,119.39360019999998,119.82100199999995,119.08422350210115,119.83929147615163,120.26077153846185,121.83655309908094,118.68498997784276,114.52770060000037,117.55039989999996,119.39360019999998,119.82100199999995,121.09332666666667,61173392,53759132.8,60.23033767992133,NaN,1.5,2.75,NaN,NaN,1.0544475004911185,1.1379162723398693,146.7312019203159,0.043278383369582785,0.44980312240549836,0.40652473903591557,14.19526126898119,0.5464850542353297,NaN,NaN,NaN,1946227181
1109601000,121.14999,121.3,120.03999,120.63,NaN,NaN,119.08741548387097,126.17048180327869,114.57860060000037,117.61769999999996,119.38860019999998,119.98100249999996,119.14484218829327,119.91459704985148,120.29307846153878,121.88055045285857,118.705606470219,114.57860060000037,117.61769999999996,119.38860019999998,119.98100249999996,120.65666333333333,69426688,54189762.4,55.15643697092977,NaN,1.5,2.75,NaN,NaN,1.0784155361703243,1.281177198887294,144.3844931072074,0.04019029862238355,0.45676261231389503,0.4165723136915115,14.06399673349958,-0.04142360303477668,NaN,NaN,NaN,1876800493
1109687400,120.78,121.52,120.78,121.23,NaN,NaN,119.20064112903226,126.28654737704917,114.63480055000036,117.68379999999993,119.39700019999997,120.13450249999997,119.22661308287,120.0398735212942,120.4407707692311,121.99175341332177,118.88978812514041,114.63480055000036,117.68379999999993,119.39700019999997,120.13450249999997,121.17666666666666,47569296,53861162.4,58.013302247478286,NaN,1.5,2.75,NaN,NaN,1.0649572835867296,0.8831836128363988,147.35658552389523,0.07064069308719845,0.5048731800505095,0.43423248696331107,14.34826519912317,0.08255593164369564,NaN,NaN,NaN,1924369789
1109773800,120.75999,121.92999,120.64999,121.17,NaN,NaN,119.31386677419356,126.40261295081967,114.69045060000035,117.76099999999992,119.43160019999998,120.24750249999997,119.30282433452216,120.14750461450427,120.55077000000034,122.09014450760587,119.01139549239481,114.69045060000035,117.76099999999992,119.43160019999998,120.24750249999997,121.24999333333334,64233296,54472127.2,57.617997082195885,NaN,1.5,2.75,NaN,NaN,1.080317477616249,1.1791956602715525,146.02551860956117,0.07823543403071592,0.532026779501706,0.45379134547099004,14.200577960300626,-0.03300882493120429,NaN,NaN,NaN,1860136493
1109860200,121.66,121.89999,120.7,121.22,NaN,NaN,119.42709241935485,126.51867852459017,114.75105055000036,117.84810009999993,119.46660019999997,120.34500249999996,119.37800769395265,120.24964703217053,120.58538538461572,122.1626927464569,119.00807802277454,114.75105055000036,117.84810009999993,119.46660019999997,120.34500249999996,121.27332999999999,62098608,54946742.4,57.87559486475804,NaN,1.5,2.75,NaN,NaN,1.088865514929374,1.1301599564890674,147.44348838987116,0.07794819390506924,0.5512265878523266,0.47327839394725735,14.197292899026136,0.8234217749313772,NaN,NaN,NaN,1922235101
1109946600,122.05,122.83,121.78999,122.73,NaN,NaN,119.54031806451614,126.63474409836066,114.81645060000035,117.94570009999993,119.51340019999996,120.53350199999997,119.50945837262118,120.48587112434477,120.7430784615388,122.69265984463433,118.79349707844327,114.81645060000035,117.94570009999993,119.51340019999996,120.53350199999997,122.44999666666666,56172608,55298217.6,64.82819063785792,NaN,1.5,2.75,NaN,NaN,1.126089406720133,1.0158122709546429,151.41699218304493,0.16573186781924698,0.680443228721316,0.514711360902069,14.764430476845908,1.9436830301520087,NaN,NaN,NaN,1978407709
1110205800,122.66,123.25,122.59,122.78999,NaN,NaN,119.65354370967742,123.25,114.88405055000035,118.04829999999991,119.55560019999997,120.66150149999999,119.63810667173408,120.70531101726432,120.87077000000035,123.10208499639224,118.63945500360846,114.88405055000035,118.04829999999991,119.55560019999997,120.66150149999999,122.87666333333334,43808192,54987876.8,65.07481643078322,NaN,1.5,2.75,NaN,NaN,1.0927973062401233,0.7966881892773864,152.3884962873693,0.21120093203109058,0.7787125259409322,0.5675115939098416,14.787427338709033,3.5328664812085644,NaN,NaN,NaN,2022215901
1110292200,122.67,123,122.11,122.33,NaN,NaN,119.76676935483871,123.28465139534883,114.94760055000037,118.15620009999992,119.58680019999996,120.77450099999999,119.74367111597981,120.86004330133439,120.95692307692342,123.31676461810694,118.59708153573989,114.94760055000037,118.15620009999992,119.58680019999996,120.77450099999999,122.48,44665808,54910527.2,61.51305139075769,NaN,1.5,2.75,NaN,NaN,1.0783117843658288,0.8134288683354691,149.85697458085804,0.19409917669411259,0.8101355647774824,0.6160363880833698,11.005767634796056,2.4110506488070285,NaN,NaN,NaN,1977550093
1110378600,121.97,122.28999,120.96001,120.97,NaN,NaN,119.87999500000001,123.31930279069768,115.00340055000036,118.25950009999991,119.59580019999996,120.81250049999998,119.79176244476491,120.87051536787396,121.01384615384649,123.3362057028042,118.69148660488878,115.00340055000036,118.25950009999991,119.59580019999996,120.81250049999998,121.4066666666667,73601376,56617856,52.383990649471066,NaN,1.5,2.75,NaN,NaN,1.0991459426254127,1.2999675579379057,145.1665588210346,0.08079681923777815,0.7170324121305924,0.6362355928928143,13.315242283550315,0.607110727951537,NaN,NaN,NaN,1903948717
1110465000,121.2,121.5,120.39999,121.24001,NaN,NaN,119.9932206451613,123.35395418604651,115.05825060000038,118.3593002999999,119.59700059999997,120.90900099999999,119.84855646653884,120.90570533283835,121.07923153846187,123.37536795383066,118.78309512309308,115.05825060000038,118.3593002999999,119.59700059999997,120.90900099999999,121.04666666666667,65303392,57113880.8,53.84842849330391,NaN,1.5,2.75,NaN,NaN,1.0992076610093116,1.143389156633881,142.8396221767872,0.016976562794402184,0.657456296385817,0.6404797335914149,12.906647745777075,-0.15645228991619417,NaN,NaN,NaN,1969252109
1110551400,121.31,121.72,120.16,120.39,NaN,NaN,120.1064462903226,123.38860558139535,115.10095055000038,118.44640039999989,119.57760059999998,120.94150049999999,119.86978954628242,120.8565905392347,121.21692307692341,123.07469859730237,119.35914755654444,115.10095055000038,118.44640039999989,119.57760059999998,120.94150049999999,120.75666666666666,58132704,57719485.6,48.76395762582003,NaN,1.5,2.75,NaN,NaN,1.1321213995086465,1.007159079740655,140.00567616459855,-0.08399946091058907,0.5354804074531785,0.6194798683637676,12.208741961190691,-0.19895548371051555,NaN,NaN,NaN,1911119405
1110810600,120.61,121.16,120.28,121.14,NaN,NaN,120.21967193548387,123.42325697674418,115.14545050000036,118.5504002999999,119.57780059999999,120.96000049999998,119.919601720938,120.88358191645044,121.3469230769234,122.90414171414712,119.78970443969969,115.14545050000036,118.5504002999999,119.57780059999999,120.96000049999998,120.85999999999999,36338704,56872865.6,52.98242654212143,NaN,1.5,2.75,NaN,NaN,1.1141127281151715,0.6389462464504339,141.5963687905647,-0.10067031764308387,0.4936419713099127,0.5943122889529966,12.216176787648916,-0.07423904974016614,NaN,NaN,NaN,1947458109
1110897000,121.42,121.46001,120.08,120.14,NaN,NaN,120.33289758064517,123.45790837209303,115.18180050000038,118.64660029999988,119.5632006,120.93300099999996,119.92824479070514,120.81276459107421,121.33923000000034,122.91907025409498,119.75938974590571,115.18180050000038,118.64660029999988,119.5632006,120.93300099999996,120.56000333333333,62465808,58368711.2,47.380904557088,NaN,1.5,2.75,NaN,NaN,1.1331053903926591,1.0701933744255774,138.62947325216055,-0.17507787878601389,0.3754649404704793,0.5505428192564932,12.767194124507496,-0.8500453907732947,NaN,NaN,NaN,1884992301
1110983400,119.7,119.88,118.89999,119.12,NaN,NaN,120.44612322580646,123.49255976744186,115.21310050000037,118.7254001999999,119.5396006,120.83250099999995,119.89654891655984,120.65154891573381,121.16153846153881,123.13192992837851,119.19114699469911,115.21310050000037,118.7254001999999,119.5396006,120.83250099999995,119.29999666666666,76723872,59982900,42.45091386528871,NaN,1.5,2.75,NaN,NaN,1.1407414339360404,1.2790957422865517,134.98255674639844,-0.28265043577575943,0.1972297745367939,0.47988021031255335,13.483219511543634,-1.732387394819332,NaN,NaN,NaN,1808268429
1111069800,119.31,119.74001,118.98,119.36,NaN,NaN,120.55934887096775,123.52721116279069,115.24635045000038,118.8191000999999,119.55220059999999,120.74000049999998,119.8755077825771,120.52854425709249,121.0638461538465,123.244662986877,118.883029320816,115.24635045000038,118.8191000999999,119.55220059999999,120.74000049999998,119.36000333333334,62726400,60529769.6,43.92925556447445,NaN,1.5,2.75,NaN,NaN,1.113546331512037,1.036290083615319,137.2883008120316,-0.3243165645292341,0.07448450465101075,0.3988010691802448,13.605642327482023,-2.7458649067057803,NaN,NaN,NaN,1870994829
1111156200,119.11,119.53,118.14999,118.53999,NaN,NaN,120.67257451612905,123.56186255813954,115.27340040000037,118.90589999999989,119.5628006,120.65549999999999,119.82313453620154,120.3391581373694,120.85692230769266,123.41351211937317,118.30033249601215,115.27340040000037,118.90589999999989,119.5628006,120.65549999999999,118.73999333333335,61884192,60716288.8,40.135593232454724,NaN,1.5,2.75,NaN,NaN,1.1325794506897486,1.0192354180909688,134.31663978984733,-0.38939779233495,-0.08794617123844262,0.30145162109650736,10.545432472047992,-3.46119419017788,NaN,NaN,NaN,1809110637
1111415400,118.71001,118.78,117.75999,118.10001,NaN,NaN,120.78580016129033,123.59651395348837,115.30345045000037,118.9715001999999,119.55260080000002,120.5410005,119.75556102497795,120.1259059338104,120.62076923076955,123.55701762248846,117.68452083905065,115.30345045000037,118.9715001999999,119.55260080000002,120.5410005,118.21333333333332,61430608,61310609.6,38.22800375202538,NaN,1.5,2.75,NaN,NaN,1.1245387756404808,1.0019572207939684,130.92842492062783,-0.44060334198110496,-0.24930255637987386,0.1913007856012311,10.239700204129836,-3.457851712580725,NaN,NaN,NaN,1747680029
1111501800,118.37,118.92999,116.89999,116.89999,NaN,NaN,120.89902580645162,123.63116534883721,115.32305040000037,119.01170009999991,119.52180060000002,120.45599949999999,119.64357784752784,119.81867584487608,120.28846076923108,123.79974355917072,116.77717797929144,115.32305040000037,119.01170009999991,119.52180060000002,120.45599949999999,117.57665666666666,93324624,61934731.2,33.54501178058429,NaN,1.5,2.75,NaN,NaN,1.1892145773804466,1.5068221366560157,126.72020785052666,-0.5279273589145098,-0.46860841304190615,0.05931894587260364,10.857892685907569,-3.364478796395798,NaN,NaN,NaN,1654355405
1111588200,116.94501,117.72,116.75,117,NaN,NaN,121.01225145161291,123.66581674418605,115.33455040000037,119.04950009999992,119.48180060000003,120.33349949999999,119.53990812801695,119.55023052631645,119.84769153846186,123.45950335413902,116.2358797227847,115.33455040000037,119.04950009999992,119.48180060000003,120.33349949999999,117.15666666666668,71946000,62116596.8,34.26771526318802,NaN,1.5,2.75,NaN,NaN,1.1735563932818434,1.1582411739594853,121.750298394611,-0.5491439314162669,-0.6271109683977301,-0.07796703698146312,10.351001580419949,-3.4972036046516313,NaN,NaN,NaN,1726301405
1111674600,117.46001,117.99001,117.06,117.14,NaN,NaN,121.1254770967742,123.70046813953488,115.34595040000036,119.0889000999999,119.46100080000004,120.17849899999999,119.44579408378098,119.32068476190537,119.41307692307724,122.86007137414276,115.96608247201172,115.34595040000036,119.0889000999999,119.46100080000004,120.17849899999999,117.39666999999999,52019200,61252238.4,35.327989518035466,NaN,1.5,2.75,NaN,NaN,1.1604459366188544,0.8492620246838196,124.05054604225816,-0.5240097521968432,-0.7329792272275171,-0.20896947503067392,10.163358895304903,-2.6995597641000084,NaN,NaN,NaN,1778320605
1112020200,117.42,117.94,117.31,117.31,NaN,NaN,121.2387027419355,123.73511953488372,115.36355045000036,119.1269001999999,119.43580060000004,119.97249949999998,119.36203745304448,119.12919097505724,119.0269230769234,122.19366150693784,115.86018464690895,115.36355045000036,119.1269001999999,119.43580060000004,119.97249949999998,117.52,46941504,60540644,36.663957291720195,NaN,1.5,2.75,NaN,NaN,1.134699798288936,0.7753717320879507,121.93291174899599,-0.46803254083276624,-0.7940101510716318,-0.3259776102388655,10.231157480207964,-3.1616311705464737,NaN,NaN,NaN,1825262109
1112106600,117.14,117.89999,116.25,116.53,NaN,NaN,121.35192838709679,123.76977093023255,115.37445040000037,119.1567001999999,119.41400060000004,119.76749949999999,119.25097716076823,118.88164897743275,118.68538461538493,121.89759215141918,115.47317707935069,115.37445040000037,119.1567001999999,119.41400060000004,119.76749949999999,116.89332999999999,73040192,60721319.2,33.26818122417767,NaN,1.5,2.75,NaN,NaN,1.171506241268298,1.2028755791590244,118.19762314536963,-0.4552179721598805,-0.8950000754387162,-0.43978210327883566,8.741606503957474,-3.0048277010154814,NaN,NaN,NaN,1752221917
1112193000,116.78,118.2,116.77,118.17999,NaN,NaN,121.46515403225807,123.8044223255814,115.39925035000037,119.18870009999992,119.41280020000002,119.61499899999998,119.20897766426752,118.81482431291535,118.4499984615388,121.30783129297137,115.59216563010622,115.39925035000037,119.18870009999992,119.41280020000002,119.61499899999998,117.71666333333333,62896704,61487689.6,44.895026553417075,NaN,1.5,2.75,NaN,NaN,1.2071129383205625,1.0229153902051964,122.12157980892185,-0.31401485385142225,-0.8323006705931135,-0.5182858167416913,12.983029341091692,-0.7891286098052391,NaN,NaN,NaN,1815118621
1112279400,118.19,118.46001,117.87,117.96001,NaN,NaN,121.57837967741936,123.83907372093023,115.41895040000036,119.20280019999993,119.38260040000002,119.45449949999997,119.1599985401786,118.73341342597102,118.26307615384647,120.89808839933528,115.62806390835766,115.41895040000036,119.20280019999993,119.38260040000002,119.45449949999997,118.09667333333334,65048800,61528464.8,43.7993480318586,NaN,1.5,2.75,NaN,NaN,1.1630341570119502,1.0572147413630903,124.76960703551359,-0.21836379415824791,-0.7912405594395011,-0.5728767652812532,12.234033074348023,-1.17291387399464,NaN,NaN,NaN,1750069821
1112365800,118.63,118.99001,116.91,117.42999,NaN,NaN,121.69160532258066,123.87372511627908,115.43610035000036,119.20430009999993,119.3668002,119.26499899999999,119.09215506801473,118.60927786159283,117.97769076923109,120.04756628220957,115.9078152562526,115.43610035000036,119.20430009999993,119.3668002,119.26499899999999,117.77666666666667,97394816,63293275.2,41.19091270081808,NaN,1.5,2.75,NaN,NaN,1.2285324315110968,1.5387861615984124,123.86987162467115,-0.17556640215281993,-0.7923347679722781,-0.6167683658194582,12.222542293299036,-0.9363928578026701,NaN,NaN,NaN,1652675005
1112621400,117.36,117.86,116.74001,117.63,NaN,NaN,121.80483096774195,123.9083765116279,115.45510035000035,119.20950009999991,119.3694002,119.009999,119.03481565358278,118.51601330334589,117.78461384615417,119.43804242032363,116.13118527198472,115.45510035000035,119.20950009999991,119.3694002,119.009999,117.41000333333334,71609504,64065120,42.580594142851616,NaN,1.5,2.75,NaN,NaN,1.2207794006888757,1.1177611780013836,124.96640295225872,-0.12115121465586376,-0.7682073841392878,-0.647056169483424,11.858902686721954,-0.39797625758033556,NaN,NaN,NaN,1724284509
1112707800,117.78,118.38,117.67,118.19,NaN,NaN,121.91805661290323,123.94302790697674,115.47790035000034,119.22260009999992,119.3976002,118.77999949999999,119.00168562795209,118.48496441731294,117.7130753846157,119.20143903399854,116.22471173523287,115.47790035000034,119.22260009999992,119.3976002,118.77999949999999,118.08,50079904,64378705.6,46.399678191938946,NaN,1.5,2.75,NaN,NaN,1.1871523006396703,0.7778954785322679,126.78899426148297,-0.03905690314205379,-0.6958772984109913,-0.6568203952689375,12.081643090172607,1.1035159198901516,NaN,NaN,NaN,1774364413
1112794200,118.45,118.95,118.17999,118.60001,NaN,NaN,122.03128225806452,123.97767930232558,115.50490040000034,119.23890019999993,119.4386004,118.59349999999999,118.9859336425422,118.49592113947361,117.65461461538494,118.92309018379204,116.38613904697785,115.50490040000034,119.23890019999993,119.4386004,118.59349999999999,118.57666666666667,53311696,64811000,49.070594232904064,NaN,1.5,2.75,NaN,NaN,1.157356422022551,0.8225717239357516,128.7587658218422,0.046599634794438516,-0.5985708517758894,-0.6451704865703279,10.231549832508392,1.3675299145299125,NaN,NaN,NaN,1827676109
1112880600,118.41,119.25999,118.32001,119.24001,NaN,NaN,122.14450790322581,124.01233069767441,115.53225045000033,119.25270029999993,119.4858006,118.5070005,118.99589742126602,118.56678674523803,117.70846230769264,119.1677817341231,116.24914288126219,115.53225045000033,119.25270029999993,119.4858006,118.5070005,118.94000333333334,47225504,63492206.4,53.0069695493336,NaN,1.5,2.75,NaN,NaN,1.1418295347352263,0.7438000138549289,131.0359498307245,0.14456986448912423,-0.4644581559589227,-0.6090280204480469,10.462820797127703,1.792735188663136,NaN,NaN,NaN,1874901613
1112967000,119.17,119.21001,118,118,NaN,NaN,122.25773354838711,124.04698209302326,115.54850045000033,119.24480039999993,119.5012006,118.345,118.95684262043206,118.51280705521536,117.70076923076955,119.15278725441027,116.24875120712883,115.54850045000033,119.24480039999993,119.5012006,118.345,118.40333666666668,64288800,63441476.8,45.645627914157885,NaN,1.5,2.75,NaN,NaN,1.1488424251112814,1.0133559816501625,127.72595829658971,0.12481496617477583,-0.4530093127295771,-0.577824278904353,12.649513575319217,0.5881851504560547,NaN,NaN,NaN,1810612813
1113226200,118.28999,118.42,117.83,118.09,NaN,NaN,122.3709591935484,124.08163348837209,115.56700045000034,119.23840039999993,119.51440080000002,118.23000000000002,118.92284879217982,118.47253971662342,117.79230846153877,119.17944482813265,116.40517209494489,115.56700045000034,119.23840039999993,119.51440080000002,118.23000000000002,118.11333333333336,45858000,62827741.6,46.22930368207751,NaN,1.5,2.75,NaN,NaN,1.1089251090319043,0.7299004998772708,125.9847188260926,0.11690147525091088,-0.4316974348407143,-0.5485989100916252,12.641389674361228,1.338711061529222,NaN,NaN,NaN,1856470813
1113312600,117.89,119.06,117.07001,118.7,NaN,NaN,122.4841848387097,124.11628488372092,115.59130045000035,119.24660039999995,119.53980100000003,118.10800000000002,118.91410962385905,118.49420260075452,117.923077692308,119.30731002739911,116.53884535721689,115.59130045000035,119.24660039999995,119.53980100000003,118.10800000000002,118.27667000000001,86547680,65338190.4,50.13755730772069,NaN,1.5,2.75,NaN,NaN,1.1718583155296258,1.324610912395272,128.50509037157408,0.14974353042021982,-0.36141949706635046,-0.5111630274865703,11.934275894589836,0.4400152682361872,NaN,NaN,NaN,1943018493
1113399000,118.56,118.8,117.13,117.3,NaN,NaN,122.59741048387097,124.15093627906977,115.61055045000033,119.23380039999995,119.52260100000004,117.96600000000004,118.85081120723713,118.38046901973028,117.93538538461569,119.29415951194716,116.57661125728421,115.61055045000033,119.23380039999995,119.52260100000004,117.96600000000004,117.74333333333334,66058192,65517809.6,42.50217006975667,NaN,1.5,2.75,NaN,NaN,1.207439864420367,1.0082478703622595,124.67538194054873,0.0777939374443542,-0.41392060568112754,-0.49171454312548174,11.490801536647703,-0.5595201288979204,NaN,NaN,NaN,1876960301
1113485400,117.44,117.5,115.77,115.77,NaN,NaN,122.71063612903227,124.1855876744186,115.61980045000035,119.20410029999995,119.45980100000004,117.79850000000003,118.72999508146313,118.13185292261312,117.81692384615415,119.58116038924983,116.05268730305848,115.61980045000035,119.20410029999995,119.45980100000004,117.79850000000003,116.34666666666665,99638816,66663556.8,36.04224085263068,NaN,1.5,2.75,NaN,NaN,1.2447655883903412,1.4946519625247479,120.41199472048119,-0.06453891829827452,-0.5723881909983248,-0.5078492727000503,13.524418604492478,-1.413599711623928,NaN,NaN,NaN,1777321485
1113571800,115.74001,116.2,114.10001,114.14999,NaN,NaN,122.82386177419356,124.22023906976744,115.61790040000037,119.17140019999995,119.35740080000004,117.53799950000003,118.55038703905281,117.75262788236425,117.63384615384646,120.20410375798252,115.0635885497104,115.61790040000037,119.17140019999995,119.35740080000004,117.53799950000003,114.81666666666666,134028816,70228677.6,30.718388201244423,NaN,1.5,2.75,NaN,NaN,1.30585304636246,1.9084627616567853,116.18595934438694,-0.24912244677135997,-0.8192523311642503,-0.5701298843928904,15.215746760417222,-2.958437473433642,NaN,NaN,NaN,1643292669
1113831000,114.12,114.96001,113.96001,114.5,NaN,NaN,122.93708741935485,124.25489046511628,115.62570040000037,119.13660019999996,119.26820060000004,117.33600000000001,118.39154833163897,117.44285379832957,117.35077000000031,120.38651751624009,114.31502248376053,115.62570040000037,119.13660019999996,119.26820060000004,117.33600000000001,114.47334000000002,100314816,72150208.8,33.02038302494199,NaN,1.5,2.75,NaN,NaN,1.2840064001937128,1.3903607164612946,118.80292033922139,-0.3242218302853933,-0.975407172249632,-0.6511853419642387,15.382703356228555,-3.1220915475082474,NaN,NaN,NaN,1743607485
1113917400,115.10001,115.71001,114.83,115.41,NaN,NaN,123.05031306451615,124.28954186046512,115.63835040000036,119.10910019999996,119.17180060000004,117.2014995,118.27462486765313,117.24924867467914,117.1546153846157,120.33370322075592,113.97552754847547,115.63835040000036,119.10910019999996,119.17180060000004,117.2014995,115.31667,68397120,72498534.4,38.72126169223884,NaN,1.5,2.75,NaN,NaN,1.2787209430370188,0.9434276232762023,123.43202083808414,-0.2902856183240128,-1.0140423648692547,-0.7237567465452419,16.035461245838672,-2.6897215270049313,NaN,NaN,NaN,1812004605
1114003800,115.39999,115.63,113.55,113.8,NaN,NaN,113.55,124.32419325581395,115.64790040000037,119.06270019999994,119.04640040000004,117.04650000000001,118.09914938264713,116.92074880090017,116.87538538461568,120.51324017807282,113.23753059115855,115.64790040000037,119.06270019999994,119.04640040000004,117.04650000000001,114.32666666666667,114822128,73573409.6,33.31809391439923,NaN,1.5,2.75,NaN,NaN,1.3359551613915173,1.5606470955234895,119.57377305581728,-0.34994589297469325,-1.1611891127636085,-0.8112432197889152,16.827784356164464,-4.562235444294244,NaN,NaN,NaN,1697182477
1114090200,114.78999,116.21001,114.38,116.00999,NaN,NaN,113.503,124.35884465116278,115.66685035000035,119.03929999999995,118.96240000000003,116.99699950000002,118.01722156371979,116.8340098674811,116.75076923076952,120.3876760275677,113.11386243397135,115.66685035000035,119.03929999999995,118.96240000000003,116.99699950000002,115.53333333333335,87459504,74349084.8,44.72084110470661,NaN,1.5,2.75,NaN,NaN,1.412673364149266,1.1763359863173461,123.43012218049837,-0.22056270690372204,-1.0869466034185677,-0.8663838965148457,21.033384300937858,-1.6864491525423713,NaN,NaN,NaN,1784641981
1114176600,115.74001,116.5,114.27,115.57001,NaN,NaN,113.456,124.39349604651163,115.68760040000035,119.01690009999994,118.88760020000004,116.91850000000002,117.9212524827896,116.71362892772099,116.54923153846183,120.13479345444883,112.96366962247482,115.68760040000035,119.01690009999994,118.88760020000004,116.91850000000002,115.44667,89839504,76240100,43.139224787202224,NaN,1.5,2.75,NaN,NaN,1.4710538381386045,1.178375998982163,121.1546490917149,-0.1480854100048885,-1.0514906590209563,-0.9034052490160678,20.48192511011933,-2.133957151325266,NaN,NaN,NaN,1694802477
1114435800,115.86,116.5,115.72,116.33,NaN,NaN,113.40899999999999,124.42814744186046,115.71060040000037,119.00130009999995,118.81940000000003,116.86950000000002,117.85885042464099,116.67709283936661,116.37461538461565,119.75914198836062,112.99008878087068,115.71060040000037,119.00130009999995,118.81940000000003,116.86950000000002,116.18333333333334,52363504,76511200,46.649106624347425,NaN,1.5,2.75,NaN,NaN,1.4324064211287044,0.6843900500841706,124.7506895321598,-0.03815820300009687,-0.9511030027661889,-0.912944799766092,21.036909587034767,-1.9966301600674006,NaN,NaN,NaN,1747165981
1114522200,115.96001,116.77,115.14999,115.2,NaN,NaN,113.362,124.4627988372093,115.72770040000037,118.96100009999996,118.70800000000001,116.803,117.75458178053742,116.5364173308555,116.06384538461566,119.05832939921058,113.06936137002074,115.72770040000037,118.96100009999996,118.70800000000001,116.803,115.70666333333334,75363808,76627380.8,42.45302779415773,NaN,1.5,2.75,NaN,NaN,1.4458066767623678,0.9835101658596689,121.42761006533131,-0.03104845987898197,-0.9517553746148195,-0.9207069147358375,21.051706982240276,-1.790281329923269,NaN,NaN,NaN,1671802173
1114608600,114.86,116.07001,114.44,115.64999,NaN,NaN,113.315,124.49745023255814,115.74665035000038,118.92419999999997,118.60740000000001,116.67649999999999,117.67204876953595,116.45199568029783,115.88307538461567,118.66434833315553,113.1018024360758,115.74665035000038,118.92419999999997,118.60740000000001,116.67649999999999,115.38666666666667,85186128,77741852,44.5904676104749,NaN,1.5,2.75,NaN,NaN,1.4589640569936273,1.0957563501317154,122.28041293075376,0.012146620678202602,-0.9055236388880843,-0.9176702595662869,20.55997464635721,-0.10366243413664465,NaN,NaN,NaN,1756988301
1114695000,115.27,115.67999,114.2,114.2,NaN,NaN,113.268,124.53210162790697,115.76005035000038,118.87369999999997,118.46880000000002,116.48849949999999,117.53588999426003,116.23751990122184,115.5838446153849,118.18198159563062,112.98570763513919,115.76005035000038,118.87369999999997,118.46880000000002,116.48849949999999,114.69333,74218192,78200321.6,39.499401260614576,NaN,1.5,2.75,NaN,NaN,1.4604659100655113,0.9490778360174928,118.86740126235169,-0.045585035353945313,-0.9746515537587186,-0.9290665184047733,20.455282943404733,0.04381077913366469,NaN,NaN,NaN,1682770109
1114781400,115.07001,115.87,113.97,115.75,NaN,NaN,113.22099999999999,124.56675302325581,115.78480035000038,118.83909989999997,118.35959980000001,116.40449999999998,117.46585509252435,116.19108943443881,115.35692153846183,117.24504526324077,113.4687978136829,115.78480035000038,118.83909989999997,118.35959980000001,116.40449999999998,115.19666666666667,104283312,78544746.4,46.52765360849485,NaN,1.5,2.75,NaN,NaN,1.4918612022036897,1.3276930256916584,122.09523628275142,0.028007024994581742,-0.8940577371615461,-0.9220647621561279,20.2978943477932,1.091703056768559,NaN,NaN,NaN,1787053421
1115040600,116.07001,116.41,115.52,116.39999,NaN,NaN,113.17399999999999,124.60140441860464,115.81325025000041,118.82209969999997,118.28299960000002,116.34299949999998,117.42405646144496,116.21098472639702,115.28769000000031,116.93659781858146,113.63878218141916,115.81325025000041,118.82209969999997,118.28299960000002,116.34299949999998,116.10999666666667,56057104,77767126.4,49.1931004601233,NaN,1.5,2.75,NaN,NaN,1.4488711163319976,0.7208329096753149,124.70370781055082,0.12255205991102869,-0.768874687267342,-0.8914267471783707,20.425828985035572,0.8578026167576518,NaN,NaN,NaN,1843110525
1115127000,116.07001,116.85001,115.69,116.60001,NaN,NaN,113.127,124.63605581395349,115.84505025000038,118.80019989999997,118.20719980000001,116.26349999999998,117.39174091393731,116.24803475245444,115.35153692307722,117.12943390829885,113.57363993785559,115.84505025000038,118.80019989999997,118.20719980000001,116.26349999999998,116.38000666666667,86824192,79604340.8,50.01875670852222,NaN,1.5,2.75,NaN,NaN,1.4282381794511405,1.0906967023084753,123.78102078270696,0.1962784512792033,-0.6460786830793666,-0.8423571343585698,20.036528559964605,2.4604657293497367,NaN,NaN,NaN,1929934717
1115213400,116.64999,117.75,116.28,117.5,NaN,NaN,113.08,124.67070720930232,115.87435025000039,118.78309979999996,118.18519960000002,116.20849949999997,117.39598636829271,116.36726953793497,115.60923000000031,117.57680458602519,113.64165541397543,115.87435025000039,118.78309979999996,118.18519960000002,116.20849949999997,117.17666666666666,82477632,81062637.6,53.667250380065845,NaN,1.5,2.75,NaN,NaN,1.431221166633202,1.0174555682111188,128.40506859623767,0.29731435278178364,-0.47071419338134035,-0.768028546163124,17.817964228561543,1.2843807675528616,NaN,NaN,NaN,2012412349
1115299800,117.67,118,116.74001,117.46001,NaN,NaN,113.033,124.70535860465117,115.91375030000037,118.76439989999997,118.1453998,116.11949949999996,117.3984970989479,116.47134005813164,115.83692307692338,117.9200352695855,113.75381088426127,115.91375030000037,118.76439989999997,118.1453998,116.11949949999996,117.40000666666666,97322816,83567503.2,53.480440465740216,NaN,1.5,2.75,NaN,NaN,1.4189903690165449,1.1646012178571346,129.6902477250981,0.3495058900669855,-0.3311461835793921,-0.6806520736463776,14.636562392264423,1.6353723600093144,NaN,NaN,NaN,1915089533
1115386200,117.92999,117.99001,117.06,117.09,NaN,NaN,112.98599999999999,124.74001,115.94980030000038,118.73159989999996,118.0823996,116.07399949999997,117.38639917349896,116.5302600525953,115.96615384615414,118.13401270422717,113.79829498808111,115.94980030000038,118.73159989999996,118.0823996,116.07399949999997,117.38000333333332,69602880,83833207.2,51.68767166186423,NaN,1.5,2.75,NaN,NaN,1.384063199801077,0.8302542909273307,128.67371767963297,0.3464890594720653,-0.247540749306296,-0.5940298087783613,14.559959639473343,0.6533138485343464,NaN,NaN,NaN,1845486653
1115645400,117.21001,118.08,117.05,117.82001,NaN,NaN,112.939,124.77466139534883,115.99410030000037,118.70190009999996,118.01020000000003,116.06049999999996,117.40340351963626,116.65309338091956,116.27538538461567,118.25801653226094,114.29275423697041,115.99410030000037,118.70190009999996,118.01020000000003,116.06049999999996,117.65000333333334,43971808,83738897.6,54.8999030225791,NaN,1.5,2.75,NaN,NaN,1.3587729712438572,0.5251061246356795,132.08661781352842,0.3784378285971931,-0.12098252303186996,-0.49942035162906306,14.516564417483835,2.2743142361111053,NaN,NaN,NaN,1889458461
1115731800,117.36,117.5,116.39,116.60001,NaN,NaN,112.892,124.80931279069767,116.03335035000036,118.65910019999997,117.92960020000002,115.95550049999997,117.37189789141523,116.64803782083197,116.32077153846184,118.30403637294432,114.33750670397936,116.03335035000036,118.65910019999997,117.92960020000002,115.95550049999997,116.83000333333332,75030624,83163044.8,49.032467769502226,NaN,1.5,2.75,NaN,NaN,1.363861330440724,0.9022111225057022,128.86878774036626,0.30531993197768703,-0.1177704366569543,-0.42309036863464133,14.699798994883345,0.8214613766935863,NaN,NaN,NaN,1814427837
1115818200,116.92999,117.39999,115.85001,117.24001,NaN,NaN,112.845,124.8439641860465,116.07070040000036,118.62340029999997,117.84980040000003,115.95250099999996,117.36672581724208,116.70441612360987,116.44923307692338,118.43767496824628,114.46079118560047,116.07070040000036,118.62340029999997,117.84980040000003,115.95250099999996,116.83000333333332,92009312,84460600.8,51.934580588366345,NaN,1.5,2.75,NaN,NaN,1.37715552112353,1.0893755328342396,130.01313201090892,0.2881862145274071,-0.06285760047538247,-0.3510438150027896,14.832172704131098,2.662005253940451,NaN,NaN,NaN,1906437149
1115904600,117.32001,117.59,115.41,115.95,NaN,NaN,112.798,124.87861558139535,116.09995035000038,118.58850029999998,117.74540040000004,115.96150099999996,117.31116794205612,116.63256696898036,116.42000230769261,118.42569330317377,114.41431131221145,116.09995035000038,118.58850029999998,117.74540040000004,115.96150099999996,116.31666666666666,95571312,84257225.6,46.221591827559884,NaN,1.5,2.75,NaN,NaN,1.4345015553289926,1.1342803103167927,126.23374267084566,0.18321490974576032,-0.12202517782058919,-0.3052400875663495,14.315551982291108,0.172786177105834,NaN,NaN,NaN,1810865837
1115991000,116.3,116.62,114.8,115.72,NaN,NaN,112.75099999999999,124.91326697674418,116.12570030000039,118.55100029999998,117.63540040000004,116.04000149999995,117.24876919923038,116.54565582907746,116.46000230769262,118.38592952098531,114.53407509439992,116.12570030000039,118.55100029999998,117.63540040000004,116.04000149999995,115.71333333333331,85440496,81827809.6,45.26551315247286,NaN,1.5,2.75,NaN,NaN,1.4620371585197793,1.0441498607583406,123.28755869831441,0.09592125415865904,-0.18533851986802574,-0.2812597740266848,12.18503805794093,-0.5841838989848742,NaN,NaN,NaN,1725425341
1116250200,115.7,116.84,115.66,116.8,NaN,NaN,112.704,124.94791837209303,116.15550030000038,118.51510029999997,117.51680040000005,116.15500149999995,117.2311704071037,116.56987908345104,116.54846461538493,118.42238537178619,114.67454385898367,116.15550030000038,118.51510029999997,117.51680040000005,116.15500149999995,116.43333333333334,49351008,79279619.2,50.44856520704678,NaN,1.5,2.75,NaN,NaN,1.4418916471969383,0.6224930000672859,126.70442861096839,0.10766619994556514,-0.14667702409472838,-0.2543432240402935,12.965370967895673,0.17151799558164676,NaN,NaN,NaN,1774776349
1116336600,116.42999,117.7,116.16,117.58,NaN,NaN,112.657,124.98256976744186,116.1880502500004,118.48410039999997,117.41260060000005,116.26350149999996,117.24484999898199,116.66608107550333,116.80846461538492,118.17651892764066,115.44041030312918,116.1880502500004,118.48410039999997,117.41260060000005,116.26350149999996,117.14666666666666,61411904,78930358.4,53.84773654019467,NaN,1.5,2.75,NaN,NaN,1.4488993866828717,0.7780517565722848,129.2494772799083,0.16148024071778416,-0.05249292314306331,-0.21397316386084747,13.45612991931137,0.06808510638297727,NaN,NaN,NaN,1836188253
1116423000,118.07001,119.08,118.00999,118.78999,NaN,NaN,112.61,125.01722116279069,116.23095015000041,118.46430029999996,117.34180040000005,116.51300099999996,117.3054437245121,116.86835811593158,117.0423100000003,118.6285798219594,115.45604017804119,116.23095015000041,118.46430029999996,117.34180040000005,116.51300099999996,118.62666,78052688,77091886.4,58.59302077848955,NaN,1.5,2.75,NaN,NaN,1.452549430491238,1.0124630703030766,133.41280927884057,0.265914265404494,0.11841966789476999,-0.147494597509724,13.998332123968156,1.1322832340981464,NaN,NaN,NaN,1914240941
1116509400,119.02,119.41,118.7,119.28999,NaN,NaN,112.56299999999999,125.05187255813954,116.27640010000042,118.45200019999994,117.30820020000004,116.67700099999998,117.38326906864889,117.0989897239381,117.264617692308,119.20010332013806,115.32913206447793,116.27640010000042,118.45200019999994,117.30820020000004,116.67700099999998,119.13333,62850096,75861416,60.404717820469,NaN,1.5,2.75,NaN,NaN,1.3995101854561491,0.8284856691839235,135.7182848027411,0.3506853356599468,0.29086207206520953,-0.059823263594737275,14.070488893069541,1.8788880348449908,NaN,NaN,NaN,1977091037
1116595800,119.34,119.39,118.74001,119.12,NaN,NaN,112.51599999999999,125.08652395348837,116.3300001500004,118.43140029999995,117.26580000000004,116.85450049999997,117.45137616399599,117.29146689308686,117.45846307692335,119.58428177479651,115.3326443790502,116.3300001500004,118.43140029999995,117.26580000000004,116.85450049999997,119.08333666666667,46424800,73690680.8,59.452318934632444,NaN,1.5,2.75,NaN,NaN,1.3459730293521388,0.6299955366947838,134.0300905011277,0.3751317280347624,0.4090913964487157,0.03395966841395333,13.893420449261741,1.1033694531175207,NaN,NaN,NaN,1930666237
1116855000,119.21001,120.03999,119.19,119.78,NaN,NaN,112.469,125.12117534883721,116.3946501000004,118.41560029999995,117.25360000000002,117.02700049999999,117.54269474580006,117.52847004612622,117.63384769230797,120.09430563210604,115.17338975250989,116.3946501000004,118.41560029999995,117.25360000000002,117.02700049999999,119.66999666666668,51291600,73637085.6,61.96011631371681,NaN,1.5,2.75,NaN,NaN,1.3155456701127002,0.6965457633483529,136.57251405470274,0.41259928241566085,0.5497087714335294,0.1371094890178685,13.817342054481408,2.7272639170442643,NaN,NaN,NaN,1981957837
1116941400,119.44,119.83,119.2,119.5,NaN,NaN,112.422,125.15582674418604,116.4571501000004,118.39930029999996,117.22080000000001,117.24200049999999,117.61945181459221,117.716234803638,117.79077000000028,120.43984578035553,115.14169421964503,116.4571501000004,118.39930029999996,117.22080000000001,117.24200049999999,119.51,50997600,72418775.2,60.25742557223715,NaN,1.5,2.75,NaN,NaN,1.266578122247507,0.7042041219167153,135.6642189484735,0.3953351365538126,0.6312784097101343,0.2359432731563217,11.886105564863918,1.9276610433588346,NaN,NaN,NaN,1930960237
1117027800,119.35001,119.87,118.83,119.41,NaN,NaN,112.375,125.19047813953487,116.51310010000039,118.38470029999995,117.20620000000001,117.43000099999999,117.68966939049055,117.87754577472009,117.96923153846183,120.71620215091274,115.22226092601092,116.51310010000039,118.38470029999995,117.20620000000001,117.43000099999999,119.37,48481008,70583519.2,59.68963052197653,NaN,1.5,2.75,NaN,NaN,1.2503939706584,0.6868601700437742,132.52996793558944,0.3558955437438624,0.6808127028361497,0.3249171590922873,11.84494488216152,2.984044846916769,NaN,NaN,NaN,1882479229
1117114200,119.78999,120.21001,119.62,120.05,NaN,NaN,112.32799999999999,125.22512953488372,116.57255010000038,118.38220029999995,117.22480000000002,117.72250100000001,117.78223137517719,118.0844461771277,118.14076923076952,121.09939716162114,115.1821412999179,116.57255010000038,118.38220029999995,117.22480000000002,117.72250100000001,119.96000333333335,43554192,69050319.2,62.402693703363994,NaN,1.5,2.75,NaN,NaN,1.218223687039943,0.6307601833649452,135.57397145838775,0.3504000356749825,0.7629172036860155,0.41251716801103294,8.617008491114698,3.741790528862771,NaN,NaN,NaN,1926033421
1117200600,120.06,120.25,119.8,120.25,NaN,NaN,112.28099999999999,125.25978093023255,116.6389001000004,118.39740029999996,117.24260000000002,117.94750100000002,117.87900661536632,118.29068939835363,118.421537692308,121.43427582137835,115.40879956323764,116.6389001000004,118.39740029999996,117.24260000000002,117.94750100000002,120.10000000000001,24641504,65068228.8,63.23542968113079,NaN,1.5,2.75,NaN,NaN,1.16335056653709,0.378702547379006,138.38248620857883,0.33758970128978016,0.8345042946232581,0.496914593333478,8.00496590982948,2.953767123287674,NaN,NaN,NaN,1950674925
1117546200,120.08,120.17,119.39999,119.48,NaN,NaN,112.234,125.2944323255814,116.70035010000039,118.41210039999994,117.26140020000001,118.10150150000001,117.94179066966568,118.40395707470091,118.59384461538492,121.57260480384332,115.61508442692653,116.70035010000039,118.41210039999994,117.26140020000001,118.10150150000001,119.68333000000001,44926800,64511713.6,57.91679084369183,NaN,1.5,2.75,NaN,NaN,1.1409690974987263,0.6964130619528296,139.11109048905683,0.25819354525803584,0.8196565249060228,0.561462979647987,9.092781627224298,1.6159210750127622,NaN,NaN,NaN,1905748125
1117632600,119.52,120.92,119.45,120.5,NaN,NaN,112.187,125.32908372093023,116.7613501000004,118.43100039999995,117.30940000000001,118.296501,118.04211260418859,118.60358021044368,118.94384461538492,121.65497857320992,116.23271065755992,116.7613501000004,118.43100039999995,117.30940000000001,118.296501,120.29,69917680,63666388,62.425269619651985,NaN,1.5,2.75,NaN,NaN,1.1644713048202457,1.0981882622271582,143.15612681034986,0.25486990681186894,0.8800503631628231,0.6251804563509542,9.471292353160095,1.4395236500987978,NaN,NaN,NaN,1975665805
1117719000,120.23,120.84,120.10001,120.75999,NaN,NaN,112.13999999999999,125.36373511627907,116.8206000500004,118.45420029999994,117.3866,118.45950050000002,118.14869603147531,118.80895257135381,119.33153615384646,121.46835998828462,117.1947123194083,116.8206000500004,118.45420029999994,117.3866,118.45950050000002,120.56666666666666,40481008,61566556.8,63.49869227874488,NaN,1.5,2.75,NaN,NaN,1.1341512116188002,0.6575161922974391,145.3374256243891,0.2503183164875903,0.9380783519604421,0.6877600354728518,8.076581574248534,1.232291158713316,NaN,NaN,NaN,2016146813
1117805400,120.55,120.89,119.73,120.14999,NaN,NaN,112.09299999999999,125.3983865116279,116.87120000000041,118.46570019999994,117.4495998,118.59399950000002,118.22717814788804,118.93667042170107,119.58922769230799,121.1812732701474,117.99718211446857,116.87120000000041,118.46570019999994,117.4495998,118.59399950000002,120.25666333333334,61052000,59753016,59.223764615711474,NaN,1.5,2.75,NaN,NaN,1.1359975536460285,1.0217392206612634,143.4059056967753,0.18914441617925803,0.9241905556969243,0.7350461395176663,8.72601377839594,0.8646658831430473,NaN,NaN,NaN,1955094813
1118064600,120.02,120.2,119.55,120.03999,NaN,NaN,112.04599999999999,125.43303790697674,116.92284990000041,118.48430019999992,117.50759959999999,118.74149900000002,118.29826880875518,119.04174847677716,119.778457692308,120.87924992128565,118.67766546333034,116.92284990000041,118.48430019999992,117.50759959999999,118.74149900000002,119.92999666666667,36332000,58089472,58.45946027867805,NaN,1.5,2.75,NaN,NaN,1.1012834426713127,0.6254489625934283,145.49613238760278,0.12716531939297304,0.8940027887588826,0.7668374693659096,8.685061758473136,0.21705626982801965,NaN,NaN,NaN,1918762813
1118151000,120.39,121.25,120.00999,120.13,NaN,NaN,111.999,125.46768930232558,116.97109990000043,118.49990009999992,117.56399959999999,118.85699850000003,118.37010140449027,119.14539147898886,119.88153538461569,120.8337077920664,118.92936297716497,116.97109990000043,118.49990009999992,117.56399959999999,118.85699850000003,120.46333,66684192,59225091.2,58.92656483128303,NaN,1.5,2.75,NaN,NaN,1.1111924824805046,1.125944944091534,147.1560477917533,0.08040492317705972,0.8673436233372342,0.7869387001601745,8.145051900571316,0.5271966527196614,NaN,NaN,NaN,1985447005
1118237400,120.42999,120.59,119.67,119.91,NaN,NaN,111.952,125.50234069767441,117.01964990000042,118.52280009999991,117.63159959999999,119.02249800000001,118.43048958470634,119.21821133813278,119.92922846153877,120.8181117819947,119.04034514108284,117.01964990000042,118.52280009999991,117.63159959999999,119.02249800000001,120.05666666666664,50022192,57974669.6,57.232608887847604,NaN,1.5,2.75,NaN,NaN,1.0975358765890402,0.862828410151043,145.30716506238977,0.025667197836688027,0.8190226974560346,0.7933554996193466,8.09021713077909,0.4187253998827569,NaN,NaN,NaN,1935424813
1118323800,119.74001,120.58,119.44,120.48,NaN,NaN,111.90499999999999,125.53699209302326,117.07029985000042,118.54519999999991,117.6775998,119.18449750000002,118.51086254216884,119.33838168688203,120.03384384615416,120.83270663845894,119.23498105384937,117.07029985000042,118.54519999999991,117.6775998,119.18449750000002,120.16666666666667,57162896,56232348.8,60.408257633260575,NaN,1.5,2.75,NaN,NaN,1.1005690282612517,1.0165482541607795,147.2272871123826,0.01915633283993423,0.8173009156692643,0.7981445828293301,8.424758330163979,0.3581840899625213,NaN,NaN,NaN,1992587709
1118410200,120.56,120.64999,119.60001,120.2,NaN,NaN,111.85799999999999,125.57164348837209,117.11579980000045,118.55249999999992,117.72239959999999,119.39699750000003,118.57710322678967,119.42044057384565,120.06615153846185,120.85524891207933,119.27705416484437,117.11579980000045,118.55249999999992,117.72239959999999,119.39699750000003,120.14999999999999,36504096,53278988,58.12502221750564,NaN,1.5,2.75,NaN,NaN,1.0969555262425912,0.6851499506709849,146.66575766941875,-0.011074235503627738,0.7843017884497954,0.7953760239534231,8.085246131129804,-0.041580041580039216,NaN,NaN,NaN,1956083613
1118669400,119.94,121.08,119.81,120.58,NaN,NaN,111.81099999999999,125.60629488372092,117.16319975000046,118.57609999999994,117.7853998,119.63999750000002,118.65564819828812,119.53087480490797,120.14922846153877,120.90928559734536,119.38917132573218,117.16319975000046,118.57609999999994,117.7853998,119.63999750000002,120.49,49501696,51482048,60.317157751756994,NaN,1.5,2.75,NaN,NaN,1.1093158457966916,0.9615331542365991,148.4561429497578,-0.012442219489298467,0.7798232495918,0.7922654690810985,8.232806054228806,0.9206561767659811,NaN,NaN,NaN,2005585309
1118755800,120.45,121.2,120.38,120.86,NaN,NaN,111.764,125.64094627906977,117.21024975000046,118.60969999999993,117.84999979999999,119.84299750000002,118.7420933669827,119.65745815682149,120.26076692307721,120.97856032679114,119.54297351936329,117.21024975000046,118.60969999999993,117.84999979999999,119.84299750000002,120.81333333333333,34001600,50714577.6,61.89985749014131,NaN,1.5,2.75,NaN,NaN,1.0886504282397855,0.6704502257354895,151.01248481283682,-0.0020013908263512015,0.7897637305481595,0.7917651213745107,7.081023401659966,0.29875518672199125,NaN,NaN,NaN,2039586909
1118842200,121.16,121.24001,120.23,121.09,NaN,NaN,111.717,125.6755976744186,117.26304975000046,118.65279999999993,117.9079998,120.01849750000004,118.83416813690495,119.79389071331468,120.34076692307721,121.16994515461018,119.51158869154425,117.26304975000046,118.65279999999993,117.9079998,120.01849750000004,120.85333666666668,53889904,50338477.6,63.19828672540589,NaN,1.5,2.75,NaN,NaN,1.0830332547940862,1.0705509298119893,153.2658773169909,0.012107325722524487,0.8068992785276663,0.7947919528051418,5.38767945707215,0.2732775979858904,NaN,NaN,NaN,2093476813
1118928600,121.09,121.64,120.92,121.39999,NaN,NaN,111.66999999999999,125.71024906976744,117.31449970000047,118.70129989999994,117.96399939999999,120.14899750000002,118.93478860212436,119.94685255014186,120.42922769230798,121.42868595267713,119.42976943193882,117.31449970000047,118.70129989999994,117.96399939999999,120.14899750000002,121.31999666666667,46642304,48767958.4,64.9328748930447,NaN,1.5,2.75,NaN,NaN,1.05710230802308,0.9564128893285802,156.3805681044205,0.032852580988855795,0.8358576790412116,0.8030050980523558,5.437694546736353,1.04036629549449,NaN,NaN,NaN,2140119117
1119015000,121.53999,121.89999,120.49001,121.36,NaN,NaN,111.62299999999999,125.74490046511627,117.36469965000047,118.74609989999995,118.00639919999998,120.25249800000002,119.02989493145282,120.08143802155692,120.57384307692335,121.52494067769274,119.62274547615397,117.36469965000047,118.74609989999995,118.00639919999998,120.25249800000002,121.25,53732800,48312093.6,64.51045259542803,NaN,1.5,2.75,NaN,NaN,1.0823078574500031,1.1122018524984807,158.95190330347222,0.03426020593081813,0.8458303554658784,0.8115701495350602,4.1955163032387235,1.0996418776775942,NaN,NaN,NaN,2086386317
1119274200,121.08,121.84,120.94,121.39999,NaN,NaN,111.576,125.77955186046512,117.40879960000048,118.78779979999996,118.07439899999997,120.36649750000001,119.12283983610172,120.20701440045626,120.64307307692336,121.68889498129415,119.59725117255256,117.40879960000048,118.78779979999996,118.07439899999997,120.36649750000001,121.39332999999999,42228096,48102258.4,64.75736068059538,NaN,1.5,2.75,NaN,NaN,1.0692858676321462,0.8778817752972696,156.6180634395059,0.028499639604874893,0.8471946990411539,0.818695059436279,4.045756172711855,1.057179721967874,NaN,NaN,NaN,2128614413
1119360600,121.5,121.64999,121.03,121.47,NaN,NaN,111.529,125.81420325581395,117.45554960000048,118.82819989999994,118.14199899999998,120.4509975,119.21488533272517,120.32729874326995,120.69768923076951,121.83259373840377,119.56278472313525,117.45554960000048,118.82819989999994,118.14199899999998,120.4509975,121.38332999999999,40059200,47540638.4,65.21364664681406,NaN,1.5,2.75,NaN,NaN,1.0371933056584215,0.8426306702688284,155.64473491272133,0.020399018093099408,0.8441938320526532,0.8237948139595538,4.052851083837579,1.300975731798851,NaN,NaN,NaN,2168673613
1119447000,121.67999,121.94,121.07001,121.57001,NaN,NaN,111.48199999999999,125.84885465116278,117.49909965000047,118.86960009999993,118.19939919999999,120.554498,119.30724316281439,120.44565219629186,120.80692153846181,121.98255672523092,119.6312863516927,117.49909965000047,118.86960009999993,118.19939919999999,120.554498,121.52667333333333,46678400,47324678.4,65.89297625408886,NaN,1.5,2.75,NaN,NaN,1.0252502123971057,0.9863437339280472,157.72105644637432,0.013124379716530798,0.8402002886052173,0.8270759088886865,3.610838493502197,0.9047227755644027,NaN,NaN,NaN,2215352013
1119533400,121.32001,121.60001,119.83,119.86,NaN,NaN,111.43499999999999,125.88350604651163,117.53549965000047,118.88660009999994,118.25059919999998,120.576998,119.32891990152756,120.38987579664501,120.79307615384641,122.00809349272431,119.57805881496851,117.53549965000047,118.88660009999994,118.25059919999998,120.576998,120.43000333333333,62813392,48041297.6,48.465212437073546,NaN,1.5,2.75,NaN,NaN,1.0784473400830266,1.307487414744601,154.71904908582854,-0.10879236084776855,0.6910854578289758,0.7998778186767443,9.165328573864937,-0.2828618968386052,NaN,NaN,NaN,2152538621
1119619800,119.88,120.0078,118.84,118.98,NaN,NaN,111.38799999999999,125.91815744186046,117.56799965000047,118.88730009999993,118.31479919999997,120.52349799999999,119.31523676813431,120.25560191125025,120.70461461538487,122.22814417829328,119.18108505247646,117.56799965000047,118.88730009999993,118.31479919999997,120.52349799999999,119.27593333333334,59186608,48822918.4,42.269411596335786,NaN,1.5,2.75,NaN,NaN,1.0848296729342388,1.2122709977124186,152.27677435059647,-0.24295621413641277,0.4961825510062283,0.7391387651426411,9.950898123355506,-1.3269198872118049,NaN,NaN,NaN,2093352013
1119879000,118.97,119.41,118.75,119.14999,NaN,NaN,111.341,125.9528088372093,117.59844960000048,118.88609999999993,118.41479919999996,120.46849749999998,119.30875650271729,120.15030553875023,120.64615230769255,122.33637085876116,118.95593375662393,117.59844960000048,118.88609999999993,118.41479919999996,120.46849749999998,119.10332999999999,51163600,50149023.2,43.764957478929595,NaN,1.5,2.75,NaN,NaN,1.0544846962960785,1.0202312375248817,151.86318925466222,-0.31020157434111284,0.3513867972162501,0.6615883715573629,9.73300718854934,-1.4148684428264082,NaN,NaN,NaN,2144515613
1119965400,119.39999,120.24001,119.37,120.14999,NaN,NaN,111.294,125.98746023255813,117.63204960000049,118.89799979999992,118.52779899999996,120.50199699999999,119.34174605163034,120.15027548744068,120.62076692307717,122.33001047633833,118.91152336981601,117.63204960000049,118.89799979999992,118.52779899999996,120.50199699999999,119.92,42615392,50033452.8,51.6929868854458,NaN,1.5,2.75,NaN,NaN,1.0570229322749298,0.8517379795943246,155.35412991108515,-0.27830229532726647,0.3137105023982798,0.5920127977255463,11.054044162885274,-0.7762903625402601,NaN,NaN,NaN,2187131005
1120051800,120.37,120.39999,119.75999,119.83,NaN,NaN,111.24699999999999,126.02211162790697,117.66289960000049,118.89399979999993,118.61619899999997,120.46849699999999,119.36089326529189,120.11977306006538,120.59230538461563,122.34050496026865,118.84410580896261,117.66289960000049,118.89399979999993,118.61619899999997,120.46849699999999,119.99666,43059008,48690519.2,49.297971205272376,NaN,1.5,2.75,NaN,NaN,1.0272355799695778,0.8843407034361629,157.01545468366876,-0.26953766095590603,0.2550907215306637,0.5246283824865697,10.98826492879627,-1.2932373388169176,NaN,NaN,NaN,2144071997
1120138200,120.22,120.32001,118.95,119.17999,NaN,NaN,111.19999999999999,126.05676302325581,117.6947995500005,118.88509959999993,118.72379879999995,120.38949699999998,119.35379901959418,120.03026991148774,120.48461230769256,122.38816102978569,118.58106358559942,117.6947995500005,118.88509959999993,118.72379879999995,120.38949699999998,119.48333333333335,62301600,49781548.8,44.76120102175718,NaN,1.5,2.75,NaN,NaN,1.0517194671146075,1.2514998328055233,155.49213173021707,-0.2961796048324582,0.15440387644599696,0.45058348127845516,10.987054033017676,-1.7963167435728378,NaN,NaN,NaN,2081770397
1120224600,119.45,119.8,119.21001,119.53,NaN,NaN,111.15299999999999,126.09141441860464,117.72674955000049,118.87829949999994,118.79419899999995,120.3584975,119.36070886196303,119.98262515801271,120.38230461538487,122.33644555622678,118.42816367454296,117.72674955000049,118.87829949999994,118.79419899999995,120.3584975,119.51333666666666,49786400,49218268.8,47.55971740984343,NaN,1.5,2.75,NaN,NaN,1.0208830766064207,1.011543095965212,158.22649530992743,-0.27912309789233936,0.10167960891303096,0.3808027068053703,11.305796372932775,-1.540354327871033,NaN,NaN,NaN,2131556797
1120570200,119.25,120.64999,119.19,120.49001,NaN,NaN,111.106,126.12606581395349,117.7634496500005,118.89009959999994,118.89259899999996,120.38099849999999,119.40499518110174,120.03094752391625,120.33615153846179,122.24916313616126,118.42313994076233,117.7634496500005,118.89009959999994,118.89259899999996,120.38099849999999,120.11,51550192,49979178.4,54.38569252206432,NaN,1.5,2.75,NaN,NaN,1.0522478568488196,1.0314333618577451,161.3384417307894,-0.1960064259086618,0.13579467441954307,0.33180110032820487,12.549830346988228,-0.8067753354737802,NaN,NaN,NaN,2183106989
1120656600,120.39,120.64999,119.41,119.48,NaN,NaN,111.059,126.16071720930232,117.79849965000048,118.88749949999993,118.95559899999995,120.34849849999998,119.40793654654873,119.97847633116233,120.18846000000028,122.04578813633593,118.33113186366462,117.79849965000048,118.88749949999993,118.95559899999995,120.34849849999998,119.84666333333332,54068800,49348408.8,47.39574897966314,NaN,1.5,2.75,NaN,NaN,1.0656580099310473,1.0956543749795637,159.3122968302715,-0.20111697134433226,0.08040488614778951,0.2815218574921218,13.241901489649011,-1.7191822226550713,NaN,NaN,NaN,2129038189
1120743000,118.28999,119.95,118.25999,119.95,NaN,NaN,118.25999,126.19536860465116,117.83344960000049,118.87929949999995,119.05059899999995,120.35049849999999,119.42919393688015,119.97576429962305,120.07999846153874,121.81141378302793,118.34858314004954,117.83344960000049,118.87929949999995,119.05059899999995,120.35049849999999,119.38666333333333,103262368,52010417.6,50.57890713735359,NaN,1.5,2.75,NaN,NaN,1.1102545806502584,1.9854170138407041,161.04434763784036,-0.1663495572904469,0.07358491087906316,0.23993446816951006,13.568968858159737,0.0750876022025725,NaN,NaN,NaN,2232300557
1120829400,119.97,121.32001,119.72,121.32001,NaN,NaN,118.34721203703704,126.23002,117.88229965000049,118.88569969999993,119.16399939999995,120.39249899999997,119.50334358641426,120.10378769965895,120.07384615384643,121.7869275603832,118.36076474730966,117.88229965000049,118.88569969999993,119.16399939999995,120.39249899999997,120.78667333333333,64550608,52379803.2,58.468056722468326,NaN,1.5,2.75,NaN,NaN,1.145237110603811,1.2323568256552746,165.25652335146202,-0.050594296185444365,0.17669159793770461,0.22728589412314898,12.616102377550634,1.9667255000840413,NaN,NaN,NaN,2296851165
1121088600,121.33,122.10001,121.31,121.94,NaN,NaN,118.43443407407408,126.26467139534883,117.93724965000048,118.89379969999995,119.31879939999995,120.47949899999999,119.59889873988821,120.2786650615962,120.11000000000028,121.95423409162842,118.26576590837215,117.93724965000048,118.89379969999995,119.31879939999995,120.47949899999999,121.78333666666667,49762496,53042723.2,61.46589853962869,NaN,1.5,2.75,NaN,NaN,1.1198637455606815,0.9381587708528509,168.78167110250263,0.062105286810907545,0.3049175026367834,0.24281221582587587,11.495171693434523,2.341594825144337,NaN,NaN,NaN,2346613661
1121175000,121.89,122.63,121.64,122.25999,NaN,NaN,118.52165611111111,126.29932279069767,117.99124955000049,118.90429949999994,119.44899919999995,120.5634985,119.7032552598926,120.46736267477752,120.16307538461568,122.20178574971203,118.12436501951933,117.99124955000049,118.90429949999994,119.44899919999995,120.5634985,122.17666333333334,52165008,53175888.8,62.95226049451995,NaN,1.5,2.75,NaN,NaN,1.1105877637349182,0.9809898654669972,170.57783102750665,0.1476948819426207,0.42743081825415175,0.27973593631153104,11.476488435071078,1.7561383067946983,NaN,NaN,NaN,2398778669
1121261400,122.27,122.52,121.99001,122.42999,NaN,NaN,118.60887814814815,126.3339741860465,118.04964950000048,118.92629939999995,119.56959919999994,120.64199799999999,119.81018603401446,120.65427956289395,120.36076692307724,122.71723669171715,118.00429715443732,118.04964950000048,118.92629939999995,119.56959919999994,120.64199799999999,122.31333333333333,41266000,53539108.8,63.752201892365974,NaN,1.5,2.75,NaN,NaN,1.0691164948967096,0.7707636702387546,168.60116299901898,0.20189707597406326,0.5321072812791101,0.33021020530504686,10.874430314257902,2.169732120504052,NaN,NaN,NaN,2440044669
1121347800,122.98,123.44,122.49001,122.91,NaN,NaN,118.69610018518519,126.36862558139535,118.1077995000005,118.95149939999996,119.69579899999994,120.73299799999998,119.9317473660139,120.86911008071357,120.66307461538493,123.23218637496768,118.09396285580218,118.1077995000005,118.95149939999996,119.69579899999994,120.73299799999998,122.94667,64775808,54083404,65.98549951157068,NaN,1.5,2.75,NaN,NaN,1.064894602404087,1.1977021268853565,166.93783300570237,0.2529088361792361,0.646346250529092,0.3934374143498559,10.518390077647792,3.129728404910919,NaN,NaN,NaN,2504820477
1121434200,122.78999,123.03999,122.36,122.84,NaN,NaN,118.78332222222222,126.40327697674418,118.16279950000049,118.99389929999995,119.80259899999993,120.80499849999998,120.04579648891531,121.05681388255037,120.94692153846185,123.59867106835912,118.29517200856458,118.16279950000049,118.99389929999995,119.80259899999993,120.80499849999998,122.74666333333334,56137808,54558179.2,65.353140267545,NaN,1.5,2.75,NaN,NaN,1.0374014165180812,1.0289531069981162,167.38936760586677,0.2635699898359962,0.7228999016448512,0.45932991180885496,9.49050362107792,2.769179285535014,NaN,NaN,NaN,2448682669
1121693400,122.5,122.63,122.05,122.35001,NaN,NaN,118.87054425925926,126.43792837209301,118.21574960000049,119.02289939999996,119.90039899999994,120.85449899999999,120.13615780307549,121.17997541754558,121.11615384615418,123.82309725396952,118.40921043833883,118.21574960000049,119.02289939999996,119.90039899999994,120.85449899999999,122.34333666666667,56816304,54712354.4,60.94999610098318,NaN,1.5,2.75,NaN,NaN,1.01972988676679,1.0384547443273617,164.67979713217565,0.2209777797896063,0.7355521365458628,0.5145743567562565,10.310652566567105,1.5436964442114325,NaN,NaN,NaN,2391866365
1121779800,122.71001,123.11,122.41,123.02,NaN,NaN,118.9577662962963,126.47257976744186,118.26259965000048,119.05069929999996,120.01899899999995,120.93549949999999,120.24924965393528,121.35521585396981,121.3615384615388,124.13516008905854,118.58791683401905,118.26259965000048,119.05069929999996,120.01899899999995,120.93549949999999,122.84666666666665,59507296,55576314.4,64.47453274824919,NaN,1.5,2.75,NaN,NaN,1.0011770377120195,1.0707312394216628,167.8262236766861,0.2207637077099659,0.7905289913937139,0.569765283683748,9.895655945039632,2.9628389688650754,NaN,NaN,NaN,2451373661
1121866200,122.59,123.73,122.3,123.44,NaN,NaN,119.04498833333334,126.50723116279069,118.31059965000048,119.07079939999996,120.13139879999993,121.03399950000001,120.37437711848683,121.55376672502031,121.68923153846187,124.35912337858001,119.01933969834373,118.31059965000048,119.07079939999996,120.13139879999993,121.03399950000001,123.15666666666668,69602496,57053479.2,66.5148550887777,NaN,1.5,2.75,NaN,NaN,1.0318072493040185,1.2199518237268165,171.48315330799682,0.23066571059551033,0.8580974219281359,0.6274317113326255,7.297642537538442,2.9095456440183365,NaN,NaN,NaN,2520976157
1121952600,123.55,123.61,122.47,122.72,NaN,NaN,119.13221037037037,126.54188255813953,118.35469970000048,119.09169939999997,120.25379859999994,121.091499,120.46636232952656,121.66483656073267,121.93461615384649,124.33874553631499,119.530486771378,118.35469970000048,119.09169939999997,120.25379859999994,121.091499,122.93333333333331,100791120,59759115.2,60.138407436694855,NaN,1.5,2.75,NaN,NaN,1.03953530292516,1.6866233655347025,168.1450614664117,0.1731113233692957,0.8438208655442452,0.6707095421749495,8.938745129887204,1.1539646262805308,NaN,NaN,NaN,2420185037
1122039000,122.88,123.56,122.63,123.53999,NaN,NaN,119.21943240740741,126.57653395348837,118.39929965000049,119.11479929999996,120.37979819999993,121.2754985,120.5868967479765,121.84342260256766,122.16923000000034,124.55890294141477,119.77955705858591,118.39929965000049,119.11479929999996,120.37979819999993,121.2754985,123.24333,55933008,59415096,64.33211592715648,NaN,1.5,2.75,NaN,NaN,1.0317113527162205,0.9413938841401519,171.36202233177863,0.17417768213077622,0.8884316448384197,0.7142539627076435,7.485693809233867,1.3121125143513248,NaN,NaN,NaN,2476118045
1122298200,123.41,123.95,122.85001,123.19,NaN,NaN,119.30665444444445,126.61118534883721,118.44799965000047,119.13499929999996,120.52459819999993,121.48599850000001,120.688979228448,121.97166806898979,122.45461461538495,124.32013009122194,120.58909913954797,118.44799965000047,119.13499929999996,120.52459819999993,121.48599850000001,123.33000333333332,57591504,59335340.8,61.364598662420995,NaN,1.5,2.75,NaN,NaN,1.0365883989507767,0.9706104864910459,168.94215265950922,0.13686811203291505,0.8853391027487874,0.7484709907158723,7.595700032948142,0.7606822150075391,NaN,NaN,NaN,2418526541
1122384600,123.23,123.53,122.37,123.34,NaN,NaN,119.39387648148148,126.64583674418604,118.50214970000049,119.15619929999997,120.67699819999993,121.69549900000001,120.7929408273324,122.10198539575266,122.71538384615418,123.94792795487619,121.48283973743217,118.50214970000049,119.15619929999997,120.67699819999993,121.69549900000001,123.08,42847504,58919536,62.17001764997498,NaN,1.5,2.75,NaN,NaN,1.0454035133114352,0.7272206624301997,170.7814402181591,0.10905732612629948,0.8847926483737467,0.7757353222474472,7.530040192938855,0.7432901040014785,NaN,NaN,NaN,2461374045
1122471000,123.5,123.89,123.05,123.78999,NaN,NaN,119.48109851851852,126.68048813953487,118.55624965000048,119.16679919999997,120.81679799999992,121.87749900000003,120.910472167437,122.26274773901432,122.90538230769265,123.96886049092188,121.84190412446341,118.55624965000048,119.16679919999997,120.81679799999992,121.87749900000003,123.57666333333331,45262704,59051901.6,64.55707204052429,NaN,1.5,2.75,NaN,NaN,1.0307318337891902,0.7664902022393127,172.6927385267676,0.10755417874347173,0.910178045676787,0.8026238669333152,7.694566352431515,0.7159628996827,NaN,NaN,NaN,2506636749
1122557400,123.99001,124.64,123.64,124.57001,NaN,NaN,119.56832055555556,126.71513953488372,118.61644970000049,119.18459939999997,120.95659819999993,122.11449950000004,121.0539834549885,122.48248700196534,123.1076907692311,124.34588462471767,121.86949691374453,118.61644970000049,119.18459939999997,120.95659819999993,122.11449950000004,124.28333666666667,48448496,59321376,68.29200273302135,NaN,1.5,2.75,NaN,NaN,1.028536702804248,0.8167122758581999,176.9612674282805,0.14343555285376064,0.981918308000516,0.8384827551467554,8.118143480110033,1.4083441875610492,NaN,NaN,NaN,2555085245
1122643800,124.41,124.63,123.5,123.74001,NaN,NaN,119.6555425925926,126.74979093023255,118.67744980000049,119.19869949999996,121.05559859999994,122.34250050000003,121.15931782930268,122.60225109701626,123.22153846153878,124.39763202546884,122.04544489760873,118.67744980000049,119.19869949999996,121.05559859999994,122.34250050000003,123.95666999999999,62446304,59328611.2,60.93385281842947,NaN,1.5,2.75,NaN,NaN,1.035784081175373,1.0525495665066233,174.5762492546995,0.09779322611667662,0.9607242877926012,0.8629310616759246,9.312489706828964,1.1360849091879932,NaN,NaN,NaN,2492638941
1122903000,123.83,124.03999,123.45,123.64999,NaN,NaN,119.74276462962963,126.7844423255814,118.74249975000049,119.22549939999998,121.14279859999994,122.54850000000002,121.25699124776139,122.70203575444329,123.31538461538493,124.41614193194077,122.21462729882909,118.74249975000049,119.22549939999998,121.14279859999994,122.54850000000002,123.71332666666667,42940704,58986326.4,60.17654639263613,NaN,1.5,2.75,NaN,NaN,1.0039416468057034,0.7279772554203342,176.2895746385562,0.05044697358086825,0.9259897786520099,0.8755428050711417,8.885544608328754,0.5121037229718798,NaN,NaN,NaN,2449698237
1122989400,123.87,124.60001,123.74001,124.39,NaN,NaN,119.82998666666667,126.81909372093023,118.8081498000005,119.25699929999998,121.24819859999994,122.74349950000001,121.37985433608448,122.86279425402012,123.42923076923108,124.63942921552457,122.2190323229376,118.8081498000005,119.25699929999998,121.24819859999994,122.74349950000001,124.24333999999999,46241200,58720876.8,64.12386281925558,NaN,1.5,2.75,NaN,NaN,1.0000901006052956,0.7874746175452203,179.16857790250265,0.057370298800259345,0.9472556785714659,0.8898853797712065,8.981265728355998,0.7696046662346102,NaN,NaN,NaN,2495939437
1123075800,124.25,124.74001,124.12,124.72,NaN,NaN,119.91720870370371,124.74001,118.87334985000051,119.30029929999996,121.34699859999995,123.0054995,121.51084044055175,123.03967099173249,123.57384615384647,124.91053566875955,122.2371566389334,118.87334985000051,119.30029929999996,121.34699859999995,123.0054995,124.52667000000001,37197600,57877316.8,65.75403495325176,NaN,1.5,2.75,NaN,NaN,0.9729415219906311,0.642697382267037,177.91328607358096,0.07164917297425966,0.9794468459890311,0.9077976730147714,8.920638074635091,1.6297262059973925,NaN,NaN,NaN,2533137037
1123162200,124.23,124.31,123.57001,123.72,NaN,NaN,120.00443074074074,124.75433701923076,118.9382498000005,119.32609929999997,121.43139859999995,123.19399949999999,121.5974741487654,123.10446423061511,123.67923000000033,124.81414612602286,122.5443138739778,118.9382498000005,119.32609929999997,121.43139859999995,123.19399949999999,123.86666999999998,51043696,55266383.2,57.26279566418936,NaN,1.5,2.75,NaN,NaN,0.9855878418484433,0.9235939289763401,174.83988679386962,0.004749044717583195,0.9137339789117505,0.9089849341941673,9.603228493083114,0.1457099033276559,NaN,NaN,NaN,2482093341
1123248600,123.45,123.98,122.67,122.88,NaN,NaN,120.09165277777778,124.76866403846154,119.00004980000051,119.35349929999997,121.50079859999997,123.27199900000001,121.64776928018637,123.08308668484224,123.6684607692311,124.83052646316679,122.50639507529542,119.00004980000051,119.35349929999997,121.50079859999997,123.27199900000001,123.17666666666665,53711104,54724408,51.27313136112491,NaN,1.5,2.75,NaN,NaN,1.0087601388592689,0.981483509150067,170.60750643782163,-0.09932549211630548,0.7848280690487854,0.8841535611650909,9.712443985660364,-0.25164380225667854,NaN,NaN,NaN,2428382237
1123507800,123.17,123.41,122.38,122.64999,NaN,NaN,120.17887481481482,124.7829910576923,119.0570997000005,119.38879919999995,121.55279839999996,123.3074985,121.6870720535124,123.04183938152393,123.6076907692311,124.88781920958536,122.32756232887684,119.0570997000005,119.38879919999995,121.55279839999996,123.3074985,122.81332999999998,48227008,54647633.6,49.73894327812833,NaN,1.5,2.75,NaN,NaN,1.0102772717978925,0.8825086252225202,168.0488912600532,-0.18208994922240307,0.6565411246370871,0.8386310738594902,9.644578788552728,-0.5594373277120163,NaN,NaN,NaN,2380155229
1123594200,123.06,123.59,122.87,123.39,NaN,NaN,120.26609685185186,124.79731807692308,119.1240996500005,119.42909919999994,121.61559839999997,123.36399899999999,121.75385354160994,123.07499753566451,123.65922923076957,124.84254039699906,122.47591806454008,119.1240996500005,119.42909919999994,121.61559839999997,123.36399899999999,123.28333333333333,47522304,54415498.4,54.460178528840885,NaN,1.5,2.75,NaN,NaN,1.005258180955186,0.8733229575638694,169.9808742153442,-0.1848395815130074,0.607581596968231,0.7924211784812384,10.314228838202865,-0.32311982576297366,NaN,NaN,NaN,2427677533
1123680600,123.82001,124.5,122.82001,123.33,NaN,NaN,120.3533188888889,124.81164509615384,119.19144965000051,119.47699929999995,121.69259839999997,123.40899949999998,121.81566320664484,123.09928348464884,123.64307615384648,124.83813188927157,122.4480204184214,119.19144965000051,119.47699929999995,121.69259839999997,123.40899949999998,123.55000333333334,73115632,56007980,54.017127391330824,NaN,1.5,2.75,NaN,NaN,1.0534533108869586,1.3054502590523707,172.09643791235206,-0.18792681392108412,0.5575126610798833,0.7454394750009674,10.05629597348586,-0.9954322071580456,NaN,NaN,NaN,2354561901
1123767000,123.27,124.03,123.00999,123.82001,NaN,NaN,120.44054092592593,124.82597211538462,119.2528497500005,119.53419929999994,121.75899859999998,123.45449999999998,121.89426504167838,123.16792410515848,123.69153846153878,124.85997068284858,122.52310624022898,119.2528497500005,119.53419929999994,121.75899859999998,123.45449999999998,123.62,58860304,55712204.8,57.087538958187295,NaN,1.5,2.75,NaN,NaN,1.0510645029664614,1.0565064551169945,175.00865573700526,-0.15553513321918033,0.551020558476992,0.7065556916961724,9.57296029336252,0.06465168380057372,NaN,NaN,NaN,2413422205
1123853400,123.57001,123.69,122.75,123.06,NaN,NaN,120.52776296296297,124.84029913461538,119.30374975000049,119.59579939999995,121.80499879999999,123.46549999999998,121.93998013808314,123.15764561895291,123.67000000000031,124.87335950258881,122.46664049741182,119.30374975000049,119.59579939999995,121.80499879999999,123.46549999999998,123.16666666666667,54814608,55646044.8,51.35932953566373,NaN,1.5,2.75,NaN,NaN,1.052417752754571,0.9850584744524377,172.47389736587795,-0.18202284264304347,0.4790271383923681,0.6610499810354116,9.454523924589473,-0.47714520640074476,NaN,NaN,NaN,2358607597
1124112600,123.22,123.87,122.83,123.82001,NaN,NaN,120.614985,124.85462615384616,119.35674980000049,119.66399949999993,121.8783992,123.53899999999996,122.01370679933478,123.2207279409574,123.67230923076954,124.87669568516232,122.46792277637677,119.35674980000049,119.66399949999993,121.8783992,123.53899999999996,123.50666999999999,36227504,54616604.8,56.10282827466228,NaN,1.5,2.75,NaN,NaN,1.0515307704149592,0.6633056765915996,174.57500044434445,-0.14660749138358276,0.47779061680593315,0.6243981081895159,10.201498231155963,-0.45822815338853945,NaN,NaN,NaN,2394835101
1124199000,123.44,123.52,122.09,122.21001,NaN,NaN,120.70220703703704,124.86895317307692,119.40179985000049,119.71469959999995,121.9217996,123.49850049999995,122.02140496406675,123.12446908943765,123.49077076923109,124.8055738814213,122.17596765704089,119.40179985000049,119.71469959999995,121.9217996,123.49850049999995,122.60667000000001,72265008,55254490.4,45.89264422050037,NaN,1.5,2.75,NaN,NaN,1.099993572528176,1.3078576506064383,170.70201709813705,-0.2251633854795092,0.34294387634012935,0.5681072618196386,11.927152388785279,-2.0125000000000015,NaN,NaN,NaN,2322570093
1124285400,122.19,122.87,122.03,122.2,NaN,NaN,120.78942907407408,124.8832801923077,119.44524990000049,119.76359959999996,121.9631996,123.43650049999994,122.02840869096609,123.03642441425312,123.37230846153878,124.84407708084235,121.9005398422352,119.44524990000049,119.76359959999996,121.9631996,123.43650049999994,122.36666666666667,62507696,54899750.4,45.83679001272835,NaN,1.5,2.75,NaN,NaN,1.0814226030618779,1.138578874121803,169.21806034015032,-0.26841540156527033,0.23258800986305062,0.5010034114283209,11.65760044117768,-1.228580666020042,NaN,NaN,NaN,2260062397
1124371800,122.05,122.56,121.84,122.19,NaN,NaN,120.87665111111112,124.89760721153846,119.48844990000049,119.82019959999997,122.00879959999999,123.41000049999995,122.03474560504586,122.95581256527663,123.26000153846186,124.84809314600146,121.67190993092227,119.48844990000049,119.82019959999997,122.00879959999999,123.41000049999995,122.19666666666669,53546096,52537499.2,45.776851034515126,NaN,1.5,2.75,NaN,NaN,1.0556067028431724,1.0191976553006543,166.86387923524381,-0.28665987753859623,0.14267856450507566,0.4293384420436719,11.036468298843603,-0.5615234374999982,NaN,NaN,NaN,2206516301
1124458200,122.63,122.82001,122.2,122.47,NaN,NaN,120.96387314814815,124.91193423076923,119.5258999000005,119.86309969999995,122.0485996,123.35650099999994,122.05181440484797,122.90954470191696,123.11230923076954,124.60694067772378,121.6176777838153,119.5258999000005,119.86309969999995,122.0485996,123.35650099999994,122.49667,39955808,51738639.2,47.83381612745556,NaN,1.5,2.75,NaN,NaN,1.0252069383543743,0.7722624448151315,168.54613961936988,-0.26911322791455594,0.09294690715047693,0.3620601350650329,10.583925328833583,-0.1467509292092104,NaN,NaN,NaN,2246472109
1124717400,122.58,123.23,121.88,122.47,NaN,NaN,121.05109518518519,124.92626125,119.5554999000005,119.90819959999993,122.0939996,123.32050099999992,122.06821383995198,122.86768330173439,122.93923230769262,124.14162975110801,121.73683486427723,119.5554999000005,119.90819959999993,122.0939996,123.32050099999992,122.52666666666669,69948320,52356480,47.83381612745556,NaN,1.5,2.75,NaN,NaN,1.0484064427576338,1.3360011979414965,170.84171425796222,-0.24730880090968155,0.05292413392793094,0.3002329348376125,10.53884251371649,-0.7456033714239417,NaN,NaN,NaN,2246472109
1124803800,122.5,122.61,121.14999,122.24001,NaN,NaN,121.13831722222223,124.94058826923077,119.58029995000052,119.95629979999993,122.12719980000001,123.26550149999991,122.07495094426758,122.8079048920454,122.82538692307723,123.99019689163597,121.66057695451849,119.58029995000052,119.95629979999993,122.12719980000001,123.26550149999991,122,56743296,53051269.6,46.16549380647022,NaN,1.5,2.75,NaN,NaN,1.077806696846374,1.0695935540815031,169.14415117221031,-0.23809246334178874,0.0026173556603765746,0.24070981900216532,9.799379951802822,-0.8837995621503286,NaN,NaN,NaN,2189728813
1124890200,121.94,122.73,121.09,121.14999,NaN,NaN,121.22553925925926,124.95491528846154,119.60049990000053,119.99149969999993,122.13299960000002,123.1335014999999,122.03867796606102,122.65000823566012,122.69230923076954,124.15815515377629,121.22646330776278,119.60049990000053,119.99149969999993,122.13299960000002,123.1335014999999,121.65666333333333,79135312,54744900,39.189244144154884,NaN,1.5,2.75,NaN,NaN,1.1179633613573474,1.445528478451874,167.5135612392683,-0.2915916765337576,-0.1237797766650317,0.1678118998687259,10.808140119884868,-2.15637197897173,NaN,NaN,NaN,2110593501
1124976600,121.35001,121.67,121.21001,121.59,NaN,NaN,121.3127612962963,124.96924230769231,119.62404990000051,120.02549969999993,122.14299960000002,122.98450099999991,122.02108275170568,122.54905507035916,122.61077153846183,124.1904652246339,121.03107785228977,119.62404990000051,120.02549969999993,122.14299960000002,122.98450099999991,121.49000333333332,35642000,54104575.2,42.93781472294989,NaN,1.5,2.75,NaN,NaN,1.0752524069746798,0.6587612945531452,169.55146732750933,-0.2832877281964118,-0.1862977603767888,0.09698996781962296,10.743711367235255,-1.1945392491467568,NaN,NaN,NaN,2146235501
1125063000,121.48,121.49001,120.67999,120.75999,NaN,NaN,121.39998333333334,124.98356932692307,119.6429998500005,120.04709949999993,122.13019960000001,122.83549999999991,121.97162813399173,122.37866792080115,122.40846307692337,124.19699719890438,120.61992895494235,119.6429998500005,120.04709949999993,122.13019960000001,122.83549999999991,120.97666333333335,61962304,54080375.2,38.159317375799795,NaN,1.5,2.75,NaN,NaN,1.0634493779050598,1.14574471369422,166.11896805117271,-0.3170861015981121,-0.2993676591780172,0.017718442420094918,10.85262998098222,-2.4713453019427107,NaN,NaN,NaN,2084273197
1125322200,120.41,121.78,120.38,121.69,NaN,NaN,120.38,124.99789634615384,119.6621498500005,120.07159939999994,122.13679960000002,122.73750049999992,121.96058389344303,122.31308049977247,122.28230923076953,124.02378014551675,120.5408383160223,119.6621498500005,120.07159939999994,122.13679960000002,122.73750049999992,121.28333333333333,56183392,54742509.6,45.48066366734318,NaN,1.5,2.75,NaN,NaN,1.0874887080546987,1.0263210877712483,168.56027917431945,-0.2624585599876051,-0.31035475756441144,-0.047896197576806354,11.2884238933426,-0.4255052429829596,NaN,NaN,NaN,2140456589
1125408600,121.25,121.3,120.39,121.05,NaN,NaN,120.43729756756757,125.01222336538461,119.67344990000049,120.10209939999993,122.12979980000001,122.57050049999994,121.92487472115114,122.19278711884175,122.06923153846184,123.67883522819685,120.45962784872683,119.67344990000049,120.10209939999993,122.12979980000001,122.57050049999994,120.91333333333334,74179872,56139443.2,41.81210285059657,NaN,1.5,2.75,NaN,NaN,1.1026680860507914,1.3213503335921934,166.9648311038845,-0.2548672081633056,-0.36648020778093837,-0.11161299961763275,9.095306407488108,-0.9410801963993499,NaN,NaN,NaN,2066276717
1125495000,121.19,122.66,120.74001,122.58,NaN,NaN,120.49459513513513,125.02655038461538,119.69269990000049,120.14699939999993,122.15199980000001,122.46350049999994,121.95056590855698,122.22966453609492,122.03230846153876,123.5697105983609,120.49490632471662,119.69269990000049,120.14699939999993,122.15199980000001,122.46350049999994,121.99333666666666,102979312,59428528.8,51.8178828400871,NaN,1.5,2.75,NaN,NaN,1.1610482227614491,1.7328262045080276,171.16576996608467,-0.1380899556552446,-0.2842254441866885,-0.1461354885314439,11.96963513590497,0.319175055241837,NaN,NaN,NaN,2169256029
1125581400,122.50999,123.14999,121.14,122.49001,NaN,NaN,120.5518927027027,125.04087740384615,119.7157499500005,120.18489949999991,122.17039980000001,122.40200099999996,121.97172057880965,122.25445934218111,121.93000076923107,123.11442039346572,120.74558114499642,119.7157499500005,120.18489949999991,122.17039980000001,122.40200099999996,122.25999999999999,74582624,60605475.2,51.25956601455003,NaN,1.5,2.75,NaN,NaN,1.2216869211356314,1.230625182854766,173.82839127577293,-0.06206799468907176,-0.2237204818927836,-0.16165248720371184,11.983277724570337,0.01633869519065828,NaN,NaN,NaN,2094673405
1125667800,122.85001,122.88,122.03999,122.27,NaN,NaN,120.60919027027026,125.05520442307692,119.73419995000049,120.23459949999993,122.21859980000004,122.37150099999994,121.9834178110132,122.25593940483053,121.93461538461568,123.12382061077179,120.74541015845958,119.73419995000049,120.23459949999993,122.21859980000004,122.37150099999994,122.39666333333332,47656304,60302735.2,49.84553110423993,NaN,1.5,2.75,NaN,NaN,1.1944242839116572,0.790284285479641,172.13120690670493,-0.023731964848922177,-0.19131744326486455,-0.16758547841594237,11.957773963085259,-0.16330529925696322,NaN,NaN,NaN,2047017101
1126013400,122.66,123.8,122.64999,123.7,NaN,NaN,120.66648783783783,125.06953144230769,119.75899990000049,120.31389949999993,122.31299980000003,122.42400149999995,122.05073475960091,122.39346898532285,122.05000000000031,123.56599232800494,120.53400767199568,119.75899990000049,120.31389949999993,122.31299980000003,122.42400149999995,123.38333,57253808,60754075.2,57.96260190407372,NaN,1.5,2.75,NaN,NaN,1.2183939779179676,0.9423862977343123,175.94972508540738,0.09432748885188721,-0.04967611735108335,-0.14400360620297056,13.740048633740441,1.1943634494139888,NaN,NaN,NaN,2104270909
1126099800,123.63,124.13,123.46001,123.91,NaN,NaN,120.7237854054054,125.08385846153845,119.7914499000005,120.41149959999993,122.40820000000004,122.45000149999994,122.12364712196951,122.5379005105302,122.182307692308,123.99522605099291,120.36938933362309,119.7914499000005,120.41149959999993,122.40820000000004,122.45000149999994,123.83333666666665,41754304,60465675.2,59.011703406401644,NaN,1.5,2.75,NaN,NaN,1.179222265209541,0.6905455675784796,177.10585382536948,0.17809462719704816,0.07861467779333964,-0.09947994940370852,13.618887405608962,2.2781760031511302,NaN,NaN,NaN,2146025213
1126186200,123.66,124,123.31,123.5,NaN,NaN,120.78108297297297,125.09818548076923,119.8190499000005,120.50149959999993,122.47520020000003,122.45850149999994,122.17762174463738,122.62952903333685,122.26153846153876,124.20327643254011,120.31980049053742,119.8190499000005,120.50149959999993,122.47520020000003,122.45850149999994,123.60333333333334,39070800,58763433.6,56.069597092094526,NaN,1.5,2.75,NaN,NaN,1.1442778176945738,0.6648828634819596,174.63149552884252,0.19600392957198123,0.145524962561268,-0.050478967010713215,12.387437767019026,1.5708528661896508,NaN,NaN,NaN,2106954413
1126272600,123.83,124.74001,123.8,124.60001,NaN,NaN,120.83838054054054,125.1125125,119.8512499500005,120.59339969999994,122.57060040000005,122.49750149999996,122.27261736249474,122.81719388730477,122.42538538461568,124.73453927359024,120.11623149564112,119.8512499500005,120.59339969999994,122.57060040000005,122.49750149999996,124.38000666666665,44112304,58026033.6,61.60102551472083,NaN,1.5,2.75,NaN,NaN,1.15111583071639,0.7602157387507527,178.02779994996413,0.26761455895316,0.28403923168073675,0.01642467272757677,12.99990150048645,3.1798777061839734,NaN,NaN,NaN,2151066717
1126531800,124.45,124.67,124.27,124.35001,NaN,NaN,120.8956781081081,125.12683951923077,119.88080000000049,120.69889979999995,122.67400080000004,122.56200199999996,122.35408374043612,122.96317637422813,122.58769307692336,125.10880208904733,120.06658406479939,119.88080000000049,120.69889979999995,122.67400080000004,122.56200199999996,124.43000333333333,33024608,56936533.6,59.759379124988946,NaN,1.5,2.75,NaN,NaN,1.0974646999509339,0.5800249139157287,176.5002747183122,0.2823657601679576,0.3693818729375238,0.08701611276956617,11.993611105227115,2.1858903771879366,NaN,NaN,NaN,2118042109
1126618200,124.13,124.42,123.52,123.66,NaN,NaN,120.95297567567567,125.14116653846153,119.9073499500005,120.77539989999994,122.75660080000006,122.55400149999996,122.40529614277196,123.02954052906354,122.78077076923105,125.21483635694332,120.34670518151879,119.9073499500005,120.77539989999994,122.75660080000006,122.55400149999996,123.86666666666667,58479008,58049108.8,54.88239421067321,NaN,1.5,2.75,NaN,NaN,1.0833600785258677,1.0074057846689974,172.446204680564,0.23198131207479533,0.37699275286306033,0.145011440788265,12.473047854519768,2.156133828996282,NaN,NaN,NaN,2059563101
1126704600,123.75,123.92,123.02,123.21001,NaN,NaN,121.01027324324323,125.15549355769231,119.93435000000049,120.85179989999995,122.81100080000004,122.60400149999995,122.43685354893776,123.04672809772416,122.90538692307722,125.24695947515767,120.56381437099677,119.93435000000049,120.85179989999995,122.81100080000004,122.60400149999995,123.38333666666666,55195392,57195628,51.90726622317996,NaN,1.5,2.75,NaN,NaN,1.0702629300597348,0.9650281661388525,169.74607548468862,0.15820112024233718,0.3427628410911865,0.1845617208488493,12.176777399760057,0.5139582313591113,NaN,NaN,NaN,2004367709
1126791000,123.50999,123.64999,122.89999,123.14999,NaN,NaN,121.0675708108108,125.16982057692307,119.9606499500005,120.91999979999996,122.88440060000005,122.65150099999997,122.46481968427354,123.05656256460757,123.08923307692336,125.07668114719753,121.1017850066492,119.9606499500005,120.91999979999996,122.88440060000005,122.65150099999997,123.23332333333333,73655808,57753033.6,51.50620564664301,NaN,1.5,2.75,NaN,NaN,1.0473870064840394,1.2753582523498816,168.6389140458673,0.09815101106195115,0.30725048467628824,0.2090994736143371,10.070301107527634,0.5388031236180032,NaN,NaN,NaN,1930711901
1126877400,123.28,123.74001,122.87,123.5,NaN,NaN,121.12486837837837,125.18414759615385,119.9819999500005,121.00299979999994,122.95540060000005,122.71700099999995,122.5054149907726,123.09879470131162,123.22846384615413,125.0510744441136,121.40585324819466,119.9819999500005,121.00299979999994,122.95540060000005,122.71700099999995,123.37000333333333,75425808,58847019.2,53.750392497494566,NaN,1.5,2.75,NaN,NaN,1.0347172203066075,1.2817269086078025,170.98788127825338,0.07579802833035398,0.30384700902727957,0.22804898069692559,10.12316285275135,1.0059703933916775,NaN,NaN,NaN,2006137709
1127136600,123.47,123.55,122.64,123.09,NaN,NaN,121.18216594594594,125.19847461538461,120.0007999500005,121.07739989999995,122.99080040000004,122.74800099999997,122.52833989309525,123.09795711071051,123.38538692307719,124.71545921192669,122.0553146342277,120.0007999500005,121.07739989999995,122.99080040000004,122.74800099999997,123.09333333333332,53373696,59517913.6,50.785553434482864,NaN,1.5,2.75,NaN,NaN,1.025808847427564,0.8967669189264054,168.1069092200758,0.029569832716504235,0.2650112715925559,0.23544143887605165,10.3036640880169,-0.49312853678253793,NaN,NaN,NaN,1952764013
1127223000,123.21001,123.61,121.87,122.05,NaN,NaN,121.23946351351351,125.21280163461539,120.0147999500005,121.15589989999994,122.99300040000006,122.727001,122.50958146591505,122.99815167159522,123.34461769230796,124.79773660852815,121.89149877608777,120.0147999500005,121.15589989999994,122.99300040000006,122.727001,122.51,84997120,60270353.6,44.13527954790942,NaN,1.5,2.75,NaN,NaN,1.0768225011827375,1.4102641667594265,164.86560946590535,-0.06947204922490749,0.1486013773449173,0.21807342656982479,8.839938761944007,-1.5010895004438702,NaN,NaN,NaN,1867766893
1127309400,121.78999,121.87,120.78,120.91,NaN,NaN,121.29676108108107,125.22712865384615,120.0232999000005,121.20749989999993,122.96600060000006,122.66050049999998,122.4468527809772,122.79928008382424,123.22307846153875,125.13398064074794,121.31217628232956,120.0232999000005,121.20749989999993,122.96600060000006,122.66050049999998,121.18666666666665,94497808,62158079.2,38.226237370046114,NaN,1.5,2.75,NaN,NaN,1.0906208939553987,1.5202819845179514,161.38969703704373,-0.20264801300380209,-0.03523658968492782,0.16741142331887426,9.689936705734903,-2.0971659919028367,NaN,NaN,NaN,1773269085
1127395800,120.95,121.66,120.44,121.34,NaN,NaN,121.35405864864865,125.24145567307691,120.0394998500005,121.25689999999993,122.94420080000008,122.670001,122.40344678956633,122.66030102822194,123.15154000000028,125.25930026730305,121.04377973269752,120.0394998500005,121.25689999999993,122.94420080000008,122.670001,121.14666666666666,84600368,62431332,41.41252012592954,NaN,1.5,2.75,NaN,NaN,1.0998622586728701,1.3550947143014664,159.63193038878134,-0.24958164590040582,-0.14456563405663303,0.1050160118437728,10.249247661753941,-2.616380207353109,NaN,NaN,NaN,1857869453
1127482200,121.24001,121.89,120.89999,121.44,NaN,NaN,121.4113562162162,125.25578269230769,120.05274990000049,121.30529989999994,122.91480080000007,122.66250099999999,122.36566456252451,122.54408188267699,122.97769384615412,125.24276588519821,120.71262180711004,120.05274990000049,121.30529989999994,122.91480080000007,122.66250099999999,121.40999666666667,59368704,63617667.2,42.15970315509759,NaN,1.5,2.75,NaN,NaN,1.092015668767665,0.9332109555881357,160.3610706836631,-0.26049090000464026,-0.22059761316202753,0.03989328684261273,7.991950886031519,-2.3401767317911752,NaN,NaN,NaN,1917238157
1127741400,122.02,122.24001,121.08,121.58,NaN,NaN,121.46865378378378,125.27010971153845,120.0645998500005,121.34609989999994,122.88960080000007,122.70350149999999,122.33485418752355,122.45226456051728,122.79846307692334,125.10837732724379,120.4885488266029,120.0645998500005,121.34609989999994,122.88960080000007,122.70350149999999,121.63333666666666,70425808,64040842.4,43.250877265444544,NaN,1.5,2.75,NaN,NaN,1.0968724067128317,1.0997014617659058,162.48414927066057,-0.24510247225747417,-0.26648480347923,-0.021382331221755813,8.27319679003738,-1.6820313763545192,NaN,NaN,NaN,1987663965
1127827800,121.52,121.99001,121.02,121.55,NaN,NaN,121.52595135135134,125.28443673076923,120.07569985000049,121.38699979999993,122.87360060000006,122.6965015,122.30407559193439,122.36633460237277,122.64846307692333,125.0093653485463,120.28756080530037,120.07569985000049,121.38699979999993,122.87360060000006,122.6965015,121.52000333333332,66151376,64539241.6,43.06339950655843,NaN,1.5,2.75,NaN,NaN,1.0878108062333438,1.0249791345549373,160.5064963407684,-0.2243282185428619,-0.3017926044003332,-0.07746438585747129,8.05478595001816,-1.3473012460594718,NaN,NaN,NaN,1921512589
1127914200,121.91,122.12,121.2,121.67,NaN,NaN,121.58324891891891,125.29876374999999,120.08219985000049,121.43279979999993,122.84660060000006,122.72750149999999,122.27920988244676,122.30001702119442,122.42307769230796,124.54283941053214,120.30331597408377,120.08219985000049,121.43279979999993,122.84660060000006,122.72750149999999,121.66333333333334,58708496,63765672.8,44.10705343599254,NaN,1.5,2.75,NaN,NaN,1.0758243200738193,0.9206912343595629,159.98550826851667,-0.19118331520056414,-0.3164435298581765,-0.12526021465761233,8.088301643648858,-1.2017784167095757,NaN,NaN,NaN,1980221085
1128000600,121.55,122.86,121.08,122.66,NaN,NaN,121.64054648648647,125.31309076923077,120.09154990000049,121.48119969999992,122.83100060000007,122.7315015,122.29414282823316,122.334301114414,122.2930769230772,124.10982618591946,120.47632766023493,120.09154990000049,121.48119969999992,122.83100060000007,122.7315015,122.2,66645632,61948988.8,51.93476293749278,NaN,1.5,2.75,NaN,NaN,1.1261225829256893,1.075814687067176,163.44022460058576,-0.0960651259643805,-0.24534162211308796,-0.14927649614870747,9.721036683776342,-0.6801619433198408,NaN,NaN,NaN,2046866717
1128087000,122.62,123.03999,122.45,123.03999,NaN,NaN,121.69784405405404,125.32741778846153,120.10234985000048,121.54559949999992,122.83740040000006,122.7590005,122.3233917369299,122.4015095797079,122.24538384615411,123.944859637259,120.54590805504922,120.10234985000048,121.54559949999992,122.83740040000006,122.7590005,122.84332666666667,47827104,60611212.8,54.564971320108924,NaN,1.5,2.75,NaN,NaN,1.0878273984309972,0.7890801353507977,166.03331887789898,-0.005799995658453072,-0.15652649072177383,-0.15072649506332075,9.753075008949358,-0.04062880818913017,NaN,NaN,NaN,2094693821
1128346200,122.96001,123.34,122.45,122.60001,NaN,NaN,121.75514162162162,125.34174480769231,120.11129990000046,121.59919949999993,122.81860080000006,122.775501,122.33423951195226,122.42041438164048,122.19846076923105,123.82074229655518,120.57617924190691,120.11129990000046,121.59919949999993,122.81860080000006,122.775501,122.79666999999999,51015104,60779152.8,51.07957780380764,NaN,1.5,2.75,NaN,NaN,1.0736968699716403,0.8393520088684093,167.6618685127101,0.024376133605423483,-0.1202563280565414,-0.1446324616619649,9.78253201692202,0.45064317902499,NaN,NaN,NaN,2043678717
1128432600,122.78999,123.03,121.16,121.22,NaN,NaN,121.81243918918918,125.35607182692307,120.12019990000049,121.65189949999991,122.77920080000007,122.65150100000001,122.29054384481688,122.30608920243662,122.05000000000028,123.64988376501262,120.45011623498795,120.12019990000049,121.65189949999991,122.77920080000007,122.65150100000001,121.80333333333333,60779696,60955447.2,42.01450802214532,NaN,1.5,2.75,NaN,NaN,1.1305756649736662,0.9971167269198543,164.58941021356264,-0.04473831808394829,-0.20055535926690027,-0.15581704118295198,10.727210491033468,0.2563890497063951,NaN,NaN,NaN,1982899021
1128519000,121.25,121.31,119.57001,119.63,NaN,NaN,121.86973675675675,125.37039884615385,120.12099990000048,121.6909994999999,122.70500080000006,122.43750100000003,122.18620879207896,122.05122356410932,121.752307692308,123.58539017139837,119.91922521321762,120.12099990000048,121.6909994999999,122.70500080000006,122.43750100000003,120.17000333333333,106061184,64170791.2,34.432389208950994,NaN,1.5,2.75,NaN,NaN,1.1741052603326902,1.652795329723159,159.84439688216392,-0.18576219212135717,-0.38801978133464843,-0.20225758921329126,12.00520544380126,-1.4092632272952101,NaN,NaN,NaN,1876837837
1128605400,119.78,120.25999,118.17,119.2,NaN,NaN,121.92703432432431,125.38472586538461,120.11504990000049,121.71499949999992,122.61320100000006,122.22250100000001,122.0691025649386,121.77967846276557,121.45307692307723,123.56396212733932,119.34219171881514,120.11504990000049,121.71499949999992,122.61320100000006,122.22250100000001,119.20999666666667,141120816,69273292,32.71302446845594,NaN,1.5,2.75,NaN,NaN,1.2395255988803553,2.0371605264551307,156.6490054639196,-0.29001291482139613,-0.5647737327400364,-0.27476081791864027,11.697667441306303,-1.8445322793148837,NaN,NaN,NaN,1735717021
1128691800,119.7,120.05,119.13,119.61,NaN,NaN,121.98433189189188,125.39905288461539,120.10969995000049,121.73529949999993,122.51400080000005,121.97300050000001,121.97266717023513,121.57304241869267,121.26538461538492,123.55678084926004,118.9739883815098,120.10969995000049,121.73529949999993,122.51400080000005,121.97300050000001,119.59666666666668,75663120,70850832.8,35.9948526768416,NaN,1.5,2.75,NaN,NaN,1.216702341817473,1.0679213921674608,159.0384985941367,-0.31148210782412755,-0.6641134526987997,-0.3526313448746722,12.00136110142316,-1.6203322914953109,NaN,NaN,NaN,1811380141
1128951000,119.67999,119.71001,118.3,118.60001,NaN,NaN,122.04162945945944,125.41337990384615,120.09885000000048,121.73339969999994,122.41120080000005,121.68550050000002,121.8404061047357,121.28989647405527,121.08769307692339,123.7842191734776,118.39116698036918,120.09885000000048,121.73339969999994,122.41120080000005,121.68550050000002,118.87000666666665,52678608,71833532.8,31.871039643669434,NaN,1.5,2.75,NaN,NaN,1.2305100316876536,0.7333428546061986,155.12910818982388,-0.36985050489830185,-0.8149444759975495,-0.44509397109924764,12.479261628071388,-2.4269765528589056,NaN,NaN,NaN,1758701533
1129037400,118.99001,119.39,118.32001,118.42999,NaN,NaN,122.09892702702702,125.42770692307693,120.08839995000048,121.72479969999995,122.30680080000003,121.42400000000002,121.70666429670686,121.01752442890715,120.86384615384647,123.90104639762251,117.82664591007043,120.08839995000048,121.72479969999995,122.30680080000003,121.42400000000002,118.71333333333334,75640688,72691616.8,31.222562415101876,NaN,1.5,2.75,NaN,NaN,1.219044315138536,1.0405696190265505,152.8423710674885,-0.39383895321361106,-0.9373926626162614,-0.5435537094026504,12.420050198571236,-2.662948960302456,NaN,NaN,NaN,1683060845
1129123800,118.39,119.13,117.41,117.5,NaN,NaN,122.15622459459459,125.44203394230769,120.07000000000048,121.70859969999994,122.16900080000003,121.13849950000004,121.54169706938502,120.68252210234456,120.56076923076954,124.05886923848682,117.06266922305225,120.07000000000048,121.70859969999994,122.16900080000003,121.13849950000004,118.01333333333332,100520496,74957872,27.88086107759743,NaN,1.5,2.75,NaN,NaN,1.2548268640572118,1.3410265435496889,147.86058606428114,-0.44262307292912717,-1.0968325505640593,-0.6542094776349321,12.525066350829167,-4.2067503668677615,NaN,NaN,NaN,1582540349
1129210200,117.46001,118.08,116.88,117.42999,NaN,NaN,116.88,125.45636096153846,120.05034995000047,121.68509959999994,122.02320060000002,120.85249950000005,121.38045365489934,120.3727571402165,120.24153769230801,124.05275272416249,116.43032266045354,120.05034995000047,121.68509959999994,122.02320060000002,120.85249950000005,117.46333,99073120,76228737.6,27.641022151252358,NaN,1.5,2.75,NaN,NaN,1.2509106594816968,1.2996820243813143,144.08566884664577,-0.44850055289233826,-1.214835168750355,-0.7663346158580167,10.398357519021346,-4.559493218424351,NaN,NaN,NaN,1483467229
1129296600,118.12,118.81,117.56,118.67,NaN,NaN,116.770625,125.47068798076923,120.03804995000046,121.67679959999994,121.92220060000001,120.61099950000005,121.2741613547072,120.21058979352922,120.01999923076957,123.83604012719334,116.2039583343458,120.03804995000046,121.67679959999994,121.92220060000001,120.61099950000005,118.34666666666669,88654368,76890165.6,37.840355861455016,NaN,1.5,2.75,NaN,NaN,1.2601320409472898,1.1530000918609025,147.432712721874,-0.3425522356500075,-1.194524910420526,-0.8519726747705185,12.902573432397286,-3.205554387801433,NaN,NaN,NaN,1572121597
1129555800,118.77,119.27,118.45,119.11,NaN,NaN,116.66125,125.485015,120.02924995000046,121.67379959999995,121.84680060000001,120.41199950000005,121.1892922819736,120.10577171795501,119.82307615384647,123.54116165727034,116.10499065042261,120.02924995000046,121.67379959999995,121.84680060000001,120.41199950000005,118.94333333333333,68967808,77669871.2,41.017345959334534,NaN,1.5,2.75,NaN,NaN,1.2286940380224831,0.8879608905544316,149.0616182849234,-0.2223416844006152,-1.1298997802712876,-0.9075580958706724,13.567697184213207,-1.7406368586041903,NaN,NaN,NaN,1641089405
1129642200,118.94,118.96001,117.8,117.82001,NaN,NaN,116.551875,125.49934201923077,120.01685000000047,121.65149969999995,121.75020100000002,120.20050000000003,121.05716356503345,119.88808012576882,119.45076923076954,122.91889640030362,115.98264206123545,120.01685000000047,121.65149969999995,121.75020100000002,120.20050000000003,118.19333999999998,75013312,77170680.8,35.31803644885453,NaN,1.5,2.75,NaN,NaN,1.234501606735163,0.9720441911664462,145.33603108288398,-0.20939063547005843,-1.1692963902082454,-0.959905754738187,13.471901555969684,-1.512990052662375,NaN,NaN,NaN,1566076093
1129728600,117.56,119.8,117.12,119.78,NaN,NaN,116.4425,125.51366903846153,120.02210000000046,121.64679969999996,121.67800100000001,120.14400000000005,121.00707871934586,119.87778678045751,119.20000076923108,122.00104888077865,116.39895265768351,120.02210000000046,121.64679969999996,121.67800100000001,120.14400000000005,118.90000000000002,116569184,78274249.6,47.29976404885651,NaN,1.5,2.75,NaN,NaN,1.3377514919683653,1.4892405177398214,148.32969527855718,-0.05646330534888233,-1.03048488642429,-0.9740215810754076,15.706675023383713,0.48657718120805227,NaN,NaN,NaN,1682645277
1129815000,119.49001,119.81,117.3,117.67,NaN,NaN,116.333125,125.5279960576923,120.02040005000046,121.62869969999996,121.564801,119.96050000000005,120.87621288721465,119.6675213727949,118.82076923076956,120.9264614069734,116.71507705456571,120.02040005000046,121.62869969999996,121.564801,119.96050000000005,118.26,132087632,80648612.8,38.9375995923485,NaN,1.5,2.75,NaN,NaN,1.4214835282563396,1.6378165403484783,143.8405369640308,-0.08342681958101628,-1.078305105551678,-0.9948782859706616,18.74096832987917,-1.6219379650530874,NaN,NaN,NaN,1550557645
1129901400,118.28999,118.78,117.50999,118.13,NaN,NaN,116.22375,125.54232307692307,120.01800005000047,121.60499969999995,121.4510008,119.79500000000004,120.76851826418662,119.52109076586204,118.58307692307724,120.19043386715126,116.97571997900323,120.01800005000047,121.60499969999995,121.4510008,119.79500000000004,118.13999666666665,96580624,82509208.8,41.37110060565084,NaN,1.5,2.75,NaN,NaN,1.410663990523744,1.1705435721012514,147.2546620349677,-0.05752741540914785,-1.0667875552320965,-1.0092601398229486,18.785898633349152,-0.39629844887871596,NaN,NaN,NaN,1647138269
1130160600,118.44,120.09,118.41,119.96001,NaN,NaN,116.114375,125.55665009615385,120.02560010000046,121.59699989999996,121.389001,119.71400050000004,120.73681205774794,119.56289259768471,118.60846230769263,120.28987265544762,116.92705195993764,120.02560010000046,121.59699989999996,121.389001,119.71400050000004,119.48667,72345120,82605174.4,49.921548498211436,NaN,1.5,2.75,NaN,NaN,1.4499022769149055,0.8757940471099592,151.5681363430007,0.08770970655316968,-0.8996230066314865,-0.9873327131846562,20.342901591650904,1.2919193862973333,NaN,NaN,NaN,1719483389
1130247000,119.72,120.24001,118.94,119.72,NaN,NaN,116.005,125.57097711538461,120.02920010000047,121.59269999999995,121.30700079999998,119.62250050000003,120.69693707509116,119.57785520742902,118.64846230769263,120.40722119369026,116.88970342169499,120.02920010000047,121.59269999999995,121.30700079999998,119.62250050000003,119.63333666666664,77054816,83150346.4,48.91398886206699,NaN,1.5,2.75,NaN,NaN,1.439195685706698,0.9266926637842605,149.3106187811269,0.16782807952559975,-0.7775476137776565,-0.9453756933032562,20.371735538595242,1.8893617021276585,NaN,NaN,NaN,1642428573
1130333400,119.50999,120.53999,119.19,119.37,NaN,NaN,115.895625,125.58530413461538,120.03515015000046,121.58600009999996,121.25020059999999,119.50750050000002,120.64490032704836,119.55805947338817,118.63000076923109,120.35266755699975,116.90733398146243,120.03515015000046,121.58600009999996,121.25020059999999,119.50750050000002,119.69999666666665,82692496,84349546.4,47.41123661300953,NaN,1.5,2.75,NaN,NaN,1.432823851013363,0.9803549577831517,145.91615445524255,0.19552952570574667,-0.7009637861710729,-0.8964933118768196,19.76448816581587,1.65205668500866,NaN,NaN,NaN,1559736077
1130419800,119.2,119.37,117.92999,118.10001,NaN,NaN,115.78625,125.59963115384615,120.03280015000045,121.56570019999998,121.1682008,119.27950100000002,120.5451007063798,119.41919761877978,118.59153923076953,120.33733839099158,116.84574007054748,120.03280015000045,121.56570019999998,121.1682008,119.27950100000002,118.46666666666665,68286816,84431605.6,42.32947666745317,NaN,1.5,2.75,NaN,NaN,1.4333371473695515,0.8087826296175518,142.05508015696208,0.12976763819763915,-0.7342837641297706,-0.8640514023274097,20.980517189217284,-0.4803151596865292,NaN,NaN,NaN,1491449261
1130506200,118.42999,119.95,118.10001,119.8,NaN,NaN,115.676875,125.61395817307692,120.04370015000046,121.56460019999997,121.12040080000001,119.11750150000003,120.51588107083549,119.45546451222933,118.6969246153849,120.55291682744712,116.84093240332268,120.04370015000046,121.56460019999997,121.12040080000001,119.11750150000003,119.28333666666667,72959872,85688244,50.047727094349945,NaN,1.5,2.75,NaN,NaN,1.463098065414584,0.8514571963920745,145.77831799518836,0.19811350911738068,-0.6164095159306839,-0.8145230250480646,21.733980507971342,0.5792964486608998,NaN,NaN,NaN,1564409133
1130769000,120.28999,121.3,120.13,120.13,NaN,NaN,115.5675,125.62828519230769,120.05315010000045,121.56110019999997,121.07360080000001,118.99400100000003,120.50074847982233,119.51970598725511,118.89923230769259,120.76258786968783,117.03587674569734,120.05315010000045,121.56110019999997,121.07360080000001,118.99400100000003,120.52000000000001,80144880,87144732.8,51.4072566334546,NaN,1.5,2.75,NaN,NaN,1.4657339178849706,0.9196755492260802,149.64109583394364,0.2590516194157688,-0.4907085007783536,-0.7497601201941224,21.69684089299514,1.9606092377686941,NaN,NaN,NaN,1644554013
1130855400,120.58,120.89999,120.22,120.49001,NaN,NaN,115.458125,125.64261221153846,120.05825015000046,121.56400029999995,121.034001,118.95750150000003,120.50032736296656,119.61211589323081,119.13461846153874,120.96898439332733,117.30025252975014,120.05825015000046,121.56400029999995,121.034001,118.95750150000003,120.53666666666668,66996128,87455554.4,52.912895064035396,NaN,1.5,2.75,NaN,NaN,1.4160379237503304,0.76605915381402,148.64721209927,0.31347694948134186,-0.35791393334244503,-0.6713908828237869,20.373167251282474,0.5927617298380339,NaN,NaN,NaN,1711550141
1130941800,120.17,121.75,120.13,121.75,NaN,NaN,115.34875,125.65693923076923,120.07590015000045,121.57570029999995,121.0242008,119.06350150000003,120.5493341330463,119.8157239033993,119.3715415384618,121.64720184216617,117.09588123475743,120.07590015000045,121.57570029999995,121.0242008,119.06350150000003,121.21,74690880,85887039.2,57.836905534346386,NaN,1.5,2.75,NaN,NaN,1.43060664348245,0.8696408759192621,152.4454573081351,0.4176872730397696,-0.14928179152407495,-0.5669690645638445,19.074258601204317,3.4673238718449886,NaN,NaN,NaN,1786241021
1131028200,122.14999,122.66,121.75,122.27,NaN,NaN,115.239375,125.67126625,120.09975015000046,121.58980029999995,121.04660100000001,119.21700150000004,120.61681122586802,120.04946448402794,119.61461846153874,122.35435911787724,116.87487780520024,120.09975015000046,121.58980029999995,121.04660100000001,119.21700150000004,122.22666666666667,84900880,83076042.4,59.70948693205891,NaN,1.5,2.75,NaN,NaN,1.3934204546622748,1.0219658706322774,153.30385238341407,0.4994625618304399,0.05735913772420531,-0.4421034241062346,14.532878408904201,3.504613561330738,NaN,NaN,NaN,1871141901
1131114600,122.39999,122.46001,121.55,122.11,NaN,NaN,115.13,125.68559326923076,120.12640015000046,121.60000029999996,121.057001,119.34200150000004,120.675367648383,120.24570596173956,119.94461769230796,122.77226675116997,117.11696863344595,120.12640015000046,121.60000029999996,121.057001,119.34200150000004,122.04000333333333,59156400,82250706.4,58.843506469370794,NaN,1.5,2.75,NaN,NaN,1.3588911364721123,0.7192205707305633,151.9405527616926,0.5183548220965567,0.20584010351446125,-0.31251471858209545,14.828036816325369,1.7922556025128729,NaN,NaN,NaN,1811985501
1131373800,122.39999,122.62,121.85001,122.23,NaN,NaN,115.020625,125.69992028846154,120.15480015000047,121.60830039999995,121.0864012,119.52350100000004,120.73633362295622,120.4346863463358,120.13307923076951,123.20753177434233,117.05862668719669,120.15480015000047,121.60830039999995,121.0864012,119.52350100000004,122.23333666666667,46765696,81955060.8,59.32003756411919,NaN,1.5,2.75,NaN,NaN,1.3168267695812477,0.5706260912199824,153.71109828798504,0.5135303652060444,0.3293982379254601,-0.18413212728058434,12.697136998854587,2.0965586368192493,NaN,NaN,NaN,1858751197
1131460200,121.95,122.42,121.78999,122.23,NaN,NaN,114.91125,125.7142473076923,120.18155015000046,121.61700039999994,121.0972012,119.71350150000004,120.79490877499715,120.60566859906572,120.48384846153873,123.39010958918988,117.57758733388758,120.18155015000046,121.61700039999994,121.0972012,119.71350150000004,122.14666333333334,42153696,80280711.2,59.32003756411919,NaN,1.5,2.75,NaN,NaN,1.2677684288968727,0.5250787564024469,151.36061908679062,0.48526507623623166,0.42244921801470525,-0.06281585822152641,12.524622350202854,2.3959118706542677,NaN,NaN,NaN,1858751197
1131546600,122.08,122.95,121.86,122.39,NaN,NaN,114.801875,125.72857432692308,120.20735015000045,121.62690049999993,121.12400120000001,119.95800150000002,120.8574613720561,120.77560492296422,120.81154076923104,123.53734292575753,118.08573861270456,120.20735015000045,121.62690049999993,121.12400120000001,119.95800150000002,122.39999999999999,57668704,78138121.6,60.03557854471394,NaN,1.5,2.75,NaN,NaN,1.2550706839756676,0.738035453363138,152.9211619787507,0.4528940499405167,0.5033017042041195,0.05040765426360276,12.136355839719817,3.6325060429715488,NaN,NaN,NaN,1916419901
1131633000,122.34,123.86,121.75,123.34,NaN,NaN,114.6925,125.74290134615384,120.23690020000045,121.64560049999994,121.1392012,120.25350200000003,120.9548158280539,121.01983302553906,121.07154000000027,124.05542998402548,118.08765001597506,120.23690020000045,121.64560049999994,121.1392012,120.25350200000003,122.98333333333333,79143376,77141634.4,64.07600245605725,NaN,1.5,2.75,NaN,NaN,1.3161370636916914,1.0259489135221123,154.79939992368148,0.4690302869843709,0.6366955129940663,0.1676652260096955,9.019315147953336,2.9549248747913244,NaN,NaN,NaN,1995563277
1131719400,123.35001,123.84,122.42999,123.75999,NaN,NaN,114.583125,125.7572283653846,120.26855020000045,121.66750029999996,121.16460079999999,120.50800150000002,121.06482265832629,121.2808003564401,121.38230846153873,124.57278948258785,118.1918274404896,120.26855020000045,121.66750029999996,121.16460079999999,120.50800150000002,123.34332666666666,34867008,74452266.4,65.72576413475676,NaN,1.5,2.75,NaN,NaN,1.3228422734279992,0.46831358783189436,156.46328649388948,0.4798310338388037,0.7674540183082001,0.28762298446939644,6.418811297421289,3.0217181386830987,NaN,NaN,NaN,2030430285
1131978600,123.75999,124.02,123.38,123.69,NaN,NaN,114.47375,125.77155538461538,120.29620020000044,121.70580029999995,121.19300079999998,120.73700150000002,121.16777078937233,121.51024794154104,121.7146161538464,124.89739604110697,118.53183626658584,120.29620020000044,121.70580029999995,121.19300079999998,120.73700150000002,123.69666666666666,45092800,73258516,65.18849825983452,NaN,1.5,2.75,NaN,NaN,1.2740678253259994,0.6155298040708332,153.86464431450608,0.4543583949072833,0.8555709781035006,0.4012125831962173,6.7843847201247005,2.655813540060292,NaN,NaN,NaN,1985337485
1132065000,123.58,124.09,122.86,123.24001,NaN,NaN,114.364375,125.78588240384614,120.31785025000045,121.74840039999995,121.18380099999999,121.00800150000002,121.24903507214204,121.67498718520379,122.11000076923102,124.6001016136727,119.61989992478934,120.31785025000045,121.74840039999995,121.18380099999999,121.00800150000002,123.39666999999999,69592496,72987475.2,61.69656335811803,NaN,1.5,2.75,NaN,NaN,1.2709201235169998,0.9534854549948866,150.90150075061658,0.3821993313817717,0.8789617474234319,0.4967624160416602,7.755625636834422,1.223827515400409,NaN,NaN,NaN,1915744989
1132151400,123.37,123.55,122.98,123.49001,NaN,NaN,114.255,125.80020942307692,120.33895030000045,121.79180059999995,121.1754012,121.19350200000001,121.33691644186196,121.84784650089867,122.39384769230794,124.58984973369911,120.19784565091678,120.33895030000045,121.79180059999995,121.1754012,121.19350200000001,123.34000333333334,51133904,69715711.2,62.88603567177047,NaN,1.5,2.75,NaN,NaN,1.2208544004086421,0.7334631336300561,151.3950488674094,0.3283614356428316,0.9072142105951997,0.5788527749523681,5.778088703665445,0.9977999509282752,NaN,NaN,NaN,1966878893
1132237800,123.75,124.64999,123.14,124.64,NaN,NaN,114.145625,125.81453644230768,120.36735025000046,121.83670069999995,121.1982012,121.542002,121.4664491304164,122.11376588176546,122.74077076923102,124.81837677891578,120.66316475954626,120.36735025000046,121.83670069999995,121.1982012,121.542002,124.14333,55717504,65897204.8,67.83425508294974,NaN,1.5,2.75,NaN,NaN,1.2415069432365964,0.845521508372082,154.92660802907716,0.34551602151677685,1.0107478018483391,0.6652317803315623,7.212136557307781,2.0719023830972083,NaN,NaN,NaN,2022596397
1132324200,125.03999,125.756,124.33,125.13,NaN,NaN,114.03625,125.82886346153846,120.39185025000046,121.88970069999993,121.20880100000001,121.892002,121.61011779196869,122.40102627397827,123.09769307692333,125.09883338382018,121.09655277002649,120.39185025000046,121.88970069999993,121.20880100000001,121.892002,125.07200000000002,72437184,64690032.8,69.6886554452106,NaN,1.5,2.75,NaN,NaN,1.2546850187196967,1.119758034811199,156.95660288643003,0.3633615269278757,1.119433688991407,0.7560721620635312,6.976731680800191,2.372576290599682,NaN,NaN,NaN,2095033581
1132583400,125.14999,125.91,124.98,125.75999,NaN,NaN,113.926875,125.84319048076922,120.42030015000046,121.95550069999994,121.23700059999999,122.18200100000001,121.77285787855816,122.72092758121843,123.40615384615411,125.69656542439662,121.1157422679116,120.42030015000046,121.95550069999994,121.23700059999999,122.18200100000001,125.54999666666667,50021200,63573836.8,71.92935936267908,NaN,1.5,2.75,NaN,NaN,1.2314932316682892,0.7868205305488185,159.5962509568144,0.3888102567750713,1.2420849830323704,0.853274726257299,7.051793053186873,2.8879898551910315,NaN,NaN,NaN,2145054781
1132669800,125.56,126.52,125.42,126.3,NaN,NaN,113.8175,125.8575175,120.45075010000046,122.02320069999992,121.28980059999999,122.51100100000004,121.95039286371274,123.06179162110239,123.7161538461541,126.36966541750337,121.06264227480483,120.45075010000046,122.02320069999992,121.28980059999999,122.51100100000004,126.08,66439872,63043089.6,73.72250693309294,NaN,1.5,2.75,NaN,NaN,1.2221008579776966,1.0538803288600247,161.60373694680288,0.4110619853155282,1.3671022079017092,0.956040222586181,6.844961502269328,3.194705449791647,NaN,NaN,NaN,2211494653
1132756200,126.25,127.41,126.21001,127.03,NaN,NaN,113.708125,125.87184451923076,120.48935010000045,122.08860059999994,121.3662004,122.89400100000005,122.14959314356715,123.43971622861645,124.09461538461565,127.10349799230518,121.08573277692612,120.48935010000045,122.08860059999994,121.3662004,122.89400100000005,126.88333666666665,50854704,61451200,75.95831421268635,NaN,1.5,2.75,NaN,NaN,1.22052151097929,0.8275624235165464,163.6383830944749,0.4413312475286839,1.5077042819970359,1.066373034468352,6.853839273196762,2.991730176747201,NaN,NaN,NaN,2262349357
1132929000,126.98,127.22,126.81,127.13,NaN,NaN,113.59875,125.88617153846154,120.52630005000044,122.16510059999993,121.4458006,123.34550050000004,122.34490321636844,123.79117182589107,124.47153846153871,127.67313966820461,121.26993725487281,120.52630005000044,122.16510059999993,121.4458006,123.34550050000004,127.05333333333333,15270000,58800359.2,76.25634412036865,NaN,1.5,2.75,NaN,NaN,1.162627117337912,0.259692291131446,165.74543201949155,0.43382796838928095,1.608657994954953,1.1748300265656721,6.518021639037513,2.7230205820152324,NaN,NaN,NaN,2277619357
1133188200,127.25,127.27,126.03999,126.23,NaN,NaN,113.489375,125.9004985576923,120.55360005000044,122.22790059999993,121.50040059999999,123.66700050000004,122.49725995298144,124.02344117580621,124.77923076923102,127.82504689116834,121.7334146472937,120.55360005000044,122.22790059999993,121.50040059999999,123.66700050000004,126.51333,54503296,57877530.4,68.07693185127074,NaN,1.5,2.75,NaN,NaN,1.1674401803852033,0.9417004426989166,162.18151668136784,0.33823648088489344,1.597625627671789,1.2593891467868956,8.710336620033075,2.053520899021753,NaN,NaN,NaN,2223116061
1133274600,126.64999,126.98,126.09,126.09,NaN,NaN,113.38,125.91482557692308,120.58065010000044,122.27560049999992,121.5604006,123.96500050000004,122.63815171953118,124.2202563019199,125.0638461538464,127.84326789186639,122.28442441582641,120.58065010000044,122.27560049999992,121.5604006,123.96500050000004,126.38666666666666,51809504,56460761.6,66.87527108138892,NaN,1.5,2.75,NaN,NaN,1.147623024643403,0.9176196447197765,164.25724353606444,0.24017458980521722,1.5596073840434173,1.3194327942382,8.773632182404194,2.3125525549697743,NaN,NaN,NaN,2171306557
1133361000,126.16,126.52,125.28999,125.41,NaN,NaN,113.270625,125.92915259615384,120.60205010000044,122.31030049999993,121.6276006,124.21100000000004,122.74685165209858,124.33356522554658,125.22307692307717,127.82043778029688,122.62571606585746,120.60205010000044,122.31030049999993,121.6276006,124.21100000000004,125.73999666666666,56075392,55914724.8,61.222534188948956,NaN,1.5,2.75,NaN,NaN,1.153507808597445,1.0028734327241113,163.48985257384967,0.11069591906018239,1.457802693063428,1.3471067740032456,9.22827218803717,1.5547735399810871,NaN,NaN,NaN,2115231165
1133447400,126.02,127.03,125.98,126.69,NaN,NaN,113.16125,125.94347961538462,120.62945005000043,122.35460059999993,121.74320059999998,124.45800000000004,122.90148492064374,124.55798758501834,125.44846230769257,128.00708451275761,122.8898401026275,120.62945005000043,122.35460059999993,121.74320059999998,124.45800000000004,126.56666666666666,65510800,55455720.8,66.89500737837307,NaN,1.5,2.75,NaN,NaN,1.1868286794119136,1.1813172573531856,167.9275939348459,0.09314362803047938,1.463536309041345,1.3703926810108655,10.417882772305205,1.6447368421052608,NaN,NaN,NaN,2180741965
1133533800,126.77,127.08,126.5,126.85001,NaN,NaN,113.051875,125.95780663461538,120.66255010000043,122.39880079999992,121.85340079999997,124.68700050000004,123.0563290414028,124.77627543406422,125.69154000000026,128.1334999927174,123.24958000728311,120.66255010000043,122.39880079999992,121.85340079999997,124.68700050000004,126.81000333333333,46724704,53546912,67.53435766911525,NaN,1.5,2.75,NaN,NaN,1.143483773739634,0.8725938108251695,168.80102773195827,0.0749773050631608,1.4641143123398166,1.3891370072766558,9.506125343573567,1.3745784384240407,NaN,NaN,NaN,2227466669
1133793000,126.64,126.73,126.17999,126.58,NaN,NaN,112.9425,125.97213365384616,120.69350010000043,122.43550079999991,121.95620079999999,124.91050050000004,123.19451221624975,124.94805872605811,125.94846230769257,127.97152486514129,123.92539975024384,120.69350010000043,122.43550079999991,121.95620079999999,124.91050050000004,126.49666333333333,59367104,53557447.2,65.24450918334043,NaN,1.5,2.75,NaN,NaN,1.109664932758231,1.1084752374082534,166.63013714110696,0.02976466720201909,1.4263428412791797,1.3965781740771606,9.635077740094458,0.6520436269118631,NaN,NaN,NaN,2168099565
1133879400,127.05,127.74001,126.63,126.82001,NaN,NaN,112.833125,125.98646067307692,120.73460010000045,122.47530089999991,122.06100099999999,125.14000100000003,123.33668859992623,125.12633979976685,126.2046161538464,127.68932355159,124.71990875610281,120.73460010000045,122.47530089999991,122.06100099999999,125.14000100000003,127.06334,57942800,54116302.4,66.33712467410234,NaN,1.5,2.75,NaN,NaN,1.113261008989786,1.0707087777674922,168.08263708863225,0.002450489529612465,1.3996412859891763,1.3971907964595638,9.338756203056215,0.4117260490894689,NaN,NaN,NaN,2226042365
1133965800,126.78999,126.87,125.67999,126.08,NaN,NaN,112.72375,126.00078769230768,120.76775010000046,122.51260079999992,122.15160099999999,125.33250100000002,123.44426943914482,125.21716458074144,126.31538538461562,127.50147851490397,125.12929225432728,120.76775010000046,122.51260079999992,122.15160099999999,125.33250100000002,126.20999666666667,66826000,55349917.6,60.067044079989415,NaN,1.5,2.75,NaN,NaN,1.1187430797762299,1.2073369373904903,165.29065200219438,-0.07476159777506441,1.3037387992407332,1.3785003970157976,9.770999631688241,-0.747854837439977,NaN,NaN,NaN,2159216365
1134052200,126.22,126.82001,125.48,126,NaN,NaN,112.614375,126.01511471153846,120.79655005000045,122.54240079999991,122.23820099999999,125.51300100000003,123.5444941670215,125.29172033495654,126.38230846153871,127.37586637645259,125.38875054662483,120.79655005000045,122.54240079999991,122.23820099999999,125.51300100000003,126.10000333333333,62586704,55595817.6,59.413256123782965,NaN,1.5,2.75,NaN,NaN,1.134547859792213,1.1257448258122207,167.10622251756863,-0.1369104498503353,1.2073623347028786,1.3442727845532139,9.010418302289997,-0.8888539290490014,NaN,NaN,NaN,2096629661
1134138600,126.16,126.78,125.82001,126.33,NaN,NaN,112.505,126.02944173076922,120.82105010000045,122.5713007999999,122.311601,125.66250100000002,123.6537296898834,125.39060411257972,126.42615538461563,127.35413483504986,125.49817593418139,120.82105010000045,122.5713007999999,122.311601,125.66250100000002,126.31000333333333,50744704,54175884,61.285173225106334,NaN,1.5,2.75,NaN,NaN,1.1220794412356268,0.9366659157790577,168.9650816146648,-0.15988272361068012,1.1444193800398637,1.3043021036505438,9.18822865936731,0.07922047056959068,NaN,NaN,NaN,2147374365
1134397800,126.71001,126.86,125.96001,126.45,NaN,NaN,112.395625,126.04376875,120.85015010000045,122.60860079999992,122.37980119999999,125.79700150000001,123.76338734910367,125.49149895900071,126.43769384615409,127.36283777037943,125.51254992192875,120.85015010000045,122.60860079999992,122.37980119999999,125.79700150000001,126.42333666666667,48393808,54852224,61.97201655760399,NaN,1.5,2.75,NaN,NaN,1.1062159097187965,0.882257900791771,169.8956617463264,-0.17013293684294828,1.0916359325968585,1.2617688694398068,8.226371622824724,0.28551034975017797,NaN,NaN,NaN,2195768173
1134484200,126.39999,127.7,126.28999,127.31,NaN,NaN,112.28625,126.05809576923076,120.88055010000045,122.64630089999991,122.47400099999999,125.9780015,123.90247019815843,125.66468953433397,126.45923230769255,127.44929172140199,125.4691728939831,120.88055010000045,122.64630089999991,122.47400099999999,125.9780015,127.09999666666667,88650880,57030128,66.55189334426383,NaN,1.5,2.75,NaN,NaN,1.1279154875960253,1.554456970533189,170.76966911980153,-0.12425903728566356,1.1064450728327273,1.2307041101183909,8.984380782164298,1.51503069930628,NaN,NaN,NaN,2284419053
1134570600,127.19,128.09,127.14,127.81,NaN,NaN,112.176875,126.07242278846154,120.91375010000047,122.6925008999999,122.60580099999999,126.206501,124.05570666097574,125.86900481677836,126.51154000000025,127.69147248430261,125.3316075156979,120.91375010000047,122.6925008999999,122.60580099999999,126.206501,127.68,64374896,56769248,68.89723307387335,NaN,1.5,2.75,NaN,NaN,1.1152072384820237,1.1339747886038583,173.06701057848323,-0.06830356424784068,1.14532465480859,1.2136282190564307,8.119234229412198,0.8840476754282142,NaN,NaN,NaN,2348793949
1134657000,127.84,128,127.17999,127.44,NaN,NaN,112.0675,126.0867498076923,120.94485010000045,122.73350089999991,122.76200099999998,126.40400050000001,124.18842404681983,126.01862340565661,126.60461692307717,127.86891147158966,125.34032237456469,120.94485010000045,122.73350089999991,122.76200099999998,126.40400050000001,127.53999666666667,55903104,57007708,65.25105271825133,NaN,1.5,2.75,NaN,NaN,1.0941217214475931,0.9806236026889557,170.09188850513038,-0.0643281245056635,1.1332180634243514,1.1975461879300149,6.572330664643106,0.465108359076992,NaN,NaN,NaN,2292890845
1134743400,127.27,128.57001,126.36,126.36,NaN,NaN,111.958125,126.10107682692308,120.96300010000046,122.75920099999992,122.90520099999998,126.49000050000002,124.27358388812101,126.05113546226075,126.6253861538464,127.86378853182057,125.38698377587224,120.96300010000046,122.75920099999992,122.90520099999998,126.49000050000002,127.09667,46239008,56533783.2,55.94428621792249,NaN,1.5,2.75,NaN,NaN,1.173828027058479,0.8179004726504842,168.93254126572995,-0.1383050862355497,1.0246648301355776,1.1629699163711273,8.353234351218108,-0.17380312845631132,NaN,NaN,NaN,2246651837
1135002600,126.73,126.87,125.69,125.71001,NaN,NaN,111.84875,126.11540384615384,120.97760020000045,122.77060099999993,123.02720119999998,126.519001,124.32991432388097,126.01864732299782,126.64846384615409,127.80380700841314,125.49312068389503,120.97760020000045,122.77060099999993,123.02720119999998,126.519001,126.09000333333334,48819504,55352899.2,51.210207911517095,NaN,1.5,2.75,NaN,NaN,1.1742688822685883,0.8819683287700312,165.03495528584597,-0.22950564955814512,0.8760878544234458,1.105593503981591,8.754300556689314,-0.8752561997117012,NaN,NaN,NaN,2197832333
1135089000,125.86,126.59,125.48,125.83,NaN,NaN,111.739375,126.12973086538462,120.99510020000045,122.79150089999993,123.17180099999997,126.5225015,124.38874121314053,126.00068091128374,126.58231000000023,127.81636814987228,125.3482518501282,120.99510020000045,122.79150089999993,123.17180099999997,126.5225015,125.96666666666665,46604704,55182074.4,52.017417624999005,NaN,1.5,2.75,NaN,NaN,1.1696782478208319,0.8445623783943867,165.69208402651873,-0.27705933386539217,0.7592693366498509,1.036328670515243,8.669172682171943,-0.19828680203045684,NaN,NaN,NaN,2244437037
1135175400,126.17,126.75999,125.8,126.03,NaN,NaN,111.63,126.14405788461538,121.02040020000044,122.81530099999995,123.32380119999998,126.5090015,124.4531043028213,126.0034732054472,126.51923230769255,127.77573320472051,125.26273141066459,121.02040020000044,122.81530099999995,123.32380119999998,126.5090015,126.19666333333333,51801200,54450140.8,53.40130513816725,NaN,1.5,2.75,NaN,NaN,1.1547005158336299,0.9513510752941892,168.48304688621616,-0.2890256317289843,0.6750466308540126,0.9640722625829969,8.112373945375003,0.02380952380952471,NaN,NaN,NaN,2296238237
1135261800,126.31,126.69,126.08,126.69,NaN,NaN,111.520625,126.15838490384616,121.04765015000042,122.83830099999996,123.50760119999997,126.49200149999999,124.54082570271066,126.06885670969032,126.5276938461541,127.78719561111558,125.26819208119261,121.04765015000042,122.83830099999996,123.50760119999997,126.49200149999999,126.48666666666666,32250496,53519930.4,57.733537094296786,NaN,1.5,2.75,NaN,NaN,1.1193647647026561,0.6025885265351542,171.11681013692026,-0.24804427886984537,0.6540169139956902,0.9020611928655355,8.633567427315725,0.28496794110662504,NaN,NaN,NaN,2328488733
1135348200,126.78999,126.86,126.42,126.75999,NaN,NaN,111.41125,126.17271192307692,121.07950010000042,122.85870089999997,123.69420119999997,126.47350099999998,124.62785175358475,126.13467892781506,126.52307692307718,127.77869272949381,125.26746111666056,121.07950010000042,122.85870089999997,123.69420119999997,126.47350099999998,126.67999666666665,27977296,54155295.2,58.17757890023759,NaN,1.5,2.75,NaN,NaN,1.0708387100810377,0.5166123810548446,173.6267902165225,-0.213112391282815,0.6356707037620168,0.8487830950448318,8.533456349207267,0.2451482799525497,NaN,NaN,NaN,2356466029
1135693800,126.92,127.05,125.38,125.47,NaN,NaN,111.301875,126.1870389423077,121.10115010000044,122.87620089999997,123.83020119999998,126.43550099999997,124.6608771750128,126.07137617278505,126.47615384615412,127.83577898595625,125.11652870635199,121.10115010000044,122.87620089999997,123.83020119999998,126.43550099999997,125.96666666666667,44500704,53655165.6,48.13923302728799,NaN,1.5,2.75,NaN,NaN,1.1136359450752493,0.8293834060965045,169.85034500156988,-0.27010839879105375,0.5111475965560146,0.7812559953470684,10.435130511163056,-1.4452910219150132,NaN,NaN,NaN,2311965325
1135780200,125.73,125.99001,125.5,125.75,NaN,NaN,111.1925,126.20136596153846,121.12920010000043,122.90490089999997,123.96300119999998,126.41850099999996,124.70358787403191,126.0407689182341,126.45692307692335,127.84961343660406,125.06423271724263,121.12920010000043,122.90490089999997,123.96300119999998,126.41850099999996,125.74666999999998,30764304,52602905.6,50.149850033914525,NaN,1.5,2.75,NaN,NaN,1.0712340918555887,0.5848403933032931,172.4531603786806,-0.28092647941546267,0.43009789607773996,0.7110243754932026,9.518283300503494,-1.611767467334326,NaN,NaN,NaN,2342729629
1135866600,125.72,125.96001,125.06,125.19,NaN,NaN,111.083125,126.21569298076923,121.15955010000043,122.93030099999999,124.11040099999997,126.40750099999998,124.722662859364,125.9597433069737,126.36923076923105,127.9176961443108,124.82076539415131,121.15955010000043,122.93030099999999,124.11040099999997,126.40750099999998,125.40333666666668,33033600,51450816,46.28489555281761,NaN,1.5,2.75,NaN,NaN,1.059003799580189,0.6420422953058703,171.66920672358782,-0.31520057775649646,0.3170236532975821,0.6322242310540785,9.063704772661742,-1.765536723163842,NaN,NaN,NaN,2309696029
1135953000,124.8,125.06,124.36,124.50999,NaN,NaN,124.36,126.23002,121.18530005000042,122.9415009,124.20500079999997,126.29850049999997,124.71432274723207,125.8216715634524,126.2199992307695,128.05583173530698,124.38416672623202,121.18530005000042,122.9415009,124.20500079999997,126.29850049999997,124.64333,44646096,50407580.8,42.04725293282589,NaN,1.5,2.75,NaN,NaN,1.0426463853244612,0.8857020172648318,169.46641923332174,-0.3693201006729713,0.17057410521286442,0.5398942058858357,9.264031262125926,-1.4640788224121537,NaN,NaN,NaN,2265049933
1136298600,125.10001,127,124.39,126.7,NaN,NaN,124.49851851851852,126.24434701923076,121.22610010000042,122.9752009,124.38560079999996,126.29099999999997,124.79219244341905,125.90532189074264,126.17307615384644,127.92430334421205,124.42184896348083,121.22610010000042,122.9752009,124.38560079999996,126.29099999999997,126.02999999999999,73388816,51740786.4,56.01448143472097,NaN,1.5,2.75,NaN,NaN,1.1546002149441426,1.4183939036535402,174.04899492827758,-0.24904158969883872,0.2285922187622873,0.477633808461126,13.778061120695552,0.7875188300438493,NaN,NaN,NaN,2338438749
1136385000,126.86,127.49001,126.7,127.3,NaN,NaN,124.63703703703703,126.25867403846154,121.27210005000043,123.0100008,124.56900079999996,126.32699999999997,124.89053783779478,126.03814837733859,126.13384538461567,127.75462574457754,124.5130650246538,121.27210005000043,123.0100008,124.56900079999996,126.32699999999997,127.16333666666667,52243200,51384591.2,58.934610162734344,NaN,1.5,2.75,NaN,NaN,1.1285580567338462,1.0167094605590634,177.7309974889968,-0.1266620755173829,0.3193062140643974,0.4459682895817803,13.5192978591081,1.168242867360724,NaN,NaN,NaN,2390681949
1136471400,127.17,127.59,126.88,127.38,NaN,NaN,124.77555555555556,126.2730010576923,121.32450010000042,123.0532008,124.71740059999996,126.35499949999999,124.98816380494009,126.16594376997301,126.12923000000029,127.73538198941736,124.52307801058322,121.32450010000042,123.0532008,124.71740059999996,126.35499949999999,127.28333333333335,47310496,50852976,59.32237753325892,NaN,1.5,2.75,NaN,NaN,1.0986610526814293,0.9303387868588064,179.2817269640381,-0.04227752627868625,0.3931213817334225,0.43539890801210873,13.523250682018242,1.0711735301118737,NaN,NaN,NaN,2437992445
1136557800,128.03999,128.58,127.36,128.44,NaN,NaN,124.91407407407408,126.28732807692307,121.38170010000042,123.0994007,124.89180059999995,126.47299949999999,125.12352993023656,126.3825205537851,126.2892300000003,128.31504090260754,124.26341909739308,121.38170010000042,123.0994007,124.89180059999995,126.47299949999999,128.12666666666667,62892608,50656306.4,64.15246671965191,NaN,1.5,2.75,NaN,NaN,1.1073281203470424,1.2415553456143815,182.95936207372478,0.07650660708428247,0.5310321668674618,0.4545255597831793,14.12088901688228,1.381324492856579,NaN,NaN,NaN,2500885053
1136817000,128.42,129.06,128.38,128.77,NaN,NaN,125.05259259259259,126.30165509615384,121.43985010000043,123.1650006,125.07980059999996,126.6114995,125.26652875650178,126.60989954866271,126.52461384615414,128.9063493905856,124.14287830172266,121.43985010000043,123.1650006,125.07980059999996,126.6114995,128.73666666666668,43532704,49703606.4,65.52492018160311,NaN,1.5,2.75,NaN,NaN,1.076804683179397,0.8758459828782162,186.35364060686896,0.16386360417316076,0.6593550649996303,0.4954914608264695,13.973600957759363,1.585681728122579,NaN,NaN,NaN,2544417757
1136903400,128.39,128.98,128.25999,128.89999,NaN,NaN,125.19111111111111,126.31598211538461,121.49780005000042,123.2320005,125.29580019999996,126.73999899999998,125.4090174327174,126.82800340117102,126.76076692307721,129.41355034107596,124.10798350507847,121.49780005000042,123.2320005,125.29580019999996,126.73999899999998,128.71332666666666,44961392,49414440.8,66.07588961444404,NaN,1.5,2.75,NaN,NaN,1.051319348666583,0.9098836549011398,188.00065113451015,0.21380563371196948,0.7627485029664314,0.5489428692544619,13.963211322717479,2.7337132382242797,NaN,NaN,NaN,2589379149
1136989800,129.02,129.44,128.73,129.31,NaN,NaN,125.32962962962964,129.44,121.56170005000044,123.30320049999999,125.48600019999996,126.882999,125.5619971412383,127.06438402963092,127.01307461538491,129.94869638456427,124.07745284620555,121.56170005000044,123.30320049999999,125.48600019999996,126.882999,129.16,49603904,49474945.6,67.8226818710192,NaN,1.5,2.75,NaN,NaN,1.0269393951903991,1.002606539500672,188.92473586237315,0.2550615586596099,0.8677698175789743,0.6127082589193644,11.727020931679045,2.831013916500996,NaN,NaN,NaN,2638983053
1137076200,129.08,129.28,128.44,128.8,NaN,NaN,125.46814814814815,129.48234225225224,121.61480010000042,123.36650049999999,125.65940019999996,126.95749900000001,125.68897764550346,127.22968078871368,127.17538230769259,130.25156126619265,124.0992033491925,121.61480010000042,123.36650049999999,125.65940019999996,126.95749900000001,128.84,40509296,47067866.4,63.44644808465223,NaN,1.5,2.75,NaN,NaN,1.0157294383910853,0.860657155260388,186.3648156508506,0.22941627199466352,0.8994785989126939,0.6700623269180304,12.394237072342614,2.883616902308502,NaN,NaN,NaN,2598473757
1137162600,128.57001,128.89999,128.2,128.67999,NaN,NaN,125.60666666666667,129.5246845045045,121.66840000000043,123.4286004,125.82319979999994,127.00099850000001,125.80627224764058,127.36780547550285,127.32307461538491,130.48837078614272,124.15777844462708,121.66840000000043,123.4286004,125.82319979999994,127.00099850000001,128.59332666666668,44858896,46092066.4,62.425694574286695,NaN,1.5,2.75,NaN,NaN,0.9931766213631515,0.9732454954547233,187.7341220446135,0.18754833490882972,0.9044977455540675,0.7169494106452378,11.833465391719267,3.3491288530342036,NaN,NaN,NaN,2553614861
1137508200,128.2,128.42,127.81,128.33,NaN,NaN,125.74518518518518,129.56702675675675,121.72290005000045,123.4895003,125.95479979999995,127.04549850000001,125.90524196341939,127.45944304926448,127.5430746153849,130.5565258802229,124.5296233505469,121.72290005000045,123.4895003,125.95479979999995,127.04549850000001,128.1866666666667,52181600,45905991.2,59.42313250811441,NaN,1.5,2.75,NaN,NaN,0.9843775769800693,1.1367056594564937,184.61225853926422,0.12260289435249994,0.8702030285858626,0.7476001342333627,11.232716967145286,1.2865035516969294,NaN,NaN,NaN,2501433261
1137594600,127.58,128.89999,127.16,127.82001,NaN,NaN,125.8837037037037,129.60936900900901,121.77385010000043,123.55620049999999,126.06579999999994,127.118499,125.98033090603039,127.49378275885834,127.70230615384642,130.5331719339974,124.87144037369542,121.77385010000043,123.55620049999999,126.06579999999994,127.118499,127.96,75066496,47347365.6,55.2527738728121,NaN,1.5,2.75,NaN,NaN,1.0383498929100647,1.585441873032108,183.03881386106934,0.03610720601054973,0.7927341417465499,0.7566269357360002,7.176277541635771,0.40849175176747776,NaN,NaN,NaN,2426366765
1137681000,128.09,128.77,127.81,128.31,NaN,NaN,126.02222222222223,129.65171126126126,121.82445010000045,123.62340049999999,126.18979999999996,127.24849850000001,126.07169047834292,127.57151773420517,127.94230615384642,130.3825875412818,125.50202476641104,121.82445010000045,123.62340049999999,126.18979999999996,127.24849850000001,128.29666666666668,78049184,48808849.6,58.28212933003086,NaN,1.5,2.75,NaN,NaN,1.032753471987918,1.5990785408718176,186.7525271869289,0.004372578602642396,0.7620926589893031,0.7577200803866607,7.017340886357425,0.7300989166274194,NaN,NaN,NaN,2504415949
1137767400,128.28,128.31,125.97,125.97,NaN,NaN,126.16074074074074,129.69405351351352,121.86130005000047,123.67550059999998,126.26459999999997,127.2554985,126.06770261644712,127.41899223570944,128.05461461538488,129.91917387200073,126.19005535876903,121.86130005000047,123.67550059999998,126.26459999999997,127.2554985,126.75,115312000,52244214.4,43.23039242277752,NaN,1.5,2.75,NaN,NaN,1.126128223988781,2.207172628094873,183.351365439148,-0.17198861152063416,0.542734315985868,0.7147229275065021,13.05770132836656,-1.9230769230769222,NaN,NaN,NaN,2389103949
1138026600,126.21001,126.82001,126.13,126.42,NaN,NaN,126.29925925925926,129.73639576576576,121.89720000000045,123.72280059999997,126.34839999999998,127.2749985,126.08151820011587,127.32385011802283,128.03307615384642,129.96498174040732,126.10117056728551,121.89720000000045,123.72280059999997,126.34839999999998,127.2749985,126.45666999999999,67094816,53008895.2,46.11256549345364,NaN,1.5,2.75,NaN,NaN,1.106405493703868,1.2657274924680941,186.04923145002738,-0.2513105053757856,0.4005847957867701,0.6518953011625557,12.05935595800876,-1.824959229634238,NaN,NaN,NaN,2456198765
1138113000,126.63,127.14999,126.42,126.55,NaN,NaN,126.43777777777778,129.778738018018,121.93995000000045,123.77780059999998,126.43159999999997,127.2679985,126.09989003540544,127.25015010678256,127.97538384615412,130.03216904379497,125.91859864851327,121.93995000000045,123.77780059999998,126.43159999999997,127.2679985,126.70666333333332,53013904,54047065.6,46.95048272602679,NaN,1.5,2.75,NaN,NaN,1.0795186727250203,0.9808840389662153,189.5007591521125,-0.28550072848958175,0.29501939055057846,0.5805201190401602,11.897224830338912,-1.8231110801482648,NaN,NaN,NaN,2509212669
1138199400,127.03999,127.17999,125.84,126.66,NaN,NaN,126.57629629629629,129.82108027027027,121.98280000000044,123.81860059999997,126.49799999999998,127.262999,126.1218551320562,127.19394533470803,127.91999923076949,130.07439103859582,125.76560742294318,121.98280000000044,123.81860059999997,126.49799999999998,127.262999,126.55999666666666,87790624,57037732,47.69165406629977,NaN,1.5,2.75,NaN,NaN,1.098123767530376,1.539167511078456,187.85800836852226,-0.29023662610142176,0.21772433641338296,0.5079609625148047,11.885677085555335,-2.0493387982368,NaN,NaN,NaN,2597003293
1138285800,127.28,127.67,126.75999,127.36,NaN,NaN,126.71481481481482,129.8634225225225,122.02610000000044,123.86730049999998,126.57000019999998,127.357499,126.17040983275987,127.20976006473585,127.83692230769256,129.98798919589206,125.68585541949305,122.02610000000044,123.86730049999998,126.57000019999998,127.357499,127.26333000000001,71360816,58380737.6,52.26240690613845,NaN,1.5,2.75,NaN,NaN,1.0918292127067781,1.222334950423785,190.6904964101117,-0.23794892990308958,0.21052480013594277,0.44847373003903235,12.30710830830681,-1.1180124223602577,NaN,NaN,NaN,2668364109
1138372200,127.66,128.66,127.45,128.53999,NaN,NaN,126.85333333333334,129.90576477477478,122.08229995000045,123.93000039999997,126.66699999999999,127.49699850000002,126.26333454520066,127.3364486299991,127.81922923076948,129.9429153641323,125.69554309740668,122.08229995000045,123.93000039999997,126.66699999999999,127.49699850000002,128.21666333333334,65790880,60132066.4,58.79819500277709,NaN,1.5,2.75,NaN,NaN,1.1066985546562937,1.094106421727759,193.3160662570738,-0.12148678307196875,0.2966152511990714,0.41810203427104015,13.60466319822115,-0.10879702430814206,NaN,NaN,NaN,2734154989
1138631400,128.44,128.81,128.35001,128.44,NaN,NaN,126.99185185185185,129.94810702702702,122.14564995000045,123.97740039999996,126.77099979999997,127.65949850000001,126.34869397480064,127.44154876047537,127.78384538461566,129.84884122142455,125.71884954780677,122.14564995000045,123.97740039999996,126.77099979999997,127.65949850000001,128.53333666666666,33710192,60165896,58.072637362655314,NaN,1.5,2.75,NaN,NaN,1.0605050864665588,0.5602873760909336,192.19025905312407,-0.052314912411835945,0.3527083937562452,0.40502330616808113,13.601932720493533,0.08571651211718632,NaN,NaN,NaN,2700444797
1138717800,128.32001,128.53999,127.49001,127.5,NaN,NaN,127.13037037037037,129.9904492792793,122.21240000000043,124.01330039999998,126.85119959999996,127.80899900000001,126.3938432306908,127.447115545192,127.64461461538488,129.5140520436846,125.77517718708516,122.21240000000043,124.01330039999998,126.85119959999996,127.80899900000001,127.84333333333332,73131184,61590150.4,51.62337178870655,NaN,1.5,2.75,NaN,NaN,1.0597532945760897,1.1873844035945071,193.608530625452,-0.06989801396776307,0.31765078870837726,0.38754880267614034,14.162966524461114,-0.25035986149586154,NaN,NaN,NaN,2627313613
1138804200,127.82001,128.42999,127.72,128.39,NaN,NaN,127.2688888888889,130.03279153153153,122.28185000000043,124.06220039999997,126.92619959999996,127.89349900000002,126.47212388831078,127.53691406469753,127.61307615384642,129.41613690071458,125.81001540697827,122.28185000000043,124.06220039999997,126.92619959999996,127.89349900000002,128.17999666666665,63562896,61098854.4,56.54415005864373,NaN,1.5,2.75,NaN,NaN,1.050484487820655,1.0403287692412118,194.79643260419903,-0.023990079648289142,0.3575612031157789,0.381551282764068,14.604037599335625,0.06234899851919888,NaN,NaN,NaN,2690876509
1138890600,128.10001,128.14,126.8,126.89999,NaN,NaN,127.4074074074074,130.07513378378377,122.33929995000044,124.08520019999996,126.96159939999995,127.87349850000001,126.48890295151428,127.47625462996443,127.47615307692334,129.20307161455628,125.7492345392904,122.33929995000044,124.08520019999996,126.96159939999995,127.87349850000001,127.27999666666666,83628624,62668125.6,47.78139135928629,NaN,1.5,2.75,NaN,NaN,1.0890213101191788,1.3344682515923214,191.30432647826225,-0.09252576366261839,0.265894078185795,0.3584198418484134,15.935396762936605,0.7382630785107595,NaN,NaN,NaN,2607247885
1138977000,126.58,128.39,126.14,126.27,NaN,NaN,127.54592592592593,130.11747603603604,122.40164995000045,124.10440009999996,126.97179959999998,127.8179985,126.48031852204313,127.36137323663448,127.31769153846182,129.07982527331868,125.55555780360497,122.40164995000045,124.10440009999996,126.97179959999998,127.8179985,126.93333333333331,86042496,64604725.6,44.63198614659815,NaN,1.5,2.75,NaN,NaN,1.1719483593963793,1.3318297570479891,188.84367727113258,-0.17410438453349336,0.14078936118154672,0.3148937457150401,11.9825002308034,-0.11865211200759823,NaN,NaN,NaN,2521205389
1139236200,126.44,126.8,126.17,126.60001,NaN,NaN,127.68444444444445,130.15981828828828,122.45460005000045,124.13380019999997,126.97779979999997,127.725999,126.48501230549242,127.2888624521931,127.22384538461567,128.99887521054703,125.4488155586843,122.45460005000045,124.13380019999997,126.97779979999997,127.725999,126.52333666666668,45513392,63735764.8,46.61694408777074,NaN,1.5,2.75,NaN,NaN,1.1332377622966376,0.7140950162411795,191.35163561856655,-0.19791980305902868,0.06749399189125427,0.26541379495028294,11.897828815392389,0.039517977084156726,NaN,NaN,NaN,2566718781
1139322600,126.38,126.66,125.39999,125.48,NaN,NaN,127.82296296296296,130.20216054054055,122.50415000000045,124.15650009999996,126.94679979999997,127.561499,126.4456000582182,127.11658983769853,127.00615307692337,128.88601158351776,125.12629457032898,122.50415000000045,124.15650009999996,126.94679979999997,127.561499,125.84666333333331,71227632,65120511.2,41.21635175571046,NaN,1.5,2.75,NaN,NaN,1.1422929221325917,1.0937818313686702,188.11219494097813,-0.2763677114441342,-0.08004584435488482,0.19632186708924937,12.939750720289512,-0.9316279804200163,NaN,NaN,NaN,2495491149
1139409000,125.88,128.10001,125.60001,126.62,NaN,NaN,127.96148148148148,130.2445027927928,122.55560000000042,124.19120019999997,126.93659979999997,127.4474995,126.45243927162142,127.06929556744153,127.05615307692337,128.85598828439268,125.25631786945407,122.55560000000042,124.19120019999997,126.93659979999997,127.4474995,126.77334,59426304,65843756.8,47.8400751269472,NaN,1.5,2.75,NaN,NaN,1.2478441419802633,0.9025351360267463,190.08422153534465,-0.2400873807570604,-0.10378735885707613,0.13630002189998427,14.129577941223388,-0.5810301507537649,NaN,NaN,NaN,2554917453
1139495400,126.92,127.60001,126.37,126.41,NaN,NaN,128.1,130.28684504504506,122.61165000000042,124.22030019999997,126.94019979999997,127.3024995,126.45077498645979,127.00650551339947,127.05538384615413,128.85631415146037,125.2544535408479,122.61165000000042,124.22030019999997,126.94019979999997,127.3024995,126.79333666666666,62024304,66464776.8,46.79406579558159,NaN,1.5,2.75,NaN,NaN,1.2465702746959584,0.9331905858442603,191.04003545390495,-0.21940612580832514,-0.13795763536042216,0.08144849044790299,13.693836176057353,-1.6570640778795707,NaN,NaN,NaN,2492893149
1139581800,126.42999,127.13,125.45,126.64,NaN,NaN,128.23851851851853,130.3291872972973,122.66660005000041,124.25580019999995,126.95119979999998,127.19449949999998,126.45819557522607,126.97160022640905,127.06230692307722,128.8560906520567,125.26852319409774,122.66660005000041,124.25580019999995,126.95119979999998,127.19449949999998,126.40666666666665,64509696,67664796.8,48.13170474139441,NaN,1.5,2.75,NaN,NaN,1.2775295407891036,0.9533716060756722,191.45526285317365,-0.18100637186484386,-0.14480947438315184,0.036196897481692025,12.314027355045823,-1.4014325755216421,NaN,NaN,NaN,2557402845
1139841000,126.57001,126.78999,125.95,126.41,NaN,NaN,128.37703703703704,130.37152954954954,122.7276500500004,124.29940019999997,126.97119979999998,127.08099999999997,126.45630555266818,126.91811449056057,127.04307615384644,128.85892441799595,125.22722788969695,122.7276500500004,124.29940019999997,126.97119979999998,127.08099999999997,126.38333,52309200,68037312,46.862906022633204,NaN,1.5,2.75,NaN,NaN,1.2462767164470248,0.7688310790408651,188.41799434347615,-0.16245755979095197,-0.16687505225699795,-0.004417492466045975,12.306532608719468,-0.8549019607843164,NaN,NaN,NaN,2505093645
1139927400,126.46001,128.03,123.64,127.75,NaN,NaN,123.64,130.4138718018018,122.78765005000041,124.36780019999996,126.99239979999999,127.05199999999998,126.50703866824982,126.99734168193575,127.07307615384646,128.92147184781786,125.22468045987507,122.78765005000041,124.36780019999996,126.99239979999999,127.05199999999998,126.47333333333334,90992496,69977856.8,54.404231324645956,NaN,1.5,2.75,NaN,NaN,1.4708283795579518,1.300304127062091,191.23238452239733,-0.05675928704935192,-0.07536660127773587,-0.018607314228383954,13.470880042583657,-0.49848119012383085,NaN,NaN,NaN,2596086141
1140013800,127.66,128.32001,127.24001,128.2,NaN,NaN,123.616,130.45621405405404,122.8466501000004,124.43640019999997,127.01939959999999,127.07099949999997,126.57342930871062,127.11188056937044,127.04692307692338,128.819628173937,125.27421797990975,122.8466501000004,124.43640019999997,127.01939959999999,127.07099949999997,127.92000666666668,85473504,70498207.2,56.63025189795037,NaN,1.5,2.75,NaN,NaN,1.4429120667323836,1.2124209592666066,193.63081635330784,0.04135334625660286,0.03308436859236963,-0.008268977664233238,12.975979993953587,1.0244366449516553,NaN,NaN,NaN,2681559645
1140100200,128.34,129.21001,128.17999,129.16,NaN,NaN,123.592,130.4985563063063,122.90945005000042,124.51360019999997,127.07099959999998,127.11349949999996,126.67486345346707,127.30693956276373,127.102307692308,129.0789112103379,125.12570417427811,122.90945005000042,124.51360019999997,127.07099959999998,127.11349949999996,128.85,61035392,69647517.6,61.00412975973908,NaN,1.5,2.75,NaN,NaN,1.4134197762514995,0.8763469841170621,197.24585344173238,0.162020977267187,0.19425724391975052,0.03223626665256352,11.298709666846555,2.288746337213907,NaN,NaN,NaN,2742595037
1140186600,129.09,129.16,128.58,128.81,NaN,NaN,123.568,130.54089855855855,122.96600005000042,124.58590019999995,127.11079939999998,127.25549949999997,126.75859429842914,127.45008817583386,127.20307692307723,129.37447639546312,125.03167745069136,122.96600005000042,124.58590019999995,127.11079939999998,127.25549949999997,128.85,40344400,65899137.6,58.680561129825655,NaN,1.5,2.75,NaN,NaN,1.3538897922335342,0.6122143850331662,199.28368998517195,0.20652962908293143,0.2903983030062278,0.08386867392329639,10.872173185220646,1.7456475714338449,NaN,NaN,NaN,2702250637
1140532200,129.12,129.39999,128.28999,128.49001,NaN,NaN,123.544,130.58324081081082,123.02115005000043,124.65530029999996,127.15899959999999,127.35899999999997,126.8264929533927,127.54912834956397,127.21077000000031,129.39957451336028,125.02196548664034,123.02115005000043,124.65530029999996,127.15899959999999,127.35899999999997,128.72666333333333,46461808,64867487.2,56.55949204422059,NaN,1.5,2.75,NaN,NaN,1.3364690927882827,0.7162572500573138,198.13455430105418,0.20241453639855123,0.3368868444214854,0.1344723080229342,11.15518620168292,2.3987966209754608,NaN,NaN,NaN,2655788829
1140618600,128.77,129.64999,128.64999,129.27,NaN,NaN,123.52,130.62558306306306,123.08205005000043,124.73130029999997,127.2243996,127.49499999999996,126.922316759142,127.71302088770074,127.39307846153878,129.82884294428376,124.95731397879379,123.08205005000043,124.73130029999997,127.2243996,127.49499999999996,129.18999333333332,42338400,64333712,60.32413878714966,NaN,1.5,2.75,NaN,NaN,1.3238627290176905,0.6581059709410207,201.30611914027972,0.23777555279180101,0.4316917490126855,0.19391619622088446,9.20220374696864,2.092876322855793,NaN,NaN,NaN,2698127229
1140705000,129.27,129.64,128.28,129.08,NaN,NaN,123.496,130.6679253153153,123.13835000000044,124.79550029999997,127.27939959999999,127.61599999999996,127.00693178819526,127.84320937458638,127.60923230769262,130.10594335893487,125.11252125645036,123.13835000000044,124.79550029999997,127.27939959999999,127.61599999999996,129,43450192,62116690.4,58.983206151590984,NaN,1.5,2.75,NaN,NaN,1.326443962659283,0.6994930302983432,199.4293607055785,0.23358131235657864,0.48589283666660776,0.2523115243100291,8.62672368058422,2.1121746697255093,NaN,NaN,NaN,2654677037
1140791400,129.11,129.48,128.75999,129.41,NaN,NaN,123.472,130.71026756756757,123.20239995000045,124.85920039999998,127.3385996,127.71849999999995,127.10116975728565,127.99242752938768,127.82538538461571,130.41981351898178,125.23095725024966,123.20239995000045,124.85920039999998,127.3385996,127.71849999999995,129.21666333333334,36782704,60387784.8,60.62051599869403,NaN,1.5,2.75,NaN,NaN,1.283127251040763,0.6091083506676337,201.66314581573732,0.23746727839388893,0.5491456223023903,0.31167834390850135,8.320353272097362,2.1873025900189482,NaN,NaN,NaN,2691459741
1141050600,129.39999,130.03999,129.28,129.46001,NaN,NaN,123.44800000000001,130.7526098198198,123.26349995000044,124.92780039999998,127.38159979999999,127.76450099999992,127.19367329621562,128.13219728849361,128.13154000000034,130.47370224685017,125.7893777531505,123.26349995000044,124.92780039999998,127.38159979999999,127.76450099999992,129.59333333333333,35880096,58892245.6,60.875402388372514,NaN,1.5,2.75,NaN,NaN,1.2457603045378505,0.6092499213512754,203.47247834750874,0.2278045088931968,0.5964339800249974,0.36862947113180056,8.393616662081396,2.4127917095166636,NaN,NaN,NaN,2727339837
1141137000,129.2,129.91,128.13,128.23,NaN,NaN,123.424,130.79495207207208,123.32489995000043,124.99790039999998,127.38999979999997,127.75400099999993,127.23431355910913,128.1415118324466,128.25538615384647,130.4289441629539,126.08182814473905,123.32489995000043,124.99790039999998,127.38999979999997,127.75400099999993,128.75666666666666,74397008,60926586.4,51.966283507941604,NaN,1.5,2.75,NaN,NaN,1.2839202827851468,1.2210926689961412,199.84488682008245,0.12794909418832673,0.528565838867209,0.40061674467888225,10.6186890552286,0.37573385518590197,NaN,NaN,NaN,2652942829
1141223400,128.60001,129.49001,128.5,129.37,NaN,NaN,123.4,130.83729432432432,123.39314995000042,125.0953004,127.42859979999997,127.84750099999992,127.31806596855583,128.25851070554694,128.48307846153878,130.4455805222937,126.52057640078387,123.39314995000042,125.0953004,127.42859979999997,127.84750099999992,129.12000333333333,48646304,59702342.4,58.08847937279067,NaN,1.5,2.75,NaN,NaN,1.2822124054433524,0.8148139929598475,203.35548852411046,0.1277541421908518,0.560309422417447,0.4325552802265952,10.12073217286918,0.9126365054602309,NaN,NaN,NaN,2701589133
1141309800,128.89999,129.42,128.61,129.36,NaN,NaN,123.376,130.8796365765766,123.45594995000043,125.19690039999999,127.48859979999997,127.89600099999993,127.39814181292618,128.3634144478758,128.69230923076952,130.38573925721906,126.99887920432,123.45594995000043,125.19690039999999,127.48859979999997,127.89600099999993,129.13,60644496,59556422.4,58.01862263903724,NaN,1.5,2.75,NaN,NaN,1.2484829479116826,1.0182696266188078,201.78704980997463,0.11635316625785164,0.5779967380489097,0.4616435717910581,10.037566914774748,0.1548467017652656,NaN,NaN,NaN,2640944637
1141396200,128.66,130.07001,128.64999,128.75999,NaN,NaN,123.352,130.92197882882883,123.51184990000041,125.28840029999999,127.54959939999998,127.98900099999994,127.45154762418397,128.4011835480781,128.873077692308,129.93874949368197,127.807405890934,123.51184990000041,125.28840029999999,127.54959939999998,127.98900099999994,129.15999666666667,73429808,59046481.6,53.835235498249645,NaN,1.5,2.75,NaN,NaN,1.2607355944894192,1.2435932846505116,199.55579576266044,0.06060787738567763,0.5374034185231551,0.47679554113747746,9.53610019865073,-0.038824625417292556,NaN,NaN,NaN,2567514829
1141655400,129.14,129.17999,127.85001,128.17,NaN,NaN,123.328,130.96432108108107,123.5587499500004,125.38410019999999,127.59639939999997,128.08400099999994,127.47972222715715,128.37916606730877,128.90538538461567,129.85168648639305,127.95908428283828,123.5587499500004,125.38410019999999,127.59639939999997,128.08400099999994,128.39999999999998,57479104,57618312,50.016294067396785,NaN,1.5,2.75,NaN,NaN,1.265681623454461,0.9975839625430193,195.63543471178377,-0.01950799220808247,0.45241055087737436,0.47191854308545683,9.76698270751719,-0.24905438173755667,NaN,NaN,NaN,2510035725
1141741800,127.92,128.06,127.39999,127.97,NaN,NaN,123.304,131.00666333333334,123.6021500000004,125.47950029999998,127.63519939999998,128.15250049999992,127.49894880648432,128.34019787042223,128.88769307692337,129.89285465071666,127.88253150313007,123.6021500000004,125.47950029999998,127.63519939999998,128.15250049999992,127.80999666666666,61784704,58431877.6,48.753727642884336,NaN,1.5,2.75,NaN,NaN,1.230276507493427,1.0573800900760375,191.74069286096656,-0.08576635001968974,0.36471060556084467,0.4504769555805344,9.712428775864792,-1.0056470952270529,NaN,NaN,NaN,2448251021
1141828200,127.7,128.44,127.17999,128.24001,NaN,NaN,127.17999,131.04900558558558,123.64775005000041,125.58690039999998,127.6661996,128.29050099999992,127.52801002975944,128.33065616847725,128.8169246153849,129.86409998774405,127.76974924302573,123.64775005000041,125.58690039999998,127.6661996,128.29050099999992,127.95333333333333,66705120,58205752,50.5679313420806,NaN,1.5,2.75,NaN,NaN,1.232400328386753,1.1460228191880417,190.58763368878786,-0.10967529627623135,0.31338283523524524,0.4230581315114766,8.991559206093333,-0.6507514719553766,NaN,NaN,NaN,2514956141
1141914600,128.33,128.67999,127.38,127.38,NaN,NaN,127.41598933333334,131.09134783783784,123.68575005000042,125.68640049999996,127.67859980000001,128.32850099999993,127.52220571486691,128.24011748576513,128.7069246153849,130.00441061607654,127.40943861469327,123.68575005000042,125.68640049999996,127.67859980000001,128.32850099999993,127.81333,56523600,58060616.8,45.092296734528645,NaN,1.5,2.75,NaN,NaN,1.2372281620734142,0.9735273773391949,189.05902855227734,-0.17765236962608955,0.20099266947886463,0.3786450391049542,9.617956113569964,-1.5686577544239249,NaN,NaN,NaN,2458432541
1142001000,127.72,128.84,127.44,128.59,NaN,NaN,127.65198866666667,131.13369009009008,123.73120005000042,125.78560049999996,127.74099980000001,128.43750099999994,127.5640800005584,128.27343962997796,128.71461615384644,130.0080466057082,127.42118570198468,123.73120005000042,125.78560049999996,127.74099980000001,128.43750099999994,128.29,60491104,57983956.8,52.831218892365634,NaN,1.5,2.75,NaN,NaN,1.253140436211028,1.043238635966975,192.4711916701334,-0.13717891281976452,0.20717139808024854,0.34435031090001306,11.300053566363419,-0.6720299187370739,NaN,NaN,NaN,2518923645
1142260200,128.84,129.16,128.53,128.83,NaN,NaN,127.887988,131.17603234234235,123.77830005000044,125.88280049999996,127.80259980000001,128.54700099999997,127.61372392210514,128.32644537950387,128.68077000000028,129.93678292161627,127.42475707838429,123.77830005000044,125.88280049999996,127.80259980000001,128.54700099999997,128.84,45713296,57044136.8,54.20979375371526,NaN,1.5,2.75,NaN,NaN,1.2086304050530974,0.8013671266562141,193.61435315558424,-0.09244292564485568,0.22879665384394343,0.3212395794887991,11.38033464122263,0.4679092256102494,NaN,NaN,NaN,2564636941
1142346600,128.71001,130.23,128.61,130.17999,NaN,NaN,128.12398733333333,131.2183745945946,123.82895000000045,126.00640029999997,127.90239960000001,128.73550049999997,127.71436180751277,128.50297343859873,128.7653846153849,130.2457482170081,127.2850210137617,123.82895000000045,126.00640029999997,127.90239960000001,128.73550049999997,129.67333,69879184,57922636,61.09726540718499,NaN,1.5,2.75,NaN,NaN,1.238013947549303,1.2064227187450516,197.22824869417627,0.02366726340351688,0.3508236587431952,0.32715639533967833,11.33425303069287,0.6261034242869282,NaN,NaN,NaN,2634516125
1142433000,130.14999,130.86,129.85001,130.75999,NaN,NaN,128.35998666666666,131.26071684684683,123.88149995000043,126.11620019999997,128.0273996,128.88599999999997,127.83379820721815,128.71792739682743,128.86923000000027,130.67051413106933,127.06794586893122,123.88149995000043,126.11620019999997,128.0273996,128.88599999999997,130.49,53407504,56043386.4,63.62849000269231,NaN,1.5,2.75,NaN,NaN,1.2217265227243541,0.9529671104956642,199.76547158544932,0.12923382602156686,0.4886986778666369,0.35946485184507004,10.546553013184859,1.082243351886189,NaN,NaN,NaN,2687923629
1142519400,130.98,131.47,130.84,131.03,NaN,NaN,128.595986,131.47,123.93924995000043,126.24980019999997,128.1139996,129.02749999999997,127.95913945399391,128.93812478760577,128.98999846153873,131.11496582059235,126.86503110248513,123.93924995000043,126.24980019999997,128.1139996,129.02749999999997,131.11333333333334,67083632,55123892.8,64.77745762481393,NaN,1.5,2.75,NaN,NaN,1.1851753425297582,1.2169610779012328,202.80737305606962,0.2025804865664938,0.6126904600531873,0.4101099734866935,10.532993656143619,1.7629777697249072,NaN,NaN,NaN,2755007261
1142605800,130.67999,130.89999,130.38,130.62,NaN,NaN,128.83198533333334,131.51613636363635,123.98984995000042,126.37470019999999,128.1803996,129.10049999999998,128.0634869263863,129.09830337926238,129.1738446153849,131.41439711912452,126.93329211164526,123.98984995000042,126.37470019999999,128.1803996,129.10049999999998,130.63333,47286800,54436463.2,61.595571455404226,NaN,1.5,2.75,NaN,NaN,1.1469485323490614,0.868660401875631,204.33489828772156,0.20802901207050922,0.67014623857483,0.4621172265043208,10.25364550888482,1.9115237575095712,NaN,NaN,NaN,2707720461
1142865000,130.64,130.89999,130.21001,130.41,NaN,NaN,129.06798466666666,131.56227272727273,124.03810000000043,126.47920009999999,128.2409996,129.1805,128.15550704692018,129.22322686695168,129.25384461538488,131.58897094347878,126.91871828729097,124.03810000000043,126.47920009999999,128.2409996,129.1805,130.50666666666666,45541200,54696303.2,59.97069646607787,NaN,1.5,2.75,NaN,NaN,1.1143079228955564,0.8326193423616972,202.3709372755976,0.1829240737912169,0.6907723187433419,0.507848244952125,9.743451817575524,1.906696882081736,NaN,NaN,NaN,2662179261
1142951400,130.34,130.99001,129.45,129.59,NaN,NaN,129.303984,131.60840909090908,124.08530005000043,126.5779001,128.2639996,129.2354995,128.21176167253114,129.2581576415277,129.27153692307718,131.61308873545062,126.92998511070374,124.08530005000043,126.5779001,128.2639996,129.2354995,130.01000333333334,87404128,56743419.2,53.98241735137079,NaN,1.5,2.75,NaN,NaN,1.1447152141173038,1.5403394654793732,198.6820899032184,0.10063916278536766,0.6336471984338345,0.5330080356484669,10.665254145273435,1.0527057819162609,NaN,NaN,NaN,2574775133
1143037800,129.50999,130.50999,129.45,130.38,NaN,NaN,129.53998333333334,131.65454545454546,124.13700010000042,126.68800009999997,128.2961996,129.2909995,128.29679062654952,129.36499977090602,129.39615307692335,131.78744764846783,127.00485850537888,124.13700010000042,126.68800009999997,128.2961996,129.2909995,130.11333,51606896,57206844,58.302309154404966,NaN,1.5,2.75,NaN,NaN,1.1386634131089248,0.9021105236988777,201.80946704786822,0.08934552537623197,0.6446899423687569,0.5553444169925249,11.01759932886847,2.3551577955723033,NaN,NaN,NaN,2626382029
1143124200,130.24001,130.39349,129.66,130.11,NaN,NaN,129.77598266666666,131.7006818181818,124.18690010000041,126.80809999999998,128.3203998,129.3424995,128.36789687648877,129.43595217367687,129.54538384615412,131.8526339566248,127.23813373568345,124.18690010000041,126.80809999999998,128.3203998,129.3424995,130.05449666666667,46836400,57376154.4,56.3551388012527,NaN,1.5,2.75,NaN,NaN,1.1097224550297171,0.8163042729123722,202.14280038120157,0.055289513891023656,0.6244563093563045,0.5691667954652808,10.000690231415607,1.182051481452687,NaN,NaN,NaN,2579545629
1143210600,129.99001,130.57001,129.74001,130.21001,NaN,NaN,130.01198200000002,131.74681818181818,124.23840015000042,126.91220009999999,128.33839999999998,129.38250000000002,128.44013660682253,129.50967196666002,129.71769230769257,131.85706539844145,127.57831921694368,124.23840015000042,126.91220009999999,128.33839999999998,129.38250000000002,130.17334333333335,43213696,57697704,56.92894866796858,NaN,1.5,2.75,NaN,NaN,1.0897422796704503,0.7489673419240391,204.4264496019535,0.03223891751541541,0.60946544235955,0.5772265248441346,8.84851827548316,1.0711868353644325,NaN,NaN,NaN,2622759325
1143469800,130.03,130.28,129.74001,130.02,NaN,NaN,130.24798133333334,131.79295454545453,124.28610015000042,127.01110010000001,128.3628,129.41049950000001,128.50209203400595,129.55827463650192,129.8546146153849,131.8188412644951,127.89038796627469,124.28610015000042,127.01110010000001,128.3628,129.41049950000001,130.01333666666667,32523200,57529859.2,55.43767410453814,NaN,1.5,2.75,NaN,NaN,1.0504742596939889,0.5653273005055434,202.53448093029283,-0.0012872254031540686,0.5756174930901921,0.5769047184933461,8.968881550442449,-0.12289907227677112,NaN,NaN,NaN,2590236125
1143556200,129.92999,130.53,129.05,129.22,NaN,NaN,130.48398066666667,131.8390909090909,124.33120015000043,127.0984,128.3736002,129.4599995,128.53024528757436,129.52605800445411,129.99615307692335,131.41662894688056,128.57567720696613,124.33120015000043,127.0984,128.3736002,129.4599995,129.60000000000002,82081680,57914092.8,49.552149770203926,NaN,1.5,2.75,NaN,NaN,1.081154669715846,1.4173006263511738,199.92388379720157,-0.07854694504373516,0.4787210371886772,0.5572679822324124,7.467755058343074,-1.177722635188324,NaN,NaN,NaN,2508154445
1143642600,129.41,130.5,129.28999,130.03,NaN,NaN,130.71998000000002,131.88522727272726,124.3784501500004,127.1812,128.4076002,129.49299950000002,128.58905919786557,129.5740524802204,130.1069223076926,131.27338500277156,128.94045961261364,124.3784501500004,127.1812,128.4076002,129.49299950000002,129.93999666666664,61532704,58558412.8,54.78612435376745,NaN,1.5,2.75,NaN,NaN,1.0953579075932858,1.0507918684571997,203.59345508342255,-0.07624247802168194,0.46196488470530994,0.5382073627269919,7.978861904964018,-0.7631840036632832,NaN,NaN,NaN,2569687149
1143729000,130.11,130.98,129.55,129.8,NaN,NaN,130.95597933333335,131.93136363636364,124.4231501500004,127.2565,128.44719999999998,129.51499950000002,128.63654707245908,129.59557129162798,130.18153769230798,131.11194012994005,129.25113525467592,124.4231501500004,127.2565,128.44719999999998,129.51499950000002,130.10999999999999,70572320,59054804,53.10142420198541,NaN,1.5,2.75,NaN,NaN,1.1192609141937637,1.1950309749567538,201.58729174061503,-0.09038612252389733,0.4252247095721202,0.5156108320960175,7.819864467171314,-0.6277752258459601,NaN,NaN,NaN,2499114829
1143815400,130.02,130.24001,129.37,129.83,NaN,NaN,131.19197866666667,131.9775,124.46685015000041,127.3337,128.4776,129.56850000000003,128.68334914804893,129.61789783528246,130.15461538461565,131.10370597396917,129.20552479526214,124.46685015000041,127.3337,128.4776,129.56850000000003,129.8133366666667,62925696,58529598.4,53.303129781548975,NaN,1.5,2.75,NaN,NaN,1.1014572774656384,1.075108965722888,202.98690029645806,-0.09729909061153563,0.393986968831598,0.49128605944313364,7.712871049582028,-0.44475116938883835,NaN,NaN,NaN,2562040525
1144071000,130.07001,130.87,129.49001,129.73,NaN,NaN,131.427978,132.02363636363637,124.5085002000004,127.4087,128.55279999999996,129.6465,128.724394279498,129.62857423192222,130.07538538461566,130.98002739105377,129.17074337817755,124.5085002000004,127.4087,128.55279999999996,129.6465,130.03000333333333,61627696,58737028,52.492690433515456,NaN,1.5,2.75,NaN,NaN,1.121352471932378,1.0492137259651613,202.01547764290763,-0.10739215358090065,0.35704586746700784,0.4644380210479085,7.688029206428341,0.10803302723974563,NaN,NaN,NaN,2500412829
1144157400,129.72,130.73,129.36,130.56,NaN,NaN,131.66397733333335,132.06977272727272,124.5545002000004,127.49199999999999,128.63559999999998,129.776,128.7963788175569,129.71728144792962,130.03923153846182,130.81705804139878,129.26140503552486,124.5545002000004,127.49199999999999,128.63559999999998,129.776,130.21666666666667,54810192,58388302.4,58.17663180272303,NaN,1.5,2.75,NaN,NaN,1.139113009651492,0.9387187115753515,204.234497839506,-0.059354147582948824,0.39024533656922245,0.44959948415217127,7.641781870092582,0.13805798435343367,NaN,NaN,NaN,2555223021
1144243800,130.61,131.28,130.38,131.00999,NaN,NaN,131.89997666666667,132.1159090909091,124.6025502000004,127.5781999,128.72479979999997,129.91449900000003,128.88318709922135,129.8403965481268,130.06923076923107,130.95669497139744,129.1817665670647,124.6025502000004,127.5781999,128.72479979999997,129.91449900000003,130.88999666666666,50610704,57583581.6,60.907448936792086,NaN,1.5,2.75,NaN,NaN,1.1220335089621003,0.8789085811223663,206.51484868970428,-0.001515015714606327,0.4477057145089134,0.4492207302235197,7.100510553798626,0.691714702943643,NaN,NaN,NaN,2605833725
1144330200,130.85001,131.21001,130.19,130.87,NaN,NaN,132.135976,132.16204545454545,124.64955020000038,127.6534999,128.80899979999995,130.088999,128.96110133062442,129.93845401973377,130.10461538461567,131.07629229786744,129.1329384713639,124.64955020000038,127.6534999,128.80899979999995,130.088999,130.75667,57911008,57652952,59.60360686794827,NaN,1.5,2.75,NaN,NaN,1.1147461154648084,1.0044760240551083,204.76446879172954,0.021787556830869637,0.47645517626210676,0.4546676194312371,6.9911269654129535,0.5068657931905491,NaN,NaN,NaN,2547922717
1144416600,131.06,131.39999,129.35001,129.53999,NaN,NaN,132.37197533333335,132.20818181818183,124.68940010000038,127.7112999,128.85259959999996,130.13649850000002,128.9838028470705,129.9005050654734,130.10076846153873,131.08092347650202,129.12061344657545,124.68940010000038,127.7112999,128.85259959999996,130.13649850000002,130.09666333333334,80183312,58637562.4,48.89442085074917,NaN,1.5,2.75,NaN,NaN,1.1815485357887512,1.3674393804610132,199.94306841016567,-0.05377223082685101,0.3874523308976734,0.4412245617245244,9.32802987052403,-0.36918166435934574,NaN,NaN,NaN,2467739405
1144675800,129.71001,130.08,129.25999,129.74001,NaN,NaN,132.60797466666668,132.25431818181818,124.73880015000039,127.77179999999998,128.87659999999997,130.18199900000002,129.01345802953833,129.88521982114258,130.05153846153874,131.03493246366926,129.06814445940822,124.73880015000039,127.77179999999998,128.87659999999997,130.18199900000002,129.69333333333336,41537008,58428748,50.339521255602214,NaN,1.5,2.75,NaN,NaN,1.155724354660985,0.7109001890644653,197.99370954120388,-0.08957056369011951,0.329261357111875,0.4188319208019945,9.375738208854003,0.4024222256616727,NaN,NaN,NaN,2509276413
1144762200,129.85001,130.06,128.25,128.64,NaN,NaN,132.843974,132.30045454545456,124.78710015000038,127.82579989999998,128.8806,130.10499950000002,128.99881261661525,129.76662745722425,129.9384615384618,131.17455429465986,128.70236878226376,124.78710015000038,127.82579989999998,128.8806,130.10499950000002,128.98333333333332,72805312,58575054.4,43.11846264264609,NaN,1.5,2.75,NaN,NaN,1.2024583293280577,1.2429405784725998,193.765377969675,-0.18133130729292113,0.1921677866858431,0.37349909397876424,9.99471674614623,-1.0689840805967967,NaN,NaN,NaN,2436471101
1144848600,128.77,129.13,128.61,128.88,NaN,NaN,133.07997333333333,132.3465909090909,124.83575020000039,127.87969979999998,128.9082,130.01100000000002,128.9941532983166,129.68218674701242,129.83615307692335,131.1808049581837,128.491501195663,124.83575020000039,127.87969979999998,128.9082,130.01100000000002,128.87333333333333,43051904,58057274.4,44.97312943381926,NaN,1.5,2.75,NaN,NaN,1.1537113058046238,0.741541941900049,194.4279671261241,-0.21742835754692968,0.1017136470451021,0.3191420045920318,9.206969543956243,-0.70878274268106,NaN,NaN,NaN,2479523005
1144935000,128.59,129.25,128.31,128.71001,NaN,NaN,133.31597266666668,132.39272727272729,124.87855030000037,127.92039989999999,128.9146002,129.89500049999998,128.98301042387283,129.5895984853922,129.7353846153849,131.20074685229812,128.27002237847168,124.87855030000037,127.92039989999999,128.9146002,129.89500049999998,128.75667,51076896,57256937.6,43.88175108163291,NaN,1.5,2.75,NaN,NaN,1.1384462125328647,0.8920647547870251,192.52911647301391,-0.24241325695351812,0.01612543340013417,0.2585386903536523,9.194828463917862,-0.8626588615882317,NaN,NaN,NaN,2428446109
1145280600,128.78999,129.31,128.02,128.66,NaN,NaN,128.02,132.43886363636364,124.92270030000036,127.9556999,128.9498004,129.7970005,128.97034334842684,129.50106529630722,129.69230769230796,131.24600192712273,128.1386134574932,124.92270030000036,127.9556999,128.9498004,129.7970005,128.66333333333333,64169600,58101077.6,43.546941369839644,NaN,1.5,2.75,NaN,NaN,1.149271483066231,1.1044476737897886,190.68860024108332,-0.2509141736220095,-0.05510402667385961,0.1958101469481499,9.175237444906923,-0.8247899483542691,NaN,NaN,NaN,2364276509
1145367000,128.95,130.94,128.84,130.7,NaN,NaN,128.05111148148148,132.485,124.98030035000036,128.0051,129.03840039999997,129.8115005,129.03817302103755,129.61524955380176,129.74384615384645,131.38112961623892,128.10656269145397,124.98030035000036,128.0051,129.03840039999997,129.8115005,130.16,92662192,60457127.2,57.71861882635179,NaN,1.5,2.75,NaN,NaN,1.2300378057043575,1.5326926086557418,195.77818236084974,-0.11468617744723311,0.05245242513910853,0.16713860258634164,13.238677638069037,0.10723039215685229,NaN,NaN,NaN,2456938701
1145453400,130.72,131.07001,130.24001,130.95,NaN,NaN,128.082222962963,132.53113636363636,125.03740035000037,128.0516,129.12540019999997,129.87950049999998,129.1131466280557,129.74236864391588,129.83230769230798,131.59186959317566,128.0727457914403,125.03740035000037,128.0516,129.12540019999997,129.87950049999998,130.75334,87273312,60450586.4,59.074502025846925,NaN,1.5,2.75,NaN,NaN,1.2014636767254738,1.4437132408032356,198.29556379844033,-0.008858424469446236,0.15606557199953386,0.1649239964689801,12.78478040062496,-0.045790401174749425,NaN,NaN,NaN,2544212013
1145539800,131,131.86,130.60001,131.13,NaN,NaN,128.11333444444446,132.5772727272727,125.09060030000038,128.0926,129.23840019999997,129.91700049999997,129.19223891715154,129.87452401116198,129.932307692308,131.82286632115938,128.04174906345662,125.09060030000038,128.0926,129.23840019999997,129.91700049999997,131.19667,86022496,62171366.4,60.067429573652745,NaN,1.5,2.75,NaN,NaN,1.205644128387941,1.3836352806941044,196.8849998255382,0.06792033301390324,0.24982441273635914,0.1819040797224559,12.653554225439642,0.19867043631083586,NaN,NaN,NaN,2630234509
1145626200,131.73,131.78999,130.62,131.14999,NaN,NaN,128.14444592592594,132.6234090909091,125.14895025000038,128.1327999,129.32899999999998,129.96899999999997,129.26901346942012,129.9959969624799,130.041537692308,132.03405485271256,128.04902053190344,125.14895025000038,128.1327999,129.32899999999998,129.96899999999997,131.18666,72359312,63447512,60.18296561152524,NaN,1.5,2.75,NaN,NaN,1.2030974049316587,1.140459408400443,198.49379915861786,0.11210060499044067,0.3220298359605067,0.20992923097006605,12.63200714320998,1.2428594444078727,NaN,NaN,NaN,2702593821
1145885400,130.92999,131.07001,130.38,130.91,NaN,NaN,128.1755574074074,132.66954545454544,125.20375025000038,128.1795999,129.41899999999998,130.00399949999996,129.33336588238404,130.08304487081514,130.06846076923108,132.09739801287043,128.03952352559173,125.20375025000038,128.1795999,129.41899999999998,130.00399949999996,130.78667,52547296,63914192,58.012866525549875,NaN,1.5,2.75,NaN,NaN,1.172161161722255,0.8221538027109847,196.0801750380579,0.11668595873377038,0.35578667938727904,0.23910072065350865,10.901095118610106,0.9017958299833523,NaN,NaN,NaN,2650046525
1145971800,131.03999,131.12,129.92,130.37,NaN,NaN,128.2066688888889,132.71568181818182,125.24900020000037,128.22239990000003,129.49359999999996,130.02149949999995,129.37401820072193,130.11037393073752,130.0192307692311,131.98445516495806,128.0540063735041,125.24900020000037,128.22239990000003,129.49359999999996,130.02149949999995,130.47,84360368,66506050.4,53.35125659809182,NaN,1.5,2.75,NaN,NaN,1.1741496501706667,1.2684615533867276,193.52953842606536,0.07680172476437003,0.3351028766089712,0.2583011518446012,11.286481300961626,1.3448383084577258,NaN,NaN,NaN,2565686157
1146058200,130.5,131.14,130.3,130.39999,NaN,NaN,128.2377803703704,132.76181818181817,125.29130015000038,128.2722998,129.57339979999998,130.08049899999997,129.41425238892893,130.13795641352442,129.98307615384647,131.90108985277115,128.0650624549218,125.29130015000038,128.2722998,129.57339979999998,130.08049899999997,130.61333,67266880,65765310.4,53.57437569660272,NaN,1.5,2.75,NaN,NaN,1.1502818180156174,1.0228322437903372,195.14343159563722,0.04733599571926922,0.3174711464936877,0.27013515077441846,9.749762858575577,1.17938392302918,NaN,NaN,NaN,2632953037
1146144600,129.89999,131.63,129.59,131.03,NaN,NaN,128.26889185185186,132.80795454545455,125.33515020000038,128.31569980000003,129.63899979999997,130.13049899999996,129.4776150403435,130.2229129455697,130.09769230769263,132.07331051821086,128.1220740971744,125.33515020000038,128.31569980000003,129.63899979999997,130.13049899999996,130.75,124605376,68918944,58.10741624872191,NaN,1.5,2.75,NaN,NaN,1.213833116728787,1.807998915363532,194.86454492012587,0.06412901226160844,0.35029641610142903,0.2861674038398206,9.950762464482086,1.802493838668795,NaN,NaN,NaN,2757558413
1146231000,130.78999,131.75,130.71001,131.47,NaN,NaN,128.30000333333334,132.8540909090909,125.38035025000039,128.3618997,129.70439979999998,130.21399899999994,129.55574778385943,130.34168314122974,130.2307684615388,132.32177779627665,128.13975912680093,125.38035025000039,128.3618997,129.70439979999998,130.21399899999994,131.31000333333336,55855104,68183083.2,60.97345386592732,NaN,1.5,2.75,NaN,NaN,1.2014157512481585,0.8191929930208847,197.12232280459762,0.09676363938814803,0.40712195307500565,0.3103583136868576,9.800214051382985,2.184050987097779,NaN,NaN,NaN,2813413517
1146490200,131.47,131.8,130.32001,130.39999,NaN,NaN,128.33111481481484,132.90022727272728,125.4178002000004,128.4000996,129.7291996,130.24249849999995,129.5888553217473,130.34723617539834,130.36615230769263,132.24476534263295,128.48753927275231,125.4178002000004,128.4000996,129.7291996,130.24249849999995,130.84,65006608,68287128.8,51.70880282308141,NaN,1.5,2.75,NaN,NaN,1.2213139118732912,0.9519598955520884,195.63986726779234,0.04103086559696656,0.36164689568306585,0.3206160300860993,11.410917909344194,-0.22954093343533752,NaN,NaN,NaN,2748406909
1146576600,131.00999,131.46001,130.74001,131.38,NaN,NaN,128.3622262962963,132.94636363636363,125.46050020000041,128.44569950000002,129.78059959999996,130.32499849999994,129.65909628952193,130.4455946348842,130.55846000000034,132.29568384808488,128.8212361519158,125.46050020000041,128.44569950000002,129.78059959999996,130.32499849999994,131.19334,49087696,67660128.8,58.00291868118797,NaN,1.5,2.75,NaN,NaN,1.2097929181680567,0.7255040283044806,198.16713788531504,0.0635666905048885,0.40007439321720994,0.33650770271232144,8.120714925828409,0.32836960672012744,NaN,NaN,NaN,2797494605
1146663000,131.22,131.32001,130.45,130.89,NaN,NaN,128.3933377777778,132.9925,125.50320015000041,128.4937995,129.82859939999997,130.34149849999994,129.70736702326616,130.4879189553714,130.72615153846186,132.10018683772213,129.3521162392016,125.50320015000041,128.4937995,129.82859939999997,130.34149849999994,130.88666999999998,60824608,67960849.6,54.19918769356869,NaN,1.5,2.75,NaN,NaN,1.1898077097274817,0.8949948147793609,196.16461422500512,0.0400209062478466,0.3865338355221297,0.3465129292742831,8.407412207404379,-0.1830244795241433,NaN,NaN,NaN,2736669997
1146749400,131.08,131.62,130.34,131.36,NaN,NaN,128.42444925925926,133.03863636363636,125.54490015000042,128.5473995,129.87039939999994,130.35899899999995,129.77217615960868,130.5709742929551,130.93384384615416,131.65876818669508,130.20891950561324,125.54490015000042,128.5473995,129.87039939999994,130.35899899999995,131.10666666666668,42930496,67576839.2,57.104909274908884,NaN,1.5,2.75,NaN,NaN,1.1962500161755187,0.635284167004958,198.59526145918196,0.05000011255784775,0.4090130699715928,0.35901295741374506,8.636021368449919,0.16012963477924103,NaN,NaN,NaN,2779600493
1146835800,132.05,132.8,131.85001,132.52,NaN,NaN,128.45556074074076,132.8,125.59030015000042,128.60929950000002,129.93919939999995,130.44149899999996,129.87993395727108,130.75659578886413,131.07384384615415,132.1713000830037,129.9763876093046,125.59030015000042,128.60929950000002,129.93919939999995,130.44149899999996,132.39000333333334,62589504,67810764,63.29443712492496,NaN,1.5,2.75,NaN,NaN,1.2136607293058386,0.9230024896932293,202.3335765876857,0.12438923464732843,0.5144995007229056,0.3901102660755772,9.947690317205588,1.229852570468271,NaN,NaN,NaN,2842189997
1147095000,132.50999,132.77,132.36,132.36,NaN,NaN,128.48667222222224,132.83800000000002,125.63850015000043,128.66839950000002,129.99819939999995,130.58249949999995,129.9771914491428,130.90930095182947,131.1823053846157,132.47134351235647,129.8932672568749,125.63850015000043,128.66839950000002,129.99819939999995,130.58249949999995,132.49666666666667,30017296,65302463.2,61.966272286854476,NaN,1.5,2.75,NaN,NaN,1.1562563914982784,0.4596656010978771,201.6800604567958,0.15072681895143514,0.5785187897648711,0.427791970813436,9.888258429973618,1.5264247909795268,NaN,NaN,NaN,2812172701
1147181400,132.42,132.77,132.31,132.62,NaN,NaN,128.5177837037037,132.876,125.68390020000041,128.72149950000002,130.06139919999995,130.72649899999993,130.0808310001568,131.07222467070284,131.2969207692311,132.79499293949635,129.79884859896583,125.68390020000041,128.72149950000002,130.06139919999995,130.72649899999993,132.5666666666667,29865008,64718863.2,63.31346935399383,NaN,1.5,2.75,NaN,NaN,1.1065237921055449,0.46145754921109305,200.4893793412206,0.1720258524887256,0.642824286424343,0.4707984339356174,9.310678402510426,1.7024617869986047,NaN,NaN,NaN,2842037709
1147267800,132.41,132.75,131.89,132.55,NaN,NaN,128.5488951851852,132.91400000000002,125.73070020000041,128.76889950000003,130.14779919999998,130.92199899999997,130.17766115701338,131.21296517825496,131.40461384615415,133.0399508626422,129.7692768296661,125.73070020000041,128.76889950000003,130.14779919999998,130.92199899999997,132.39666666666668,64406896,64298942.4,62.66984828191897,NaN,1.5,2.75,NaN,NaN,1.0889149498122925,1.0016789327471116,198.82663886767912,0.16759837871042804,0.6802964073236524,0.5126980286132243,9.364667654104236,1.1600396855681983,NaN,NaN,NaN,2777630813
1147354200,132.50999,132.55,130.52,130.95,NaN,NaN,128.5800066666667,132.95200000000003,125.76875020000041,128.80399950000003,130.17939919999998,131.02549899999994,130.20794895477755,131.187920875564,131.40769076923107,133.03944028594753,129.7759412525146,125.76875020000041,128.80399950000003,130.17939919999998,131.02549899999994,131.34,80654688,66179081.6,50.12662315180189,NaN,1.5,2.75,NaN,NaN,1.1561353105399859,1.2187338665032184,193.91956590313447,0.04925510779573139,0.5742669133578886,0.5250118055621572,11.949811771910397,-0.3955274967673311,NaN,NaN,NaN,2696976125
1147440600,130.48,130.72,129.19,129.24001,NaN,NaN,128.61111814814817,132.99,125.79600030000041,128.83279960000002,130.1769994,131.05199899999994,130.1699905643941,131.00240555408172,131.32076846153876,133.25644862612168,129.38508829695584,125.79600030000041,128.83279960000002,130.1769994,131.05199899999994,129.71667,91733376,68211905.6,40.74139665215242,NaN,1.5,2.75,NaN,NaN,1.1992685026442718,1.3448293988139222,189.49810734575232,-0.14141619523126014,0.34824156152308205,0.4896577567543422,13.823523092163999,-0.8895552829413486,NaN,NaN,NaN,2605242749
1147699800,128.78999,129.74001,128.61,129.5,NaN,NaN,128.64222962962964,133.02800000000002,125.82065025000041,128.8706995,130.1917996,131.09399899999994,130.14371642461396,130.85931931083584,131.2515384615388,133.36976311956843,129.13331380350914,125.82065025000041,128.8706995,130.1917996,131.09399899999994,129.28333666666666,84040368,69205444,42.50402798767753,NaN,1.5,2.75,NaN,NaN,1.1943214667411095,1.2143606505869682,187.1760625804879,-0.24138416530332885,0.18792755012518114,0.42931171542851,13.308625969323634,-1.4309636169888837,NaN,NaN,NaN,2689283117
1147786200,129.75999,130,129.00999,129.31,NaN,NaN,128.6733411111111,133.066,125.84850020000042,128.90549950000002,130.2145996,131.02449899999993,130.1110216628644,130.71176509075624,131.11923076923108,133.4775397532313,128.76092178523086,125.84850020000042,128.90549950000002,130.2145996,131.02449899999993,129.43999666666667,62136400,67679154.4,41.53179048379135,NaN,1.5,2.75,NaN,NaN,1.1797277905453167,0.9181024874034182,187.8913442781265,-0.3074277045159864,0.045027084783527016,0.3524547892995134,12.24701708840559,-1.2071204828481812,NaN,NaN,NaN,2627146717
1147872600,128.67,129.10001,126.77,126.85001,NaN,NaN,128.70445259259262,133.104,125.8645003000004,128.9136996,130.1921998,130.81949949999995,129.98313885255598,130.3439788916366,130.7638469230772,134.02370091772258,127.50399292843184,125.8645003000004,128.9136996,130.1921998,130.81949949999995,127.57333999999997,144779632,70554470.4,31.488804129846557,NaN,1.5,2.75,NaN,NaN,1.2768900912206518,2.052026344740304,182.5251262154406,-0.49291072499875016,-0.2636836169489243,0.22922710804982588,15.90210606231764,-3.4333054202192566,NaN,NaN,NaN,2482367085
1147959000,127.38,127.75,126.11,126.21001,NaN,NaN,128.7355640740741,133.14200000000002,125.8736003500004,128.9088997,130.15159979999999,130.57349999999994,129.83517301520084,129.9502675686236,130.44154076923107,134.50984938541947,126.37323215304268,125.8736003500004,128.9088997,130.15159979999999,130.57349999999994,126.69000333333332,87923872,70649539.2,29.49078403157641,NaN,1.5,2.75,NaN,NaN,1.3028265132763195,1.2445073668647508,179.75938026735523,-0.6262618187651008,-0.5536001654065501,0.07266165335855068,15.330351008100303,-4.761537881074565,NaN,NaN,NaN,2394443213
1148045400,126.87,127.49001,125.8,127.10001,NaN,NaN,128.76667555555557,133.18,125.88550040000038,128.9122999,130.146,130.37100099999995,129.72791172048707,129.6788144668499,130.11231076923107,134.50346305483544,125.7211584836267,125.88550040000038,128.9122999,130.146,130.37100099999995,126.79667333333333,124320880,73247617.6,35.60949877607793,NaN,1.5,2.75,NaN,NaN,1.330482476613725,1.6972685811968307,181.87303408658212,-0.6208787431356763,-0.7034367755610447,-0.08255803242536841,14.817640191869481,-3.974002719854953,NaN,NaN,NaN,2518764093
1148304600,126.28,127.17,125.5,126.13,NaN,NaN,128.79778703703704,133.21800000000002,125.89755040000038,128.91889989999999,130.09679999999997,130.13200099999997,129.58681714321307,129.34083213667373,129.74615692307725,134.5875907857084,124.90472306044612,125.89755040000038,128.91889989999999,130.09679999999997,130.13200099999997,126.26666666666667,110877376,76164121.6,32.31775245039168,NaN,1.5,2.75,NaN,NaN,1.3547337282841734,1.4557691163604256,178.5543447925781,-0.6461083522071017,-0.8901934726842455,-0.24408512047714384,14.807468404900442,-4.893681194389993,NaN,NaN,NaN,2407886717
1148391000,127.17999,127.63,125.17,125.17,NaN,NaN,128.82889851851854,133.25600000000003,125.90900040000037,128.9130999,130.0236,129.87200099999998,129.41360862779294,128.94361002841907,129.2700030769234,134.5779839011971,123.96202225264969,125.90900040000037,128.9130999,130.0236,129.87200099999998,125.99000000000001,91990624,76545634.4,29.419261369734357,NaN,1.5,2.75,NaN,NaN,1.4336813191210176,1.2017749244756406,176.91159400898786,-0.6870913947414871,-1.1029493639040027,-0.4158579691625156,14.212654821258942,-5.567710298000761,NaN,NaN,NaN,2315896093
1148477400,125.67999,126.89,124.75999,126.17,NaN,NaN,128.86001000000002,133.294,125.92660045000035,128.9228999,129.94340019999999,129.66050149999998,129.2864082894481,128.67945669237915,128.78154153846188,133.97068567147747,123.5923974054463,125.92660045000035,128.9228999,129.94340019999999,129.66050149999998,125.93999666666667,168394368,81602008.8,35.871296568128514,NaN,1.5,2.75,NaN,NaN,1.4834190820409447,2.063605669472196,174.2476168706572,-0.6091513440093087,-1.1772971491741515,-0.5681458051648428,16.06841742301914,-3.650248186330651,NaN,NaN,NaN,2484290461
1148563800,126.92,127.73,126.42999,127.73,NaN,NaN,128.8911214814815,133.33200000000002,125.94830045000035,128.9551,129.8828004,129.4955015,129.22537267025407,128.5890322454859,128.42538769230802,133.20241080931842,123.64836457529762,125.94830045000035,128.9551,129.8828004,129.4955015,127.29666333333336,78992128,79321346.4,44.40871425518103,NaN,1.5,2.75,NaN,NaN,1.4888891476094488,0.9958495611214183,178.09775055817568,-0.4236320777204837,-1.0976859023154475,-0.6740538245949638,18.046446668919284,-1.1683765731680213,NaN,NaN,NaN,2563282589
1148650200,128,128.38,127.50999,128.38,NaN,NaN,128.922232962963,133.37,125.97355045000035,128.97189999999998,129.8298004,129.3410015,129.19222080083236,128.56912441258248,128.0992338461542,132.22007141484366,123.97839627746473,125.97355045000035,128.97189999999998,129.8298004,129.3410015,128.08999666666668,62990704,79678126.4,47.542403315962204,NaN,1.5,2.75,NaN,NaN,1.4446834942087734,0.7905645733155693,181.31900351133464,-0.23751800064840145,-0.9709513254054656,-0.7334333247570641,17.117644503013512,-0.8648648648648684,NaN,NaN,NaN,2626273293
1148995800,127.97,128,126.05,126.10001,NaN,NaN,128.95334444444447,133.40800000000002,125.98495045000034,128.95990009999997,129.7394006,129.1260025,129.07095763217228,128.3339706590032,127.60308076923113,130.93943652482722,124.26672501363505,125.98495045000034,128.95990009999997,129.7394006,129.1260025,126.71667000000001,72445504,80050071.2,39.196066010623554,NaN,1.5,2.75,NaN,NaN,1.5079203874795752,0.90500236806785,176.9344989102406,-0.24723128040050812,-1.0424724252576993,-0.7952411448571912,19.609483239876106,-2.482398886397034,NaN,NaN,NaN,2553827789
1149082200,126.58,127.50999,126.2,127.50999,NaN,NaN,128.98445592592594,133.44600000000003,126.00720040000033,128.9612,129.6814004,128.932502,129.00974321522435,128.2554963105267,127.33846461538496,130.06006719499226,124.61686203577769,126.00720040000033,128.9612,129.6814004,128.932502,127.07332666666667,86932688,81942320.8,45.56094395449462,NaN,1.5,2.75,NaN,NaN,1.5009246455167489,1.0609009746279972,180.62363920271537,-0.1431274123735724,-0.9741504103241567,-0.8310229979505843,21.15510141386169,0.520283758747835,NaN,NaN,NaN,2640760477
1149168600,127.38,128.94,127.27,128.73,NaN,NaN,129.01556740740742,133.484,126.03175035000032,128.96409999999997,129.6642004,128.824502,128.99877289305869,128.30068713809558,127.29923307692343,129.92300777141816,124.67545838242869,126.03175035000032,128.96409999999997,129.6642004,128.824502,128.3133333333333,73728000,82587490.4,50.39913255735257,NaN,1.5,2.75,NaN,NaN,1.5130014565512668,0.8927260005469302,185.013247011668,0.015060316820279973,-0.8121976019252344,-0.8272579187455144,18.58097410915165,1.9966641314741935,NaN,NaN,NaN,2714488477
1149255000,129.25,129.42999,128.32001,129,NaN,NaN,129.04667888888892,133.52200000000002,126.06570030000033,128.96639999999996,129.6366004,128.706502,128.99882101489953,128.36728836303885,127.2607715384619,129.76637336464384,124.75516971227995,126.06570030000033,128.96639999999996,129.6366004,128.706502,128.91666666666666,91702688,85026100,51.42796248010476,NaN,1.5,2.75,NaN,NaN,1.4842142096547484,1.07852398263592,188.3053945317706,0.13819255594603252,-0.6545172238129737,-0.7927097797590063,18.109846213661275,1.4948779311661757,NaN,NaN,NaN,2806191165
1149514200,128.78999,128.86,126.77,127.12,NaN,NaN,129.0777903703704,133.56000000000003,126.09030030000032,128.9486001,129.5768004,128.436502,128.92514175941326,128.2484989951304,127.09231000000035,129.30104651533753,124.88357348466316,126.09030030000032,128.9486001,129.5768004,128.436502,127.58333333333333,86119184,86202584,44.50569093940174,NaN,1.5,2.75,NaN,NaN,1.5374846232508381,0.9990325116008123,183.64624307386623,0.09537495159698761,-0.6734910902627718,-0.7688660418597594,20.150938979648775,0.7849044636486238,NaN,NaN,NaN,2720071981
1149600600,127.21001,127.38,125.75999,126.81,NaN,NaN,129.10890185185187,133.598,126.11340030000034,128.9236001,129.5088002,128.159002,128.84219502375,128.11149909083227,127.08923230769264,129.29942176972742,124.87904284565786,126.11340030000034,128.9236001,129.5088002,128.159002,126.64999666666667,130874816,91245460,43.466740303157835,NaN,1.5,2.75,NaN,NaN,1.543379293018635,1.434315921033222,180.74709435551125,0.05076412330005842,-0.7054108877346863,-0.7561750110347447,19.64074948893938,1.3102181033794045,NaN,NaN,NaN,2589197165
1149687000,126.91,127.64999,125.78999,125.86,NaN,NaN,129.14001333333334,133.63600000000002,126.13035030000033,128.8942001,129.4256002,127.821002,128.72524619928922,127.8970706059911,127.06230846153879,129.32264222336846,124.80197469970913,126.13035030000033,128.8942001,129.4256002,127.821002,126.43332666666669,108703120,95187365.6,40.35752707155917,NaN,1.5,2.75,NaN,NaN,1.5659950578030182,1.1419910543253864,178.0924646593899,-0.033591096240488616,-0.7981638813353555,-0.7645727850948669,19.62253671707321,-0.2457002457002475,NaN,NaN,NaN,2480494045
1149773400,125.58,126.5,123.87,125.75,NaN,NaN,129.17112481481485,133.674,126.14675030000033,128.8649002,129.3562002,127.48100199999999,128.60856987774847,127.6925876911348,126.95846153846186,129.32392724515304,124.59299583177068,126.14675030000033,128.8649002,129.3562002,127.48100199999999,125.37333333333333,204960320,102215036.8,40.00073502091233,NaN,1.5,2.75,NaN,NaN,1.641995410817088,2.0051875576881857,175.73207728198156,-0.08475189172709441,-0.870512649753735,-0.7857607580266406,19.050155563777516,-1.5501448367650543,NaN,NaN,NaN,2275533725
1149859800,126.36,126.96001,125.28999,125.35001,NaN,NaN,129.20223629629632,133.71200000000002,126.16230030000031,128.8351003,129.2626004,127.2010025,128.480783215876,127.46948505388387,126.89846230769263,129.38158131793648,124.41534329744879,126.16230030000031,128.8351003,129.2626004,127.2010025,125.86667,94976320,102931118.4,38.66223402012868,NaN,1.5,2.75,NaN,NaN,1.6439971671872955,0.9227172644808258,174.16255039971853,-0.13073844948660263,-0.9491838198848939,-0.8184453703982912,17.291302757907534,-2.3601729241314833,NaN,NaN,NaN,2180557405
1150119000,125.88,125.92999,123.82001,123.99001,NaN,NaN,129.2333477777778,133.75000000000003,126.17650040000031,128.7968003,129.1464006,126.9385025,128.30467446231222,127.1381064773235,126.80769384615415,129.60348832863824,124.01189936367008,126.17650040000031,128.7968003,129.1464006,126.9385025,124.58000333333332,95878192,103138359.2,34.44219897232291,NaN,1.5,2.75,NaN,NaN,1.6772816552453464,0.9296074975759359,169.67924804542656,-0.23203882000301734,-1.108493895402063,-0.8764550753990455,17.370871888892097,-1.6732750457355232,NaN,NaN,NaN,2084679213
1150205400,123.78,124.84,122.55,122.55,NaN,NaN,129.26445925925927,133.788,126.18130040000031,128.7392003,129.0008006,126.59100250000002,128.07900095398625,126.70114395567364,126.52923230769261,130.12909511443277,122.92936950095245,126.18130040000031,128.7392003,129.0008006,126.59100250000002,123.31333333333335,185695872,108221134.4,30.629907630833316,NaN,1.5,2.75,NaN,NaN,1.7210472512992507,1.7158928616811837,165.16357485665105,-0.3672756718100726,-1.3355496651616363,-0.9682739933515637,15.772701970991504,-3.889883451484864,NaN,NaN,NaN,1898983341
1150291800,122.84,123.63,122.34,123.5,NaN,NaN,122.34,133.82600000000002,126.19500045000032,128.7145003,128.8762006,126.30050250000002,127.89943228912405,126.39627310275235,126.20384769230799,130.06588454585236,122.3418108387636,126.19500045000032,128.7145003,128.8762006,126.30050250000002,123.15666666666668,163652000,113296914.4,35.68738729559341,NaN,1.5,2.75,NaN,NaN,1.6902581619207324,1.4444524007266344,166.27858303744762,-0.36333196314204397,-1.4224389472791188,-1.0591069841370748,14.761800452367734,-4.0627670317719184,NaN,NaN,NaN,2062635341
1150378200,123.92,126.36,123.86,126.12,NaN,NaN,122.20146341463415,133.86400000000003,126.21715045000032,128.7115003,128.7874006,126.264002,127.82965063072703,126.3699613786807,126.03000153846185,129.68232713690688,122.3776759400168,126.21715045000032,128.7115003,128.7874006,126.264002,125.44666666666667,134446320,112780248.8,47.134513589039706,NaN,1.5,2.75,NaN,NaN,1.7738111503549658,1.1921087373944506,170.84554514120356,-0.16495570565482387,-1.2653016162056048,-1.100345910550781,19.173409126219553,-2.23255813953488,NaN,NaN,NaN,2197081661
1150464600,125.19,125.56,124.46001,124.64999,NaN,NaN,122.06292682926829,133.90200000000002,126.23515040000034,128.6925002,128.6602006,126.186001,127.70495805697303,126.20615458071111,125.91846153846183,129.6432687232005,122.19365435372315,126.23515040000034,128.6925002,128.6602006,126.186001,124.89000000000001,94263008,113097205.6,42.55751990384621,NaN,1.5,2.75,NaN,NaN,1.7656810681867545,0.833468939395263,168.12875431728054,-0.11575102034143292,-1.245034685977572,-1.1292836656361391,19.711769959285313,-1.9430538074260557,NaN,NaN,NaN,2102818653
1150723800,125.39999,125.48,123.55,123.67,NaN,NaN,121.92439024390244,133.94000000000003,126.24060040000032,128.6626002,128.51620060000002,126.01450050000001,127.54672440767996,125.96461604921481,125.62307769230799,129.40479314602894,121.84136223858704,126.24060040000032,128.6626002,128.51620060000002,126.01450050000001,124.23333333333333,95817376,111672030.4,39.78397324661488,NaN,1.5,2.75,NaN,NaN,1.777418134744844,0.8580248398528267,164.05478546342044,-0.13108782583070555,-1.2931434479245212,-1.1620556220938156,18.653179488911995,-2.476145414399496,NaN,NaN,NaN,2007001277
1150810200,124.00999,124.81,123.72,124.09,NaN,NaN,121.78585365853658,133.978,126.2486003500003,128.6299002,128.4072008,125.91250050000001,127.41116658777094,125.78608118738482,125.26615461538489,128.66392294042828,121.86838629034152,126.2486003500003,128.6299002,128.4072008,125.91250050000001,124.20666666666666,65518304,109404076.8,41.54235359257432,NaN,1.5,2.75,NaN,NaN,1.731888267977355,0.5988652883545926,162.00844727045234,-0.09643113985250795,-1.2825945469094506,-1.1861634070569427,18.98508120182569,-1.4063244875258192,NaN,NaN,NaN,2072519581
1150896600,124,125.7,123.96001,125.00999,NaN,NaN,121.64731707317074,134.01600000000002,126.26230030000029,128.59460020000003,128.31260039999998,125.90450000000001,127.31700280001522,125.71216774096722,124.95923076923106,127.58572805111689,122.33273348734522,126.26230030000029,128.59460020000003,128.31260039999998,125.90450000000001,124.89,75038688,108556480,45.309651102487145,NaN,1.5,2.75,NaN,NaN,1.7324669631218301,0.6912409834954117,165.75010465722627,-0.00012828289788635594,-1.1863237606793007,-1.1861954777814143,19.369894652048394,-0.5884771371769368,NaN,NaN,NaN,2147558269
1150983000,124.95,125.06,124.03999,124.46001,NaN,NaN,121.50878048780488,134.05400000000003,126.26610035000029,128.5548003,128.22900059999998,125.81900049999999,127.20496386668128,125.59291462277986,124.75461615384644,127.0721819049878,122.43705040270508,126.26610035000029,128.5548003,128.22900059999998,125.81900049999999,124.52,74994128,103886468,43.504668861946705,NaN,1.5,2.75,NaN,NaN,1.6815771800416994,0.7218854336254843,162.67491521209337,0.03595508594609398,-1.1412516203487968,-1.1772067062948908,19.488587320681333,-0.7100119098514636,NaN,NaN,NaN,2072564141
1151069400,124.33,125.3,124.03,124.44,NaN,NaN,121.37024390243903,134.092,126.26875035000029,128.52420030000002,128.14020059999996,125.6545005,127.09653391112515,125.48311323013415,124.57230846153877,126.56447945541396,122.58013746766358,126.26875035000029,128.52420030000002,128.14020059999996,125.6545005,124.58999999999999,54112496,102642486.4,43.436869499721716,NaN,1.5,2.75,NaN,NaN,1.6521788100387205,0.5271939320441091,163.64257405505592,0.06614199484755101,-1.094529212735452,-1.160671207583003,19.44357977692653,0.36292440011900934,NaN,NaN,NaN,2018451645
1151328600,124.53999,125.06,124.25,124.99001,NaN,NaN,121.23170731707317,134.13000000000002,126.27620040000029,128.49020040000002,128.0658006,125.48500099999998,127.01392513029671,125.43615101774043,124.50538615384646,126.37469499051144,122.63607731718147,126.27620040000029,128.49020040000002,128.0658006,125.48500099999998,124.76667,37905200,101388211.2,45.93114869727384,NaN,1.5,2.75,NaN,NaN,1.5920231807502405,0.3738620057634472,166.25072840934604,0.12727726298826036,-1.0015746288476777,-1.128851891835938,18.474247245932535,1.991032231742147,NaN,NaN,NaN,2056356845
1151415000,125.00999,125.28999,123.77,123.91,NaN,NaN,121.09317073170732,134.16800000000003,126.2727503500003,128.46030050000002,127.97080059999999,125.37550049999997,126.89220257616743,125.29080330176515,124.363847692308,126.10930471768147,122.61839066693453,126.2727503500003,128.46030050000002,127.97080059999999,125.37550049999997,124.32333000000001,69780880,101254980,42.01336075945099,NaN,1.5,2.75,NaN,NaN,1.5868779535537954,0.6891599800819673,162.43398011170214,0.10029139234965401,-1.0034876513988706,-1.1037790437485246,17.80130044480969,0.33198380566801344,NaN,NaN,NaN,1986575965
1151501400,124.19,124.77,123.64999,124.75,NaN,NaN,120.95463414634146,134.20600000000002,126.2747503000003,128.44510050000002,127.85180059999999,125.23750099999998,126.808194632004,125.23929822540657,124.31769307692338,125.98644848748961,122.64893766635714,126.2747503000003,128.44510050000002,127.85180059999999,125.23750099999998,124.38999666666666,62368096,100026750.4,45.87994968159552,NaN,1.5,2.75,NaN,NaN,1.5535302425856667,0.6235141674661461,164.4557367736177,0.14178951138175688,-0.9265421545213286,-1.0683316659030855,17.678418488676016,-1.0862670472565845,NaN,NaN,NaN,2048944061
1151587800,125.2,127.35001,125.17,127.27,NaN,NaN,120.8160975609756,134.24400000000003,126.29280030000031,128.45180040000002,127.7782006,125.16450099999997,126.82630464643522,125.43269839441547,124.5700000000003,126.84573121303468,122.29426878696593,126.29280030000031,128.45180040000002,127.7782006,125.16450099999997,126.59667,110696624,101875181.6,55.47250414141672,NaN,1.5,2.75,NaN,NaN,1.6282787966866903,1.0865906912896242,169.26364089381244,0.3309271766482178,-0.6546726950928132,-0.985599871741031,17.272946165250573,2.1018934698671004,NaN,NaN,NaN,2159640685
1151674200,127.47,127.66,126.96001,127.23,NaN,NaN,120.67756097560975,134.28200000000004,126.31290025000031,128.46930040000004,127.70020059999999,125.07600099999998,126.84213583677109,125.60386997589971,124.9300000000003,127.29265794265139,122.56734205734922,126.31290025000031,128.46930040000004,127.70020059999999,125.07600099999998,127.28333666666666,54229904,100001542.4,55.304938824608136,NaN,1.5,2.75,NaN,NaN,1.5619724540662125,0.5422906757086179,172.76519334454304,0.43856007094412985,-0.4373997830608687,-0.8759598540049985,15.359290124929855,2.8786286083933064,NaN,NaN,NaN,2105410781
1151933400,127.42999,128.00999,127.31,127.8,NaN,NaN,120.53902439024391,128.00999,126.3361503000003,128.4811004,127.6332008,125.11000099999998,126.87969913728988,125.81302521629021,125.26076923076954,127.91590579733383,122.60563266420525,126.3361503000003,128.4811004,127.6332008,125.11000099999998,127.70666333333332,23936192,96892392.8,57.285033598476204,NaN,1.5,2.75,NaN,NaN,1.5061165644900534,0.24703891924113985,177.08913004290352,0.5273942674471033,-0.21671701969611945,-0.7441112871432227,14.01404669529301,2.989765492787488,NaN,NaN,NaN,2129346973
1152106200,127.28999,127.45,126.52,127.07001,NaN,NaN,120.40048780487805,127.89023974999999,126.35400035000029,128.48770050000002,127.55640100000001,125.12300149999999,126.88716230837655,125.932738052834,125.33384692307723,128.12820047242317,122.53949337373129,126.35400035000029,128.48770050000002,127.55640100000001,125.12300149999999,127.01333666666665,69653504,93831327.2,53.98637516161081,NaN,1.5,2.75,NaN,NaN,1.4899653813121925,0.7423267482035573,173.10940200017023,0.5156246059898049,-0.09958052965596664,-0.6152051356457715,14.933421135809073,1.6478843010866526,NaN,NaN,NaN,2059693469
1152192600,127.2,127.85001,127.08,127.44,NaN,NaN,120.2619512195122,127.77048949999998,126.37575035000029,128.49570050000003,127.497801,125.20200149999998,126.90884221785197,126.07628680970694,125.5484630769234,128.52254483528645,122.57438131856033,126.37575035000029,128.49570050000003,127.497801,125.20200149999998,127.45666999999999,51289504,90960646.4,55.38854406730571,NaN,1.5,2.75,NaN,NaN,1.4392535683613217,0.5638647704244986,175.50674485158984,0.5104383215546064,0.022842766297486605,-0.48759555525711984,14.601538044260455,2.394335337109487,NaN,NaN,NaN,2110982973
1152279000,127.19,127.56,126.28999,126.61,NaN,NaN,120.12341463414634,127.65073924999999,126.39855035000029,128.49770050000004,127.4220012,125.24500149999999,126.8971229151911,126.12711663735391,125.77461692307723,128.585591147446,122.96364269870845,126.39855035000029,128.49770050000004,127.4220012,125.24500149999999,126.81999666666667,81628368,84794048.8,51.59052922754076,NaN,1.5,2.75,NaN,NaN,1.4271647420497986,0.9626662384353559,172.8177358834439,0.4319062933052498,0.052287311374442424,-0.3796189819308074,14.983803913082534,1.743812279009966,NaN,NaN,NaN,2029354605
1152538200,126.94,127.42999,126.41,126.85001,NaN,NaN,119.98487804878049,127.53098899999999,126.4282504000003,128.48870060000002,127.33840140000001,125.32000149999999,126.89527534988949,126.19596362427258,125.98692538461569,128.67093414925273,123.30291661997865,126.4282504000003,128.48870060000002,127.33840140000001,125.32000149999999,126.89666666666666,60956400,83093052.8,52.60263712692502,NaN,1.5,2.75,NaN,NaN,1.398080831903385,0.7335920145661082,174.9863691620389,0.3788204891186551,0.0939066294675115,-0.28491385965114363,14.936235531387357,1.4881189304649223,NaN,NaN,NaN,2090311005
1152624600,126.61,127.41,125.94,127.41,NaN,NaN,119.84634146341463,127.41123874999998,126.4586004000003,128.4808006,127.2572014,125.49100099999998,126.91546063028598,126.31158613624662,126.17154153846185,128.8912894288126,123.4517936481111,126.4586004000003,128.4808006,127.2572014,125.49100099999998,126.91999999999999,73640816,81981184,54.968287507500825,NaN,1.5,2.75,NaN,NaN,1.4032179153388573,0.8982648506271879,177.6599712543758,0.3640236983210706,0.17011576325019462,-0.19390793507087598,14.935914665863246,2.824630780405133,NaN,NaN,NaN,2163951821
1152711000,127.21001,127.39999,125.72,126.05,NaN,NaN,119.70780487804878,127.29148849999999,126.48165040000029,128.44970060000003,127.1702016,125.66600099999998,126.88152099772574,126.2866731708898,126.29384846153877,128.83164328029005,123.75605364278749,126.48165040000029,128.44970060000003,127.1702016,125.66600099999998,126.38999666666666,82561376,76824459.2,48.62131777532416,NaN,1.5,2.75,NaN,NaN,1.4237023499575103,1.0746756548596699,173.89547546191852,0.25064243156223887,0.11939510438192258,-0.13124732718031626,15.503178426478122,1.042084168336671,NaN,NaN,NaN,2081390445
1152797400,125.5,125.67999,124,124,NaN,NaN,119.56926829268292,127.17173824999999,126.49375040000028,128.40160060000002,127.0226016,125.69100099999999,126.76852017428551,126.0688947736622,126.2600023076926,128.9052536466447,123.6147509687405,126.49375040000028,128.40160060000002,127.0226016,125.69100099999999,124.55999666666668,102454192,73764568.8,40.94646177006849,NaN,1.5,2.75,NaN,NaN,1.4684378963891167,1.3889350085918215,169.59754314250932,0.036808505691270074,-0.08523669506622866,-0.12204520075749874,18.198836731017106,-2.5693407715879597,NaN,NaN,NaN,1978936253
1152883800,124.16,124.25999,122.83,123.52,NaN,NaN,119.43073170731708,127.05198799999998,126.50360040000028,128.35190050000003,126.8752016,125.56100099999999,126.64112722627432,125.82614289045627,126.14692461538492,129.10664962581086,123.18719960495898,126.50360040000028,128.35190050000003,126.8752016,125.56100099999999,123.53666333333332,103243184,72204412,39.37905797765563,NaN,1.5,2.75,NaN,NaN,1.4656916180756085,1.4298736204651872,166.60724876484076,-0.12866783491815484,-0.2828799944051923,-0.15421215948703745,12.624605406725681,-2.915978935785591,NaN,NaN,NaN,1875693069
1153143000,123.5,124.10001,123.14999,123.34,NaN,NaN,119.29219512195122,126.93223774999998,126.5119504000003,128.29260050000002,126.71480160000002,125.4955015,126.51167125661651,125.58936737707948,126.10307846153874,129.2074134553697,122.99874346770778,126.5119504000003,128.29260050000002,126.71480160000002,125.4955015,123.53000000000002,81289632,71555743.2,38.77956595503005,NaN,1.5,2.75,NaN,NaN,1.4288579310702076,1.1360322507278493,164.46198641779918,-0.23572147554842265,-0.44886400392256576,-0.2131425283741431,12.552906861656318,-3.4898278560250344,NaN,NaN,NaN,1794403437
1153229400,123.74001,124.05,122.39,123.97,NaN,NaN,122.39,126.81248749999997,126.5185004000003,128.24150050000003,126.54380160000001,125.51050149999999,126.4119978740041,125.43514191259572,126.04307846153876,129.27714299636995,122.80901392670758,126.5185004000003,128.24150050000003,126.54380160000001,125.51050149999999,123.46999999999998,123697008,72949724.8,42.101840883315845,NaN,1.5,2.75,NaN,NaN,1.445368078850907,1.6956473563009247,165.70872128379395,-0.24831540631129695,-0.5235367862632643,-0.2752213799519673,12.694824829302572,-2.4396078980398266,NaN,NaN,NaN,1918100445
1153315800,124.17999,126.25999,123.724,125.69,NaN,NaN,122.39217391304348,126.69273724999998,126.53175045000029,128.20430050000002,126.4104016,125.59050149999999,126.38368423188629,125.45941411139613,125.92154000000029,129.07990426843833,122.76317573156224,126.53175045000029,128.20430050000002,126.4104016,125.59050149999999,125.22466333333334,134399184,76393768.8,50.068660154256044,NaN,1.5,2.75,NaN,NaN,1.5232696446472704,1.7592951115143831,170.90640086374816,-0.1309164116556229,-0.43886689452149596,-0.30795048286587307,15.745466195995936,-1.3731952291274325,NaN,NaN,NaN,2052499629
1153402200,126.12,126.3,124.66,124.83,NaN,NaN,122.39434782608696,126.57298699999998,126.5429004000003,128.15800040000002,126.2546016,125.58150199999997,126.32275543847899,125.39946991031078,125.73692461538491,128.847992987227,122.62585624354281,126.5429004000003,128.15800040000002,126.2546016,125.58150199999997,125.26333333333332,112337808,78258724.8,46.6148446208571,NaN,1.5,2.75,NaN,NaN,1.5316075271724654,1.4354668861151696,167.49502284306502,-0.10254580668728608,-0.4361327412249807,-0.3335869345376946,15.835494196860461,-1.4058921096279924,NaN,NaN,NaN,1940161821
1153488600,125.14999,125.19,123.82001,123.95,NaN,NaN,122.39652173913043,126.45323674999997,126.5565504000003,128.11520040000002,126.0826016,125.55600149999998,126.22970620559747,125.26142515694785,125.44077076923107,128.44090169340916,122.44063984505296,126.5565504000003,128.11520040000002,126.0826016,125.55600149999998,124.32000333333333,101722192,79595128,43.32172283245953,NaN,1.5,2.75,NaN,NaN,1.520063418088718,1.2779952059377302,164.32090879344423,-0.13250633624113356,-0.4992198548391116,-0.366713518597978,15.894027471641447,-2.2861724646296793,NaN,NaN,NaN,1838439629
1153747800,124.44,126.32001,124.44,126.21001,NaN,NaN,122.39869565217391,126.33348649999998,126.5894504500003,128.08360050000002,125.9878018,125.64450199999996,126.22893380537796,125.35176657057187,125.37461692307723,128.264012350527,122.48522149562747,126.5894504500003,128.08360050000002,125.9878018,125.64450199999996,125.65667333333333,92889872,81533996.8,52.585839022352076,NaN,1.5,2.75,NaN,NaN,1.5807738882252378,1.1392777938735859,169.4703982224372,0.0032330009226955725,-0.36267226744460856,-0.36590526836730414,19.646924636252752,-0.9418334510634956,NaN,NaN,NaN,1931329501
1153834200,125.98,127.3,125.72,126.66,NaN,NaN,122.40086956521739,126.21373624999998,126.62675045000029,128.05660050000003,125.93620159999999,125.72800149999996,126.2458383620298,125.4763602305174,125.31461692307722,128.0587054892937,122.57052835686078,126.62675045000029,128.05660050000003,125.93620159999999,125.72800149999996,126.56,95483872,84412930.4,54.19134554128623,NaN,1.5,2.75,NaN,NaN,1.5807186104948634,1.1311522008244366,172.60126480876684,0.12019550752621988,-0.21566088395952931,-0.3358563914857492,19.575612939603452,0.48393494644982105,NaN,NaN,NaN,2026813373
1153920600,126.59,127.45,126.17999,126.83,NaN,NaN,122.40304347826087,126.09398599999997,126.66285045000029,128.0373006,125.88280159999998,125.87400149999996,126.26874666155804,125.60527830380146,125.3315400000003,128.10987470705936,122.55320529294124,126.66285045000029,128.0373006,125.88280159999998,125.87400149999996,126.81999666666667,84528128,85150292.8,54.81384663318092,NaN,1.5,2.75,NaN,NaN,1.5585251383166587,0.992693333404486,173.99699112436454,0.20111543506767537,-0.08446209765115498,-0.28557753271883035,18.485361423309545,2.2822580645161277,NaN,NaN,NaN,2111341501
1154007000,127.33,127.69,126.2,126.71001,NaN,NaN,122.40521739130435,125.97423574999998,126.7034004500003,128.02270070000003,125.83080179999997,125.97200199999995,126.28605110620282,125.71049084629655,125.32077076923109,128.07647187376946,122.56506966469271,126.7034004500003,128.02270070000003,125.83080179999997,125.97200199999995,126.86667,87257184,86394747.2,54.253443307053416,NaN,1.5,2.75,NaN,NaN,1.5536304855797543,1.009982514307305,171.7471625986627,0.2362377489097735,0.009719653418386542,-0.22651809549138696,15.107245004869348,2.582585816062177,NaN,NaN,NaN,2024084317
1154093400,126.99001,128.14,126.86,127.98,NaN,NaN,122.40739130434783,125.85448549999998,126.75115050000029,128.02280070000003,125.85340159999996,126.00750199999996,126.35248047458703,125.92663457522069,125.36461692307724,128.2661691279666,122.46306471818785,126.75115050000029,128.02280070000003,125.85340159999996,126.00750199999996,127.66000000000001,82137184,84966775.2,59.02804396255251,NaN,1.5,2.75,NaN,NaN,1.5447990223240566,0.9666976745517346,176.29377032212474,0.3289806787413804,0.18470775293533848,-0.14427292580604187,15.171594627820898,3.7619588130371335,NaN,NaN,NaN,2106221501
1154352600,127.66,127.96001,126.55,127.85001,NaN,NaN,122.4095652173913,125.73473524999997,126.80290055000029,128.01890070000002,125.88620159999996,126.03850249999996,126.41120712264244,126.10981318710444,125.50307923076954,128.68088506008684,122.32527340145226,126.80290055000029,128.01890070000002,125.88620159999996,126.03850249999996,127.45333999999998,49589104,84734735.2,58.35667156488485,NaN,1.5,2.75,NaN,NaN,1.536599092158053,0.5852275797281302,176.55026491014604,0.3628840902419195,0.30933218699635745,-0.053551903245562,15.120386774528136,3.1297975316608846,NaN,NaN,NaN,2056632397
1154439000,127.34,127.38,126.60001,127.22,NaN,NaN,122.41173913043478,125.61498499999998,126.85185060000029,128.01730070000002,125.88860139999997,126.00950249999994,126.44292449038196,126.21554526452306,125.75077153846185,128.92329602036077,122.57824705656294,126.85185060000029,128.01730070000002,125.88860139999997,126.00950249999994,127.06667,65220896,86798970.4,55.08648639298151,NaN,1.5,2.75,NaN,NaN,1.516127728432478,0.7514017240001731,173.9320091629176,0.32539356420219256,0.3531900520071787,0.027796487804986142,15.83321931181897,1.2172806110271313,NaN,NaN,NaN,1991411501
1154525400,127.58,128.46001,127.55,128.08,NaN,NaN,122.41391304347826,125.49523474999998,126.8989006000003,128.01220070000002,125.92760139999997,126.06000199999994,126.50712352997482,126.39311238218752,126.10154076923108,129.21777214894414,122.98530938951804,126.8989006000003,128.01220070000002,125.92760139999997,126.06000199999994,128.03000333333333,64787504,86555670.4,58.50482531742619,NaN,1.5,2.75,NaN,NaN,1.4964050335444448,0.7485067552547082,177.28022156893212,0.33946733607958063,0.45213065790446194,0.11266332182488131,14.472461028830175,2.603540815509104,NaN,NaN,NaN,2056199005
1154611800,127.33,128.55,127.14999,128.42,NaN,NaN,122.41608695652174,125.37548449999997,126.9454506000003,128.00810070000003,125.99260139999997,126.10900199999995,126.58213829350522,126.58614929816966,126.49231000000032,129.3918832646753,123.59273673532532,126.9454506000003,128.00810070000003,125.99260139999997,126.10900199999995,128.03999666666667,63704496,87176420,59.80724518309548,NaN,1.5,2.75,NaN,NaN,1.4895196740055565,0.7307537519893568,179.66768884619478,0.3511639406360484,0.5516182476199418,0.20045430698389344,13.357388488734635,3.606292860024191,NaN,NaN,NaN,2119903501
1154698200,129.06,129.42999,127.48,128.2,NaN,NaN,122.41826086956522,125.25573424999997,126.9973505500003,127.98830080000003,126.03320139999997,126.18850199999993,126.64558385062267,126.73984936501064,126.81769461538494,129.44899947494736,124.18638975582253,126.9973505500003,127.98830080000003,126.03320139999997,126.18850199999993,128.36999666666665,96296624,87909832.8,58.52715872552486,NaN,1.5,2.75,NaN,NaN,1.5224104115765882,1.095402197147621,181.51033608243108,0.32421916203881523,0.6057282595324125,0.28150909749359726,12.209924809807006,1.5767291358268585,NaN,NaN,NaN,2023606877
1154957400,127.89999,128.08,127.39999,127.95,NaN,NaN,122.4204347826087,125.13598399999998,127.03820055000031,127.96020090000003,126.03760139999997,126.24350149999991,126.69673742510805,126.8551018064382,126.99154076923108,129.60038756065418,124.38269397780797,127.03820055000031,127.96020090000003,126.03760139999997,126.24350149999991,127.80999666666666,45434400,87133732.8,57.03327825047931,NaN,1.5,2.75,NaN,NaN,1.4708103821782594,0.5214329575927453,178.89938354155032,0.27181371193942117,0.6212762374178737,0.3494625254784526,8.120769757638971,1.0184746565608767,NaN,NaN,NaN,1978172477
1155043800,128.09,128.46001,126.95,127.41,NaN,NaN,122.42260869565217,125.01623374999997,127.08690055000032,127.92400090000002,126.01820139999997,126.24350149999991,126.72470850647636,126.90794925344409,127.19000230769264,129.48451643425085,124.89548818113444,127.08690055000032,127.92400090000002,126.01820139999997,126.24350149999991,127.60667000000001,90898128,87996598.4,53.836769926176736,NaN,1.5,2.75,NaN,NaN,1.473610354879813,1.0329732018368565,176.53144290522877,0.18707054554887897,0.5833007074145513,0.39623016186567234,8.56872461118232,0.45730505400930244,NaN,NaN,NaN,1887274349
1155130200,128.2,128.60001,126.61,126.98,NaN,NaN,122.42478260869565,124.89648349999997,127.13115055000031,127.88760090000001,126.03580119999995,126.2900014999999,126.73471993759493,126.91481122930655,127.42307923076956,128.77623473819284,126.06992372334628,127.13115055000031,127.88760090000001,126.03580119999995,126.2900014999999,127.39667000000001,78916128,87814336,51.367897366752764,NaN,1.5,2.75,NaN,NaN,1.510496043816969,0.8986702125721249,174.0939900399228,0.09309467329250204,0.5125985034812999,0.41950383018879783,8.840765485045903,0.2130770883847354,NaN,NaN,NaN,1808358221
1155216600,126.53,127.5,126.28,127.37,NaN,NaN,122.42695652173913,124.77673324999998,127.16820050000031,127.85720090000002,126.03300139999996,126.4585014999999,126.75963288121866,126.95816254080117,127.51230923076955,128.6730280368443,126.35159042469479,127.16820050000031,127.85720090000002,126.03300139999996,126.4585014999999,127.05,69324320,86157842.4,53.45283811840206,NaN,1.5,2.75,NaN,NaN,1.4897463264014712,0.8046199634172826,176.3274564249448,0.05037659311703108,0.48247457158508666,0.4320979784680556,8.962732666040207,-0.47663697452726944,NaN,NaN,NaN,1877682541
1155303000,127.17,127.2,126.39,127.00999,NaN,NaN,122.4291304347826,124.65698299999997,127.2046504500003,127.83140080000003,125.99860119999995,126.6330009999999,126.76945080744538,126.9630984892963,127.53923153846185,128.63398722224548,126.4444758546782,127.2046504500003,127.83140080000003,125.99860119999995,126.6330009999999,126.86666333333332,47489392,83370152.8,51.2678435479909,NaN,1.5,2.75,NaN,NaN,1.4533358745156522,0.5696210262913181,173.03947667883767,-0.005953448145230245,0.42465616828651775,0.430609616431748,6.769387814437951,-0.6570355371892388,NaN,NaN,NaN,1830193149
1155562200,127.63,128.16,126.92,127.11,NaN,NaN,122.43130434782609,124.53723274999997,127.2433504500003,127.79870080000005,125.96080119999995,126.8215009999999,126.78280567774164,126.97708910936332,127.5607700000003,128.60888803395224,126.51265196604837,127.2433504500003,127.79870080000005,125.96080119999995,126.8215009999999,127.39666666666666,58044496,82207896,51.856592255678585,NaN,1.5,2.75,NaN,NaN,1.4380975977645338,0.7060695970129195,174.33877342824127,-0.03849131824325347,0.38249546862768113,0.4209867868709346,6.823245715431217,-0.08646439239113303,NaN,NaN,NaN,1888237645
1155648600,128.21001,128.87,127.89999,128.63,NaN,NaN,122.43347826086956,124.41748249999998,127.29600040000032,127.78390080000003,125.99100119999996,127.05450099999992,126.85524467077137,127.13450919418587,127.70846153846183,128.7763402453392,126.64058283158445,127.29600040000032,127.78390080000003,125.99100119999996,127.05450099999992,128.46666333333334,68149808,79430536,59.80486364360828,NaN,1.5,2.75,NaN,NaN,1.4610906264956387,0.8579799587403011,179.15871990698676,0.03629714647503812,0.46635821996473226,0.43006107348969413,9.274800852495606,0.4294191130543277,NaN,NaN,NaN,1956387453
1155735000,129.32001,129.89,129.03999,129.78999,NaN,NaN,122.43565217391304,124.29773224999997,127.34595035000034,127.77970060000001,126.05060099999996,127.2595004999999,126.97033272289798,127.38741212807292,127.84769153846183,129.3882417621822,126.30714131474147,127.34595035000034,127.77970060000001,126.05060099999996,127.2595004999999,129.57332666666665,71759184,76298536,64.60713717382991,NaN,1.5,2.75,NaN,NaN,1.4467270103173782,0.940505385319582,182.818064738743,0.15137741800699767,0.6192828459984412,0.4679054279914435,9.843112787972302,1.0668042361002972,NaN,NaN,NaN,2028146637
1155821400,129.58,130.37,129.49001,130.03,NaN,NaN,122.43782608695652,124.17798199999997,127.39545035000032,127.77980060000002,126.13400099999996,127.51950049999991,127.0903196749412,127.63908716349455,128.01538307692337,129.94571646322825,126.08504969061849,127.39545035000032,127.77980060000002,126.13400099999996,127.51950049999991,129.96333666666666,70994816,74231386.4,65.52491694886412,NaN,1.5,2.75,NaN,NaN,1.4062457952947078,0.956398895979666,184.02411011705405,0.2266231213578036,0.751184329688698,0.5245612083308944,9.814369563412026,1.4274570982839412,NaN,NaN,NaN,2099141453
1155907800,130.19,130.69,129.59,130.69,NaN,NaN,122.44,124.05823174999996,127.44645030000031,127.79450060000003,126.23280099999994,127.85650049999992,127.23148360925722,127.92965029078078,128.28230615384646,130.61632388904093,125.948288418652,127.44645030000031,127.79450060000003,126.23280099999994,127.85650049999992,130.32333333333332,58288400,72059696.8,67.9835580547035,NaN,1.5,2.75,NaN,NaN,1.3843710956307997,0.8088904420702475,185.79802922198124,0.29924304568127114,0.8986150154324832,0.5993719697512121,9.836872014740836,2.1414615084017155,NaN,NaN,NaN,2157429853
1156167000,130.17999,130.28,129.8,130.13,NaN,NaN,122.44217391304348,123.93848149999997,127.4883503000003,127.79550060000001,126.32840079999994,128.05249999999995,127.34515091869812,128.13920740594452,128.43999846153878,130.9670582672364,125.91293865584116,127.4883503000003,127.79550060000001,126.32840079999994,128.05249999999995,130.07000000000002,42133696,69521888,63.82440082481689,NaN,1.5,2.75,NaN,NaN,1.349058874514313,0.606049363906803,183.7331475634506,0.287870740859107,0.9592103958250959,0.6713396549659889,10.25634656651687,2.134840279412918,NaN,NaN,NaN,2115296157
1156253400,129.94,130.52,129.67999,130.12,NaN,NaN,122.44434782608695,123.81873124999997,127.5276003000003,127.79870060000003,126.45100059999993,128.22549999999995,127.45396852972956,128.32785431966408,128.57076769230798,131.25142772231732,125.89010766229866,127.5276003000003,127.79870060000003,126.45100059999993,128.22549999999995,130.10666333333333,60840496,67789719.2,63.7493985913474,NaN,1.5,2.75,NaN,NaN,1.3126982406204342,0.8974885383505172,185.8322545164189,0.25889348846999505,0.9949565155534827,0.7360630270834877,9.639262161818534,2.4728303669869276,NaN,NaN,NaN,2054455661
1156339800,130.17999,130.44,129.19,129.75999,NaN,NaN,122.44652173913043,123.69898099999996,127.5658502500003,127.79800050000003,126.59520039999992,128.37199949999996,127.54440074424997,128.4642481939818,128.6907669230772,131.43324657332434,125.94828727283007,127.5658502500003,127.79800050000003,126.59520039999992,128.37199949999996,129.79666333333333,66610128,66893819.2,60.97151719292408,NaN,1.5,2.75,NaN,NaN,1.308219794861832,0.9957590820289118,182.78965271161857,0.1974739403215049,0.9829054524853689,0.785431512163864,9.51813062354332,1.8764151684069899,NaN,NaN,NaN,1987845533
1156426200,129.99001,130.10001,129.39999,129.64999,NaN,NaN,122.44869565217391,123.57923074999997,127.60295020000031,127.79720040000004,126.71820019999991,128.51899849999995,127.62697287192644,128.57717598503115,128.8215353846157,131.57236467239485,126.07070609683652,127.60295020000031,127.79720040000004,126.71820019999991,128.51899849999995,129.71666333333334,57982896,65430104.8,60.109641662572415,NaN,1.5,2.75,NaN,NaN,1.2647769523717007,0.8861806988883197,183.91540878318705,0.1344448749839019,0.9534876058937414,0.8190427309098395,9.646470744470554,2.0785766536947214,NaN,NaN,NaN,1929862637
1156512600,129.64,130.25,129.55,129.81,NaN,NaN,122.45086956521739,123.45948049999997,127.64085020000032,127.78970040000004,126.79200019999993,128.61049849999995,127.71258177890972,128.69458779598057,129.00615076923106,131.6741666834356,126.33813485502651,127.64085020000032,127.78970040000004,126.79200019999993,128.61049849999995,129.87,41757904,63411140.8,60.973838182651235,NaN,1.5,2.75,NaN,NaN,1.224435741488007,0.658526301107013,185.1314364984367,0.09063606355114429,0.9323378103487698,0.8417017467976255,9.209729337045959,2.1241444418220463,NaN,NaN,NaN,1971620541
1156771800,129.64999,130.82001,129.64,130.42999,NaN,NaN,122.45304347826087,123.33973024999996,127.68105015000032,127.78390040000004,126.90760019999992,128.73949749999994,127.81914680718778,128.85986419636336,129.2715346153849,131.7609561475101,126.7821130832597,127.68105015000032,127.78390040000004,126.90760019999992,128.73949749999994,130.29666666666665,52679504,63565660.8,64.2093050007379,NaN,1.5,2.75,NaN,NaN,1.2212624742388642,0.8287415459385896,188.4122968953174,0.09031893627394505,0.9546004171400568,0.8642814808661118,9.272015136585965,1.399354738396959,NaN,NaN,NaN,2024300045
1156858200,130.49001,130.83,129.81,130.58,NaN,NaN,122.45521739130434,123.21997999999996,127.71725015000032,127.78100040000002,127.04580019999992,128.90749749999995,127.92741555984708,129.02368665385256,129.51845769230798,131.83525842258024,127.2016569620357,127.71725015000032,127.78100040000002,127.04580019999992,128.90749749999995,130.40666666666667,61817008,63395466.4,64.96611970370645,NaN,1.5,2.75,NaN,NaN,1.2068865832218034,0.975101399364419,191.4006463658679,0.08707929762097111,0.9731306028923257,0.8860513052713546,7.132897097594254,0.6086833044674891,NaN,NaN,NaN,2086117053
1156944600,130.87,131.03999,130.55,130.66,NaN,NaN,122.45739130434782,123.10022974999997,127.75175020000033,127.79220050000004,127.17720019999992,129.03649749999994,128.0345757339707,129.1795260201523,129.799227692308,131.67461349027778,127.9238418943382,127.75175020000033,127.79220050000004,127.17720019999992,129.03649749999994,130.74999666666668,50053104,62658746.4,65.38647805448687,NaN,1.5,2.75,NaN,NaN,1.1556796844202444,0.798820705420305,193.6215885690022,0.07751136669006409,0.9829405136339346,0.9054291469438706,5.313269185109733,0.4845035760978201,NaN,NaN,NaN,2136170157
1157031000,130.85001,130.99001,130.58,130.64,NaN,NaN,122.4595652173913,122.98047949999996,127.78650020000033,127.80120040000003,127.28980039999993,129.14749749999993,128.1367492345993,129.3186187801378,130.07076615384648,131.17277904915073,128.96875325854222,127.78650020000033,127.80120040000003,127.28980039999993,129.14749749999993,130.73667,38523008,61399672,65.17593380123499,NaN,1.5,2.75,NaN,NaN,1.1024175641045126,0.6274139054032731,195.94116499210378,0.05792012104300537,0.9778292982476273,0.919909177204622,5.274764049943377,-0.03825847425205553,NaN,NaN,NaN,2097647149
1157117400,131.14,131.58,130.84,131.42,NaN,NaN,122.46173913043478,122.86072924999996,127.82740015000032,127.82900040000004,127.42900019999993,129.30849749999996,128.2655041665758,129.51875032488658,130.28538153846188,131.26088981751295,129.3098732594108,127.82740015000032,127.82900040000004,127.42900019999993,129.30849749999996,131.28,48800000,59024840.8,69.32448622368247,NaN,1.5,2.75,NaN,NaN,1.0908163095256207,0.8267705484433937,198.6827855924939,0.08399558076778901,1.0249036531643583,0.9409080723965693,5.573903489521037,0.9913163759317545,NaN,NaN,NaN,2146447149
1157463000,131.50999,131.85001,131.2,131.67,NaN,NaN,122.46391304347826,122.74097899999997,127.86830010000031,127.85690040000004,127.57360019999994,129.49449749999997,128.39901380710222,129.72363124632597,130.42999769230804,131.60573039352678,129.2542649910893,127.86830010000031,127.85690040000004,127.57360019999994,129.49449749999997,131.57333666666668,52348896,59370565.6,70.53602824399375,NaN,1.5,2.75,NaN,NaN,1.0593301445595056,0.8817314686319916,200.69119487975797,0.10331232327963402,1.0700484764961118,0.9667361532164778,4.662261459568925,1.1912081155856,NaN,NaN,NaN,2198796045
1157549400,131.11,131.16,130.33,130.50999,NaN,NaN,122.46608695652174,122.62122874999996,127.89765005000031,127.87490020000004,127.68399979999992,129.64949699999997,128.48179718721585,129.79852255619969,130.46692000000033,131.6200171374513,129.31382286254936,127.89765005000031,127.87490020000004,127.68399979999992,129.64949699999997,130.66666333333333,53795600,57515439.2,58.90976092727257,NaN,1.5,2.75,NaN,NaN,1.079377991376682,0.9353245102229871,196.25550725828094,0.027161203376393717,1.0006876574369699,0.9735264540605761,7.418962822666602,0.5779901801780349,NaN,NaN,NaN,2145000445
1157635800,130.06,130.57001,129.35001,129.91,NaN,NaN,122.46826086956521,122.50147849999996,127.92155005000029,127.88740020000004,127.80399979999993,129.79599699999997,128.53780514065835,129.80913945560923,130.40692000000033,131.5881712892669,129.22566871073374,127.92155005000029,127.88740020000004,127.80399979999993,129.79599699999997,129.94334,86300624,57884664,53.95598989175552,NaN,1.5,2.75,NaN,NaN,1.0894224205640617,1.4909065378698578,193.24963066107222,-0.06915809341513801,0.8870788372916536,0.9562369307067916,7.763197958960869,0.2005476436982325,NaN,NaN,NaN,2058699821
1157722200,130.08,130.46001,129.83,130.28,NaN,NaN,122.47043478260869,122.38172824999997,127.9441501000003,127.88320020000005,127.91459979999992,129.94149699999997,128.60612650769136,129.85398331697976,130.4184584615388,131.59156685157717,129.2453500715004,127.9441501000003,127.88320020000005,127.91459979999992,129.94149699999997,130.19000333333335,45107696,56673832.8,56.391352756787256,NaN,1.5,2.75,NaN,NaN,1.0566072476666286,0.7959175120409362,195.81668024955772,-0.11100907504920587,0.8174755868952843,0.9284846619444902,7.883409583606575,0.36206763731607644,NaN,NaN,NaN,2103807517
1157981400,129.86,130.69,129.48,130.41,NaN,NaN,122.47260869565217,122.26197799999996,127.9647001000003,127.87780020000004,127.97739979999992,130.11149749999998,128.67686664464463,129.90693728679122,130.44076615384648,131.60128600680355,129.28024630088942,127.9647001000003,127.87780020000004,127.97739979999992,130.11149749999998,130.1933333333333,68497184,57724222.4,57.246978154340624,NaN,1.5,2.75,NaN,NaN,1.0675638728332986,1.1866280939282086,194.09358066887515,-0.13158970153586635,0.7639975350246573,0.8955872365605236,7.876385168795773,-0.015326229803442488,NaN,NaN,NaN,2172304701
1158067800,130.56,131.84,130.3681,131.69,NaN,NaN,122.47478260869565,122.14222774999996,127.9880001000003,127.88340020000005,128.06659979999992,130.34049749999997,128.7950287370115,130.0767527832873,130.5892284615388,131.85264457081226,129.32581235226533,127.9880001000003,127.88340020000005,128.06659979999992,130.34049749999997,131.29936666666666,69888128,58316404,64.60981512614059,NaN,1.5,2.75,NaN,NaN,1.0964450247737776,1.198429999216001,197.85334162791708,-0.0640693781050975,0.8155005139291518,0.8795698920342493,9.272254631782761,0.8500536069842128,NaN,NaN,NaN,2242192829
1158154200,131.64,132.45,131.52,132.22,NaN,NaN,122.47695652173913,122.02247749999995,128.0134501000003,127.89410030000005,128.15499979999993,130.51999749999996,128.92934133556008,130.28087156583138,130.78692153846185,132.19643750560357,129.37740557132014,128.0134501000003,127.89410030000005,128.15499979999993,130.51999749999996,132.06333333333336,62913008,58054564,67.13375518672979,NaN,1.5,2.75,NaN,NaN,1.0845560944327919,1.0836875460816482,200.5636329429505,0.007414166217976859,0.8888375998067204,0.8814234335887435,9.437615473431439,1.1939384662482797,NaN,NaN,NaN,2305105837
1158240600,131.96001,132.24001,131.75,132.23,NaN,NaN,122.4791304347826,121.90272724999996,128.0434501000003,127.90730030000005,128.2581995999999,130.64199799999997,129.058778930244,130.466502845276,130.9730753846157,132.45470619572558,129.49144457350582,128.0434501000003,127.90730030000005,128.2581995999999,130.64199799999997,132.07333666666668,57812192,57357214.4,67.1813134750011,NaN,1.5,2.75,NaN,NaN,1.0420885162590219,1.0079323517496346,198.293249897018,0.044432411531869276,0.9369639480035801,0.8925315364717108,9.455810986151292,1.2170851194121277,NaN,NaN,NaN,2362918029
1158327000,132.31,132.39,131.67999,131.96001,NaN,NaN,122.48130434782608,121.78297699999996,128.0728001500003,127.92320040000004,128.3485997999999,130.73849849999993,129.1725526976854,130.60874162191638,131.09076923076955,132.62334085620026,129.55819760533885,128.0728001500003,127.92320040000004,128.3485997999999,130.73849849999993,132.01,76715680,57643257.6,64.46888286928714,NaN,1.5,2.75,NaN,NaN,1.018368622240519,1.3308699611036556,200.48414012703867,0.039938339395585,0.942454460716192,0.902516121320607,9.614925852377716,0.41090397199819184,NaN,NaN,NaN,2286202349
1158586200,131.78999,132.39,131.64999,132.14,NaN,NaN,122.48347826086956,121.66322674999995,128.10645015000028,127.94060050000003,128.4591997999999,130.81099849999993,129.2889231801291,130.75457575316244,131.21076923076956,132.80752761122184,129.61401085031727,128.10645015000028,127.94060050000003,128.4591997999999,130.81099849999993,132.05999666666665,64155504,57936612.8,65.46979215750034,NaN,1.5,2.75,NaN,NaN,0.9984858635090522,1.1073395716361245,200.10617565402944,0.03828638240673443,0.9503740993290251,0.9120877169222906,9.098910797448694,0.3569529885319351,NaN,NaN,NaN,2350357853
1158672600,132.12,132.13,131.07001,131.81,NaN,NaN,122.48565217391304,121.54347649999995,128.1320501500003,127.94840050000002,128.55839959999992,130.89499849999993,129.3877889377711,130.85509234809936,131.2992307692311,132.89155092529202,129.70691061317015,128.1320501500003,127.94840050000002,128.55839959999992,130.89499849999993,131.67000333333334,92097808,60434818.4,62.02018860818135,NaN,1.5,2.75,NaN,NaN,1.0035933018298335,1.523919661517507,198.16687950201515,0.005868773666039884,0.9194236840048404,0.9135549103388005,9.208817929881498,0.9960999920389348,NaN,NaN,NaN,2258260045
1158759000,132.25,132.77,132.06,132.50999,NaN,NaN,122.48782608695652,121.42372624999996,128.16035005000032,127.95880040000003,128.6603993999999,131.01449799999995,129.5102281951134,131.01270164828037,131.44307615384648,133.10742491398872,129.77872739370423,128.16035005000032,127.95880040000003,128.6603993999999,131.01449799999995,132.44666333333336,75212816,61153434.4,66.10042274865515,NaN,1.5,2.75,NaN,NaN,1.0004794945562747,1.229903385442568,200.78456411389504,0.021585414488005994,0.9405366784488081,0.9189512639608021,7.619681809320047,2.0013778769917567,NaN,NaN,NaN,2333472861
1158845400,132.61,132.75,131.42,131.87,NaN,NaN,122.49,121.30397599999995,128.1868000500003,127.97350050000004,128.7767993999999,131.11999849999992,129.60276826589327,131.0943491103489,131.47769153846184,133.15732878167688,129.7980542952468,128.1868000500003,127.97350050000004,128.7767993999999,131.11999849999992,132.01333333333332,88947008,62270278.4,59.7772605026656,NaN,1.5,2.75,NaN,NaN,1.0240166735165417,1.4284022857363683,198.36646109247056,-0.01891581255022934,0.8953064982730154,0.9142223108232448,7.689114848491549,1.2204482652747954,NaN,NaN,NaN,2244525853
1158931800,131.67,131.67999,131,131.47,NaN,NaN,122.49217391304347,121.18422574999995,128.2100500000003,127.97440050000004,128.92619939999992,131.21099899999993,129.67599303977983,131.13012538555375,131.46230692307722,133.1382763386143,129.78633750754014,128.2100500000003,127.97440050000004,128.92619939999992,131.21099899999993,131.38332999999997,65969184,62669592.8,56.161182277209534,NaN,1.5,2.75,NaN,NaN,1.0130154825510747,1.0526505926172223,195.7110360697516,-0.07717145469302678,0.8177579924569613,0.8949294471499881,8.043984749087596,0.8128211026761769,NaN,NaN,NaN,2178556669
1159191000,131.73,132.85001,131.05,132.48,NaN,NaN,122.49434782608695,121.06447549999996,128.2420500000003,127.99030050000005,129.1053993999999,131.34449899999993,129.78595409704337,131.25868487264387,131.61384615384645,133.2741609240698,129.9535313836231,128.2420500000003,127.99030050000005,129.1053993999999,131.34449899999993,132.12667,92298320,65196613.6,62.35373569479053,NaN,1.5,2.75,NaN,NaN,1.0692293766545684,1.4156919340362795,198.8546570617251,-0.05334256790085634,0.8282512372739177,0.881593805174774,8.92666965093243,0.5998936897258653,NaN,NaN,NaN,2270854989
1159277400,132.5,133.60001,132.39999,133.58,NaN,NaN,122.49652173913043,120.94472524999995,128.2799500000003,128.01250050000004,129.3101993999999,131.50199949999993,129.9347402108848,131.47976250382064,131.89615384615414,133.54965332327671,130.24265436903156,128.2799500000003,128.01250050000004,129.3101993999999,131.50199949999993,133.19333333333336,74016624,66263469.6,67.70442722433731,NaN,1.5,2.75,NaN,NaN,1.0785715640363847,1.117004956830694,201.79857735050106,0.026551330011090668,0.9147829676886374,0.8882316376775468,8.453480812666163,1.0285887157767462,NaN,NaN,NaN,2344871613
1159363800,133.49001,133.97,133.27,133.74001,NaN,NaN,122.49869565217391,120.82497499999995,128.3170000500003,128.02470060000005,129.5055995999999,131.6599999999999,130.08396647712462,131.69502417012345,132.16230846153874,133.80338234294067,130.52123458013682,128.3170000500003,128.02470060000005,129.5055995999999,131.6599999999999,133.66000333333332,82433872,67294312.8,68.40783400970446,NaN,1.5,2.75,NaN,NaN,1.051530738033785,1.2249753147044546,204.17060307213572,0.07734903892236589,0.9849179363305041,0.9075688974081382,8.2908855751423,1.1419571957952224,NaN,NaN,NaN,2427305485
1159450200,133.74001,133.99001,133.28,133.69,NaN,NaN,122.50086956521739,120.70522474999996,128.35320005000028,128.03800060000003,129.6655995999999,131.81149999999994,130.22537955645308,131.88502186820693,132.41461615384645,133.90182713005962,130.9274051776333,128.35320005000028,128.03800060000003,129.6655995999999,131.81149999999994,133.65333666666666,58601600,67721737.6,67.90999187151245,NaN,1.5,2.75,NaN,NaN,1.0271363996028013,0.8653292440033318,205.2786861472099,0.09366764055371435,1.0246534481002811,0.9309858075465668,8.315982087109795,1.3109956569418162,NaN,NaN,NaN,2368703885
1159536600,133.8,133.94,133.48,133.58,NaN,NaN,122.50304347826086,120.58547449999995,128.38455005000029,128.0476006,129.8405995999999,131.95849999999993,130.35693329933727,132.04644835694913,132.56000076923104,134.10388324788724,131.01611829057484,128.38455005000029,128.0476006,129.8405995999999,131.95849999999993,133.66666666666666,47991696,68195172,66.75914616684575,NaN,1.5,2.75,NaN,NaN,0.9866266567740304,0.7037403762248741,203.03435171646277,0.08347804849833795,1.0353333681694892,0.9518553196711512,8.175884522815398,1.0897532919630895,NaN,NaN,NaN,2320712189
1159795800,133.53999,133.83,132.34,133.08,NaN,NaN,122.50521739130434,120.46572424999995,128.4109000500003,128.05290060000004,130.02319959999988,132.04149999999993,130.46372022877503,132.1448818467635,132.62615461538488,134.17976272060054,131.07254651016922,128.4109000500003,128.05290060000004,130.02319959999988,132.04149999999993,133.08333333333334,52444496,68377396.8,61.645324615991534,NaN,1.5,2.75,NaN,NaN,1.0225818955758859,0.7669858528454537,201.40135855460733,0.03212863719491188,0.9920161161647911,0.9598874789698792,8.654487093340792,0.9635080798118582,NaN,NaN,NaN,2268267693
1159882200,132.89,133.87,132.64999,133.36,NaN,NaN,122.50739130434782,120.34597399999996,128.4405000500003,128.07700060000002,130.1661993999999,132.12599999999992,130.5772998276466,132.26060738516696,132.71307769230796,134.2944973526845,131.13165803193144,128.4405000500003,128.07700060000002,130.1661993999999,132.12599999999992,133.29333,73108688,69415386.4,63.33893155252478,NaN,1.5,2.75,NaN,NaN,1.0366839030347512,1.0532058062562337,201.06615779303033,0.00737741969107597,0.9691092535837242,0.9617318338926483,8.43064871078613,0.6414686168190232,NaN,NaN,NaN,2341376381
1159968600,133.23,135,133.08,134.92,NaN,NaN,122.5095652173913,120.22622374999995,128.48330005000028,128.13380050000004,130.3313993999999,132.34650049999993,130.7476017951899,132.51388287229392,132.9407692307695,134.8427776355299,131.03876082600908,128.48330005000028,128.13380050000004,130.3313993999999,132.34650049999993,134.33333333333334,80893312,70770272,71.01751603608203,NaN,1.5,2.75,NaN,NaN,1.0997779099608396,1.1430408519554651,205.0536382005057,0.08226472954402864,1.064562745822684,0.9822980162786554,10.165344996104254,2.312883900811392,NaN,NaN,NaN,2422269693
1160055000,134.92,135.41,134.75,135.17999,NaN,NaN,122.51173913043478,120.10647349999995,128.5306499500003,128.19060040000005,130.49839919999988,132.60999999999996,130.92142094047657,132.76779783683736,133.17461461538488,135.35277951483684,130.99644971593293,128.5306499500003,128.19060040000005,130.49839919999988,132.60999999999996,135.11333,60640000,69487240.8,72.0675464147168,NaN,1.5,2.75,NaN,NaN,1.0683652021064936,0.8726781967719174,208.07483987773085,0.13252672239858,1.1479564192768805,1.0154296968783005,9.2497116112118,2.821928957176546,NaN,NaN,NaN,2482909693
1160141400,134.95,135.10001,134.39999,135.00999,NaN,NaN,122.51391304347825,119.98672324999995,128.5765499000003,128.24760030000004,130.6643987999999,132.84649949999994,131.0817569820265,132.98133994761474,133.42076769230795,135.64911995966892,131.19241542494697,128.5765499000003,128.24760030000004,130.6643987999999,132.84649949999994,134.83666333333335,65001808,70481946.4,70.27470348748477,NaN,1.5,2.75,NaN,NaN,1.0477676876703155,0.9222476296426455,205.37320137957596,0.13697621443804975,1.1866499649258628,1.049673750487813,8.912384967246878,1.9097146739130422,NaN,NaN,NaN,2417907885
1160400600,134.85001,135.3,134.64,135.09,NaN,NaN,122.51608695652173,119.86697299999994,128.62184990000029,128.33000020000006,130.8065987999999,133.08049949999995,131.23894298273134,133.1821647145086,133.61923000000027,135.94519287376946,131.2932671262311,128.62184990000029,128.33000020000006,130.8065987999999,133.08049949999995,135.01,41177904,69115982.4,70.64484425995884,NaN,1.5,2.75,NaN,NaN,1.0200699956938661,0.595779768587938,207.58349924788843,0.1281209264080414,1.2098249084978647,1.0817039820898233,8.369971830750607,1.1304087438239188,NaN,NaN,NaN,2459085789
1160487000,135.11,135.45,134.84,135.27,NaN,NaN,122.51826086956521,119.74722274999995,128.6647499000003,128.42060010000006,130.9549985999999,133.25949949999995,131.39702365007523,133.38100617026967,133.8807684615387,136.12431242478098,131.63722449829643,128.6647499000003,128.42060010000006,130.9549985999999,133.25949949999995,135.18666666666664,56428496,68443000.8,71.50451030684675,NaN,1.5,2.75,NaN,NaN,0.9907792817157317,0.8244597013636492,208.9942423423005,0.11747978351573662,1.2285537114844942,1.1110739279687576,7.339655487076442,1.144003204426258,NaN,NaN,NaN,2515514285
1160573400,134.84,135.42999,134.3,135.11,NaN,NaN,122.52043478260869,119.62747249999995,128.7064999500003,128.50070000000005,131.1127985999999,133.40399949999997,131.54263056575854,133.5456722492916,134.1607684615387,136.00374653009337,132.31779039298405,128.7064999500003,128.50070000000005,131.1127985999999,133.40399949999997,134.94666333333336,104076320,70501166.4,69.55464904997169,NaN,1.5,2.75,NaN,NaN,1.0007229044503219,1.4762354343119066,206.15464886096547,0.08431136179922549,1.2164631302177895,1.132151768418564,7.472399000604953,1.0621587254095415,NaN,NaN,NaN,2411437965
1160659800,135.45,136.39,135.39999,136.28,NaN,NaN,122.52260869565217,119.50772224999994,128.7605499500003,128.60220000000007,131.2767985999999,133.60649949999998,131.7284097592582,133.80608441602575,134.4530761538464,136.34184758892408,132.56430471876874,128.7605499500003,128.60220000000007,131.2767985999999,133.60649949999998,136.02333,59172896,70569201.6,74.93681511421309,NaN,1.5,2.75,NaN,NaN,1.020671268418154,0.8385087921980968,210.42079466250578,0.12344735184572264,1.2864609582257174,1.1630136063799947,8.560037412413498,2.0212606677646265,NaN,NaN,NaN,2470610861
1160746200,136.16,136.71001,136.03999,136.63,NaN,NaN,122.52478260869565,119.38797199999995,128.8149499500003,128.71680000000006,131.4409985999999,133.83999899999998,131.92062898438533,134.07502875735665,134.68769153846182,136.8256557407868,132.54972733613684,128.8149499500003,128.71680000000006,131.4409985999999,133.83999899999998,136.46,53945296,69430682.4,76.28728309437781,NaN,1.5,2.75,NaN,NaN,0.9956247492454303,0.7769662364718454,212.53184220795103,0.15323892733249211,1.35456226554561,1.2013233382131179,8.382333510896508,2.6675683799218386,NaN,NaN,NaN,2524556157
1161005400,136.52,137.05,136.42,136.84,NaN,NaN,122.52695652173912,119.26822174999995,128.8731999500003,128.82350000000005,131.6137985999999,134.074999,132.1135454948016,134.3383593518941,134.92615230769258,137.26975249275478,132.58255212263037,128.8731999500003,128.82350000000005,131.6137985999999,134.074999,136.77,42275904,68336702.4,77.08509769044731,NaN,1.5,2.75,NaN,NaN,0.9695086957279013,0.6186412647268739,215.77396553015265,0.16632814574240662,1.4092335203911261,1.2429053746487195,7.500672573461595,2.609478104379116,NaN,NaN,NaN,2566832061
1161091800,136.47,136.7,135.67,136.41,NaN,NaN,122.5291304347826,119.14847149999994,128.93270000000032,128.91030000000006,131.7829985999999,134.304999,132.28203390677015,134.53565846123752,135.13538307692335,137.48584127729495,132.78492487655174,128.93270000000032,128.91030000000006,131.7829985999999,134.304999,136.26,90785376,68271080.8,71.76103456131975,NaN,1.5,2.75,NaN,NaN,0.9838295031759096,1.3297779226017468,213.4210774167425,0.1270400915249028,1.401705489054848,1.2746653975299451,8.242193728653218,1.104358138155951,NaN,NaN,NaN,2476046685
1161178200,137.03999,137.37,136.10001,136.59,NaN,NaN,122.53130434782608,119.02872124999995,128.9821500000003,128.99240000000006,131.9665985999999,134.50899950000002,132.4509737535635,134.73131003635774,135.3669215384618,137.65097244727383,133.0828706296498,128.9821500000003,128.99240000000006,131.9665985999999,134.50899950000002,136.68667000000002,87371184,68878999.2,72.61373085282327,NaN,1.5,2.75,NaN,NaN,1.0042695386633451,1.2684734826983375,214.82552644188374,0.09562174712601634,1.3941925814374656,1.2985708343114493,5.686993019839606,1.0430611808744767,NaN,NaN,NaN,2563417869
1161264600,136.39,136.88,136.23,136.81,NaN,NaN,122.53347826086956,118.90897099999994,129.02970000000033,129.09949990000007,132.16319859999993,134.7559995,132.6219159593061,134.92928050908557,135.65384461538488,137.63352058318063,133.67416864758914,129.02970000000033,129.09949990000007,132.16319859999993,134.7559995,136.64000000000001,64081808,67635739.2,73.66058592396206,NaN,1.5,2.75,NaN,NaN,0.9789645716159637,0.9474548331690297,217.25405012361452,0.07311775115829189,1.3899680232593141,1.3168502721010222,5.675777009091346,1.3332420808267704,NaN,NaN,NaN,2627499677
1161351000,136.81,136.95,136.33,136.84,NaN,NaN,122.53565217391304,118.78922074999994,129.0770000000003,129.19280000000006,132.35259859999994,135.02449950000002,132.78733101972549,135.11125379393457,135.92153692307718,137.48563433229944,134.35743951385493,129.0770000000003,129.19280000000006,132.35259859999994,135.02449950000002,136.70666666666668,48099504,66742255.2,73.80761795055305,NaN,1.5,2.75,NaN,NaN,0.9533242450719647,0.7206754380094725,215.65477144005362,0.04508878647186454,1.3732112551908529,1.3281224687189883,5.502856338116389,1.2954326745132874,NaN,NaN,NaN,2675599181
1161610200,136.56,137.8,136.39,137.47,NaN,NaN,122.53782608695651,118.66947049999995,129.12215000000032,129.28020000000006,132.56179879999993,135.2739995,132.9709650973833,135.3358962897503,136.11769076923102,137.76742470373068,134.46795683473135,129.12215000000032,129.28020000000006,132.56179879999993,135.2739995,137.22,66234000,65439039.2,76.74359342199995,NaN,1.5,2.75,NaN,NaN,0.9859439418525404,1.012148112345757,217.59126311315734,0.053254034899213654,1.3946900123430055,1.3414359774437918,5.773896946052151,1.6263768758778654,NaN,NaN,NaN,2741833181
1161696600,137.28,137.92999,137.22,137.88,NaN,NaN,122.53999999999999,118.54972024999994,129.16770000000034,129.36900000000006,132.77719879999995,135.48899950000003,133.16347627003495,135.57819188120266,136.32538384615407,138.12375485135667,134.52701284095147,129.16770000000034,129.36900000000006,132.77719879999995,135.48899950000003,137.67666333333332,53355392,64405977.6,78.43755451480939,NaN,1.5,2.75,NaN,NaN,0.9662329460059308,0.8284229816581496,219.4008237791538,0.06951581633526471,1.4283307478628728,1.3588149315276081,5.807731005374719,2.0501813337280597,NaN,NaN,NaN,2795188573
1161783000,137.74001,138.41,137.50999,138.35001,NaN,NaN,122.54217391304347,118.42996999999994,129.21495010000032,129.48130010000006,132.97159899999994,135.71949950000004,133.3668697496414,135.84217455918335,136.5823084615387,138.505580203098,134.6590367199794,129.21495010000032,129.48130010000006,132.97159899999994,135.71949950000004,138.09,80750816,64321824.8,80.21653469762794,NaN,1.5,2.75,NaN,NaN,0.9615027355769364,1.255418611817742,222.53293593906739,0.0936711357497384,1.475903851214781,1.3822327154650427,5.502624844824049,1.518938949222187,NaN,NaN,NaN,2875939389
1161869400,138.66,139,137.98,138.78,NaN,NaN,122.54434782608695,118.31021974999994,129.2623001000003,129.60100010000005,133.15139919999993,135.97399950000005,133.57914936730253,136.12196745830875,136.86615461538486,138.91006770774996,134.82224152301976,129.2623001000003,129.60100010000005,133.15139919999993,135.97399950000005,138.58666666666667,66848368,64734163.2,81.7037413765782,NaN,1.5,2.75,NaN,NaN,0.9656811116071561,1.0326597996403852,225.82220289515863,0.11874023171524839,1.5306580051091032,1.4119177733938548,3.885073435803318,1.5735929151723675,NaN,NaN,NaN,2942787757
1161955800,138.61,138.75,137.63,137.91,NaN,NaN,122.54652173913043,118.19046949999994,129.3078501000003,129.72150010000004,133.30899919999993,136.19049950000004,133.74898664701615,136.29225627180315,137.0692315384618,138.95708077654123,135.18138230038235,129.3078501000003,129.72150010000004,133.30899919999993,136.19049950000004,138.09666666666666,80239376,66346547.2,70.20426560473527,NaN,1.5,2.75,NaN,NaN,0.9788467464923596,1.209397917243838,222.53422314905148,0.05983494389187016,1.4867114532586925,1.4268765093668223,6.001246505446038,0.7819351066939442,NaN,NaN,NaN,2862548381
1162218600,137.66,138.2,137.39999,137.81,NaN,NaN,122.5486956521739,118.07071924999994,129.35350015000031,129.84210010000004,133.45139919999997,136.42699950000002,133.90824207262335,136.4368032935362,137.2769238461541,138.81937926978281,135.73446842252537,129.35350015000031,129.84210010000004,133.45139919999997,136.42699950000002,137.80333,49718096,66210227.2,69.0021012538479,NaN,1.5,2.75,NaN,NaN,0.9660726931714757,0.7509126324218383,223.57782695840208,0.00038727688695283646,1.4273606054755135,1.4269733285885606,6.057941650826406,1.0263177186423325,48.28051477816124,20.36548587860226,31.35399934323651,2812830285
1162305000,138.07001,138.25999,137.25,137.78999,NaN,NaN,122.55086956521738,117.95096899999994,129.4008001000003,129.96649990000003,133.60459899999995,136.64849900000002,134.0604674815401,136.56567821796133,137.3930769230772,138.8423513435143,135.94380250264007,129.4008001000003,129.96649990000003,133.60459899999995,136.64849900000002,137.76666,71297184,66119652,68.74841623894083,NaN,1.5,2.75,NaN,NaN,0.9692096436592266,1.0783054938038694,224.63021798920786,-0.05118010569792775,1.362998196466151,1.4141783021640788,5.586938348778917,0.8785342997291057,23.602629393853803,44.127650042102395,32.2697205640438,2741533101
1162391400,138.22,138.31,136.72,136.86,NaN,NaN,122.55304347826086,117.83121874999993,129.44600005000032,130.09519980000005,133.73939899999996,136.74549900000002,134.1702530704993,136.59370886386978,137.4107692307695,138.82760248280314,135.99393597873583,129.44600005000032,130.09519980000005,133.73939899999996,136.74549900000002,137.29666666666665,83006496,66225311.2,58.063906002517676,NaN,1.5,2.75,NaN,NaN,1.0135518119692821,1.2533953332332548,221.35404135579304,-0.15306117917583917,1.2228518281942797,1.375913007370119,7.13266074046499,0.03654703603538584,4.292883921894584,77.472073805582,18.23504227252342,2658526605
1162477800,136.50999,137.00999,136.36,136.78,NaN,NaN,122.55521739130434,117.71146849999994,129.4883500500003,130.23749980000005,133.87979919999995,136.82549950000003,134.27259608734246,136.61145087683457,137.4061538461541,138.83076379470344,135.98154389760475,129.4883500500003,130.23749980000005,133.87979919999995,136.82549950000003,136.71666333333334,60703904,66228506.4,57.23979374525865,NaN,1.5,2.75,NaN,NaN,0.9875831111143316,0.9165827118819035,219.6462162281331,-0.2265438916883593,1.0927331427596698,1.3192770344480291,7.08483254897789,-0.04384682841274647,0,100,0,2597822701
1162564200,137.27,137.39,135.62,136.53999,NaN,NaN,135.62,117.59171824999994,129.5412000000003,130.36789970000007,134.01759919999998,136.90199950000004,134.36151349568198,136.6046450790408,137.41615307692334,138.8142326846576,136.01807346918906,129.5412000000003,130.36789970000007,134.01759919999998,136.90199950000004,136.51666333333333,71346368,66545734.4,54.73004655518209,NaN,1.5,2.75,NaN,NaN,1.0434700317490209,1.0721403654687145,218.12838966743706,-0.28807010153428303,0.9591894075301752,1.2472595090644583,7.15045812328055,-0.6765185131301448,0,100,0,2526476333
1162823400,136.96001,138.28,136.95,138.08,NaN,NaN,135.7918181818182,117.47196799999993,129.59950000000032,130.48749970000006,134.18299919999995,137.05149950000003,134.50733649585132,136.74515507151312,137.5307684615387,138.88268144505741,136.17885547802,129.59950000000032,130.48749970000006,134.18299919999995,137.05149950000003,137.77,63312704,67652474.4,65.25654271371371,NaN,1.5,2.75,NaN,NaN,1.0932228866240916,0.9358520078018018,222.1987173652481,-0.22462361357667815,0.9664799920936105,1.1911036056702886,9.423494287394199,0.14505366985785978,4.022760988528312,78.24385624416335,17.73338276730835,2589789037
1162909800,138.2,138.98,138,138.61,NaN,NaN,135.96363636363637,117.35221774999994,129.65980000000033,130.62709980000005,134.34659939999995,137.21849950000004,134.6682252607199,136.92275935041664,137.66923000000025,139.06548059388257,136.27297940611794,129.65980000000033,130.62709980000005,134.34659939999995,137.21849950000004,138.53,63363200,67999209.6,68.01319309473962,NaN,1.5,2.75,NaN,NaN,1.0851355375795129,0.9318225957732309,223.97774756555617,-0.15011714547883592,1.0034571738217437,1.1535743193005796,9.519448547040986,0.18792192353294096,18.62968007170515,50.66242557239688,30.70789435589797,2653152237
1162996200,138,139.05,136.86,138.91,NaN,NaN,136.13545454545454,117.23246749999993,129.72105000000033,130.77949980000005,134.51319939999996,137.4084995,134.83456936814267,137.11202036466267,137.82846076923104,139.28111946710266,136.37580207135943,129.72105000000033,130.77949980000005,134.51319939999996,137.4084995,138.27333333333334,87519632,67171375.2,69.48888859430005,NaN,1.5,2.75,NaN,NaN,1.1640544277524048,1.3029304780408901,226.47148973346367,-0.08692016360825372,1.0449241147902626,1.1318442783985163,9.408572773454441,0.09367343997693864,51.17156919744495,18.26781810898534,30.560612693569713,2740671869
1163082600,139.00999,139.14,137.89999,138.17999,NaN,NaN,136.30727272727273,117.11271724999993,129.77514995000033,130.92039970000005,134.66359919999996,137.503499,134.96576233409786,137.2137317585043,137.88307538461567,139.33109887005926,136.43505189917207,129.77514995000033,130.92039970000005,134.66359919999996,137.503499,138.40666,95917680,69008614.4,61.993960287982226,NaN,1.5,2.75,NaN,NaN,1.1694798257700891,1.3899377756525422,224.36900202946762,-0.09965936209532522,1.0072700757793598,1.106929437874685,9.749386366665668,0.19577260532231677,42.71989292375032,24.767105962367364,32.51300111388231,2644754189
1163169000,138.14,138.34,137.72,138.24001,NaN,NaN,136.47909090909093,116.99296699999994,129.8236500500003,131.05269990000005,134.81559939999997,137.5839995,135.09416420334892,137.31147254340866,137.91076846153874,139.37121434959892,136.45032257347856,129.8236500500003,131.05269990000005,134.81559939999997,137.5839995,138.10000333333335,48992000,68760949.6,62.35348501179182,NaN,1.5,2.75,NaN,NaN,1.1302312667865118,0.7124974318272068,227.2578909183565,-0.1086810646759333,0.9710781070297685,1.0797591717057018,9.008962772205045,0.31203105725274655,67.34705276076704,8.59897072218392,24.053976517049048,2693746189
1163428200,138.17999,139.03999,138.07001,138.58,NaN,NaN,136.6509090909091,116.87321674999993,129.87435005000034,131.19389980000003,134.95879939999995,137.6709995,135.23086364635486,137.43228468213164,137.92846000000026,139.41509802122107,136.44182197877944,129.87435005000034,131.19389980000003,134.95879939999995,137.6709995,138.56333333333336,59403504,69617329.6,64.40743679480462,NaN,1.5,2.75,NaN,NaN,1.1187847477303319,0.8532861622431436,228.2400853402267,-0.096785042815974,0.9587778681857344,1.0555629110017084,9.069017296059949,0.5733435353323008,67.72449917963556,8.438362041785416,23.83713877857902,2753149693
1163514600,138.97,139.74001,138.12,139.62,NaN,NaN,136.82272727272726,116.75346649999993,129.93495005000034,131.34569980000003,135.11779939999994,137.8314995,135.40298664061547,137.64063852192862,137.99307538461565,139.6814711864451,136.3046795827862,129.93495005000034,131.34569980000003,135.11779939999994,137.8314995,139.16000333333332,96704192,69913270.4,69.82987333409366,NaN,1.5,2.75,NaN,NaN,1.1545865514638802,1.3832022368102521,231.67333948790542,-0.027508210104310038,1.0211776483713209,1.048685858475631,9.870285564631063,2.0166593599298483,70.99838346633626,6.912194516465252,22.089422017198483,2849853885
1163601000,139.57001,140.45,139.53,140.02,NaN,NaN,136.99454545454546,116.63371624999994,129.99310005000035,131.49599970000006,135.30799959999996,138.0029995,135.5840459880423,137.86724437698305,138.15538307692333,140.1572102340688,136.15355591977786,129.99310005000035,131.49599970000006,135.30799959999996,138.0029995,140,76518192,69370620.8,71.62067934552856,NaN,1.5,2.75,NaN,NaN,1.1378303692164593,1.1030345572458824,234.02184197194197,0.03332158908477112,1.0903378448315948,1.0570162557468237,8.42643888213595,2.368767363649663,70.06584549733115,7.332681569227115,22.60147293344174,2926372077
1163687400,140.44,140.67999,139.49001,140.38,NaN,NaN,137.16636363636366,116.51396599999993,130.06050010000033,131.66069970000004,135.51739959999998,138.1814995,135.77212261596222,138.106554436318,138.35307538461564,140.66327521925072,136.04287554998055,130.06050010000033,131.66069970000004,135.51739959999998,138.1814995,140.18333333333334,76740128,70003536.8,73.16453847967296,NaN,1.5,2.75,NaN,NaN,1.1415553428438545,1.0962321549444913,235.12208118038234,0.08303949952364187,1.160815630151376,1.077776130627734,8.226226495774599,2.812370207438866,100.00000000000001,0,0,3003112205
1163773800,139.92999,140.42999,139.73,140.42,NaN,NaN,137.33818181818182,116.39421574999993,130.13125010000033,131.81739970000004,135.72019959999997,138.3604995,135.95439231729702,138.3268825852401,138.55538384615411,141.08328139673338,136.02748629557485,130.13125010000033,131.81739970000004,135.72019959999997,138.3604995,140.19332999999997,56357296,70416426.4,73.33809424276744,NaN,1.5,2.75,NaN,NaN,1.1100149612121517,0.8003430290520962,233.7336609113811,0.10257548210857292,1.2059954832634503,1.1034200011548774,7.908951609958122,1.694669756662786,100.00000000000001,0,0,3059469501
1164033000,140.3,140.74001,139.94099,140.5,NaN,NaN,137.51,116.27446549999993,130.20075005000032,131.94969970000002,135.9219996,138.5119995,136.1326514421089,138.53384614855057,138.83538384615412,141.3564562788344,136.31431141347383,130.20075005000032,131.94969970000002,135.9219996,138.5119995,140.3936666666667,69185504,70564001.6,73.7043866821009,NaN,1.5,2.75,NaN,NaN,1.0878010354112846,0.9804645772810028,234.66982569088415,0.10448882482706634,1.2340310321887102,1.129542207361644,5.864775124992313,1.3635379842724091,100,0,0,3128655005
1164119400,140.49001,140.67,140.28999,140.64,NaN,NaN,137.6818181818182,116.15471524999992,130.27655005000034,132.08379970000004,136.1009996,138.64999949999998,136.30941020908503,138.734432229641,139.13230692307718,141.52088769357968,136.74372615257468,130.27655005000034,132.08379970000004,136.1009996,138.64999949999998,140.53332999999998,51371392,70464801.6,74.36804006589487,NaN,1.5,2.75,NaN,NaN,1.037244532881907,0.7290362114636253,237.08862181967294,0.09884724635895248,1.2531012653103346,1.1542540189513821,5.718659482887413,1.2454106975739614,100,0,0,3180026397
1164205800,140.75,141.16,140.5,140.92,NaN,NaN,137.85363636363638,116.03496499999993,130.34805005000032,132.21499970000005,136.2749996,138.77849899999998,136.490217651866,138.94258154110375,139.46923076923105,141.5105194653633,137.4279420730988,130.34805005000032,132.21499970000005,136.2749996,138.77849899999998,140.85999999999999,45508704,68702696,75.68953630066827,NaN,1.5,2.75,NaN,NaN,1.0102984948189135,0.6624005555764507,239.4325752422176,0.0974753105850783,1.2760981571827301,1.1786228465976518,5.711693118749337,1.9829282083462185,100,0,0,3225535101
1164378600,140.24001,140.84,140.2,140.35001,NaN,NaN,138.02545454545455,115.91521474999993,130.41775010000032,132.34779970000005,136.4373998,138.85699949999997,136.64158205767518,139.07662234671292,139.6438469230772,141.56472196533517,137.72297188081924,130.41775010000032,132.34779970000005,136.4373998,138.85699949999997,140.46333666666666,30998192,66910187.2,68.00339128372758,NaN,1.5,2.75,NaN,NaN,0.9895628880461339,0.46328060490017575,240.79317792831722,0.04438488125706175,1.234103948168979,1.1897190669119173,5.211142294557392,1.526330908106839,87.05048291491153,1.5149056058718335,11.43461147921665,3194536909
1164637800,140.28,140.35001,138.38,138.42,NaN,NaN,138.19727272727272,115.79546449999992,130.4766501000003,132.45759970000006,136.56659960000002,138.8824995,136.71132393776634,139.0140868851212,139.62923153846182,141.58394244949622,137.67452062742743,130.4766501000003,132.45759970000006,136.56659960000002,138.8824995,139.0500033333333,84547376,67125587.2,49.626767522424906,NaN,1.5,2.75,NaN,NaN,1.0595948246142675,1.2595402070464121,235.98595679755988,-0.12523307111161808,1.0331777280223946,1.1584107991340127,10.28936439516807,-0.11545677586955189,45.79960678567414,22.272202777484022,31.928190436841835,3109989533
1164724200,138.24001,139.16,138.11,139.02,NaN,NaN,138.36909090909091,115.67571424999993,130.53970010000032,132.58169970000006,136.7041996,138.94299949999998,136.80186025393238,139.01465003891917,139.63769307692334,141.5807949758273,137.69459117801938,130.53970010000032,132.58169970000006,136.7041996,138.94299949999998,138.76333333333332,106667680,69973066.4,53.80600500216014,NaN,1.5,2.75,NaN,NaN,1.0589094799989616,1.524410540910638,238.5515790578347,-0.1972518049289722,0.9118460429727975,1.1090978479017697,10.497239881306074,-0.4297378599054536,52.64671948033675,17.237850949677814,30.11542956998544,3216657213
1164810600,139.47,140.53,139.08279,140.47,NaN,NaN,138.5409090909091,115.55596399999993,130.60330010000033,132.71789960000004,136.87739960000002,139.077,136.9457088714252,139.15325479711734,139.81384769230797,141.60573427344576,138.02196111117019,130.60330010000033,132.71789960000004,136.87739960000002,139.077,140.02759666666668,91542000,70985307.2,62.00910785496152,NaN,1.5,2.75,NaN,NaN,1.0911302314276066,1.2895908126745417,242.8793648346182,-0.14962730732899354,0.9220637137405276,1.0716910210695212,11.318477322459088,0.32138265962004614,58.6272762359229,13.377019931941925,27.995703832135167,3308199213
1164897000,140.44,141.05,139.75999,140.53,NaN,NaN,138.71272727272728,115.43621374999992,130.6649501000003,132.84909960000005,137.03779980000002,139.2605,137.0862693078399,139.28437338786807,139.99000076923105,141.56556486361376,138.41443667484833,130.6649501000003,132.84909960000005,137.03779980000002,139.2605,140.4466633333333,83997680,71034866.4,62.307382857892044,NaN,1.5,2.75,NaN,NaN,1.1053359291827791,1.1824852253118334,245.90663812285035,-0.11787482681780448,0.9243474875472657,1.0422223143650702,11.227170742469315,0.10685282803818613,63.19274376121206,10.750786653689564,26.056469585098377,3392196893
1164983400,140.53,140.66,138.97,140.22,NaN,NaN,138.88454545454545,115.31646349999993,130.72025010000033,132.99079960000006,137.20479980000002,139.43249999999998,137.20916070753245,139.37348068426158,140.1161546153849,141.4664494401217,138.76585979064808,130.72025010000033,132.99079960000006,137.20479980000002,139.43249999999998,139.95000000000002,126156688,74307505.6,59.69941307790233,NaN,1.5,2.75,NaN,NaN,1.1470976485268662,1.6977650774486501,244.3752211008612,-0.12107901166128299,0.8908735497884663,1.0119525614497493,11.218638309499323,-0.14242985329724303,43.00617770724376,24.526563711090503,32.46725858166573,3266040205
1165242600,140.25,141.55,140.23,141.28999,NaN,NaN,139.05636363636364,115.19671324999993,130.7826500500003,133.16369950000004,137.4011996,139.67,137.36919322880567,139.55600538099858,140.24461538461566,141.6956526027503,138.793578166481,130.7826500500003,133.16369950000004,137.4011996,139.67,141.02333,87814496,75130912,65.12535941123622,NaN,1.5,2.75,NaN,NaN,1.1601621022035196,1.1688197795336226,248.68136289402793,-0.05768168701069065,0.939850452686386,0.9975321396970767,12.065478751387205,0.562270462633444,69.26220061368531,7.684969219686628,23.052830166628073,3353854701
1165329000,141.56,141.96001,141.25999,141.89999,NaN,NaN,139.22818181818184,115.07696299999992,130.8496999500003,133.34749940000003,137.58959940000003,139.8609995,137.5468715335584,139.77924201137967,140.38923000000025,142.0772733181475,138.70118668185302,130.8496999500003,133.34749940000003,137.58959940000003,139.8609995,141.70666333333335,73380688,75634311.2,67.7880230185608,NaN,1.5,2.75,NaN,NaN,1.127294809188984,0.9702036924215421,250.86266170806718,0.01491276204088332,1.0161730922481809,1.0012603302072975,12.24890986691347,0.8958973265074064,66.82958425547345,8.858492115899907,24.311923628626644,3427235389
1165415400,141.87,142.07001,141.5,141.78,NaN,NaN,139.4,114.95721274999993,130.9122499500003,133.53189940000004,137.7535994,140.0194995,137.71287657145808,139.96979039124827,140.49692230769259,142.3403497227181,138.65349489266708,130.9122499500003,133.53189940000004,137.7535994,140.0194995,141.78333666666666,53324000,75132351.2,66.70909734421798,NaN,1.5,2.75,NaN,NaN,1.0874887513897706,0.709734211006563,249.20357240378377,0.042846023901657926,1.0548178600843698,1.011971836182712,12.29407520446823,0.6102753335225757,45.044432654272036,22.878729268537782,32.07683807719019,3373911389
1165501800,142.03,142.3,141.11,141.16,NaN,NaN,139.57181818181817,114.83746249999993,130.97264995000032,133.70379940000004,137.9019992,140.13199949999998,137.84805788238128,140.08314368731985,140.55384538461564,142.42967233823111,138.67801843100017,130.97264995000032,133.70379940000004,137.9019992,140.13199949999998,141.52333333333334,62850304,73898884.8,61.281595922074715,NaN,1.5,2.75,NaN,NaN,1.0948109834333584,0.8504905611241376,246.77314512773,0.009315086277136286,1.0236156940291323,1.014300607751996,12.608890850650608,0.5771214408891022,21.760712541763596,46.466158667572145,31.77312879066426,3311061085
1165588200,141.13,141.89999,140.78,141.42,NaN,NaN,139.74363636363637,114.71771224999992,131.0326999500003,133.86109940000003,138.05659920000002,140.29399999999998,137.98813404385652,140.21046333614652,140.6246146153849,142.55558318619273,138.69364604457706,131.0326999500003,133.86109940000003,138.05659920000002,140.29399999999998,141.36666333333332,79624624,73084232,62.65382723588467,NaN,1.5,2.75,NaN,NaN,1.09660948461669,1.0894911504303693,246.09491212941748,-0.004844360474127507,1.0082451571593367,1.0130895176334642,12.337938495969796,2.1673168617251846,59.07185255117512,13.115641981127643,27.812505467697235,3390685709
1165847400,141.42,142.09,141.34,141.83,NaN,NaN,139.91545454545457,114.59796199999992,131.09454990000032,134.03109940000004,138.2215992,140.47349949999997,138.13879545390137,140.36470492318017,140.71615307692335,142.75137109327983,138.68093506056687,131.09454990000032,134.03109940000004,138.2215992,140.47349949999997,141.75333333333333,39779296,72623596.8,64.77398687304728,NaN,1.5,2.75,NaN,NaN,1.0718516642869265,0.5477461562465604,248.2118631164461,0.003463820411954366,1.0174192931484072,1.0139554727364528,8.110981611718326,2.0212919004459806,53.11820326514299,17.001712762422397,29.880083972434637,3430465005
1165933800,141.69,141.87,140.89,141.72,NaN,NaN,140.08727272727273,114.47821174999993,131.16199990000032,134.20879940000003,138.39439920000004,140.63049949999998,138.279234847866,140.49378064478205,140.7776915384618,142.8810799786557,138.6743030982679,131.16199990000032,134.20879940000003,138.39439920000004,140.63049949999998,141.49333333333334,77453504,73526096.8,63.7286632118274,NaN,1.5,2.75,NaN,NaN,1.0652908311235758,1.0534151460628058,246.01577914488976,-0.0077743334723643365,1.0042375558959975,1.0120118893683618,8.203177224950517,0.8898697230725422,20.652650203683457,48.03146975093434,31.31588004538219,3353011501
1166020200,142.23,142.34,141.56,141.87,NaN,NaN,140.2590909090909,114.35846149999992,131.22449990000032,134.36539930000004,138.56459920000003,140.74299949999997,138.42004916755755,140.6248491548028,140.8946138461541,143.0580367083307,138.7311909839775,131.22449990000032,134.36539930000004,138.56459920000003,140.74299949999997,141.92333333333332,55568400,71469307.2,64.56836410210991,NaN,1.5,2.75,NaN,NaN,1.044912914614749,0.7775141830394012,244.7702744073307,-0.014064316847414604,0.9944314933090936,1.0084958101565082,6.190191454864964,0.953533053440549,43.1781924952375,24.48953248288653,32.33227502187596,3408579901
1166106600,141.86,143.24001,141.84,143.12,NaN,NaN,140.4309090909091,143.24001,131.2932999000003,134.52999930000004,138.72859920000002,140.89799949999997,138.60436096490824,140.8624825686311,141.25615230769256,143.20477660655538,139.30752800882973,131.2932999000003,134.52999930000004,138.72859920000002,140.89799949999997,142.73333666666667,64779200,70882357.6,70.66337676674317,NaN,1.5,2.75,NaN,NaN,1.0702769921422677,0.9138973673189449,247.4181723729562,0.053308334135439006,1.075131227825807,1.021822893690368,7.599752383090737,2.0681785765226115,71.77458889969301,6.594211945927982,21.631199154379,3473359101
1166193000,142.64,142.89,142.24001,142.34,NaN,NaN,140.6027272727273,143.37244495652175,131.36119995000033,134.68509930000005,138.87179940000004,140.99599949999998,138.75085661334322,141.00319851447574,141.51153692307716,143.04748222385862,139.9755916222957,131.36119995000033,134.68509930000005,138.87179940000004,140.99599949999998,142.49000333333333,70858816,70588292,63.34121875903572,NaN,1.5,2.75,NaN,NaN,1.0566850641321053,1.0038324202546225,246.17431956360906,0.03364815353238715,1.0638830856058519,1.0302349320734647,8.41612812115643,0.7431595118663499,38.18300714149505,28.82862557595643,32.98836728254852,3402500285
1166452200,142.53999,142.88,141.75,141.95,NaN,NaN,140.77454545454546,143.50487991304348,131.43009995000034,134.83749920000002,139.01059960000003,141.07249949999996,138.87631321674152,141.09337008452567,141.62538307692333,143.0510946987208,140.19967145512587,131.43009995000034,134.83749920000002,139.01059960000003,141.07249949999996,142.19333333333333,48956800,70218267.2,59.99383122758162,NaN,1.5,2.75,NaN,NaN,1.0619218452655261,0.6972088881167947,243.21811753485957,-0.01471970270780143,1.0118353036887129,1.0265550063965143,7.740319965989204,0.03524313144770914,20.78332977596174,47.91391912095482,31.30275110308343,3353543485
1166538600,141.55,142.56,141.19,142.22,NaN,NaN,140.94636363636363,143.63731486956522,131.50134995000033,134.97989920000003,139.15319960000005,141.15849949999995,139.007438188634,141.20066817171372,141.75538307692332,143.06100753615036,140.4497586176963,131.50134995000033,134.97989920000003,139.15319960000005,141.15849949999995,141.99,65077504,70012867.2,61.510348624052824,NaN,1.5,2.75,NaN,NaN,1.0839274277465603,0.9295077691090474,244.43666112654947,-0.03639224362939952,0.9810647018597649,1.0174569454891644,7.420507500383209,0.31033996332345726,51.15869816508584,18.403854246761703,30.43744758815247,3418620989
1166625000,142.28,142.66,142.00999,142.14,NaN,NaN,141.11818181818182,143.76974982608698,131.57084990000033,135.12279910000004,139.29059960000004,141.23349949999994,139.13028374986405,141.29012834583622,141.90307538461565,142.87135526255594,140.93479550667536,131.57084990000033,135.12279910000004,139.29059960000004,141.23349949999994,142.26999666666666,41473200,69517957.6,60.77522912113195,NaN,1.5,2.75,NaN,NaN,1.0529333257646638,0.5965825440188134,245.801103183824,-0.06244980472779882,0.9393946895794159,1.0018444943072147,7.40734550550165,0.6942476622272526,28.850571922859338,38.21297996933824,32.93644810780241,3377147789
1166711400,142.27,142.42999,141.32001,141.62,NaN,NaN,141.29000000000002,143.9021847826087,131.6420499000003,135.26679910000004,139.42079960000004,141.26849949999993,139.22791968124193,141.32154469385182,141.92846076923104,142.84715043816124,141.00977110030084,131.6420499000003,135.26679910000004,139.42079960000004,141.26849949999993,141.79,48698400,69677442.4,56.08340055530594,NaN,1.5,2.75,NaN,NaN,1.0570080882100454,0.6989119910635525,243.73893799826655,-0.11782726745270278,0.8545604099913362,0.972387677444039,7.2532484601212195,0.14142271248763758,7.7207319146391535,69.3293156862108,22.949952399150046,3328449389
1166797800,141.64,141.64999,140.67,140.75,NaN,NaN,141.4618181818182,144.03461973913045,131.7028499000003,135.39349910000004,139.51019960000005,141.28849899999994,139.28760910550696,141.26711186586593,141.84000000000026,142.95344234077916,140.72655765922136,131.7028499000003,135.39349910000004,139.51019960000005,141.28849899999994,141.02333,62073200,71231192.8,49.23498738722885,NaN,1.5,2.75,NaN,NaN,1.0515067961950433,0.8714328310391568,241.67029610579718,-0.210746528552891,0.7089545167529252,0.9197010453058162,8.049633795374252,-0.7614750052880296,8.316936345863464,68.07920420212622,23.603859452010315,3266376189
1167143400,140.81,141.61,140.78,141.58,NaN,NaN,141.63363636363636,144.16705469565218,131.7665999000003,135.52509910000003,139.60919960000004,141.44649899999993,139.37750678764394,141.29691073578346,141.82461538461564,142.94644398487463,140.70278678435665,131.7665999000003,135.52509910000003,139.60919960000004,141.44649899999993,141.32333333333335,32697600,68638704,54.89391654473814,NaN,1.5,2.75,NaN,NaN,1.0378277393239697,0.47637263081191045,244.86479438833052,-0.2133549179023151,0.6530073979279223,0.8663623158302374,8.664025828964148,-0.09878633926050406,19.57241503482947,49.36946883346136,31.05811613170916,3299073789
1167229800,141.87,142.60001,141.83,142.50999,NaN,NaN,141.80545454545455,144.29948965217392,131.8282499000003,135.66819900000004,139.72259940000004,141.62099849999993,139.50034926655985,141.41244209428027,141.928460769231,143.03480020807788,140.82212133038414,131.8282499000003,135.66819900000004,139.72259940000004,141.62099849999993,142.31333333333336,39732496,65291944.8,60.24179357707471,NaN,1.5,2.75,NaN,NaN,1.0365550436579707,0.6085359552653423,248.88936680022618,-0.1523540591505539,0.6759197418920451,0.828273801042599,9.459242061529485,0.45111017128355757,12.93336144249292,59.37848795612254,27.68815060138453,3338806285
1167316200,142.41,142.7,141.99001,142.21001,NaN,NaN,141.97727272727275,144.43192460869565,131.8855000000003,135.81079910000005,139.83859960000004,141.70799899999994,139.6066104717928,141.48840094244406,141.989230769231,143.06350137089805,140.91496016756395,131.8855000000003,135.81079910000005,139.83859960000004,141.70799899999994,142.3000066666667,37291104,62579400,57.85884453472709,NaN,1.5,2.75,NaN,NaN,1.013228969110971,0.5959006318373139,247.17863435341073,-0.13282848806672987,0.6622381909591866,0.7950666790259164,9.571217963137718,-0.6358230855226338,13.46958593078423,58.48702162462147,28.04339244459429,3301515181
1167402600,142.10001,142.53999,141.42999,141.62,NaN,NaN,142.14909090909092,144.56435956521742,131.9384500000003,135.95289910000005,139.93919960000002,141.76249899999993,139.68556692387935,141.50093418602083,141.97307692307717,143.0626457755005,140.88350807065385,131.9384500000003,135.95289910000005,139.93919960000002,141.76249899999993,141.86332666666667,45466704,60652851.2,53.385884105269014,NaN,1.5,2.75,NaN,NaN,1.0201411856030436,0.7496218743299573,244.49398967055777,-0.15852868052831592,0.5969058283655215,0.7554345088938375,8.123214759328846,-0.5058311086131789,13.906546024038004,57.77323244104347,28.320221534918524,3256048477
1167834600,142.25,142.86,140.57001,141.37,NaN,NaN,142.32090909090908,144.69679452173915,131.9922000000003,136.09679910000006,140.0303996,141.81999899999994,139.7516231229429,141.48846426354265,141.9461538461541,143.07596005046878,140.8163476418394,131.9922000000003,136.09679910000006,140.0303996,141.81999899999994,141.60000333333335,94808496,59085441.6,51.56676754317293,NaN,1.5,2.75,NaN,NaN,1.1108446723456846,1.6045999392175143,245.31931349808843,-0.18916829605049867,0.5189741388307141,0.7081424348812128,7.653135695531808,-0.40859457555476164,11.150752042858334,62.49137288481581,26.357875072325864,3161239981
1167921000,141.23,142.05,140.61,141.67,NaN,NaN,142.49272727272728,144.82922947826088,132.0485000000003,136.23979910000006,140.1269996,141.83899949999994,139.82685358870984,141.5057533813005,141.93076923076947,143.06971426328442,140.79182419825452,132.0485000000003,136.23979910000006,140.1269996,141.83899949999994,141.44333333333336,69634624,58176448,53.6095792115303,NaN,1.5,2.75,NaN,NaN,1.1343557671781357,1.1969555789999418,244.14868530332703,-0.18576679906807558,0.47593393604611833,0.6617007351141939,7.682931547453175,-0.386724792574892,19.88589099147014,48.95857527026644,31.15553373826342,3230874605
1168007400,141.33,141.39999,140.38,140.53999,NaN,NaN,142.66454545454548,144.96166443478262,132.1032499500003,136.37509910000006,140.1883994,141.77099949999996,139.85481972248593,141.41377591641475,141.73230692307715,142.87232697901976,140.59228686713453,132.1032499500003,136.37509910000006,140.1883994,141.77099949999996,140.77332666666666,76688880,58341857.6,45.777413911216,NaN,1.5,2.75,NaN,NaN,1.145473212379697,1.314474429761729,240.12408986762762,-0.25204380167029883,0.34664598302632044,0.5986897846966193,8.723894256641318,-1.1256578021668762,5.892308289215277,73.3494969010736,20.758194809711124,3154185725
1168266600,140.82001,141.41,140.25,141.19,NaN,NaN,140.25,145.09409939130435,132.1572999500003,136.51589910000004,140.25459940000002,141.74149949999997,139.90717973336882,141.39246392437525,141.64384538461562,142.75973396047107,140.52795680876017,132.1572999500003,136.51589910000004,140.25459940000002,141.74149949999997,140.95,69655808,59158448,50.277443135049616,NaN,1.5,2.75,NaN,NaN,1.1465108400668613,1.1774448173488257,242.3547632221235,-0.2443484111654145,0.2932542707398511,0.5376026819052656,9.342128056942785,-0.30362943087135064,20.956447615220565,47.5303454430947,31.513206941684743,3223841533
1168353000,141.31,141.60001,140.39999,141.07001,NaN,NaN,140.3602380952381,145.2265343478261,132.21210000000028,136.64029920000004,140.3089994,141.73699999999997,139.95278092029554,141.3617540268157,141.57615384615409,142.7160475379305,140.43626015437766,132.21210000000028,136.64029920000004,140.3089994,141.73699999999997,141.02333666666667,75681120,59799988.8,49.46140352125406,NaN,1.5,2.75,NaN,NaN,1.150332922919228,1.2655708055918566,244.03000995407172,-0.2392746445146453,0.238509376261959,0.4777840207766043,9.15013742099679,0.22736056838365637,17.5611716524681,52.194309592576644,30.244518754955244,3148160413
1168439400,140.58,141.57001,140.3,141.53999,NaN,NaN,140.47047619047618,145.35896930434785,132.2687499000003,136.75779920000005,140.36419920000003,141.74299949999994,140.01502441361728,141.37872888140467,141.5238453846156,142.6014655503035,140.44622521892774,132.2687499000003,136.75779920000005,140.36419920000003,141.74299949999994,141.13666666666666,72447376,59441126.4,52.699730376647466,NaN,1.5,2.75,NaN,NaN,1.1588812855678536,1.218808935626092,243.16398455028727,-0.19791417370052578,0.23039130365094707,0.42830547735147284,8.562252077464283,-0.028259641192275486,45.784803080568174,22.29683301427127,31.91836390516058,3220607789
1168525800,141.56,142.62,141.5,142.16,NaN,NaN,140.5807142857143,145.4914042608696,132.3294499000003,136.87909920000004,140.4491992,141.75949949999995,140.09914110327935,141.4531356546042,141.52538384615406,142.6065694326254,140.4441982596827,132.3294499000003,136.87909920000004,140.4491992,141.75949949999995,142.09333333333333,55532496,60228786.4,56.646365837727934,NaN,1.5,2.75,NaN,NaN,1.1561040508844358,0.9220258172095595,246.53498386260347,-0.125952433393764,0.27086493560926783,0.39681736900303183,8.258361909515665,-0.24558980040626707,43.398461334870646,24.216196588025618,32.385342077103736,3276140285
1168612200,142.12,143.24001,142.11,143.24001,NaN,NaN,140.69095238095238,145.62383921739132,132.39954995000028,137.00459930000002,140.55779940000002,141.83549999999997,140.22231243256252,141.6233141636895,141.65000000000023,143.06728218793623,140.23271781206424,132.39954995000028,137.00459930000002,140.55779940000002,141.83549999999997,142.86334,57631200,59237671.2,62.51380416030693,NaN,1.5,2.75,NaN,NaN,1.1542401901069759,0.9728809190594919,249.46347954409623,-0.008939567122775327,0.38564291009956264,0.39458247722233797,8.550988383511728,0.7242809419674473,73.03777043564034,6.018108911054427,20.94412065330523,3333771485
1168957800,143.07001,143.44,142.73,142.96001,NaN,NaN,140.80119047619047,145.75627417391306,132.4642000000003,137.13289940000004,140.66119980000002,141.89000049999996,140.32967312148165,141.75061852905242,141.820000769231,143.29373609677668,140.34626544168532,132.4642000000003,137.13289940000004,140.66119980000002,141.89000049999996,143.04333666666665,44988304,58708666.4,60.2376282308292,NaN,1.5,2.75,NaN,NaN,1.1225087479564781,0.7662974950492147,249.35097075400364,0.04340417842584393,0.44883770025464287,0.40543352182879894,8.534586386469822,0.9462011015393352,50.92001365666113,18.565461666135423,30.51452467720344,3288783181
1169044200,142.85001,143.46001,142.73,143.02,NaN,NaN,140.91142857142856,145.8887091304348,132.5303000000003,137.26189940000003,140.78439980000002,141.88500049999996,140.4351761363255,141.871512002476,141.93077000000022,143.5270687471647,140.33447125283575,132.5303000000003,137.26189940000003,140.78439980000002,141.88500049999996,143.07000333333335,51597008,58049556.8,60.568892343559945,NaN,1.5,2.75,NaN,NaN,1.0944731231024456,0.8888441332596014,250.45813219282496,0.07406906693813531,0.4980198555014681,0.4239507885633328,8.004519006415858,1.1671500318313686,82.81208813428407,2.6066270444636803,14.581284821252252,3340380189
1169130600,143.17,143.25999,142.31,142.53999,NaN,NaN,141.02166666666668,146.02114408695653,132.5938499500003,137.38969940000004,140.89959960000004,141.89499999999992,140.5177178564696,141.93517657366877,141.93307769230793,143.53280223229032,140.33335315232554,132.5938499500003,137.38969940000004,140.89959960000004,141.89499999999992,142.70332666666664,68234368,57918334.4,56.51195285812731,NaN,1.5,2.75,NaN,NaN,1.0841529000236985,1.1781134369085033,247.87169542143198,0.054908206874437315,0.49258604715637944,0.4376778402819421,8.25292497543314,0.6140961389143795,48.90735078286344,20.03005927692448,31.06258994021208,3272145821
1169217000,142.53999,143.10001,142.46001,142.82001,NaN,NaN,141.13190476190476,146.1535790434783,132.6593000000003,137.52139960000002,141.02520000000004,141.93850049999995,140.60800382288255,142.01944642379556,141.980000769231,143.6439598849331,140.31604165352888,132.6593000000003,137.52139960000002,141.02520000000004,141.93850049999995,142.79334333333335,56983904,58319689.6,58.26802085929802,NaN,1.5,2.75,NaN,NaN,1.0524276928791476,0.9770954610842099,251.3132293591051,0.05390016895589189,0.505053051476807,0.4511528825209151,8.244401038796287,1.6223282782359723,49.2658608703263,19.764928379588294,30.9692107500854,3329129725
1169476200,143.07001,143.10001,141.92999,142.38,NaN,NaN,141.24214285714285,146.28601400000002,132.7184000000003,137.64709960000002,141.11120000000005,141.94650049999996,140.677493869044,142.05378485962456,142.03846230769253,143.70112355376665,140.3758010616184,132.7184000000003,137.64709960000002,141.11120000000005,141.94650049999996,142.47,60261696,58078899.2,54.5410732970273,NaN,1.5,2.75,NaN,NaN,1.0608271433877794,1.0375833018543161,248.47140787155726,0.018249329426157868,0.47396454430361246,0.4557152148774546,6.651828310270193,0.8428358948934045,20.679780558919504,47.935695559120745,31.38452388195975,3268868029
1169562600,142.25999,143.08,142.06,142.8,NaN,NaN,141.35238095238094,146.41844895652176,132.7773500500003,137.7707997,141.19500000000005,141.97950049999997,140.7607294035913,142.12485296823175,142.1484623076925,143.80888261244644,140.48804200293858,132.7773500500003,137.7707997,141.19500000000005,141.97950049999997,142.64666666666668,54077200,58709099.2,57.345592124334516,NaN,1.5,2.75,NaN,NaN,1.0579109188600815,0.9211042365984726,251.26499404551723,0.017596164054102914,0.47771041994508323,0.4601142558909803,6.412854225700419,1.2263343569622027,43.18074419886221,24.43812247478528,32.381133326352504,3322945229
1169649000,142.97,143.98,142.91,143.95,NaN,NaN,141.46261904761906,146.5508839130435,132.8427500500003,137.9044997,141.29580000000004,142.09600049999997,140.8857988387446,142.29867649506681,142.32384692307713,144.21121143610114,140.43648241005312,132.8427500500003,137.9044997,141.29580000000004,142.09600049999997,143.61333333333332,56469392,59097648.8,63.91081520384384,NaN,1.5,2.75,NaN,NaN,1.0666315675129312,0.9555268804534911,254.3938075081913,0.08545989220425981,0.5669391211463051,0.48147922894204526,7.357186953924026,1.7027060691469598,44.29449118028737,23.526767445256805,32.17874137445583,3379414621
1169735400,143.84,143.92,142.00999,142.25999,NaN,NaN,141.57285714285715,146.68331886956523,132.9063500500003,138.02049960000002,141.37740000000005,142.17149999999998,140.9396886882056,142.29499206696522,142.45615461538483,144.04179533229347,140.8705138984762,132.9063500500003,138.02049960000002,141.37740000000005,142.17149999999998,142.72999333333334,73607312,59674354.4,51.392139583261304,NaN,1.5,2.75,NaN,NaN,1.1290157412620077,1.2334831727982634,249.92506081927536,0.011273569252288118,0.4955711905074054,0.48429762125511727,10.722168922076735,0.07033624085536799,42.894186082061964,24.675765467520314,32.430048450417715,3305807309
1169821800,142.57001,142.64999,141.58,142.16,NaN,NaN,141.68309523809523,146.81575382608696,132.96845000000027,138.13569960000004,141.45579980000005,142.20049999999998,140.98754403376617,142.2821356796352,142.53077000000022,143.95403998284124,141.1075000171592,132.96845000000027,138.13569960000004,141.45579980000005,142.20049999999998,142.12999666666667,74585632,61768756,50.758640503824395,NaN,1.5,2.75,NaN,NaN,1.1247996168861492,1.2074977193971659,252.00237095291075,-0.04661233704883394,0.4260321999440748,0.47264453699290876,10.445661796934703,-0.753986264033363,16.74056773815184,53.44364981205984,29.81578244978833,3231221677
1170081000,142.19,142.8,141.74001,142.05,NaN,NaN,141.79333333333332,146.94818878260872,133.0355000000003,138.2419996,141.52519980000005,142.17750049999998,141.02920897361847,142.26002751966993,142.60615384615406,143.79675308675772,141.4155546055504,133.0355000000003,138.2419996,141.52519980000005,142.17750049999998,142.19667,66216000,63092931.2,50.02803401356523,NaN,1.5,2.75,NaN,NaN,1.1201703585371383,1.049499503995148,253.53534192458633,-0.09177955899447676,0.3579200882498128,0.44969964724428957,9.267288200835656,-0.6365486404204922,15.317420723956799,55.52387133666629,29.15870793937692,3165005677
1170167400,142.35001,142.86,142.06,142.78999,NaN,NaN,141.90357142857144,147.08062373913046,133.10504995000028,138.35319950000002,141.58859960000007,142.20649949999998,141.09825920994714,142.3105001368442,142.7023076923079,143.72269364794974,141.68192173666606,133.10504995000028,138.35319950000002,141.58859960000007,142.20649949999998,142.56999666666667,70410624,64748907.2,54.746920514103444,NaN,1.5,2.75,NaN,NaN,1.098015332927343,1.0874411174618248,256.7807400042758,-0.07215365532989787,0.35950757808191725,0.4316612334118151,9.84010361642135,-0.1608236610264448,18.469559539004266,50.879962773274706,30.65047768772102,3235416301
1170253800,142.63,144.13,142.39999,143.75,NaN,NaN,142.01380952380953,147.2130586956522,133.1802499000003,138.4855996,141.66319960000004,142.3129995,141.2022490448512,142.44759536190668,142.82461538461558,143.93303791967674,141.71619284955443,133.1802499000003,138.4855996,141.66319960000004,142.3129995,143.42666333333332,91887872,67069965.6,60.021353429609334,NaN,1.5,2.75,NaN,NaN,1.143157809146818,1.3700301048014851,259.9112351727755,0.0012601170842466702,0.4332363797671235,0.4319762626828768,10.595159828821952,0.848891598771693,25.124970660900587,42.285174237115,32.58985510198441,3327304173
1170340200,144.14999,144.66,143.91,144.61,NaN,NaN,142.12404761904762,147.34549365217393,133.25999990000028,138.63259960000002,141.74779960000004,142.4749995,141.33588633720996,142.6535386607727,142.92999923076943,144.38323142680565,141.4767670347332,133.25999990000028,138.63259960000002,141.74779960000004,142.4749995,144.39333333333335,69316128,65795347.2,64.06231825915484,NaN,1.5,2.75,NaN,NaN,1.126503679922045,1.0535110908267993,263.7596278999122,0.09815333570583401,0.5546679323151693,0.4565145966093353,10.699389379074711,1.2533187751492367,51.30035100973666,18.171856409892936,30.52779258037041,3396620301
1170426600,144.73,144.95,144.38,144.81,NaN,NaN,142.2342857142857,147.47792860869566,133.3305499000003,138.7778996,141.83559960000005,142.63199949999998,141.4721260886919,142.85891593117532,143.07230615384634,144.83812331157503,141.30648899611765,133.3305499000003,138.7778996,141.83559960000005,142.63199949999998,144.71333333333334,49607696,64794000.8,64.94960925579375,NaN,1.5,2.75,NaN,NaN,1.0867534170704698,0.7656217456477854,265.5926581778945,0.1623403442830773,0.6594400269631819,0.4970996826801046,10.694247976001211,1.7067003792667559,77.94004224303933,4.12724451780488,17.932713239155788,3446227997
1170685800,144.7,144.94,144.34,144.85001,NaN,NaN,142.34452380952382,147.6103635652174,133.4000499500003,138.9222997,141.92259980000006,142.84750049999997,141.60459212442947,143.04854393773005,143.21307615384634,145.2156700706202,141.21048223707248,133.4000499500003,138.9222997,141.92259980000006,142.84750049999997,144.71000333333333,45735200,63246316.8,65.13505982890635,NaN,1.5,2.75,NaN,NaN,1.05198531585115,0.7231282755108991,264.2718839941506,0.19208275045859602,0.7372031207533496,0.5451203702947536,10.34945091411867,1.4355812324929873,100,0,0,3491963197
1170772200,144.97,145.03,144.33,144.89,NaN,NaN,142.4547619047619,147.74279852173916,133.46884995000028,139.0542997,142.00759980000004,143.03250049999997,141.73343164896164,143.2239207055653,143.39384615384634,145.53989512403243,141.24779718366025,133.46884995000028,139.0542997,142.00759980000004,143.03250049999997,144.75,57082192,62617636,65.33249541519041,NaN,1.5,2.75,NaN,NaN,1.0268435075760671,0.9115992817103475,266.62912894824103,0.19823772927692307,0.7929175318909074,0.5946798026139843,10.347160704690708,0.6530045154567543,100,0,0,3549045389
1170858600,145.12,145.36,144.57001,145.21001,NaN,NaN,142.565,147.8752334782609,133.53915005000027,139.18419980000002,142.09340000000003,143.23950049999996,141.8697680548847,143.41307206694003,143.5776923076925,145.89801927204027,141.25736534334473,133.53915005000027,139.18419980000002,142.09340000000003,143.23950049999996,145.04667333333336,55694192,61618289.6,66.9456003230402,NaN,1.5,2.75,NaN,NaN,1.0099253998920636,0.9038581298108606,268.2808417985288,0.2067043097697343,0.8530601898261523,0.646355880056418,9.5021658562357,2.073682136488287,100,0,0,3604739581
1170945000,144.78,145.12,144.27,145.02,NaN,NaN,142.6752380952381,148.00766843478263,133.60970005000027,139.31209980000003,142.18679980000005,143.41350099999994,141.99330656253628,143.56611282246956,143.7807692307694,146.10835579915397,141.45318266238485,133.60970005000027,139.31209980000003,142.18679980000005,143.41350099999994,144.8033333333333,70646000,61528220.8,65.01128889046873,NaN,1.5,2.75,NaN,NaN,1.0049314427569163,1.1481885723567031,267.2917710884351,0.18315651943488598,0.8753015293500255,0.6921450099151395,5.413494200649906,2.0118176702307355,68.92945303768843,7.834272517131608,23.236274445179973,3534093581
1171031400,145.06,145.33,143.39,143.94,NaN,NaN,142.78547619047617,148.14010339130436,133.67755005000026,139.4318997,142.29719980000004,143.50250099999997,142.0696474816525,143.6017211250915,143.86846153846173,146.12649808727627,141.61042498964719,133.67755005000026,139.4318997,142.29719980000004,143.50250099999997,144.22,79084880,62705840,55.2411822546438,NaN,1.5,2.75,NaN,NaN,1.071722053988567,1.261204379049862,263.9715156185138,0.08356262238931822,0.7965982879017872,0.713035665512469,7.572718424315264,1.3305174234424402,35.62775721458169,31.092158253963536,33.28008453145477,3455008701
1171290600,143.94,144.03999,143.19,143.45,NaN,NaN,142.8957142857143,148.2725383478261,133.74280010000027,139.54499970000003,142.38579980000003,143.51300049999995,142.12377895296027,143.5872714941304,143.83000000000018,146.09818125721006,141.5618187427903,133.74280010000027,139.54499970000003,142.38579980000003,143.51300049999995,143.55999666666665,65657056,63107132.8,51.46235376152258,NaN,1.5,2.75,NaN,NaN,1.0558840501322402,1.0404062597500865,261.45490414009026,-0.021012658897363146,0.6867698418907651,0.7077825007881282,7.969466997892164,0.46222427776624947,15.709485890464627,54.925899170513695,29.364614939021674,3389351645
1171377000,143.77,144.89999,143.75999,144.66,NaN,NaN,143.00595238095238,148.40497330434783,133.81095010000027,139.67349970000004,142.46959980000003,143.59799999999996,142.22323860186378,143.68943611373703,144.01461615384636,146.12692354588816,141.90230876180456,133.81095010000027,139.67349970000004,142.46959980000003,143.59799999999996,144.43999333333332,64107072,64063071.2,58.933043620138804,NaN,1.5,2.75,NaN,NaN,1.0840344751227955,1.00068683563207,264.6877387340952,-0.014690245683357972,0.6894196936839307,0.7041099393672887,8.760267370012835,0.6330434782608672,17.049638445230315,52.922064034389884,30.028297520379795,3453458717
1171463400,144.8,145.89999,144.78,145.61,NaN,NaN,143.11619047619047,148.5374082608696,133.88165010000026,139.80449980000003,142.57119980000002,143.72749999999996,142.3560527743397,143.8723469600478,144.28000076923098,146.2560932460792,142.30390829238277,133.88165010000026,139.80449980000003,142.57119980000002,143.72749999999996,145.42999666666665,66062368,64786339.2,63.662006032523436,NaN,1.5,2.75,NaN,NaN,1.0951741554711678,1.0196959546681716,267.8541205850371,0.044250152099206685,0.7594226294912971,0.7151724773920904,8.725761588569245,0.6915151096051448,19.086032605795662,50.02485188194598,30.889115512258346,3519521085
1171549800,145.67,145.95,145.42999,145.8,NaN,NaN,143.22642857142856,148.66984321739133,133.95865015000024,139.94379980000002,142.6827998,143.89050049999997,142.49110952828715,144.05593296385277,144.5684623076925,146.22763942180205,142.90928519358295,133.95865015000024,139.94379980000002,142.6827998,143.89050049999997,145.72666333333333,38721696,63310705.6,64.54145162444362,NaN,1.5,2.75,NaN,NaN,1.0540910015089404,0.6116137173489344,269.96424654785244,0.08447845063448989,0.8207705406852028,0.7362920900507129,8.206985569911788,0.6836544437538906,39.4886016882171,27.543076621406968,32.96832169037593,3558242781
1171636200,145.44,145.75999,145.23,145.73,NaN,NaN,143.33666666666667,148.80227817391307,134.03040015000025,140.0863998,142.7716,144.03599999999997,142.61812484090333,144.2153679196763,144.79461692307711,146.20535949814155,143.38387434801268,134.03040015000025,140.0863998,142.7716,144.03599999999997,145.57332999999997,39842800,62453650.4,63.92759700236831,NaN,1.5,2.75,NaN,NaN,1.019513072829732,0.637957905499788,270.6909444821005,0.09408439792202716,0.8538975874532468,0.7598131895312197,8.229771734404958,0.6075180802541831,50.38629618763977,18.825505420356777,30.78819839200345,3518399981
1171981800,145.56,146.2,144.06,146.03999,NaN,NaN,143.44690476190476,148.9347131304348,134.10615010000026,140.22199970000003,142.8544,144.21899949999997,142.75231563145616,144.3891414511357,144.9707700000002,146.38764340434898,143.5538965956514,134.10615010000026,140.22199970000003,142.8544,144.21899949999997,145.43332999999998,56923904,62286760.8,65.49280061602168,NaN,1.5,2.75,NaN,NaN,1.099547853341893,0.9139005347023922,273.11366304136226,0.1080289257709941,0.8948493467449623,0.7868204209739682,8.268611615755743,0.7936986679550021,83.48834989960216,2.398419696747214,14.113230403650633,3575323885
1172068200,145.61,146.07001,145.35001,145.98,NaN,NaN,143.55714285714285,149.06714808695654,134.17925010000025,140.34599970000002,142.9384,144.37799949999996,142.8788914890461,144.5406517891228,145.07615461538484,146.57163360423007,143.5806756265396,134.17925010000025,140.34599970000002,142.9384,144.37799949999996,145.8000066666667,63973392,62781570.4,64.90585815967222,NaN,1.5,2.75,NaN,NaN,1.0724372923889005,1.0189836219834347,271.67994216352184,0.10010431763843075,0.9119508180220066,0.8118465003835759,8.294382476662793,0.5302595874760828,50.155277168363874,19.031162638985894,30.813560192650243,3511350493
1172154600,146.05,146.42,145.17,145.87,NaN,NaN,143.66738095238094,146.42,134.24600010000023,140.46729960000002,143.0326,144.47399949999996,142.9961898620247,144.6672563806349,145.1576930769233,146.70105683742216,143.61432931642443,134.24600010000023,140.46729960000002,143.0326,144.47399949999996,145.82,79079680,63912084.8,63.77719108133919,NaN,1.5,2.75,NaN,NaN,1.0851203429325504,1.2373196751046995,270.47661344700253,0.07546830044487196,0.9061818759396658,0.8307135754947939,8.278121005496232,0.5861260515790886,16.160489095469163,54.296001860734535,29.5435090437963,3432270813
1172241000,145.74001,145.78999,144.75,145.3,NaN,NaN,143.77761904761905,146.49066644444443,134.31070010000022,140.5833996,143.1102,144.62599999999998,143.08653535763156,144.7275176777173,145.1923076923079,146.7266744291174,143.65794095549842,134.31070010000022,140.5833996,143.1102,144.62599999999998,145.27999666666668,71971376,63830288,58.13572587053022,NaN,1.5,2.75,NaN,NaN,1.0876117470087971,1.127542711384915,269.3690635986135,0.012121223657553415,0.8458651050667356,0.8337438814091822,8.608799502674707,0.9448381269973695,4.2325335342062385,77.68268669934623,18.08477976644753,3360299437
1172500200,145.83,145.95,144.75,145.17,NaN,NaN,143.88785714285714,146.56133288888887,134.37345010000024,140.69929960000002,143.17700000000002,144.7765,143.1682398534107,144.76965885126802,145.2138461538464,146.73846374451705,143.68922856317573,134.37345010000024,140.69929960000002,143.17700000000002,144.7765,145.29,70074752,63604744,56.89952694371206,NaN,1.5,2.75,NaN,NaN,1.0956394793653108,1.1017220979617495,268.6085944979841,-0.04411629152481711,0.7785985170031609,0.822714808527978,7.176472863129301,1.1990240501917038,2.7749144998837956,82.28822663651435,14.936858863601849,3290224685
1172586600,143.88,144.2,139,139.5,NaN,NaN,143.99809523809523,146.6319993333333,134.40820010000024,140.76349960000002,143.1326,144.64899999999997,143.0243873101397,144.2677865797187,144.77461461538485,148.18024333943288,141.36898589133682,134.40820010000024,140.76349960000002,143.1326,144.64899999999997,140.9,274909952,74039441.6,28.467134460800608,NaN,1.5,2.75,NaN,NaN,1.4580938022677878,3.713020331584997,262.92235379490677,-0.44639891535204135,0.26471616433792633,0.7111150796899677,24.511346077834283,-3.5669846536706737,0,100,0,3015314733
1172673000,140.39,141.98,139.8,140.92999,NaN,NaN,144.10833333333332,146.70266577777775,134.45810005000024,140.8391995,143.1137998,144.55599999999998,142.94225408229107,143.94990119117406,144.4599984615387,148.4263429905997,140.4936539324777,134.45810005000024,140.8391995,143.1137998,144.55599999999998,140.90332999999998,177549680,79396394.4,37.01532627262887,NaN,1.5,2.75,NaN,NaN,1.5310871021058023,2.23624361460928,265.95836949057565,-0.5903653810344449,-0.02684164660308852,0.5635237344313564,24.830773695935697,-3.2140718357255746,7.414696463363018,70.05657143020841,22.528732106428574,3192864413
1172759400,139.34,141.25,138.05,140.50999,NaN,NaN,144.21857142857144,146.7733322222222,134.51444995000023,140.89509940000002,143.0615996,144.3939995,142.8468711771032,143.62229060153842,144.19615153846178,148.6873672334717,139.70493584345186,134.51444995000023,140.89509940000002,143.0615996,144.3939995,139.9366633333333,212841120,85444056.8,35.66717590985684,NaN,1.5,2.75,NaN,NaN,1.6502951662411012,2.4909997016901944,263.68913497485096,-0.6815938009469162,-0.2884685167522889,0.39312528419462733,24.13899229692057,-3.628264746227725,5.03965813066463,75.65864697720279,19.30169489213258,2980023293
1172845800,140.05,140.66,138.66,138.67,NaN,NaN,144.32880952380953,146.84399866666666,134.5602999500002,140.9299995,142.9881996,144.09699949999998,142.68307230741289,143.15064387758238,143.82845923076945,149.20017574024112,138.4567427212978,134.5602999500002,140.9299995,142.9881996,144.09699949999998,139.33,162600320,90108266.4,30.43707034507942,NaN,1.5,2.75,NaN,NaN,1.6752740829381654,1.8044994815259257,259.2152247147012,-0.824051645256727,-0.6369392723762815,0.18711237288044558,24.497555479687737,-4.844575584985935,4.0444287311302105,78.35861365121919,17.596957617650602,2817422973
1173105000,137.92999,139.58,137.33,137.35001,NaN,NaN,144.4390476190476,146.9146651111111,134.60050000000018,140.9533997,142.8961998,143.724,142.47393260908296,142.59820255590787,143.26615230769255,149.61373175522982,136.91857286015528,134.60050000000018,140.9533997,142.8961998,143.724,138.08667,144137008,94834732,27.339814018439455,NaN,1.5,2.75,NaN,NaN,1.716325934156868,1.5198757349786152,253.6699564614965,-0.9560878591275213,-1.007997451028956,-0.05190959190143474,24.437152186365903,-5.950411253794246,3.58099591585847,79.63886084168274,16.780143242458802,2673285965
1173191400,138.78,140.12,137.717,139.7,NaN,NaN,144.5492857142857,146.98533155555555,134.6647499500002,140.9994997,142.84579979999998,143.4664995,142.36515093813853,142.32218326486904,142.81153692307714,149.26814425064933,136.35492959550496,134.6647499500002,140.9994997,142.84579979999998,143.4664995,139.179,143379312,99716937.6,39.20151826512837,NaN,1.5,2.75,NaN,NaN,1.7915876531456636,1.4378631699977118,258.3880359407553,-0.8382817729438898,-1.099761808081297,-0.2614800351374072,27.508066656081155,-4.301959172489383,17.76919745085549,52.02064423642894,30.210158312715585,2816665277
1173277800,139.59,140.46001,139.39999,139.56,NaN,NaN,144.65952380952382,147.055998,134.73149990000022,141.0423997,142.7941998,143.1999995,142.25514501899585,142.05911819202436,142.33153692307715,148.7558096419968,135.9072642041575,134.73149990000022,141.0423997,142.7941998,143.1999995,139.80666666666667,115224496,102624052.8,38.79519172187595,NaN,1.5,2.75,NaN,NaN,1.7393328207781167,1.122782552980601,257.8413636671647,-0.7270496940407292,-1.1702921526883188,-0.44324245864758954,27.478516940173424,-4.325769520806198,3.5955595474371336,79.5948560893637,16.809584363199157,2701440781
1173364200,140.53999,141.16,140.07001,140.74001,NaN,NaN,144.7697619047619,147.12666444444443,134.79969990000023,141.0986998,142.7766,142.9764995,142.1957279594274,141.933488840403,141.94769153846175,148.10460589860222,135.7907771783213,134.79969990000023,141.0986998,142.7766,142.9764995,140.65667333333332,117892256,105733956,44.058388575482276,NaN,1.5,2.75,NaN,NaN,1.7293804764368221,1.1149895498093347,261.451483752836,-0.5398719971840018,-1.1180824551275919,-0.57821045794359,28.42152765249064,-3.1383275980729515,17.894230162491706,51.841698504494474,30.264071333013817,2819333037
1173450600,141.31,141.42,140.08,140.78,NaN,NaN,144.88,147.19733088888887,134.8729499000002,141.1436998,142.7772,142.7644995,142.14020921592044,141.8236327603646,141.54307692307714,147.2456542060995,135.8404996400548,134.8729499000002,141.1436998,142.7772,142.7644995,140.76,107765632,107589937.6,44.2334089340043,NaN,1.5,2.75,NaN,NaN,1.7015675852627616,1.0016330002964888,263.4242716005003,-0.3864281580897291,-1.0612456555557515,-0.6748174974660224,28.505244012482656,-3.0240407797754267,43.84890413972842,23.95032320637274,32.20077265389885,2927098669
1173706200,140.42,141.34,140.16,140.99001,NaN,NaN,144.99023809523808,147.2679973333333,134.95204995000023,141.1872999,142.76540020000002,142.61700000000002,142.09510336431572,141.74424011652036,141.15923153846177,146.25499816528264,136.0634649116409,134.95204995000023,141.1872999,142.76540020000002,142.61700000000002,140.83000333333334,80371808,107654284,45.202989093747625,NaN,1.5,2.75,NaN,NaN,1.6643127577439933,0.7465732436620915,266.288731096658,-0.2504407999658502,-0.9878684974233352,-0.7374276974574849,28.607055335721814,1.0681075268817293,74.98598662581307,5.237196403988623,19.776816970198297,3007470477
1173792600,140.17999,140.77,138.03999,138.25,NaN,NaN,145.10047619047617,147.33866377777775,135.01244995000025,141.20139989999998,142.68020040000002,142.35700000000003,141.94431499708764,141.4114553435184,140.5730776923079,145.0862385584636,136.05991682615218,135.01244995000025,141.20139989999998,142.68020040000002,142.35700000000003,139.01999666666666,190080624,113875462.4,36.32832616504932,NaN,1.5,2.75,NaN,NaN,1.7561489893337097,1.6691973845280297,260.8656474659573,-0.3202160873205735,-1.1376978066082017,-0.8174817192876283,20.19362012802087,-1.9016463422725025,32.70690868866569,34.0091603315844,33.28393097974992,2817389853
1173879000,138.42999,139.36,136.75,139.28,NaN,NaN,136.75,147.4093302222222,135.07019995000024,141.2300999,142.62160020000002,142.08800000000002,141.8398320560254,141.20845959651666,140.110000769231,143.7363382137862,136.48366332467577,135.07019995000024,141.2300999,142.62160020000002,142.08800000000002,138.46333333333334,231826880,122261452.8,41.016313061758616,NaN,1.5,2.75,NaN,NaN,1.8171383472384457,1.8961567582485002,263.2997797548849,-0.273978610709832,-1.1599549826749183,-0.8859763719650863,19.69320929518056,-0.8753754804195678,67.03785905443905,8.767601069843044,24.194539875717904,3049216733
1173965400,138.97,139.99001,138.8,139.47,NaN,NaN,136.67222222222222,147.47999666666664,135.12564995000025,141.2588999,142.5786002,141.781,141.746897465593,141.04289201589603,139.67153923076944,141.82312745279614,137.51995100874274,135.12564995000025,141.2588999,142.5786002,141.781,139.42000333333337,132413680,125579018.4,41.86660269765404,NaN,1.5,2.75,NaN,NaN,1.7723434652928425,1.0544251873209418,266.77118190839474,-0.21043281104682543,-1.1490173857736181,-0.9385845747267927,19.70526020596405,0.5769092089132555,67.7203989667188,8.4320622265442,23.847538806737006,3181630413
1174051800,139.31,139.63,138.12,138.53,NaN,NaN,136.59444444444443,147.55066311111108,135.18779990000024,141.27609990000002,142.52180020000003,141.41750000000002,141.62074462380505,140.80356896676307,139.59692384615406,141.83276048429394,137.36108720801417,135.18779990000024,141.27609990000002,142.52180020000003,141.41750000000002,138.76,122046192,129745243.2,38.88036585928586,NaN,1.5,2.75,NaN,NaN,1.753604646343353,0.9406602430261581,264.05548678559467,-0.2110040068068061,-1.2023395832353003,-0.9913355764284942,18.53501603057284,0.8591116957326786,44.62690211921377,23.236467767009326,32.1366301137769,3059584221
1174311000,139.25999,140.33,138.5466,140.2,NaN,NaN,136.51666666666668,147.62132955555555,135.25124995000024,141.30969990000003,142.49240020000002,141.14100000000002,141.5650291483617,140.7460862080237,139.54077076923096,141.67418854559023,137.4073529928717,135.25124995000024,141.30969990000003,142.49240020000002,141.14100000000002,139.6922,96213120,132563759.2,46.2196462966911,NaN,1.5,2.75,NaN,NaN,1.7569186001759716,0.7257875046742036,267.896059659529,-0.08468752674234814,-1.0971949848564293,-1.0125074581140812,18.63357982609445,0.35790980672870437,45.37374664255593,22.6739907856835,31.952262571760585,3155797341
1174397400,140.08,141.05,139.96001,140.97,NaN,NaN,136.4388888888889,147.691996,135.31244995000026,141.34469990000002,142.5010004,140.8875005,141.54169467195536,140.76741133106907,139.57615615384637,141.78657308100767,137.36573922668506,135.31244995000026,141.34469990000002,142.5010004,140.8875005,140.66000333333332,83351248,133885126.4,49.24588337054904,NaN,1.5,2.75,NaN,NaN,1.709280843020545,0.622557936353414,271.4505140960724,0.057295094261083035,-0.9408885902877273,-0.9981836845488103,16.294706693015694,1.0103181427343053,77.65153514165205,4.250491938216614,18.097972920131358,3239148589
1174483800,141.10001,143.64999,140.82001,143.28999,NaN,NaN,136.36111111111111,147.76266244444443,135.38389990000027,141.3987998,142.54300020000002,140.753,141.61025527305515,141.0076569185863,139.9315400000002,142.82497489086398,137.03810510913644,135.38389990000027,141.3987998,142.54300020000002,140.753,142.58666333333335,153296944,138351304,57.081968700482726,NaN,1.5,2.75,NaN,NaN,1.7893307828047924,1.1080267375000672,275.9377331831168,0.30044013892462884,-0.6226335108930243,-0.9230736498176532,18.4391575818679,1.811837301986817,74.46014249061209,5.45783507119799,20.082022438189924,3392445533
1174570200,143.48,143.67999,142.78999,143.17999,NaN,NaN,136.28333333333333,147.83332888888887,135.46419985000028,141.44709960000003,142.5851998,140.6184995,141.6718134976412,141.21454578348283,140.38000000000022,143.34037966383735,137.4196203361631,135.46419985000028,141.44709960000003,142.5851998,140.6184995,143.21665666666664,118950624,140344851.2,56.63548280307176,NaN,1.5,2.75,NaN,NaN,1.7250928697473085,0.8475595861403429,276.97126200138064,0.43848471712743775,-0.374967753408356,-0.8134524705357937,18.13702846533527,1.7047805085949725,43.01355290508231,24.58910725258341,32.39733984233429,3273494909
1174656600,143.28,143.81,143.14999,143.39,NaN,NaN,136.20555555555555,147.9039953333333,135.54709985000028,141.4931996,142.62220000000002,140.5229995,141.73919336047882,141.4217318993416,140.66384615384635,143.9935637622464,137.3341285454463,135.54709985000028,141.4931996,142.62220000000002,140.5229995,143.44999666666666,74425744,140467569.6,57.321834200496326,NaN,1.5,2.75,NaN,NaN,1.649015521908215,0.529842896918749,278.78284092094725,0.5228407294214097,-0.15990155875903156,-0.6827422881804412,18.115543233085198,1.702241172973868,71.2226989505782,6.820818386692797,21.956482662728988,3347920653
1174915800,143.5,143.64999,142.09,143.2,NaN,NaN,136.12777777777777,147.97466177777775,135.63379985000026,141.54609960000002,142.643,140.42449949999997,141.796479895362,141.59109076607098,140.94384615384635,144.46202806600616,137.42566424168655,135.63379985000026,141.54609960000002,142.643,140.42449949999997,142.97999666666666,113811504,142654407.2,56.451303107251924,NaN,1.5,2.75,NaN,NaN,1.6426565560576283,0.797812743636006,277.7984262903426,0.5424043436821014,-0.004736858577814473,-0.5471412022599159,18.206895432552717,3.5804701627486355,43.89371931930046,23.801971590568716,32.30430909013084,3234109149
1175002200,143.12,143.16,142.39,142.86,NaN,NaN,136.05,148.0453282222222,135.71934985000027,141.59659960000002,142.6353998,140.59249949999997,141.83818656613212,141.7119392645404,141.1069223076925,144.76590869369323,137.4479359216918,135.71934985000027,141.59659960000002,142.6353998,140.59249949999997,142.8033333333333,100535184,133935668.8,54.84613602494768,NaN,1.5,2.75,NaN,NaN,1.5831810877677979,0.7506229289086882,274.76143749041694,0.5095228823169411,0.08976240063626051,-0.4197604816806806,12.748696635663809,2.5703618609994345,22.29194875131312,45.78041972362409,31.927631525062782,3133573965
1175088600,142.14,142.47,141.25999,141.82001,NaN,NaN,135.97222222222223,148.11599466666664,135.8016998500003,141.63689980000004,142.6125998,140.63700049999997,141.83747375961713,141.72223171553657,141.18692307692328,144.85927314083537,137.5145730130112,135.8016998500003,141.63689980000004,142.6125998,140.63700049999997,141.85,152962064,132706288,50.14889771091214,NaN,1.5,2.75,NaN,NaN,1.5843831529272427,1.1526361433604413,271.7168253769699,0.399660531907862,0.07981518320414693,-0.31984534870371506,13.756987240188915,1.6849573384957321,2.0820554604059365,84.64975125015873,13.26819328943534,2980611901
1175175000,142.53999,142.61,141.19,141.97,NaN,NaN,135.89444444444445,148.18666111111108,135.89159980000028,141.68799980000003,142.5915998,140.71000099999998,141.84267086708311,141.74582869500927,141.26230692307715,144.95556743861903,137.56904640753527,135.89159980000028,141.68799980000003,142.5915998,140.71000099999998,141.92333333333332,139480064,129038235.2,50.803308246858656,NaN,1.5,2.75,NaN,NaN,1.5726414991467266,1.080920424739349,274.25292832870866,0.3223380539555758,0.08307721874075469,-0.2392608352148211,13.761712662511131,2.483216631776509,18.10735921136417,51.40179341015243,30.490847378483416,3120091965
1175261400,142.24001,142.84,140.56,142,NaN,NaN,135.81666666666666,148.25732755555552,135.98884980000028,141.7401998,142.5808,140.87650099999996,141.84884063700142,141.77003548596076,141.55076846153867,144.819220474512,138.28231644856533,135.98884980000028,141.7401998,142.5808,140.87650099999996,141.79999999999998,128208496,127318644,50.94202495306948,NaN,1.5,2.75,NaN,NaN,1.623167106350532,1.0069891727718998,275.92694313790105,0.26107215461199723,0.08707935805017541,-0.17399279656182182,12.723545007952907,1.283880171184031,23.952006657953405,43.70994089198456,32.338052450062044,3248300461
1175520600,142.16,142.46001,140.89,142.16,NaN,NaN,135.73888888888888,148.32799399999996,136.08214980000028,141.7963999,142.56759979999998,141.11700049999996,141.86104296496214,141.8071749634883,141.77230692307714,144.77465334986144,138.76996049629284,136.08214980000028,141.7963999,142.56759979999998,141.11700049999996,141.83667,79428368,124083212,51.72384881009707,NaN,1.5,2.75,NaN,NaN,1.6193701701826384,0.6401217918182195,278.86041602134395,0.22078312739987696,0.10198611268802438,-0.11879701471185258,11.191305219975202,0.8441512378520236,42.53310061068403,24.97912427920436,32.48777511011163,3327728829
1175607000,142.97,143.98,142.91,143.69,NaN,NaN,135.6611111111111,148.3986604444444,136.16999980000028,141.85249990000003,142.59379979999997,141.31650049999996,141.93276677025773,141.98649163363228,142.09692230769252,144.9417733034925,139.25207131189254,136.16999980000028,141.85249990000003,142.59379979999997,141.31650049999996,143.52666666666667,82499312,121039212,58.529836776412196,NaN,1.5,2.75,NaN,NaN,1.6337008723124493,0.6815916151205611,282.495215150028,0.28268100465418844,0.23455424110588297,-0.04812676354830547,12.24041862983494,0.27916116122278245,66.28498795310853,9.157994413600443,24.557017633291014,3410228141
1175693400,143.69,143.95,143.16,143.85001,NaN,NaN,135.58333333333334,148.46932688888887,136.26599990000025,141.90490000000003,142.61479999999997,141.53100099999997,142.00795277926724,142.16396957328635,142.50615384615406,144.61664716747933,140.3956605248288,136.26599990000025,141.90490000000003,142.61479999999997,141.53100099999997,143.65333666666666,64006528,118478313.6,59.17801294093585,NaN,1.5,2.75,NaN,NaN,1.573436524290131,0.5402383445133709,283.8536902309384,0.3173090164879754,0.3485095070616637,0.031200490573688372,8.111746880268521,0.46795645117728657,100,0,0,3474234669
1175779800,143.67,144.44,143.61,144.24001,NaN,NaN,135.50555555555556,148.5399933333333,136.36884995000028,141.9582001,142.62060019999998,141.70600099999996,142.09548443498224,142.36168770916385,142.81692384615405,144.64898778400996,140.98485990829815,136.36884995000028,141.9582001,142.62060019999998,141.70600099999996,144.09667000000002,46843232,114925862.4,60.78677579367434,NaN,1.5,2.75,NaN,NaN,1.5203339154122635,0.407595218532813,285.56842009522103,0.3469837604487168,0.46493019113458445,0.1179464306858676,8.174979393391371,0.5927958713996974,100,0,0,3521077901
1176125400,144.64999,144.8,144.14999,144.44,NaN,NaN,135.42777777777778,148.61065977777776,136.47059995000026,142.02080020000002,142.6642004,141.88900099999995,142.18742622184567,142.559622213053,143.08384692307715,144.76684011891695,141.40085372723735,136.47059995000026,142.02080020000002,142.6642004,141.88900099999995,144.46333,51137744,112094468,61.62201037418976,NaN,1.5,2.75,NaN,NaN,1.4581679214542453,0.45620220972902964,286.160463559772,0.3590814524741018,0.5667982462784948,0.20771679380439306,8.172503164257884,0.8659217877095037,100,0,0,3572215645
1176211800,144.33,144.85001,144.27,144.61,NaN,NaN,135.35,148.6813262222222,136.5686000000003,142.0845001,142.71320039999998,142.07000049999996,142.28242911510662,142.75489628800034,143.18538615384637,145.05482706263066,141.31594524506207,136.5686000000003,142.0845001,142.71320039999998,142.07000049999996,144.57667,56632064,110907480.8,62.3560117397702,NaN,1.5,2.75,NaN,NaN,1.395442355636084,0.5106243834185079,288.3577248071541,0.35679569686124163,0.6537114148809451,0.29691571801970346,8.06795468226451,1.22497550048999,100,0,0,3628847709
1176298200,144.82001,144.86,143.53999,144.02,NaN,NaN,135.2722222222222,148.75199266666664,136.66639995000028,142.13890010000003,142.7526004,142.35850049999996,142.35056914980834,142.87538235580982,143.2500023076925,145.1715724349648,141.32843218042024,136.66639995000028,142.13890010000003,142.7526004,142.35850049999996,144.13999666666666,106552256,106731062.4,58.19599106566433,NaN,1.5,2.75,NaN,NaN,1.3900543302335084,0.998324701394521,284.9816930594589,0.2962998639417727,0.6672905479469193,0.3709906840051466,8.381353189418455,1.5512550027319938,60.19231982705826,12.524265997564713,27.283414175377033,3522295453
1176384600,143.74001,144.92,143.34,144.66,NaN,NaN,135.19444444444446,148.82265911111108,136.76749995000029,142.18930010000003,142.79000059999998,142.62750049999994,142.44113506550212,143.04534594097078,143.34769461538482,145.41165854680423,141.28373068396542,136.76749995000029,142.18930010000003,142.79000059999998,142.62750049999994,144.30666666666664,116447120,100962074.4,61.21841486746031,NaN,1.5,2.75,NaN,NaN,1.4036218780739709,1.1533748755859556,287.66083056578026,0.28031077297984275,0.72137915022995,0.4410683772501073,6.780559230563132,1.8947664999647797,66.67761731313996,8.99149334866782,24.330889338192236,3638742573
1176471000,144.89999,145.32001,144.36,145.32001,NaN,NaN,135.11666666666667,148.89332555555552,136.8691499500003,142.24230020000002,142.8214008,142.92000099999996,142.55403212175693,143.26198061325928,143.51077230769252,145.82243611387912,141.19910850150592,136.8691499500003,142.24230020000002,142.8214008,142.92000099999996,145.00000666666668,85181568,98600468.8,64.10095614793829,NaN,1.5,2.75,NaN,NaN,1.3719353153544003,0.8639063184656989,289.7978870248562,0.29369392670734906,0.8081857856342936,0.5144918589269445,6.9012283896834425,2.338035211267603,70.31158220736724,7.251171451192061,22.437246341440677,3723924141
1176730200,145.83,146.86,145.82001,146.7,NaN,NaN,135.0388888888889,148.96399199999996,136.98309995000028,142.3055002,142.8632008,143.32850099999993,142.71661909737432,143.5894110310441,143.80615692307714,146.6335344957818,140.9787793503725,136.98309995000028,142.3055002,142.8632008,143.32850099999993,146.46000333333333,83206816,96658500,69.24775212563642,NaN,1.5,2.75,NaN,NaN,1.3839392214005157,0.860832891054589,293.2237100991354,0.37006352106651597,0.9770712602600895,0.6070077391935735,7.833755656753163,3.1935846933033147,71.46604664960437,6.683328238776324,21.850625111619316,3807130957
1176816600,146.97,147.39999,146.64999,147.09,NaN,NaN,134.9611111111111,149.0346584444444,137.0947999500003,142.37220020000004,142.9088008,143.67300099999994,142.88812423081063,143.92280045665896,144.21154076923096,147.2841585325864,141.13892300587554,137.0947999500003,142.37220020000004,142.9088008,143.67300099999994,147.04666,108442368,97269962.4,70.53350045738476,NaN,1.5,2.75,NaN,NaN,1.338657848443336,1.1148597709337655,292.0816296176951,0.417886077208905,1.1293653357047049,0.7114792584957998,7.7303431979824735,2.3662050247059683,74.9443148802807,5.240891988352676,19.81479313136662,3915573325
1176903000,146.60001,147.7,146.57001,147.27,NaN,NaN,134.88333333333333,149.10532488888884,137.1947999500003,142.43990020000004,142.9572006,143.98800099999997,143.05996249626904,144.2415813655486,144.61923307692328,147.7985936006493,141.43987255319726,137.1947999500003,142.43990020000004,142.9572006,143.98800099999997,147.1800033333333,88348256,97519812.8,71.13338482794788,NaN,1.5,2.75,NaN,NaN,1.3237530021259543,0.9059518621225245,290.06420551751194,0.430954809127695,1.2501727699054186,0.8192179607777236,6.228331472988648,2.377469421100501,100,0,0,4003921581
1176989400,146.55,147.39999,146.36,147.23,NaN,NaN,134.80555555555554,149.1759913333333,137.29479995000028,142.50580020000004,143.00400059999998,144.18500149999994,143.2234933787683,144.52619266406776,145.02154076923097,148.09518737015924,141.9478941683027,137.29479995000028,142.50580020000004,143.00400059999998,144.18500149999994,146.99666333333334,103342944,95022112.8,70.7885001661728,NaN,1.5,2.75,NaN,NaN,1.303484216259814,1.0875673141210138,287.4569325474481,0.40653331357126254,1.3273846027418017,0.9208512891705392,6.3862651486532025,2.072926922287358,73.53696447833627,5.805298949293023,20.6577365723707,3900578637
1177075800,148.22,148.62,147.0439,148.62,NaN,NaN,134.7277777777778,149.24665777777776,137.3988999500003,142.58280020000004,143.07220039999999,144.45700199999993,143.43512108940484,144.9160790770137,145.51846384615402,148.6687559607463,142.36817173156174,137.3988999500003,142.58280020000004,143.07220039999999,144.45700199999993,148.09463333333332,124128320,95280997.6,75.27472494098564,NaN,1.5,2.75,NaN,NaN,1.3229567722412556,1.302760499224664,291.26624607684124,0.45022657249585607,1.4836345047903592,1.0334079322945031,7.573865086863051,2.893935198006097,75.98754800835079,4.839498981321291,19.172953010327934,4024706957
1177335000,148.37,148.73,147.97,148.06,NaN,NaN,134.65,149.3173242222222,137.5038499000003,142.65990010000004,143.1330004,144.69050199999995,143.61648888982035,145.21550011729812,145.85461769230787,149.08434690223189,142.62488848238385,137.5038499000003,142.65990010000004,143.1330004,144.69050199999995,148.25333333333333,77569312,95438176,70.57232555053608,NaN,1.5,2.75,NaN,NaN,1.2827455742240226,0.8127702692054802,290.65065906559016,0.40885176521989464,1.5444726388193715,1.1356208735994768,8.494817124920687,2.385727128137742,55.72772297921577,15.301533775682826,28.970743245101414,3947137645
1177421400,148.23,148.39999,147.32001,148.12,NaN,NaN,134.57222222222222,149.38799066666664,137.60724990000028,142.75690010000005,143.21660039999998,144.93650199999996,143.79309716865092,145.49211915374593,146.18307846153863,149.39901095224997,142.9671459708273,137.60724990000028,142.75690010000005,143.21660039999998,144.93650199999996,147.9466666666667,114473504,95471276,70.78292391470038,NaN,1.5,2.75,NaN,NaN,1.2682623189223072,1.1990360744733317,289.069520235506,0.35496197354961057,1.5793233405364902,1.2243613669868796,8.54918162308557,2.8468268296069947,56.421755563187375,14.855583875498171,28.722660561314452,4061611149
1177507800,148.73,149.66,148.0233,149.48,NaN,NaN,134.49444444444444,149.45865711111108,137.72159990000029,142.86150010000003,143.33720039999997,145.26750199999995,144.0161129659587,145.87191732957965,146.5861546153848,150.03219057081142,143.14011865995818,137.72159990000029,142.86150010000003,143.33720039999997,145.26750199999995,149.05443333333335,109158944,95902464,75.12786982157412,NaN,1.5,2.75,NaN,NaN,1.2945792961421418,1.138228773767481,292.3107200664461,0.37820695686829464,1.6971200630722478,1.3189131062039532,8.24216749750808,3.3319507811419835,58.57401800226566,13.513674509621296,27.91230748811304,4170770093
1177594200,149.49001,149.8,149.10001,149.64999,NaN,NaN,134.41666666666666,149.52932355555552,137.8355998000003,142.95330000000004,143.43700019999997,145.65900099999993,144.23704932023483,146.23173377438158,146.98692307692323,150.55116386667288,143.4226822871736,137.8355998000003,142.95330000000004,143.43700019999997,145.65900099999993,149.51666666666668,88749440,92691832.8,75.615984642452,NaN,1.5,2.75,NaN,NaN,1.2521086321319899,0.9574677435874372,290.9524757636026,0.3717743140873362,1.7836309988131234,1.4118566847257872,8.353979193263697,2.9796171910530465,84.02503921337006,2.270816771746689,13.704144014883227,4259519533
1177680600,149.09,149.74001,148.84,149.53,NaN,NaN,134.3388888888889,149.59998999999996,137.9461998000003,143.04330000000004,143.5154002,146.03700099999998,144.44461601355894,146.5458543672976,147.36538461538478,150.88424966308048,143.84651956768909,137.9461998000003,143.04330000000004,143.5154002,146.03700099999998,149.37000333333333,108191744,91127416.8,74.50451408742404,NaN,1.5,2.75,NaN,NaN,1.2269587298368483,1.1872578835132743,289.16972008158046,0.32772432496445014,1.8215120909313498,1.4937877659668997,8.641135226385552,1.9291070211315697,53.93242454797691,16.485360011297804,29.582215440725292,4151327789
1177939800,149.64,149.74001,148.21001,148.28999,NaN,NaN,134.26111111111112,149.6706564444444,138.05739975000031,143.12399990000003,143.56519999999998,146.3515005,144.59541499341938,146.71196252279307,147.69384538461554,150.65532158460735,144.73236918462374,138.05739975000031,143.12399990000003,143.56519999999998,146.3515005,148.74667,101012752,89767629.6,64.03002519761579,NaN,1.5,2.75,NaN,NaN,1.248604534848502,1.125269236250391,285.38818600134266,0.19018167528500962,1.7315148600731618,1.5413331847881522,9.638590736624408,0.8158202461078152,47.14593996281901,21.222676196709514,31.631383840471454,4050315037
1178026200,148.42,149.47,147.67,148.67,NaN,NaN,134.18333333333334,149.74132288888885,138.1807497500003,143.19780000000003,143.624,146.6770005,144.75520264073626,146.89844228252707,148.00230692307707,150.42116478554527,145.58344906060887,138.1807497500003,143.19780000000003,143.624,146.6770005,148.60333333333332,134434624,92517942.4,65.6249777322819,NaN,1.5,2.75,NaN,NaN,1.2879899252164668,1.4530654326354753,286.92015818630887,0.10420227942734539,1.6715860340723339,1.5673837546449885,9.633034627390877,0.9506348883003851,49.34072668602597,19.578634395253307,31.080638918720716,4184749661
1178112600,148.89999,149.95,148.75,149.53999,NaN,NaN,134.10555555555555,149.8119893333333,138.31084970000032,143.27420000000004,143.694,146.96949999999998,144.94284136070738,147.15001825561973,148.32692076923092,150.31265659016347,146.34118494829838,138.31084970000032,143.27420000000004,143.694,146.96949999999998,149.41333,87181808,92752067.2,69.01261200745455,NaN,1.5,2.75,NaN,NaN,1.2874192162724334,0.9399446355412335,290.68376096587434,0.08608079496860155,1.6749847483557403,1.5889039533871387,10.015105567242196,1.568966922502207,46.958347568769554,21.36648525796762,31.67516717326284,4271931469
1178199000,149.97,150.39999,149.05,150.35001,NaN,NaN,134.02777777777777,149.88265577777773,138.4458997500003,143.35990010000003,143.7814002,147.2945,145.15488718969925,147.45477937413213,148.60769076923094,150.62579593366718,146.5895856047947,138.4458997500003,143.35990010000003,143.7814002,147.2945,149.93333333333334,87844064,93943944,71.79924882919275,NaN,1.5,2.75,NaN,NaN,1.2918885579672588,0.9350689385576573,292.4935980314915,0.10741795206496896,1.72317639346835,1.615758441403381,10.16940144907264,1.16404925312878,46.90246238372368,21.409428366907573,31.68810924936875,4359775533
1178285400,150.75,151.12,150.22,150.92,NaN,NaN,133.95,149.95332222222217,138.58064975000028,143.45750010000003,143.8824002,147.6284995,145.38097004500517,147.78480038611954,148.90230615384633,151.06146868824894,146.7431436194437,138.58064975000028,143.45750010000003,143.8824002,147.6284995,150.75333333333333,96412256,96422395.2,73.59845495910834,NaN,1.5,2.75,NaN,NaN,1.263896518112455,0.9998948460056507,294.4242126298183,0.13680551112682204,1.7867653303119084,1.6499598191850864,9.157300148015917,1.9316493313521446,76.44722505757991,4.666123773654774,18.886651168765304,4456187789
1178544600,150.88,151.2,150.81,150.95,NaN,NaN,133.87222222222223,150.02398866666664,138.7069497500003,143.55280010000004,143.9954002,147.95399949999998,145.5993633765736,148.08624796839388,149.18538307692324,151.37896447539197,146.99180167845452,138.7069497500003,143.55280010000004,143.9954002,147.95399949999998,150.98666666666665,63688656,97049940.8,73.69358563967717,NaN,1.5,2.75,NaN,NaN,1.2014753382472787,0.6562462117442116,295.70780876864825,0.13492565405410817,1.8186168867527215,1.6836912326986133,8.58122139149242,1.910613016473119,100,0,0,4519876445
1178631000,150.58,150.92,150.13,150.75,NaN,NaN,133.79444444444445,150.09465511111108,138.83654975000027,143.64200010000005,144.10700020000002,148.26099949999997,145.8013491265119,148.33993863807066,149.45615230769246,151.47983845994324,147.4324661554417,138.83654975000027,143.64200010000005,144.10700020000002,148.26099949999997,150.6,81533936,98295034.4,71.83525777207302,NaN,1.5,2.75,NaN,NaN,1.174227099801044,0.8294817382962327,293.8790010108109,0.09856094597655018,1.806892415169301,1.708331469192751,8.749421619179106,0.8496119882258565,77.73880572796,4.2157256173838205,18.04546865465617,4438342509
1178717400,150.64,152.82001,150.37,151.16,NaN,NaN,133.71666666666667,150.16532155555552,138.97259975000028,143.73640010000005,144.3402002,148.61799949999997,146.01149229802124,148.60851591063536,149.6515369230771,151.80112813237042,147.50194571378375,138.97259975000028,143.73640010000005,144.3402002,148.61799949999997,151.45000333333334,102947872,98114815.2,73.32053755899533,NaN,1.5,2.75,NaN,NaN,1.2653544498152545,1.0492591948539898,296.2446574261065,0.08119223405504306,1.8098217617615546,1.7286295277065116,7.44991004172741,1.009027798799047,78.72532726037791,3.8717282384721954,17.402944501149907,4541290381
1178803800,150.73,151.02,149.27,149.58,NaN,NaN,133.63888888888889,150.23598799999996,139.0894497000003,143.81350010000003,144.51320040000002,148.86399949999998,146.1514337765302,148.70103820486057,149.76846000000018,151.71480310912872,147.82211689087163,139.0894497000003,143.81350010000003,144.51320040000002,148.86399949999998,149.95666666666668,153698560,99977387.2,60.155160709245806,NaN,1.5,2.75,NaN,NaN,1.309971989114164,1.5373332340895582,292.0828654057729,-0.05054186343215461,1.6654521984163182,1.7159940618484728,9.993983395418399,0.03343810606568004,38.987073840329536,28.049327790410157,32.963598369260325,4387591821
1178890200,149.75,150.92999,149.72,150.86,NaN,NaN,133.5611111111111,150.3066544444444,139.2104497000003,143.89090010000004,144.7202006,149.140999,146.33608343235255,148.90665361392146,149.97922923076942,151.75152447250997,148.20693398902887,139.2104497000003,143.89090010000004,144.7202006,149.140999,150.50333,113413120,101388964.8,65.55167498943769,NaN,1.5,2.75,NaN,NaN,1.3128304184631516,1.1185943186590264,296.08837631538967,-0.0644185362468046,1.635470891539967,1.6998894277867715,11.10368072814829,1.7330974261985082,41.163414562815,26.13911290399191,32.697472533193086,4501004941
1179149400,150.86,151.3,149.78999,150.53,NaN,NaN,133.48333333333332,150.37732088888885,139.3289497000003,143.97280010000003,144.9574006,149.332499,146.5005507487309,149.06125803164323,150.05999846153867,151.82962769700325,148.2903692260741,139.3289497000003,143.97280010000003,144.9574006,149.332499,150.53999666666667,108062320,102631740,63.17602633755028,NaN,1.5,2.75,NaN,NaN,1.3269146742872138,1.052913260556627,293.28821398243304,-0.10629663630721753,1.5670186324027497,1.6733152687099673,9.715413736444383,1.2510930248200807,20.113464047964257,48.62375920586149,31.262776746174268,4392942621
1179235800,150.7,151.66499,150.19,150.57001,NaN,NaN,133.40555555555557,150.4479873333333,139.44824970000028,144.0590002,145.2218006,149.5064995,146.66013738603556,149.20494869529625,150.13076923076943,151.90273503254184,148.35880342899702,139.44824970000028,144.0590002,145.2218006,149.5064995,150.8083333333333,180931808,106256212,63.34945391683118,NaN,1.5,2.75,NaN,NaN,1.3374914832666978,1.7027880497000967,290.8248065722842,-0.13967472395710034,1.498721863763592,1.6383965877206923,9.713004082702527,0.6887923424362992,48.487659163731735,20.21480141183816,31.2975394244301,4573874429
1179322200,150.8,151.63,150.38,151.60001,NaN,NaN,133.32777777777778,150.51865377777773,139.56634975000028,144.15280030000002,145.4598008,149.723,146.85385788070084,149.4330497719347,150.29000076923097,152.18515150413805,148.3948500343239,139.56634975000028,144.15280030000002,145.4598008,149.723,151.20333666666667,114667008,107572149.6,67.58221887681887,NaN,1.5,2.75,NaN,NaN,1.3312420916047907,1.0659544168856137,293.120454628934,-0.10247823803935074,1.510298790171504,1.6127770282108547,9.896163072108989,0.8313933600669531,49.527321463815916,19.447505256105636,31.025173280078445,4688541437
1179408600,151.38,151.96001,151.11,151.3,NaN,NaN,133.25,150.58932022222217,139.6835997000003,144.24440030000002,145.69460080000002,149.9265,147.02821639518316,149.61085455555997,150.52154000000021,152.09005796489325,148.95302203510718,139.6835997000003,144.24440030000002,145.69460080000002,149.9265,151.45667,101566000,107483302.4,65.21954038929029,NaN,1.5,2.75,NaN,NaN,1.296868370775877,0.9449467752862792,290.9756935699813,-0.10764144034261358,1.4782252277825876,1.5858666681252012,9.700456384532567,0.25178902729924724,56.826354489065196,14.488851843207637,28.684793667727174,4586975437
1179495000,152.00999,152.62,151.81,152.62,NaN,NaN,133.17222222222222,150.6599866666666,139.81059970000027,144.35440030000004,145.9322006,150.12650000000002,147.2475020267446,149.89743983598282,150.82538615384635,152.3716918915999,149.2790804160928,139.81059970000027,144.35440030000004,145.9322006,150.12650000000002,152.35,99182256,106235999.2,70.16221132592213,NaN,1.5,2.75,NaN,NaN,1.2985206300061711,0.9336030794352429,293.2547667933073,-0.035453620805340647,1.5415496421185253,1.577003262923866,10.643435897096031,1.1063265982113388,55.75652798715402,15.169876978094612,29.07359503475136,4686157693
1179754200,152.58,153.23,152.4993,152.53999,NaN,NaN,133.09444444444443,150.73065311111105,139.93289965000028,144.47230020000003,146.16740040000002,150.3504995,147.4550505747154,150.14911128017494,151.0561553846156,152.66059777968877,149.45171298954244,139.93289965000028,144.47230020000003,146.16740040000002,150.3504995,152.75643,174706432,111092855.2,69.51733781803135,NaN,1.5,2.75,NaN,NaN,1.2579620135771579,1.5726162738861715,295.27150348676935,-0.007832445649602615,1.5672127058618628,1.5750451515114654,10.674310044566038,1.1873897180762778,46.7613479690807,21.55153664948957,31.68711538142975,4511451261
1179840600,152.7,153.16,152.38,152.42,NaN,NaN,133.01666666666668,150.8013195555555,140.05289965000028,144.58070020000002,146.3960002,150.56549950000002,147.64975447374616,150.36538639634875,151.2153853846156,152.91589131567937,149.5148794535518,140.05289965000028,144.58070020000002,146.3960002,150.56549950000002,152.6533333333333,82254320,109481896,68.5005028022097,NaN,1.5,2.75,NaN,NaN,1.2238218697502181,0.7513052203626434,296.45375865073663,-0.01212630590778585,1.5598872691267331,1.572013575034519,10.63496678211477,0.8335538502249212,19.08102479189648,50.06734036554802,30.85163484255551,4429196941
1179927000,152.95,153.5,152.36,152.44,NaN,NaN,132.9388888888889,150.87198599999996,140.17409965000027,144.68000030000002,146.6798002,150.7134995,147.8376072394816,150.56296864431553,151.33230846153867,153.1410731674181,149.52354375565923,140.17409965000027,144.68000030000002,146.6798002,150.7134995,152.76666666666668,133950624,110721480,68.58299100147721,NaN,1.5,2.75,NaN,NaN,1.2178345933394874,1.2097979904170355,293.9921486471975,-0.027237327754517926,1.5379669153413715,1.5652042430958895,10.594866874617438,1.91202032357266,21.39582605799191,46.96354875262432,31.64062518938377,4563147565
1180013400,152.53,153.21001,150.74001,151.06,NaN,NaN,132.86111111111111,150.9426524444444,140.28964965000026,144.7685002,146.9154002,150.78400000000002,147.96397558303133,150.61030496390453,151.3407700000002,153.14332016729423,149.53821983270615,140.28964965000026,144.7685002,146.9154002,150.78400000000002,151.67000666666667,187770320,115672524,57.411290492594595,NaN,1.5,2.75,NaN,NaN,1.3072749795295238,1.6232923213467703,289.48005663140543,-0.13761884215196973,1.3931806904059272,1.530799532557897,10.059567789923388,0.1325732467188046,16.13770547512306,54.311622881598154,29.550671643278783,4375377245
1180099800,151.49001,152.02,151.17999,151.69,NaN,NaN,132.78333333333333,151.01331888888885,140.41104965000025,144.86920020000002,147.15980019999998,150.892,148.11009418761833,150.71313306258028,151.41307769230787,153.19027005560267,149.63588532901306,140.41104965000025,144.86920020000002,147.15980019999998,150.892,151.62999666666667,83309120,114428392.8,60.56909846194788,NaN,1.5,2.75,NaN,NaN,1.282469623848844,0.7280458805849801,292.82057918170966,-0.17334050875033746,1.314123896619975,1.4874644053703125,9.135399954770206,0.7706105095329812,14.569897556839715,56.732570209152634,28.697532234007653,4458686365
1180445400,151.94,152.5,151.45,152.24001,NaN,NaN,132.70555555555555,151.0839853333333,140.53734970000028,144.9779003,147.4340004,151.089501,148.27205167045682,150.8585499137631,151.49615538461555,153.31865453495377,149.67365623427733,140.53734970000028,144.9779003,147.4340004,151.089501,152.0633366666667,83960816,113575796,63.13875984468573,NaN,1.5,2.75,NaN,NaN,1.2658646507167846,0.7392491970736441,295.40672922434266,-0.16510393720567018,1.281084483863225,1.4461884210688951,9.106481735570334,1.1091186086791227,38.42536832888365,28.527154062641955,33.047477608474395,4542647181
1180531800,151.46001,153.53999,151.34,153.48,NaN,NaN,132.62777777777777,151.15465177777773,140.66789970000028,145.0960003,147.6996004,151.330001,148.47628493828205,151.10821182673806,151.79615538461556,153.5404977334371,150.05181303579403,140.66789970000028,145.0960003,147.6996004,151.330001,152.78666333333334,131273376,113417733.6,68.17433376362867,NaN,1.5,2.75,NaN,NaN,1.3325878899512988,1.1574325445699085,298.69965702403334,-0.08533775134529731,1.3395162318872735,1.4248539832325708,9.909778321231098,1.2400988627903073,63.02757562281108,10.859096520790384,26.113327856398538,4673920557
1180618200,153.66,153.89,153.12,153.32001,NaN,NaN,132.55,151.22531822222217,140.79944980000027,145.2238005,147.9466006,151.519002,148.66623494070237,151.31885927181062,151.98538692307707,153.81414082879778,150.15663301735637,140.79944980000027,145.2238005,147.9466006,151.519002,153.44333666666668,115777808,114847533.6,66.90436561406254,NaN,1.5,2.75,NaN,NaN,1.2924030406690619,1.0081000816546921,300.5196844963535,-0.054068615255008945,1.3572682141638097,1.4113368294188187,9.50607366233296,1.335102445472561,34.12412604583104,32.589337488729846,33.28653646543913,4558142749
1180704600,153.88,154.39999,153.50999,154.08,NaN,NaN,132.47222222222223,154.39999,140.93429980000028,145.3527005,148.1624008,151.7055015,148.8785394528317,151.5818250554477,152.258463846154,154.1934802463417,150.3234474459663,140.93429980000028,145.3527005,148.1624008,151.7055015,153.99666000000002,107774432,115844052,69.78382608501968,NaN,1.5,2.75,NaN,NaN,1.2772299663355577,0.9303406617717412,303.3406585722432,0.003998537469825925,1.4163350012561011,1.4123364637862752,9.508043181758417,0.9566242956362259,74.0083282010928,5.6253075579678775,20.36636424093934,4665917181
1180963800,153.53999,154.39,153.48,154.10001,NaN,NaN,132.39444444444445,154.5156420289855,141.06164985000026,145.4830005,148.3808012,151.864502,149.08330300370105,151.8216521930241,152.53000230769246,154.43148534033546,150.62851927504946,141.06164985000026,145.4830005,148.3808012,151.864502,153.99000333333333,78047568,114925817.6,69.8581851128658,NaN,1.5,2.75,NaN,NaN,1.2509992544544464,0.6791125756585438,305.1087687476093,0.02858528341256461,1.448068068051981,1.4194827846394165,8.459794119892807,1.0226957534217807,73.59370623791779,5.7891620001493385,20.617131761932864,4743964749
1181050200,153.74001,153.89999,152.86,153.49001,NaN,NaN,132.31666666666666,154.63129405797102,141.18014995000027,145.6025007,148.5828014,151.9915025,149.2561150427716,151.9805434127361,152.67538692307704,154.5591454209888,150.79162842516527,141.18014995000027,145.6025007,148.5828014,151.9915025,153.41666666666666,127943056,118138537.6,64.63617943791212,NaN,1.5,2.75,NaN,NaN,1.250214307707699,1.0829917027853915,301.42282152924713,-0.009372636867319928,1.4077669885552666,1.4171396254225865,8.899564700747447,0.7020141713686031,43.46798448995425,24.16162765712419,32.37038785292156,4616021693
1181136600,152.91,152.95,151.75,151.84,NaN,NaN,132.23888888888888,154.7469460869565,141.28919995000027,145.6993007,148.75560140000002,152.04600250000001,149.3574438646237,151.96715832580884,152.71692538461554,154.4985863304234,150.93526443880768,141.28919995000027,145.6993007,148.75560140000002,152.04600250000001,152.17999999999998,164138128,122268747.2,53.07829321958337,NaN,1.5,2.75,NaN,NaN,1.2851997143000073,1.342437309278327,296.8849690346019,-0.1508921717520999,1.2285244107324615,1.3794165824845614,11.067544838777726,-0.393597480976118,13.165904939100296,58.996145988579244,27.837949072320463,4451883565
1181223000,151.56,152.5,149.06,149.10001,NaN,NaN,132.1611111111111,154.86259811594203,141.38125000000028,145.75790070000002,148.88040160000003,151.94300300000003,149.34734841895218,151.69409658049372,152.44615692307707,155.07359242041048,149.81872142574366,141.38125000000028,145.75790070000002,148.88040160000003,151.94300300000003,150.22000333333332,232486192,128745663.2,40.2175642478691,NaN,1.5,2.75,NaN,NaN,1.4391140204214352,1.805778821759955,289.7247810005537,-0.4191194959070077,0.8555172126008017,1.2746367085078094,15.037854582771775,-1.2974910631537169,9.147604062270464,66.26102160518568,24.591374332543875,4219397373
1181309400,149.5,151.19,149.09,151.03999,NaN,NaN,132.08333333333334,154.97825014492753,141.48579995000028,145.8387005,149.06480120000003,152.0160025,149.41372652016975,151.6318007156848,152.33077230769248,155.06131353594128,149.6002310794437,141.48579995000028,145.8387005,149.06480120000003,152.0160025,150.43999666666664,176982320,129909851.2,49.53998989133758,NaN,1.5,2.75,NaN,NaN,1.4863201618199038,1.3623471843373183,293.3303322760177,-0.4530838778346802,0.7082818612144592,1.1613657390491394,16.578966838987714,-0.4285120970400217,14.410896311068917,56.96933447632475,28.619769212606318,4396379693
1181568600,150.92999,151.95,150.7,151.3,NaN,NaN,132.00555555555556,155.09390217391305,141.59169995000028,145.92150049999998,149.25140120000003,152.0380025,149.4876980291827,151.60020064752433,152.2446184615386,155.0286149087554,149.4606220143218,141.59169995000028,145.92150049999998,149.25140120000003,152.0380025,151.31666666666666,102527504,129365570.4,50.650732707833775,NaN,1.5,2.75,NaN,NaN,1.4694401502613392,0.792540887679648,292.17563173763847,-0.444615407854287,0.6055964792312807,1.0502118870855677,16.412754292748517,-0.6174526656954377,15.045476418794376,55.969952263291226,28.9845713179144,4498907197
1181655000,150.67,151.53999,149.55,149.64999,NaN,NaN,131.92777777777778,155.20955420289854,141.6911499500003,145.99260049999998,149.404401,151.994002,149.49406242019515,151.41446630014107,152.03000230769246,155.13259226306354,148.92741235232137,141.6911499500003,145.99260049999998,149.404401,151.994002,150.24666,235736560,135749282.4,44.027481442809915,NaN,1.5,2.75,NaN,NaN,1.5066222823855278,1.7365584247095807,286.1175792452941,-0.5308744253428138,0.38661885540705043,0.9174932807498642,17.262103295759022,-2.495445660672392,11.573290986758197,61.72973272485783,26.696976288383976,4263170637
1181741400,150.5,152.07001,149.722,151.89,NaN,NaN,131.85,155.32520623188407,141.80235000000027,146.08330039999998,149.59900100000002,152.0600015,149.5880207566581,151.45975522393715,152.09384846153858,155.1477444983979,149.03995242467926,141.80235000000027,146.08330039999998,149.59900100000002,152.0600015,151.22733666666667,193250624,136365223.2,53.01070994206295,NaN,1.5,2.75,NaN,NaN,1.5718649765008468,1.4171547515202543,290.36486940305474,-0.422522997763245,0.3893395335458081,0.8118625313090531,19.008455284453536,-0.9326962605859536,33.191342251676446,33.5018380358939,33.306819712429636,4456421261
1181827800,152.06,153.12,152.03,152.86,NaN,NaN,131.7722222222222,155.44085826086956,141.91760000000028,146.1881004,149.78240100000002,152.123001,149.7163336681617,151.59311186927647,152.18384846153862,155.25375238701324,149.113944536064,141.91760000000028,146.1881004,149.78240100000002,152.123001,152.67,146645312,137964138.4,56.28273795357425,NaN,1.5,2.75,NaN,NaN,1.5474460496079305,1.0629234067684359,293.5826086954534,-0.27795953016733943,0.46441311859987877,0.7423726487672182,19.476768361850198,-0.791796469366562,65.17228219511269,9.706284508081616,25.121433296805716,4603066573
1181914200,153.14,153.66,152.92999,153.07001,NaN,NaN,131.69444444444446,155.55651028985508,142.03080010000028,146.29080050000002,149.96680100000003,152.2115015,149.84785038705732,151.73376883410728,152.24769461538475,155.3539237767262,149.1414654540433,142.03080010000028,146.29080050000002,149.96680100000003,152.2115015,153.22,154416368,140606656.8,56.98117868799698,NaN,1.5,2.75,NaN,NaN,1.4940570460645055,1.0982152019988856,298.24010885029054,-0.16614457361428303,0.5346919317493644,0.7008365053636474,19.231727473774463,-0.6683971013369832,64.1919385246795,10.222230632781194,25.585830842539302,4757482941
1182173400,153.38,153.39,152.66,152.89,NaN,NaN,131.61666666666667,155.67216231884058,142.14235010000027,146.3802005,150.13980080000002,152.2250015,149.9671503718786,151.84388608800182,152.20231000000013,155.25191761320204,149.1527023867982,142.14235010000027,146.3802005,150.13980080000002,152.2250015,152.98,88635680,140079328,56.15306227730454,NaN,1.5,2.75,NaN,NaN,1.439481542774183,0.6327534638087355,296.9395866379884,-0.10522876227806299,0.5693005525160686,0.6745293147941316,19.226778159378814,-0.3909114345617841,48.03457109350572,20.551059430784527,31.414369475709744,4668847261
1182259800,152.55,153.38,152.36,153.27,NaN,NaN,131.5388888888889,155.7878143478261,142.25540010000026,146.49030059999998,150.31640080000005,152.26150199999998,150.0966738867069,151.97970646057308,152.19846307692322,155.24254245997685,149.1543836938696,142.25540010000026,146.49030059999998,150.31640080000005,152.26150199999998,153.00333333333333,111117440,136899878.4,57.55540449800487,NaN,1.5,2.75,NaN,NaN,1.4095185754331685,0.8116693842147342,299.1196273072392,-0.04343048902295821,0.6202412035154339,0.6636716925383921,19.1929472533025,0.9417808219178126,85.47086996293001,1.8742561891305582,12.654873847939427,4779964701
1182346200,153.58,153.58,150.96001,151.14,NaN,NaN,131.4611111111111,155.9034663768116,142.35790010000025,146.58010059999998,150.44700080000007,152.19750199999996,150.1375886362478,151.89973441670898,151.97230923076935,154.8562772919498,149.08834116958892,142.35790010000025,146.58010059999998,150.44700080000007,152.19750199999996,151.89333666666667,177234432,141648884,48.24177942842263,NaN,1.5,2.75,NaN,NaN,1.4959808200450853,1.2512236383027204,294.6767531885203,-0.14440202264681135,0.4831691642298779,0.6275711868766892,19.912585272764076,1.3682024568609947,48.47326337984979,20.22251158030114,31.304225039849065,4602730269
1182432600,151.08,152.11,150.25,151.98,NaN,NaN,131.38333333333333,156.01911840579712,142.46070010000028,146.67940059999998,150.60620080000004,152.17450199999996,150.20984006227732,151.90737875797478,151.80923153846166,154.42035304960396,149.19811002731936,142.46070010000028,146.67940059999998,150.60620080000004,152.17450199999996,151.4466666666667,205265680,145214636.8,51.57013893457331,NaN,1.5,2.75,NaN,NaN,1.521982190041866,1.4135329917376482,296.50129350553743,-0.152233840249536,0.4372788865647692,0.5895127268143052,16.556164660931277,0.6223583568828368,52.955536690967016,17.02387572870145,30.02058758033155,4807995949
1182519000,151.52,151.77,149.85001,150.55,NaN,NaN,131.30555555555554,156.1347704347826,142.55510010000026,146.7570007,150.72400080000006,152.14900199999997,150.2231796676782,151.77810459054862,151.58307692307704,154.07948089212226,149.08667295403183,142.55510010000026,146.7570007,150.72400080000006,152.14900199999997,150.72333666666665,205153120,146083776.8,46.131503627625264,NaN,1.5,2.75,NaN,NaN,1.5654113193245893,1.4043525194510167,292.37267938631356,-0.24579605659658876,0.2822676560685693,0.5280637126651581,16.084286321424994,-0.495703899537343,21.200477042018708,47.17832294391855,31.621200014062737,4602842829
1182778200,150.24001,151.25,149.02,149.83,NaN,NaN,131.2277777777778,156.25042246376813,142.6517001500003,146.8178007,150.81420060000005,152.05600199999998,150.20776085718103,151.59257082002017,151.42846153846168,154.08585174644682,148.77107133047653,142.6517001500003,146.8178007,150.81420060000005,152.05600199999998,150.03333333333333,232036432,153520142.4,43.636220085587354,NaN,1.5,2.75,NaN,NaN,1.6128819393728322,1.5114396610929668,288.58874204299224,-0.3423169797746593,0.10016748794683394,0.44248446772149325,16.21477617958867,0.12028734515786468,14.980815347077021,56.04652636114764,28.972658291775332,4370806397
1182864600,150.21001,150.46001,148.28,148.28999,NaN,NaN,131.15,156.36607449275363,142.7436001000003,146.85460059999997,150.84600040000004,151.85850099999996,150.13255415689943,151.27803931335157,151.36615230769243,154.26593713470544,148.46636748067942,142.7436001000003,146.85460059999997,150.84600040000004,151.85850099999996,149.01,198318256,159238014.4,38.801745490985,NaN,1.5,2.75,NaN,NaN,1.6533910865604877,1.2454203021009285,285.8029896012511,-0.4871834896550761,-0.16649489434735187,0.3206885953077242,16.07571590977927,-2.3701428665481585,4.883729230038756,75.86958676040857,19.246684009552688,4172488141
1182951000,148.13,150.57001,148.06,150.39999,NaN,NaN,148.06,156.48172652173915,142.8442000500003,146.91050049999998,150.91220020000003,151.70450049999994,150.14304183702103,151.19441556922285,151.31692153846166,154.25861253312144,148.37523054380188,142.8442000500003,146.91050049999998,150.91220020000003,151.70450049999994,149.67666666666665,209169056,163132798.4,47.400360836458326,NaN,1.5,2.75,NaN,NaN,1.714578151806167,1.2822011149904973,290.047500529011,-0.4207124340112576,-0.20520194720634777,0.2155104868049098,15.818116271031176,-1.6093222556587798,20.513149956722405,48.084344787660285,31.4025052556173,4381657197
1183037400,150.38,151.41,149.67,150.38,NaN,NaN,148.21493150684933,156.59737855072464,142.94405005000033,146.96580039999998,150.97440020000005,151.55749999999995,150.1523343140006,151.1168521816778,151.24615230769243,154.23002960666253,148.26227500872233,142.94405005000033,146.96580039999998,150.97440020000005,151.55749999999995,150.48666666666665,157701504,165228983.2,47.332508621246994,NaN,1.5,2.75,NaN,NaN,1.7163939981057272,0.95444213809094,291.9293019187937,-0.3602357061774516,-0.23478414591690466,0.1254515602605469,15.139660597624406,-1.7573723291714693,5.174462300579387,75.1132448028994,19.71229289652121,4223955693
1183123800,150.89999,151.64999,149.14999,150.42999,NaN,NaN,148.36986301369862,156.71303057971016,143.03775000000033,147.02120029999998,151.03840000000002,151.37499949999997,150.16322277227508,151.05143673580375,151.30615230769243,154.1888881311022,148.42341648428265,143.03775000000033,147.02120029999998,151.03840000000002,151.37499949999997,150.40999,199697632,169825143.2,47.534768156727054,NaN,1.5,2.75,NaN,NaN,1.7723658553838895,1.1759014492030766,293.3006505305352,-0.3013993867350703,-0.251297673158291,0.05010171357677931,15.075796101664823,-1.609006475243628,22.11525333461354,45.995192478532736,31.889554186853715,4423653325
1183383000,150.87,151.92,150.77,151.78999,NaN,NaN,148.52479452054794,156.82868260869566,143.1355999500003,147.08700009999995,151.10179980000004,151.25949849999998,150.2270175655192,151.12177514191768,151.29845923076934,154.17544966360924,148.42146879792944,143.1355999500003,147.08700009999995,151.10179980000004,151.25949849999998,151.49333,103352000,171090364.8,52.84083739182603,NaN,1.5,2.75,NaN,NaN,1.7521975799993246,0.6040784360990502,298.1801508952779,-0.16238681263308738,-0.15288180221457992,0.009505010418507459,16.293700739313802,-0.9656227572258246,46.06532386084869,22.058945053070886,31.87573108608041,4527005325
1183469400,152.17999,152.5,151.99001,152.34,NaN,NaN,148.67972602739727,156.94433463768118,143.23614995000034,147.16020009999997,151.18739980000004,151.20199799999997,150.30987962177335,151.23779655697314,151.25845923076935,154.0609903910749,148.45592807046378,143.23614995000034,147.16020009999997,151.18739980000004,151.20199799999997,152.27667,54047488,167395586.4,54.830427693283525,NaN,1.5,2.75,NaN,NaN,1.6777556099993736,0.32287283770344377,300.4803485152465,-0.031730141346610966,-0.030157666264756244,0.0015724750818547177,16.387849553482763,0.7939658594680542,73.6893169771139,5.741862644806319,20.568820378079785,4581052813
1183642200,152.39999,152.56,151.63,152.17999,NaN,NaN,148.8346575342466,157.05998666666667,143.33724985000035,147.24259999999995,151.26859960000004,151.21899749999997,150.38321728366458,151.32752926583285,151.18999615384627,153.85213278565823,148.5278595220343,143.33724985000035,147.24259999999995,151.26859960000004,151.21899749999997,152.12333,89254432,163651401.6,54.11514515831067,NaN,1.5,2.75,NaN,NaN,1.6243444949994188,0.5453936301636906,298.6364396237879,0.04160047507372399,0.053573068924009704,0.011972593850285715,14.039816283099912,0.13158968285301612,45.915845515793464,22.17591736383633,31.908237120370202,4491798381
1183728600,152.38,153.17,151.92999,152.98,NaN,NaN,148.98958904109588,157.17563869565217,143.44144985000034,147.33789999999996,151.33859960000004,151.41299699999996,150.48505189999145,151.48490743099163,151.19691923076937,153.87711066000367,148.51672780153507,143.44144985000034,147.33789999999996,151.33859960000004,151.41299699999996,152.69332999999997,81106368,156082410.4,57.12660344719443,NaN,1.5,2.75,NaN,NaN,1.5968920310708878,0.5196381052300817,300.8910645001994,0.13632753652898566,0.1823820145115178,0.046054477982532135,14.003044929472123,1.6140817004317358,80.12169503154189,3.3924385163073603,16.485866452150745,4572904749
1183987800,153.16,153.36,152.62,153,NaN,NaN,149.1445205479452,157.2912907246377,143.54739985000032,147.42129999999995,151.40559980000003,151.51099749999997,150.58367731567805,151.62920196137338,151.17615000000012,153.79524928784434,148.5570507121559,143.54739985000032,147.42129999999995,151.40559980000003,151.51099749999997,152.99333333333334,72343568,150850472.8,57.202225409134336,NaN,1.5,2.75,NaN,NaN,1.535685457422968,0.47957137062416944,301.94291191248095,0.18941059213720265,0.28281771815403545,0.09340712601683279,12.471135833303611,2.115731161983573,73.87890438049705,5.676528067367624,20.444567552135318,4645248317
1184074200,152.28999,152.61,150.77,150.92,NaN,NaN,149.29945205479453,157.40694275362318,143.63944990000033,147.47439999999995,151.43339980000005,151.49199749999997,150.5968664405534,151.56165891743305,151.15922692307706,153.7818824435355,148.53657140261862,143.63944990000033,147.47439999999995,151.43339980000005,151.49199749999997,151.4333333333333,180356128,154741904,47.76602467553287,NaN,1.5,2.75,NaN,NaN,1.5852793533213265,1.1655286857527616,297.3534138937983,0.07916049109795346,0.19235773988927463,0.11319724879132116,14.937255878874277,1.7735586872721476,26.37375157276159,40.85543692086557,32.77081150637286,4464892189
1184160600,150.75,152.05,150.52,151.99001,NaN,NaN,149.45438356164385,157.5225947826087,143.74004995000033,147.53630009999995,151.50740020000003,151.60899849999998,150.65149952131603,151.6024542586299,151.15999692307707,153.7836215914216,148.53637225473256,143.74004995000033,147.53630009999995,151.50740020000003,151.60899849999998,151.52000333333334,175533632,151731757.6,52.13990584153541,NaN,1.5,2.75,NaN,NaN,1.581330828084089,1.1568681123614692,298.63175122856694,0.07316168066784184,0.20464934962612347,0.13148766895828162,13.49546864557473,1.0571942192283454,41.583968311019646,25.74854959981736,32.667482089162995,4640425821
1184247000,152.37,154.75,152.34,154.39,NaN,NaN,149.60931506849315,157.6382468115942,143.85464995000032,147.62290009999995,151.62180020000005,151.73399849999998,150.79810738322522,151.86793480542707,151.45538153846167,154.55861149393812,148.35215158298521,143.85464995000032,147.62290009999995,151.62180020000005,151.73399849999998,153.82666666666668,133863120,148762382.4,60.19171768470888,NaN,1.5,2.75,NaN,NaN,1.6655207689352245,0.8998452286147307,302.7602831854982,0.21752949331861723,0.4033995356065532,0.18587004228793594,14.000178930411291,2.6665780023939294,66.25430736736212,9.156406941460565,24.589285691177317,4774288941
1184333400,154.57001,155.46001,154.39,154.85001,NaN,NaN,149.76424657534247,157.75389884057972,143.96650000000034,147.71100029999997,151.72800060000006,151.833499,150.95700552505951,152.15194196681497,151.84153615384628,155.27175277513697,148.41131953255558,143.96650000000034,147.71100029999997,151.72800060000006,151.833499,154.90000666666666,111793872,147019810.4,61.52772983182214,NaN,1.5,2.75,NaN,NaN,1.622984285439853,0.7604000555832576,303.77171212800835,0.3242754077653063,0.5912143019945688,0.26693889422926254,13.890140793491987,2.938257191933599,68.12061809178245,8.234565529593585,23.644816378623954,4886082813
1184592600,154.99001,155.53,154.58,154.83,NaN,NaN,149.9191780821918,157.86955086956522,144.07275000000033,147.79950029999998,151.81760040000006,151.92149849999998,151.1088876613317,152.4069951128326,152.34461384615398,155.44637799245302,149.24284969985493,144.07275000000033,147.79950029999998,151.81760040000006,151.92149849999998,154.98000000000002,98370368,144217510.4,61.43114918556895,NaN,1.5,2.75,NaN,NaN,1.5749139793370055,0.6820972552303884,300.602567407288,0.3704720038161726,0.7300288989994783,0.3595568951833057,13.92411715846208,2.002773700690028,48.42735048986687,20.260000223812284,31.312649286320852,4787712445
1184679000,154.92999,156,154.67999,154.75,NaN,NaN,150.0741095890411,156,144.17779995000032,147.88830029999997,151.89420040000005,152.0144985,151.25167638049516,152.63013843541995,152.67923000000016,155.8080928897065,149.55036711029382,144.17779995000032,147.88830029999997,151.89420040000005,152.0144985,155.14333,126120752,146091764,61.01875725778295,NaN,1.5,2.75,NaN,NaN,1.5567065522415047,0.8632981664866474,298.39058704054486,0.3716229559426303,0.8240855901115935,0.45246263416896326,13.458679634728517,1.5819876591834032,55.261159916112994,15.490630643762413,29.24820944012459,4661591693
1184765400,154.23,154.8,153.3,154.47,NaN,NaN,150.2290410958904,156.05161322580645,144.28169995000033,147.98000029999994,151.96460040000005,152.07449849999998,151.3778851498875,152.80536334633234,152.99384538461553,155.95255697377144,150.03513379545961,144.28169995000033,147.98000029999994,151.96460040000005,152.07449849999998,154.19000000000003,237719120,152421848,59.51289475547354,NaN,1.5,2.75,NaN,NaN,1.5526560842242545,1.5596131599191738,295.70688676089156,0.33086929967235224,0.8660492587594035,0.5351799590870513,13.569647605730703,1.5048036210279652,15.897290795007413,54.64005548618689,29.462653718805683,4423872573
1184851800,155.2,155.53,154.75,155.07001,NaN,NaN,150.38397260273973,156.1032264516129,144.3891500000003,148.07900039999996,152.05100060000007,152.270999,151.52267435969583,153.02104398001498,153.35077000000013,156.09815387973336,150.6033861202669,144.3891500000003,148.07900039999996,152.05100060000007,152.270999,155.11667,145213120,150820782.4,61.694462301552164,NaN,1.5,2.75,NaN,NaN,1.5174663639225223,0.9628190338840199,298.35263807195616,0.32139308496435437,0.9369213152924942,0.6155282303281399,13.540197871932047,1.3661981958425982,16.97160053946613,53.036521883205815,29.991877577328065,4569085693
1184938200,154.89,155.2484,152.28999,153.5,NaN,NaN,150.53890410958905,156.15483967741935,144.49125000000032,148.21900039999994,152.09780060000006,152.34699899999998,151.60021654166854,153.06665883906118,153.48230923076935,156.07773041063848,150.8868880509002,144.49125000000032,148.21900039999994,152.09780060000006,152.34699899999998,153.67946333333336,245501872,152832592,53.561751626906954,NaN,1.5,2.75,NaN,NaN,1.620390909356629,1.6063450131108161,294.13715823328175,0.19279959682715897,0.8565277263620885,0.6637281295349295,14.953172003381399,0.32679738562091504,3.4990392623193745,79.79689673780152,16.704063999879093,4323583821
1185197400,154.17999,154.72,153.3,153.97,NaN,NaN,150.69383561643835,156.2064529032258,144.59430000000032,148.34940049999994,152.18560060000007,152.51799899999997,151.693149226309,153.15269133057916,153.60769384615398,156.1266240868967,151.08876360541126,144.59430000000032,148.34940049999994,152.18560060000007,152.51799899999997,153.99666666666667,121181808,148634026.4,55.45483538628099,NaN,1.5,2.75,NaN,NaN,1.6060772729740118,0.8153032716336345,292.93715823328176,0.12603603561259558,0.821273174050674,0.6952371384380784,15.03213450370956,2.020938245428049,10.920610562550008,62.961936272896665,26.11745316455333,4444765629
1185283800,153.12,154.28,150.75999,151.3,NaN,NaN,150.84876712328767,156.25806612903224,144.6762000000003,148.45730059999994,152.19440060000008,152.59149899999997,151.677731609591,152.97624453719067,153.54000230769242,156.24889511591587,150.83110949946897,144.6762000000003,148.45730059999994,152.19440060000008,152.59149899999997,152.11333,256825632,149873486.4,44.385262193333794,NaN,1.5,2.75,NaN,NaN,1.742786753475869,1.713616185017232,286.28216845951886,-0.0991485950582991,0.5713013946152046,0.6704499896735037,16.44684708695446,-0.45398378485533414,8.151031409644585,68.34099200845807,23.50797658189734,4187939997
1185370200,152.02,152.39,150.25,151.61,NaN,NaN,151.003698630137,156.30967935483872,144.75835005000033,148.58670059999994,152.2160006000001,152.7574995,151.67507546803841,152.84612600983917,153.43461769230782,156.32309640827307,150.54613897634258,144.75835005000033,148.58670059999994,152.2160006000001,152.7574995,151.41666666666666,265201056,153217626.4,45.739546940743736,NaN,1.5,2.75,NaN,NaN,1.7711591282275916,1.7308782431314311,283.445200518781,-0.22142131461805836,0.39367334640093077,0.6150946610189891,15.931473004339399,-1.800634756137038,33.711606802528195,33.044715566149065,33.243677631322726,4453141053
1185456600,150.19,150.8,146.39,148.02,NaN,NaN,151.15863013698632,156.36129258064517,144.82340010000033,148.69340049999994,152.16500040000008,152.6385,151.53173917517415,152.38649496128306,153.05154076923088,157.14044599564355,148.96263554281822,144.82340010000033,148.69340049999994,152.16500040000008,152.6385,148.40333333333334,467454208,166131884,35.084547882969034,NaN,1.5,2.75,NaN,NaN,2.017504904782766,2.8137537283330873,276.4367022760012,-0.5211653289469519,-0.0363620001647007,0.4848033287822512,17.58579272995533,-4.410726224686706,9.626660506338903,65.38462217470249,24.98871731895861,3985686845
1185543000,148.21001,148.87,145.05,145.11,NaN,NaN,151.3135616438356,156.41290580645162,144.87350010000034,148.74750049999994,152.03520020000008,152.375,151.2799062663438,151.69349544116088,152.6046176923078,158.42937136820774,146.77986401640788,144.87350010000034,148.74750049999994,152.03520020000008,152.375,146.34333333333333,422916864,179392652,29.155723301740252,NaN,1.5,2.75,NaN,NaN,2.146254554441139,2.357492680357945,271.5752059691566,-0.8718479835105672,-0.6050066506059579,0.2668413329046094,18.99151776873763,-6.277853129238518,7.577607370599613,69.55581825103918,22.86657437836121,3562769981
1185802200,145.92999,147.81,145.28999,147.38,NaN,NaN,151.46849315068494,156.46451903225807,144.93405010000032,148.82570049999993,151.95680020000006,152.2225005,151.12696876570286,151.2826863515265,152.25000153846167,158.7081343574712,145.79186871945214,144.93405010000032,148.82570049999993,151.95680020000006,152.2225005,146.82666333333333,282213376,183518439.2,37.96263445431214,NaN,1.5,2.75,NaN,NaN,2.1858078005524857,1.5377930263042474,275.2145600271158,-0.9035120102134139,-0.862548679862158,0.040963330351255905,22.669341485177657,-4.762520193861069,12.133102381191879,60.93380436091908,26.933093257889045,3844983357
1185888600,148.33,149.46001,145.03999,145.72,NaN,NaN,151.62342465753426,156.51613225806452,144.98710010000033,148.87550039999994,151.81880020000008,151.91900099999998,150.914930774891,150.75290669900016,151.5830784615386,158.76914215349714,144.39701476958007,144.98710010000033,148.87550039999994,151.81880020000008,151.91900099999998,146.74,316607488,194181213.6,34.57747568048386,NaN,1.5,2.75,NaN,NaN,2.34539438622731,1.6304743498626482,272.75435036553256,-0.982305592959354,-1.1869186608479367,-0.20461306788858266,22.74756860409899,-5.664530329513822,11.39205139684675,62.23345745717457,26.374491145978684,3528375869
1185975000,145.17999,147.00999,143.95,146.42999,NaN,NaN,151.77835616438355,156.56774548387097,145.03785005000034,148.9320002999999,151.69660020000006,151.62350049999998,150.73905074450312,150.34120034671443,150.93538461538475,158.3413343208106,143.5294349099589,145.03785005000034,148.9320002999999,151.69660020000006,151.62350049999998,145.79665999999997,467658496,214861764,37.1585341004132,NaN,1.5,2.75,NaN,NaN,2.3964369300682162,2.1765552292496304,269.91025316450566,-0.9330224803565367,-1.3708911683342535,-0.43786868797771683,23.50604972648207,-5.571689845122208,17.429195633284134,52.58365332446235,29.987151042253526,3996034365
1186061400,146.75999,147.75999,145.25999,147.60001,NaN,NaN,151.93328767123288,156.6193587096774,145.09270010000034,148.99810029999992,151.60020040000006,151.3945015,150.6159511074638,150.0801345994083,150.37923153846168,157.6157204772476,143.14274259967576,145.09270010000034,148.99810029999992,151.60020040000006,151.3945015,146.87332999999998,294674176,225132751.2,41.27052719439102,NaN,1.5,2.75,NaN,NaN,2.403834292206201,1.308890751920061,273.12409309880354,-0.7745622917163322,-1.406071552623132,-0.6315092609067998,24.196822066469995,-3.8436416938110765,43.02791891408379,24.687961681579228,32.28411940433697,4290708541
1186147800,147.28,147.58,143.2,143.8,NaN,NaN,152.0882191780822,156.67097193548386,145.12750010000033,149.0536002999999,151.42740040000007,150.9355015,150.34865890717109,149.4820265423218,149.536923846154,157.08474902421548,141.9890986680925,145.12750010000033,149.0536002999999,151.42740040000007,150.9355015,144.85999999999999,359378688,239046367.2,33.58422381384872,NaN,1.5,2.75,NaN,NaN,2.5464182713343297,1.5033848546182802,266.8105786166566,-0.8713890914219489,-1.720745625184236,-0.849356533762287,27.008062930638076,-6.605182827823594,46.34653017521962,22.013997750945485,31.639472073834877,3931329853
1186407000,144.21001,146.83,142.53,146.21001,NaN,NaN,152.24315068493152,156.7225851612903,145.17650015000032,149.12290039999993,151.33040060000008,150.596002,150.1863589500271,149.17040591924354,148.90154000000013,156.0620355172352,141.74104448276506,145.17650015000032,149.12290039999993,151.33040060000008,150.596002,145.19000333333335,324726272,251665502.4,41.07911842129969,NaN,1.5,2.75,NaN,NaN,2.671674109096164,1.2903090368098062,268.90365109054574,-0.724853968188429,-1.7554239939978231,-1.0305700258093942,29.74509320180039,-3.364170522141441,47.240725880338815,21.388617094064323,31.370657025596863,4256056125
1186493400,145.94,149,145.23,147.77,NaN,NaN,152.39808219178082,156.77419838709676,145.23240015000033,149.20590039999993,151.2520006000001,150.438502,150.09159977551624,149.03703392693464,148.34000076923093,154.56074474652146,142.1192567919404,145.23240015000033,149.20590039999993,151.2520006000001,150.438502,147.33333333333334,280677376,256681564.8,45.37611048776559,NaN,1.5,2.75,NaN,NaN,2.750125958446439,1.0934847472146936,271.42254521023534,-0.4860601214401885,-1.6381451776096299,-1.1520850561694413,29.857311475867487,-2.5328144581492005,73.63702358426502,5.8607900714921985,20.502186344242773,4536733501
1186579800,148.41,150.59,147.34,149.83,NaN,NaN,152.55301369863014,156.82581161290324,145.29750015000033,149.31890039999993,151.20380040000006,150.3305015,150.08134096079013,149.1125545053218,148.05769307692324,153.61372423417387,142.5016619196726,145.29750015000033,149.31890039999993,151.20380040000006,150.3305015,149.25333333333333,274739968,261641881.6,50.50888989985299,NaN,1.5,2.75,NaN,NaN,2.785831247128836,1.0500611229360612,276.83600579987257,-0.16894096275399217,-1.3632612596119316,-1.1943202968579394,31.22721157329746,1.2228077286853143,69.98722988848452,7.460973799071459,22.55179631244401,4811473469
1186666200,147.42999,149.95,145.28999,145.39,NaN,NaN,152.70794520547946,156.8774248387097,145.34025015000032,149.37080039999992,151.0420004000001,149.88050149999998,149.89736680546503,148.75802550481498,147.39769307692322,151.93215022927677,142.86323592456966,145.34025015000032,149.37080039999992,151.0420004000001,149.88050149999998,146.8766633333333,357626368,272830044,41.46505444047668,NaN,1.5,2.75,NaN,NaN,2.919701158048205,1.3108027354934562,270.8104193298522,-0.2337826904588831,-1.4865486599315432,-1.25276596947266,33.002670345682255,0.192957067052562,38.07633041793363,29.08255910092567,32.841110481140696,4453847101
1186752600,144.39,146.5,143.12,144.71001,NaN,NaN,152.86287671232878,156.92903806451613,145.3764502000003,149.40820049999994,150.8698004000001,149.37350149999997,149.69394104838796,148.37250021864213,146.89077076923093,151.02242190044484,142.759119638017,145.3764502000003,149.40820049999994,150.8698004000001,149.37350149999997,144.77667,411013376,287791019.2,40.27564449190311,NaN,1.5,2.75,NaN,NaN,2.9525796467590473,1.4281660947674215,267.024480432652,-0.2941430992575209,-1.6204448435445613,-1.3263017442870404,31.060513675377763,-1.8116365856968275,35.581790847345445,31.41997003649513,32.99823911615943,4042833725
1187011800,146.5,146.89,145.02,145.23,NaN,NaN,153.01780821917808,156.98065129032258,145.4132002000003,149.42760059999992,150.69280040000007,148.89350149999999,149.51888453668647,148.07321448353335,146.40000153846165,149.578544300892,143.2214587760313,145.4132002000003,149.42760059999992,150.69280040000007,148.89350149999999,145.71333333333334,181944192,291969710.4,41.653926573666006,NaN,1.5,2.75,NaN,NaN,2.897394671990542,0.6231611893943915,265.3961330644547,-0.2712801799630564,-1.665401969240861,-1.3941217892778046,29.561872549639464,-0.33626132308537543,31.840441761025147,34.867653525543176,33.291904713431684,4224777917
1187098200,145.7,146.06,142.72,143.00999,NaN,NaN,153.1727397260274,157.03226451612903,145.4365001000003,149.42590059999992,150.47100000000006,148.30650099999997,149.2636337705419,147.59100262795874,146.01461615384628,149.512843590074,142.51638871761855,145.4365001000003,149.42590059999992,150.47100000000006,148.30650099999997,143.92999666666665,264096560,298868500.8,37.65824112118245,NaN,1.5,2.75,NaN,NaN,2.929009338276932,0.8836547153449634,259.47698079099837,-0.37169509938815937,-1.8587406635130037,-1.4870455641248443,30.144689189730098,-2.3355871293851864,11.947657995716586,61.06422645689078,26.988115547392642,3960681357
1187184600,142.72,144.46001,140.62,141.03999,NaN,NaN,153.32767123287672,157.08387774193548,145.44780005000032,149.40240049999994,150.22199960000006,147.6350005,148.941137936403,146.96709666339123,145.7015384615386,150.08425030316502,141.3188266199122,145.44780005000032,149.40240049999994,150.22199960000006,147.6350005,142.04,323735040,303169296.8,34.495966107072576,NaN,1.5,2.75,NaN,NaN,2.9940808141142945,1.067835837655972,253.2071234472376,-0.5273120413812737,-2.1461856158514365,-1.6188735744701628,30.525911314746583,-4.444457693464932,1.5249568723014724,86.96843437681741,11.506608750881126,3636946317
1187271000,139.78999,142.94,137,142.10001,NaN,NaN,137,157.13549096774193,145.4687501000003,149.3914005999999,150.02719980000006,146.9865005,148.67285840948526,146.50356460021112,145.2953853846155,149.95076506739997,140.64000570183106,145.4687501000003,149.3914005999999,150.02719980000006,146.9865005,140.68000333333333,546451200,323231200.8,37.53548931455354,NaN,1.5,2.75,NaN,NaN,3.2045036131061306,1.6905892706135068,248.70926070691644,-0.514800195907658,-2.2623738193547354,-1.7475736234470773,30.461106016640315,-1.1821905424200374,22.825428854769388,45.112277393475715,32.0622937517549,4183397517
1187357400,145.5,148.35001,141.386,144.71001,NaN,NaN,136.684,157.18710419354838,145.5032501500003,149.40990069999992,149.93939980000005,146.547001,148.51745258950544,146.33274987638148,145.21769384615396,149.87584531387736,140.55954237843056,145.5032501500003,149.40990069999992,149.93939980000005,146.547001,144.81534,388157184,330363966.4,44.37911775592678,NaN,1.5,2.75,NaN,NaN,3.47303978359855,1.1749380183007756,257.59042054108227,-0.2974749389164264,-2.1194172970926104,-1.821942358176184,29.183312391670707,-1.0259215494205902,55.043972413481605,15.63979522652533,29.31623235999307,4571554701
1187616600,145.17,145.47,143.28999,144.64,NaN,NaN,136.368,157.23871741935483,145.5375002000003,149.43810059999993,149.81140000000005,146.080501,148.3653956252111,146.1715356024404,145.0800023076924,149.69227092356627,140.46773369181855,145.5375002000003,149.43810059999993,149.81140000000005,146.080501,144.46666333333334,187079936,333658872.8,44.23910626555871,NaN,1.5,2.75,NaN,NaN,3.380680513341512,0.5606922256556877,260.6224136901742,-0.13352312421471013,-1.9888462634445716,-1.8553231392298615,27.351794057537138,-2.118156594708008,38.139531473805015,28.833069921248835,33.02739860494615,4384474765
1187703000,144.60001,145.97,144.14,144.92999,NaN,NaN,136.052,157.29033064516128,145.57785015000027,149.46770049999995,149.68399980000004,145.7620005,148.23067383598715,146.05329316411274,144.87461615384626,149.2515135651977,140.4977187424948,145.57785015000027,149.46770049999995,149.68399980000004,145.7620005,145.01333,157000816,328667632,45.01294963473556,NaN,1.5,2.75,NaN,NaN,3.269917619531405,0.47768870650456996,263.9259032812371,0.011659311014529994,-1.8407490004616989,-1.8524083114762289,26.438252502869346,-3.2703797637322354,57.92622992946836,13.856800731728317,28.21696933880331,4541475581
1187789400,146.00999,146.8,145.33,146.64999,NaN,NaN,135.736,157.34194387096775,145.6272001000003,149.51420039999994,149.62399980000004,145.51399999999998,148.1686862345759,146.11012143419725,145.09384615384627,149.51871815351,140.66897415418254,145.6272001000003,149.51420039999994,149.62399980000004,145.51399999999998,146.25999666666667,172226192,324018888.8,49.49036777252981,NaN,1.5,2.75,NaN,NaN,3.169924218136305,0.5315313333671305,269.41615438140155,0.22870008316407708,-1.5665332075211325,-1.7952332906852095,26.014927102971928,0.8666276910379093,84.69959169821277,2.0802280180155996,13.220180283771635,4713701773
1187875800,147.34,147.64999,145.61,146.52,NaN,NaN,135.42,157.3935570967742,145.67710015000029,149.55780039999993,149.51659980000005,145.439,148.10403187243566,146.14915748808323,145.11769153846166,149.56962459913456,140.66575847778876,145.67710015000029,149.55780039999993,149.51659980000005,145.439,146.59333,203853744,310838865.6,49.16454201873459,NaN,1.5,2.75,NaN,NaN,3.0892146311265685,0.6558180670441874,268.4525302697421,0.3608193392121555,-1.3442091166700152,-1.7050284558821707,19.010141090048133,1.2507704200974066,52.513859615106796,17.38936081940392,30.096779565489292,4509848029
1187962200,146.48,148.33,146.28,148.33,NaN,NaN,135.104,157.44517032258065,145.7283501500003,149.60420039999994,149.42599980000006,145.59999999999997,148.11289336763426,146.35685677493245,145.16076846153857,149.72396954189634,140.5975673811808,145.7283501500003,149.60420039999994,149.42599980000006,145.59999999999997,147.64666666666668,128886256,296137335.2,53.732231727039334,NaN,1.5,2.75,NaN,NaN,3.0149850146175288,0.43522460926095347,273.59558193117397,0.5557687738215455,-1.0103174886052386,-1.5660862624267842,19.705055519652785,2.134545204158936,37.21571621367866,29.682339504108366,33.10194428221297,4638734285
1188221400,147.85001,148.33,146.73,146.95,NaN,NaN,134.788,157.4967835483871,145.7700501500003,149.63520029999995,149.30359960000004,145.57849999999996,148.0672897061584,146.41334660589126,144.93923000000012,148.79970860299056,141.07875139700968,145.7700501500003,149.63520029999995,149.30359960000004,145.57849999999996,147.33666666666667,112992128,287676272.8,50.040448109129095,NaN,1.5,2.75,NaN,NaN,2.913914656430564,0.39277527791996614,269.7317007910781,0.5750343185950708,-0.8472933641829457,-1.4223276827780165,20.801572019869543,2.7550592794251654,45.48009785325995,22.525593272809378,31.99430887393066,4525742157
1188307800,146.16,146.25,143.46001,143.72,NaN,NaN,134.472,157.54839677419355,145.7941001500003,149.63000019999993,149.12019960000003,145.47849999999997,147.8968077568973,146.15683740533018,144.81076846153857,148.7136079140501,140.90792900902704,145.7941001500003,149.63000019999993,149.12019960000003,145.47849999999997,144.47667,219626128,282827204.8,42.65351299018981,NaN,1.5,2.75,NaN,NaN,2.9550628952569507,0.7765381981387103,263.54745484195996,0.3638013754979952,-0.9675759634055225,-1.3313773389035177,23.03384646580669,1.9001773894056644,16.713889789605265,53.41806704031289,29.868043170081844,4306116029
1188394200,144.37,146.74001,143.96001,146.53999,NaN,NaN,134.156,157.60001,145.8359001500003,149.65100009999992,148.98559940000004,145.48399999999995,147.8435992174111,146.19332812863206,144.95153615384626,148.9602558467987,140.94281646089382,145.8359001500003,149.65100009999992,148.98559940000004,145.48399999999995,145.74667,207614496,269825004.8,49.64282152353587,NaN,1.5,2.75,NaN,NaN,2.9597019741671695,0.7694412760369939,269.6337142179223,0.4044366766203973,-0.8258314931280211,-1.2302681697484183,23.358647020109746,3.1245458744161887,19.361881986330793,49.64662121776616,30.991496795903068,4513730525
1188480600,145.45,147.19,145.31,146.14999,NaN,NaN,133.84,157.65162322580645,145.8754500500003,149.66639999999992,148.8857992,145.41149899999994,147.77718316966948,146.18920068780997,145.0223046153847,149.08036790317465,140.96424132759478,145.8754500500003,149.66639999999992,148.8857992,145.41149899999994,146.21666333333334,191681632,264675377.6,48.757761200783605,NaN,1.5,2.75,NaN,NaN,2.8825804045837997,0.724214068335762,267.11422496671355,0.39503208841614823,-0.736478059228233,-1.1315101476443812,23.502018668697325,0.995079746038295,19.974681945094783,48.812696043578114,31.21262201132711,4322048893
1188567000,147.64999,148.5,146.83,147.59,NaN,NaN,133.524,157.7032364516129,145.9205000500003,149.70209999999992,148.79799920000002,145.60099899999994,147.76984265321187,146.3226101461138,145.37461307692317,149.46778470988693,141.2814414439594,145.9205000500003,149.70209999999992,148.79799920000002,145.60099899999994,147.64000000000001,185474624,255980174.4,52.149981938998174,NaN,1.5,2.75,NaN,NaN,2.844539661399242,0.7245663631362851,273.11422496671355,0.4706430759963982,-0.5432063026488834,-1.0138493786452816,21.935645117396795,2.0395464601770033,24.184923730388864,43.42205443806519,32.39302183154596,4507523517
1188912600,147.45,149.98,147.39999,149.08,NaN,NaN,133.208,157.75484967741934,145.9678000500003,149.7462999999999,148.76859920000004,145.7444984999999,147.82122137269374,146.58521870362677,145.99307538461548,149.6900249565723,142.29612581265866,145.9678000500003,149.7462999999999,148.76859920000004,145.7444984999999,148.8199966666667,120054688,245746595.2,55.43723812955691,NaN,1.5,2.75,NaN,NaN,2.8256446855850093,0.4885304225773461,277.50896335371635,0.5976940807855433,-0.26673177766335243,-0.8644258584488957,22.332107683079165,2.8634584187855174,41.05603298987964,26.173358764872813,32.770608245247544,4627578205
1188999000,148.2,148.36,147,147.78999,NaN,NaN,132.892,157.8064629032258,146.00665000000032,149.7709997999999,148.72779900000003,145.74549799999994,147.81999661298025,146.69995882709088,146.43076615384626,149.4690682996647,143.39246400802782,146.00665000000032,149.7709997999999,148.72779900000003,145.74549799999994,147.71666333333334,166256624,240025557.6,52.10004720012046,NaN,1.5,2.75,NaN,NaN,2.7723843509003667,0.6926621717386648,273.2048462864407,0.5715504588886681,-0.14998778483806063,-0.7215382437267287,23.329295670663576,0.7773611167651537,45.43142150715451,22.562259076639258,32.006319416206225,4461321581
1189085400,147.95,148.61,147.12,148.13,NaN,NaN,132.576,157.85807612903224,146.0454000000003,149.7852997999999,148.72459920000003,145.66049799999993,147.83215360854965,146.8361532245108,146.69384230769242,149.6824532985497,143.70523131683515,146.0454000000003,149.7852997999999,148.72459920000003,145.66049799999993,147.95333333333335,127860432,232681580.8,52.904757942429704,NaN,1.5,2.75,NaN,NaN,2.6807854686931982,0.5495081800647625,275.94458584331585,0.55347929398571,-0.02968912624459108,-0.5831684202303011,22.48636466833365,1.0988260988260887,39.67256363843181,27.379691736275042,32.94774462529315,4589182013
1189171800,146.48,146.89,145.25999,146.07001,NaN,NaN,132.26,157.90968935483872,146.0736500500003,149.7750998999999,148.63799960000003,145.69449849999995,147.76304993762614,146.76318720312884,146.80384307692321,149.5796690635394,144.02801709030703,146.0736500500003,149.7750998999999,148.63799960000003,145.69449849999995,146.07333333333335,235429056,226571715.2,47.678558976843426,NaN,1.5,2.75,NaN,NaN,2.694301506643685,1.0390928796746823,270.47319020666464,0.38699122463172575,-0.09942938944064394,-0.4864206140723697,24.088751432713757,-1.5236230027641178,35.72977838588092,30.999671169509472,33.27055044460959,4353752957
1189431000,146.52,146.72,144.33,145.78999,NaN,NaN,131.944,157.96130258064517,146.10010000000034,149.76029979999987,148.54619940000003,145.74849749999993,147.68567503811138,146.6705017552118,146.86999692307705,149.50126526894525,144.23872857720886,146.10010000000034,149.76029979999987,148.54619940000003,145.74849749999993,145.61333,192354688,215638780.8,46.998905450874204,NaN,1.5,2.75,NaN,NaN,2.672565684740564,0.892022702439616,267.02546741432326,0.24891739036942012,-0.17527387611059453,-0.42419126648001465,22.716695755111715,-0.7893909493024838,10.500329312455127,63.70487111871608,25.794799568828793,4161398269
1189517400,146.24001,147.7,146.13,147.49001,NaN,NaN,131.628,158.01291580645162,146.13435005000034,149.7628998999999,148.48739980000005,145.86149799999993,147.67800189936193,146.74855015947733,146.934613846154,149.5823034783594,144.28692421394862,146.13435005000034,149.7628998999999,148.48739980000005,145.86149799999993,147.10667,162048256,214643984,51.5174595341502,NaN,1.5,2.75,NaN,NaN,2.6180974215448094,0.7549629529798515,271.1522461859929,0.26168530071765245,-0.09708464058294908,-0.3587699413006015,23.315537766657368,2.6231630949067726,13.160958446290048,59.03836852702173,27.80067302668822,4323446525
1189603800,147.28999,148.44,146.98,147.87,NaN,NaN,131.312,158.06452903225806,146.16910005000034,149.75539989999987,148.40900000000005,146.10449849999992,147.68553123664185,146.85535490619378,147.03846000000016,149.71865497398292,144.3582650260174,146.16910005000034,149.75539989999987,148.40900000000005,146.10449849999992,147.76333333333332,149577680,208918040,52.49240541408372,NaN,1.5,2.75,NaN,NaN,2.535376177148752,0.7159634467181484,268.09719572268904,0.28349091483607436,-0.004406297755508604,-0.28789721259158296,18.347899176416178,0.907608905937564,33.28492822583167,33.44090440978804,33.2741673643803,4473024205
1189690200,148.55,149.45,148.2,148.91,NaN,NaN,130.996,158.1161422580645,146.21190000000036,149.7638998999999,148.34040000000005,146.49799899999994,147.73354961951864,147.05103539131818,147.0830753846155,149.86515573777174,144.30099503145928,146.21190000000036,149.7638998999999,148.34040000000005,146.49799899999994,148.85333333333332,153905248,200426550.4,55.150662769623274,NaN,1.5,2.75,NaN,NaN,2.4671350216381254,0.7678885242142051,270.3010883827664,0.35129226342114234,0.15121811668484497,-0.20007414673629736,15.39286534613901,1.888477720730596,35.284971290437774,31.47696645457526,33.23806225498697,4626929453
1189776600,147.96001,149.09,147.74001,148.89999,NaN,NaN,130.68,158.16775548387096,146.26429995000038,149.77169979999988,148.27480000000006,146.8379979999999,147.7792923795375,147.22712630643073,147.23307461538474,150.17590834700619,144.2902408837633,146.26429995000038,149.77169979999988,148.27480000000006,146.8379979999999,148.57666666666668,121903056,179199143.2,55.118694559049494,NaN,1.5,2.75,NaN,NaN,2.387338948663973,0.6802658418067705,272.17003400703663,0.3765587372425775,0.2706242748169245,-0.10593446242565298,15.20069188120624,0.8875872349075135,45.75859206123835,22.34803826018737,31.893369678574274,4505026397
1190035800,148.31,148.8905,147.63,148.10001,NaN,NaN,130.364,158.2193687096774,146.30970000000036,149.75789989999987,148.17720020000007,147.00749799999994,147.79186954112427,147.31025808677066,147.56999846153857,149.72406671281868,145.41593021025847,146.30970000000036,149.75789989999987,148.17720020000007,147.00749799999994,148.20683666666665,109853056,165283936.8,52.49958769120921,NaN,1.5,2.75,NaN,NaN,2.30752830947369,0.6646323782384641,268.3895171518556,0.32256837187282067,0.2972760024153729,-0.025292369457447797,14.792383966688215,-0.6573584652535651,56.400798580524935,14.766317092932558,28.83288432654252,4395173341
1190122200,148.83,152.5,148.13409,152.46001,NaN,NaN,130.048,158.27098193548386,146.36965005000036,149.78600009999988,148.16640040000004,147.39849849999993,147.9749338728449,147.80071064993535,148.02538461538472,151.31805399673283,144.73271523403662,146.36965005000036,149.78600009999988,148.16640040000004,147.39849849999993,151.03136666666668,263372816,169098580.8,62.85834374580788,NaN,1.5,2.75,NaN,NaN,2.4569898587969976,1.5575105051384321,275.7308206357136,0.5502942897031984,0.6625754926715501,0.1122812029683518,21.710540505972673,3.1599027782598963,63.086740781685144,10.815541003561277,26.09771821475359,4658546157
1190208600,153.41,154.39,148.10001,153.36,NaN,NaN,129.732,158.3225951612903,146.43380005000034,149.8243000999999,148.21520040000004,147.81999899999994,148.1861129366549,148.33016677851293,148.58000076923088,152.73757629058187,144.4224252478799,146.43380005000034,149.8243000999999,148.21520040000004,147.81999899999994,151.95000333333334,193766752,170936877.6,64.5756509161694,NaN,1.5,2.75,NaN,NaN,2.7307755831686396,1.1335573383610231,278.9808206357136,0.7205927601950598,1.0130221532121766,0.2924293930171168,20.61097049276481,3.530682508607317,65.6031407159147,9.48043255608148,24.916426728003795,4852312909
1190295000,153.34,153.42999,152.11,152.28,NaN,NaN,129.416,158.37420838709676,146.49410005000036,149.8642001999999,148.22100020000005,148.10149949999996,148.3466575273743,148.7063413710355,148.94077000000013,153.48780779461617,144.39373220538408,146.49410005000036,149.8642001999999,148.22100020000005,148.10149949999996,152.60666333333333,175178752,171084505.6,60.93464205222355,NaN,1.5,2.75,NaN,NaN,2.630005184370879,1.0239311350004567,274.50661472644674,0.7179687791778513,1.189890366989431,0.47192158781157967,21.522213045085476,4.251379184543087,37.060766064486835,29.759182135388233,33.18005180012495,4677134157
1190381400,152.71001,153.11771,151.74001,151.97,NaN,NaN,129.1,158.42582161290323,146.54750010000035,149.8972001999999,148.17260020000003,148.37399949999994,148.4887493890459,149.01716600236546,149.16307769230784,153.9896045997769,144.33655078483878,146.54750010000035,149.8972001999999,148.17260020000003,148.37399949999994,152.27590666666666,141459312,167964784,59.89079789552619,NaN,1.5,2.75,NaN,NaN,2.540554814058672,0.842196254662525,277.40776392403495,0.654601114101933,1.2901729804389959,0.6355718663370629,19.072876411591313,4.238981016460739,35.24016736023597,31.481775764123544,33.2780568756405,4535674845
1190640600,152.42,152.82001,151.36,151.69,NaN,NaN,128.784,158.47743483870968,146.59645015000032,149.9187002999999,148.10940000000002,148.54199949999995,148.61428862869116,149.2717216211878,149.4630784615386,154.3946061387455,144.5315507843317,146.59645015000032,149.9187002999999,148.10940000000002,148.54199949999995,151.95667,139314944,168486218.4,58.909195715175734,NaN,1.5,2.75,NaN,NaN,2.4633730416259083,0.8268625488955719,274.28664564522126,0.5569048839353714,1.3317029712562771,0.7747980873209057,19.06451923903258,2.8476437149878726,34.91064147050488,31.828373471723317,33.2609850577718,4396359901
1190727000,150.81,151.66,150.47,151.39,NaN,NaN,128.468,158.52904806451613,146.64450015000034,149.9291001999999,148.04060000000004,148.76399949999995,148.72314005501698,149.47346241916992,149.71384769230784,154.68014356439238,144.7475518202233,146.64450015000034,149.9291001999999,148.04060000000004,148.76399949999995,151.17333333333332,142289568,169951090.4,57.81581854683498,NaN,1.5,2.75,NaN,NaN,2.3745606815097715,0.8372383352475389,271.80293246354523,0.4402679198884222,1.3251329871814335,0.8848650672930113,18.66581012027401,2.380469331169258,7.9385673961604,68.75057711071746,23.310855493122126,4254070333
1190813400,152.25,152.77,151.39,152.19,NaN,NaN,128.152,158.58066129032258,146.69965015000034,149.9418001999999,147.98940000000002,149.18749949999997,148.8590953469771,149.73218028401087,150.18461615384632,154.82991109639084,145.5393212113018,146.69965015000034,149.9418001999999,147.98940000000002,149.18749949999997,152.11666666666665,135546944,165747131.2,59.950520275134295,NaN,1.5,2.75,NaN,NaN,2.3035206328305042,0.8177936053471797,274.8249107793471,0.3870695437299747,1.3687019969554797,0.981632453225505,18.727789457669694,2.202672755355585,4.310228809709437,77.457871902455,18.231899287835574,4389617277
1190899800,152.91,153.10001,152.19,153.09,NaN,NaN,127.836,158.63227451612903,146.75800015000033,149.9632001999999,147.9618,149.51499999999996,149.02501317650743,150.0519726379146,150.74615538461555,154.86591119690644,146.62639957232466,146.75800015000033,149.9632001999999,147.9618,149.51499999999996,152.79333666666665,102704064,160501609.6,62.264075022133646,NaN,1.5,2.75,NaN,NaN,2.2039841590568967,0.6398942929977943,278.03021460312726,0.381921548830243,1.4590343892633086,1.0771128404330657,18.648962166487365,2.8139760116840846,17.911419809415708,51.71898662014436,30.36959357043992,4492321341
1190986200,152.85001,153.19,151.98,152.58,NaN,NaN,127.52,158.68388774193548,146.81175015000034,149.9815001999999,147.91199980000002,149.83650049999997,149.16442442448752,150.2927371485894,151.13769307692326,154.8969008992077,147.3784852546388,146.81175015000034,149.9815001999999,147.91199980000002,149.83650049999997,152.58333333333334,133367008,157585878.4,60.143828675380504,NaN,1.5,2.75,NaN,NaN,2.1329852905528335,0.8463131935050342,276.03389445905043,0.3163070859647017,1.4724966978889427,1.156189611924241,18.922581213341786,3.024976163067116,18.347747458793123,51.09959046322415,30.55266207798271,4358954333
1191245400,152.60001,154.75,152.5,154.3,NaN,NaN,127.204,158.73550096774193,146.87465015000032,150.0129001999999,147.9279998,150.17200049999997,149.36581954509586,150.67438122967613,151.63230846153868,155.23016386222412,148.03445306085325,146.87465015000032,150.0129001999999,147.9279998,150.17200049999997,153.85,148120256,155718160,64.53060524187538,NaN,1.5,2.75,NaN,NaN,2.141343484084774,0.9512073350982313,281.03966036525225,0.3578254934566356,1.6034714787450355,1.2456459852883999,18.806996636871318,1.206867295889591,44.53536675448303,23.284951006994426,32.179682238522545,4507074589
1191331800,154.61,154.64999,153.81,154.09,NaN,NaN,126.888,158.78711419354838,146.93575015000033,150.0580001999999,147.9303998,150.42250049999998,149.55108152371955,150.99967825542126,152.03077000000022,155.47862707775937,148.58291292224106,146.93575015000033,150.0580001999999,147.9303998,150.42250049999998,154.18332999999998,112689008,155349876,63.610047177937574,NaN,1.5,2.75,NaN,NaN,2.0483896637930044,0.7253884644233639,283.28716610524094,0.3403325972050921,1.6710617317947651,1.330729134589673,10.216095835829993,0.47600417318726507,48.20928215290701,20.429792007830475,31.360925839262503,4394385581
1191418200,153.81,154.41,153.00999,153.78,NaN,NaN,126.572,158.83872741935483,146.98905015000034,150.0872001999999,147.9799998,150.722001,149.71692146396583,151.264470802524,152.4061553846156,155.44747203506194,149.36483873416927,146.98905015000034,150.0872001999999,147.9799998,150.722001,153.73333,119037872,152988938.4,62.19946249895279,NaN,1.5,2.75,NaN,NaN,2.0020768306649335,0.7780815609607498,280.4498023796336,0.27961211232017247,1.6802442749898887,1.4006321626697162,9.851870243509172,0.9850275807722616,21.34344654205269,47.004953966617755,31.651599491329563,4275347709
1191504600,154.11,154.25999,153.59,154.02,NaN,NaN,126.256,158.89034064516127,147.04745015000034,150.1221001999999,148.0281998,151.016501,149.88566964184952,151.52690215466455,152.86153923076944,154.7366360447309,150.986442416808,147.04745015000034,150.1221001999999,148.0281998,151.016501,153.95666333333335,76764944,150434164,62.88566044343789,NaN,1.5,2.75,NaN,NaN,1.906927771331723,0.5102892983803865,282.9981012554513,0.22944290302698933,1.6874357914534528,1.4579928884264635,8.676321109281734,1.3489504507468655,18.603969523154856,50.704549545584385,30.691480931260763,4352112653
1191591000,155.03,156.10001,154.63,155.85001,NaN,NaN,125.94,158.94195387096775,147.11695020000033,150.1749001999999,148.18480000000002,151.505501,150.11956534216915,151.93862671136316,153.1223084615387,155.56000506181448,150.6846118612629,147.11695020000033,150.1749001999999,148.18480000000002,151.505501,155.52667333333332,134583008,145391861.6,67.70042591773162,NaN,1.5,2.75,NaN,NaN,1.9192907876651704,0.9256570933128488,287.32143058255417,0.2894647585735217,1.8198238366433657,1.530359078069844,10.30523957567649,2.7424418221372533,47.993634357110594,20.591821084034503,31.414544558854896,4486695661
1191850200,155.39,155.49001,154.77,155.02,NaN,NaN,125.624,158.9935670967742,147.18095020000032,150.20910009999992,148.38300000000004,151.9670015,150.3117392503194,152.23209083409049,153.250000769231,155.88966578298593,150.6103357554761,147.18095020000032,150.20910009999992,148.38300000000004,151.9670015,155.0933366666667,71270128,139337633.6,63.66622917535521,NaN,1.5,2.75,NaN,NaN,1.8593421599748001,0.5114923094258722,284.21302871629524,0.2449897831110026,1.8365963069585973,1.5916065238475947,11.015992169980365,2.3977805667481498,24.271870303485468,43.44733599723918,32.28079369927536,4415425533
1191936600,155.60001,156.5,155.03,156.48,NaN,NaN,125.30799999999999,159.04518032258065,147.25265020000032,150.2609000999999,148.56500000000003,152.416501,150.55363182873825,152.63665361179616,153.57307769230792,156.65056530209344,150.4955900825224,147.25265020000032,150.2609000999999,148.56500000000003,152.416501,156.00333333333333,94001120,135935276.8,67.35160455236283,NaN,1.5,2.75,NaN,NaN,1.832246291405171,0.6915138013681522,287.8670829955933,0.2829343771642645,1.9452744953029253,1.6623401181386608,11.370669566204919,2.818844864971412,52.25399519419548,17.600099945914657,30.14590485988986,4509426653
1192023000,156.03999,156.44,155.41,156.22,NaN,NaN,124.99199999999999,159.0967935483871,147.32565020000033,150.2969000999999,148.775,152.834001,150.77584234525833,152.977924696387,153.90000076923099,157.1262125988326,150.67378893962936,147.32565020000033,150.2969000999999,148.775,152.834001,156.02333333333334,101668560,133539820.8,66.06644406369189,NaN,1.5,2.75,NaN,NaN,1.7778001277333726,0.7613351537461401,286.52644982529756,0.26013759589317065,1.987512113005124,1.7273745171119534,11.62520645999122,2.044548958129202,55.16330166359175,15.639277990669028,29.197420345739225,4407758093
1192109400,156.92999,157.52,154.53999,155.47,NaN,NaN,124.676,157.52,147.39925020000032,150.3262001999999,148.95580020000003,153.162001,150.95992695916976,153.215265201493,154.1907700000002,157.24460116217912,151.1369388378213,147.39925020000032,150.3262001999999,148.95580020000003,153.162001,155.84333,233513568,137520236.8,62.36940838582393,NaN,1.5,2.75,NaN,NaN,1.8636722614667047,1.698030583961298,282.6226055661089,0.16860078079679464,1.9381254931079468,1.7695247123111522,12.13073597479832,1.894088347096596,18.43293471524485,51.068208503544966,30.498856781210197,4174244525
1192195800,155.46001,156.35001,155.27,156.33,NaN,NaN,124.36,157.54491803278688,147.47300020000034,150.3653001999999,149.13040000000004,153.5335015,151.17051805881016,153.5119066108746,154.57077000000024,157.3533486542526,151.78819134574786,147.47300020000034,150.3653001999999,149.13040000000004,153.5335015,155.98333666666667,124539376,137652052.8,64.80170328371375,NaN,1.5,2.75,NaN,NaN,1.8076963856476536,0.9047404195340848,284.95943767683605,0.14113971878180154,1.9459493607884042,1.8048096420066027,11.88975989521018,1.3156189241736882,17.399162087592277,52.544352501169186,30.056485411238523,4298783901
1192455000,156.27,156.36,153.94,155.00999,NaN,NaN,124.044,157.56983606557378,147.53550020000034,150.3910000999999,149.35459980000002,153.87900050000002,151.32108558591565,153.65458121936274,154.78769230769254,157.21047186654957,152.3649127488355,147.53550020000034,150.3910000999999,149.35459980000002,153.87900050000002,155.10333,161094752,140214137.6,58.54652413442043,NaN,1.5,2.75,NaN,NaN,1.8514323581013936,1.1489194653078978,281.02410514892136,0.01583482042481177,1.8246031675376173,1.8087683471128055,11.937105377201906,0.5970471802193421,13.188250190235573,59.07541800500708,27.73633180475736,4137689149
1192541400,154.41,156.48,153.47,153.78,NaN,NaN,123.728,157.59475409836065,147.59335015000033,150.4182000999999,149.50599960000002,153.94500000000002,151.41751360215426,153.66652586513771,154.84076923076947,157.13951197132138,152.54202649021755,147.59335015000033,150.4182000999999,149.50599960000002,153.94500000000002,154.57666666666668,166428752,135366934.4,53.3762840580513,NaN,1.5,2.75,NaN,NaN,1.9341871896655791,1.2294638475612845,277.3465529407396,-0.15851923383478583,1.6106193048193234,1.7691385386541092,12.868714395736546,0,3.2896496134424233,80.53616800448691,16.174182382070672,3971260397
1192627800,154.98,155.09,152.47,154.25,NaN,NaN,123.41199999999999,157.61967213114755,147.65650015000034,150.4438000999999,149.6355996,153.98950000000002,151.528591500109,153.7220948303627,154.96923076923102,156.90648569535554,153.0319758431065,147.65650015000034,150.4438000999999,149.6355996,153.98950000000002,153.93666666666667,216672560,136512224.8,55.01119830961012,NaN,1.5,2.75,NaN,NaN,1.983173818975181,1.587202613666582,278.38249248130523,-0.2456257334309082,1.4621063718654739,1.707732105296382,12.935638733687568,0.14933125568107372,20.40371622273803,48.37682596741674,31.219457809845245,4187932957
1192714200,153.45,154.19,153.08,153.69,NaN,NaN,123.096,157.64459016393442,147.71810015000034,150.4582999999999,149.7127996,154.06,151.6133526177518,153.71903817985196,154.92230769230792,156.9495868518692,152.89502853274664,147.71810015000034,150.4582999999999,149.7127996,154.06,153.65333333333334,148428368,135174705.6,52.642553739299295,NaN,1.5,2.75,NaN,NaN,1.9250899747626673,1.0980483910889316,277.2837126702554,-0.33865325238524147,1.2844155398148303,1.6230687922000717,13.093641038956804,-1.3859543544463038,25.099782777552925,42.460364479869845,32.439852742577216,4039504589
1192800600,153.09,156.48,149.66,149.67,NaN,NaN,122.78,157.66950819672132,147.75810015000033,150.4201999999999,149.79839959999998,153.94500000000002,151.5371427111733,153.33341549605655,154.58230769230792,158.03521048761442,151.12940489700142,147.75810015000033,150.4201999999999,149.79839959999998,153.94500000000002,151.93666666666664,297148672,142959173.6,39.49571169054349,NaN,1.5,2.75,NaN,NaN,2.274726405136762,2.078556167591053,271.626858420763,-0.6505525528442255,0.8098781011447898,1.4604306539890153,17.814228911869495,-3.4511675912785593,6.573016628276803,71.83457166363591,21.592411708087294,3742355917
1193059800,148.86,150.75999,148.66,150.53999,NaN,NaN,122.464,157.6944262295082,147.80810015000034,150.3923997999999,149.9149992,153.88749950000005,151.49803868328414,153.0673749726226,154.3330761538464,158.39556381860345,150.27058848908936,147.80810015000034,150.3923997999999,149.9149992,153.88749950000005,149.98666,261945376,149090695.2,42.823639482019445,NaN,1.5,2.75,NaN,NaN,2.2622452333412784,1.7569532132680004,273.9052737627471,-0.769735690227157,0.498261041205069,1.267996731432226,18.643103992850733,-3.7960186605316983,24.563726204980064,43.002894486017375,32.43337930900257,4004301293
1193146200,151.46001,151.95,150.25,151.75999,NaN,NaN,122.148,157.7193442622951,147.86095010000034,150.3691996999999,150.045599,153.90599900000004,151.50831128393966,152.9428621180871,154.15922923076945,158.44757585416687,149.87088260737204,147.86095010000034,150.3691996999999,150.045599,153.90599900000004,151.31999666666664,179986432,150975538.4,47.20874434164978,NaN,1.5,2.75,NaN,NaN,2.222084859531186,1.1921562519826059,277.5499386430279,-0.7377890892717283,0.34576036984256575,1.083549459114294,18.341773168176108,-2.8549545512738517,45.835105091239015,22.277091967022166,31.887802941738826,4184287725
1193232600,151.21001,151.74001,148,151.48,NaN,NaN,121.832,157.74426229508197,147.91300005000033,150.3429995999999,150.2149992,153.87049900000005,151.50720103751067,152.80354191636454,153.82307461538483,158.21249406564627,149.43365516512338,147.91300005000033,150.3429995999999,150.2149992,153.87049900000005,150.40667,326582016,160527292,46.330534778706614,NaN,1.5,2.75,NaN,NaN,2.331935226707529,2.0344329735531823,274.5285860603968,-0.7068362767827688,0.200004113135833,0.9068403899186018,18.336956874574078,-2.5664115263394924,16.373192311598316,53.96385400175406,29.66295368664764,3857705709
1193319000,151.64999,152.28999,149.88,151.84,NaN,NaN,121.51599999999999,157.76918032786887,147.96450010000032,150.32649949999993,150.4309994,153.80799900000005,151.52025197721613,152.7117760195679,153.57845923076945,158.02782695557474,149.12909150596417,147.96450010000032,150.32649949999993,150.4309994,153.80799900000005,151.33666333333335,237346064,167259392,47.67826362674654,NaN,1.5,2.75,NaN,NaN,2.3375105676569907,1.4190298144812101,273.5487901632835,-0.6356752597097416,0.11224631528142481,0.7479215749911664,18.550630830736377,-2.8721294697115134,35.131692577722035,31.612113893670923,33.25619352860704,4095051773
1193405400,153.06,153.62,151.89999,153.62,NaN,NaN,121.2,157.79409836065574,148.02180010000032,150.34429949999992,150.6613992,153.85999900000004,151.60259503693314,152.79827354151382,153.35845923076945,157.48318484548494,149.23373361605397,148.02180010000032,150.34429949999992,150.6613992,153.85999900000004,153.04666333333333,176488496,169415466.4,53.84927027051742,NaN,1.5,2.75,NaN,NaN,2.2976883842529197,1.0417496097038752,277.42177350949095,-0.4509729819469036,0.18420534755753692,0.6351783295044405,19.794156016291083,-0.8967099475330482,64.48828431299636,10.075048257450732,25.436667429552898,4271540269
1193664600,153.92999,154.44,153.55,154.13,NaN,NaN,120.884,157.81901639344264,148.07625005000034,150.39459939999992,150.849799,153.85149900000005,151.7017089570534,152.92510463279822,153.19769000000022,157.01523155412127,149.38014844587917,148.07625005000034,150.39459939999992,150.849799,153.85149900000005,154.04,106819248,167350416,55.46982291940834,NaN,1.5,2.75,NaN,NaN,2.197139213949139,0.6382968776127811,279.3749286018517,-0.2848082146499331,0.2791680611920242,0.5639762758419573,19.482096250923092,0.22759786708284194,61.21586060592354,11.894923628280155,26.889215765796312,4378359517
1193751000,153.45,153.75,152.87,153.06,NaN,NaN,120.568,157.8439344262295,148.12675000000033,150.41479949999993,151.018199,153.799999,151.75497527246307,152.93795181062697,153.01230538461562,156.59744845904808,149.42716231018315,148.12675000000033,150.41479949999993,151.018199,153.799999,153.22666666666666,132970816,168364506.4,51.39243481721482,NaN,1.5,2.75,NaN,NaN,2.1302006986670565,0.7897793830968639,276.8671628853445,-0.2391558047576423,0.2650315198949045,0.5041873246525468,19.351481818510713,-0.7714748784440828,39.511457343300165,27.588764115245244,32.89977854145459,4245388701
1193837400,153.98,155.27,152.84,154.64999,NaN,NaN,120.252,157.8688524590164,148.18489995000036,150.4482993999999,151.212599,153.8434985,151.86850526177824,153.10100306675773,152.8830738461541,156.0807108761151,149.68543681619312,148.18489995000036,150.4482993999999,151.212599,153.8434985,154.25333,220927568,173458991.2,56.508382876196485,NaN,1.5,2.75,NaN,NaN,2.151614934476553,1.2736587851203878,281.15741346077715,-0.10113194850418827,0.37777238902231147,0.47890433752649975,20.26381071830749,0.6246274969093661,83.41150682429954,2.4228061326382155,14.165687043062256,4466316269
1193923800,153.28999,153.41,150.59,151.03,NaN,NaN,119.93599999999999,157.89377049180328,148.22735000000034,150.46209949999994,151.3001992,153.69399850000002,151.83562270249283,152.90376467944748,152.57692076923104,155.6614974158749,149.49234412258718,148.22735000000034,150.46209949999994,151.3001992,153.69399850000002,151.67666666666665,332966400,186269064,44.917097348197466,NaN,1.5,2.75,NaN,NaN,2.287927439156799,1.7875560914398538,274.146144336229,-0.2447051497915017,0.17302290028712264,0.41772805007862435,24.488492470450517,0.9086657312754819,38.28158157128285,28.693004164770446,33.02541426394671,4133349869
1194010200,151.53,152,149.21001,151.2,NaN,NaN,119.62,157.91868852459018,148.26924995000033,150.45519949999994,151.3937992,153.461498,151.8106963220029,152.74150137664296,152.3784592307695,155.45986614915768,149.2970523123813,148.26924995000033,150.45519949999994,151.3937992,153.461498,150.80333666666667,331219456,196100886.4,45.48265857488832,NaN,1.5,2.75,NaN,NaN,2.323789050645598,1.6890257972847185,272.4231382422177,-0.3148255466214224,0.0241961168018463,0.3390216634232687,18.737289978020957,0.43842835382146617,47.33539425741811,21.14161532554209,31.5229904170398,4464569325
1194273000,149.64,151.16,148,150.05,NaN,NaN,119.304,157.94360655737705,148.30759995000034,150.42709949999994,151.4281992,153.21299800000003,151.74164940741457,152.48516791220078,152.05538230769255,155.1647283878791,148.946036227506,148.30759995000034,150.42709949999994,151.4281992,153.21299800000003,149.73666666666665,226765936,203875676.8,42.31735799142501,NaN,1.5,2.75,NaN,NaN,2.3863755470280545,1.1122755767597285,267.50529469192196,-0.41875308670035,-0.1844196949521688,0.23433339174818119,19.065384519416085,-1.1267726098294923,25.326686283983932,42.090541197517574,32.5827725184985,4237803389
1194359400,150.86,152.11,149.89999,152.07001,NaN,NaN,118.988,157.96852459016395,148.35395000000034,150.41709949999992,151.5305994,152.9924985,151.7545262933983,152.44562906341974,151.93076769230794,154.89452164967423,148.96701373494164,148.35395000000034,150.41709949999992,151.5305994,152.9924985,151.36,177729632,208062102.4,49.02768706733109,NaN,1.5,2.75,NaN,NaN,2.373778007954623,0.8542143424962334,270.5525416930222,-0.33516518036322035,-0.18462308370584424,0.1505420966573761,20.129964262079202,0.38949696329548894,41.61821900965787,25.727177577816196,32.65460341252592,4415533021
1194445800,150.44,152.10719,147.55,147.91,NaN,NaN,118.672,157.99344262295082,148.3737500000003,150.36729949999994,151.6143994,152.5769985,151.60376055640228,152.0136643907131,151.79538307692332,155.2756437786198,148.31512237522682,148.3737500000003,150.36729949999994,151.6143994,152.5769985,149.18906333333334,306449152,218301132,38.97264126668435,NaN,1.5,2.75,NaN,NaN,2.529736007386435,1.4037909432370694,262.86778043742316,-0.532058570666505,-0.5145311166757551,0.01752745399074987,25.771524274622905,-2.5882507903055894,17.28731051366462,52.6154342160823,30.097255270253083,4109083869
1194532200,147.99001,149.3,145.07001,147.16,NaN,NaN,118.356,158.01836065573772,148.39825005000034,150.30619949999993,151.6267996,152.16149850000002,151.42949543654336,151.5514106392166,151.53538384615405,155.77427582711962,147.29649186518847,148.39825005000034,150.30619949999993,151.6267996,152.16149850000002,147.17666999999997,374404352,225345671.2,37.48020373258285,NaN,1.5,2.75,NaN,NaN,2.6511827211445476,1.6614668034501832,261.7583800449727,-0.6755991861059198,-0.8269715286416499,-0.1513723425357301,25.622924133022384,-4.205181616976962,16.4495635894022,53.84925974889515,29.701176661702636,3734679517
1194618600,145.69,147.53999,144.89,145.14,NaN,NaN,118.03999999999999,158.0432786885246,148.41315005000033,150.24619949999993,151.6065998,151.6019985,151.18284855667892,150.94080010214836,151.02615384615407,156.45757400589946,145.5947336864087,148.41315005000033,150.24619949999993,151.6065998,151.6019985,145.85666333333333,277731328,233005268.8,33.733320143934904,NaN,1.5,2.75,NaN,NaN,2.6510975267770798,1.1919529950131325,257.31240808524706,-0.857683285468323,-1.2234764493711339,-0.36579316390281086,24.38792013278442,-5.83273859728801,1.8970799195132588,85.40068661735495,12.702233463131787,3456948189
1194877800,145.21001,146.61,143.7,143.7,NaN,NaN,117.72399999999999,158.0681967213115,148.42140005000033,150.16339949999994,151.5287998,151.036499,150.88940351524053,150.25120009241994,150.42769230769252,157.0999443590528,143.75544025633224,148.42140005000033,150.16339949999994,151.5287998,151.036499,144.67,243016816,237101372,31.328905902390844,NaN,1.5,2.75,NaN,NaN,2.669590560578719,1.0249490078868038,253.99171131694268,-1.0154114657606987,-1.6350574961036841,-0.6196460303429855,23.781024947666225,-6.115248921991385,1.9354438496366808,85.22937656117405,12.835179589189265,3213931373
1194964200,145.37,148.31,145.22,148.08,NaN,NaN,117.408,158.09311475409837,148.44785010000035,150.13869949999994,151.5087998,150.751499,150.77923082836836,150.04441913123708,150.13846153846174,156.8664997170667,143.4104233598568,148.44785010000035,150.13869949999994,151.5087998,150.751499,147.20333333333335,191073376,238333603.2,44.32727790471804,NaN,1.5,2.75,NaN,NaN,2.8081912348230973,0.8017055649498946,259.7217491294997,-0.7758723244422462,-1.5894864358957932,-0.813614111453547,31.876859479213863,-4.248296427306585,2.104559343867037,84.56362244302214,13.331818213110829,3405004749
1195050600,149.22,149.39999,146.78,147.67,NaN,NaN,117.092,158.11803278688527,148.46745010000032,150.11709949999994,151.50639999999999,150.422499,150.65730020764803,149.81828397588117,149.68076923076944,156.20563387913276,143.15590458240612,148.46745010000032,150.11709949999994,151.50639999999999,150.422499,147.94999666666664,230524880,239026219.2,43.497290260176435,NaN,1.5,2.75,NaN,NaN,2.7947482894785907,0.9644334448812635,256.5594714693313,-0.603808999609077,-1.5683753609648932,-0.9645663613558162,30.69264580254564,-2.2247235648546737,2.374634402927423,83.54913531229944,14.076230284773153,3174479869
1195137000,146.57001,147.49001,144.52,145.53999,NaN,NaN,116.776,158.14295081967214,148.47210005000034,150.08959949999996,151.45459979999998,150.0149985,150.45662137597557,149.41082740674963,149.0199992307694,155.3455133296871,142.6944851318517,148.47210005000034,150.08959949999996,151.45459979999998,150.0149985,145.85,263051680,244757384.8,39.37272218155033,NaN,1.5,2.75,NaN,NaN,2.8201234116586895,1.0747446097078905,251.49030698478074,-0.5914488702289005,-1.7038774491419417,-1.1124285789130413,29.019413214416204,-3.743392857142857,2.8838503926575934,81.76996963157137,15.346179975771028,2911428189
1195223400,146.31,146.47,144.57001,145.78999,NaN,NaN,116.46,158.16786885245904,148.47700000000034,150.04349949999994,151.4489994,149.82099799999997,150.27361622397652,149.06598574896395,148.46076769230788,154.53935944569764,142.38217593891812,148.47700000000034,150.04349949999994,151.4489994,149.82099799999997,145.60999999999999,308757248,245337813.6,40.090769500010374,NaN,1.5,2.75,NaN,NaN,2.7543995965402117,1.2584984086611262,249.57150053758025,-0.5266008385241308,-1.7706796270682048,-1.244078788544074,29.057272219243853,-2.8390603132289383,21.16790066790388,47.232784018538894,31.599315313557238,3220185437
1195482600,145.28,145.36,143.19,143.75999,NaN,NaN,116.14399999999999,158.1927868852459,148.47154990000033,149.97729939999996,151.40839939999998,149.48199799999998,150.01817990146765,148.56065282049119,147.6230753846156,153.02260588975923,142.22354487947194,148.47154990000033,149.97729939999996,151.40839939999998,149.48199799999998,144.10333,267712624,245626176,36.328317303601374,NaN,1.5,2.75,NaN,NaN,2.7433703396444815,1.0899189506577671,243.54319849372786,-0.5765578911530826,-1.9647761524854275,-1.3882182613323448,29.60296956600017,-5.464601468757718,19.340009274522565,49.79461045865538,30.86538026682206,2952472813
1195569000,144.02,145.53,142.11,144.64,NaN,NaN,115.828,158.2177049180328,148.47029990000033,149.91939949999994,151.35139919999997,149.12599849999998,149.80727088572382,148.18725731377774,147.13153692307714,152.3617507470024,141.90132309915188,148.47029990000033,149.91939949999994,151.35139919999997,149.12599849999998,144.09333333333333,414724608,257363084.8,39.00087126773706,NaN,1.5,2.75,NaN,NaN,2.7917010296698748,1.6114378187621101,242.97037653185836,-0.5088295833037901,-2.0242552404620824,-1.5154256571582922,28.284353813740513,-2.2108038672165575,29.68007125676453,37.24923677045436,33.07069197278109,3367197421
1195655400,143.08,143.91,141.67,141.67999,NaN,NaN,115.512,158.24262295081968,148.45264980000036,149.81829949999997,151.22759899999997,148.63599799999997,149.48855398824446,147.56751756960844,146.39922846153866,151.80861011999457,140.98984680308274,148.45264980000036,149.81829949999997,151.22759899999997,148.63599799999997,142.41999666666666,259160320,253992000,33.8536183956748,NaN,1.5,2.75,NaN,NaN,2.8044366704077404,1.0203483574285803,238.6421744416905,-0.6147901811312952,-2.2839133835724112,-1.669123202441116,26.443214014257116,-3.723844794781186,28.922414204053965,38.0728061367779,33.00477965916813,3108037101
1195828200,143.07001,144.34,142.7,144.13,NaN,NaN,115.196,158.26754098360658,148.44819980000034,149.73619949999994,151.13199899999998,148.25049799999996,149.27841461615645,147.24013494393145,145.94384384615404,151.03455848009557,140.8531292122125,148.44819980000034,149.73619949999994,151.13199899999998,148.25049799999996,143.72333333333333,77684624,246008928,40.81610110452821,NaN,1.5,2.75,NaN,NaN,2.79412047966433,0.3157796939792364,244.6421744416905,-0.4774049217051677,-2.2658793545725757,-1.788474432867408,29.13578109745089,-0.6958798401543276,46.39654667272566,21.89955795589955,31.703895371374788,3185721725
1196087400,144.42999,144.88,140.66,140.95,NaN,NaN,140.66,158.29245901639345,148.43324980000037,149.62389959999996,150.97299919999998,147.61699799999997,148.95181012140523,146.64107447308083,145.08845846153866,149.46045469308865,140.71646222998868,148.43324980000037,149.62389959999996,150.97299919999998,147.61699799999997,142.16333333333333,214165440,247892775.2,35.58105190876307,NaN,1.5,2.75,NaN,NaN,2.8959690168311636,0.863943855673935,238.99585241926277,-0.5529031387470542,-2.479603356301226,-1.9267002175541716,30.74611345875605,-1.9137091162143356,22.20703180550491,45.90575488043835,31.88721331405673,2971556285
1196173800,141.74001,143.23,140.95,142.57001,NaN,NaN,140.7122857142857,158.31737704918035,148.42884985000035,149.51979969999994,150.86239919999997,147.03899849999996,148.70154344997758,146.25335404707315,144.67769000000018,148.91342179333253,140.44195820666783,148.42884985000035,149.51979969999994,150.86239919999997,147.03899849999996,142.25000333333332,293832192,257243422.4,39.81597691766755,NaN,1.5,2.75,NaN,NaN,2.851971229914652,1.1422340336582304,242.82906887376893,-0.450289250713114,-2.4895617809455644,-2.0392725302324504,31.396648427667664,-3.7209548892490654,52.52160826163435,17.339583254992508,30.138808483373147,3265388477
1196260200,144.19,147.47,144.14,147.13,NaN,NaN,140.76457142857143,158.34229508196722,148.44119985000034,149.46109969999995,150.755799,146.74249849999995,148.6399142950765,146.33684413782808,144.67538230769247,148.90573125131874,140.4450333640662,148.44119985000034,149.46109969999995,150.755799,146.74249849999995,146.24666666666667,259068752,263548319.2,49.81652313024141,NaN,1.5,2.75,NaN,NaN,2.9982582849207486,0.9830028618144949,249.42716585099882,-0.052768379837552004,-2.1052330050293904,-2.0524646251918384,31.9257958128455,-0.36568023295184676,45.06790176935257,22.86945510394733,32.06264312670012,3524457229
1196346600,146.62,147.72,146.10001,147.17999,NaN,NaN,140.81685714285715,158.36721311475412,148.44904980000035,149.42369959999994,150.6321988,146.36899849999998,148.58266236193623,146.41714374374922,144.83230461538477,149.26638902367702,140.39822020709252,148.44904980000035,149.42369959999994,150.6321988,146.36899849999998,147,199180560,262460968.8,49.914778441285655,NaN,1.5,2.75,NaN,NaN,2.899810550283552,0.7588959261663748,247.20469111787045,0.2210583796560457,-1.7761416506217813,-1.997200030277827,31.89986502040955,1.1268380601098125,76.80067836379013,4.5434837293054935,18.65583790690438,3723637789
1196433000,149.03999,149.87,147.33,148.66,NaN,NaN,140.86914285714286,158.392131147541,148.46334980000037,149.39039949999994,150.55979879999998,146.25049849999996,148.58569521048776,146.6307491014874,145.21384307692324,150.02969182233375,140.39799433151273,148.46334980000037,149.39039949999994,150.55979879999998,146.25049849999996,148.62,222886496,256956973.6,52.85765895503566,NaN,1.5,2.75,NaN,NaN,2.88482479669187,0.8674078499498642,251.68525711985203,0.49375831412843585,-1.3800021376172822,-1.873760451745718,31.00118593980511,1.9685919451671599,80.13799832897297,3.393203120663855,16.46879855036316,3946524285
1196692200,148.19,148.45,147.28999,147.67999,NaN,NaN,140.92142857142858,158.4170491803279,148.47309975000036,149.32329939999997,150.4739986,146.07449799999998,148.55017735909607,146.73067680610765,145.18307307692325,149.92989433010808,140.43625182373842,148.47309975000036,149.32329939999997,150.4739986,146.07449799999998,147.80666,145927872,247692394.4,50.73199075526278,NaN,1.5,2.75,NaN,NaN,2.7766237397853084,0.5891495875498711,249.0047375461154,0.5933384909077923,-1.1320873381109777,-1.72542582901877,31.40591819166864,2.726767023286532,84.88984622171054,2.0206668769653673,13.089486901324095,3800596413
1196778600,146.66,147.54089,146.31,146.36,NaN,NaN,140.9737142857143,158.44196721311476,148.47469980000037,149.23839929999997,150.36739859999997,145.88999799999996,148.46428805089622,146.69537425314502,145.08230384615402,149.66650272090473,140.4981049714033,148.47469980000037,149.23839929999997,150.36739859999997,145.88999799999996,146.73696333333334,136528560,243180525.6,47.93576622123415,NaN,1.5,2.75,NaN,NaN,2.6761499012292154,0.5614288383625403,245.6927546401766,0.5561413322514188,-1.0302491637044966,-1.5863904959559154,30.63199147255897,1.1891592920354173,62.564092953469014,11.099357260504833,26.336549786026136,3664067853
1196865000,147.92999,149.2,147.83,148.81,NaN,NaN,141.026,158.46688524590166,148.48884980000037,149.17819929999996,150.3157986,145.72699749999998,148.47784538223362,146.89676718141692,145.33384307692324,150.33113662137563,140.33654953247085,148.48884980000037,149.17819929999996,150.3157986,145.72699749999998,148.61333333333332,171036688,242845878.4,53.102541486036316,NaN,1.5,2.75,NaN,NaN,2.687853479712841,0.7043013829465923,250.34391936885837,0.6744891219073375,-0.7432790935717435,-1.417768215479081,31.74203928653895,5.032474945826858,58.34932313349349,13.549422947650585,28.101253918855924,3835104541
1196951400,148.63,151.21001,148.57001,150.94,NaN,NaN,141.0782857142857,158.49180327868854,148.51419980000037,149.14009929999997,150.2907986,145.87849749999998,148.57440046528328,147.28183697366293,145.72999769230788,151.55680019851349,139.90319518610227,148.51419980000037,149.14009929999997,150.2907986,145.87849749999998,150.2400066666667,154542560,235250548.8,57.08950127065786,NaN,1.5,2.75,NaN,NaN,2.684435374019068,0.6569275216925657,255.68245849487403,0.8621665354991894,-0.3400600461050942,-1.2022265816042836,28.432573984736305,4.724901130923474,56.04682919282951,14.987367056472324,28.965803750698168,3989647101
1197037800,151.42,151.5,150.55,150.91,NaN,NaN,141.13057142857141,158.51672131147544,148.54224980000038,149.10449929999996,150.24719859999996,146.06599749999998,148.6659926038996,147.62737630950457,146.27999846153864,152.58900964336857,139.9709872797087,148.54224980000038,149.10449929999996,150.24719859999996,146.06599749999998,150.98666666666668,148980064,223979334.4,57.01597958222618,NaN,1.5,2.75,NaN,NaN,2.5605471330177054,0.6651509363535282,256.5569331270692,0.9436488483144482,-0.02266552121122345,-0.9663143695256716,27.754546027997673,7.066335579992911,24.218201245088146,43.38575864540452,32.39604010950735,3840667037
1197297000,151.28,152.25,150.86,152.08,NaN,NaN,141.18285714285713,158.5416393442623,148.5767998000004,149.07459919999997,150.23719859999997,146.4129975,148.79987524688394,148.05143570859937,146.85230615384637,153.7817133981631,139.92289890952964,148.5767998000004,149.07459919999997,150.23719859999997,146.4129975,151.73000000000002,123914368,216288486.4,59.221638166773744,NaN,1.5,2.75,NaN,NaN,2.47693662351644,0.5729124562406666,259.93477801184025,1.028729121798377,0.31959703272229945,-0.7091320890760775,21.83343113819142,6.670400037146674,49.48350010690541,19.47398226244183,31.04251763065276,3964581405
1197383400,152.14,152.89,147.83,147.91,NaN,NaN,141.23514285714285,152.89,148.6188498000004,149.0186992,150.10939859999996,146.62349749999998,148.7649781783787,148.03796564111371,147.33153769230788,153.5933749764408,141.06970040817495,148.6188498000004,149.0186992,150.10939859999996,146.62349749999998,149.54333333333332,250346368,216654964,49.476929286742326,NaN,1.5,2.75,NaN,NaN,2.661441150408121,1.15550718699434,254.14930498768678,0.7684734722554019,0.2514597512431749,-0.517013721012227,29.54070002130889,0.5301434105892756,37.70634494698287,29.143896380253288,33.149758672763824,3714235037
1197469800,151.06,151.77,147.2,149.37,NaN,NaN,141.28742857142856,152.7797619047619,148.66104985000038,148.9726992,150.01499859999996,146.6879975,148.78870452432463,148.16482605624574,147.7346146153848,153.79146914227562,141.67776008849398,148.66104985000038,148.9726992,150.01499859999996,146.6879975,149.4466666666667,322435584,223223074.4,52.428394991191546,NaN,1.5,2.75,NaN,NaN,2.7977667825218284,1.4444545433605944,255.69638049423156,0.6629529284328504,0.311677439528836,-0.3512754889040144,24.230096155854167,1.487980804999376,47.81775780560467,20.711798906482322,31.470443287913007,4036670621
1197556200,148.32001,149.39,147.3,149.06,NaN,NaN,141.33971428571428,152.66952380952378,148.7037999000004,148.9502992,149.92059859999998,146.75749749999997,148.79934356258642,148.25008071755568,148.35846076923093,152.9959033867662,143.72101815169566,148.7037999000004,148.9502992,149.92059859999998,146.75749749999997,148.58333333333334,237607056,223577183.2,51.737288160642265,NaN,1.5,2.75,NaN,NaN,2.747212012341696,1.062751809461029,251.42194095982083,0.5454806436475614,0.3305753156554374,-0.21490532799212403,24.312216038030122,0.26907036189964056,22.633122225402726,45.334673440662264,32.03220433393501,3799063565
1197642600,147.92999,149.10001,147.10001,147.17,NaN,NaN,141.392,152.5592857142857,148.7462999000004,148.9058992,149.78359859999998,146.838998,148.73544773660262,148.14721588731229,148.71230615384633,152.04848001308133,145.37613229461132,148.7462999000004,148.9058992,149.78359859999998,146.838998,147.79000666666664,159152880,218382243.2,47.61614546260641,NaN,1.5,2.75,NaN,NaN,2.6938397257458604,0.7287812308725291,247.00159327166207,0.3246001608945647,0.1908448731260819,-0.13375528776848283,24.822430626183092,-0.34533453042623863,22.36046217594223,45.67987508398661,31.959662740071163,3639910685
1197901800,146.61,146.87,144.86,145.07001,NaN,NaN,141.4442857142857,152.4490476190476,148.7848999000004,148.87639929999997,149.56799859999998,146.802999,148.59170508026526,147.8541486599492,148.55384538461553,152.34082237951262,144.76686838971844,148.7848999000004,148.87639929999997,149.56799859999998,146.802999,145.60000333333335,177269312,211807846.4,43.47262086900065,NaN,1.5,2.75,NaN,NaN,2.666422602478297,0.8369345848747556,241.0259482576629,0.03634344224710957,-0.08832598495959587,-0.12466942720670544,25.83942093474416,-0.8813815250068442,9.926326664908013,64.73040662232721,25.343266712764784,3462641373
1197988200,146.10001,146.48,143.96001,145.88,NaN,NaN,141.49657142857143,152.33880952380952,148.8157999000004,148.88409929999997,149.38519859999997,146.9089995,148.48536370456858,147.6661345018588,148.4538461538463,152.44386660849148,144.46382569920115,148.8157999000004,148.88409929999997,149.38519859999997,146.9089995,145.44000333333335,245569248,210700677.6,45.44459223610641,NaN,1.5,2.75,NaN,NaN,2.6559631308727027,1.1654886486231215,244.44253674957656,-0.09340721095153914,-0.24142844089612936,-0.14802122994459022,25.705635353025055,-1.9689536993481667,32.72898353484685,33.94577690468461,33.325239560468546,3708210621
1198074600,145.94,146.89,144.94,145.88,NaN,NaN,141.54885714285714,152.2285714285714,148.8473999000004,148.86909929999996,149.17319859999998,146.9709995,148.38319257889924,147.49602645406273,148.24000000000015,152.45457353624343,144.02542646375687,148.8473999000004,148.86909929999996,149.17319859999998,146.9709995,145.90333333333334,198917120,199910303.2,45.44459223610641,NaN,1.5,2.75,NaN,NaN,2.6055371929532236,0.9950318558668466,242.3073965833552,-0.1684863650437814,-0.35862918624931694,-0.19014282120553555,23.36981515390761,-3.3523254273221164,11.003755373351327,62.72878635908755,26.267458267561135,3708210621
1198161000,146.84,146.86,145.17999,146.8,NaN,NaN,141.60114285714286,152.1183333333333,148.8776998500004,148.87989929999995,148.98479859999998,147.22700000000003,148.321106595413,147.42973822034247,148.1723084615386,152.44850262577708,143.8961142973001,148.8776998500004,148.87989929999995,148.98479859999998,147.22700000000003,146.27999666666668,214813744,197692974.4,47.84146339485773,NaN,1.5,2.75,NaN,NaN,2.5394281077422796,1.086602822644364,244.52592650201757,-0.14626644411965076,-0.372975876355099,-0.22670943223544823,21.749775523519183,-2.7234775694122226,43.81459772808869,23.859341462501103,32.326060809410194,3923024365
1198247400,147.37,148.42,147.09,148.13,NaN,NaN,141.65342857142858,152.00809523809522,148.9144498500004,148.89689939999994,148.83799859999996,147.42700000000002,148.3136122191223,147.4964298184051,148.30846230769245,152.45594734588934,144.16097726949556,148.9144498500004,148.89689939999994,148.83799859999996,147.42700000000002,147.88,146090320,201113259.2,51.180698099083905,NaN,1.5,2.75,NaN,NaN,2.473754671474972,0.7264081969589005,249.02378924233872,-0.037727539965024925,-0.2738688571917294,-0.23614131722670445,22.76713222510246,-2.59731720147292,72.58663691026162,6.2012830031001815,21.212080086638203,4069114685
1198506600,148.82001,149.48,148.48,149.23,NaN,NaN,141.7057142857143,151.89785714285713,148.9556498000004,148.91319929999995,148.69599859999997,147.84100000000004,148.349548994843,147.66153174046175,148.34077000000013,152.50986607957805,144.17167392042222,148.9556498000004,148.91319929999995,148.69599859999997,147.84100000000004,149.0633333333333,45601328,192685053.6,53.814326838183845,NaN,1.5,2.75,NaN,NaN,2.393486480655331,0.23666250779712786,253.86046605839238,0.1046325679110233,-0.10535060733792534,-0.20998317524894863,22.717974123095747,0.8924345886011718,100,0,0,4114716013
1198679400,148.64999,149.67999,148.5,149.55,NaN,NaN,141.75799999999998,151.78761904761902,149.0121498000004,148.97069929999995,148.58679879999997,148.18999950000006,148.39662550484914,147.84138586041777,148.23384692307707,152.19702530628226,144.27066853987188,149.0121498000004,148.97069929999995,148.58679879999997,148.18999950000006,149.24333,67118064,181349347.2,54.58192458544268,NaN,1.5,2.75,NaN,NaN,2.306808160608522,0.3701036978422606,252.56724767269588,0.2107121423952646,0.053407002745132104,-0.15730513965013249,15.628955522100146,0.12050612572806241,100,0,0,4181834077
1198765800,149.02,149.03,147.32001,147.67,NaN,NaN,141.8102857142857,151.67738095238093,149.0540998000004,148.98529919999993,148.46459879999998,148.21699950000004,148.36813038701192,147.82506339752084,147.9846161538463,151.6387251069957,144.3305072006969,149.0540998000004,148.98529919999993,148.46459879999998,148.21699950000004,148.00666999999999,122981680,174544993.6,49.388597658494916,NaN,1.5,2.75,NaN,NaN,2.301321149136485,0.7045844023566425,247.21595216260081,0.14761179884351217,0.02720960890425772,-0.12040218993925444,16.3437910821302,-0.9325103984972594,78.5511259426101,4.064100110160469,17.384773947229437,4058852397
1198852200,148.53999,148.61,146.89999,147.3,NaN,NaN,141.8625714285714,151.56714285714284,149.09324980000036,148.98059919999992,148.3255988,148.22300000000004,148.32624292085458,147.7750573596617,147.616923846154,150.40892483716172,144.8249228551463,149.09324980000036,148.98059919999992,148.3255988,148.22300000000004,147.60333,116398064,170405868.8,48.412302547012416,NaN,1.5,2.75,NaN,NaN,2.2590846384838796,0.6830637044350435,248.4742579018126,0.0778088197201658,-0.023141165289047194,-0.100949985009213,16.354639469804276,0.0883332200856315,41.14940471744784,26.637190546063803,32.21340473648836,3942454333
1199111400,147.10001,147.6062,146.06,146.21001,NaN,NaN,141.91485714285713,151.45690476190475,149.13164985000037,148.94439929999993,148.175999,148.10050050000004,148.24325339454657,147.6260052301701,147.48615538461553,150.36877352397477,144.6035372452563,149.13164985000037,148.94439929999993,148.175999,148.10050050000004,146.62540333333334,108126752,164667881.6,45.555373192530666,NaN,1.5,2.75,NaN,NaN,2.2081643071636026,0.6566353495859876,246.5637605843583,-0.038661475829572675,-0.14927682979617884,-0.11061535396660617,15.223736541255827,0.7858274773676619,7.802377946119344,69.00793892889735,23.18968312498332,3834327581
1199284200,146.53,146.99001,143.88,144.92999,NaN,NaN,141.96714285714285,151.34666666666664,149.15529980000036,148.93979919999995,148.08119879999998,147.96300050000005,148.11332149672123,147.36924187491582,147.14461615384627,150.1045801445341,144.18465216315843,149.15529980000036,148.93979919999995,148.08119879999998,147.96300050000005,145.26666666666665,204935504,167618263.2,42.391619288150714,NaN,1.5,2.75,NaN,NaN,2.2725818566519176,1.222632308004967,243.68172615552515,-0.19031552919991712,-0.3485097654665026,-0.15819423626658546,13.642646510083718,-0.6512270359199286,1.4057840676938582,87.50964075480508,11.08457517750105,3629392077
1199370600,144.91,145.49001,144.07001,144.86,NaN,NaN,142.01942857142856,151.23642857142855,149.17474980000037,148.94129909999995,147.96759899999998,147.88800050000003,147.9857402615557,147.13026645825715,146.82153923076936,149.7915617533677,143.85151670817103,149.17474980000037,148.94129909999995,147.96759899999998,147.88800050000003,144.80667333333335,125133248,167048497.6,42.21896610071491,NaN,1.5,2.75,NaN,NaN,2.211683152605353,0.7490833488346201,245.61684394291274,-0.27841706893820756,-0.5062155724393449,-0.22779850350113734,13.157826789479822,-0.699204825884276,0,100,0,3504258829
1199457000,143.34,143.44,140.91,141.31,NaN,NaN,142.07171428571428,151.12619047619046,149.16484985000037,148.90209909999993,147.7585992,147.51300050000003,147.7239465258084,146.57595536699458,146.37077000000014,150.5322228488421,142.20931715115816,149.16484985000037,148.90209909999993,147.7585992,147.51300050000003,141.88666666666668,232330816,170113204,34.5357864602408,NaN,1.5,2.75,NaN,NaN,2.3358486417049718,1.3657424029236438,240.1144266791385,-0.5435182354987748,-0.9071962978746058,-0.363678062375831,19.043394396052523,-3.7397820163487796,0,100,0,3271928013
1199716200,141.81,142.23,140.10001,141.19,NaN,NaN,142.124,151.01595238095237,149.15489990000037,148.88389919999995,147.55279919999998,147.02550050000005,147.46771332871788,146.06300723680462,146.07230769230785,151.04215079057425,141.10246459404144,149.15489990000037,148.88389919999995,147.55279919999998,147.02550050000005,141.17333666666667,234990944,174135623.2,34.308500449218826,NaN,1.5,2.75,NaN,NaN,2.3211444530117586,1.3494708301592366,242.66731550932877,-0.6855289229932011,-1.2205892161173324,-0.5350602931241313,18.167237726171873,-4.685073921555389,0,100,0,3036937069
1199802600,142.08,142.89999,138.44,138.91,NaN,NaN,142.1762857142857,150.90571428571425,149.13249990000037,148.86259929999994,147.29419919999998,146.42550050000006,147.1321167275917,145.38176845234705,145.536153846154,151.8069048327717,139.26540285953632,149.13249990000037,148.86259929999994,147.29419919999998,146.42550050000006,140.08333000000002,326366720,183004956,30.236786382894763,NaN,1.5,2.75,NaN,NaN,2.4739191349394907,1.7833764021123013,239.1525116522343,-0.8792281427302452,-1.6340954715369378,-0.7548673288066926,17.37168416960458,-6.91549956443074,0,100,0,2710570349
1199889000,139.09,140.78999,137.7,140.37,NaN,NaN,142.22857142857143,150.79547619047617,149.11834990000037,148.84529919999994,147.0291992,145.84000050000003,146.86693567945085,144.90445717117115,145.11230769230784,151.95185460419106,138.27276078042462,149.11834990000037,148.84529919999994,147.0291992,145.84000050000003,139.61999666666665,301910784,191904776.8,35.51443798408765,NaN,1.5,2.75,NaN,NaN,2.517924196729527,1.5732322510900625,242.64058657497702,-0.8544886984673584,-1.8229782018908907,-0.9684895034235322,18.322063470021362,-6.138415245737216,7.119897386555997,70.50456293846364,22.375539674980367,3012481133
1199975400,139.67999,142.8,139.37,141.28999,NaN,NaN,142.28085714285714,150.68523809523808,149.11049985000037,148.81109899999993,146.77239899999998,145.50900000000007,146.64823192731552,144.56022220248818,144.68846076923091,151.7368531184003,137.64006842006154,149.11049985000037,148.81109899999993,146.77239899999998,145.50900000000007,141.15333,335701248,196172520.8,38.663272070228096,NaN,1.5,2.75,NaN,NaN,2.5830724683917046,1.7112552085837294,246.29280640371397,-0.7266476380668407,-1.876799051007083,-1.1501514129402424,19.196715940701505,-4.32045100562064,25.60116670723006,41.749000616267914,32.64983267650204,3348182381
1200061800,140.78,141.8985,139,140.14999,NaN,NaN,142.33314285714286,150.575,149.10214975000036,148.76619889999995,146.51419879999997,145.04799950000006,146.39339891055806,144.1402000879655,144.07461384615397,151.20665385773668,136.94257383457125,149.10214975000036,148.76619889999995,146.51419879999997,145.04799950000006,140.34949666666668,267076560,193404569.6,36.29802398258731,NaN,1.5,2.75,NaN,NaN,2.6056030063637263,1.3809216636006516,242.5400296539814,-0.6706936940498882,-1.9885185305026027,-1.3178248364527145,18.766136685333773,-4.854046164290569,24.412332692390848,43.167723796946795,32.419943510662364,3081105821
1200321000,141.16,141.86,140.39999,141.28,NaN,NaN,142.38542857142858,150.46476190476187,149.09869975000035,148.72969899999995,146.24679899999998,144.65899950000008,146.1928734630852,143.86780007958782,143.4630753846155,150.06574645825626,136.86040431097476,149.09869975000035,148.72969899999995,146.24679899999998,144.65899950000008,141.17999666666665,170365632,190042498.4,40.20301045239576,NaN,1.5,2.75,NaN,NaN,2.5416320773377463,0.8964607044968211,246.5166562799087,-0.5163350184632809,-1.9632436095318155,-1.4469085910685346,20.2377710938378,-3.371868998572676,44.969167934506686,22.932546991934732,32.09828507355859,3251471453
1200407400,139.78999,141.4903,137.89999,138.17,NaN,NaN,142.4377142857143,150.35452380952378,149.07954975000035,148.64489909999995,145.98959899999997,144.20899950000006,145.87825097433677,143.32515245296042,142.5876907692309,148.73182445861804,136.44355707984377,149.07954975000035,148.64489909999995,145.98959899999997,144.20899950000006,139.18676333333335,240456496,194107679.2,34.021641351794884,NaN,1.5,2.75,NaN,NaN,2.616537643242192,1.2387788931948656,242.1543848802012,-0.5778006011977599,-2.1691593425657345,-1.5913587413679746,22.739108421310796,-4.664314128497502,50.480525129608075,18.760089903603383,30.759384966788545,3011014957
1200493800,137.36,139.12,136.28,136.98,NaN,NaN,142.49,150.2442857142857,149.05364975000035,148.54949909999993,145.70519899999996,143.80449900000008,145.52929995573533,142.72085221934515,141.7653830769232,147.82951699296245,135.70124916088395,149.05364975000035,148.54949909999993,145.70519899999996,143.80449900000008,137.46,378956032,204192015.2,31.994549810338185,NaN,1.5,2.75,NaN,NaN,2.6324992401534644,1.8558807582599344,241.96369236235208,-0.6474716814461048,-2.4006983431756055,-1.7532266617295007,22.732037637877127,-5.4397349164710915,18.114916869024366,51.388596511979834,30.496486618995807,2632058925
1200580200,137.81,137.88,132.92999,133.42999,NaN,NaN,142.5422857142857,150.13404761904758,149.00234970000037,148.40049899999994,145.37279879999997,143.18199850000008,145.05481721237317,141.83600819845515,140.69845923076937,147.34475697032184,134.0521614912169,149.00234970000037,148.40049899999994,145.37279879999997,143.18199850000008,134.74666,398404864,211833796,26.854150900511314,NaN,1.5,2.75,NaN,NaN,2.798035722999645,1.8807426932008526,235.75145953230668,-0.8677681412708682,-2.837936838318086,-1.9701686970472179,25.25712525047628,-5.576399405562238,1.6770542543636269,86.29828333453426,12.024662411102124,2233654061
1200666600,134.74001,135.02,131.10001,132.06,NaN,NaN,142.5945714285714,150.0238095238095,148.94339965000037,148.25159899999994,144.97259859999997,142.49099850000007,144.54521653737814,140.90495979860228,139.60999692307706,146.89342749264333,132.3265663535108,148.94339965000037,148.25159899999994,144.97259859999997,142.49099850000007,132.72666999999998,348561408,219316010.4,25.17328445898515,NaN,1.5,2.75,NaN,NaN,2.8781753142139572,1.5893112744677211,231.87058018739066,-1.0298237638677703,-3.2574484018819305,-2.22762463801416,23.051672056210162,-6.466463630568734,1.535167319560567,86.91879514775572,11.546037532683728,1885092653
1201012200,127.21001,132.42661,126,130.72,NaN,NaN,126,149.9135714285714,148.87579960000036,148.12159899999995,144.62879859999998,141.68699850000004,144.00305118297115,139.93496362730681,138.5169207692309,146.50930734914087,130.52453418932092,148.87579960000036,148.12159899999995,144.62879859999998,141.68699850000004,129.71553666666668,435925248,230371585.6,23.616227869447144,NaN,1.5,2.75,NaN,NaN,3.1316349346272467,1.8922700334967004,228.97157081880474,-1.1426188660743515,-3.6558982206070993,-2.513279354532748,22.79663582323872,-5.89590382261896,0,100,0,1449167405
1201098600,127.09,134.19,126.84,133.86,NaN,NaN,125.61421052631579,149.8033333333333,148.82289960000037,147.99479909999994,144.36279859999996,140.97349850000006,143.60528446991347,139.35639566280142,137.67076692307703,145.10765740549326,130.2338764406608,148.82289960000037,147.99479909999994,144.36279859999996,140.97349850000006,131.63,511912960,248662717.6,33.929195229787155,NaN,1.5,2.75,NaN,NaN,3.432946725011014,2.0586639000039626,235.53689246179087,-0.9301181293654346,-3.675927016239541,-2.7458088868741064,28.19979229801485,-4.6377431075015965,6.701937309298364,71.57562108587172,21.722441604829914,1961080365
1201185000,134.48,135.46001,133.31,134.99001,NaN,NaN,125.22842105263157,149.6930952380952,148.77479965000038,147.88319929999994,144.15979879999998,140.26149900000004,143.26743056913256,138.94054940920128,137.18461384615395,144.43017084787908,129.93905684442882,148.77479965000038,147.88319929999994,144.15979879999998,140.26149900000004,134.58667333333335,259949248,259380113.6,37.21452556602128,NaN,1.5,2.75,NaN,NaN,3.341308387510228,1.0021942098494014,239.40413379839705,-0.6510208413475271,-3.5595849385585154,-2.9085640972109883,27.846489450144748,-4.458900450060176,19.08393770091962,50.21374277832034,30.70231952076005,2221029613
1201271400,136.50999,136.75999,132.60001,133.03999,NaN,NaN,124.84263157894736,149.5828571428571,148.7198996000004,147.73769919999992,143.9465986,139.43599850000004,142.86635446838227,138.37859137022974,136.55769000000012,143.71835532859328,129.39702467140697,148.7198996000004,147.73769919999992,143.9465986,139.43599850000004,134.13333,269603840,269504402.4,34.066498838635056,NaN,1.5,2.75,NaN,NaN,3.3997849312594965,1.000368964659258,236.60925978429248,-0.5398893770859754,-3.5834258185684575,-3.043536441482482,27.5818363140974,-5.073136287772845,22.165546790560516,46.12257892231632,31.711874287123177,1951425773
1201530600,133.25999,135.52,132.06,135.24001,NaN,NaN,124.45684210526316,149.47261904761902,148.6727996500004,147.59929929999993,143.68979879999998,138.81449900000004,142.56728213628884,138.0796788587793,136.2753830769232,143.33144474796526,129.21932140588112,148.6727996500004,147.59929929999993,143.68979879999998,138.81449900000004,134.27333666666667,217934560,274252046.4,40.211421212416745,NaN,1.5,2.75,NaN,NaN,3.4040860075981043,0.7946506247108901,242.13382613228154,-0.27378495746014986,-3.3857676383076694,-3.1119826808475195,30.342883709384385,-4.275191109852766,45.24911006917909,22.707527920395236,32.04336201042566,2169360333
1201617000,136.10001,136.45,134.88,135.91,NaN,NaN,124.07105263157895,149.36238095238093,148.6257496000004,147.48049939999993,143.45459879999999,138.24499900000004,142.30621224859124,137.8730427769908,135.93230615384624,142.58057983288964,129.28403247480284,148.6257496000004,147.48049939999993,143.45459879999999,138.24499900000004,135.74666666666667,168968816,276880584,41.984708563787784,NaN,1.5,2.75,NaN,NaN,3.273079864198239,0.6102588110692514,245.22374830729163,-0.021515054002406053,-3.138876498350527,-3.117361444348121,29.961255904446162,-1.635666208294124,77.65391777277875,4.229525790495296,18.116556436725958,2338329149
1201703400,135.58,138.53999,134.60001,134.91,NaN,NaN,123.68526315789474,149.25214285714281,148.5667996000004,147.34829939999995,143.24199899999996,137.6799985,142.0161647094308,137.5908482268012,135.4415376923078,141.3343690677266,129.548706316889,148.5667996000004,147.34829939999995,143.24199899999996,137.6799985,136.01666666666665,334939136,288221203.2,40.07422888203764,NaN,1.5,2.75,NaN,NaN,3.320715588184078,1.162090548097469,242.6894761807694,0.10233341430603193,-2.989444676465581,-3.091778090771613,27.76222306799392,-1.5111695137976298,35.40979132764998,31.306732331261312,33.28347634108871,2003390013
1201789800,133.39999,138.53999,133.2,137.37,NaN,NaN,123.29947368421053,149.14190476190473,148.5181996000004,147.26129929999996,143.07359919999996,137.301999,141.83396217180606,137.56981506234393,135.22769230769242,140.60034974984185,129.855034865543,148.5181996000004,147.26129929999996,143.07359919999996,137.301999,136.36999666666665,343680768,295158466.4,46.52116025578824,NaN,1.5,2.75,NaN,NaN,3.464949474742358,1.1643940700458932,246.95859226172527,0.3597733518988897,-2.642061400898001,-3.0018347527968907,29.717481402970574,2.952866892967616,39.876453315615436,27.200744881283647,32.9228018031009,2347070781
1201876200,137.94,139.61,137.52,139.58,NaN,NaN,122.91368421052631,149.03166666666664,148.4797496000004,147.19919939999997,142.9899994,137.03799899999999,141.74557149840192,137.7612612468826,135.0969230769232,139.9295860511699,130.26426010267647,148.4797496000004,147.19919939999997,142.9899994,137.03799899999999,138.90333333333334,206843680,299243988,51.562678944465894,NaN,1.5,2.75,NaN,NaN,3.377453083689333,0.6912208374926483,252.48851088680468,0.6706759952163752,-2.1634897587764215,-2.8341657539927967,25.507285807058945,5.694381341814334,67.37089102970513,8.586251658779526,24.042857311515334,2553914461
1202135400,139.21001,139.3,137.64,137.82001,NaN,NaN,122.5278947368421,148.92142857142855,148.4326996500004,147.10249939999997,142.85359959999997,136.8634995,141.59162791022928,137.76685636622713,135.07000076923086,139.83734256042518,130.30265897803653,148.4326996500004,147.10249939999997,142.85359959999997,136.8634995,138.25333666666666,124694256,293862160,47.70565875459359,NaN,1.5,2.75,NaN,NaN,3.274777863425811,0.42432906638949364,249.73051208748493,0.7439059029959858,-1.9042833752478145,-2.6481892782438003,26.040420684618972,5.431464198286412,51.065034801566874,18.393945279091636,30.541019919341505,2429220205
1202221800,135.94,136.25,133.67,134.13,NaN,NaN,122.1421052631579,148.81119047619043,148.3602496500004,146.96509939999996,142.7025998,136.51049949999998,141.2990150510046,137.4204890932531,134.85077000000007,139.50745177975082,130.1940882202493,148.3602496500004,146.96509939999996,142.7025998,136.51049949999998,134.6833333333333,286882560,296456740.8,40.81258984585828,NaN,1.5,2.75,NaN,NaN,3.3372944446096824,0.9677046277505321,244.42621258421977,0.5394634323030081,-1.9738599878650405,-2.5133234201680485,30.8430244330753,0.20170327207528896,25.940226811944104,41.40225607003138,32.657517118024536,2142337645
1202308200,134.58,135.25,132.41,133.05,NaN,NaN,121.75631578947369,148.70095238095234,148.2851996500004,146.80649939999995,142.48099979999998,136.2174995,140.9755242646907,137.0042520367528,134.82154000000008,139.51812719202158,130.1249528079786,148.2851996500004,146.80649939999995,142.48099979999998,136.2174995,133.57,250792880,292678048.8,39.03481896606369,NaN,1.5,2.75,NaN,NaN,3.301773412851848,0.8568899547754536,241.44822315297063,0.33703370078652517,-2.092031294184892,-2.429064994971417,28.14878241527832,-1.4371507936031716,29.80341800428131,37.072531738981546,33.12405025673714,1891544765
1202394600,131.8,134.78999,131.73,133.92999,NaN,NaN,121.37052631578948,148.59071428571426,148.21424960000041,146.65679939999995,142.3405996,135.89549900000003,140.69922880333027,136.71146517610967,134.96538538461547,139.42332714390452,130.50744362532643,148.21424960000041,146.65679939999995,142.3405996,135.89549900000003,133.48332666666667,297541632,292459591.2,41.27927801010799,NaN,1.5,2.75,NaN,NaN,3.2845031690767157,1.0173768990756902,244.91978247666523,0.27079103114493064,-2.0905762060402537,-2.3613672371851844,27.955301487079403,0.6689717881067301,26.630037688622966,40.60229870155615,32.767663609820886,2189086397
1202481000,133.09,134.22,132.10001,133.07001,NaN,NaN,120.98473684210526,148.48047619047617,148.13219965000042,146.50649939999994,142.1505996,135.48450000000003,140.4000437522193,136.3646599212421,135.14615538461547,139.05796727434267,131.23434349488826,148.13219965000042,146.50649939999994,142.1505996,135.48450000000003,133.13000666666667,221643504,286756704,39.73953617852759,NaN,1.5,2.75,NaN,NaN,3.2013236569998074,0.7729322485168473,242.59546773369468,0.18172231565997077,-2.134214342610221,-2.315936658270192,26.863167034972435,-1.6045547467794594,8.431056630249547,67.75198534627553,23.81695802347493,1967442893
1202740200,133.10001,134.23,132.03999,133.75,NaN,NaN,120.59894736842105,148.37023809523805,148.0526997000004,146.31939929999993,141.88299959999998,135.16450050000003,140.1392577227205,136.1156446906476,135.13769384615392,139.06105615073915,131.2143315415687,148.0526997000004,146.31939929999993,141.88299959999998,135.16450050000003,133.33999666666668,188576256,282831688.8,41.5946365195503,NaN,1.5,2.75,NaN,NaN,3.129086967214107,0.666743732995735,244.2284608955501,0.18087891193241834,-2.089838018354669,-2.2707169302870875,25.068871942456365,-1.589287028180411,19.188812833245326,49.91867841910019,30.892508747654475,2156019149
1202826600,134.91,136.31,133.98,134.99001,NaN,NaN,120.21315789473684,148.25999999999996,147.97999975000042,146.1356993999999,141.6392,134.85000100000002,139.93732643947655,136.0084413867764,135.13769384615392,139.06105615073915,131.2143315415687,147.97999975000042,146.1356993999999,141.6392,134.85000100000002,135.09333666666666,256654368,287146125.6,44.92431419134586,NaN,1.5,2.75,NaN,NaN,3.0884378981273852,0.8938110081189965,248.04826574539638,0.27070454548598466,-1.932336248429607,-2.2030407939155916,25.561982609586472,0.05930620413610235,48.12519173810586,20.51310982705747,31.36169843483667,2412673517
1202913000,136.00999,137.10001,135.14,136.37,NaN,NaN,119.82736842105263,148.14976190476187,147.92039980000038,145.9765993999999,141.3934,134.76000100000002,139.79743128498728,136.04287554041676,135.3938484615385,139.1679190190401,131.6197779040369,147.92039980000038,145.9765993999999,141.3934,134.76000100000002,136.20333666666667,181967744,284221688,48.446733750035605,NaN,1.5,2.75,NaN,NaN,3.018549476832571,0.6402317334770034,251.9288357459777,0.42096717307963516,-1.6768318275660477,-2.097799000645683,25.859666552296165,-0.7279609812914027,76.62883595184564,4.610222326131195,18.760941722023148,2594641261
1202999400,136.95,137,134.78999,135.17,NaN,NaN,119.44157894736843,148.03952380952376,147.8528998000004,145.80859939999993,141.14320020000002,134.66950100000003,139.61596339145837,135.95974453656754,135.38846307692313,139.16359599125855,131.61333016258772,147.8528998000004,145.80859939999993,141.14320020000002,134.66950100000003,135.65332999999998,215207120,276034242.4,45.709109014943245,NaN,1.5,2.75,NaN,NaN,2.960796657058817,0.7796392147904039,245.90309730081398,0.43562511862952813,-1.5532676023587726,-1.9888927209883007,23.93256932638956,-3.1594784353059353,44.87404799279157,23.034707460392937,32.09124454681549,2379434141
1203085800,134.55,136.10001,133.36,135.14,NaN,NaN,119.05578947368421,147.92928571428567,147.7808998500004,145.64309939999993,140.91880020000002,134.7550015,139.44043541532275,135.881673628323,135.32923230769237,139.09392324971265,131.56454136567208,147.7808998500004,145.64309939999993,140.91880020000002,134.7550015,134.86667,154110256,263819512,45.63967430234541,NaN,1.5,2.75,NaN,NaN,2.9450261815546144,0.5841503338085168,243.87250928961308,0.4381940717501924,-1.4411501313005601,-1.8793442030507526,21.241106394756862,-1.9445724898728494,50.4542317390145,18.802338435567744,30.743429825417778,2225323885
1203431400,136.69,136.89,134.61,135.52,NaN,NaN,118.67,147.81904761904758,147.7067498000004,145.48439939999992,140.65300020000004,134.9280015,139.28669285001598,135.84722852086367,135.37615538461543,139.1339751963502,131.61833557288065,147.7067498000004,145.48439939999992,140.65300020000004,134.9280015,135.67333333333332,145190000,253650941.6,46.743233677843605,NaN,1.5,2.75,NaN,NaN,2.8975243114435685,0.5724007925385916,246.54611138194997,0.4582177190895236,-1.3065720541888481,-1.7647897732783717,20.569283722322194,1.0363080593454221,48.034671322857776,20.585344743282093,31.379983933860135,2370513885
1203517800,133.99001,137.60001,133.75999,135.92,NaN,NaN,118.28421052631579,147.7088095238095,147.6317498000004,145.32169939999991,140.35260020000004,135.1880015,139.15466567942713,135.85415913792426,135.264616923077,138.86173335338785,131.66750049276615,147.6317498000004,145.32169939999991,140.35260020000004,135.1880015,135.76,220709376,242890148,47.941265460507616,NaN,1.5,2.75,NaN,NaN,2.964845432054743,0.9086798201465133,249.48467142645052,0.48836394033707387,-1.1543348478570294,-1.6426987881941033,12.70258069007979,2.1570838030815302,45.91957299648645,22.21078831223905,31.869638691274503,2591223261
1203604200,136.66,137.00999,134.07001,134.78999,NaN,NaN,117.89842105263158,147.59857142857138,147.5509497500004,145.13869929999993,140.03020000000004,135.23450100000002,138.98350192729274,135.75280969621718,134.8961546153847,137.49143749428708,132.3008717364823,147.5509497500004,145.13869929999993,140.03020000000004,135.23450100000002,135.28999666666667,201051184,227347059.2,44.87040213969317,NaN,1.5,2.75,NaN,NaN,2.9630693297651183,0.8843359782504722,244.67726972583188,0.4245197360478359,-1.1120491181343084,-1.5365688541821443,12.774677771328307,0.6421265319290961,19.24947629124894,49.840633142504174,30.909890566246894,2390172077
1203690600,134.97,135.85001,132.86,135.62,NaN,NaN,117.51263157894738,147.4883333333333,147.4752997500004,144.96909929999993,139.70100000000005,135.26600050000002,138.85159989092833,135.74016115372032,134.72692307692316,136.7644980853498,132.6893480684965,147.4752997500004,144.96909929999993,139.70100000000005,135.26600050000002,134.77667,205491008,224624147.2,47.529019840537785,NaN,1.5,2.75,NaN,NaN,2.9649936633533227,0.9148215388305323,247.1527306883082,0.4292273037015959,-1.0000347245551495,-1.4292620282567454,12.708598653766048,1.9162770033608687,48.742719554415906,20.055965463912695,31.20131498167142,2595663085
1203949800,135.53999,137.64999,134.78,137.33,NaN,NaN,117.12684210526317,147.3780952380952,147.4061497500004,144.79939929999992,139.48940000000005,135.480501,138.79192930697036,135.89157437717554,134.973076923077,137.39890358463654,132.54725026151746,147.4061497500004,144.79939929999992,139.48940000000005,135.480501,136.58666333333335,190107008,220649305.6,52.60057981332716,NaN,1.5,2.75,NaN,NaN,2.958207687399514,0.861579906100552,252.0972504690421,0.531835625599457,-0.7644674962574243,-1.2963031218568812,13.159132384134312,2.676635514018701,74.39991217164192,5.468831709978195,20.13125611837988,2785770093
1204036200,136.75,138.95,136.5,138.36,NaN,NaN,116.74105263157895,147.2678571428571,147.3500497500004,144.64209929999993,139.26920000000004,135.6365005,138.77499090277544,136.12666253173026,135.38153846153855,138.1399748096545,132.62310211342262,147.3500497500004,144.64209929999993,139.26920000000004,135.6365005,137.93666666666667,212420624,220373608.8,55.39705955033579,NaN,1.5,2.75,NaN,NaN,2.921907138299548,0.9639113556141936,256.0203391756609,0.6458191734525607,-0.4890291550411803,-1.134848328493741,13.35626895339503,2.496473627937357,76.40333136790055,4.69483844922619,18.901830182873248,2998190717
1204122600,137.56,139.14,137.41,138.22,NaN,NaN,116.35526315789474,139.14,147.2868497500004,144.48649929999993,139.05240000000003,135.7520005,138.75322655364698,136.3260280048988,135.71153923076932,138.7122222504838,132.71085621105485,147.2868497500004,144.48649929999993,139.05240000000003,135.7520005,138.25666666666666,168395808,220344958.4,54.92274507656103,NaN,1.5,2.75,NaN,NaN,2.8367709141352937,0.7642371725805731,253.6147446034394,0.6848186674335655,-0.2788249942017842,-0.9636436616353496,13.007088582067285,1.356603358509932,49.55391199567093,19.45678153376412,30.989306470564934,2829794909
1204209000,137.24001,137.96001,136.55,136.87,NaN,NaN,115.96947368421053,138.87557692307692,147.2185497500004,144.31499929999993,138.84640000000002,135.85000050000002,138.67937453193534,136.3778348615751,136.00384615384624,138.63600886174711,133.37168344594537,147.2185497500004,144.31499929999993,138.84640000000002,135.85000050000002,137.12667000000002,170831056,212139554.4,50.43809316333886,NaN,1.5,2.75,NaN,NaN,2.7534301345542005,0.8052767739762915,249.3135819699181,0.59599497772496,-0.21864993947914968,-0.8146449172041097,13.656752916845436,1.257675519715926,52.191301795415825,17.57901049921064,30.22968770537355,2658963853
1204295400,135.60001,137.0249,132.78,133.82001,NaN,NaN,115.58368421052631,138.61115384615383,147.1347997500004,144.09469929999992,138.62140000000002,135.672501,138.4888112169575,136.13423249380605,136.00923153846162,138.62315005426785,133.3953130226554,147.1347997500004,144.09469929999992,138.62140000000002,135.672501,134.54163666666668,252715120,207591272,42.07848486529525,NaN,1.5,2.75,NaN,NaN,2.8599636963717576,1.21736871480801,243.24664762811972,0.32186269398996803,-0.41231654971664966,-0.7341792437066177,18.443852974204606,-0.9767574367322703,21.000502445319324,47.48390704495281,31.51559050972786,2406248733
1204554600,133.14,133.81,132.24001,133.5,NaN,NaN,115.1978947368421,138.34673076923076,147.0442997000004,143.8794992999999,138.37380000000002,135.368501,138.29317156139052,135.88335320868165,135.89461538461546,138.7924927869933,132.99673798223762,147.0442997000004,143.8794992999999,138.37380000000002,135.368501,133.1833366666667,195613632,207029769.6,41.304951234115606,NaN,1.5,2.75,NaN,NaN,2.768537718059488,0.9448575071012396,241.90146220985062,0.11944039652200689,-0.5848787480541091,-0.704319144576116,18.452264752576095,-1.4905548996458162,5.102114445589804,75.38627077229448,19.5116147821157,2210635101
1204641000,132.23,133.39999,130.99001,132.99001,NaN,NaN,114.81210526315789,138.08230769230767,146.9527497500004,143.64459939999992,138.11600020000003,135.127001,138.085204441336,135.60779671261673,135.63461615384625,138.89861326853006,132.37061903916245,146.9527497500004,143.64459939999992,138.11600020000003,135.127001,132.46000333333333,282513152,214920714.4,40.04163041411589,NaN,1.5,2.75,NaN,NaN,2.750070023912381,1.3144994087177666,237.81417920607646,-0.039820468082850224,-0.7540947296796787,-0.7142742615968285,18.314856243587567,-2.155672454384914,0,100,0,1928121949
1204727400,133.41,134.77,132.34,133.83,NaN,NaN,114.42631578947369,137.8178846153846,146.85879975000043,143.42069939999993,137.85660020000003,135.11200100000002,137.91833367893068,135.43848273998657,135.5315392307693,138.92959745459362,132.133481006945,146.85879975000043,143.42069939999993,137.85660020000003,135.11200100000002,133.64666666666668,270681344,214110653.6,43.127051362706645,NaN,1.5,2.75,NaN,NaN,2.7272078793472114,1.264212403487801,241.05158082323322,-0.07743653635417247,-0.811069932039544,-0.7336333956853716,18.73316211789095,-0.7122116412353591,5.872467933526815,73.46337265970757,20.664159406765606,2198803293
1204813800,132.98,133.22,130.55,131.06,NaN,NaN,114.04052631578948,137.55346153846153,146.75139980000043,143.17659939999993,137.51520020000004,135.012501,137.64937941701183,135.02148438379737,135.21769307692315,139.37194823800593,131.06343791584038,146.75139980000043,143.17659939999993,137.51520020000004,135.012501,131.60999999999999,247912128,213966616,36.463402072599614,NaN,1.5,2.75,NaN,NaN,2.7666930308224105,1.1586486370378453,234.07031337110857,-0.26704074115354093,-1.0674343221272977,-0.8003935809737568,21.567989599372773,-3.3623359386521177,5.194736410293594,75.1484244882508,19.656839101455613,1950891165
1204900200,129.63,131.74001,128.58,129.71001,NaN,NaN,113.65473684210527,137.28903846153844,146.63784985000044,142.91039949999993,137.12480040000003,134.801502,137.33803159673687,134.51562968057857,134.77077076923086,139.84664238297825,129.69489915548348,146.63784985000044,142.91039949999993,137.12480040000003,134.801502,130.01000666666667,326434560,215411262.4,33.72819079963155,NaN,1.5,2.75,NaN,NaN,2.794787100049381,1.515401545690027,231.02560151770268,-0.4507384390439405,-1.3638166297786825,-0.913078190734742,21.13851558343215,-5.5486710842496185,4.6603558498803785,76.54862936923186,18.791014780887764,1624456605
1205155800,129.81,129.92999,127.59,128,NaN,NaN,113.26894736842105,137.02461538461537,146.51564985000044,142.64029959999993,136.69380040000004,134.5480015,136.97183427921777,133.89509352052346,134.1615400000001,140.3242576165649,127.9988223834353,146.51564985000044,142.64029959999993,136.69380040000004,134.5480015,128.50666333333334,235683376,216113256,30.597289158909177,NaN,1.5,2.75,NaN,NaN,2.762301592902997,1.0905549264409768,224.74335139002815,-0.6430526272123944,-1.716893974750235,-1.0738413475378406,18.590296010254875,-7.487713211910966,4.4474604520926855,77.12157559380246,18.430963954104847,1388773229
1205242200,130.72,132.72,127.71519,132.60001,NaN,NaN,112.88315789473684,136.7601923076923,146.42334990000043,142.42849969999992,136.39240060000003,134.49050200000002,136.8003901898367,133.77175223285457,133.99308000000008,140.19745909563036,127.7887009043698,146.42334990000043,142.42849969999992,136.39240060000003,134.49050200000002,131.01173333333335,341875712,223778228.8,45.305633366692625,NaN,1.5,2.75,NaN,NaN,2.9224807648384967,1.5277433994955276,231.71433371640043,-0.4265296549737254,-1.6070034162549973,-1.180473761281272,29.914892728354165,-4.065974533352628,23.74643942412311,44.0623595281644,32.1912010477125,1730648941
1205328600,132.73,133.77,131.16,131.36,NaN,NaN,112.49736842105264,136.4957692307692,146.32169990000045,142.19959969999994,136.07360060000002,134.30900150000002,136.58704155494112,133.5420615440113,133.66538769230777,139.94102587000964,127.3897495146059,146.32169990000045,142.19959969999994,136.07360060000002,134.30900150000002,132.09666666666666,229161120,222403566.4,42.679836118409455,NaN,1.5,2.75,NaN,NaN,2.9001607102071767,1.0303841962131413,227.71193059212237,-0.33683024876255985,-1.6015115722344717,-1.2646813234719119,29.969319858987934,-4.025717834441434,7.101611779835394,70.61279406425685,22.28559415590775,1501487821
1205415000,129.61,132.64,128.60001,131.64999,NaN,NaN,112.11157894736843,136.23134615384615,146.21874980000044,141.97919959999993,135.78240020000004,134.07300100000003,136.39343169004147,133.36186425410546,133.22846384615391,139.20656554958043,127.2503621427274,146.21874980000044,141.97919959999993,135.78240020000004,134.07300100000003,130.96333333333334,351881472,230899252.8,43.504478259119836,NaN,1.5,2.75,NaN,NaN,2.9815770880495203,1.5239610684439597,230.07657629407746,-0.23291485793976685,-1.5558248958966203,-1.3229100379568535,30.069367202808582,-1.6215960527876168,27.918495368356176,39.17111484935328,32.91038978229055,1853369293
1205501400,132.77,132.81,127.78,129.61,NaN,NaN,111.72578947368422,135.96692307692305,146.09939980000044,141.77859959999992,135.47600040000003,133.795001,136.12741476102025,133.00454384895255,132.55538692307698,138.0190773961897,127.09169644996429,146.09939980000044,141.77859959999992,135.47600040000003,133.795001,130.0666666666667,484687872,244373290.4,39.228908245439186,NaN,1.5,2.75,NaN,NaN,3.1278930103316975,1.9833913567503365,224.32074189499772,-0.27369960013757466,-1.6650345381288219,-1.3913349379912472,28.735121939589494,-2.9138576779026115,22.557997931346428,45.54364993203993,31.898352136613646,1368681421
1205760600,126.57001,129.25999,126.07001,128.3,NaN,NaN,126.07001,135.7025,145.97429975000045,141.55619969999992,135.14480040000004,133.45300100000003,135.82045731941162,132.55649205381422,131.79231000000007,136.61116631600328,126.97345368399687,145.97429975000045,141.55619969999992,135.14480040000004,133.45300100000003,127.87666666666667,405310976,256933326.4,36.73237686234266,NaN,1.5,2.75,NaN,NaN,3.1573285095937207,1.5774947597455773,218.0921421690999,-0.3558315056629673,-1.8361243200699562,-1.480292814406989,28.99937260132706,-3.5265882001211972,20.017363812041992,48.75160147526498,31.231034712693056,963370445
1205847000,130.62,133.69,129.98,133.63,NaN,NaN,126.07185236842105,135.43807692307692,145.87204975000043,141.37489979999992,134.99120040000003,133.35850100000005,135.73455703237587,132.65873090583193,131.5430792307693,135.5529184272043,127.5332400343343,145.87204975000043,141.37489979999992,134.99120040000003,133.35850100000005,132.4333333333333,334416384,266394645.6,50.5277404514577,NaN,1.5,2.75,NaN,NaN,3.3168050446227397,1.255341987999777,225.90991979824895,-0.03501322220225056,-1.524059342159802,-1.4890461199575515,38.692550559924896,-0.14944332361953003,19.83600497906478,48.99670565345046,31.167289367484763,1297786829
1205933400,134.14,134.64999,130.03999,130.32001,NaN,NaN,126.0736947368421,135.17365384615383,145.75314975000046,141.1632998999999,134.77380060000004,133.07850150000004,135.52222185463563,132.43599558146698,131.27384846153853,135.10189518828943,127.44580173478765,145.75314975000046,141.1632998999999,134.77380060000004,133.07850150000004,131.66999666666666,345971456,272657749.6,44.097208683392715,NaN,1.5,2.75,NaN,NaN,3.4091761128639737,1.2688854672480578,221.4564567262865,-0.02975556626565634,-1.526240577789622,-1.4964850115239656,41.07702729292439,-0.5646192583549564,17.41859730635667,52.38266052366146,30.19874216998188,951815373
1206019800,130.05,132.91,129.25999,132.08,NaN,NaN,126.07553710526315,134.90923076923076,145.64609970000046,140.96569989999992,134.63720060000006,132.94300200000004,135.38723276229697,132.4020912403749,131.16461769230776,134.80897402887723,127.52026135573827,145.64609970000046,140.96569989999992,134.63720060000006,132.94300200000004,131.41666333333333,245320624,274871221.6,47.89445814378933,NaN,1.5,2.75,NaN,NaN,3.4263785333736902,0.8924929375000092,226.73721080466996,0.10106128490875221,-1.3701584053880254,-1.4712196902967776,40.21104303158322,1.8271450291307518,13.815006074115285,57.90799618663896,28.276997739245765,1197135997
1206365400,133.31,135.81,133.24001,134.72,NaN,NaN,126.0773794736842,134.64480769230767,145.56049970000046,140.7766998999999,134.52420060000006,132.89800200000002,135.36106677161865,132.62284445557728,131.29769384615392,135.30702137319642,127.28836631911143,145.56049970000046,140.7766998999999,134.52420060000006,132.89800200000002,134.59000333333336,209110368,275052189.6,53.04652815636945,NaN,1.5,2.75,NaN,NaN,3.4480657809898543,0.7602570563212123,234.3810692170538,0.35964841489449095,-1.0216591716786638,-1.3813075865731548,40.87213618319354,5.249999999999999,35.23919170641231,31.48271544747378,33.278092846113914,1406246365
1206451800,134.86,135.55,133.77,134.85001,NaN,NaN,126.07922184210526,134.3803846153846,145.48924970000044,140.58389999999991,134.39540100000005,132.77400250000002,135.3410253295944,132.83495545980801,131.37615615384624,135.61404901645992,127.13826329123255,145.48924970000044,140.58389999999991,134.39540100000005,132.77400250000002,134.72333666666668,192947184,275194198.4,53.291463588011425,NaN,1.5,2.75,NaN,NaN,3.328918225204865,0.7011310017500718,238.09729644740264,0.5237625061760673,-0.7266044538530707,-1.250366960029138,39.494404200509514,1.6968324512192723,67.77380419700793,8.394890791734623,23.83130501125745,1599193549
1206538200,134.46001,135.08839,133.11,133.2,NaN,NaN,126.0810642105263,134.11596153846153,145.40004975000045,140.38529999999992,134.25640120000006,132.5160025,135.25706355196326,132.86972160649296,131.54077153846163,135.88175038809445,127.19979268882882,145.40004975000045,140.38529999999992,134.25640120000006,132.5160025,133.79946333333334,196934192,274419876.8,49.74475352086656,NaN,1.5,2.75,NaN,NaN,3.232451923404517,0.7176382202938151,235.81274439455032,0.5052691165475818,-0.6187805643446609,-1.1240496808922427,35.47657770539534,1.4007308160779346,39.12958952431076,27.87424034600276,32.99617012968646,1402259357
1206624600,134.2,134.44,132.36,132.78,NaN,NaN,126.08290657894736,133.85153846153844,145.30744975000044,140.16660009999993,134.08640120000007,132.24400250000002,135.15992380482743,132.86117669158887,131.7769246153847,136.0268957735381,127.52695345723131,145.30744975000044,140.16660009999993,134.08640120000007,132.24400250000002,133.19333333333336,225153120,277257742.4,48.853480123646534,NaN,1.5,2.75,NaN,NaN,3.150133928875622,0.8120715333358353,232.38036184011384,0.4506351037729823,-0.5607558011760148,-1.011390904948997,35.0218756776245,0.8583441593880855,47.5094544793589,20.961510568333182,31.529034952307914,1177106237
1206711000,132.99001,133.36,131.06,131.50999,NaN,NaN,126.08474894736841,133.58711538461537,145.21674975000045,139.97139999999993,133.95320100000004,131.97600200000005,135.01678914581458,132.73249224477087,132.04692384615393,135.70797574145553,128.38587195085233,145.21674975000045,139.97139999999993,133.95320100000004,131.97600200000005,131.97666333333333,180918688,277762124,46.160244826235775,NaN,1.5,2.75,NaN,NaN,3.089410076813078,0.6513439823782453,229.11499040604855,0.3209401128214274,-0.6102157639222128,-0.9311558767436402,35.53377687146127,1.4659285548954355,20.859019785956345,47.64446296689731,31.496517247146343,996187549
1206970200,131.28999,132.73,131.09,131.97,NaN,NaN,126.08659131578946,133.3226923076923,145.11714975000044,139.77909999999991,133.85300100000006,131.88350150000002,134.89730721852774,132.65987393574508,131.9984615384616,135.64559779886298,128.35132527806024,145.11714975000044,139.77909999999991,133.85300100000006,131.88350150000002,131.92999999999998,166692128,273460974.4,47.29365346837621,NaN,1.5,2.75,NaN,NaN,2.9858807856121428,0.6095645946034485,232.22096188427068,0.2606715279790438,-0.6053164667698354,-0.8659879947488792,34.15022062931303,2.8604832424006137,17.588967834449225,52.17158305250956,30.23944911304121,1162879677
1207056600,133.71001,136.84,133.50999,136.61,NaN,NaN,126.08843368421053,133.0582692307692,145.03589975000045,139.64469999999992,133.91660120000006,132.03900150000004,134.9644716413306,133.03607641805507,132.40230769230777,136.76891774763567,128.03569763697988,145.03589975000045,139.64469999999992,133.91660120000006,132.03900150000004,135.65333,254547248,276407655.2,57.10310438880836,NaN,1.5,2.75,NaN,NaN,3.12046072949699,0.9209124393310218,238.42836994993039,0.5132405217199462,-0.22443734259894654,-0.7376778643188927,37.84883073029069,2.230038165082705,21.853233910165887,46.36981480166011,31.776951288173986,1417426925
1207143000,137.06,137.67,135.98,136.7,NaN,NaN,126.09027605263158,132.79384615384615,144.95404970000044,139.49099989999993,134.00940120000004,132.22450100000003,135.0325315769647,133.38502152109746,132.79077000000007,137.6869572039573,127.89458279604285,144.95404970000044,139.49099989999993,134.00940120000004,132.22450100000003,136.78333333333333,210910816,272827538.4,57.26922814238716,NaN,1.5,2.75,NaN,NaN,3.0182849631043474,0.7730554519418704,241.11697022304116,0.6571098157061862,0.08370940531384008,-0.5734004103923461,30.86907025423706,4.89563344876968,48.332471312526245,20.356075752692277,31.311452934781492,1628337741
1207229400,135.94,137.44,135.71001,137.03999,NaN,NaN,126.09211842105263,132.52942307692305,144.87479965000045,139.38229979999994,134.13580100000004,132.38500050000002,135.11125543669155,133.73311375718342,133.36230769230775,138.37316246875605,128.35145291585945,144.87479965000045,139.38229979999994,134.13580100000004,132.38500050000002,136.73,175884752,268087708.8,57.932002997062156,NaN,1.5,2.75,NaN,NaN,2.926263894311179,0.6560716744056861,243.45524575589278,0.7397624692139806,0.35130267612512966,-0.3884597930888509,25.536047520912287,3.7552922471229375,78.46956338422551,3.9518050420006197,17.578631573773873,1804222493
1207315800,137.12,137.96001,136.12,136.89,NaN,NaN,126.09396078947368,132.265,144.79289965000046,139.27959979999991,134.19640100000007,132.67650050000003,135.18101012544875,134.03376958983262,134.02307692307699,138.4169471050975,129.62920674105646,144.79289965000046,139.27959979999991,134.19640100000007,132.67650050000003,136.99000333333333,204473056,265915755.2,57.50822723781747,NaN,1.5,2.75,NaN,NaN,2.8486743304318094,0.7689392298181511,245.17987875289793,0.7467574825360958,0.5449870600812687,-0.201770422454827,25.147888906322226,1.6107482185273065,75.00521584356348,5.227776522339266,19.767007634097236,1599749437
1207575000,137.87,138.57001,136.74001,136.96001,NaN,NaN,126.09580315789474,132.00057692307692,144.72199970000045,139.19779989999995,134.23580100000004,133.03900050000001,135.25077482641154,134.3124591527057,134.2792315384616,138.9322000970545,129.6262629798687,144.72199970000045,139.19779989999995,134.23580100000004,133.03900050000001,137.42334333333335,154381312,257313092.8,57.663899371084185,NaN,1.5,2.75,NaN,NaN,2.7759118782581074,0.5999745691914515,247.15190534726446,0.7183029372485056,0.696108249105805,-0.022194688142700564,22.94180408107502,1.5647014041749152,74.5755935680402,5.40742051371375,20.016985918246057,1754130749
1207661400,136.19,137.1554,135.95,136.82001,NaN,NaN,126.09764552631579,131.73615384615383,144.64619975000045,139.12899999999993,134.31140140000005,133.48000100000002,135.3123134606699,134.5512735191147,134.7792315384616,138.99980380456566,130.55865927235754,144.64619975000045,139.12899999999993,134.31140140000005,133.48000100000002,136.6418033333333,148937248,252975786.4,57.212511710987464,NaN,1.5,2.75,NaN,NaN,2.6637324583825284,0.5887411207193701,244.97946151712247,0.6540814244092272,0.7954070923688334,0.14132566795960624,22.99166602248717,2.717725225225231,46.5322557294039,21.753816376242035,31.713927894354057,1605193501
1207747800,136.61,136.8,134.89,135.83,NaN,NaN,126.09948789473684,131.47173076923076,144.57259975000045,139.00649999999993,134.32320120000003,133.6415005,135.33261489358483,134.67305699348472,135.06769307692315,139.01463078046757,131.12075537337873,144.57259975000045,139.00649999999993,134.32320120000003,133.6415005,135.84,195610560,245662528.8,53.993773997111134,NaN,1.5,2.75,NaN,NaN,2.6113237113552055,0.7962572108799362,240.64356483938673,0.515072030758972,0.7851657064083213,0.2700936756493493,22.05146723035196,2.297032685645437,17.431543031316963,52.43312179263569,30.135335176047345,1409582941
1207834200,135.39,136.67,134.89999,136.02,NaN,NaN,126.10133026315789,131.20730769230767,144.50354975000045,138.88999999999993,134.32540120000004,133.8745005,135.35957117226778,134.8013372798195,135.16769307692314,139.14011837818973,131.19526777565656,144.50354975000045,138.88999999999993,134.32540120000004,133.8745005,135.86333,192967808,243852863.2,54.52257123683876,NaN,1.5,2.75,NaN,NaN,2.5512298748298328,0.7913288590002499,243.60371686250986,0.41060567255071856,0.7833507663377475,0.3727450937870289,21.81924607518502,3.4294048687860315,18.544357794360973,50.84701335044832,30.60862885519072,1602550749
1207920600,134.45,135.9837,133.00999,133.38,NaN,NaN,126.10317263157894,130.9428846153846,144.42899980000047,138.76840009999992,134.29480120000005,133.961001,135.28194093021807,134.6659718245986,135.05461538461543,139.1388902068813,130.97034056234955,144.42899980000047,138.76840009999992,134.29480120000005,133.961001,134.12456333333333,222973312,237407455.2,46.52129324702908,NaN,1.5,2.75,NaN,NaN,2.5839998837705602,0.9392009691193557,238.73182871543105,0.1517266768787202,0.5624034398854292,0.41067676300670897,24.423710377280266,1.0684246419640802,17.9837829346558,51.63971855299399,30.37649851235021,1379577437
1208179800,133.19,133.53999,132.55,132.92999,NaN,NaN,126.105015,130.67846153846153,144.34164980000045,138.63980009999995,134.20600100000004,134.1270005,135.1897075604056,134.5006402222559,135.03384538461543,139.15818418923837,130.9095065799925,144.34164980000045,138.63980009999995,134.20600100000004,134.1270005,133.00666,160521936,221199158.4,45.30091919129196,NaN,1.5,2.75,NaN,NaN,2.4701420349298044,0.7256896326419296,236.14446626605437,-0.050950073958964004,0.34698917055800393,0.39793924451696794,24.527439163927376,-2.6938071883463945,4.809940358565523,76.16639234007513,19.02366730135935,1219055501
1208266200,133.58,133.69,132.33,133.24001,NaN,NaN,126.10685736842105,130.41403846153844,144.25594985000046,138.53460029999994,134.07920120000006,134.374001,135.11324883254656,134.38058020108866,135.0692307692308,139.12290158840992,131.0155599500517,144.25594985000046,138.53460029999994,134.07920120000006,134.374001,133.08667,172389120,209553065.6,46.34516391644017,NaN,1.5,2.75,NaN,NaN,2.39084617529196,0.8226513866853209,239.05039889508149,-0.15915623181053207,0.19899395475380288,0.35815018656433495,12.11941049698293,-2.5310826627651624,18.19275747805276,51.41099494757946,30.39624757436778,1391444621
1208352600,134.53999,136.92999,134.39999,136.85001,NaN,NaN,126.1086997368421,130.14961538461537,144.18804995000045,138.45670039999993,134.05980120000007,134.5350015,135.18135711362316,134.61576399146117,135.48000153846158,139.0626202111716,131.89738286575155,144.18804995000045,138.45670039999993,134.05980120000007,134.5350015,136.05999666666665,189268816,202295687.2,56.70902922119956,NaN,1.5,2.75,NaN,NaN,2.4836414484853906,0.9356048001798429,244.49098709857566,0.008482056910153024,0.3687527577020262,0.3602707007918732,20.743842955012187,-0.13863106674189876,44.542709393190066,23.381945367473076,32.07534523933685,1580713437
1208439000,136.02,137.25,135.66,137.05,NaN,NaN,126.11054210526315,129.8851923076923,144.11435000000043,138.41040049999992,134.11820120000004,134.87150100000002,135.25463722681442,134.8475959922744,135.8707707692308,138.9025986249885,132.8389429134731,144.11435000000043,138.41040049999992,134.11820120000004,134.87150100000002,136.65333333333334,179707504,193982489.6,57.202225549842304,NaN,1.5,2.75,NaN,NaN,2.41980991645072,0.9264109578682302,244.25125544783296,0.12258822052516444,0.5135059764483287,0.3909177559231643,20.709343041356398,0.11688216816423773,43.7776958465345,24.003632184097714,32.218671969367776,1760420941
1208525400,138.94,139.56,138.25999,138.48,NaN,NaN,126.1123844736842,129.6207692307692,144.04505000000043,138.35390049999992,134.22680120000004,135.19150100000002,135.38112204144915,135.1935392311054,136.01461692307697,139.3366441305333,132.69258971562064,144.04505000000043,138.35390049999992,134.22680120000004,135.19150100000002,138.76666333333333,218530560,192642986.4,60.65394979075982,NaN,1.5,2.75,NaN,NaN,2.4262520652756683,1.1343810853629914,249.22839617565666,0.2753768128860924,0.7351387720307798,0.4597619591446874,21.51508863468006,1.1098057016788905,79.00169933935642,3.7931203126026474,17.20518034804092,1978951501
1208784600,138.23,138.98,136.87,138.55,NaN,NaN,126.11422684210525,129.35634615384615,143.9769000500004,138.32990049999992,134.31920140000005,135.38300100000004,135.50539176531387,135.51320216147633,136.15692461538464,139.73298642206524,132.58086280870404,143.9769000500004,138.32990049999992,134.31920140000005,135.38300100000004,138.13333333333335,118587376,188116836.8,60.82052875730416,NaN,1.5,2.75,NaN,NaN,2.403662632041691,0.6303921436127401,246.84374375566352,0.3569817094474488,0.9059890959539985,0.5490073865065497,21.515153767239507,1.2644276228309113,100,0,0,2097538877
1208871000,138.19,138.37,136.64,137.94,NaN,NaN,126.1160692105263,129.09192307692305,143.90170005000041,138.28360039999993,134.41660120000003,135.53750050000002,135.60086659804665,135.74432576514525,136.22615615384618,139.90139357887713,132.55091872881522,143.90170005000041,138.28360039999993,134.41660120000003,135.53750050000002,137.65,162166064,186577780.8,58.4963770700503,NaN,1.5,2.75,NaN,NaN,2.368401015467287,0.8691606433771024,242.8827856406124,0.34548253609371726,0.9808605566236963,0.635378020529979,21.72701803948537,1.5534123536773798,78.9317969050849,3.8022978518602373,17.265905243054885,1935372813
1208957400,138.09,138.78,137.12,137.72,NaN,NaN,126.11791157894736,128.8275,143.82530005000044,138.18950039999993,134.49600120000005,135.76350050000002,135.6839698687115,135.9324852160838,136.29000230769236,140.03728199385588,132.54272262152884,143.82530005000044,138.18950039999993,134.49600120000005,135.76350050000002,137.87333333333333,193309008,186396521.6,57.64087246302831,NaN,1.5,2.75,NaN,NaN,2.3178009429339093,1.03708484654469,244.16238035667004,0.3003318054166739,1.0107927773008214,0.7104609718841475,21.194331707791807,1.2498162034994769,48.02054254958636,20.618785368690695,31.360672081722953,1742063805
1209043800,138.08,139.74001,137.03999,138.32001,NaN,NaN,126.11975394736841,128.56307692307692,143.76230010000043,138.1009005999999,134.56260120000005,136.040501,135.78734399150713,136.1598685288377,136.39461769230772,140.28411381947754,132.5051215651379,143.76230010000043,138.1009005999999,134.56260120000005,136.040501,138.36667,229381376,186607934.4,59.385470197902094,NaN,1.5,2.75,NaN,NaN,2.3451023041529173,1.2292155568707692,247.36512539141378,0.28810241203025144,1.0705889869219618,0.7824865748917104,21.262450272485616,3.703711201079623,51.305690904287175,18.221399380647963,30.472909715064876,1971445181
1209130200,139.41,139.89,137.91,139.60001,NaN,NaN,126.12159631578946,128.29865384615383,143.7003501000004,138.0103006999999,134.62720140000005,136.44500200000002,135.93686030556566,136.48750104990077,136.60846384615388,140.85710794927235,132.35981974303542,143.7003501000004,138.0103006999999,134.62720140000005,136.44500200000002,139.13333666666665,190788064,187101403.2,62.896240223746155,NaN,1.5,2.75,NaN,NaN,2.319023568141994,1.0197040788414569,250.31742100376633,0.339887289619909,1.2073456869165966,0.8674583972966876,16.65180424057062,5.017693900375674,49.67203392391649,19.394223743949404,30.93374233213413,2162233245
1209389400,139.88,140.25,139.38,139.63,NaN,NaN,126.12343868421053,128.03423076923076,143.62655010000043,137.9298007999999,134.71640140000005,136.82800200000003,136.08168931319054,136.78678666419594,136.90077153846158,141.40985910988613,132.39168396703704,143.62655010000043,137.9298007999999,134.71640140000005,136.82800200000003,139.75333333333333,105616496,184047621.6,62.97699046906245,NaN,1.5,2.75,NaN,NaN,2.2155218847032807,0.5738541747067054,252.35973651112042,0.34853303340729513,1.3031246890558066,0.9545916556485115,16.14618787164011,4.795849234775638,48.18051367461134,20.459610004177215,31.359876321211438,2267849741
1209475800,139.39,139.73,138.61,139.08,NaN,NaN,126.12528105263158,127.76980769230768,143.54770005000043,137.8570007999999,134.79520140000005,136.95150200000003,136.19927012443796,137.00518793427253,137.1361561538462,141.75489994322047,132.51741236447194,143.54770005000043,137.8570007999999,134.79520140000005,136.95150200000003,139.14000000000001,125514064,177595962.4,60.38160716605258,NaN,1.5,2.75,NaN,NaN,2.1372703215101874,0.7067394005124071,249.8175917473432,0.2918787955738158,1.3194401501157813,1.0275613545419655,16.896630271818324,1.6295139474231788,51.83048369161127,17.816804781787546,30.35271152660117,2142335677
1209562200,139.28999,140.59,138.25999,138.25999,NaN,NaN,126.12712342105263,127.5053846153846,143.4648500000004,137.7515006999999,134.85000120000004,137.02950150000004,136.28008266857765,137.12469289291323,137.51154000000002,141.61234686881724,133.4107331311828,143.4648500000004,137.7515006999999,134.85000120000004,137.02950150000004,139.03665999999998,208395808,177470212,56.63413012881673,NaN,1.5,2.75,NaN,NaN,2.151037441402318,1.1742579537798714,250.96323567108215,0.17936904487167493,1.2517726606315591,1.0724036157598842,10.036638609230218,0.8828821597956776,50.16362125012752,19.000085369008534,30.83629338086394,1933939869
1209648600,138.39,141.12,138.27,141.12,NaN,NaN,126.12896578947368,127.24096153846152,143.3967000000004,137.6533006999999,134.95400120000002,137.23350200000004,136.46988334824127,137.5051983316834,138.1415407692308,141.71600902399703,134.56707251446457,143.3967000000004,137.6533006999999,134.95400120000002,137.23350200000004,140.17,187279504,178039949.6,64.83221506110318,NaN,1.5,2.75,NaN,NaN,2.2016783384450105,1.0518959616690433,255.62469109473113,0.27218954871628775,1.4126405516552438,1.140451002938956,15.018123156536424,1.9064124783362326,47.55053500161535,20.93524011644011,31.514224881944546,2121219373
1209735000,142.33,142.37,140.56,141.50999,NaN,NaN,126.13080815789473,126.97653846153845,143.3318999500004,137.55930059999991,135.08840120000002,137.46450150000004,136.6675345894867,137.88660706199926,138.7776930769231,141.47156962118123,136.08381653266497,143.3318999500004,137.55930059999991,135.08840120000002,137.46450150000004,141.47999666666666,181585504,176895572,65.78213682765791,NaN,1.5,2.75,NaN,NaN,2.173701314270367,1.0265124329963442,257.72351535872735,0.33058999298987457,1.5536884941762992,1.2230985011864246,14.253300051890982,2.13640562973654,47.06421842136385,21.30641188760135,31.62936969103481,2302804877
1209994200,141.05,141.61,140.41,140.83,NaN,NaN,126.13265052631579,126.71211538461537,143.26069990000042,137.4468005999999,135.1926012,137.65800100000007,136.8307685271539,138.16693019895172,139.08384615384617,141.73614099143907,136.43155131625326,143.26069990000042,137.4468005999999,135.1926012,137.65800100000007,140.95000000000002,118510368,175102024.8,62.60674246225035,NaN,1.5,2.75,NaN,NaN,2.1041512203939132,0.6768075248436533,255.59150819517126,0.2953180575636023,1.5922460731409274,1.296928015577325,14.795519458478683,2.0951138176018667,28.094049504528087,38.88726461302035,33.018685882451564,2184294509
1210080600,140.00999,142.2,139.69,142.05,NaN,NaN,126.13449289473684,126.4476923076923,143.2034499000004,137.38820059999992,135.28700120000002,137.91950050000008,137.0354442711871,138.53674637048013,139.46846153846155,142.2751092640944,136.6618138128287,143.2034499000004,137.38820059999992,135.28700120000002,137.91950050000008,141.31333333333333,179339808,176622152.8,65.79679935985448,NaN,1.5,2.75,NaN,NaN,2.1331404189372045,1.015386830909469,258.35110682819465,0.32376293590320726,1.7016316854563343,1.377868749553127,14.73830144544633,3.1440604124310285,52.72064527885563,17.198707396166125,30.08064732497826,2363634317
1210167000,141.89,142.03999,139.13,139.52,NaN,NaN,126.13633526315789,126.18326923076921,143.1311999000004,137.28970059999992,135.31020120000002,138.10400050000007,137.13287782917976,138.63038957329155,139.54846153846154,142.29652559724792,136.80039747967515,143.1311999000004,137.28970059999992,135.31020120000002,138.10400050000007,140.22999666666666,199267248,176804987.2,55.2670754079958,NaN,1.5,2.75,NaN,NaN,2.1893446747274052,1.1270454027102241,254.50469658033083,0.1505989906482934,1.5661174878634938,1.4155184972152004,18.95991045319394,0.8675462067997348,53.48232225559721,16.68046973849225,29.83720800591055,2164367069
1210253400,139.74001,140.32001,138.98,139.16,NaN,NaN,126.13817763157894,125.91884615384615,143.0704999000004,137.1907005999999,135.32900120000002,138.26100050000008,137.21237281627074,138.6808286615495,139.59538461538463,142.29403875730176,136.8967304734675,143.0704999000004,137.1907005999999,135.32900120000002,138.26100050000008,139.48667,178321184,176072656,53.94418604295458,NaN,1.5,2.75,NaN,NaN,2.128677912246877,1.0127704553965495,257.1856479040217,-0.001710834351977386,1.4133799542752286,1.415090788627206,18.969268782198682,-0.31519338716379813,24.640470596727504,42.88590821578405,32.47362118748843,1986045885
1210339800,138.60001,139.39,138.45,138.89999,NaN,NaN,126.14001999999999,125.65442307692307,143.0069498500004,137.10800049999992,135.36960100000002,138.53700000000006,137.27855388229935,138.70170116997335,139.66923,142.23175703958736,137.10670296041263,143.0069498500004,137.10800049999992,135.36960100000002,138.53700000000006,138.91333,152589632,172553472,52.95821844644957,NaN,1.5,2.75,NaN,NaN,2.0437723470863856,0.884303458118768,255.7677941462771,-0.12658034053884704,1.256865362953647,1.383445703492494,18.18118364998177,-0.522817446107565,6.086092198477941,72.87566578824314,21.038242013278907,1833456253
1210599000,139.25,140.56,138.73,140.46001,NaN,NaN,126.14186236842104,125.38999999999999,142.96914990000042,137.06190049999992,135.50240100000002,138.91350100000005,137.4033168673072,138.8691591537854,139.88,142.20640985878043,137.55359014121956,142.96914990000042,137.06190049999992,135.50240100000002,138.91350100000005,139.91666999999998,150911440,172072947.2,57.92696288086894,NaN,1.5,2.75,NaN,NaN,2.0285028937230734,0.8770201385845736,259.56286956088974,-0.1112663557706779,1.2443627587791468,1.3556291145498247,19.383201203765942,0.9922418751797516,20.207125805339498,48.50532371196179,31.287550482698702,1984367693
1210685400,140.8,140.89,139.73,140.48,NaN,NaN,126.1437047368421,125.1255769230769,142.9459999000004,137.00790049999992,135.642001,139.27550050000008,137.52397110780495,139.0225725677106,140.04615307692308,142.20572115454235,137.8865849993038,142.9459999000004,137.00790049999992,135.642001,139.27550050000008,140.36666666666667,159141872,171410584.8,57.98819813416094,NaN,1.5,2.75,NaN,NaN,1.9664669727428536,0.9284249988743986,260.2699763420763,-0.10691837734156917,1.2219811428728633,1.3288995202144325,19.174223901293793,1.6056778247994972,18.464697165625818,50.89824341436823,30.637059420005954,2143509565
1210771800,141.07001,142.2,140.46201,140.77,NaN,NaN,126.14554710526315,124.86115384615383,142.9129499000004,136.95680049999993,135.7976008,139.47150000000005,137.65126635847926,139.18899422792865,140.1361523076923,142.31130916775396,137.96099544763064,142.9129499000004,136.95680049999993,135.7976008,139.47150000000005,141.14400333333333,181910752,171042681.6,58.9222567238669,NaN,1.5,2.75,NaN,NaN,1.9501471889755067,1.063540107640595,262.54341851768635,-0.0921965114361436,1.213653880919253,1.3058503923553966,18.662433887099603,-0.24801587301586897,48.16801983810291,20.459392126387996,31.37258803550909,2325420317
1210858200,141.03999,142.63,140.83,142.53,NaN,NaN,126.1473894736842,124.59673076923076,142.8969999000004,136.91410049999996,135.9716008,139.74550000000005,137.84258924638203,139.5071852538402,140.35922923076924,142.85255215888435,137.86590630265414,142.8969999000004,136.91410049999996,135.9716008,139.74550000000005,141.99666666666667,166927008,170403656.8,64.13402192676628,NaN,1.5,2.75,NaN,NaN,1.9437081040486837,0.9795975692934776,266.1165742462357,0.02227786193728809,1.3336977197770068,1.3114198578397187,16.11927453501072,0.7208042343865713,78.5463258749173,3.9192811703746275,17.534392954708075,2492347325
1210944600,142.86,142.87,141.61,142.66,NaN,NaN,126.14923184210525,124.33230769230768,142.8781499500004,136.85940049999996,136.20360079999998,139.95450000000005,138.03150731515137,139.80745332490304,140.63461384615385,143.28764603083502,137.9815816614727,142.8781499500004,136.85940049999996,136.20360079999998,139.95450000000005,142.38,204236816,169688969.6,64.4923783694551,NaN,1.5,2.75,NaN,NaN,1.8948718109023484,1.2035951216006442,267.5793746243586,0.08920067087583838,1.4229206964345167,1.3337200255586783,16.080146029656436,1.2994390399772662,100,0,0,2696584141
1211203800,142.81,144.3,142.3,143.05,NaN,NaN,126.1510742105263,144.3,142.8553999000004,136.79760049999996,136.4704006,140.17950000000005,138.2283109498513,140.11626729395988,141.00307615384617,143.56346662798322,138.44268567970911,142.8553999000004,136.79760049999996,136.4704006,140.17950000000005,143.21666666666667,165704064,172044804,65.60273474788019,NaN,1.5,2.75,NaN,NaN,1.9023809672664664,0.9631448329006205,266.1290476695439,0.13920016244442057,1.507720228614204,1.3685200661697834,15.693466168592213,0.7039774727208729,100,0,0,2862288205
1211290200,142.27,142.34,141,141.89,NaN,NaN,126.15291657894736,144.3905263157895,142.8458499000004,136.72100049999995,136.7482006,140.37700000000004,138.37190659887673,140.28519421834466,141.06230692307693,143.66603519768705,138.4585786484668,142.8458499000004,136.72100049999995,136.7482006,140.37700000000004,141.74333333333334,178552000,172864100.8,59.629869300958134,NaN,1.5,2.75,NaN,NaN,1.912925183890291,1.0329038775181016,262.9264304965498,0.07673674633152472,1.4644409990841893,1.3877042527526646,15.881071194860086,1.6986811926605332,77.18702869300229,4.406750583240049,18.406220723757656,2683736205
1211376600,141.81,142.12,139,139.49001,NaN,NaN,126.1547589473684,144.48105263157896,142.8122499000004,136.63920059999995,136.88600060000002,140.46550050000005,138.41575379107763,140.2094623880261,140.90692384615386,143.62387234855453,138.1899753437532,142.8122499000004,136.63920059999995,136.88600060000002,140.46550050000005,140.20333666666667,252724816,175834891.2,49.57339831437273,NaN,1.5,2.75,NaN,NaN,1.9991448136124135,1.437284797546484,258.88265593853396,-0.13224996958343405,1.2223917907733721,1.3546417603568062,15.511025305730225,0.23714429433746456,42.697914060278485,24.815771257021563,32.48631468269996,2431011389
1211463000,139.42999,140.17,139,139.50999,NaN,NaN,126.15660131578946,144.57157894736844,142.7709498500004,136.56130049999996,137.0490004,140.52499950000006,138.45866501495695,140.14284597011886,140.80538461538464,143.62304069952364,137.98772853124564,142.7709498500004,136.56130049999996,137.0490004,140.52499950000006,139.55999666666665,170820320,172906838.4,49.64952834872392,NaN,1.5,2.75,NaN,NaN,1.9399201840686688,0.9879327016831279,260.8427848279588,-0.26738096586291826,1.0204155530281582,1.2877965188910765,15.425122232794509,0.4391648984279878,42.71576970594606,24.80087651892181,32.48335377513211,2601831709
1211549400,139.05,139.6631,137.52,137.64,NaN,NaN,126.15844368421052,144.6621052631579,142.70999985000037,136.47560039999996,137.16880060000003,140.42699900000005,138.42656050456648,139.9044796872504,140.46615384615387,143.64187610163842,137.29043159066933,142.70999985000037,136.47560039999996,137.16880060000003,140.42699900000005,138.27436666666665,181436192,172439244.8,43.09224529204802,NaN,1.5,2.75,NaN,NaN,1.9544330280637623,1.052174591755113,256.7974338092133,-0.46914089255822544,0.7013704031932946,1.17051129575152,17.329901720012145,-2.007695998312989,17.408147359843507,52.438552345245604,30.153300294910878,2420395517
1211895000,137.8,139,137.53,138.66,NaN,NaN,126.16028605263158,144.7526315789474,142.67634985000038,136.41290049999995,137.3498006,140.37849900000003,138.4357149945835,139.78595781227415,140.40000000000003,143.68572815021446,137.1142718497856,142.67634985000038,136.41290049999995,137.3498006,140.37849900000003,138.39666666666665,168322816,175574560.8,47.18933971029235,NaN,1.5,2.75,NaN,NaN,1.9198306689163507,0.9586970642731062,260.2496842037944,-0.5165842760234991,0.5247809507221461,1.0413652267456452,16.481874312974373,-1.2955580865603598,16.05375381760374,54.40306151680283,29.543184665593426,2588718333
1211981400,139.17,140,138,139.3,NaN,NaN,126.16212842105263,144.84315789473686,142.6492998000004,136.35730049999992,137.5698006,140.38949900000006,138.46960852420767,139.7396761158671,140.41076923076923,143.6810514161171,137.14048704542137,142.6492998000004,136.35730049999992,137.5698006,140.38949900000006,139.1,181288064,178363260.8,49.63930925326134,NaN,1.5,2.75,NaN,NaN,1.9255570497080399,1.0163980137326576,262.1457955125625,-0.4878912914340774,0.43150111245304856,0.919392403887126,16.818438085276426,-1.0442565887618092,39.12444402874223,27.866999410039906,33.00855656121786,2770006397
1212067800,139.13,140.92999,139.08,140,NaN,NaN,126.16397078947368,144.93368421052634,142.6231498000004,136.34420049999994,137.6972006,140.47649950000005,138.52962387619954,139.7644688667369,140.49538538461542,143.6601491730905,137.33062159614033,142.6231498000004,136.34420049999994,137.6972006,140.47649950000005,140.00333,173927184,176639829.6,52.24863117413252,NaN,1.5,2.75,NaN,NaN,1.9201594033003222,0.9846430694247001,264.7751643050512,-0.40804057724711473,0.40934168232823254,0.8173822595753473,17.08734775617895,-1.7750648986178357,75.16510242986004,5.155670400395744,19.679227169744205,2943933581
1212154200,140.47,140.74001,139.94,140.35001,NaN,NaN,126.16581315789473,145.0242105263158,142.6098499000004,136.33580059999994,137.8978006,140.43800000000005,138.60101156732895,139.82023468895244,140.48692384615387,143.6526087901543,137.32123890215345,142.6098499000004,136.33580059999994,137.8978006,140.43800000000005,140.34334,117361936,173143951.2,53.544729860169504,NaN,1.5,2.75,NaN,NaN,1.8401487316360146,0.6778286806244491,266.7550632923735,-0.3217166327689547,0.41523646861415386,0.7369531013831085,15.176620872058587,-1.619227533996915,73.32941724861955,5.891793904347831,20.778788847032626,3061295517
1212413400,139.83,139.86,138,138.89999,NaN,NaN,126.16765552631578,145.1147368421053,142.59914990000038,136.33570049999992,138.0342004,140.30750000000006,138.61273621174743,139.73259233762363,140.36538461538464,143.6421725209005,137.0885967098688,142.59914990000038,136.33570049999992,138.0342004,140.30750000000006,138.91999666666666,181069872,173118169.6,47.76104895085604,NaN,1.5,2.75,NaN,NaN,1.8765673936620133,1.0459322231650952,263.11965186913454,-0.3500010888837102,0.2994517402784709,0.6494528291621811,15.875253428219274,-2.9010905277874928,74.49102951562458,5.435842570157868,20.073127914217547,2880225645
1212499800,139.3,139.62,137.23,138.09,NaN,NaN,126.16949789473684,145.20526315789476,142.5790998500004,136.31290049999993,138.1016004,140.17050000000006,138.5922367524632,139.57615497213567,140.1592307692308,143.63917422184014,136.67928731662144,142.5790998500004,136.31290049999993,138.1016004,140.17050000000006,138.31333333333336,272049920,180795147.2,44.84690867644407,NaN,1.5,2.75,NaN,NaN,1.9132411512575849,1.5047412732768306,260.70314485014217,-0.40699420957632404,0.14071006719177603,0.5477042767681001,15.568408824522022,-2.678130946507846,36.49202512595626,30.3243235154262,33.18365135861754,2608175725
1212586200,137.7,139.16,137.46001,138.02,NaN,NaN,126.17134026315789,145.29578947368424,142.5456498000004,136.28020059999994,138.1650002,139.96900000000005,138.56979609550388,139.4279497366942,139.8123076923077,143.1749375866237,136.4496777979917,142.5456498000004,136.28020059999994,138.1650002,139.96900000000005,138.21333666666666,246726368,184164475.2,44.59367994732935,NaN,1.5,2.75,NaN,NaN,1.8980089261677564,1.3397066276330367,258.8919331549287,-0.43084163630518235,0.009152231386622134,0.4399938676918045,15.356190658663035,-1.0538460782962178,11.828398270112976,61.308663037335876,26.862938692551147,2361449357
1212672600,138.58,140.89,138.32001,140.78,NaN,NaN,126.17318263157894,145.3863157894737,142.52634980000042,136.28650069999995,138.3166002,140.03200000000007,138.6564707584253,139.5567164284376,139.66769230769233,142.67045305637802,136.66493155900665,142.52634980000042,136.28650069999995,138.3166002,140.03200000000007,139.99667,237867008,186094463.2,55.30882315164291,NaN,1.5,2.75,NaN,NaN,1.967436860012915,1.2782057236402509,263.8217435268427,-0.2510778988377925,0.1261464941445638,0.3772243929823563,17.248282773931905,0.9103362418705739,15.832031243675738,54.788568579924295,29.37940017639998,2599316365
1212759000,139.55,139.8,136.22,136.28999,NaN,NaN,126.17502499999999,145.4768421052632,142.4831498000004,136.23660059999992,138.38680000000002,139.88849950000008,138.5636675914282,139.24559962572926,139.14769153846157,141.9628984046913,136.33248467223186,142.4831498000004,136.23660059999992,138.38680000000002,139.88849950000008,137.4366633333333,384276224,196392215.2,41.31179952040603,NaN,1.5,2.75,NaN,NaN,2.1526199414405642,1.9566774762872579,258.34451795179103,-0.4152245839548871,-0.14180633696125255,0.27341824699363454,25.771447391341557,-0.9808267945364703,4.244060119320589,77.64738441351956,18.108555467159842,2215040141
1213018200,136.86,137.5,135.41,136.62,NaN,NaN,126.17686736842104,145.56736842105266,142.43299985000039,136.22110059999994,138.48900020000002,139.77450000000007,138.48744533294084,138.99554251851694,138.74230692307694,141.37290255122616,136.11171129492772,142.43299985000039,136.22110059999994,138.48900020000002,139.77450000000007,136.51,228263872,200175927.2,42.464305306716334,NaN,1.5,2.75,NaN,NaN,2.148147088480524,1.1403162967340061,255.44704511547155,-0.4777740220499756,-0.323799280568835,0.1539747414811406,24.85392182977986,-1.4712245781047109,14.42837391272467,56.95900699579672,28.61261909147862,2443304013
1213104600,135.67,137.10001,135.35001,135.94,NaN,NaN,126.1787097368421,145.6578947368421,142.3800998500004,136.21070059999994,138.5684002,139.54849950000008,138.38754551596276,138.70453846913438,138.46922923076926,141.44681442054141,135.4916440409971,142.3800998500004,136.21070059999994,138.5684002,139.54849950000008,136.13000666666667,260234816,205642096,40.69110303151243,NaN,1.5,2.75,NaN,NaN,2.119708010731915,1.2654744386577348,251.8117480690963,-0.536732864066884,-0.5169413386024644,0.019791525464419618,24.384448507266878,-2.4120603015075472,14.798458212769972,56.37358953395069,28.827952253279335,2183069197
1213191000,135.97,136.2592,133.92999,133.94,NaN,NaN,126.18055210526315,145.74842105263158,142.30814985000038,136.21580069999993,138.5150002,139.22149950000008,138.21313196631715,138.2507729006454,138.0407684615385,141.79714791004164,134.28438901303537,142.30814985000038,136.21580069999993,138.5150002,139.22149950000008,134.70973,284064256,211888215.2,35.93783859032061,NaN,1.5,2.75,NaN,NaN,2.1346724385367777,1.340632633730354,245.36231103201794,-0.6733664635722274,-0.8219165540008646,-0.14855009042863723,25.00349749039368,-4.32857142857143,14.133688096531612,57.43044060366537,28.435871299803008,1899004941
1213277400,134.60001,135.87,133.52,134.45,NaN,NaN,126.1823944736842,145.83894736842106,142.24564985000038,136.23970069999996,138.47000020000002,138.90549950000008,138.06555816371647,137.88879452915535,137.79538384615387,142.0128924867963,133.57787520551145,142.24564985000038,136.23970069999996,138.47000020000002,138.90549950000008,134.61333333333332,252791744,215432264.8,37.92899845846581,NaN,1.5,2.75,NaN,NaN,2.1500529786412934,1.173416360054903,245.88854584360217,-0.6898054626379732,-1.0108069187261037,-0.3210014560881306,24.854584350727034,-4.20378309912483,14.290600319208814,57.1788226579725,28.530577022818672,2151796685
1213363800,135.17,136.52,134.418,136.14999,NaN,NaN,126.18423684210525,145.92947368421054,142.20779980000037,136.29400059999998,138.4522002,138.58649900000006,137.99043784357073,137.7231940978072,137.60230615384617,141.8732856870418,133.33132662065054,142.20779980000037,136.29400059999998,138.4522002,138.58649900000006,135.69599666666667,244727056,219322267.2,44.15939297763021,NaN,1.5,2.75,NaN,NaN,2.1466206230240585,1.1158331487465127,250.1260594706163,-0.5525324672603198,-1.0116670401635304,-0.4591345729032106,26.44101950804207,-1.9798417552081897,42.23159622641608,25.20499912225945,32.56340465132446,2396523741
1213623000,135.55,136.92999,135.46001,136.23,NaN,NaN,126.1860792105263,146.02,142.15624985000036,136.31770059999997,138.43900019999998,138.26499900000005,137.92140106539148,137.58098513611128,137.36615230769232,141.5745754561718,133.15772915921283,142.15624985000036,136.31770059999997,138.43900019999998,138.26499900000005,136.20666666666668,185833376,218402095.2,44.442047289960236,NaN,1.5,2.75,NaN,NaN,2.098289149950911,0.85087725843392,252.79272613728295,-0.428235854684919,-0.9944293912593594,-0.5661935365744404,26.073533564863762,-1.346947642841635,42.07972716293674,25.30931064248102,32.610962194582235,2582357117
1213709400,137.07001,137.12,135.37,135.57001,NaN,NaN,126.18792157894735,146.11052631578949,142.10334995000036,136.32350059999996,138.4112002,137.89099950000005,137.8291896510624,137.38946369457688,137.02538384615386,141.03842241045652,133.0123452818512,142.10334995000036,136.32350059999996,138.4112002,137.89099950000005,136.02000333333334,191743808,219704082.4,42.529662884962605,NaN,1.5,2.75,NaN,NaN,2.073411353525846,0.8727366642687382,249.90335166371867,-0.3648374563663124,-1.0222403570323308,-0.6574029006660185,26.02542071310531,-1.7750978119113272,46.870510525898155,21.446965769129367,31.682523704972482,2390613309
1213795800,134.69,135.5235,133.71001,134.25,NaN,NaN,126.1897639473684,146.20105263157896,142.03664995000037,136.33560069999996,138.3598,137.50899950000004,137.68882927258935,137.09046715223622,136.55615230769232,140.32349597660837,132.78880863877626,142.03664995000037,136.33560069999996,138.3598,137.50899950000004,134.49450333333334,266970560,224125010.4,38.9221909229113,NaN,1.5,2.75,NaN,NaN,2.058167685416856,1.1911680875040798,245.98309388486896,-0.3842217238610225,-1.1376800554922966,-0.7534583316312741,26.39237274802066,-4.63844296064782,48.094165752826974,20.51638829799758,31.389445949175453,2123642749
1213882200,134.14999,135.24001,132,134.42,NaN,NaN,126.19160631578946,146.29157894736844,141.96334995000035,136.32740059999998,138.3316,137.25549900000004,137.56063988935054,136.83613694726134,136.2115376923077,139.8764463830416,132.5466290015738,141.96334995000035,136.32740059999998,138.3316,137.25549900000004,133.88666999999998,304310784,226704308.8,39.632375916042044,NaN,1.5,2.75,NaN,NaN,2.142584993601367,1.3423246589832791,246.89596481404425,-0.35851173089396693,-1.2015979952487328,-0.8430862643547659,22.45084940027374,-1.372067016807325,50.59023430608396,18.68584196445136,30.723923729464687,2427953533
1213968600,132.84,133.09,131.22,131.58,NaN,NaN,126.19344868421052,146.3821052631579,141.88230000000033,136.28410059999996,138.2428,136.85899950000004,137.32610499172895,136.3355524760936,135.7107684615385,139.9466978981421,131.47483902493488,141.88230000000033,136.28410059999996,138.2428,136.85899950000004,131.96333333333334,289275648,232627075.2,32.77595465324215,NaN,1.5,2.75,NaN,NaN,2.218114636915554,1.2435166790077925,240.58245033189732,-0.4971593367425735,-1.4645354352829827,-0.9673760985404092,17.884560909407295,-3.68906455862977,21.491592695124265,46.8125530381075,31.69585426676824,2138677885
1214227800,132.09,132.23,131.32001,131.45,NaN,NaN,126.19529105263157,146.4726315789474,141.79890000000034,136.24950059999998,138.2042,136.54949950000005,137.09566950185723,135.8702617640847,135.20538384615386,139.77337582328244,130.6373918690253,141.79890000000034,136.24950059999998,138.2042,136.54949950000005,131.66666999999998,165115680,231811049.6,32.49879858839866,NaN,1.5,2.75,NaN,NaN,2.124677162850157,0.7122856321340776,236.35053694560372,-0.5574759691508606,-1.6642210599789848,-1.1067450908281242,17.5757979828185,-3.3029277622480575,6.969842324631021,70.9600985311611,22.070059144207896,1973562205
1214314200,131.05,132.44,130.19,131.19,NaN,NaN,126.19713342105263,146.56315789473686,141.72449995000034,136.18770059999997,138.16940019999998,136.17599950000005,136.86407461943145,135.4245225484576,134.46769153846157,138.22120405644148,130.71417902048165,141.72449995000034,136.18770059999997,138.16940019999998,136.17599950000005,131.27333333333334,267300624,236759940,31.91748249769448,NaN,1.5,2.75,NaN,NaN,2.133628794075146,1.128994305371086,232.3248259268706,-0.5725600631873047,-1.822445169812255,-1.2498851066249503,17.589691971390543,-2.0531581305061968,6.188272789535211,72.75456830935376,21.057158901111034,1706261581
1214400600,131.72,133.39999,131.239,131.81,NaN,NaN,126.19897578947368,146.65368421052634,141.65460000000033,136.11000059999998,138.14079999999998,135.80149950000003,136.66587561474788,135.08028230574735,134.12307692307695,137.96565079298333,130.28050305317058,141.65460000000033,136.11000059999998,138.14079999999998,135.80149950000003,132.14966333333334,287853824,242088228,34.90753478241761,NaN,1.5,2.75,NaN,NaN,2.139083165926922,1.1890451112724076,236.10258036190586,-0.5010380209769729,-1.8761826328461666,-1.3751446118691937,16.556581315418367,-1.963555224990693,25.331140039009732,42.21611615203803,32.45274380895224,1994115405
1214487000,130.57001,131.42,128.08,128.23,NaN,NaN,126.20081815789473,146.7442105263158,141.55829995000033,136.01410049999996,137.96839979999996,135.21299950000005,136.33505696318915,134.42787446710474,133.47769230769234,138.15386494284294,128.80151967254173,141.55829995000033,136.01410049999996,137.96839979999996,135.21299950000005,129.24333333333334,297775104,248280624,27.419352719551526,NaN,1.5,2.75,NaN,NaN,2.2527200826464266,1.199348943153937,229.16536189915007,-0.645874455078884,-2.1824876807177986,-1.5366132256389147,21.750627040295207,-5.817106560198802,5.292744524730086,74.94257946167251,19.764676013597395,1696340301
1214573400,128.28,128.86,127.035,127.53,NaN,NaN,126.20266052631578,146.8347368421053,141.45659995000034,135.94810049999998,137.77799979999998,134.57199900000006,135.98976061169154,133.7709340416662,132.83076923076925,138.23555004061708,127.42598842092141,141.45659995000034,135.94810049999998,137.77799979999998,134.57199900000006,127.80833333333334,303423232,257583688.8,26.23432944469279,NaN,1.5,2.75,NaN,NaN,2.222168648171683,1.1779598056598684,225.7865060770312,-0.7334606750416257,-2.4534390694409467,-1.719978394399321,18.76571740331475,-6.386258533362688,5.250290596579393,75.05031617908345,19.699393224337147,1392917069
1214832600,127.89,128.91,127.3,127.98,NaN,NaN,126.20450289473683,146.92526315789476,141.35194995000032,135.89740049999997,137.56799979999997,134.02599950000007,135.67565235240951,133.21941651388846,132.37230769230771,138.3079890845868,126.43662630002864,141.35194995000032,135.89740049999997,137.56799979999997,134.02599950000007,128.06333333333333,258888192,261474604.8,28.377315926178156,NaN,1.5,2.75,NaN,NaN,2.17844231615942,0.9901083594639015,222.79257281731475,-0.7055101368905174,-2.6018660655124677,-1.8963559286219502,19.241966278066062,-5.59859072076486,19.001881152993455,50.16781523931701,30.830303607689537,1651805261
1214919000,126.52,128.47,125.92999,128.38,NaN,NaN,126.20634526315789,147.01578947368424,141.24935000000033,135.84190059999997,137.36459979999995,133.54049950000007,135.38954833858952,132.75851970304194,131.90538461538463,138.06461812107557,125.7461511096937,141.24935000000033,135.84190059999997,137.36459979999995,133.54049950000007,127.59333,388621824,267303200,30.315232830222314,NaN,1.5,2.75,NaN,NaN,2.2042685792908894,1.4538614726647492,220.28376480412226,-0.6081914933474257,-2.656595295306232,-2.0484038019588064,19.981360947671227,-4.372439478584734,47.97207782629357,20.621383596535647,31.406538577170785,2040427085
1215005400,128.78999,129.16,125.95,126.17999,NaN,NaN,126.20818763157894,147.1063157894737,141.13974990000034,135.77300039999997,137.12939959999997,132.94849900000006,135.0283891880566,132.131993064657,131.13846153846154,137.47297644384,124.8039466330831,141.13974990000034,135.77300039999997,137.12939959999997,132.94849900000006,127.09666333333331,291223296,269528046.4,26.127892282442176,NaN,1.5,2.75,NaN,NaN,2.2761065379129684,1.0804934769860746,214.604856458322,-0.63703624199889,-2.844699104457419,-2.207662862458529,21.01128030914813,-6.130047611962494,22.7109475535187,45.271018078198644,32.01803436828264,1749203789
1215091800,127.11,127.11,124.99001,126.31,NaN,NaN,126.21002999999999,147.1968421052632,141.00899985000035,135.69860039999998,136.90119959999996,132.22499900000005,134.6864915728387,131.57751753468966,130.37538461538463,136.45764914501348,124.29312008575577,141.00899985000035,135.69860039999998,136.90119959999996,132.22499900000005,126.13667,239359632,269602677.6,26.771607332338675,NaN,1.5,2.75,NaN,NaN,2.264955356633471,0.8878236452648643,211.22117867190101,-0.5932973037956839,-2.949284492203134,-2.35598718840745,20.98113165069498,-4.0051679586563385,46.331105788382914,21.87781741140652,31.791076800210558,1988563421
1215437400,126.78999,127.34,123.92,125.02,NaN,NaN,126.21187236842104,147.28736842105266,140.86729985000034,135.5989003,136.63519939999998,131.66149950000005,134.30741347194305,130.9529920551954,129.5638453846154,135.46989379332032,123.65779697591049,140.86729985000034,135.5989003,136.63519939999998,131.66149950000005,125.42666666666666,372427264,269010229.6,24.491159438596142,NaN,1.5,2.75,NaN,NaN,2.3474585454453663,1.3844353226038062,207.32317348405886,-0.5956266604981044,-3.10052051403008,-2.504893853531976,18.923971746462307,-4.891593761886644,42.14758084034213,25.31990204774968,32.532517111908184,1616136157
1215523800,124.99001,127.39,124.2,127.24001,NaN,NaN,126.21371473684209,147.37789473684214,140.74209990000037,135.50760039999997,136.38799939999998,131.19250000000005,134.03026039461196,130.59937471660538,129.0246153846154,134.37466194881816,123.67456882041263,140.74209990000037,135.50760039999997,136.38799939999998,131.19250000000005,126.27667000000001,376225280,276408300,34.786344459489015,NaN,1.5,2.75,NaN,NaN,2.4076400779135545,1.361121500331213,211.16529591338158,-0.40135043140996274,-3.0065818927944292,-2.6052314613844665,22.970173240353752,-3.0108925985212287,46.4392030263747,21.84317614227599,31.717620831349297,1992361437
1215610200,127.5,127.74001,124.39,124.78999,NaN,NaN,126.21555710526314,147.4684210526316,140.60619985000037,135.40380029999997,136.09119919999998,130.63499950000005,133.66789684972522,130.0460999816906,128.2838453846154,133.07848979333164,123.48920097589918,140.60619985000037,135.40380029999997,136.09119919999998,130.63499950000005,125.64,336789760,280236047.2,29.93545286732632,NaN,1.5,2.75,NaN,NaN,2.4749522152054433,1.2018074168725286,207.121418915194,-0.39114555672689155,-3.094163407293081,-2.7030178505661895,24.729542593831077,-5.32585539792125,18.040195417057113,51.58126221487761,30.378542368065276,1655571677
1215696600,124.42999,125.78999,123.58,125.3,NaN,NaN,126.2173994736842,147.5589473684211,140.47424985000035,135.30540029999997,135.81559919999998,130.20299950000006,133.33974403208893,129.59409045962482,127.80076846153847,132.43236475467546,123.16917216840147,140.47424985000035,135.30540029999997,135.81559919999998,130.20299950000006,124.88999666666666,436475648,287856616.8,32.05936299505977,NaN,1.5,2.75,NaN,NaN,2.456026342690769,1.5162953447176066,209.04591981249274,-0.3070542980492017,-3.0868357231276917,-2.77978142507849,24.640832184629648,-2.2849567183966255,45.57501740983181,22.520454412680515,31.904528177487663,2092047325
1215783000,123.97,125.89999,122.49001,123.84,NaN,NaN,126.21924184210525,147.64947368421056,140.33649985000037,135.18860029999996,135.5271994,129.67249950000007,132.9672050504384,129.04608184442245,127.21538384615384,131.7772320810751,122.65353561123257,140.33649985000037,135.18860029999996,135.5271994,129.67249950000007,124.07666666666667,481124608,299273260,29.319359350119754,NaN,1.5,2.75,NaN,NaN,2.5241658896414285,1.6076431552889157,204.24487825882963,-0.30608228507641666,-3.1623842814240106,-2.856301996347594,20.73414103818585,-2.893436838390965,20.68890035558317,47.94607874650962,31.365020897907197,1610922717
1216042200,125.25999,125.5,122.39999,122.72,NaN,NaN,126.2210842105263,147.74000000000004,140.18914985000038,135.05660029999996,135.1591994,129.00100000000006,132.56535387198983,128.44359785923936,126.56384538461538,131.08818517902435,122.0395055902064,140.18914985000038,135.05660029999996,135.1591994,129.00100000000006,123.53999666666667,322720768,303172945.6,27.385741667245128,NaN,1.5,2.75,NaN,NaN,2.5652976118098976,1.0644774630576403,197.55468986913124,-0.33486313041052185,-3.2748809093607463,-2.9400177789502244,20.962714737650884,-4.11001719018597,22.4438516434415,45.61720902884273,31.938939327715765,1288201949
1216128600,121.8,123.49001,120.02,120.99001,NaN,NaN,120.02,147.8305263157895,140.02864990000037,134.91860049999997,134.74879980000003,128.23900050000006,132.1114188181863,127.73373234883562,125.73153846153846,130.06623974416783,121.39683717890911,140.02864990000037,134.91860049999997,134.74879980000003,128.23900050000006,121.50000666666666,502502400,319006396.8,24.678398213777356,NaN,1.5,2.75,NaN,NaN,2.6299199252520475,1.5752110460500959,191.44380964261254,-0.4189486673943037,-3.463703613193104,-3.0447549457988003,21.14912799403632,-5.756340551487769,5.1426530469036145,75.22460293254284,19.632744020553556,785699549
1216215000,121.45,124.57001,121.10001,123.96001,NaN,NaN,119.94710831325301,147.921052631579,139.88554995000038,134.80200059999996,134.41140000000001,127.65850050000006,131.79175572727704,127.37433022037509,125.40307769230769,129.5747695926556,121.23138579195978,139.88554995000038,134.80200059999996,134.41140000000001,127.65850050000006,123.21001,371642880,328001350.4,36.31788576499756,NaN,1.5,2.75,NaN,NaN,2.6977827877340443,1.1330528961139301,196.97754456779845,-0.2323929603567536,-3.3352461462447422,-3.1028531858879886,26.995045067292207,-1.7593756347579412,18.712900805176155,50.57844772186133,30.708651472962522,1157342429
1216301400,125.14,126.25999,124.09,125.2,NaN,NaN,119.87421662650603,148.01157894736846,139.74004995000038,134.68070059999997,134.0744,127.20600050000004,131.53325550267795,127.16725115176793,125.22384692307693,129.21073418455006,121.2369596616038,139.74004995000038,134.68070059999997,134.0744,127.20600050000004,125.18333,375490560,333427350.4,40.45507585920046,NaN,1.5,2.75,NaN,NaN,2.6693683028958985,1.1261540468996871,202.46589142450424,0.004140350793290892,-3.097677747396375,-3.101818098189666,26.427703718417316,-0.878790277887736,16.82467685451646,53.287543352614236,29.887779792869296,1532832989
1216387800,126.17,126.41589,125.14999,125.98,NaN,NaN,119.80132493975903,148.10210526315794,139.59949995000036,134.55690059999995,133.8036,126.78400050000005,131.31548077708274,127.05417961350432,125.07000076923077,128.7631263164972,121.37687522196437,139.59949995000036,134.55690059999995,133.8036,126.78400050000005,125.84862666666668,267030000,331563311.2,42.965165833826255,NaN,1.5,2.75,NaN,NaN,2.569120566974763,0.8053665498560747,203.8512992484715,0.23023426507426015,-2.8140252668468406,-3.0442595319211008,26.72236211576844,0.7678771396576611,40.12997189169556,27.008295593543494,32.86173251476094,1799862989
1216647000,126.50999,126.8,125.19,126.05,NaN,NaN,119.72843325301204,148.19263157894738,139.46084995000038,134.43520059999994,133.54139999999998,126.50750050000006,131.1089913348442,126.95854345983724,124.89077,128.12110786720544,121.66043213279455,139.46084995000038,134.43520059999994,133.54139999999998,126.50750050000006,126.01333333333334,222863008,328242679.2,43.19658913163206,NaN,1.5,2.75,NaN,NaN,2.500611955047994,0.6789580457458074,207.41500518471258,0.39209745928107065,-2.5541377078197627,-2.9462351671008333,25.952381979554573,-0.935248276072912,65.3096325853749,9.63036209784831,25.060005316776795,2022725997
1216733400,125.14999,127.8,124.85001,127.48,NaN,NaN,119.65554156626506,148.28315789473686,139.32814995000038,134.34130059999995,133.31300019999998,126.30900050000007,130.96667794916405,127.0082059874718,124.99077076923078,128.44713794512765,121.5344035933339,139.32814995000038,134.34130059999995,133.31300019999998,126.30900050000007,126.71000333333333,296904192,334832104.8,47.85169706949112,NaN,1.5,2.75,NaN,NaN,2.5327103868302805,0.8867255790102478,211.89729356130206,0.5911152997638363,-2.2073410423960382,-2.7984563421598745,24.682422522448977,2.155629630229156,100,0,0,2319630189
1216819800,127.89,129.14999,127.55,128.17,NaN,NaN,119.58264987951807,148.37368421052633,139.18974990000038,134.28480049999996,133.06719999999999,126.15800050000007,130.85700430409878,127.11885303628401,125.13384769230771,128.93372827095868,121.33396711365673,139.18974990000038,134.28480049999996,133.06719999999999,126.15800050000007,128.28999666666667,311698432,337051995.2,49.98170848452073,NaN,1.5,2.75,NaN,NaN,2.471087502056689,0.9247784805873773,214.83377969606792,0.7544157661041999,-1.8554366345296245,-2.6098524006338244,21.35269976155785,2.2905027932960818,100,0,0,2631328621
1216906200,128.34,128.41,125.16,125.50999,NaN,NaN,119.50975819277107,148.4642105263158,139.04219985000037,134.20490039999996,132.7677998,125.84300000000007,130.64731746864393,126.96562798520934,125.17153923076924,128.9758729377483,121.36720552379018,139.04219985000037,134.20490039999996,132.7677998,125.84300000000007,126.35999666666667,248634496,335091028.8,42.73494963391856,NaN,1.5,2.75,NaN,NaN,2.52672410905264,0.7419909058454626,209.07704451021823,0.671259515906443,-1.7707780057507705,-2.4420375216572134,25.226409326617187,1.3485061369509033,78.96765853630774,3.7764460118665513,17.25589545182571,2382694125
1216992600,125.89,126.49001,125.17,125.48,NaN,NaN,119.43686650602409,148.55473684210529,138.88719985000037,134.12980029999994,132.46199979999997,125.70550000000007,130.4446775679128,126.8241396056656,125.03615384615387,128.6572629279736,121.41504476433416,138.88719985000037,134.12980029999994,132.46199979999997,125.70550000000007,125.71333666666668,219131008,331158824,42.659851364320126,NaN,1.5,2.75,NaN,NaN,2.4405302441203083,0.6617097057936164,211.33652745060408,0.6042999544623404,-1.6866625785792877,-2.290962533041628,24.08397444673725,2.249022164276406,54.48167594432295,16.008317564705763,29.510006490971268,2163563117
1217251800,125.50999,126.06,123.42,123.64,NaN,NaN,119.3639748192771,148.64526315789476,138.72429985000036,134.02790029999994,132.0841998,125.51100000000005,130.17782746721034,126.52088821464982,124.9476930769231,128.64394151245546,121.25144464139075,138.72429985000036,134.02790029999994,132.0841998,125.51100000000005,124.37333333333333,205202880,326247806.4,38.22187703936858,NaN,1.5,2.75,NaN,NaN,2.4547780838260005,0.6289785738770871,207.131552042612,0.4341143630832045,-1.7483195791876227,-2.182433942270827,25.176235652862214,2.1902552119799004,32.36181038166436,34.38975326746334,33.24843635087229,1958360237
1217338200,123.98,126.38,123.64,126.28,NaN,NaN,119.29108313253012,148.73578947368424,138.57834985000034,133.98010029999995,131.75659979999998,125.42600000000007,130.02497148810406,126.49794647992127,125.02307769230772,128.78439355297135,121.2617618316441,138.57834985000034,133.98010029999995,131.75659979999998,125.42600000000007,125.43333333333332,261505568,326378675.2,46.7771583292794,NaN,1.5,2.75,NaN,NaN,2.475151077838429,0.8012336217730931,212.29787656696283,0.49306380533713057,-1.5661041855994142,-2.059167990936545,25.6591406325824,1.8715632565696019,30.273394211017067,36.56667658973234,33.1599291992506,2219865805
1217424600,127.11,128.60001,126.28,128.53,NaN,NaN,119.21819144578313,148.8263157894737,138.43934985000033,133.96830019999996,131.46619979999997,125.43350000000007,129.96634515523724,126.69147538659543,125.38384692307696,129.50457086305082,121.26312298310312,138.43934985000033,133.96830019999996,131.46619979999997,125.43350000000007,127.80333666666667,354710016,324683084.8,52.779165586050745,NaN,1.5,2.75,NaN,NaN,2.464069572278541,1.0924807376968717,215.95405586492177,0.6665277393788878,-1.2260083167129352,-1.892536056091823,24.012002857666985,2.6597444089456856,32.70615356146037,34.03959279653841,33.254253642001224,2574575821
1217511000,127.39999,128.57001,126.63,126.83,NaN,NaN,119.14529975903613,148.91684210526319,138.29844990000035,133.95660019999997,131.16499979999998,125.46600050000006,129.84335122758088,126.70466820691968,125.7000007692308,129.57822696172394,121.82177457673765,138.29844990000035,133.95660019999997,131.16499979999998,125.46600050000006,127.34333666666666,277402112,323992025.6,48.343230215669415,NaN,1.5,2.75,NaN,NaN,2.426636745687216,0.8562004311256727,212.9150931936066,0.6490749486783405,-1.0811923702438975,-1.730267318922238,25.433364999189504,0.6747102714716576,31.18752363623024,35.60237389384625,33.21010246992351,2297173709
1217597400,127.12,127.28,125.46001,126.16,NaN,NaN,119.07240807228915,149.00736842105266,138.16034990000034,133.89220009999997,130.89839959999995,125.45850050000006,129.69890608140125,126.6527950443559,126.09769230769234,128.8630605413216,123.33232407406308,138.16034990000034,133.89220009999997,130.89839959999995,125.45850050000006,126.30000333333332,248703568,324459222.4,46.67810657770208,NaN,1.5,2.75,NaN,NaN,2.383304835280987,0.766517179448187,212.26043952289862,0.5771269783385893,-1.0088585959990013,-1.5859855743375906,25.476452089733478,0.08726695755652474,29.796025129564608,37.07752869891838,33.12644617151701,2048470141
1217856600,126.03999,126.14,124.75999,124.99001,NaN,NaN,118.99951638554217,149.09789473684214,138.01404995000036,133.82850019999995,130.60799999999998,125.45700100000006,129.51424348997375,126.49443456394106,126.1769230769231,128.74472767788984,123.60911847595636,138.01404995000036,133.82850019999995,130.60799999999998,125.45700100000006,125.29666666666665,188251744,315250446.4,43.83849777188578,NaN,1.5,2.75,NaN,NaN,2.3130694899037727,0.5971498094601906,208.85902507400172,0.4415705337850502,-1.0340224071062778,-1.475592940891328,26.040230884126462,-1.95323972387826,28.93992689414696,37.92909268902622,33.13098041682683,1860218397
1217943000,126.02,128.56,124.9736,128.36,NaN,NaN,118.92662469879518,149.1884210526316,137.88739995000037,133.79560029999996,130.42239999999995,125.51300050000006,129.46897903938654,126.67210746261334,126.42000000000002,129.16408957021167,123.67591042978836,137.88739995000037,133.79560029999996,130.42239999999995,125.51300050000006,127.29786666666666,251624320,309020398.4,52.7539250745763,NaN,1.5,2.75,NaN,NaN,2.4040216691963603,0.8142644346548743,213.42396863087288,0.561976111527005,-0.7731228014825717,-1.3350989130095767,29.847561157755003,0.14824061792933305,28.648583383209502,38.248932744312896,33.10248387247759,2111842717
1218029400,128.02,129.3,127.48,128.92999,NaN,NaN,118.8537330120482,149.2789473684211,137.78369990000039,133.78880019999994,130.22779979999996,125.72000050000005,129.44784221431254,126.8871438947454,126.64692230769234,129.680560431335,123.61328418404966,137.78369990000039,133.78880019999994,130.22779979999996,125.72000050000005,128.5699966666667,209555376,302658679.2,54.08166462000771,NaN,1.5,2.75,NaN,NaN,2.362305835682335,0.6923818492630229,215.3582331707807,0.6565315507656486,-0.514434474552516,-1.1709660253181646,29.796952409092142,2.7248826965885358,20.74968726678347,47.7676170216793,31.482695711537232,2321398093
1218115800,127.96001,129.0549,126.53999,127.00999,NaN,NaN,118.7808413253012,149.36947368421056,137.66604990000036,133.77590009999997,129.98199959999994,125.80550000000005,129.35224016669244,126.89884352381728,126.72076769230772,129.73938846442056,123.70214692019489,137.66604990000036,133.77590009999997,129.98199959999994,125.80550000000005,127.53496000000001,246312432,293150518.4,49.07837120143894,NaN,1.5,2.75,NaN,NaN,2.3732061331335967,0.8402251285256469,210.3404078022997,0.5695261586842657,-0.45905832696283255,-1.0285844856470983,28.38328093071596,1.219309850175325,21.935864577737895,46.22205967874352,31.842075743518578,2075085661
1218202200,126.58,129.92999,126.38,129.37,NaN,NaN,118.70794963855421,149.46000000000004,137.55409995000036,133.73330009999998,129.76939959999993,126.08200000000004,129.35293663074373,127.13419175964421,126.86615230769233,130.18423577392787,123.54806884145681,137.55409995000036,133.73330009999998,129.76939959999993,126.08200000000004,128.55999666666665,260811632,282134869.6,54.63400556246671,NaN,1.5,2.75,NaN,NaN,2.457262123624055,0.9244218283609137,215.51576418862618,0.6451250953690847,-0.22217811643574237,-0.8673032118048271,30.007322535284512,4.634422516984798,51.68759583506562,17.897414993274943,30.414989171659425,2335897293
1218461400,129.47,131.50999,129.23,130.71001,NaN,NaN,118.63505795180723,131.50999,137.45025000000035,133.7372001,129.57659959999992,126.48150050000007,129.40615519424398,127.47474587777333,127.06153769230771,130.91901376879355,123.20406161582187,137.45025000000035,133.7372001,129.57659959999992,126.48150050000007,130.48333333333332,249425808,278470121.6,57.471226194848526,NaN,1.5,2.75,NaN,NaN,2.4445998290794795,0.89570043122357,218.81504379206075,0.7521138662911564,0.07283912105911838,-0.679274745232038,27.941100864839964,3.5080852074754594,76.72669703392152,4.566539499562784,18.706763466515678,2585323101
1218547800,130.28011,130.7028,128.73,129.35001,NaN,NaN,118.56216626506024,131.2894725862069,137.33780005000034,133.7099002,129.38559999999995,126.89950050000007,129.40395342192068,127.65334246084254,127.35692384615385,131.28143898466297,123.43240870764473,137.33780005000034,133.7099002,129.38559999999995,126.89950050000007,129.59427,213200816,264005042.4,53.79406562107339,NaN,1.5,2.75,NaN,NaN,2.4114148412880896,0.8075634240234496,215.08613484911754,0.6991460989060917,0.19465787840057658,-0.5044882205055151,27.377216029078625,0.6379911304753726,50.021838744348244,19.093045873268146,30.8851153823836,2372122285
1218634200,128.78999,129.64999,127.67,128.57001,NaN,NaN,118.48927457831324,131.06895517241378,137.21255010000036,133.6484003,129.19520019999993,127.13000050000008,129.37124975831594,127.74064413123848,127.59461692307693,131.40836423805288,123.78086960810097,137.21255010000036,133.6484003,129.19520019999993,127.13000050000008,128.63,256467184,258246257.6,51.7490125780925,NaN,1.5,2.75,NaN,NaN,2.3805987811960834,0.9931109414071138,212.56377110838153,0.5841180797067584,0.22565937912793288,-0.3584587005788255,25.885857068831598,1.3719230465978065,23.834550412638855,43.854900344265,32.310549243096155,2115655101
1218720600,127.84,130.28,127.75,129.53999,NaN,NaN,118.41638289156626,130.84843775862066,137.08960005000034,133.59530009999997,129.02559999999994,127.34700000000007,129.3778670226957,127.91201040445387,128.0484623076923,131.22229624559327,124.87462836979131,137.08960005000034,133.59530009999997,129.02559999999994,127.34700000000007,129.18999666666664,239556064,251449532.8,54.08657265819551,NaN,1.5,2.75,NaN,NaN,2.391270296824935,0.9527003742358912,215.31120392771928,0.5465701678873556,0.3247540092803689,-0.2218161586069866,24.691647193124705,2.679129676601135,50.49779496743186,18.75029661146747,30.751908421100655,2355211165
1218807000,129.92999,130.5,129.3,130.17,NaN,NaN,118.34349120481927,130.62792034482757,136.97515005000034,133.5650001,128.81339999999994,127.55650000000007,129.40893106102138,128.12705703260113,128.34769307692306,131.53166382554258,125.16372232830354,136.97515005000034,133.5650001,128.81339999999994,127.55650000000007,129.99,181005376,247148301.6,55.59142122113369,NaN,1.5,2.75,NaN,NaN,2.3061795613374385,0.7323755608604191,216.5005878633521,0.5366117747766701,0.44894855986385096,-0.08766321491281909,24.261232293874105,4.144323214311279,46.66056069159484,21.606976884806503,31.73246242359866,2536216541
1219066200,130.42999,130.48,127.66,128.39,NaN,NaN,118.27059951807229,130.40740293103448,136.84385010000034,133.52110009999996,128.65540019999995,127.67350000000006,129.36897298019701,128.15209921997246,128.33692384615387,131.51930191127875,125.154545781029,136.84385010000034,133.52110009999996,128.65540019999995,127.67350000000006,128.84333333333333,172275056,244618904,50.5502269169815,NaN,1.5,2.75,NaN,NaN,2.342881021241907,0.7042589643848621,212.9254502162954,0.38944373815979527,0.399141457786925,0.00969771962712973,25.21038934437839,0.023371766905556802,20.788421919250542,47.716380056357146,31.495198024392323,2363941485
1219152600,127.42,128.1181,126.53,126.99001,NaN,NaN,118.1977078313253,130.18688551724136,136.72365015000034,133.47590029999995,128.46280039999996,127.64900050000006,129.27568031430692,128.04142405616557,128.34923230769232,131.50936185418058,125.18910276120404,136.72365015000034,133.47590029999995,128.46280039999996,127.64900050000006,127.21270333333331,194673632,239507376,46.944444792038865,NaN,1.5,2.75,NaN,NaN,2.308389519724627,0.8128085040687849,208.47760429570266,0.18735387622059302,0.24389006490287102,0.05653618868227799,21.051677222552073,-1.5046770731929828,21.728827530109097,46.48848155544703,31.782690914443872,2169267853
1219239000,127.39,127.95,126.34,127.58,NaN,NaN,118.1248161445783,129.96636810344825,136.60555015000034,133.43200029999997,128.29560039999996,127.61950050000004,129.2091830470792,127.99747890795932,128.45846307692307,131.39888342851899,125.51804272532716,136.60555015000034,133.43200029999997,128.29560039999996,127.61950050000004,127.29,225498128,235197360.8,48.608144983260495,NaN,1.5,2.75,NaN,NaN,2.2585045540300106,0.9587613025630515,209.9155081755109,0.08800281994463872,0.1665397136130764,0.07853689366843768,21.07150573662681,0.44879146908050016,53.2427287806274,16.826172520129177,29.931098699243424,2394765981
1219325400,126.75,128.44,126.60001,127.8,NaN,NaN,118.05192445783132,129.74585068965516,136.49430015000036,133.34390029999994,128.17280039999997,127.73400100000006,129.15392096680156,127.97867139291557,128.67461615384616,130.88617685479963,126.46305545289268,136.49430015000036,133.34390029999994,128.17280039999997,127.73400100000006,127.61333666666665,180609808,231796126.4,49.24724167117693,NaN,1.5,2.75,NaN,NaN,2.2286106573135815,0.7791752640780972,207.71358064525816,0.034442129553068634,0.12158955560977347,0.08714742605670484,19.11977610978652,-1.2135734714385153,49.81071164429843,19.23553389689587,30.953754458805697,2575375789
1219411800,128.67,129.64999,127.8,129.64999,NaN,NaN,117.97903277108433,129.52533327586207,136.38220005000036,133.27340019999994,128.07680019999998,127.94250050000005,129.17337465437797,128.13784459359027,128.77384615384614,131.0352356173516,126.51245669034067,136.38220005000036,133.27340019999994,128.07680019999998,127.94250050000005,129.03332666666668,167715248,229225338.4,54.38433724137193,NaN,1.5,2.75,NaN,NaN,2.201566324648326,0.7316610335081525,211.83668627087582,0.11633334655223107,0.23256410924699367,0.1162307626947626,17.845749309692046,-0.8109707894598192,48.965593948292224,19.854498958288612,31.179907093419146,2743091037
1219671000,128.8,129.64999,126.75,127.02,NaN,NaN,117.90614108433735,129.30481586206895,136.27775005000035,133.17320029999996,127.89420039999999,128.11150050000006,129.0889285895004,128.03138320372454,128.62692384615383,131.0695638294271,126.18428386288058,136.27775005000035,133.17320029999996,127.89420039999999,128.11150050000006,127.80666333333333,171936880,227562038.4,47.08752373231655,NaN,1.5,2.75,NaN,NaN,2.251453730030589,0.7555604669781337,207.18349662150158,-0.007336682728015617,0.10705990928474307,0.11439659201275869,20.08110615266934,-1.8013218553288102,50.24533201707675,18.94405262009464,30.810615362828607,2571154157
1219757400,127.02,127.87,126.58,127.39,NaN,NaN,117.83324939759035,129.08429844827583,136.17890005000035,133.07820029999996,127.7174004,128.16700050000003,129.02230393893174,127.97029908908411,128.65615538461537,131.0287871623931,126.28352360683765,136.17890005000035,133.07820029999996,127.7174004,128.16700050000003,127.27999999999997,159117184,222442619.2,48.14169228644627,NaN,1.5,2.75,NaN,NaN,2.182778463599833,0.7153178854495345,210.16738912255306,-0.0618964564428372,0.03702602145921219,0.09892247790204939,19.693459188281334,-0.9177956819012426,78.33898066440308,3.994686915445106,17.66633242015183,2730271341
1219843800,127.55,128.83,127.3,128.63,NaN,NaN,117.76035771084337,128.86378103448274,136.09635005000035,132.99490019999993,127.5786002,128.17200050000002,129.00691947073835,128.03312774726658,128.5992323076923,130.9358621581937,126.2626024571909,136.09635005000035,132.99490019999993,127.5786002,128.17200050000002,128.25333333333333,171032752,213258756,51.620407083892566,NaN,1.5,2.75,NaN,NaN,2.1361514304855604,0.8019963878997775,214.19624842973582,-0.014616705297543525,0.08065159628011997,0.0952683015776635,20.42622104740695,-0.7024780533022995,76.78930271021233,4.547968393004538,18.662728896783126,2901304093
1219930200,129.28,130.34,128.63,130.19,NaN,NaN,117.68746602409638,128.64326362068965,136.02880005000034,132.92860009999995,127.49740019999999,128.34000050000003,129.05331478561135,128.2385441522888,128.55923153846155,130.76403995670782,126.35442312021527,136.02880005000034,132.92860009999995,127.49740019999999,128.34000050000003,129.72,167537056,207765503.2,55.6510253109311,NaN,1.5,2.75,NaN,NaN,2.1057120425937352,0.8063757140603118,219.09993620998384,0.11447057123917663,0.2383565156266343,0.12388594438745766,21.183635315235925,0.015364523315671993,76.47434721286638,4.664381124769679,18.861271662363947,3068841149
1220016600,129.73,130.14,128.50999,128.78999,NaN,NaN,117.6145743373494,128.42274620689653,135.93235000000035,132.85819999999995,127.3848,128.47150000000005,129.0429883234305,128.29106280445177,128.51615307692308,130.67895963081648,126.35334652302967,135.93235000000035,132.85819999999995,127.3848,128.47150000000005,129.14666,189210000,204790824.8,51.503956247462355,NaN,1.5,2.75,NaN,NaN,2.075304753837041,0.9239183453886846,216.2487904301149,0.09890442680967548,0.247516477899552,0.14861205108987652,21.89954077826353,0.3115429550588072,45.68978406050025,22.377691193356547,31.932524746143198,2879631149
1220362200,130.03,130.71001,127.52,127.99001,NaN,NaN,117.54168265060241,130.71001,135.83395005000037,132.77790009999993,127.3130002,128.62150000000005,129.001695055845,128.2623911087897,128.4715376923077,130.65191724023137,126.29115814438403,135.83395005000037,132.77790009999993,127.3130002,128.62150000000005,128.74000666666666,252469568,208001716,49.24572054546366,NaN,1.5,2.75,NaN,NaN,2.154926557134396,1.2137859862656133,218.2487904301149,0.03155541315930516,0.18805631753900798,0.15650090437970282,20.69674013859829,0.7874635177995497,37.48784801639203,29.34480039674191,33.167351586866054,2627161581
1220448600,127.88,128.5,126.92999,127.88,NaN,NaN,117.46879096385541,130.656678,135.74565010000038,132.72290009999995,127.24160020000001,128.59750000000005,128.9577070144393,128.22597290795258,128.34384615384616,130.4522205544697,126.2354717532226,135.74565010000038,132.72290009999995,127.24160020000001,128.59750000000005,127.76999666666666,251949680,208017984,48.92801558231709,NaN,1.5,2.75,NaN,NaN,2.1131468030533673,1.2111918169536726,219.22544090692128,-0.02075920079860638,0.13055190338144484,0.15131110418005123,19.578635175318137,0.23514657469822633,13.98742876996527,57.62258027869111,28.389990951343616,2375211901
1220535000,126.97,127.23,123.96001,124.03,NaN,NaN,117.39589927710843,130.60334600000002,135.63685015000036,132.63390019999994,127.09840020000001,128.35250050000008,128.76446360210835,127.82635644052853,127.87153846153845,130.74430180724335,124.99877511583355,135.63685015000036,132.63390019999994,127.09840020000001,128.35250050000008,125.07333666666666,340438528,214562141.6,39.35819271644321,NaN,1.5,2.75,NaN,NaN,2.242207031406698,1.5866663403959984,212.97703685536624,-0.2995382358681796,-0.22311169065517333,0.0764265452130063,26.25394112156851,-2.949921752738651,2.3163022638434736,83.75522406621712,13.928473669939402,2034773373
1220621400,123.28999,124.95,122,124.42,NaN,NaN,117.32300759036144,130.550014,135.54015020000034,132.54570009999995,126.95060020000001,128.22300100000007,128.59409248045705,127.50194154143057,127.56615384615385,130.9517994949715,124.18050819733621,135.54015020000034,132.54570009999995,126.95060020000001,128.22300100000007,123.79,289514752,216722257.6,40.625079767561736,NaN,1.5,2.75,NaN,NaN,2.292763672020506,1.335879181059251,213.87970778921468,-0.43437712224999486,-0.4665448575994873,-0.03216773534949241,26.355804071781296,-4.033930122169697,5.586922738166321,74.07037825283733,20.34269900899636,2324288125
1220880600,128.03999,128.24001,124.42,126.99001,NaN,NaN,117.25011590361446,130.49668200000002,135.45190025000036,132.44710009999994,126.92580040000003,128.10400150000007,128.531187285145,127.45318615653242,127.56615384615385,130.9517994949715,124.18050819733621,135.45190025000036,132.44710009999994,126.92580040000003,128.10400150000007,126.55000666666666,364148736,221889112.8,48.29134579424104,NaN,1.5,2.75,NaN,NaN,2.401852695447613,1.6411293524267045,217.55718104184473,-0.33181545615734387,-0.44693705554617225,-0.11512159938882838,27.970541757217006,-0.023610455046447775,25.143526266151312,42.25964444542495,32.59682928842375,2688436861
1220967000,127.10001,127.36,122.8,123.22,NaN,NaN,117.17722421686747,130.44335,135.35960030000035,132.30880009999993,126.83960040000004,127.72950100000007,128.32290543082559,127.050025570196,127.23076923076925,131.33255207422403,123.1289863873145,135.35960030000035,132.30880009999993,126.83960040000004,127.72950100000007,124.45999999999998,377326848,228284164.8,40.10998229171382,NaN,1.5,2.75,NaN,NaN,2.556006074344212,1.6528822677235473,210.68001196253203,-0.4896811654116847,-0.7272230561534343,-0.23754189074174958,30.70134553299128,-3.2734123557579102,21.619133047088088,46.63023983282473,31.75062712008718,2311110013
1221053400,123.89,124.89999,122.55,123.72,NaN,NaN,117.10433253012047,130.39001800000003,135.25755030000036,132.16120009999995,126.75440040000005,127.44800050000006,128.14239933549908,126.73288027779638,126.9169230769231,131.40283290569744,122.43101324814876,135.25755030000036,132.16120009999995,126.75440040000005,127.44800050000006,123.72332999999999,298916608,232569954.4,41.52492658435805,NaN,1.5,2.75,NaN,NaN,2.5412906404624827,1.285276117334957,212.28237508229222,-0.5288839817706867,-0.8986468679551081,-0.3697628861844213,30.788833732770513,-3.817149965015935,43.56032273963121,24.06355710331619,32.376120157052604,2610026621
1221139800,122.12,125.74001,121.60001,125.50999,NaN,NaN,117.03144084337349,130.33668600000001,135.18035025000034,132.03079999999994,126.69700020000003,127.29499950000006,128.03916759685205,126.61641453705387,126.59846153846155,130.8444508797767,122.3524721971464,135.18035025000034,132.03079999999994,126.69700020000003,127.29499950000006,124.28333666666668,375369216,238515056,46.406525538387534,NaN,1.5,2.75,NaN,NaN,2.655484166143734,1.5737757703647857,209.68345492866837,-0.40812653760718565,-0.8799210581934034,-0.47179452058621774,31.594281152764708,-3.594753821338041,73.68362376994193,5.7438711434598755,20.57250508659818,2985395837
1221226200,124.28999,126.21001,123.83,126.09,NaN,NaN,116.9585491566265,130.28335400000003,135.09795020000035,131.91229999999993,126.69520040000005,127.12250000000009,127.96272965187747,126.56627981923921,126.52692307692308,130.7734308013295,122.28041535251666,135.09795020000035,131.91229999999993,126.69520040000005,127.12250000000009,125.37666999999999,297851136,241429809.6,47.92358281848478,NaN,1.5,2.75,NaN,NaN,2.63580743999061,1.2336966031389356,212.2229390479014,-0.2697272997900406,-0.8089536453237685,-0.5392263455337278,30.61942833123231,-2.096428456901026,73.89982880391825,5.655895138397299,20.44427605768445,3283246973
1221485400,121.63,125.65199,119.89,120.09,NaN,NaN,116.88565746987952,130.23002200000002,134.96275020000036,131.73599999999996,126.57080040000004,126.61850000000008,127.65399515572541,125.94949126502596,125.96538461538461,131.37752301481922,120.55324621595001,134.96275020000036,131.73599999999996,126.57080040000004,126.61850000000008,121.87732999999999,483607040,256559892.8,36.43413853503494,NaN,1.5,2.75,NaN,NaN,2.890392622848424,1.8849674230920943,200.56580008120426,-0.5468317472498194,-1.2227660295960021,-0.6759342823461827,40.26547973784988,-6.172364546264193,38.38913998572332,28.52163828125565,33.08922173302103,2799639933
1221571800,117.2,122.32001,117,122.10001,NaN,NaN,116.81276578313252,130.17669000000004,134.83735030000034,131.57379999999995,126.51240060000003,126.3040005000001,127.4361918162852,125.58287400169014,125.46307769230768,131.00334770134063,119.92280768327473,134.83735030000034,131.57379999999995,126.51240060000003,126.3040005000001,120.47334000000002,581744128,277033346.4,41.49446301148788,NaN,1.5,2.75,NaN,NaN,3.0639367212163933,2.0999065114711404,198.9430452219192,-0.5574131164471119,-1.3727006779050726,-0.8152875614579607,42.48817409488706,-4.519854551141694,71.75762225060147,6.5548410052065265,21.687536744192,3381384061
1221658200,119.64,121.8517,116,116.61,NaN,NaN,116.73987409638553,130.12335800000002,134.67710030000035,131.34389989999997,126.29980040000002,125.78500000000011,127.0116352744701,124.72831457295774,124.41846230769228,131.01927196577384,117.81765264961071,134.67710030000035,131.34389989999997,126.29980040000002,125.78500000000011,118.15390000000002,624095488,298504439.2,33.62160423894953,NaN,1.5,2.75,NaN,NaN,3.280799098272365,2.090741061247172,186.4583879712508,-0.8777515884816154,-1.91247704705998,-1.0347254585783645,48.4545496219908,-5.98242360719181,39.17150511288118,27.818421094159795,33.01007379295902,2757288573
1221744600,118.05,121.78999,113.8,120.07001,NaN,NaN,116.66698240963855,130.07002600000004,134.53905040000035,131.14829999999995,126.20540080000002,125.4095005000001,126.73941467547127,124.28466651839034,123.74769461538457,130.20594964783072,117.28943958293841,134.53905040000035,131.14829999999995,126.20540080000002,125.4095005000001,118.55333333333333,776114688,326035267.2,41.194301993281414,NaN,1.5,2.75,NaN,NaN,3.6171698769671963,2.3804623796232067,193.34665886183495,-0.8022771986014958,-2.0375719568302344,-1.2352947582287386,50.90254085002318,-3.4962144349783038,48.23603494960319,20.397343965637052,31.366621084759757,3533403261
1221831000,126.7,128,116.52,124.12,NaN,NaN,116.59409072289156,130.01669400000003,134.42785040000032,130.99869999999999,126.18180080000002,125.2255005000001,126.63669253133514,124.26898399282935,123.45000153846149,129.43829100786965,117.46171206905332,134.42785040000032,130.99869999999999,126.18180080000002,125.2255005000001,122.88000000000001,501146880,342062120.8,48.5878205354763,NaN,1.5,2.75,NaN,NaN,4.178800600040968,1.4650756383897154,205.06843347150902,-0.44319176995697473,-1.789284470674957,-1.3460927007179824,55.021573000631,-2.2600281707198806,52.21095009485433,17.533306147964044,30.255743757181627,4034550141
1222090200,124.4505,124.75,120.36,121.31,NaN,NaN,116.52119903614458,129.96336200000005,134.29035040000034,130.82920009999995,126.13120080000003,124.80850100000009,126.42780262814553,123.98717599351227,122.94461692307686,128.44085558918135,117.44837825697238,134.29035040000034,130.82920009999995,126.13120080000003,124.80850100000009,122.14,249966432,346174680,44.415274297261824,NaN,1.5,2.75,NaN,NaN,4.193886271466613,0.7220817883041013,197.47238186557584,-0.3619467001242067,-1.7985260758732409,-1.4365793757490342,54.68075587116397,-1.5500730400908915,61.71769221484826,11.609811467246153,26.672496317905605,3784583709
1222176600,120.85001,122.02,118.28,118.55,NaN,NaN,116.44830734939758,129.91003000000003,134.12840040000034,130.60350009999993,126.04780080000002,124.3850010000001,126.11886919174766,123.46934970841586,122.5230784615384,128.44572467367053,116.60043224940628,134.12840040000034,130.60350009999993,126.04780080000002,124.3850010000001,119.61666666666667,328230144,353989343.2,40.716704608394885,NaN,1.5,2.75,NaN,NaN,4.161465823504711,0.9272317099516572,191.53460931544032,-0.4550897524094235,-2.0054415662608136,-1.55035181385139,53.60732422991637,-4.178790817976077,38.09301652831128,28.865551859027793,33.04143161266094,3456353565
1222263000,119.35001,120,117.78999,118.92999,NaN,NaN,116.3754156626506,129.85669800000002,133.96850035000034,130.37770009999994,126.00660040000001,123.96200050000012,125.83695236069873,123.03702973618579,122.10076999999994,128.20237495136388,115.999165048636,133.96850035000034,130.37770009999994,126.00660040000001,123.96200050000012,118.90665999999999,311871232,361627045.6,41.43972794046706,NaN,1.5,2.75,NaN,NaN,4.022076121825803,0.8624112488117509,188.42450846937,-0.4512291206546952,-2.1143882146697592,-1.663159094015064,53.56375274498585,-5.242610568290219,68.55050925477542,8.046857226102262,23.402633519122322,3768224797
1222349400,119.39999,121.91,118.4369,120.78999,NaN,NaN,116.30252397590361,129.80336600000004,133.81205030000035,130.17729999999995,125.94320000000002,123.57000000000012,125.6390322681223,122.82302595178714,121.62384538461532,127.05460334191667,116.19308742731397,133.81205030000035,130.17729999999995,125.94320000000002,123.57000000000012,120.37896333333335,328252928,369488054.4,44.97716252991748,NaN,1.5,2.75,NaN,NaN,3.9828635416953886,0.8883992975985099,193.14248041282826,-0.2912916166463393,-2.027273614822988,-1.7359819981766489,53.7116414800214,-4.203354746609564,58.8852190169123,13.265587179161509,27.849193803926173,4096477725
1222435800,118.83,121.5,118.50999,120.85001,NaN,NaN,116.22963228915663,129.75003400000003,133.67675035000033,129.96530009999995,125.85620020000002,123.10300050000012,125.45122747329398,122.63511967066457,121.44153846153839,126.80442301921678,116.07865390385999,133.67675035000033,129.96530009999995,125.85620020000002,123.10300050000012,120.28666666666666,285917440,375407073.6,45.09242431240531,NaN,1.5,2.75,NaN,NaN,3.911945431574289,0.7616197458885601,189.04001911755134,-0.15611894706714136,-1.9311306820105756,-1.7750117349434342,53.52702533567538,0.6328670164043585,51.50517933269185,18.084349889605548,30.41047077770259,4382395165
1222695000,119.17999,121.17999,110.97,111.38,NaN,NaN,116.15674060240963,129.69670200000004,133.48680035000035,129.68390009999993,125.56420020000003,122.23250100000014,124.89941463120402,121.56320351155365,120.4923076923076,127.88880138490792,113.09581399970729,133.48680035000035,129.68390009999993,125.56420020000003,122.23250100000014,114.50999666666667,459562240,388924685.6,33.25537758749192,NaN,1.5,2.75,NaN,NaN,4.361805757890411,1.1816227074684815,174.65831778101492,-0.6513827946874351,-2.589240228302728,-1.937857433615293,65.47436326789827,-8.77969625063913,40.36313814603455,26.768334862776776,32.86852699118867,3922832925
1222781400,113.50999,116.8,110.5321,115.99001,NaN,NaN,116.08384891566264,129.64337000000003,133.32145040000034,129.45220019999994,125.36300040000003,121.63250100000013,124.55002621429406,121.03242317711997,119.76000153846145,126.90516440791843,112.61483866900447,133.32145040000034,129.45220019999994,125.36300040000003,121.63250100000013,114.44070333333332,328510208,392726717.6,41.329505720228155,NaN,1.5,2.75,NaN,NaN,4.497955346612525,0.8364855083136824,181.77085848698755,-0.6157908723701775,-2.707596024078015,-2.0918051517078373,69.98151224067134,-0.5316782437183787,68.33301070964544,8.117012433879577,23.54997685647499,4251343133
1222867800,115.27,116.69,113.95,116.06,NaN,NaN,116.01095722891566,129.59003800000005,133.16590040000037,129.22380029999994,125.13460040000005,121.04150100000012,124.21708400981194,120.55885906501331,118.988463076923,125.35679809645568,112.62012805739032,133.16590040000037,129.22380029999994,125.13460040000005,121.04150100000012,115.56666666666668,333084928,396783480,41.44531937915983,NaN,1.5,2.75,NaN,NaN,4.372387107568772,0.8394626913398713,180.65555474404377,-0.5376645833477545,-2.7638858808925306,-2.226221297544776,64.96460380165519,-3.3397265478698586,68.6157616862562,7.982272942977668,23.401965370766135,4584428061
1222954200,114.95,115.11,111.06,111.85001,NaN,NaN,115.93806554216867,129.53670600000004,132.99980040000034,128.93770029999993,124.80820060000005,120.43250150000013,123.73210071530951,119.72944486834537,118.35461769230763,125.72038559526959,110.98884978934566,132.99980040000034,128.93770029999993,124.80820060000005,120.43250150000013,112.67333666666667,365632512,398043179.2,36.746528600374404,NaN,1.5,2.75,NaN,NaN,4.417216599885289,0.9185749966495093,173.96470712505968,-0.7088869649127836,-3.1123300036857557,-2.403443038772972,64.99140515036467,-9.885586529165328,39.61096302144133,27.428900506337442,32.96013647222122,4218795549
1223040600,112.86,115.45,109.67999,110.34,NaN,NaN,115.86517385542169,129.48337400000005,132.82210040000035,128.63630029999993,124.50480080000007,119.72850150000014,123.2069202951013,118.83521202374105,117.45000153846146,125.60041602156977,109.29958705535316,132.82210040000035,128.63630029999993,124.50480080000007,119.72850150000014,111.82333,461832448,406659064,35.204840770759276,NaN,1.5,2.75,NaN,NaN,4.5138446998934825,1.1356747921890658,169.81259922665433,-0.8534983896017745,-3.4703160257751904,-2.616817636173416,59.73023963244502,-9.042947819635645,15.653785158627374,55.004478443697245,29.341736397675394,3756963101
1223299800,107.14999,107.62,100.64,104.72,NaN,NaN,115.79228216867469,129.43004200000004,132.61630040000034,128.27580029999993,124.08960080000008,118.61500100000012,122.48194302862673,117.4909061167181,116.53538615384608,127.15275425394822,105.91801805374394,132.61630040000034,128.27580029999993,124.08960080000008,118.61500100000012,104.32666666666667,610790912,418991172.8,30.137016397713452,NaN,1.5,2.75,NaN,NaN,4.884284364186805,1.4577655846977786,155.36520248096784,-1.2341944768586184,-4.159560732246689,-2.9253662553880706,63.952391764934006,-11.665963728384646,13.426557173338312,58.56591189089897,28.007530935762727,3146172189
1223386200,106.84,107.33,99.64999,100.03,NaN,NaN,115.7193904819277,129.37671000000006,132.38245040000035,127.85080029999992,123.61740080000007,117.45550100000014,121.60147467456294,115.82796267703065,114.99384692307686,128.5290930743014,101.45860077185232,132.38245040000035,127.85080029999992,123.61740080000007,117.45550100000014,102.33666333333333,540213504,427135505.6,26.68475549498622,NaN,1.5,2.75,NaN,NaN,5.083979052459177,1.264735656290522,145.9865920650622,-1.680743732713506,-5.026295921279953,-3.345552188566447,66.32555754623452,-15.891693928503653,2.6472673120938306,82.58482210683529,14.767910581070891,2605958685
1223472600,97.52,102.17999,96.81,97.50999,NaN,NaN,115.64649879518072,129.32337800000005,132.12935035000032,127.39930019999993,123.04200060000007,116.14500050000015,120.65671056967811,114.08339385064679,112.946923076923,128.27251059106305,97.62133556278295,132.12935035000032,127.39930019999993,123.04200060000007,116.14500050000015,98.83332666666665,725787904,448479070.4,25.025904981439254,NaN,1.5,2.75,NaN,NaN,5.10440840585495,1.6183317169130487,137.2116276776701,-2.002845181724135,-5.849108665721616,-3.8462634839974807,65.1674385395213,-19.273120231237705,0,99.99999999999999,0,1880170781
1223559000,99.66,100.62,90.25,90.7,NaN,NaN,115.57360710843373,129.27004600000006,131.83670035000034,126.87580019999994,122.28540060000006,114.40450100000014,119.48193760616132,111.85640396010899,110.59230769230763,129.1250152446754,92.05960013993986,131.83670035000034,126.87580019999994,122.28540060000006,114.40450100000014,93.85666666666667,534758400,456448529.6,21.191973707357434,NaN,1.5,2.75,NaN,NaN,5.480522091151025,1.171563419140873,127.36488540759248,-2.4992716782763367,-6.970353081842902,-4.471081403566565,67.19693907116576,-24.94828920576837,0,99.99999999999999,0,1345412381
1223645400,86.75999,93.94,83.58,88.5,NaN,NaN,83.58,129.21671400000005,131.53145035000034,126.34190019999994,121.51880060000006,112.52500100000013,118.26695966082167,109.63198453533671,108.28076923076917,129.55937908637904,87.00215937515928,131.53145035000034,126.34190019999994,121.51880060000006,112.52500100000013,88.67333333333333,871546880,485133316.8,20.11962670769266,NaN,1.5,2.75,NaN,NaN,5.8290562274973805,1.7965100516056745,121.30172577239362,-2.779043102406791,-7.944885281575054,-5.165842179168263,64.719165232206,-20.54228766385347,0,99.99999999999999,0,473865501
1223904600,93.87,101.35001,89.94791,101.35001,NaN,NaN,82.99225806451612,129.16338200000007,131.29985040000034,125.96050019999996,121.02260080000008,111.58800150000013,117.6035498702012,108.84322505578083,106.92846307692301,127.55248586509725,86.30444028874876,131.29985040000034,125.96050019999996,121.02260080000008,111.58800150000013,97.54930999999999,456904704,483798200,39.40628488584408,NaN,1.5,2.75,NaN,NaN,6.330552925533282,0.944411748534823,135.54075663829175,-1.9415627640907607,-7.592795634281714,-5.651232870190953,108.09681456706332,-12.621776651282296,2.561354701065746,82.92162743009315,14.517017868841103,930770205
1223991000,104.7,105.53,97.11,99.85001,NaN,NaN,82.40451612903226,129.11005000000006,131.06260045000033,125.56390039999995,120.51980080000007,110.47550150000014,116.9073326203894,107.9867283838017,105.31769538461533,124.58601655977503,86.04937420945564,131.06260045000033,125.56390039999995,120.51980080000007,110.47550150000014,100.83000333333332,546688512,482045419.2,38.245453376191676,NaN,1.5,2.75,NaN,NaN,6.479799145138047,1.1341016639205521,137.65064120935858,-1.3590716687249245,-7.350072456097109,-5.991000787372185,103.30206017122185,-13.966905049112532,2.5512521995231263,82.95727347864177,14.491474321835108,384081693
1224077400,97.46001,97.8,89.71001,90.02,NaN,NaN,81.81677419354838,129.05671800000005,130.78165040000033,125.08770039999996,119.75300080000008,109.14600150000012,115.85292741958982,106.2756113948682,102.9461561538461,121.56189607404659,84.33041623364562,130.78165040000033,125.08770039999996,119.75300080000008,109.14600150000012,92.51000333333332,484627456,475072017.6,31.662807403178192,NaN,1.5,2.75,NaN,NaN,6.741242063342473,1.0201136628679432,126.75158282414885,-1.495442215150537,-7.860303556310356,-6.364861341159819,114.2573605071524,-19.517217745443208,3.1319443519403287,81.00218111210481,15.86587453595487,-100545763
1224163800,91.28999,94.77,86.53999,93.77,NaN,NaN,81.22903225806452,129.00338600000006,130.52585045000035,124.63880039999997,119.0498010000001,107.83100100000013,114.98693026588042,105.08460078583315,101.59154076923072,120.11795521197593,83.06512632648551,130.52585045000035,124.63880039999997,119.0498010000001,107.83100100000013,91.69333,708811264,471706846.4,36.175833339843386,NaN,1.5,2.75,NaN,NaN,6.847582630246582,1.5026520590268033,132.33727884165643,-1.2051796144757567,-7.871335859254515,-6.666156244778758,119.94167951101676,-15.017219503353278,18.849239172399525,50.43715296345346,30.713607864147,608265501
1224250200,91.99001,98.59,91.64999,93.21001,NaN,NaN,80.64129032258064,128.95005400000005,130.26760050000033,124.17790049999998,118.3738014000001,106.28550150000012,114.13293339270864,103.95368737765855,99.83923307692302,116.83251389344281,82.84595226040324,130.26760050000033,124.17790049999998,118.3738014000001,106.28550150000012,94.48333333333333,476770048,470488004.8,35.79566597688236,NaN,1.5,2.75,NaN,NaN,6.854184585228969,1.0133521856793575,134.40433647818406,-0.9350343123729115,-7.834949135244898,-6.899914822871986,120.11414903654433,-10.991205118411003,24.409981798554238,43.231288824009006,32.35872937743675,131495453
1224509400,95.35001,99.10001,94.08949,98.81,NaN,NaN,80.05354838709677,128.89672200000007,130.05510050000032,123.76600049999998,117.76260140000011,105.16050150000012,113.53203404397496,103.46381238931012,98.51230999999994,112.69316703205308,84.3314529679468,130.05510050000032,123.76600049999998,117.76260140000011,105.16050150000012,97.33316666666667,321294080,474054387.2,42.32319948891597,NaN,1.5,2.75,NaN,NaN,6.785314257712614,0.6777578452500397,142.25988721758833,-0.2964129413088745,-7.270430999508079,-6.974018058199205,124.85243486260411,-1.2196341097670687,22.05724663059284,46.06735224174816,31.875401127658993,452789533
1224595800,96.97,98.64,95.22,95.86,NaN,NaN,79.4658064516129,128.84339000000006,129.82845050000034,123.32110039999998,117.06560120000012,104.02600150000012,112.83901310107399,102.7396397808044,97.28230923076916,109.21851243430851,85.34610602722981,129.82845050000034,123.32110039999998,117.06560120000012,104.02600150000012,96.57333333333332,356502016,475467980.8,40.015232679052666,NaN,1.5,2.75,NaN,NaN,6.557077525018856,0.7497918480234285,137.627073497724,-0.005280298743606693,-6.980618431628713,-6.975338132885106,123.34561360989474,-1.692124058263161,26.511652015170952,40.65803778244079,32.83031020238826,96287517
1224682200,93.2,95.86,87.53,90.64,NaN,NaN,78.87806451612903,128.79005800000007,129.58710050000033,122.83850049999997,116.29140100000012,102.61150200000012,111.96846356769854,101.5872931350135,95.76692461538457,105.48290644148713,86.050942789282,129.58710050000033,122.83850049999997,116.29140100000012,102.61150200000012,91.34333333333332,516167936,485682816,36.248425533684234,NaN,1.5,2.75,NaN,NaN,6.683714844660367,1.0627675490993693,129.864986149594,-0.09206257542031704,-7.090416352160503,-6.998353776740186,126.46039604637956,-0.06615214994487571,25.745148930455922,41.54976083343041,32.70509023611366,-419880419
1224768600,90.28999,92.45,85.81,91.69,NaN,NaN,78.29032258064515,128.73672600000006,129.34370050000035,122.37450049999998,115.5538008000001,101.15650250000012,111.1732297022986,100.64469378882174,94.76461692307687,103.18080408268241,86.34842976347133,129.34370050000035,122.37450049999998,115.5538008000001,101.15650250000012,89.98333333333333,634666496,501003494.4,37.5224435054047,NaN,1.5,2.75,NaN,NaN,6.680592355756055,1.2667905575390734,126.231805724677,-0.010818750336491156,-7.0118772146607995,-7.001058464324308,119.65811842287657,3.604519774011297,23.193148657433927,44.6336410633157,32.17321027925038,214786077
1224855000,84.06,89.92,84,87.03999,NaN,NaN,77.70258064516129,128.68339400000008,129.07245050000034,121.86470039999996,114.7038008000001,99.4660015000001,110.2268281453457,99.34900771369585,93.76538538461533,102.5213986145657,85.00937215466496,129.07245050000034,121.86470039999996,114.7038008000001,99.4660015000001,86.98666333333334,545812480,513998246.4,34.25740455247225,NaN,1.5,2.75,NaN,NaN,6.75269290177348,1.061895607276531,119.78124326101843,-0.19225501925251987,-7.241377238389958,-7.0491222191374385,122.80426657897775,-14.119406598973198,22.518137814270236,45.48083959462916,32.00102259110059,-331026403
1225114200,85.97,89.50999,83.7,83.95,NaN,NaN,77.11483870967741,128.63006200000007,128.79145055000035,121.29640039999997,113.77940080000009,98.09450150000009,109.19636429650862,97.88243555048673,92.72230923076918,102.60385176493928,82.84076669659909,128.79145055000035,121.29640039999997,113.77940080000009,98.09450150000009,85.71999666666666,400238592,511032064,32.24921687495555,NaN,1.5,2.75,NaN,NaN,6.685356980218231,0.783196633235131,112.76826827305375,-0.4288278731158863,-7.585157060532296,-7.15632918741641,86.96980493649288,-15.923894248984046,7.975428592493355,68.712470784392,23.31210062311463,-731264995
1225200600,87.34,94.24001,84.53,93.75999,NaN,NaN,76.52709677419355,128.57673000000008,128.55385050000032,120.87110039999997,113.08680060000007,96.98300050000009,108.59101628488084,97.48982168853561,92.95769307692302,102.7809409154568,83.13444523838925,128.55385050000032,120.87110039999997,113.08680060000007,96.98300050000009,90.84333333333335,639939328,526603520,43.56087536479898,NaN,1.5,2.75,NaN,NaN,6.942832195916928,1.2152203768026466,119.44213825534592,0.1366662420269158,-6.985496384882765,-7.122162626909681,114.41645846020158,4.154621195289942,29.101539408398764,37.8486068726834,33.04985371891786,-91325667
1225287000,93.77,97.17,92.10001,93.08,NaN,NaN,75.93935483870968,128.52339800000007,128.32840050000036,120.43570039999997,112.40860040000007,95.83400050000009,107.98274113645414,97.06983867057984,93.31000076923071,102.79104267888079,83.82895885958064,128.32840050000036,120.43570039999997,112.40860040000007,95.83400050000009,94.11667,531381504,536518348.8,43.024649264958825,NaN,1.5,2.75,NaN,NaN,6.809057753351434,0.9904255934368521,123.0192765483599,0.5054787516686101,-6.490314187323918,-6.995792938992528,96.40476814669904,-0.7358430201556977,28.449600033686227,38.56502092037645,32.985379045937336,-622707171
1225373400,95.78,96.53999,92.89999,96.3,NaN,NaN,75.3516129032258,128.4700660000001,128.12500050000034,120.03930039999996,111.78300040000008,95.0565000000001,107.52459442522064,96.99652070195319,92.92153846153839,101.41551124647296,84.42756567660382,128.12500050000034,120.03930039999996,111.78300040000008,95.0565000000001,95.24665999999999,414582016,538965824,46.39003539005952,NaN,1.5,2.75,NaN,NaN,6.582696485254902,0.7692176341036422,129.04934305940765,0.9794174425382538,-5.771521135819711,-6.750938578357965,95.51424942591595,3.3150838627739665,23.430674717682344,44.43649901776827,32.13282626454937,-208125155
1225459800,95.08,98.57001,94.48,96.83,NaN,NaN,74.76387096774194,128.41673400000008,127.94200055000036,119.66820039999995,111.16360040000006,94.3810000000001,107.10519856540807,96.98066158748145,92.68922999999992,100.55444835567287,84.82401164432697,127.94200055000036,119.66820039999995,111.16360040000006,94.3810000000001,96.62666999999999,411500032,536449203.2,46.94552329746908,NaN,1.5,2.75,NaN,NaN,6.404647450593837,0.7670810759813614,134.55475165546332,1.320500731710232,-5.1003126637201746,-6.4208133954304065,95.36117770451771,-2.003845764598729,49.603621399567956,19.458204280584365,30.93817431984766,203374877
1225722600,96.78,97.69,95.95,97.11,NaN,NaN,74.17612903225806,128.3634020000001,127.76725055000036,119.29480039999994,110.51280060000006,94.00050000000009,106.7132299942156,96.99297953153084,93.23461461538453,101.2653639044953,85.20386532627376,127.76725055000036,119.29480039999994,110.51280060000006,94.00050000000009,96.91666666666669,205566752,516187995.2,47.25645517440812,NaN,1.5,2.75,NaN,NaN,6.07145834697999,0.3982400867737189,136.8902484879479,1.5414685750713195,-4.493977676591257,-6.035446251662576,88.86134106382592,1.3039849780930524,71.40807047793416,6.708439722255713,21.883489799810114,408941629
1225809000,99.06,100.86,96.7142,100.41,NaN,NaN,73.5883870967742,100.86,127.61570055000034,118.93740049999995,109.98060060000006,94.0195000000001,106.46604450424636,97.31841005233743,93.74538384615377,102.64499569914462,84.84577199316293,127.61570055000034,118.93740049999995,109.98060060000006,94.0195000000001,99.32806666666666,346977536,506526196.8,50.90814004164722,NaN,1.5,2.75,NaN,NaN,5.933911322195705,0.6850139996549928,143.3730740314148,1.8647829105797191,-3.7044676134379273,-5.569250524017646,88.8882424062821,10.778905560458954,66.83987581855152,8.84682942976405,24.31329475168442,755919165
1225895400,99.2,100.7114,95,96.19,NaN,NaN,73.00064516129032,100.19666644444445,127.42735055000034,118.53700049999996,109.35660060000004,93.9535005000001,106.06306236682492,97.21094242830529,93.97461384615377,102.96035410609089,84.98887358621666,127.42735055000034,118.53700049999996,109.35660060000004,93.9535005000001,97.30046666666665,390404096,489757006.4,46.47672256253496,NaN,1.5,2.75,NaN,NaN,5.918017656324584,0.797138358202771,137.22527324207115,1.7511383234972069,-3.3803276196461383,-5.131465943143345,85.90242132766701,4.90784164030974,73.93842763104041,5.641377917157467,20.42019445180212,365515069
1225981800,94.46001,95.44,90.06,90.86,NaN,NaN,72.41290322580645,99.53333288888889,127.20670050000034,118.08990039999998,108.60120060000003,93.96150050000008,105.4668638426357,96.60609076846669,93.3630753846153,102.02554253090123,84.70060823832937,127.20670050000034,118.08990039999998,108.60120060000003,93.96150050000008,92.12,477982720,486918222.4,41.55640789366309,NaN,1.5,2.75,NaN,NaN,5.933159252301399,0.9816488642467368,129.4548607469183,1.2947449807836886,-3.513034717163734,-4.8077796979474225,92.96675589113093,4.388798757904265,39.00016960546633,27.974528014494275,33.02530238003938,-112467651
1226068200,91.64999,94,90.5,93.86,NaN,NaN,71.82516129032258,98.86999933333333,127.01080055000033,117.68600039999997,107.87460060000004,94.22950050000009,105.01169271155194,96.344558314327,93.20922923076915,101.75915868936026,84.65929977217804,127.01080055000033,117.68600039999997,107.87460060000004,94.22950050000009,92.78666666666668,380518656,462366811.2,45.08061770607937,NaN,1.5,2.75,NaN,NaN,5.759362162851299,0.8229800383215741,133.57209439382564,1.176098405256731,-3.337656691376509,-4.51375509663324,88.51324468153834,11.804645622394277,37.45770997618809,29.375891736934477,33.16639828687744,268051005
1226327400,95.21001,95.53,90.92,92.63,NaN,NaN,71.2374193548387,98.20666577777777,126.79775050000033,117.26810039999997,107.15140080000003,93.79350000000008,104.52613613462835,95.99079085581967,93.36230615384608,101.79318619299237,84.93142611469979,126.79775050000033,117.26810039999997,107.15140080000003,93.79350000000008,93.02666666666666,301903104,454616731.2,43.91146478380149,NaN,1.5,2.75,NaN,NaN,5.677264865504777,0.6640826948957659,129.5404399830241,1.0027353255888496,-3.2603359396471774,-4.263071265236027,85.29696357352633,-1.2051942411683347,20.49588082925408,48.10660421784472,31.397514952901194,-33852099
1226413800,90.75999,92.1377,88.64999,89.77,NaN,NaN,70.64967741935484,97.54333222222222,126.56705050000033,116.85000039999997,106.38700060000002,93.28949950000008,103.9474641293488,95.39833458383684,93.21461384615375,101.82290386954237,84.60632382276513,126.56705050000033,116.85000039999997,106.38700060000002,93.28949950000008,90.18589666666666,418596608,448212136,41.23365977527791,NaN,1.5,2.75,NaN,NaN,5.556032375111578,0.9339251983127917,123.69343220126085,0.6978567516030507,-3.3907503257322134,-4.088607077335264,58.82864221666315,-3.556080790717665,4.621456557995036,76.56910405499474,18.809439387010226,-452448707
1226500200,88.23,90.1516,85.12,85.82001,NaN,NaN,70.06193548387097,96.87999866666667,126.32160055000033,116.39370049999997,105.54580080000004,93.07950000000008,103.23658357525669,94.4861131949,93.12076923076914,102.01801743989725,84.22352102164103,126.32160055000033,116.39370049999997,105.54580080000004,93.07950000000008,87.03053666666668,454330624,446697294.4,37.804706680861464,NaN,1.5,2.75,NaN,NaN,5.5185729197464655,1.017088372138571,114.5321783881318,0.25537788021018404,-3.7693847270725342,-4.024762607282718,63.31568049386139,-10.882647975077882,4.544450720621239,76.77804458625853,18.677504693120238,-906779331
1226586600,86.13,91.73,82.09,91.17,NaN,NaN,69.47419354838709,96.21666511111111,126.09060055000033,115.99350049999995,104.88860080000003,92.94950000000009,102.76338421936427,94.17029289062381,93.67615384615375,100.97137776095057,86.38092993135693,126.09060055000033,115.99350049999995,104.88860080000003,92.94950000000009,88.33,753800960,448946779.2,44.53273859058424,NaN,1.5,2.75,NaN,NaN,5.8129605683360035,1.6790430289827103,120.32310954995113,0.34277022106775323,-3.596299830948027,-3.93907005201578,71.08350415941653,-5.845295879376223,33.56707613413271,33.102196335558794,33.33072753030848,-152978371
1226673000,89.41,92.06,86.52,86.62,NaN,NaN,68.88645161290323,95.55333155555556,125.82580055000031,115.54160049999997,104.13260080000003,92.61999950000008,102.13031032840881,93.45121737723107,93.12692384615376,101.33248913929626,84.92135855301126,125.82580055000031,115.54160049999997,104.13260080000003,92.61999950000008,88.39999999999999,540352256,452125889.6,40.518299757585346,NaN,1.5,2.75,NaN,NaN,5.793463384883432,1.1951367272465965,114.19011384119375,0.1251188452485743,-3.7826714954550624,-3.9077903407036367,75.1978634599704,-10.802183091339714,12.565576916332894,59.982996085002696,27.45142699866442,-693330627
1226932200,86.38,88.56,85.16,85.47,NaN,NaN,68.29870967741935,94.88999799999999,125.56405050000032,115.11400049999996,103.30220060000003,91.95299950000008,101.47696482533395,92.6911014365424,92.54153923076916,101.70666099000769,83.37641747153063,125.56405050000032,115.11400049999996,103.30220060000003,91.95299950000008,86.39666666666666,415543808,456838376,39.54792329903234,NaN,1.5,2.75,NaN,NaN,5.622501714534615,0.909607926633554,109.28761623705148,-0.055623491909663425,-3.977319705590716,-3.9216962136810527,74.66613881413176,-14.878996115924707,11.598977758410923,61.65855118064388,26.7424710609452,-1108874435
1227018600,85.14999,87.22,82.91,87.08,NaN,NaN,67.71096774193549,94.22666444444444,125.32880050000033,114.70950049999996,102.57940060000003,91.51399950000008,100.9123779694385,92.15671082353836,91.83230846153839,101.14997589040264,82.51464103267413,125.32880050000033,114.70950049999996,102.57940060000003,91.51399950000008,85.73666666666666,524140544,465220302.4,41.65464909992182,NaN,1.5,2.75,NaN,NaN,5.528751592067857,1.1266501941038247,106.0533748329016,-0.02749361737945133,-3.9560632354053666,-3.9285696180259153,71.75698742308492,-9.47083896454933,31.47866553691877,35.22332093813647,33.298013524944764,-584733891
1227105000,85.91,86.87,80.92,81.5,NaN,NaN,67.12322580645161,93.56333088888888,125.07105050000033,114.24470049999996,101.73500060000002,91.05699950000007,100.15110824514679,91.14178598320137,90.65307769230762,100.96906349869182,80.33709188592341,125.07105050000033,114.24470049999996,101.73500060000002,91.05699950000007,83.09666666666668,558809344,467352372.8,36.860114319240765,NaN,1.5,2.75,NaN,NaN,5.573840764063009,1.1956916804595712,96.46371694215604,-0.32870764092898774,-4.3394541691871495,-4.010746528258162,76.25615504658128,-10.301562843935725,29.779397030528884,37.018669678464306,33.20193329100682,-1143543235
1227191400,80.13,82.50999,75.05,75.45,NaN,NaN,66.53548387096774,92.89999733333333,124.77865055000034,113.71540049999997,100.73380080000003,90.24499950000008,99.18243733357241,89.64733017527743,88.98692384615379,101.38067430087253,76.59317339143504,124.77865055000034,113.71540049999997,100.73380080000003,90.24499950000008,77.66999666666668,814180352,476328065.6,32.49314092185304,NaN,1.5,2.75,NaN,NaN,5.708565709487081,1.7092848622606964,86.5937287624941,-0.8498030132861958,-5.073000294865906,-4.2231972815797105,80.88363615046723,-19.61431919880673,4.49607077828673,76.90878451437803,18.595144707335244,-1957723587
1227277800,77.46001,80.89999,74.34,79.52,NaN,NaN,74.34,92.23666377777778,124.51090050000033,113.24880059999998,99.80240080000003,89.86900000000007,98.41136135970683,88.68282253953673,87.3800007692307,98.81252884015274,75.94747269830867,124.51090050000033,113.24880059999998,99.80240080000003,89.86900000000007,78.25333,718768640,484975873.6,37.829351777321314,NaN,1.5,2.75,NaN,NaN,5.7693817302380035,1.482070921723476,90.80869702415497,-0.8336274439786884,-5.265231586553071,-4.431604142574383,86.15042709801122,-14.153082154809457,23.29405275788755,44.50754257889204,32.19840466322041,-1238954947
1227537000,81.92,86.985,80.3614,85.03,NaN,NaN,74.03200000000001,91.57333022222221,124.26730050000033,112.83600059999999,99.10120080000003,89.92300000000007,97.88660209069872,88.33493467862847,86.52153923076915,96.79637413792729,76.24670432361101,124.26730050000033,112.83600059999999,99.10120080000003,89.92300000000007,84.12546666666667,523461888,491137038.4,44.25388473782542,NaN,1.5,2.75,NaN,NaN,5.890497320935289,1.0658163548514,101.24421330271062,-0.3877513657077456,-4.916293349709065,-4.528541984001319,98.65326783737919,-5.280160409936499,43.296504017421434,24.30914811700249,32.39434786557609,-715493059
1227623400,87.3,87.50999,83.82001,85.66,NaN,NaN,73.724,90.90999666666666,124.02065045000032,112.44240059999998,98.37240060000002,89.51800050000007,97.4071274989066,88.08017899494956,86.12153923076917,96.08994722341257,76.15313123812578,124.02065045000032,112.44240059999998,98.37240060000002,89.51800050000007,85.66333333333334,454188288,481849486.4,44.954296174812164,NaN,1.5,2.75,NaN,NaN,5.733317512297054,0.9425936953743322,106.21167499613873,-0.006467329532724442,-4.536626145917225,-4.530158816384501,97.88097686443585,-0.18644835860541123,41.65606806377476,25.683395515096016,32.660536421129216,-261304771
1227709800,84.3,89.19,84.24001,88.97,NaN,NaN,73.416,90.2466631111111,123.78365045000034,112.05970049999998,97.81960060000003,89.31250050000008,97.07625975385145,88.16492385257341,85.74538538461533,94.84889822425048,76.64187254498019,123.78365045000034,112.05970049999998,97.81960060000003,89.31250050000008,87.46666999999998,370320384,473796430.4,48.60778736519349,NaN,1.5,2.75,NaN,NaN,5.677365547132979,0.7816023090071808,112.89034635822794,0.4853902061776356,-3.9234210586624556,-4.408811264840091,96.94843750459273,-2.4130744762531564,66.74691924872923,8.906757520583048,24.34632323068773,109015613
1227882600,88.63,90.13,88.48,90.09,NaN,NaN,73.108,89.58332955555555,123.55825045000034,111.71270059999999,97.22000040000003,89.00200050000008,96.80228878311217,88.3482644380426,85.55000076923072,94.14913856859212,76.95086296986932,123.55825045000034,111.71270059999999,97.22000040000003,89.00200050000008,89.56666666666668,119905312,459062595.2,49.8213939937351,NaN,1.5,2.75,NaN,NaN,5.389696579480622,0.2611959964800896,116.92745492922712,0.8799020982292021,-3.3089336420535886,-4.188835740282791,90.3522879726067,4.006003232509811,100,0,0,228920925
1228141800,87.50999,87.55,81.86,82.11,NaN,NaN,72.80000000000001,88.919996,123.29310045000035,111.2808006,96.37980040000002,88.26600050000008,96.22612059553914,87.75414401537188,84.96076999999994,93.37016967660075,76.55137032339913,123.29310045000035,111.2808006,96.37980040000002,88.26600050000008,83.83999999999999,370826752,457028931.2,42.17874626451828,NaN,1.5,2.75,NaN,NaN,5.592575395232006,0.8113857278714001,108.4835221961933,0.609972445844102,-3.4263701829776636,-4.036342628821766,101.23046899469395,-3.9312039312039304,77.75564978004387,4.1991363667789265,18.045213853177206,-141905827
1228228200,83.47,85.49001,82.03799,85.27,NaN,NaN,72.492,88.25666244444444,123.04185045000035,110.8951006,95.65900040000002,87.67400050000008,95.79646880747879,87.51755887105075,84.91846153846149,93.31566930205318,76.52125377486979,123.04185045000035,110.8951006,95.65900040000002,87.67400050000008,84.266,469785344,470239860.8,45.729040458509616,NaN,1.5,2.75,NaN,NaN,5.439678581286863,0.9990334362569205,114.21818553734627,0.6472723885335041,-3.2272521431548853,-3.8745245316883894,103.95705159258287,-2.07854846118512,77.01267403557794,4.466215731516459,18.521110232905613,327879517
1228314600,83.39999,87.83,83.14,87.32001,NaN,NaN,72.184,87.59332888888888,122.79885050000036,110.5411007,95.03440060000003,87.01950100000008,95.4640586581659,87.49874469285544,84.6223084615384,92.36257450195511,76.88204242112168,122.79885050000036,110.5411007,95.03440060000003,87.01950100000008,86.09666999999999,520103680,478896168,47.961359976677954,NaN,1.5,2.75,NaN,NaN,5.3861301111949444,1.0860468609972256,118.12757594165912,0.8028703313940548,-2.870936617445821,-3.673806948839876,104.33542002248636,7.141116564417174,78.08370749122601,4.083587670157116,17.832704838616884,847983197
1228401000,86.06,88.05,83.74001,85.3,NaN,NaN,71.876,86.92999533333332,122.55140055000034,110.1842006,94.36180080000004,86.47500100000006,95.06546812255155,87.28934043639302,84.52076999999994,92.18783338914126,76.85370661085862,122.55140055000034,110.1842006,94.36180080000004,86.47500100000006,85.69667000000001,444341504,481593038.4,45.955464762792246,NaN,1.5,2.75,NaN,NaN,5.309262960395306,0.9226493503233332,113.06451210791029,0.7628893956902352,-2.720195204227082,-3.483084599917317,97.00279283969681,13.055003313452609,46.234729562713646,21.95077005324656,31.8145003840398,403641693
1228487400,83.64999,88.42,82.24001,87.92999,NaN,NaN,71.56800000000001,86.26666177777777,122.31295050000035,109.8239004,93.70460080000002,86.32850050000008,94.78564545107893,87.35035468054606,84.70999999999995,92.58017325193742,76.83982674806248,122.31295050000035,109.8239004,93.70460080000002,86.32850050000008,86.19666666666667,472064256,481297115.2,48.94914254942273,NaN,1.5,2.75,NaN,NaN,5.371457748938498,0.9808167161023532,117.67327991945609,0.8974326321124391,-2.361293809776768,-3.2587264418892072,82.4326470569885,10.575943158953732,55.72176474691925,15.207452283530353,29.070782969550393,875705949
1228746600,90.34,92.38,88.0815,91,NaN,NaN,71.26,85.60332822222222,122.08130050000034,109.4819004,93.10760060000003,86.18550050000007,94.6371887667229,87.69793994906549,85.01153846153842,93.49806999969084,76.525006923386,122.08130050000034,109.4819004,93.10760060000003,86.18550050000007,90.48716666666668,413016832,482922024,52.27260928724949,NaN,1.5,2.75,NaN,NaN,5.305640052585749,0.8552453842941733,123.57204712502156,1.1603468776852637,-1.8082928447826276,-2.9686397224678913,80.05621333202187,7.021051393625778,78.356848710698,3.9847815936290294,17.658369695672988,1288722781
1228833000,90.37,92.13,88.98,89.5,NaN,NaN,70.952,84.93999466666666,121.83700050000034,109.1171004,92.67000060000002,86.02900050000008,94.43573038371416,87.86956471582116,85.62692307692303,94.16572617668221,77.08811997716386,121.83700050000034,109.1171004,92.67000060000002,86.02900050000008,90.20333333333333,370862592,486369998.4,50.54131465556623,NaN,1.5,2.75,NaN,NaN,5.1516657631153375,0.7625112429220923,119.1866004137796,1.1956471585642077,-1.4740807742626316,-2.6697279328268393,73.7529271212371,4.482839131449922,53.43912640411476,16.703802183168367,29.857071412716863,917860189
1228919400,90.32001,91.36,89,90.11,NaN,NaN,70.644,84.27666111111111,121.59645050000034,108.75770040000002,92.1524004,86.04600050000008,94.26609389807831,88.08293950479057,86.75461538461533,93.24620783775408,80.26302293147658,121.59645050000034,108.75770040000002,92.1524004,86.04600050000008,90.1566666666667,396381184,485259227.2,51.248459542599655,NaN,1.5,2.75,NaN,NaN,4.952261065749957,0.8168441974553761,123.95796892258382,1.2183630658600304,-1.1467741005018013,-2.3651371663618317,73.74711374060873,1.2813307856580876,50.67104736066815,18.627183570638753,30.70176906869311,1314241373
1229005800,89.53999,91,87.37,87.94,NaN,NaN,70.33600000000001,83.61332755555554,121.35180050000034,108.36230040000002,91.5900004,86.15200000000007,94.01801178442818,88.06932621862005,87.40230769230764,92.3813226881803,82.42329269643498,121.35180050000034,108.36230040000002,91.5900004,86.15200000000007,88.77,366329600,480859176,48.58711250688665,NaN,1.5,2.75,NaN,NaN,4.857813846767817,0.7618230415135095,117.76395135249761,1.0518105249073626,-1.0503740102276282,-2.102184535134991,72.24636313613975,-2.386502386502393,53.516544369371275,16.65154164527186,29.831913985356874,947911773
1229092200,85.55,89.07001,85.2,88.99001,NaN,NaN,70.028,82.94999399999999,121.12765050000034,107.97050050000001,91.1328004,86.04300050000008,93.82083524386238,88.15701038827528,87.7069238461538,92.55082851348509,82.86301917882251,121.12765050000034,107.97050050000001,91.1328004,86.04300050000008,87.75334,415140864,463926171.2,49.94172464120437,NaN,1.5,2.75,NaN,NaN,4.787256429141544,0.8948425197185772,120.98184487306,0.978455373467326,-0.8791153183008333,-1.8575706917681594,72.20302822484167,8.379015954207768,52.138555422507324,17.59415368953176,30.26729088796092,1363052637
1229351400,89.02,89.14999,86.28999,87.75,NaN,NaN,69.72,82.28666044444444,120.89890050000035,107.59290060000001,90.68100039999999,86.09950050000006,93.58276327351483,88.11824749415382,87.86769307692302,92.56571364261572,83.16967251123032,120.89890050000035,107.59290060000001,90.68100039999999,86.09950050000006,87.72999333333333,256846128,449750864.8,48.3224938959687,NaN,1.5,2.75,NaN,NaN,4.649595255631433,0.5710853454705798,115.76609165490895,0.8189861142794366,-0.8338380489188637,-1.6528241631983003,44.60584750156075,2.9084085844963106,26.874184884029383,40.24488265262881,32.880932463341814,1106206509
1229437800,88.3,92.02,88.17999,91.88,NaN,NaN,69.412,81.62332688888888,120.69335045000034,107.25690060000001,90.42420039999999,86.42000050000007,93.51598824318091,88.47650963756774,88.09153923076916,93.23454568466259,82.94853277687572,120.69335045000034,107.25690060000001,90.42420039999999,86.42000050000007,90.69333,377699840,447858666.4,53.70615825008216,NaN,1.5,2.75,NaN,NaN,4.622481308800616,0.8433460561030243,122.69605487587214,0.9547367005989686,-0.45940328744958947,-1.4141399880485581,46.89197570214313,5.2221592736876685,56.13611497922824,14.92440134492281,28.939483675848948,1483906349
1229524200,90.84,92.42999,90.06,90.99001,NaN,NaN,69.10400000000001,80.95999333333333,120.47915050000034,106.9304007,90.2434006,86.61550100000008,93.4169302728601,88.71589062446606,88.16077076923071,93.4321493154653,82.88939222299612,120.47915050000034,106.9304007,90.2434006,86.61550100000008,91.16000000000001,288101888,436056733.6,52.43837385154962,NaN,1.5,2.75,NaN,NaN,4.4615890724577145,0.6606981748028211,125.4194106489335,0.9458690244195829,-0.23180370752407953,-1.1776727319436624,46.57282424306857,6.6705861664712796,29.002927411906136,37.86433999109838,33.1327325969955,1195804461
1229610600,91.39999,91.67,88.21001,89.28999,NaN,NaN,68.796,80.29665977777776,120.27030045000033,106.5605006,90.07900060000001,87.00500050000008,93.25508947784598,88.77056675546929,88.71307769230764,92.67469757320113,84.75145781141414,120.27030045000033,106.5605006,90.07900060000001,87.00500050000008,89.72333333333334,374829312,426857732,50.00991355862516,NaN,1.5,2.75,NaN,NaN,4.390046281567878,0.8781129727784807,122.58117958794577,0.7929722322071399,-0.18645744168473755,-0.9794296738918774,45.656343203584264,1.546685038858755,28.51969388317361,38.39522624324928,33.0850798735771,820975149
1229697000,89.10001,90.62,88.09,88.19,NaN,NaN,68.488,79.63332622222221,120.06270040000034,106.15710059999999,90.02880060000001,87.64200050000008,93.05645851793045,88.71527468351984,88.93769307692303,92.39155840840685,85.4838277454392,120.06270040000034,106.15710059999999,90.02880060000001,87.64200050000008,88.96666666666665,301523456,401224887.2,48.44653587019133,NaN,1.5,2.75,NaN,NaN,4.257185832884458,0.7515073606331367,125.86112844671308,0.5943010515721243,-0.23655335942672195,-0.8308544109988463,43.35865337231695,-3.0879120879120903,7.032406960489901,70.67741806874544,22.290174970764657,519451693
1229956200,88.58,88.67,85.49001,87.06,NaN,NaN,68.18,78.96999266666666,119.85800040000035,105.75940059999999,90.00000060000002,88.01900050000008,92.82130328193318,88.55762947556556,88.91769230769226,92.41157645749868,85.42380815788584,119.85800040000035,105.75940059999999,90.00000060000002,88.01900050000008,87.07333666666666,244192192,377496064.8,46.827043398586575,NaN,1.5,2.75,NaN,NaN,4.180243273392711,0.646873477023859,121.6248059175106,0.37408434224608433,-0.3632489831912409,-0.7373333254373252,37.94207874600414,-2.726256983240221,7.9268972489292935,68.80823382025318,23.26486893081752,275259501
1230042600,87.53,87.92999,85.8,86.16,NaN,NaN,67.87200000000001,78.3066591111111,119.62580035000036,105.35940059999999,89.69620040000001,88.07550050000008,92.56007570224953,88.32928381122599,88.98384615384612,92.22463252057,85.74305978712223,119.62580035000036,105.35940059999999,89.69620040000001,88.07550050000008,86.62999666666668,221772560,362411598.4,45.52182081618487,NaN,1.5,2.75,NaN,NaN,4.033796611007518,0.6119356029969708,118.75841162917268,0.16573288552911447,-0.5301672185259321,-0.6959001040550465,37.375047350909604,-4.383531239596053,0,100,0,53486941
1230129000,86.45,86.87,86,86.66,NaN,NaN,67.56400000000001,77.64332555555555,119.40230035000035,104.97610049999999,89.43240020000002,88.12550050000007,92.32870018451426,88.17030440063304,88.88615461538458,92.31899796567093,85.45331126509824,119.40230035000035,104.97610049999999,89.43240020000002,88.12550050000007,86.50999999999999,62142416,342809304.8,46.41541410495334,NaN,1.5,2.75,NaN,NaN,3.807811138792696,0.18127400607242794,121.12911894230878,0.06470745749922258,-0.6150157821810183,-0.6797232396802408,37.27525072424227,-1.4555378667273153,0.3002497807408947,94.39642912137039,5.303321097888721,115629357
1230301800,87.24001,87.3,86.5,87.16,NaN,NaN,67.256,76.97999199999998,119.17985040000035,104.56410049999998,89.3752002,88.03500050000008,92.12600605963135,88.0740849339061,88.59076999999996,91.90397594418012,85.27756405581981,119.17985040000035,104.56410049999998,89.3752002,88.03500050000008,86.98666666666668,74775808,328032076,47.345530373404245,NaN,1.5,2.75,NaN,NaN,3.592967486021789,0.22795273228097365,125.904427458894,0.03610034348902058,-0.6345978103189651,-0.6706981538079857,35.17625376134235,-2.0564218388108975,2.862265090478409,81.88698632852913,15.250748580992449,190405165
1230561000,87.24001,87.33,85.60001,86.91,NaN,NaN,66.94800000000001,76.31665844444443,118.96635040000034,104.14390059999998,89.23800019999999,87.87600050000009,91.9214568023909,87.96321970210552,88.39153923076921,91.77287329614629,85.01020516539214,118.96635040000034,104.14390059999998,89.23800019999999,87.87600050000009,86.61333666666667,128419184,328457769.6,46.907110001734466,NaN,1.5,2.75,NaN,NaN,3.459897665591661,0.39097624073983844,121.79589974205918,0.006437730069475123,-0.6626509912211418,-0.6690887212906169,34.22628733955861,-0.9572649572649612,4.622127996749509,76.66046068679037,18.71741131646012,61985981
1230647400,87.50999,89.05,86.8766,88.97,NaN,NaN,66.64000000000001,75.65332488888887,118.76970040000035,103.76350069999997,89.1532,88.21900050000009,91.80571339837557,88.05910354000024,88.3038469230769,91.5591458182905,85.0485480278633,118.76970040000035,103.76350069999997,89.1532,88.21900050000009,88.29886666666668,168555680,318344216,50.938582717509995,NaN,1.5,2.75,NaN,NaN,3.3680049751922567,0.5294761818446232,127.79763560206946,0.12507264380894578,-0.5127479165294346,-0.6378205603383804,36.23994114324928,-3.1671745755333007,31.514033831199594,35.3143467134637,33.1716194553367,230541661
1230733800,89.08,90.97,88.87,90.24001,NaN,NaN,66.33200000000001,74.98999133333332,118.55275045000035,103.37220079999996,88.9818002,88.4675010000001,91.74431326510594,88.26680891714307,88.48077076923074,91.88436939319763,85.07717214526386,118.55275045000035,103.37220079999996,88.9818002,88.4675010000001,90.02667000000002,194141808,304562039.2,53.29326064318587,NaN,1.5,2.75,NaN,NaN,3.277433191249952,0.6374458501458576,134.89731203169677,0.27973815426388227,-0.2881478675085276,-0.5678860217724099,24.692565484687726,-0.8242663123127473,77.464564353937,4.328196265184758,18.20723938087822,424683469
1230906600,90.44,93.44,89.85001,92.96001,NaN,NaN,66.024,74.32665777777777,118.36595045000034,102.99470079999996,88.9238004,88.7495010000001,91.7919876468665,88.71378044884372,88.78615538461537,92.94609082223195,84.62621994699879,118.36595045000034,102.99470079999996,88.9238004,88.7495010000001,92.08334,227638496,289938780,57.94828137171085,NaN,1.5,2.75,NaN,NaN,3.2997586775892414,0.7851260738560051,142.288184781244,0.5407765176009212,0.10808462522874152,-0.4326918923721796,29.868406205317363,4.11022556951792,83.06589129777612,2.5272046962440786,14.406904005979804,652321965
1231165800,92.63,94.5533,91.89,92.85001,NaN,NaN,65.71600000000001,94.5533,118.16980050000033,102.62970079999995,88.9680006,89.1270015000001,91.8334787195384,89.10770707276336,89.17846384615383,93.80886417852966,84.548063513778,118.16980050000033,102.62970079999995,88.9680006,89.1270015000001,93.09777000000001,240697632,279756586.4,57.69783769464453,NaN,1.5,2.75,NaN,NaN,3.2542973434757236,0.8603823598842713,146.84065663728003,0.6729667343128338,0.40851652551886275,-0.2644502087939711,26.90268692576014,5.284057149336659,50.06217331027266,19.056884379874006,30.880942309853346,411624333
1231252200,93.64,94.45,92.67999,93.47,NaN,NaN,65.40800000000002,94.39947804878048,117.96355050000032,102.27870069999996,89.00360060000001,89.4040020000001,91.89765602465455,89.523163542024,89.30077153846153,94.28093184673001,84.32061123019305,117.96355050000032,102.27870069999996,89.00360060000001,89.4040020000001,93.53333000000002,328481792,272577463.2,58.779179094847535,NaN,1.5,2.75,NaN,NaN,3.1482768189417434,1.2050951980537767,152.17378964633838,0.7625202284251007,0.6887000767374047,-0.0738201516876959,24.823727024315794,7.3627383413737615,75.17536523210758,5.150864732008871,19.673770035883543,740106125
1231338600,92,92.25999,90.2,90.67,NaN,NaN,65.10000000000001,94.24565609756097,117.74265045000033,101.89000079999997,89.07620080000001,89.38750200000011,91.84951265113868,89.63238606183123,89.2761553846154,94.22574345906,84.32656731017079,117.74265045000033,101.89000079999997,89.07620080000001,89.38750200000011,91.04333000000001,281047552,265978999.2,52.27952923309338,NaN,1.5,2.75,NaN,NaN,3.156971331874476,1.0566531675257165,146.77134199013975,0.6006615987586522,0.6770068467606194,0.07634524800196718,30.92412921579969,5.234447539461473,46.612490377177586,21.636632278709516,31.750877344112883,459058573
1231425000,90.16,91.09,89.67,91.04201,NaN,NaN,64.792,94.09183414634145,117.53186050000033,101.49872089999995,89.21804100000001,89.46460250000011,91.81784588050579,89.76663596070445,89.41092615384618,94.44929591123883,84.37255639645352,117.53186050000033,101.49872089999995,89.21804100000001,89.46460250000011,90.60067,263834368,260627588,53.02277942425943,NaN,1.5,2.75,NaN,NaN,3.0329019510262993,1.012304069667406,150.42282570684085,0.49076885591711356,0.6898063178983591,0.19903746198124556,29.536137785972805,5.05655435033465,49.72962839907251,19.298037917566177,30.972333683361306,722892941
1231511400,91.16,91.32001,85.36,89.09,NaN,NaN,64.48400000000001,93.93801219512194,117.31341050000033,101.10572089999997,89.12464120000003,89.41360250000011,91.71087153225066,89.70219444063736,89.48015692307693,94.47405557336711,84.48625827278676,117.31341050000033,101.10572089999997,89.12464120000003,89.41360250000011,88.59000333333331,331160832,257366570.4,48.73362997452947,NaN,1.5,2.75,NaN,NaN,3.2419810973815637,1.2867282315854336,145.18692710714075,0.26977599479928593,0.536257455480353,0.26648146068106704,33.385403571585485,2.2143184947223578,23.004207375147022,44.87340086663382,32.12239175821915,391732109
1231770600,88.84,88.91,86.41,86.95,NaN,NaN,64.17600000000002,93.78419024390243,117.09061055000035,100.70532079999997,89.00204120000002,89.36410250000012,91.52417068784868,89.44008068438617,89.4716953846154,94.48231275404828,84.46107801518252,117.09061055000035,100.70532079999997,89.00204120000002,89.36410250000012,87.42333333333333,278008320,252950506.4,44.485091137298255,NaN,1.5,2.75,NaN,NaN,3.201839590425738,1.0990621207153275,139.68601809135072,-0.02187941381726244,0.239132193409489,0.26101160722675143,36.68761595773032,0.046024623173404965,21.81099708492629,46.38489937172247,31.804103543351236,113723789
1231857000,86.73,87.88,86.2,87.11,NaN,NaN,63.86800000000001,93.63036829268292,116.86631055000035,100.30062079999998,88.81824120000002,89.27010200000011,91.35106595499187,89.21816823825415,89.54477230769231,94.38487041752587,84.70467419785875,116.86631055000035,100.30062079999998,88.81824120000002,89.27010200000011,87.06333333333333,356731648,250030045.6,44.8720577587563,NaN,1.5,2.75,NaN,NaN,3.0931367625381845,1.4267551211453284,141.3827172039773,-0.1957051853971187,0.016380125480353058,0.21208531087747176,36.66364482347822,-2.0905923344947728,21.995391783152417,46.14800828771261,31.856599929134973,470455437
1231943400,85.53999,85.75,83.16,84.37,NaN,NaN,63.56000000000001,93.4765463414634,116.60511055000033,99.8663208,88.56904120000002,89.10110200000011,91.07729866263925,88.756437929849,89.36861846153846,94.75204749253236,83.98518943054457,116.60511055000033,99.8663208,88.56904120000002,89.10110200000011,84.42666666666665,435967232,258986100.8,39.760732535046714,NaN,1.5,2.75,NaN,NaN,3.154341279499743,1.683361503390764,132.99686121635378,-0.47119056240870977,-0.37690289213341543,0.09428767027529432,37.60404794656761,-6.504886247242208,18.535963076752218,50.7855059910533,30.678530932194466,34488205
1232029800,84.12,85.25,81.72,84.39999,NaN,NaN,63.25200000000001,93.32272439024389,116.34361050000034,99.4138208,88.31484100000002,88.72710150000009,90.81544342096713,88.34153812700623,89.15631,95.06360799567108,83.24901200432893,116.34361050000034,99.4138208,88.31484100000002,88.72710150000009,83.78999666666667,533808896,266791553.6,39.84150532350669,NaN,1.5,2.75,NaN,NaN,3.1811740452497617,2.00084631165025,135.31863316897963,-0.6181045827480502,-0.6783430581597685,-0.06023847541171824,35.78077970453788,-9.208282141966201,27.526908417925178,39.501355878986395,32.97173570308841,568297101
1232116200,85.86,85.98759,83.05,85.06,NaN,NaN,62.94400000000001,93.16890243902438,116.08371055000035,98.99422079999998,88.00784100000003,88.4306010000001,90.58973975739978,88.02901068633898,89.01400230769231,95.21283914649108,82.81516546889354,116.08371055000035,98.99422079999998,88.00784100000003,88.4306010000001,84.69919666666667,399307008,272351809.6,41.694415144984454,NaN,1.5,2.75,NaN,NaN,3.163775184874779,1.4661441338923271,138.74895724808226,-0.6351159019240447,-0.854133352816774,-0.2190174508927294,29.25768555084676,-8.38988601078233,53.48474604477051,16.66403235047528,29.85122160475421,967604109
1232461800,84.23,85.05901,80.05,80.57001,NaN,NaN,62.63600000000001,93.01508048780487,115.80211060000035,98.52602089999999,87.69544120000005,87.99460200000009,90.19680917867822,87.31862966859241,88.36784923076922,96.02903049147059,80.70666797006785,115.80211060000035,98.52602089999999,87.69544120000005,87.99460200000009,81.89300666666666,420108544,274615771.2,34.018184772501456,NaN,1.5,2.75,NaN,NaN,3.2956483859551517,1.5298048694153077,131.54280907942993,-0.8970283742330416,-1.3403029186840314,-0.4432745444509898,38.50087753669716,-13.801208944046222,48.998717690224254,19.83188051050177,31.169401799273967,547495565
1232548200,81.94,84.24001,80.47,84.05,NaN,NaN,62.32800000000001,92.86125853658535,115.53756055000035,98.08022089999999,87.55924120000005,87.78760200000008,89.9557578383379,87.00733160491694,87.8916946153846,95.79390372634455,79.98948550442464,115.53756055000035,98.08022089999999,87.55924120000005,87.78760200000008,82.92000333333334,364767232,277777960,42.806999345942074,NaN,1.5,2.75,NaN,NaN,3.3295313583869266,1.31316117376627,137.03185541095507,-0.7880402468252072,-1.4283248529824988,-0.6402846061572915,49.41082003985563,-7.301202161685237,48.86722260197949,19.92905753728379,31.20371986073673,912262797
1232634600,82.42,84.03999,81.17,82.75,NaN,NaN,62.02000000000001,92.70743658536584,115.26721050000035,97.60582089999998,87.33704120000006,87.57210200000009,89.67317909957956,86.60187145206771,87.10630923076921,94.86569786167212,79.34692059986631,115.26721050000035,97.60582089999998,87.33704120000006,87.57210200000009,82.65333,427940352,286965368,40.629787763734015,NaN,1.5,2.75,NaN,NaN,3.2974219756450034,1.491261314849672,132.16864724650296,-0.7555438385317326,-1.5847144043219572,-0.8291705657902246,47.95244771792968,-9.107894256728299,49.546682729710845,19.429617915913482,31.023699354375676,484322445
1232721000,80.89999,83.99001,80.57001,83.11,NaN,NaN,61.71200000000001,92.55361463414633,115.00361050000033,97.14902099999999,87.14664120000005,87.41960200000008,89.41579952704703,86.2693122661565,86.35707769230766,93.61833907927577,79.09581630533954,115.00361050000033,97.14902099999999,87.14664120000005,87.41960200000008,82.55667333333334,386800640,295216772,41.51686277075508,NaN,1.5,2.75,NaN,NaN,3.3061775488132175,1.3102258295812543,134.03621381239793,-0.6650351141326469,-1.6604644584560333,-0.9954293443233864,47.97748259014747,-6.712313390952974,45.179616778770935,22.758143852857565,32.06223936837149,871123085
1232980200,83.59,85.36,82.81,83.67999,NaN,NaN,61.40400000000001,92.39979268292682,114.74191045000035,96.7059208,87.02484100000004,87.27060150000008,89.19086582010401,86.02271014557017,85.60399999999997,91.69459114576,79.51340885423994,114.74191045000035,96.7059208,87.02484100000004,87.27060150000008,83.94999666666668,318269440,308023123.2,42.96979740153132,NaN,1.5,2.75,NaN,NaN,3.2521648667551304,1.0332647649746316,137.8259458564239,-0.5279931900025283,-1.6554208318265466,-1.1274276418240183,48.03613850289928,-3.7607935595169626,44.5095404315571,23.41626648460634,32.07419308383657,1189392525
1233066600,84.13,85.14999,83.3,84.53,NaN,NaN,61.09600000000001,92.2459707317073,114.49766045000032,96.27242080000002,86.99904080000002,87.13910150000007,89.00808676833522,85.88054727456348,85.13169230769228,90.48530725921734,79.77807735616722,114.49766045000032,96.27242080000002,86.99904080000002,87.13910150000007,84.32666333333334,274112000,317989932.8,45.15791594105551,NaN,1.5,2.75,NaN,NaN,3.152009519129764,0.8620147109260938,141.93112051974745,-0.3498954963885428,-1.5647970123096968,-1.214901515921154,47.36187971630156,-2.9617724715876457,72.49594594154865,6.289475045485045,21.21457901296631,1463504525
1233153000,86.39999,87.95,86.07001,87.39,NaN,NaN,60.78800000000001,92.09214878048779,114.26996050000032,95.90602080000001,86.92344080000002,87.16310150000007,88.94463238526325,86.024304676986,84.85076846153844,89.22872158788566,80.47281533519121,114.26996050000032,95.90602080000001,86.92344080000002,87.16310150000007,87.13667,330317312,328084839.2,51.85172534252682,NaN,1.5,2.75,NaN,NaN,3.171151696334781,1.0068045594713966,147.85172618374597,-0.02633066852651078,-1.2478148515792924,-1.2214841830527816,51.71790013217132,3.579471376081541,72.10069554215644,6.459152583794181,21.44015187404938,1793821837
1233239400,86.11,87.4901,84.47,84.55,NaN,NaN,60.48000000000001,91.93832682926828,114.02651045000032,95.5073208,86.88204080000003,86.94210150000006,88.77229386035096,85.88389470774925,84.50153769230768,88.13153701682846,80.8715383677869,114.02651045000032,95.5073208,86.88204080000003,86.94210150000006,85.50336666666668,294591488,334386629.6,45.865140879970504,NaN,1.5,2.75,NaN,NaN,3.160362289453725,0.8809906315703957,142.1277733219872,0.007747667132481428,-1.21179959913718,-1.2195472662696614,51.96658111886612,0.17773698788352302,79.77812378861219,3.5357783809579972,16.686097830429798,1499230349
1233325800,84.98,85.39999,82.21001,82.83,NaN,NaN,60.17200000000001,91.78450487804876,113.75641040000033,95.0657207,86.82924080000002,86.57160100000007,88.53926272857248,85.59304759272551,84.18461461538459,87.61830545625823,80.75092377451095,113.75641040000033,95.0657207,86.82924080000002,86.57160100000007,83.48,383464192,343852748.8,42.65323597997586,NaN,1.5,2.75,NaN,NaN,3.162477840207031,1.1151988557260009,137.87205821038597,-0.06994683992790796,-1.3069808161795464,-1.2370339762516385,53.31001868920966,-2.6216788149541546,47.04633313469248,21.417134843798653,31.53653202150887,1115766157
1233585000,81.57001,83.17999,81.31,82.58,NaN,NaN,59.86400000000001,91.63068292682925,113.48406040000035,94.65932070000001,86.73924080000002,86.05260050000007,88.3055661509814,85.30609067913261,83.83615307692305,86.91244626170564,80.75985989214047,113.48406040000035,94.65932070000001,86.73924080000002,86.05260050000007,82.35666333333334,288488960,346895272,42.19075540896734,NaN,1.5,2.75,NaN,NaN,3.070157280192243,0.8316312826540916,136.04118064046045,-0.11965413615185949,-1.3866016464414628,-1.2669475102896033,52.95335531344903,2.4947123625775918,20.091461966549517,48.64696941660447,31.261568616845995,827277197
1233671400,83.10001,84.36,82.22,83.74001,NaN,NaN,59.55600000000001,91.47686097560974,113.21036045000035,94.2595208,86.78404100000003,85.59710050000005,88.12652473329587,85.15694013826284,83.7876923076923,86.84863009108554,80.72675452429905,113.21036045000035,94.2595208,86.78404100000003,85.59710050000005,83.44000333333332,278480640,348784422.4,45.16194235754508,NaN,1.5,2.75,NaN,NaN,3.0037174744642257,0.798431988687348,138.81796408822686,-0.05895759208106677,-1.3406445003909369,-1.28168690830987,42.1810401991761,-0.3688161808447342,20.165539533414883,48.547386347217824,31.287074119367276,1105757837
1233757800,84.3,85.37,83.03999,83.33,NaN,NaN,59.24800000000001,91.32303902439023,112.93426045000037,93.83772090000001,86.94164100000003,85.09010050000005,87.93842572414701,84.98294583938066,83.70538538461537,86.75355565896967,80.65721511026106,112.93426045000037,93.83772090000001,86.94164100000003,85.09010050000005,83.91332999999999,322993920,348510028.8,44.29536298215594,NaN,1.5,2.75,NaN,NaN,2.9555955120024953,0.9267851519571536,136.48571325707812,-0.03230450519656247,-1.3220675398055732,-1.2897630346090108,34.45358094849998,0.7009063444108741,3.690037987169856,79.21400186594883,17.09596014688132,782763917
1233844200,82.7,85.28999,77.73,84.57001,NaN,NaN,58.94000000000001,91.16921707317073,112.66741050000037,93.422521,87.04264120000003,84.78510100000004,87.80633098986674,84.9436186165825,83.66769384615382,86.65952827504285,80.6758594172648,112.66741050000037,93.422521,87.04264120000003,84.78510100000004,82.53000000000002,417679872,355341644.8,47.571901409173165,NaN,1.5,2.75,NaN,NaN,3.2844808325737453,1.1754318079860477,139.7584073026298,0.07698765355260173,-1.1935284676682585,-1.2705161212208602,34.10900809893563,1.7567200096257936,22.63523953325551,45.33321416432981,32.03154630241468,1200443789
1233930600,84.86,87.34,84.67999,86.979,NaN,NaN,58.63200000000001,91.01539512195122,112.41370550000036,93.091411,87.08162120000004,84.58195050000003,87.77388663732295,85.13746446262226,84.16069307692307,87.05899306436423,81.2623930894819,112.41370550000036,93.091411,87.08162120000004,84.58195050000003,86.33299666666666,366101504,360455001.6,53.31676067415653,NaN,1.5,2.75,NaN,NaN,3.247731487389907,1.0156649300881833,145.15439346520162,0.3067732082174264,-0.8870496109490773,-1.1938228191665037,37.23161760630369,3.9424120390071695,53.129160247581765,16.90409607572337,29.966743676694875,1566545293
1234189800,86.96001,87.74001,86.32001,87.10001,NaN,NaN,58.32400000000001,90.8615731707317,112.15760550000036,92.74141099999999,87.11042140000005,84.48245100000005,87.74746010252596,85.32437356142015,84.39530923076921,87.68689353752269,81.10372492401574,112.15760550000036,92.74141099999999,87.11042140000005,84.48245100000005,87.05334333333333,240075120,355900716,53.59185425093781,NaN,1.5,2.75,NaN,NaN,3.1171792382906283,0.6745564400606601,146.8045121173794,0.4533232139621455,-0.6271688017138217,-1.0804920156759672,37.240443356102865,3.040352537560625,78.7753442379458,3.894310082117895,17.330345679936308,1806620413
1234276200,86.27,87.03,82.45,83.11,NaN,NaN,58.01600000000001,90.70775121951219,111.87515545000036,92.40641099999999,86.99322140000004,84.29045100000005,87.56559892203475,85.1134808412849,84.42300153846152,87.66442675589063,81.18157632103241,111.87515545000036,92.40641099999999,86.99322140000004,84.29045100000005,84.19666666666667,536212736,368810936.8,44.31841038454038,NaN,1.5,2.75,NaN,NaN,3.2266671498412975,1.4538959735100783,140.38148174621222,0.2766314891105668,-0.7347026542877586,-1.0113341433983254,46.90673417686093,-4.89758553610253,43.54080787569399,24.284712535960047,32.17447958834596,1270407677
1234362600,83.45,84.05,82.39999,83.60001,NaN,NaN,57.70800000000001,90.55392926829268,111.59500550000035,92.04171099999999,86.86342160000004,84.11495150000005,87.41008563097456,84.96934076116253,84.46069461538461,87.65116570325971,81.27022352750951,111.59500550000035,92.04171099999999,86.86342160000004,84.11495150000005,83.35000000000001,324674560,367208082.4,45.56419385704611,NaN,1.5,2.75,NaN,NaN,3.11404878199549,0.8841705168306503,142.38148174621222,0.19187449307606497,-0.7714910270532442,-0.9633655201293092,41.802611225764494,-1.1235836782968653,67.61971882060377,8.566343128566821,23.813938050829424,1595082237
1234449000,82.17,83.82001,81.05,83.66,NaN,NaN,57.40000000000001,90.40010731707316,111.31790550000034,91.63711099999999,86.89442160000004,84.07945150000005,87.26302344936772,84.84464164105181,84.45915692307692,87.65115052054915,81.26716332560468,111.31790550000034,91.63711099999999,86.89442160000004,84.07945150000005,82.84333666666666,469302272,368874834.4,45.72429521426894,NaN,1.5,2.75,NaN,NaN,3.0894745832815262,1.2722534264592815,140.8861707229867,0.14130331320206524,-0.7867363786267276,-0.9280396918287929,37.64192299909625,1.0020523964747052,68.54096633075683,8.118521311553959,23.340512357689203,2064384509
1234535400,83.55,84.24001,82.74001,82.75999,NaN,NaN,57.09200000000001,90.24628536585365,111.04040550000035,91.2516109,86.84422140000002,83.99745150000005,87.0864339023337,84.64610338952306,84.3230023076923,87.63985111900695,81.00615349637766,111.04040550000035,91.2516109,86.84422140000002,83.99745150000005,83.24667,293998336,356884306.4,43.65010398392366,NaN,1.5,2.75,NaN,NaN,2.975940684475703,0.8237917182900257,137.9855960672791,0.05322314932358796,-0.861510755174308,-0.9147339044978959,36.18695112122262,0.2179583434245624,44.52983759343901,23.477591873766805,31.992570532794183,1770386173
1234881000,80.16,82.95799,79.17,79.22,NaN,NaN,56.78400000000001,90.09246341463414,110.73090550000035,90.85831089999999,86.68222120000001,83.70545150000007,86.77794629832061,84.12933163813992,83.69454076923077,87.50765403628922,79.88142750217231,110.73090550000035,90.85831089999999,86.68222120000001,83.70545150000007,80.44933,478910720,360864492,36.6145967652569,NaN,1.5,2.75,NaN,NaN,3.0339442070131524,1.3271206522585768,129.94231039260333,-0.22234827377163613,-1.1926692467124411,-0.970320972940805,44.053970915410495,-5.397670719169963,19.98781481125548,48.81541889097792,31.196766297766597,1291475453
1234967400,79.78999,79.94,78.28,79.03,NaN,NaN,56.47600000000001,89.93864146341463,110.41850555000036,90.459311,86.55682120000002,83.62845100000007,86.47410526701393,83.64368100593612,83.26992538461538,87.77416986931546,78.7656808999153,110.41850555000036,90.459311,86.55682120000002,83.62845100000007,79.08333333333333,362970112,358007570.4,36.276630524339936,NaN,1.5,2.75,NaN,NaN,2.9358053350836415,1.0138615549231413,125.34982641430693,-0.38669436417090375,-1.4536889281544347,-1.066994563983531,42.573408602674,-5.160206408256327,24.396053454144557,43.186315476125905,32.417631069729545,928505341
1235053800,79.84,80.14999,78.02,78.181,NaN,NaN,56.16800000000001,89.78481951219511,110.10526055000035,90.0332211,86.36184140000002,83.33500100000006,86.14888545262123,83.12342567203744,82.91231,88.17400855673758,77.65061144326243,110.10526055000035,90.0332211,86.36184140000002,83.33500100000006,78.78366333333332,316869632,355612690.4,34.733827500584354,NaN,1.5,2.75,NaN,NaN,2.878247096863382,0.8910526551894955,121.4623465108219,-0.5138857629810079,-1.7093517677097907,-1.1954660047287828,42.66278553798398,-7.55469935500776,8.293582079669282,67.99032966314756,23.716088257183145,611635709
1235140200,76.73,78.34,75.77,77.42,NaN,NaN,55.860000000000014,89.6309975609756,109.78211055000034,89.598921,86.09024140000001,83.06850100000007,85.8065762191851,82.58024227470054,82.51538692307693,88.5405827170106,76.49019112914327,109.78211055000034,89.598921,86.09024140000001,83.06850100000007,77.17666666666668,477176576,358074501.6,33.364128997386956,NaN,1.5,2.75,NaN,NaN,2.8562294470874265,1.3326181391520786,116.22824359500784,-0.6043345335913752,-1.9508841717180019,-1.3465496381266266,40.48550339801471,-10.990009082652131,0,100,0,134459133
1235399400,78.27,78.27,74.59,74.64999,NaN,NaN,55.552000000000014,89.47717560975609,109.45776050000035,89.23162090000001,85.79324120000001,82.64550050000008,85.36906303411902,81.82498015330049,81.81615461538465,89.09084055774547,74.54146867302383,109.45776050000035,89.23162090000001,85.79324120000001,82.64550050000008,75.83666333333333,379644672,357716703.2,28.89719629433951,NaN,1.5,2.75,NaN,NaN,2.9150702008668956,1.0612998179951918,110.02030822658932,-0.7938451867942078,-2.3388561216193864,-1.5450109348251786,35.60413155805275,-14.29393636120133,0,100,0,-245185539
1235485800,75.28999,77.95,74.7003,77.48,NaN,NaN,55.244000000000014,89.32335365853658,109.14936050000034,88.84652080000002,85.54064120000001,82.33550100000008,85.05968801317317,81.41117251965282,81.36615461538464,88.92864178399329,73.803667446776,109.14936050000034,88.84652080000002,85.54064120000001,82.33550100000008,76.71010000000001,426412288,363123845.6,38.026304019804826,NaN,1.5,2.75,NaN,NaN,2.9425659008049747,1.1742888636118805,116.92613737235278,-0.6763219197747445,-2.3904133345436094,-1.7140914147688648,46.099516805252854,-6.774154734688961,5.5705315954993555,74.11692291869413,20.312545485806513,181226749
1235572200,77.14,78.42,75.63,76.87199,NaN,NaN,54.936000000000014,89.16953170731706,108.83922050000034,88.45464070000001,85.319281,81.95260050000009,84.73860181657814,80.97886942254303,80.77399923076928,88.44504051683515,73.1029579447034,108.83922050000034,88.45464070000001,85.319281,81.95260050000009,76.97399666666666,462039552,372520223.2,36.92927081312586,NaN,1.5,2.75,NaN,NaN,2.9316683364617626,1.240307299375633,113.13404032718108,-0.5903814337479685,-2.4520682069538253,-1.8616867732058568,40.286519087688475,-8.047869850733273,5.066723514068439,75.39476245121269,19.538514034718883,-280812803
1235658600,77.82001,79.6667,75.53,75.62,NaN,NaN,54.628000000000014,89.01570975609755,108.51502045000034,88.09234060000003,85.05188079999999,81.36410050000008,84.38100958847704,80.46850090611036,79.90023000000004,87.1194856759527,72.68097432404737,108.51502045000034,88.09234060000003,85.05188079999999,81.36410050000008,76.9389,363371264,374172920.8,34.70877593085429,NaN,1.5,2.75,NaN,NaN,3.0177420267144943,0.9711319120130192,110.96691583342707,-0.5684932657106092,-2.5723033553441184,-2.003810089633509,39.54299233372766,-9.610327516136735,4.885757524739574,75.8677381078187,19.246504367441712,-644184067
1235745000,74.00999,75.68719,73.81,73.92999,NaN,NaN,54.320000000000014,88.86188780487804,108.18227040000035,87.72824050000003,84.7754806,80.83310000000009,83.97116568304656,79.8457855817189,78.8871515384616,85.44686637002566,72.32743670689753,108.18227040000035,87.72824050000003,84.7754806,80.83310000000009,74.47572666666666,470568960,382971794.4,31.91881039302004,NaN,1.5,2.75,NaN,NaN,2.936274024806316,1.2287300706759308,107.35935533447169,-0.6145569655849115,-2.7720062966146486,-2.157449331029737,39.487891155783366,-10.669406799106667,5.0290580775362335,75.4925653812968,19.47837654116698,-1114753027
1236004200,72.52,73.9169,70.37,70.60001,NaN,NaN,54.012000000000015,88.70806585365852,107.83142045000034,87.38704060000003,84.3498808,80.2216005000001,83.44680663665258,78.9652355263171,77.92484461538467,85.33902762337539,70.51066160739396,107.83142045000034,87.38704060000003,84.3498808,80.2216005000001,71.62897,426453248,385121247.2,27.267805808253357,NaN,1.5,2.75,NaN,NaN,2.9808251658915794,1.10732204753828,99.23702671379755,-0.8040551990501297,-3.162518329842399,-2.3584631307922694,43.91044335139969,-10.881078010603385,5.090925385775279,75.32744269524092,19.5816319189838,-1541206275
1236090600,71.61,71.7,69.64,70.07001,NaN,NaN,53.704000000000015,88.55424390243901,107.46912050000033,87.08744070000003,83.93148079999999,79.59610100000009,82.92222637639169,78.11807119047738,76.88407538461544,84.6113930294174,69.15675773981349,107.46912050000033,87.08744070000003,83.93148079999999,79.59610100000009,70.47000333333334,443761152,392884856.8,26.603366084058024,NaN,1.5,2.75,NaN,NaN,2.915051939756467,1.129494161761238,95.17813816258227,-0.8930008220737511,-3.474714158384458,-2.581713336310707,40.28956475379929,-11.337454131342534,0,100,0,-1984967427
1236177000,71.23,72.87,70.07291,71.73,NaN,NaN,53.396000000000015,88.4004219512195,107.11447050000034,86.82964080000002,83.58028099999997,78.9956005000001,82.48331553810182,77.50968345805096,75.96638307692314,83.06492990314207,68.8678362507042,107.11447050000034,86.82964080000002,83.58028099999997,78.9956005000001,71.55763666666667,462763264,402098988,32.17769069574804,NaN,1.5,2.75,NaN,NaN,2.906833229773863,1.1508690093992477,100.43267615288413,-0.772463965272737,-3.547293292901628,-2.774829327628891,45.03572684547238,-8.251365421266028,5.447358005460873,74.41955383911576,20.133088155423348,-1522204163
1236263400,70.10001,71.73,68.17,68.8,NaN,NaN,53.088000000000015,88.24659999999999,106.74322050000033,86.6106408,83.19248099999999,78.26910050000009,81.9467149287645,76.68018979537943,74.89253769230776,81.77570609159831,68.0093692930172,106.74322050000033,86.6106408,83.19248099999999,78.26910050000009,69.56666666666666,485551104,410226847.2,28.1183722629751,NaN,1.5,2.75,NaN,NaN,2.95348799907573,1.1836161073175124,91.5173658037886,-0.818108126795086,-3.797464486122749,-2.979356359327663,48.65164032974778,-11.134073882717649,5.0306249895820025,75.48385848139552,19.485516529022476,-2007755267
1236349800,69.39999,70.45,67.10001,68.92,NaN,NaN,67.10001,88.09277804878047,106.37837050000033,86.41484080000001,82.82968099999998,77.4866000000001,81.43586336293059,75.94112410058139,74.10023000000007,81.17699655136106,67.02346344863908,106.37837050000033,86.41484080000001,82.82968099999998,77.4866000000001,68.82333666666666,490495232,413867615.2,28.516117228337137,NaN,1.5,2.75,NaN,NaN,2.981809570570321,1.185150067281708,88.52378292343629,-0.7690100802197017,-3.94061895960229,-3.171608879382588,49.35436758780434,-7.6758081280385975,22.872941803107135,45.03432278609852,32.09273541079434,-1517260035
1236605400,67.95,70,67.73,68.11,NaN,NaN,66.99658157142856,87.93895609756096,106.02147045000032,86.0824407,82.46868099999998,76.5431500000001,80.91328048595292,75.19530275766888,73.26023000000006,80.38914088613586,66.13131911386427,106.02147045000032,86.0824407,82.46868099999998,76.5431500000001,68.61333333333334,379907328,414557906.4,27.413463492460878,NaN,1.5,2.75,NaN,NaN,2.930966029815298,0.9164155890767979,83.73999620320978,-0.7207009516252589,-4.072485068914162,-3.351784117288903,46.78865827267839,-12.0934434692824,24.98571711108881,42.48821693492251,32.52606595398868,-1897167363
1236691800,69.50999,72.37,69.37,72.17,NaN,NaN,66.89315314285714,87.78513414634145,105.68477050000033,85.8056406,82.17888099999999,75.7966495000001,80.57040674140575,74.90717868550995,72.79784538461544,79.34623764789848,66.24945312133241,105.68477050000033,85.8056406,82.17888099999999,75.7966495000001,71.30333333333334,406230784,422865689.6,39.94784852525321,NaN,1.5,2.75,NaN,NaN,3.0258970276856343,0.9606614913219007,93.19840719351564,-0.36298409984175173,-3.8055142420910926,-3.442530142249341,55.04840986346456,-6.1166492502665735,51.334328453669535,18.174024911638,30.491646634692458,-1490936579
1236778200,73,73.75,71.83,72.64,NaN,NaN,66.78972471428571,87.63131219512194,105.35977050000032,85.63184059999999,81.888481,75.27314950000012,80.25941039860552,74.69125690593758,72.43015307692313,78.41134710888932,66.44895904495695,105.35977050000032,85.63184059999999,81.888481,75.27314950000012,72.74,356809984,413895552,41.21340568617953,NaN,1.5,2.75,NaN,NaN,2.946904382850946,0.8620773581060374,95.60540756610614,-0.0583666887743548,-3.5154885032172842,-3.4571218144429294,55.587667434043816,-3.9407564136471884,48.62005123067251,20.140870926855467,31.239077842472025,-1134126595
1236864600,72.62,75.75,71.97,75.5,NaN,NaN,66.68629628571428,87.47749024390242,105.04397050000033,85.44914059999999,81.660281,74.8681490000001,80.07276685356217,74.76828005775305,72.49553846153853,78.58988445639628,66.40119246668078,105.04397050000033,85.44914059999999,81.660281,74.8681490000001,74.40666666666667,409818624,418152755.2,48.346901796492226,NaN,1.5,2.75,NaN,NaN,3.0064112126473073,0.9800691706646443,103.94304086532588,0.3496577195290351,-3.0200496650316353,-3.3697073845606704,60.43861773081572,2.1236442748064706,79.89825273680981,3.4728547410589163,16.628892522131277,-724307971
1236951000,76.00999,76.98,74.73,76.09,NaN,NaN,66.58286785714286,87.32366829268291,104.72792050000032,85.27794049999999,81.402681,74.4896490000001,79.91657991812836,74.89415814749086,72.38861538461545,78.17015354666518,66.60707722256572,104.72792050000032,85.27794049999999,81.402681,74.4896490000001,75.93333333333334,337474560,411561369.6,49.7028350024081,NaN,1.5,2.75,NaN,NaN,2.9523818403153568,0.8199859970531111,106.86478441427977,0.6554432791245071,-2.5504032856550367,-3.2058465647795438,58.807312874426856,7.776188700256567,78.53870364215062,3.9278075475086833,17.5334888103407,-386833411
1237210200,76.96001,77.97,75.81,75.86,NaN,NaN,66.47943942857142,87.1698463414634,104.40722050000034,85.0484405,81.1150808,74.1446495000001,79.75749835271156,74.98614308582506,72.31077000000006,77.87179317350383,66.74974682649629,104.40722050000034,85.0484405,81.1150808,74.1446495000001,76.54666666666667,360821248,414902515.2,49.16105419590649,NaN,1.5,2.75,NaN,NaN,2.8957831374356884,0.8696530745928821,108.9360938022383,0.8272933525786543,-2.1717298740562256,-2.99902322663488,50.28053228404489,8.263149955308988,78.51467451633654,3.9840233722521066,17.501302111411366,-747654659
1237296600,76.07001,78.36,75.45,78.17999,NaN,NaN,66.37601099999999,87.01602439024389,104.09637040000034,84.87164039999999,80.81948040000002,74.0926490000001,79.69563528005621,75.29031898241315,72.50769230769237,78.67207641118013,66.3433082042046,104.09637040000034,84.87164039999999,80.81948040000002,74.0926490000001,77.32999666666667,357075200,408810739.2,54.54351930706064,NaN,1.5,2.75,NaN,NaN,2.8967986276188533,0.8734486787180761,113.74793816317167,1.067035428925366,-1.6652289404781726,-2.7322643694035387,50.88530311064976,8.992039592917886,78.26125055973344,4.0725823379284956,17.666167102338083,-390579459
1237383000,77.81,80.89999,77.07001,79.92999,NaN,NaN,66.27258257142857,86.86220243902437,103.80152040000034,84.76454030000001,80.56108,74.1376485000001,79.70482566123047,75.73219241265951,72.96923076923083,80.28196241728159,65.65649912118008,103.80152040000034,84.76454030000001,80.56108,74.1376485000001,79.29999666666667,473552384,414339852.8,58.143378218838805,NaN,1.5,2.75,NaN,NaN,2.9634544399317924,1.1429081243328567,119.02982277803649,1.297955801820354,-1.109819617128096,-2.40777541894845,50.77631349827686,16.17731104651164,80.24968970139969,3.401447240549066,16.348863058051247,82972925
1237469400,80.92999,81,78.69,78.94,NaN,NaN,66.16915414285714,86.70838048780486,103.50577040000033,84.63704030000001,80.27047999999999,74.1755985000001,79.67483249804496,76.03769789716813,73.61076846153853,81.4256183045485,65.79591861852856,103.50577040000033,84.63704030000001,80.27047999999999,74.1755985000001,79.54333333333334,428597248,419926233.6,55.467268631738676,NaN,1.5,2.75,NaN,NaN,2.9167791227938076,1.0206488990355853,117.85468347525048,1.3334236098660455,-0.7409959066158933,-2.074419516481939,41.686897181585394,14.538595473012181,50.269315228122174,19.082563853309125,30.6481209185687,-345624323
1237555800,78.75999,78.91,76.53,76.71001,NaN,NaN,66.0657257142857,86.55455853658535,103.19922045000033,84.53374050000002,79.99128019999999,74.1400990000001,79.55856494910202,76.10172762124735,74.12153769230775,81.81089944759783,66.43217593701767,103.19922045000033,84.53374050000002,79.99128019999999,74.1400990000001,77.38333666666666,371165696,414625689.6,49.89632246891339,NaN,1.5,2.75,NaN,NaN,2.880580614022821,0.8951825834961481,112.72982728766861,1.1623532104394372,-0.6214780034326424,-1.7838312138720795,48.03929255511711,12.626648069299659,26.19436074197035,41.270225790229496,32.53541346780015,-716790019
1237815000,78.74001,82.28999,78.31,82.22,NaN,NaN,65.96229728571429,86.40073658536583,102.90642045000033,84.5164405,79.81483999999999,74.5185995000001,79.66293495109802,76.6844202287476,74.92846076923082,83.58536445802652,66.27155708043513,102.90642045000033,84.5164405,79.81483999999999,74.5185995000001,80.93999666666666,420247296,416655820.8,60.46280835584473,NaN,1.5,2.75,NaN,NaN,3.0733948558783344,1.0086197648531687,121.54400082648743,1.3620946604065376,-0.08121288836390761,-1.4433075487704452,56.01570165086372,13.925453789663292,50.80303249912609,18.54113810980537,30.65582939106854,-296542723
1237901400,81.24001,82.36,80.50999,80.60001,NaN,NaN,65.85886885714285,86.24691463414632,102.62797055000031,84.3848407,79.64504019999998,74.6746000000001,79.69968299223143,77.05733354029545,75.83615384615389,84.20200185030718,67.4703058420006,102.62797055000031,84.3848407,79.64504019999998,74.6746000000001,81.15666666666667,330843904,411877401.6,56.678181328800065,NaN,1.5,2.75,NaN,NaN,2.986010223315596,0.8032582091534686,117.45039901908412,1.3256598609687757,0.2137672774405246,-1.1118925835282512,53.91671808150405,10.958163546255504,27.60419815013276,39.43870496959025,32.95709688027698,-627386627
1237987800,81.23,82.7,79.06,81.45,NaN,NaN,65.75544042857142,86.09309268292681,102.35212055000032,84.26854070000002,79.53504019999998,74.90350050000009,79.76832287488902,77.47568272693397,76.80000000000005,84.6262710248264,68.97372897517371,102.35212055000032,84.26854070000002,79.53504019999998,74.90350050000009,81.07,441995008,410875174.4,58.15808184881407,NaN,1.5,2.75,NaN,NaN,3.0327237787930534,1.0757403599412991,121.06979123325489,1.2977112425903035,0.5102464697096281,-0.7874647728806753,53.84203795106911,7.880794701986758,26.810488398851096,40.34045956613637,32.84905203501254,-185391619
1238074200,82.25,83.3,81.32001,83.11,NaN,NaN,65.652012,85.9392707317073,102.08797055000034,84.13664070000003,79.45504019999998,75.2780005000001,79.89936903665809,78.01228437198787,77.9538461538462,84.6576106919582,71.2500816157342,102.08797055000034,84.13664070000003,79.45504019999998,75.2780005000001,82.57667,422025216,413807872,60.96276524813199,NaN,1.5,2.75,NaN,NaN,2.957528508879264,1.019857872592622,126.58576131347886,1.325281910300538,0.8691376149949974,-0.4561442953055407,51.4288024701036,9.225916677618603,56.65741505122796,14.607369979312205,28.735214969459836,236633597
1238160600,82.05,82.53,81.31,81.61,NaN,NaN,65.54858357142857,85.78544878048778,101.82632055000035,83.98444070000004,79.39984019999999,75.66200100000009,79.96645260384797,78.35492395560807,78.68000000000005,84.73401796649608,72.62598203350402,101.82632055000035,83.98444070000004,79.39984019999999,75.66200100000009,81.81666666666666,322343680,406396608,57.22973226678019,NaN,1.5,2.75,NaN,NaN,2.8748479011021737,0.7931751241388314,120.41303386910192,1.1815212877697652,1.0207573144066657,-0.1607639733630994,53.865255153613774,7.57975217505932,57.963661679227,13.7932794393284,28.24305888144461,-85710083
1238419800,79.8,79.87,77.96001,78.78999,NaN,NaN,65.44515514285713,85.63162682926827,101.54802050000035,83.80124060000001,79.2876402,76.07150000000009,79.92031681546177,78.39635881697873,79.15307615384621,84.10631186972198,74.19984043797045,101.54802050000035,83.80124060000001,79.2876402,76.07150000000009,78.87333333333333,324108544,401279372.8,50.917172279076524,NaN,1.5,2.75,NaN,NaN,2.93021519388059,0.8076880247755411,112.57539574090467,0.8509768207128756,0.9029570525279951,0.051980231815119515,58.958481960081244,0.7802508033065743,30.77293185228591,35.97664832106783,33.25041982664626,-409818627
1238506200,79.56,81.08,79.05,79.52,NaN,NaN,65.34172671428571,85.47780487804876,101.26487055000034,83.59234060000003,79.1768402,76.54399950000008,79.90461811681621,78.50337226298076,79.46230692307698,83.94419622992163,74.98041761623233,101.26487055000034,83.59234060000003,79.1768402,76.54399950000008,79.88333333333333,364238336,397303232,52.38144790849558,NaN,1.5,2.75,NaN,NaN,2.8844862514605474,0.9167766750007209,117.32299329542448,0.645301980270019,0.8586077071526432,0.21330572688262428,56.725652441863204,-0.5129363834525784,56.68117622484444,14.585614445912448,28.733209329243106,-45580291
1238592600,78.53,81.42,78.33,81.06,NaN,NaN,65.23829828571428,85.32398292682925,100.98902055000035,83.44104060000001,79.18664,77.01049950000008,79.9499272102744,78.74686061888735,79.84461461538467,83.94204075570428,75.74718847506506,100.98902055000035,83.44104060000001,79.18664,77.01049950000008,80.27,377018368,393015987.2,55.40394763937636,NaN,1.5,2.75,NaN,NaN,2.899165804927651,0.9592952456871454,123.02387042092018,0.5788957134312107,0.9369253686716377,0.35802965524042696,56.361007328021536,2.685583987838871,54.82923051885548,15.778214172256629,29.392555308887907,331438077
1238679000,83.08,84.61,81.12959,83.42999,NaN,NaN,65.13486985714286,85.17016097560973,100.72832045000035,83.36674050000002,79.1742398,77.74199900000009,80.08640026085187,79.19287294089808,80.42692153846161,84.2351568899804,76.61868618694282,100.72832045000035,83.36674050000002,79.1742398,77.74199900000009,83.05652666666667,476230912,392549977.6,59.64875070457753,NaN,1.5,2.75,NaN,NaN,2.9456539617185333,1.2131726892754253,131.21125909700814,0.6549100190481927,1.1766671790506678,0.5217571600024751,57.60634080635667,8.760238722430108,56.42327508704988,14.748919115105695,28.827805797844423,807668989
1238765400,83.49001,84.28,82.67,84.25999,NaN,NaN,65.03144142857143,85.01633902439022,100.47837040000034,83.27074040000001,79.2044396,78.50899850000009,80.25007044670082,79.67545551795541,80.89461384615392,84.96831097104516,76.82091672126268,100.47837040000034,83.27074040000001,79.2044396,78.50899850000009,83.73666333333334,284646144,382257523.2,61.04710472385865,NaN,1.5,2.75,NaN,NaN,2.8502501073100666,0.7446449755053507,134.7441067668388,0.7164347483166844,1.4173005953983306,0.7008658470816462,53.33460446059583,2.481135976648021,80.39696077410844,3.30746369225063,16.295575533640946,1092315133
1239024600,83.34,84.2747,82.28999,83.60001,NaN,NaN,64.92801299999999,84.86251707317072,100.22427045000035,83.18044050000002,79.2142398,79.28349900000009,80.38144062526158,80.04922261148347,81.17692307692313,85.44798367386568,76.90586247998058,100.22427045000035,83.18044050000002,79.2142398,79.28349900000009,83.38823333333333,264866560,376505484.8,59.28771430269145,NaN,1.5,2.75,NaN,NaN,2.7884258139307754,0.7034865910139325,131.00077936998983,0.668932521420332,1.5370314988570613,0.8680989774367293,37.715052384226624,3.722083905448647,83.314754438289,2.448844179314615,14.236401382396394,827448573
1239111000,82.25,82.64999,81.50999,81.64999,NaN,NaN,64.82458457142857,84.7086951219512,99.97462040000035,83.09924040000001,79.17363979999999,79.75749850000008,80.43118765956504,80.20167664848505,81.38538384615389,85.45936909538567,77.3113985969221,99.97462040000035,83.09924040000001,79.17363979999999,79.75749850000008,81.93665666666668,259071936,369147542.4,54.30747998523691,NaN,1.5,2.75,NaN,NaN,2.738539684364291,0.7018113524897194,126.29537342890222,0.4717324842718209,1.4577645827765053,0.9860320985046844,38.53837504341678,0.24553713934929364,61.3952552277194,11.789730504458703,26.815014267821898,568376637
1239197400,82.06,82.94,81.53999,82.53,NaN,NaN,64.72115614285714,84.5548731707317,99.73002040000034,83.06634030000004,79.1336398,80.25199850000008,80.5134940258566,80.4234217295817,81.83307538461541,84.91088037903883,78.755270390192,99.73002040000034,83.06634030000004,79.1336398,80.25199850000008,82.33666333333333,230402752,362827180.8,56.09967803138247,NaN,1.5,2.75,NaN,NaN,2.6429304211954125,0.6350206494783094,130.6081451594718,0.37057304097126775,1.449248399718769,1.0786753587475013,38.558592715355,-0.697870292383586,57.23823178967398,14.273467706184439,28.488300504141577,798779389
1239283800,84.67,85.82001,84.33,85.81,NaN,NaN,64.6177277142857,84.40105121951217,99.50312040000036,83.01274030000002,79.1020398,80.76749850000007,80.72120014248968,80.93642918390725,82.10922923076926,85.84931142146706,78.36914704007145,99.50312040000036,83.01274030000002,79.1020398,80.76749850000007,85.32000333333333,269653504,355818924.8,62.07115101837671,NaN,1.5,2.75,NaN,NaN,2.689150391110026,0.7578391288534408,137.87415312773553,0.4872300705211745,1.6877129468989693,1.2004828763777948,43.14662082612238,5.146428133807135,49.68270796291396,19.385708371887656,30.93158366519839,1068432893
1239629400,84.92,86.53999,84.58,85.83,NaN,NaN,64.51429928571429,84.24722926829267,99.27322040000035,83.00484030000001,79.12763979999998,81.25449850000008,80.92154523494106,81.40248354734466,82.51153615384618,86.62246078589759,78.40061152179477,99.27322040000035,83.00484030000001,79.12763979999998,81.25449850000008,85.64999666666667,224847440,350187568.8,62.10499929187351,NaN,1.5,2.75,NaN,NaN,2.6370675060307387,0.6420771610211424,139.93570594054435,0.525138811259009,1.856906390451556,1.331767579192547,41.049991837392774,8.935157879827115,47.34742410981032,21.14494671671727,31.507629173472417,1293280333
1239715800,85.03,85.75999,84.08,84.35001,NaN,NaN,64.41087085714285,84.09340731707316,99.05382045000034,82.99364040000002,79.15803999999999,81.67899900000008,81.05599483357082,81.68320035235945,82.73461384615388,86.90521531033806,78.56401238196969,99.05382045000034,82.99364040000002,79.15803999999999,81.67899900000008,84.73,276598784,345976445.6,57.981465882396655,NaN,1.5,2.75,NaN,NaN,2.5737055413142573,0.7994728760228641,135.9412244531744,0.4147796562212396,1.8502421494690964,1.4354624932478568,35.598015688612854,6.073956237424549,46.40025369916182,21.874987288234422,31.724759012603748,1016681549
1239802200,83.84,85.42,83.61,85.25,NaN,NaN,64.30744242857142,83.93958536585365,98.84242045000036,82.97534040000002,79.21144,82.03249950000007,81.22046562441118,82.02289555689664,82.89922923076928,87.27975272171373,78.51870573982482,98.84242045000036,82.97534040000002,79.21144,82.03249950000007,84.75999999999999,250726064,340658988.8,59.73237095884096,NaN,1.5,2.75,NaN,NaN,2.5191551455060965,0.7360030771041847,139.87060099405213,0.36821366259966704,1.8957295714974407,1.5275159088977737,35.64118428459771,5.169010609425114,74.76945546003464,5.337595218773762,19.892949321191608,1267407613
1239888600,85.92999,87.14999,84.77,86.5,NaN,NaN,64.204014,83.78576341463413,98.63502045000035,83.02534040000002,79.2666398,82.36100000000008,81.42750618815975,82.44928645623982,83.27538307692313,87.97655316018623,78.57421299366004,98.63502045000035,83.02534040000002,79.2666398,82.36100000000008,86.13999666666666,335202816,333741510.4,62.09489594454457,NaN,1.5,2.75,NaN,NaN,2.509214777969947,1.0043785551226414,144.82275300341226,0.3855706401009418,2.009479209023951,1.623908568923009,35.15755950467719,3.6797439386004913,77.26143773365706,4.3930654262755,18.345496840067447,1602610429
1239975000,86.83,87.64999,86.14,87.08,NaN,NaN,64.10058557142857,83.63194146341462,98.42852045000036,83.14164040000001,79.3416398,82.76800000000006,81.64917261215349,82.89030679374079,83.9130761538462,88.24180406737767,79.58434824031474,98.42852045000036,83.14164040000001,79.3416398,82.76800000000006,86.95666333333332,262648944,325444095.2,63.174517292085916,NaN,1.5,2.75,NaN,NaN,2.4378415795435227,0.8070478090517834,148.61006735529804,0.39844678782706433,2.1219670537068396,1.7235202658797752,32.1916374622929,3.3467960297645374,77.20086280695348,4.415035322570738,18.384101870475767,1865259373
1240234200,85.53999,87.0489,83.34,83.42999,NaN,NaN,63.99715714285714,83.47811951219511,98.21477045000036,83.18074030000001,79.3188394,83.10399900000007,81.71900858814747,82.9417051943369,84.21384461538467,87.75074372867158,80.67694550209777,98.21477045000036,83.18074030000001,79.3188394,83.10399900000007,84.60629666666667,293690112,321570316,52.9530055975903,NaN,1.5,2.75,NaN,NaN,2.5308528952904132,0.913299820870282,140.33737130141088,0.13698195236527977,1.894747706336375,1.7577657539710951,41.63059812272845,-0.20337318141468386,51.06490414290438,18.50563985006997,30.429456007025653,1571569261
1240320600,82.82001,85.13,82.75,85.06,NaN,NaN,63.89372871428571,83.3242975609756,98.00852045000036,83.1810403,79.2804594,83.24599900000007,81.85002785920051,83.14344755678101,84.52153692307698,87.56960585492675,81.47346799122721,98.00852045000036,83.1810403,79.2804594,83.24599900000007,84.31333333333333,300478464,315581874.4,56.349590086023376,NaN,1.5,2.75,NaN,NaN,2.520077688483955,0.9521410713821402,145.87451858137374,0.05391825396692784,1.825163571429755,1.771245317462827,42.89316888892241,4.176375281858577,78.21441534592024,4.087153754562026,17.698430899517724,1872047725
1240407000,84.28999,86.34,84.07001,84.53999,NaN,NaN,63.79030028571428,83.17047560975608,97.80612040000037,83.1698402,79.229259,83.44299800000006,81.95551657060442,83.27645159899234,84.60692153846159,87.5893801319424,81.62446294498078,97.80612040000037,83.1698402,79.229259,83.44299800000006,84.98333333333333,340395008,316059429.6,54.985739733701195,NaN,1.5,2.75,NaN,NaN,2.502214282163673,1.0769968433810018,147.50896912251244,-0.050304875766720825,1.708364222754426,1.7586690985211468,40.2120209808788,2.4354658911910843,49.256327548057925,19.81709402558698,30.92657842635511,1531652717
1240493400,84.71001,85.42,83.63,85.37,NaN,NaN,63.686871857142854,83.01665365853657,97.59677035000036,83.13384020000001,79.274459,83.63899800000004,82.0894178815611,83.47583716099307,84.69230692307698,87.69364463591964,81.69096921023433,97.59677035000036,83.13384020000001,79.274459,83.63899800000004,84.80666666666667,324903680,310204863.2,56.78369906068049,NaN,1.5,2.75,NaN,NaN,2.4513418334376964,1.0473842242457791,150.82559391286784,-0.07605700095920787,1.6635978473221371,1.739654848281345,40.15321201925348,-0.5127607504952776,48.6862968082071,20.240142192021974,31.073560999770923,1856556397
1240579800,86.03,87.31,85.69,86.66,NaN,NaN,63.58344342857142,82.86283170731706,97.40612040000035,83.0995402,79.33565879999999,83.81649800000005,82.26865639600969,83.77909076470802,84.92769076923084,88.02779113870439,81.82759039975728,97.40612040000035,83.0995402,79.33565879999999,83.81649800000005,86.55333333333333,287703040,303488754.4,59.491793640467655,NaN,1.5,2.75,NaN,NaN,2.414817416763575,0.9479858341663813,155.14364551286675,-0.021746215315895823,1.7124720791364751,1.734218294452371,34.32488541402733,0.9670278457415802,49.6145853776009,19.553606530002597,30.831808092396503,2144259437
1240839000,85.67999,87.00999,85.53999,85.84,NaN,NaN,63.480014999999995,82.70900975609754,97.20882040000035,83.13684020000001,79.3792588,84.02799800000005,82.40870908636225,83.97536783473582,85.24999923076929,87.72902091129295,82.77097755024563,97.20882040000035,83.13684020000001,79.3792588,84.02799800000005,86.12999333333335,289581568,301850648.8,57.04475524679115,NaN,1.5,2.75,NaN,NaN,2.3473304584233197,0.9593538034495687,151.08162631054878,-0.05470631599653952,1.6658353994566966,1.720541715453236,34.852772057720806,1.7664372535344168,47.999106370410026,20.62905725250149,31.37183637708849,1854677869
1240925400,84.97,86.59,84.75999,85.57001,NaN,NaN,63.37658657142857,82.55518780487803,97.01747045000035,83.1398403,79.4354592,84.36699900000005,82.5326816712108,84.12723851714193,85.4838461538462,87.40267165142963,83.56502065626277,97.01747045000035,83.1398403,79.4354592,84.36699900000005,85.63999999999999,247927872,298041615.2,56.22472556057818,NaN,1.5,2.75,NaN,NaN,2.3103789971073683,0.831856557459698,152.32164018490752,-0.10541325452888861,1.5887751472921252,1.6941884018210138,33.17204954089571,0.37537829912023035,23.802565668061742,43.95109550662939,32.246338825308854,1606749997
1241011800,86.52,88.36,86.3,87.39,NaN,NaN,63.273158142857135,82.40136585365852,96.84082045000034,83.14054019999999,79.59885919999999,84.76049900000007,82.72316474292802,84.43797770598556,85.60538461538468,87.77518872406566,83.4355805067037,96.84082045000034,83.14054019999999,79.59885919999999,84.76049900000007,87.35000000000001,311505664,295404981.6,60.36128636111067,NaN,1.5,2.75,NaN,NaN,2.3446369258854136,1.054503760609567,158.12034693727912,-0.030967526550572888,1.6554789936327978,1.6864465201833707,34.727984302942744,1.028901734104047,53.94277899670753,16.402087083724588,29.655133919567866,1918255661
1241098200,88.55,89.02,86.92,87.42,NaN,NaN,63.16972971428571,82.247543902439,96.67297040000032,83.1617402,79.76665919999999,85.07849900000006,82.90735436085241,84.72197982922503,85.72769230769238,88.1037957611485,83.35158885423625,96.67297040000032,83.1617402,79.76665919999999,85.07849900000006,87.78666666666668,301419776,291625052,60.4276666487301,NaN,1.5,2.75,NaN,NaN,2.3271628597507408,1.0335867029695378,159.98518257086684,0.0038565013103120105,1.6912671468212608,1.6874106455109488,33.868687177628665,0.3904455672944458,53.35134794643366,16.800498980517112,29.84815307304924,2219675437
1241184600,87.44,88.21001,86.72,87.89,NaN,NaN,63.06630128571428,82.09372195121949,96.49262035000032,83.16134029999999,79.9608392,85.30149950000006,83.10275222905427,85.02369603596551,85.99999923076932,88.49076198083564,83.509236480703,96.49262035000032,83.16134029999999,79.9608392,85.30149950000006,87.60667,236110320,279619022.4,61.51502348691839,NaN,1.5,2.75,NaN,NaN,2.267366226911402,0.8444000625330847,163.10826169064683,0.04009186438624024,1.737525475993749,1.6974336116075088,33.797002702935146,5.345811500157193,51.486479590096025,18.08847441122082,30.425045998683174,2455785757
1241443800,88.55,90.94,88.38,90.88,NaN,NaN,62.96287285714285,81.93989999999998,96.32102035000032,83.16014029999998,80.2300392,85.63250000000008,83.40774233771882,85.58143927063547,86.43307615384626,89.98386621047231,82.8822860972202,96.32102035000032,83.16014029999998,80.2300392,85.63250000000008,90.06666666666666,287119872,279742708.8,67.61209515041392,NaN,1.5,2.75,NaN,NaN,2.3232686392748727,1.0263712438892347,169.3388314880249,0.2360414427761377,1.992485415077681,1.7564439723015433,24.851742120234277,6.842229014813065,80.58531215973731,3.26144211572439,16.153245724538287,2742905629
1241530200,90.57001,90.92999,89.84,90.57001,NaN,NaN,62.85944442857142,81.78607804878047,96.14397040000033,83.17084039999997,80.5484396,85.98100000000007,83.6886155793769,86.05654124486067,86.74615384615393,90.92713168883029,82.56517600347757,96.14397040000033,83.17084039999997,80.5484396,85.98100000000007,90.44666666666667,243036256,278651193.6,66.43692493527095,NaN,1.5,2.75,NaN,NaN,2.235177307898096,0.8721881031985645,167.32499049242583,0.3106891578397579,2.1448054196012407,1.8341162617614828,24.666751297618212,7.132742741038877,79.90130855567433,3.4811662716967,16.61752517262896,2499869373
1241616600,91.67999,92.2,90.61,92.14101,NaN,NaN,62.756015999999995,81.63225609756095,95.97442545000033,83.19115049999996,80.8416598,86.50555100000005,84.02008202724447,86.63601445963585,87.1354623076924,92.21436578542465,82.05655882996017,95.97442545000033,83.19115049999996,80.8416598,86.50555100000005,91.65033666666666,291941120,280294652.8,69.34490993774345,NaN,1.5,2.75,NaN,NaN,2.1919496430482326,1.041550800501036,171.6541219654057,0.4247263224326594,2.365024164802307,1.9402978423696475,23.998099280801007,7.931369333489504,79.84057919977144,3.5009877147249067,16.658433085503656,2791810493
1241703000,93.00999,93.14999,90.28,90.86,NaN,NaN,62.65258757142857,81.47843414634144,95.79132545000033,83.22035049999997,81.12142,86.92205100000005,84.28831410460744,87.03829879681338,87.70700153846163,92.66000251039065,82.7540005665326,95.79132545000033,83.22035049999997,81.12142,86.92205100000005,91.42999666666667,317800448,284664537.6,64.44193147808588,NaN,1.5,2.75,NaN,NaN,2.240381097116216,1.1164033661493913,167.7834041843797,0.3744973616978866,2.4084195444920056,2.033922182794119,27.228345971452228,4.846526655896611,47.92824680151504,20.693047964228285,31.378705234256664,2474010045
1241789400,92.03,93.22,90.911,92.98,NaN,NaN,62.549159142857135,93.22,95.61537545000034,83.26025039999996,81.46862000000002,87.28055100000006,84.62916453187773,87.60417510187877,88.3162323076924,93.7427341835783,82.8897304318065,95.61537545000034,83.26025039999996,81.46862000000002,87.28055100000006,92.37033333333333,299081728,286135948.8,68.42124717495096,NaN,1.5,2.75,NaN,NaN,2.248925304465058,1.0452434559666206,175.07795875034117,0.44013361867273115,2.584089206135033,2.143955587462302,28.53728047305671,8.317800559179869,51.09464724418823,18.375131707039763,30.530221048772013,2773091773
1242048600,91.7,92.11,91.03999,91.24001,NaN,NaN,62.44573071428571,93.20449651162791,95.44402555000035,83.29515049999996,81.81482040000002,87.55105150000006,84.88841337376488,87.95044509217603,88.83161846153855,93.99175772526304,83.67147919781407,95.44402555000035,83.29515049999996,81.81482040000002,87.55105150000006,91.46333333333332,247923568,287289755.2,62.26250018104662,NaN,1.5,2.75,NaN,NaN,2.2268599255746966,0.862973926193105,170.53251961323323,0.3276124906699005,2.5534712007996774,2.225858710129777,30.929684673455085,6.626153251588965,25.13552445518686,42.31244361065042,32.55203193416272,2525168205
1242135000,91.63,91.83,89.85001,90.97,NaN,NaN,62.34230228571428,93.18899302325582,95.27147555000036,83.28605049999996,82.22222020000001,87.88205100000008,85.12690696695057,88.23802175006402,89.2623876923078,94.12085964287051,84.40391574174508,95.27147555000036,83.28605049999996,82.22222020000001,87.88205100000008,90.88333666666665,282431232,287581377.6,61.33979810199139,NaN,1.5,2.75,NaN,NaN,2.2092263594622183,0.9820915191276279,167.98028747471432,0.20238830303068855,2.4788440889181373,2.276455785887449,30.909502116503845,4.096578555898843,23.718608632273433,44.02616431984929,32.255227047877256,2242736973
1242221400,89.74001,90.00999,88.5,88.67999,NaN,NaN,62.23887385714285,93.17348953488371,95.09667550000036,83.26295029999997,82.5944198,88.05355050000007,85.26624355648192,88.28011396434364,89.41777153846164,94.05767631408762,84.77786676283566,95.09667550000036,83.26295029999997,82.5944198,88.05355050000007,89.06332666666667,269618944,288526021.6,54.02693435665473,NaN,1.5,2.75,NaN,NaN,2.2278530480720597,0.934470112972299,160.04483357645313,-0.053606422243478224,2.209447758083101,2.2630541803265793,34.05631620271283,1.4413063372226058,5.942434669386941,73.23468973209263,20.82287559852043,1973118029
1242307800,88.72,90.12,88.5,89.44,NaN,NaN,62.13544542857142,93.15798604651162,94.91247550000037,83.26445039999999,82.9486198,88.20055050000008,85.42992027975714,88.39057930107282,89.69469461538473,93.85204028886022,85.53734894190924,94.91247550000037,83.26445039999999,82.9486198,88.20055050000008,89.35333333333334,260098624,284770812,55.90578959831318,NaN,1.5,2.75,NaN,NaN,2.18443497320977,0.9133612471491636,164.16442269343477,-0.18337858967390908,2.033830943234193,2.217209532908102,34.280617267142226,1.7635680964842384,23.65328365987621,44.10654650975552,32.24016983036826,2233216653
1242394200,89.37,90,88.14999,88.71001,NaN,NaN,62.032016999999996,93.14248255813953,94.71337555000036,83.26965049999998,83.34682,88.28205100000008,85.55855124917844,88.42100127239922,89.9362330769232,93.4167104869105,86.4557556669359,94.71337555000036,83.26965049999998,83.34682,88.28205100000008,88.95333333333333,271502592,285213494.4,53.638290758832724,NaN,1.5,2.75,NaN,NaN,2.1605474751233578,0.951927581726652,160.86781124244095,-0.3219043939189321,1.8148290405094372,2.1367334344283693,34.71427080921589,-2.387753080985914,4.7683887285584,76.20436948159981,19.027241789841803,1961714061
1242653400,89.55,91.34,88.57021,91.23,NaN,NaN,61.92858857142856,93.12697906976744,94.53537555000035,83.31135049999999,83.79301999999998,88.67205150000008,85.78096100411261,88.68852496074216,90.23161769230781,93.43862218012356,87.02461320449206,94.53537555000035,83.31135049999999,83.79301999999998,88.67205150000008,90.38007,242217248,282639851.2,59.71295515438673,NaN,1.5,2.75,NaN,NaN,2.204064798328832,0.8569819399904921,167.723465842842,-0.2505152402892046,1.8235893840668638,2.0741046243560683,32.948140847578344,0.7287069969408281,20.438182658568522,48.290704354242955,31.27111298718853,2203931309
1242739800,91.17999,91.97,90.81,91.12,NaN,NaN,61.825160142857136,93.11147558139535,94.36017555000035,83.3609505,84.25321999999998,88.97505150000009,85.9903350823827,88.92009401210005,90.51623307692317,93.30394263880939,87.72852351503695,94.36017555000035,83.3609505,84.25321999999998,88.97505150000009,91.3,206102192,277921037.6,59.34740820893056,NaN,1.5,2.75,NaN,NaN,2.129488741305344,0.7415854293716122,170.42795945797323,-0.2185666379475384,1.8008963269216451,2.0194629648691835,32.8793475012146,-1.1080950816579824,23.112022468905778,44.843175894919604,32.044801636174604,1997829117
1242826200,91.95,92.8,90.41,90.50999,NaN,NaN,61.72173171428571,93.09597209302325,94.18777545000033,83.3994504,84.62001979999997,89.27355150000008,86.16757645170102,89.07151267761434,90.71777076923087,93.06013755505796,88.37540398340377,94.18777545000033,83.3994504,84.62001979999997,89.27355150000008,91.23999666666667,285898240,275196199.2,57.254207119540624,NaN,1.5,2.75,NaN,NaN,2.148096688354962,1.0388887667457292,170.91053247040634,-0.24442472009621308,1.7139320647489171,1.9583567848451302,31.293315386321247,-0.385219018269863,22.303632628699127,45.861537279666294,31.834830091634576,1711930877
1242912600,89.46001,89.8,88.25999,89.21001,NaN,NaN,61.618303285714276,93.08046860465116,93.99202550000032,83.41995050000001,84.95141999999996,89.46555200000009,86.28688757124216,89.08470289879392,90.58931000000008,93.06156919924074,88.11705080075943,93.99202550000032,83.41995050000001,84.95141999999996,89.46555200000009,89.08999999999999,258988368,271900433.6,52.96677620637332,NaN,1.5,2.75,NaN,NaN,2.1553754963296075,0.9525117873883375,166.758424572001,-0.34863456891227473,1.5225635737047867,1.8711981426170614,31.360876792615187,-4.054624650462473,4.90616534773847,75.88741551168128,19.206419140580252,1452942509
1242999000,89.46001,90,88.67999,89.02,NaN,NaN,61.51487485714285,93.06496511627907,93.79247555000033,83.44105050000002,85.22181999999997,89.58355200000008,86.39406845080129,89.0785407179564,90.47007846153855,93.08022224425156,87.85993467882554,93.79247555000033,83.44105050000002,85.22181999999997,89.58355200000008,89.23333000000001,166811872,265855875.2,52.34971460889805,NaN,1.5,2.75,NaN,NaN,2.0957065323060635,0.6274522685440356,167.64568667676664,-0.424860633664196,1.3401223505368165,1.7649829842010125,27.09448849512947,-2.4331540516052135,5.870402815367115,73.45925601662749,20.6703411680054,1286130637
1243344600,88.36,91.56,88.32001,91.3,NaN,NaN,61.41144642857142,93.04946162790698,93.61392560000033,83.46435050000002,85.52601999999997,89.8565520000001,86.58645792331887,89.29010826862722,90.40538538461547,92.88509469574862,87.92567607348232,93.61392560000033,83.46435050000002,85.52601999999997,89.8565520000001,90.39333666666666,236318432,263192718.4,58.584617923477815,NaN,1.5,2.75,NaN,NaN,2.1774410657127734,0.8978912237261956,172.92408969866054,-0.32095249729794695,1.3637923625785788,1.6847448598765258,30.106871073066433,0.36275695284159426,5.618990804348429,74.067455456482,20.31355373916958,1522449069
1243431000,91.44,91.75,89.53,89.67,NaN,NaN,61.30801799999999,93.03395813953489,93.41542560000033,83.45865040000002,85.80221999999998,90.06155150000009,86.70738114201225,89.32628843351986,90.31384692307702,92.80748811719205,87.820205728962,93.41542560000033,83.45865040000002,85.80221999999998,90.06155150000009,90.31666666666666,246313504,263112000,53.222942281436445,NaN,1.5,2.75,NaN,NaN,2.1804809895904325,0.9361545805588495,168.58744910796096,-0.35838231952229327,1.236766960473659,1.5951492799959524,31.845289981102336,1.116384880061441,5.2581910331996555,74.97166659218958,19.77014237461076,1276135565
1243517400,90.46001,91.34,89.10001,90.92,NaN,NaN,61.20458957142856,93.01845465116278,93.21647555000033,83.43825030000002,86.05702019999998,90.2380515000001,86.87258188154118,89.47807048747035,90.15538538461549,92.1662726262265,88.14449814300447,93.21647555000033,83.43825030000002,86.05702019999998,90.2380515000001,90.45333666666666,289094912,261991462.4,56.51004296175521,NaN,1.5,2.75,NaN,NaN,2.184731633191116,1.1034516520184132,172.14717406798874,-0.29782620529475823,1.2228665233775047,1.520692728672263,28.838601952407846,1.6547406082289848,27.78123683400484,39.312201552855726,32.906561613139424,1565230477
1243603800,91.42,93.7,90.67999,92.53,NaN,NaN,61.10116114285714,93.0029511627907,93.03237550000033,83.43505020000002,86.3090204,90.4935515000001,87.09444141559838,89.7687304410446,90.25461538461549,92.57352080794413,87.93570996128685,93.03237550000033,83.43505020000002,86.3090204,90.4935515000001,92.30333,258641376,259852542.4,60.37261073362283,NaN,1.5,2.75,NaN,NaN,2.2443943736774647,0.9953390242450058,176.67314081554667,-0.15537569083398095,1.3264731151297866,1.4818488059637676,29.969131823098124,4.3061544012902315,58.01192585277181,13.807199253677783,28.180874893550396,1823871853
1243863000,93.67,95.17,93.42999,94.77,NaN,NaN,60.9977327142857,92.9874476744186,92.86337545000033,83.44805020000004,86.6256204,90.83755150000009,87.3954437130259,90.24504182761177,90.54692307692318,93.88631277352712,87.20753338031923,92.86337545000033,83.44805020000004,86.6256204,90.83755150000009,94.45666333333332,276246784,261859365.6,65.02666088214781,NaN,1.5,2.75,NaN,NaN,2.272651918414789,1.0549433027420425,182.13272116057865,0.07149641661226025,1.5712193267290928,1.4997229101168326,31.067692456556223,3.8803025320618127,79.69402526056875,3.562227716845593,16.743747022585662,2100118637
1243949400,94.39999,95.37,87.53,94.85001,NaN,NaN,87.53,92.97194418604651,92.68992555000031,83.48985030000003,86.98842040000001,91.03605200000008,87.68777964584841,90.68361022498208,91.02154000000009,94.8784089401532,87.16467105984698,92.68992555000031,83.48985030000003,86.98842040000001,91.03605200000008,92.58333666666665,230874432,259047093.6,65.18394904587859,NaN,1.5,2.75,NaN,NaN,2.6703196385280186,0.8912450195503757,184.86724341141124,0.201380861797825,1.751448987364114,1.550068125566289,27.98547496545817,4.093514047410001,79.7564655282756,3.541658846604945,16.70187562511946,2330993069
1244035800,94.03999,94.13,92.75999,93.64999,NaN,NaN,87.87049983333334,92.95644069767442,92.50732550000033,83.51593010000005,87.21702020000001,91.19005100000008,87.92159181659945,90.96612258450759,91.34538538461545,95.32182632789826,87.36894444133264,92.50732550000033,83.51593010000005,87.21702020000001,91.19005100000008,93.51332666666667,235403936,258665477.6,60.7695284742782,NaN,1.5,2.75,NaN,NaN,2.6288696643474454,0.910070946398299,180.83329655098692,0.18151905006544267,1.7769669381480924,1.5954478880826497,29.491019813233446,3.4692303026439406,79.7919913688245,3.5299800889236073,16.678028542251898,2095589133
1244122200,94,94.67,93.3,94.53,NaN,NaN,88.21099966666667,92.94093720930232,92.33802550000033,83.57033010000005,87.49562,91.30950050000008,88.18074507869359,91.30553948122115,91.793076923077,95.79231819434297,87.79383565181102,92.33802550000033,83.57033010000005,87.49562,91.30950050000008,94.16666666666667,210102256,254573534.4,62.761177401842005,NaN,1.5,2.75,NaN,NaN,2.5389504026083425,0.82531067691379,185.20247766301964,0.201169311193095,1.8469095270740183,1.6457402158809233,29.045256767171058,5.963445133567416,78.47595758238394,3.974214069464238,17.54982834815183,2305691389
1244208600,95.49001,95.67,93.8,94.55,NaN,NaN,88.5514995,92.92543372093023,92.17582545000032,83.64633010000003,87.75762,91.49400050000008,88.43051978148992,91.61453572110484,92.0484615384616,96.28805394381769,87.8088691331055,92.17582545000032,83.64633010000003,87.75762,91.49400050000008,94.67333333333333,284257792,252896401.6,62.80739133915567,NaN,1.5,2.75,NaN,NaN,2.4911682309934613,1.1240088439439464,184.3802512112266,0.18921254034213209,1.8822558913085885,1.6930433509664564,26.69871333690195,6.212087171422154,79.09926796739794,3.760845875949949,17.139886156652118,2589949181
1244467800,93.84,95.10001,93.03999,94.16,NaN,NaN,88.89199933333333,92.90993023255814,92.00872545000031,83.71683010000002,87.97862,91.55300050000008,88.65520528025502,91.85696089052342,92.28230769230777,96.62535266347041,87.93926272114513,92.00872545000031,83.71683010000002,87.97862,91.55300050000008,94.09999999999998,238565120,249870571.2,61.21212292567101,NaN,1.5,2.75,NaN,NaN,2.4603719287796424,0.9547547710572489,181.4545848239699,0.13147539204413095,1.8573875910216202,1.7259121989774893,26.939640119093905,3.132530120481927,50.22994921785527,19.00414182513882,30.765908957005916,2351384061
1244554200,94.69,95.145,94.02,94.64,NaN,NaN,89.23249916666667,92.89442674418605,91.84292545000031,83.81953010000001,88.23922000000002,91.7230000000001,88.88990311240188,92.1220122342831,92.60000076923085,96.98203247928203,88.21796905917967,91.84292545000031,83.81953010000001,88.23922000000002,91.7230000000001,94.60166666666667,225125440,248730664.8,62.47540501192602,NaN,1.5,2.75,NaN,NaN,2.3649882195810963,0.9050972471810801,183.84694856205806,0.10329237530367585,1.855027668107084,1.7517352928034082,23.866994933206986,5.542544886807181,49.93018039513907,19.22118696749599,30.848632637364947,2576509501
1244640600,95.48,95.49001,93.19,94.39999,NaN,NaN,89.572999,92.87892325581396,91.66667545000031,83.91953010000002,88.55142000000002,91.89449950000008,89.10598495113122,92.33896249768472,92.9992300000001,97.00242442802912,88.99603557197108,91.66667545000031,83.91953010000002,88.55142000000002,91.89449950000008,94.36,296100352,249414120.8,61.398603629791154,NaN,1.5,2.75,NaN,NaN,2.360346918182447,1.1871835926941632,182.031978136112,0.04892593563000247,1.8128927123409113,1.7639667767109088,20.10486347732219,3.8275296964364283,45.58446173849477,22.514542976765817,31.90099528473941,2280409149
1244727000,94.58,96.11,94.56,94.82001,NaN,NaN,89.91349883333334,96.11,91.50567550000031,84.01713020000001,88.85742020000002,92.20150050000008,89.33006436481234,92.57525273600046,93.4453846153847,96.81841591482048,90.07235331594892,91.50567550000031,84.01713020000001,88.85742020000002,92.20150050000008,95.16333666666667,275414016,249703874.4,62.613032496126415,NaN,1.5,2.75,NaN,NaN,2.3138942811694148,1.1029625257588713,184.3463170014387,0.023008272868531687,1.7927271177965736,1.7697188449280419,19.32638746723462,2.474883821463304,48.65762542888596,20.156931652481887,31.185442918632177,2555823165
1244813400,94.39999,95.14,94,95.08,NaN,NaN,90.25399866666667,96.23565217391304,91.34412550000032,84.16223010000002,89.13782020000001,92.48350050000008,89.55555203678048,92.8138000944766,93.73615384615393,96.96804017760348,90.50426751470437,91.34412550000032,84.16223010000002,89.13782020000001,92.48350050000008,94.74,184373008,245917593.6,63.381007032047805,NaN,1.5,2.75,NaN,NaN,2.230044689657314,0.749734922585059,182.81460102053563,0.006015217791407235,1.777237867167301,1.7712226493758938,17.355091277186943,0.32710773451514435,43.95207115731627,23.824762546562177,32.223166296121555,2740196173
1245072600,93.96001,94.02,92.39999,92.89999,NaN,NaN,90.5944985,96.36130434782609,91.16547545000032,84.25073000000002,89.32722020000001,92.69299950000007,89.68670646671066,92.8220086569074,93.98461461538469,96.29243257714802,91.67679665362135,91.16547545000032,84.25073000000002,89.32722020000001,92.69299950000007,93.10665999999999,224190432,243551985.6,53.46411688570421,NaN,1.5,2.75,NaN,NaN,2.262185068967505,0.9205034048385932,175.86355267005413,-0.16022207167393998,1.5709450597834689,1.7311671314574089,17.35546443602905,-2.055898570806682,44.52176366774649,23.32158363960293,32.156652692650574,2516005741
1245159000,93.23,93.28999,91.58,91.64,NaN,NaN,90.93499833333334,96.48695652173913,90.97272545000033,84.33963000000001,89.47482040000003,92.71349950000008,89.76330621311416,92.7094364038686,94.0399992307693,96.0686444930717,92.01135396846689,90.97272545000033,84.33963000000001,89.47482040000003,92.71349950000008,92.16999666666668,227319008,242807073.6,48.71938714959657,NaN,1.5,2.75,NaN,NaN,2.2227425640412553,0.9362124613160364,171.90762665338616,-0.3522096169281874,1.2909051102971745,1.643114727225362,18.445818888305578,-2.146278926457976,20.423302150553866,48.24985525283561,31.32684259661053,2288686733
1245245400,91.60001,92.33,90.83,91.55,NaN,NaN,91.27549816666667,96.61260869565217,90.78652550000032,84.42403,89.63382020000003,92.73499950000007,89.8333726361293,92.59901388921445,93.96461461538469,96.26653199477808,91.6626972359913,90.78652550000032,84.42403,89.63382020000003,92.73499950000007,91.57000000000001,223445312,243674229.6,48.38905086469177,NaN,1.5,2.75,NaN,NaN,2.1711180951811655,0.9169837629805725,169.52445918560568,-0.47480383382725977,1.0496099349412873,1.524413768768547,17.490575971216654,-3.152438379350475,23.53037712618105,44.263254746846776,32.20636812697216,2065241421
1245331800,91.69,92.67,91.25,92.21899,NaN,NaN,91.615998,96.73826086956522,90.60767040000032,84.50941999999999,89.84520020000004,92.82044950000008,89.92692625824188,92.5628211378607,93.76838307692316,96.1938345231318,91.34293163071452,90.60767040000032,84.50941999999999,89.84520020000004,92.82044950000008,92.04633000000001,211725056,239965570.4,51.04612306345887,NaN,1.5,2.75,NaN,NaN,2.117466802668225,0.8823143072027969,171.91192646286834,-0.4979579228170965,0.9019663652471763,1.3999242880642728,17.022118373850574,-2.4653728186144814,19.150589540253794,49.9763883388557,30.873022120890514,2276966477
1245418200,92.58,92.7,91.52,92.03999,NaN,NaN,91.95649783333333,96.86391304347826,90.42847035000031,84.58451989999998,90.03540000000004,92.96194850000008,90.0097915030167,92.51302769615968,93.55222769230778,96.05325349459055,91.05120189002501,90.42847035000031,84.58451989999998,90.03540000000004,92.96194850000008,92.08666333333333,215655568,237798930.4,50.29993716009981,NaN,1.5,2.75,NaN,NaN,2.0505048881919237,0.906881993275778,174.70477447162213,-0.510552884411791,0.7617331825495341,1.2722860669613252,16.94260413180195,-2.251497451146977,4.672145573247683,76.46547353394872,18.862380892803575,2061310909
1245677400,91.14,91.19,89.25,89.28,NaN,NaN,92.29699766666667,96.9895652173913,90.25472035000031,84.60341989999999,90.10480000000003,92.97494850000007,89.9811722283886,92.20512029652542,93.21607461538468,96.59485724132955,89.83729198943982,90.25472035000031,84.60341989999999,90.10480000000003,92.97494850000007,89.90666666666668,251913568,242054015.2,40.4753547141687,NaN,1.5,2.75,NaN,NaN,2.103325253321072,1.0407328620095537,167.12635561064377,-0.6794184396594549,0.4230130173870066,1.1024314570464615,23.285139412199598,-5.663567202028741,4.517873072187806,76.88425437806612,18.59787254974608,1809397341
1245763800,89.47,89.88,88.85001,89.35001,NaN,NaN,92.6374975,97.11521739130434,90.07937040000031,84.65142,90.17520020000003,92.87744900000008,89.95642076845179,91.93320503018967,92.81761384615393,96.67102759752036,88.9642000947875,90.07937040000031,84.65142,90.17520020000003,92.87744900000008,89.36000666666666,188309680,239653577.6,40.79126928885253,NaN,1.5,2.75,NaN,NaN,2.026658449512424,0.7857578505016234,165.7691138255672,-0.7552266434409356,0.158398152745292,0.9136247961862276,22.706853792304294,-5.349555651435985,18.420426712592924,50.99560858552663,30.583964701880447,1997707021
1245850200,90.16,91.08,89.60001,90.118,NaN,NaN,92.97799733333333,97.2408695652174,89.8950103500003,84.7243,90.29056000000004,92.89984900000007,89.96275720890466,91.76032836064779,92.47669076923086,96.43937727278983,88.51400426567189,89.8950103500003,84.7243,90.29056000000004,92.89984900000007,90.26600333333333,211577632,237916784,44.28451347197387,NaN,1.5,2.75,NaN,NaN,2.0054678459758226,0.8892925855958107,170.19775958085248,-0.7224695435560541,0.010537866741159974,0.7330074102972141,24.12647249794474,-4.958879460147707,43.94076391026461,23.793546901435416,32.26568918829996,2209284653
1245936600,89.67,92.17,89.57001,92.08,NaN,NaN,93.31849716666667,97.36652173913043,89.73931035000031,84.8193,90.42716000000004,92.95784900000007,90.04578633796723,91.79077327868133,92.31669076923085,96.16078344632822,88.47259809213347,89.73931035000031,84.8193,90.42716000000004,92.95784900000007,91.27333666666665,279410944,237432585.6,52.065266525204706,NaN,1.5,2.75,NaN,NaN,2.0479337141204073,1.1768011677669235,175.09248463271527,-0.5455374128917998,0.05108564418246431,0.5966230570742641,28.133244191001527,-3.155237694572991,47.65671740278958,20.871702368493892,31.471580228716522,2488695597
1246023000,91.77,92.24001,91.27,91.84,NaN,NaN,93.658997,97.49217391304347,89.5799103500003,84.90029990000001,90.53396000000004,92.92334900000006,90.11614765804694,91.79546153785454,92.10130615384621,95.70693419228067,88.49567811541175,89.5799103500003,84.90029990000001,90.53396000000004,92.92334900000006,91.78333666666667,167579008,232879467.2,51.124734278156424,NaN,1.5,2.75,NaN,NaN,1.9709391631118067,0.7195954629013339,177.55651153423818,-0.426797346337079,0.06312637415291533,0.48992372048999433,27.905863594194308,-1.1410011992466298,51.50867825024609,18.05787751865047,30.433444231103444,2321116589
1246282200,92.11,92.82001,91.60001,92.7,NaN,NaN,93.99949683333334,97.61782608695653,89.41586040000031,84.99399990000002,90.64636000000004,92.81984900000006,90.21747520086863,91.88160805805886,91.97053769230776,95.34938505437265,88.59169033024287,89.41586040000031,84.99399990000002,90.64636000000004,92.81984900000006,92.37334,168481248,227491190.4,54.30981472851213,NaN,1.5,2.75,NaN,NaN,1.9173006514609632,0.740605593138608,180.0608287941459,-0.2795833010120961,0.1404445942248742,0.4200278952369703,25.647155435803693,1.1567001309471872,81.66944036568688,2.9278931223525864,15.402666511960529,2489597837
1246368600,92.72,93.06,91.27,91.95,NaN,NaN,94.33999666666666,97.74347826086957,89.24516040000032,85.06779980000003,90.81676020000005,92.67484850000008,90.28541734985417,91.88812157633897,91.74976769230777,94.7033208650774,88.79621451953814,89.24516040000032,85.06779980000003,90.81676020000005,92.67484850000008,92.09333333333332,228888192,227391878.4,51.17755134829133,NaN,1.5,2.75,NaN,NaN,1.9082077477851804,1.0065803300035538,178.1114699251841,-0.2243487327916912,0.13959197924735633,0.36394071203904754,24.769990544870534,0.4369197160021908,52.65063752262584,17.293404309964856,30.055958167409308,2260709645
1246455000,92.34,93.23,92.21001,92.33,NaN,NaN,94.6804965,97.8691304347826,89.10636040000033,85.12130980000003,90.96216020000003,92.60884900000008,90.3655970616246,91.93020523573526,91.5382292307693,93.82637861116002,89.25007985037858,89.10636040000033,85.12130980000003,90.96216020000003,92.60884900000008,92.59000333333334,173041056,224273734.4,52.6670846691538,NaN,1.5,2.75,NaN,NaN,1.8633357658005247,0.7715618436681277,181.87033042513147,-0.15703530996168658,0.16764657458693932,0.3246818845486259,24.843457581210473,0.12037650813568135,50.85303802067999,18.552292878011222,30.5946691013088,2433750701
1246541400,91.13,92.3624,89.75999,89.81,NaN,NaN,95.02099633333333,97.99478260869566,88.94491035000034,85.14840970000003,91.06756040000003,92.37284900000007,90.3438089415609,91.72828092757,91.30053769230776,93.6152869933831,88.98578839123242,88.94491035000034,85.14840970000003,91.06756040000003,92.37284900000007,90.64413,212309808,224384112,43.24462248370826,NaN,1.5,2.75,NaN,NaN,1.9161267825290582,0.9461891312518598,177.36153143951645,-0.2703930857584293,-0.013309472649410736,0.25708361310901856,29.230344554982622,-2.4228490246467875,18.350755800864885,51.1365150122095,30.51272918692561,2221440893
1246887000,88.94,89.92999,88.66,89.8,NaN,NaN,95.36149616666667,98.1204347826087,88.81086035000033,85.21530970000002,91.15616040000005,92.13534900000008,90.32248310071537,91.54463512494428,91.15899923076928,93.59524205059189,88.72275641094667,88.81086035000033,85.21530970000002,91.15616040000005,92.13534900000008,89.46333,174499568,218896200.8,43.21158480987312,NaN,1.5,2.75,NaN,NaN,1.8699741552055544,0.7971795187045566,174.71087604396348,-0.3302510500298703,-0.15573019942831934,0.17452085060155098,29.26527624482394,0.5824372759856586,16.69250281607053,53.44653211716035,29.8609650667691,2046941325
1246973400,89.71001,89.82001,88,88.06,NaN,NaN,95.70199600000001,98.24608695652174,88.65081030000034,85.25990960000001,91.18416040000005,91.83034900000007,90.23375827323633,91.21276511304482,90.89053769230775,93.81542511221679,87.9656502723987,88.65081030000034,85.25990960000001,91.18416040000005,91.83034900000007,88.62667,197088880,216822388.8,37.80023311081179,NaN,1.5,2.75,NaN,NaN,1.8664052869765861,0.9089876792280779,170.0626899673507,-0.46309036496177053,-0.4043421056006622,0.058748259361108335,25.94439434510993,-1.4437715228011674,3.681465323392284,79.24300550835487,17.075529168252867,1849852445
1247059800,88.59,88.8,87,88,NaN,NaN,87,98.37173913043478,88.47021030000035,85.3033096,91.22736040000005,91.49834900000006,90.14615990958,90.90678748323103,90.56600000000005,93.75370919437108,87.378290805629,88.47021030000035,85.3033096,91.22736040000005,91.49834900000006,87.93333333333334,248050496,217968641.6,37.62525982021339,NaN,1.5,2.75,NaN,NaN,1.8616620521925442,1.138010009968333,166.86970986230472,-0.5264401683796437,-0.5993019511134463,-0.07286178273380262,25.913444422906814,-2.350251891963864,3.613298042081791,79.44811999258881,16.9385819653294,1601801949
1247146200,88.61,88.89999,87.91,88.17,NaN,NaN,86.9788,98.49739130434783,88.30451030000033,85.3574097,91.27936020000004,91.18684950000006,90.06866344253766,90.64614105625664,90.26830846153851,93.57056635593389,86.96605056714313,88.30451030000033,85.3574097,91.27936020000004,91.18684950000006,88.32666333333333,163777568,211352502.4,38.49397477452558,NaN,1.5,2.75,NaN,NaN,1.79939976275022,0.7749024314367426,169.64264859029515,-0.5270364645306416,-0.7316573633971046,-0.20462089886646304,25.242017777283515,-4.246307558644653,3.0208870886743426,81.31071865322073,15.66839425810493,1765579517
1247232600,87.7,88.49001,87.35001,87.96001,NaN,NaN,86.9576,98.62304347826087,88.15156035000032,85.44480980000002,91.29076040000004,90.84384950000006,89.98597115067344,90.39031905089887,90.16677076923082,93.65999092074054,86.6735506177211,88.15156035000032,85.44480980000002,91.29076040000004,90.84384950000006,87.93334333333333,173520256,206257814.4,37.79377305258307,NaN,1.5,2.75,NaN,NaN,1.752299779696633,0.8412784577630044,169.03525083031002,-0.5113176705975344,-0.843767987113381,-0.3324503165158466,20.26988183985361,-4.224727787456453,3.3182361994246197,80.35693365714585,16.32483014342953,1592059261
1247491800,88.31,90.17,87.59,90.10201,NaN,NaN,86.9364,98.74869565217391,88.00742045000032,85.55552990000002,91.34440060000003,90.59495000000007,89.99052169378429,90.36286104605135,90.224616923077,93.68658627515376,86.76264757100023,88.00742045000032,85.55552990000002,91.34440060000003,90.59495000000007,89.28733666666666,217413376,207909832.8,48.15364092873951,NaN,1.5,2.75,NaN,NaN,1.8114212240040164,1.045709926615842,174.21095163192894,-0.3349329959048642,-0.7511165613969268,-0.41618356549206265,26.131143623335976,-2.802578209277234,18.890891885779265,50.30116839186735,30.807939722353396,1809472637
1247578200,90.38,90.69,89.73,90.61,NaN,NaN,86.9152,98.87434782608696,87.85652050000031,85.67981990000003,91.39880060000002,90.48045050000007,90.01481496069471,90.38639808928455,90.26246307692314,93.72969588944908,86.7952302643972,87.85652050000031,85.67981990000003,91.39880060000002,90.48045050000007,90.34333333333335,181555376,205778080,50.26892445955435,NaN,1.5,2.75,NaN,NaN,1.7506054222894432,0.8822872484766113,177.8808773028901,-0.1706077566837504,-0.6294432613467507,-0.45883550466300027,25.632161851866982,-1.4573137574768933,43.28088333611603,24.304593959899233,32.41452270398474,1991028013
1247664600,91.81,93.50999,90.6795,93.25999,NaN,NaN,86.894,99,87.71857040000032,85.83821980000002,91.4464004,90.56145000000006,90.14207672694198,90.6600735093527,90.35323153846161,94.05957359929548,86.64688947762775,87.71857040000032,85.83821980000002,91.4464004,90.56145000000006,92.48316,220877808,205456020,59.54208151263621,NaN,1.5,2.75,NaN,NaN,1.8327043206973403,1.075061261285992,185.53628474847358,0.1146309469246492,-0.3155468210071888,-0.430177767931838,30.788022483202536,1.0072457489440092,78.93722533578521,3.785806623256426,17.276968040958348,2211905821
1247751000,93,94.50999,92.82001,94.14999,NaN,NaN,86.8728,99.12565217391304,87.63242035000032,86.03321980000003,91.51799999999999,90.69144950000008,90.29924979647366,90.99244650846197,90.53092307692317,94.6981795425618,86.36366661128454,87.63242035000032,86.03321980000003,91.51799999999999,90.69144950000008,93.82666333333333,231174496,205842479.2,62.09825002424051,NaN,1.5,2.75,NaN,NaN,1.8225097263618164,1.1230650587694633,188.83109418617542,0.3481234660922157,0.004976564683431661,-0.34314690140878407,31.11298525019428,4.83241287161786,80.78593200327862,3.184352372207132,16.02971562451427,2443080317
1247837400,94.06,94.32001,93.53999,94.13,NaN,NaN,86.8516,99.25130434782609,87.52312030000031,86.19971980000003,91.55777979999999,90.78700000000006,90.44947529465117,91.29126112670369,90.64092307692316,95.09688696173333,86.18495919211298,87.52312030000031,86.19971980000003,91.55777979999999,90.78700000000006,93.99666666666667,138561680,202184310.4,62.00349340102536,NaN,1.5,2.75,NaN,NaN,1.748046174478829,0.6853236026369729,188.13123997395166,0.47807553596479485,0.2544475185472095,-0.22362801741758537,24.937312680061037,4.821826280623606,83.44840001488102,2.4020104508366935,14.149589534282288,2304518637
1248096600,94.67999,95.28999,94.19,95.131,NaN,NaN,86.8304,99.37695652173913,87.41847530000032,86.38230990000002,91.6431998,90.94155050000008,90.63306449878249,91.6569505432081,90.88561538461546,95.91474554698586,85.85648522224507,87.41847530000032,86.38230990000002,91.6431998,90.94155050000008,94.87033000000001,164179376,199610500.8,64.8924234871561,NaN,1.5,2.75,NaN,NaN,1.706042162016056,0.8224986929144561,192.983908012956,0.6003857216227773,0.5268541346108861,-0.07353158701189105,24.937445042785143,8.029752441517145,84.19147181028785,2.227923013097901,13.580605176614254,2468698013
1248183000,95.87,95.89999,94.42,95.57001,NaN,NaN,86.8092,99.50260869565217,87.33707530000032,86.58181,91.69500000000002,91.25605100000007,90.82667020471258,92.02962287242637,91.134846923077,96.71639017358618,85.55330367256784,87.33707530000032,86.58181,91.69500000000002,91.25605100000007,95.29666666666667,217718256,197900735.2,66.10944177294004,NaN,1.5,2.75,NaN,NaN,1.689895579014909,1.100138692157825,194.3981215753291,0.6742611308687447,0.7692948265740398,0.09503369570529513,19.151821600283267,8.602284090909087,85.0337249541328,2.008245358230174,12.958029687637024,2686416269
1248269400,94.96001,96.13,94.89,95.55,NaN,NaN,86.788,99.62826086956522,87.26312530000033,86.7980101,91.78119980000001,91.56605050000007,91.01189882413561,92.36489688457624,91.57638538461546,97.56234865752684,85.59042211170409,87.26312530000033,86.7980101,91.78119980000001,91.56605050000007,95.52333333333333,196067568,198288629.6,65.99714203553451,NaN,1.5,2.75,NaN,NaN,1.6577601805138438,0.9887988453776676,196.37526368177743,0.6830755280193684,0.9488781057295057,0.26580257771013727,19.07379206254809,8.370193943518197,56.827800075835,14.605049512462566,28.567150411702425,2490348701
1248355800,95.61,98.08,95.53,97.661,NaN,NaN,86.7668,99.75391304347826,87.22783030000032,87.06862,91.91501980000001,91.94320050000007,91.27264788985579,92.86928765747373,92.18107769230778,98.87359272473012,85.48856265988545,87.22783030000032,87.06862,91.91501980000001,91.94320050000007,97.09033333333333,258795504,200649523.2,71.49785118359497,NaN,1.5,2.75,NaN,NaN,1.721491596191426,1.289788781317174,202.3883213686035,0.7850880904379175,1.2471626907575342,0.46207460031961667,20.06369107401202,11.028864139510675,58.72994456709531,13.425823428433251,27.844232004471458,2749144205
1248442200,97.2,98.14,96.69,98.06,NaN,NaN,86.7456,99.8795652173913,87.21798030000032,87.34851989999999,92.10262000000003,92.24220050000008,91.53881856084183,93.36364121390481,92.95030846153855,99.86635113177974,86.03426579129737,87.21798030000032,87.34851989999999,92.10262000000003,92.24220050000008,97.63,154003008,194379126.4,72.4064662384939,NaN,1.5,2.75,NaN,NaN,1.70209933932061,0.7922816140406319,205.12202184224174,0.8291225751871997,1.4984778193036163,0.6693552441164167,18.88901677059053,8.832200302745738,78.38025914022737,4.01942712148144,17.60031373829118,2903147213
1248701400,97.88,98.39999,97.34,98.35001,NaN,NaN,86.7244,100.00521739130434,87.22218040000033,87.61471999999999,92.28082020000004,92.56770100000008,91.80592410747549,93.83853347924722,93.74646307692316,100.58220319921091,86.91072295463542,87.22218040000033,87.61471999999999,92.28082020000004,92.56770100000008,98.03000000000002,159259376,193963144.8,73.07825131496163,NaN,1.5,2.75,NaN,NaN,1.656234386511995,0.8210806035559802,208.16871725550124,0.8256639383787279,1.7014351670898265,0.8757712287110986,17.317726980337792,8.542114556892173,77.12425057109581,4.4205408751243995,18.45520855377978,3062406589
1248787800,97.66,98.37,97.06,97.89,NaN,NaN,86.7032,100.1308695652174,87.25813040000031,87.90562,92.46442000000005,92.82720100000009,92.04451531894703,94.22438743360462,94.49415538461547,100.83494527394605,88.15336549528489,87.25813040000031,87.90562,92.46442000000005,92.82720100000009,97.77333333333331,186685680,194873366.4,70.16045862394711,NaN,1.5,2.75,NaN,NaN,1.6315033589039956,0.9579845796721455,207.22330448335643,0.7428724611824149,1.8043618051891173,1.0614893440067024,18.932365920820335,4.964626309739041,48.33596467776485,20.33108676541326,31.3329485568219,2875720909
1248874200,97.44,98.088,96.98,97.65199,NaN,NaN,86.682,100.25652173913043,87.30389035000032,88.1929399,92.59285980000006,93.11230050000009,92.26441628683146,94.55082577326132,95.2396923076924,100.5230300630297,89.9563545523551,87.30389035000032,88.1929399,92.59285980000006,93.11230050000009,97.57332999999998,194399312,193148922.4,68.63354203683039,NaN,1.5,2.75,NaN,NaN,1.5941102618394236,1.0064737073573236,203.65798002946187,0.6271711273654204,1.8454532532134778,1.2182821258480574,14.070510639012243,3.7195967838127175,48.10230875180333,20.506225327377727,31.391465920818952,2681321597
1248960600,98.83,99.83,98.60001,98.67,NaN,NaN,86.6608,100.38217391304347,87.29049030000031,88.4985399,92.74385980000007,93.4293005000001,92.51561564813218,94.94312808056976,95.89876846153855,100.55440727398563,91.24312964909147,87.29049030000031,88.4985399,92.74385980000007,93.4293005000001,99.03333666666667,225575376,195775638.4,71.49139800824078,NaN,1.5,2.75,NaN,NaN,1.6358173859937506,1.1522137169034,209.71694950546282,0.5756346003398378,1.9378253762728548,1.362190775933017,14.189772244311513,4.823116965898233,46.16973190071313,21.985732505844226,31.844535593442647,2906896973
1249047000,98.64999,99.47,98.38,98.81,NaN,NaN,86.6396,100.50782608695653,87.28529025000033,88.76493989999999,92.90986000000008,93.8793005000001,92.76245425016621,95.31140159670598,96.52953769230778,100.28250783842536,92.77656754619021,87.28529025000033,88.76493989999999,92.90986000000008,93.8793005000001,98.88666666666666,207357936,195528044.8,71.87096666355087,NaN,1.5,2.75,NaN,NaN,1.5968304298513403,1.0605022732779865,212.88367794568066,0.5096724263373733,1.9992813088547337,1.4896088825173603,14.013906743927972,3.867298777475273,49.54150200817425,19.440090405557907,31.01840758626785,3114254909
1249306200,99.85001,100.53,99.31,100.44,NaN,NaN,86.6184,100.63347826086957,87.33739025000031,89.04293990000001,93.13445980000007,94.41130050000011,93.06353447564989,95.79983953987684,97.08184615384624,100.86080588262043,93.30288642507206,87.33739025000031,89.04293990000001,93.13445980000007,94.41130050000011,100.09333333333332,175776880,195591910.4,75.89503365423255,NaN,1.5,2.75,NaN,NaN,1.6056282562905302,0.8986919737146757,218.80638268022122,0.5320530549721174,2.154675201232507,1.6226221462603898,15.216867132840164,5.0957303446970466,51.58092519398874,18.017581199177204,30.40149360683404,3290031789
1249392600,99.99001,100.84,99.78,100.7,NaN,NaN,86.5972,100.7591304347826,87.37204025000032,89.2949399,93.36805980000007,95.04330050000011,93.36300371189891,96.26652148846,97.58569307692316,101.41299573891014,93.75839041493619,87.37204025000032,89.2949399,93.36805980000007,95.04330050000011,100.43999999999998,176714496,194573191.2,76.47318814149776,NaN,1.5,2.75,NaN,NaN,1.5666548094126351,0.9082160543810828,221.46965571463093,0.519989155314335,2.2726085904033084,1.7526194350889734,15.300651877453404,5.38984824699111,77.75634945272644,4.2069945926529,18.03665595462065,3466746285
1249479000,100.77,100.855,99.58,100.41,NaN,NaN,86.576,100.88478260869566,87.40804020000033,89.5381399,93.55025980000006,95.66380050000012,93.63935650751073,96.66113848955905,98.0687700000001,101.60356279309376,94.53397720690644,87.40804020000033,89.5381399,93.55025980000006,95.66380050000012,100.28166666666668,184726368,191406984.8,74.33167557474954,NaN,1.5,2.75,NaN,NaN,1.5458223230260189,0.9650973196877818,219.58366472172656,0.4506836266112717,2.315973968353063,1.8652903417417914,15.718697905359125,2.814839086226841,78.22888624312847,4.040762378058315,17.730351378813207,3282019917
1249565400,100.87,101.02,99.42,99.89,NaN,NaN,86.5548,101.0104347826087,87.41344020000031,89.7784399,93.75465980000007,96.24980050000012,93.88447978172599,96.96864910960105,98.43484692307703,101.64790663694681,95.22178720920725,87.41344020000031,89.7784399,93.75465980000007,96.24980050000012,100.11,193203744,192878293.6,70.51835236465129,NaN,1.5,2.75,NaN,NaN,1.5496921570955886,1.001687335541629,216.58577516869897,0.33342800228678504,2.2820753446002726,1.9486473423134876,12.404330555723282,1.866204364674687,48.38576110179898,20.33390841125892,31.28033048694211,3088816173
1249651800,100.94,102.03,100.39,101.202,NaN,NaN,86.53359999999999,101.13608695652174,87.44015020000032,90.00865999999998,93.96029980000007,96.91190000000012,94.1714413589132,97.37182538487714,98.86807692307704,101.93462571652964,95.80152812962444,87.44015020000032,90.00865999999998,93.96029980000007,96.91190000000012,101.20733333333334,220684368,195236499.2,74.1251568035197,NaN,1.5,2.75,NaN,NaN,1.5918570030173325,1.1303438081725243,222.2782487364153,0.3084189308085268,2.334171005824146,2.0257520750156193,13.864775074937205,2.8998370208604967,49.512726135117745,19.5002199663193,30.98705389856297,3309500541
1249911000,100.74001,101.22,100.27,100.99001,NaN,NaN,86.5124,101.26173913043479,87.49190025000033,90.21926019999997,94.12950000000008,97.45630000000011,94.43883620758326,97.71641439584123,99.28653923076935,101.87519027600749,96.69788818553121,87.49190025000033,90.21926019999997,94.12950000000008,97.45630000000011,100.82667,130898624,190910761.6,72.58006454152263,NaN,1.5,2.75,NaN,NaN,1.5460100742303804,0.6856534587309508,220.6120796564642,0.24457879778247937,2.3314755722437184,2.086896774461239,14.189780258491073,3.1668301154356904,28.141142913575088,39.023738635970915,32.83511845045399,3178601917
1249997400,100.53999,100.61,99.46001,99.73,NaN,NaN,86.49119999999999,101.38739130434783,87.53210025000033,90.42716019999996,94.22870000000006,97.9123000000001,94.64633282689373,97.90818445338016,99.44569307692319,101.86380496692996,97.02758118691642,87.53210025000033,90.42716019999996,94.22870000000006,97.9123000000001,99.93333666666666,157301008,189698043.2,64.03614287773743,NaN,1.5,2.75,NaN,NaN,1.544866497499639,0.8292178735557986,216.32089267448757,0.09230708033744461,2.202280624883045,2.1099735445456003,16.242391328422503,2.1279750673795856,8.779224285223597,67.16107710597578,24.059698608800634,3021300909
1250083800,99.56,101.56,99.50999,100.8,NaN,NaN,86.47,101.51304347826087,87.60090030000032,90.66806009999995,94.34769980000006,98.28930050000011,94.88765310819201,98.18359545782015,99.65646230769242,102.03198530190403,97.28093931348081,87.60090030000032,90.66806009999995,94.34769980000006,98.28930050000011,100.62333000000001,219052368,189606771.2,67.53153667804169,NaN,1.5,2.75,NaN,NaN,1.5809481762496647,1.1552982344124216,220.39736750684256,0.041075902392546215,2.161318422536283,2.1202425201437367,16.7073289402987,2.1587108543630236,33.289899003493716,33.58116936391839,33.12893163258789,3240353277
1250170200,101.25999,101.61,100.25999,101.57001,NaN,NaN,86.4488,101.63869565217391,87.68900035000031,90.86156019999994,94.50610020000008,98.6603015000001,95.14970631963546,98.50611112850395,99.90415461538473,102.35348003396307,97.45482919680639,87.68900035000031,90.86156019999994,94.50610020000008,98.6603015000001,101.14666666666666,176449504,186870521.6,69.80584820753934,NaN,1.5,2.75,NaN,NaN,1.5644525922318313,0.9442340209104442,224.05620567956808,0.03662231887014711,2.1660204187314207,2.1293980998612736,16.344150194641134,2.7932496710859165,62.13783690981682,11.442089583287336,26.42007350689585,3416802781
1250256600,101.52,101.60001,99.7,100.78999,NaN,NaN,86.4276,101.76434782608696,87.72415035000033,91.06345999999994,94.63130000000008,98.99330100000012,95.37089391494386,98.72362340197976,100.12723076923088,102.31660023718305,97.9378613012787,87.72415035000033,91.06345999999994,94.63130000000008,98.99330100000012,100.69666666666667,199691248,189927000,64.85027287479735,NaN,1.5,2.75,NaN,NaN,1.588420978500986,1.0514105314147015,219.5727143039486,-0.03728127361331168,2.082796507844634,2.1200777814579457,17.44563662889142,0.34845679012346215,29.321352218910587,37.72466144818319,32.95398633290621,3217111533
1250515800,98.85001,98.95,98.11501,98.31,NaN,NaN,86.4064,101.89,87.75030035000033,91.23205999999993,94.70650000000009,99.1522510000001,95.48615297710293,98.6842306970293,100.17784692307701,102.1562344200043,98.19945942614973,87.75030035000033,91.23205999999993,94.70650000000009,99.1522510000001,98.45833666666665,237892624,193612662.4,52.169450694475856,NaN,1.5,2.75,NaN,NaN,1.6660323371794874,1.2287038515513953,211.39882294181268,-0.25924378020174155,1.7960230562057689,2.0552668364075104,20.755256971656923,-2.373386295928501,21.75288079199867,46.463048722545466,31.784070485455864,2979218909
1250602200,98.53,99.44,98.35001,99.09,NaN,NaN,86.3852,102.01565217391304,87.76425035000032,91.39185999999992,94.8051000000001,99.32825050000011,95.6274803113342,98.72287539255032,100.2101546153847,102.10076256724992,98.31954666351947,87.76425035000032,91.39185999999992,94.8051000000001,99.32825050000011,98.96000333333332,173461440,191399821.6,55.14056115124467,NaN,1.5,2.75,NaN,NaN,1.627744313095238,0.9062779607104922,216.62695198893206,-0.3537352895186916,1.6130977245091458,1.9668330140278374,21.410868540900143,-1.3146100985957507,43.18272353959157,24.37888959841589,32.438386861992534,3152680349
1250688600,98.31,100.3,98.21001,99.96001,NaN,NaN,86.364,102.1413043478261,87.77990040000032,91.57536009999993,94.91150020000008,99.5487510000001,95.79738343637992,98.84069773611695,100.298616923077,102.01883173372553,98.57840211242848,87.77990040000032,91.57536009999993,94.91150020000008,99.5487510000001,99.49000666666666,192812752,191237080.8,58.25534978256794,NaN,1.5,2.75,NaN,NaN,1.6607618621598639,1.0082393602402238,219.31666719713434,-0.356826584012921,1.520799784011686,1.877626368024607,22.181675260988026,0.07008709580538228,41.42000318304844,25.85984563248571,32.72015118446584,3345493101
1250775000,100.09,101.22,99.87,100.99001,NaN,NaN,86.3428,102.26695652173913,87.79930045000032,91.79736029999992,95.0433006000001,99.7152015000001,96.00101585063953,99.04539414220105,100.34092538461547,102.09959331308012,98.58225745615083,87.79930045000032,91.79736029999992,95.0433006000001,99.7152015000001,100.69333666666667,174131248,187003868,61.650306955000026,NaN,1.5,2.75,NaN,NaN,1.6385645862913019,0.9311638837331428,223.63600932504113,-0.2914444758094188,1.5133207732628335,1.8047652490722523,22.735504792089046,-0.20947214481927248,41.20300099461151,26.04564513011665,32.75135387527185,3519624349
1250861400,101.82001,103.13,101.62,102.97,NaN,NaN,86.3216,102.39260869565217,87.81210045000033,92.03186029999992,95.20630040000009,99.9607015000001,96.27430934669289,99.41916612865809,100.51554076923085,102.76455345512105,98.26652808334066,87.81210045000033,92.03186029999992,95.20630040000009,99.9607015000001,102.57333333333335,224604944,190533964.8,67.17653011978906,NaN,1.5,2.75,NaN,NaN,1.6743806872704943,1.178818402460494,228.79352810833217,-0.1252816001324093,1.6481632489067408,1.7734448490391501,24.20293133577596,1.9605800613347804,72.00734152807173,6.448769738916972,21.543888733011304,3744229293
1251120600,103.39,103.95,102.59,102.96001,NaN,NaN,86.3004,102.51826086956522,87.84595050000033,92.25086039999992,95.3639006000001,100.19120150000008,96.53649368603827,99.75638935450017,100.71169538461547,103.30771502627917,98.11567574295177,87.84595050000033,92.25086039999992,95.3639006000001,100.19120150000008,103.16667000000002,191278880,192134940,67.123973024376,NaN,1.5,2.75,NaN,NaN,1.6519249238940303,0.9955444855579105,229.45924713178113,-0.031372156900339565,1.7342296529137258,1.7656018098140653,24.114434299350922,3.2387546375213003,78.69686619971436,3.9964158475752134,17.306717952710436,3552950413
1251207000,103.37,104.25999,102.94,103.16,NaN,NaN,86.2792,102.64391304347826,87.90745050000032,92.44816049999991,95.56910080000009,100.45470150000007,96.79623903168383,100.08054274930969,100.96323384615393,103.81329537585798,98.11317231644988,87.90745050000032,92.44816049999991,95.56910080000009,100.45470150000007,103.45333000000001,215310560,193566184,67.66929924704013,NaN,1.5,2.75,NaN,NaN,1.6282152864730286,1.1123356133321303,231.8500188636042,0.025799283004544815,1.7978509135697465,1.7720516305652017,22.298724114906975,2.341269841269841,79.92055911278088,3.5776757017187975,16.50176518550032,3768260973
1251293400,102.84,103.64,102.49001,103.17,NaN,NaN,86.258,102.7695652173913,87.9540005000003,92.63726059999992,95.79970080000008,100.73060200000006,97.04619044220603,100.37477677318495,101.11461846153854,104.19877886385825,98.03045805921883,87.9540005000003,92.63726059999992,95.79970080000008,100.73060200000006,103.10000333333333,194620624,193577249.6,67.69815157310165,NaN,1.5,2.75,NaN,NaN,1.5940563374392411,1.0053899639660961,230.61679814802514,0.04476351307288229,1.8280060219063046,1.7832425088334223,21.856110063881648,1.575258287362584,80.10417851714351,3.5166399219076077,16.379181560948897,3962881597
1251379800,103.11,103.72,101.94,103.39999,NaN,NaN,86.2368,102.89521739130434,88.00785045000032,92.83526039999991,96.03670060000007,100.96710150000006,97.29535905231559,100.66289231859591,101.30000153846161,104.61313502161855,97.98686805530468,88.00785045000032,92.83526039999991,96.03670060000007,100.96710150000006,103.01999666666666,196230000,192109980.8,68.39669254881372,NaN,1.5,2.75,NaN,NaN,1.6073380276221525,1.0214461486219668,231.8349405730896,0.05272329069745374,1.8491466222052395,1.7964233315077858,21.597142795491447,2.5895428702790815,80.69756131336734,3.322626960935047,15.979811725697587,4159111597
1251466200,104.23,104.35001,102.67,103.38,NaN,NaN,86.2156,103.0208695652174,88.07590045000032,93.05256049999991,96.25992080000007,101.19560150000007,97.53397242281302,100.92166447872962,101.58077076923085,104.93253057693951,98.22901096152219,88.07590045000032,93.05256049999991,96.25992080000007,101.19560150000007,103.46667000000001,147024368,189093302.4,68.2585237673993,NaN,1.5,2.75,NaN,NaN,1.6125288827919986,0.7775228743374043,230.87469168760316,0.03729511938049357,1.8430422307334027,1.805747111352909,20.806205003704907,5.157155935306676,58.04003008966347,14.071177949880925,27.888791960455595,4012087229
1251725400,102.37,102.58,101.78999,102.46001,NaN,NaN,86.1944,103.14652173913043,88.15910045000031,93.25186059999992,96.46832120000006,101.29660200000005,97.72715036701643,101.06817357599347,101.70846384615393,105.05799615444951,98.35893153785835,88.15910045000031,93.25186059999992,96.46832120000006,101.29660200000005,102.27666666666667,176051568,189107036.8,62.04631794656656,NaN,1.5,2.75,NaN,NaN,1.610920391163998,0.9309625436423739,226.66036334487976,-0.04950429555586444,1.7438667419080787,1.793371037463943,14.0219978943144,3.4009587243919603,57.5509919064713,14.134944272989323,28.31406382053937,3836035661
1251811800,101.95,103.24001,99.99001,100.2,NaN,NaN,86.1732,103.27217391304347,88.20425045000033,93.39576059999992,96.68672120000006,101.27160200000004,97.82412486242755,100.9854903782798,101.60307846153856,105.04824704738184,98.15790987569528,88.20425045000033,93.39576059999992,96.68672120000006,101.27160200000004,101.14334000000001,321276672,196335145.6,50.00633418899432,NaN,1.5,2.75,NaN,NaN,1.7279975060808552,1.6363686237539328,221.49686020206263,-0.2618917701075827,1.4660063248294648,1.7278980949370475,20.329107628174317,0.24008601039556313,20.88301973931125,47.76416767983693,31.35281258085182,3514758989
1251898200,99.78,100.44,99.57001,99.82001,NaN,NaN,86.152,103.39782608695653,88.27025050000033,93.53566069999992,96.89612120000007,101.24210250000004,97.90239486782255,100.87449224701506,101.5284646153847,105.08117550901798,97.97575372175143,88.27025050000033,93.53566069999992,96.89612120000007,101.24210250000004,99.94333999999999,171805008,195689077.6,48.308935565404596,NaN,1.5,2.75,NaN,NaN,1.6667112556465085,0.8779488876286675,218.9027492243468,-0.42128631636171665,1.2012901994849017,1.6225765158466183,19.87730814108556,-1.1585304328616284,5.210459056920994,75.14600395149556,19.64353699158345,3342953981
1251984600,100.39999,100.77,99.59,100.64999,NaN,NaN,86.1308,103.52347826086957,88.34615045000034,93.69866049999992,97.10676100000006,101.28010200000004,98.0101436965354,100.85311108063267,101.70846384615393,104.79753687236314,98.61939081994473,88.34615045000034,93.69866049999992,97.10676100000006,101.28010200000004,100.33666333333333,143572256,193207503.2,52.13096186211829,NaN,1.5,2.75,NaN,NaN,1.6319461659574714,0.7430987597380225,223.3897675364705,-0.46093254087899216,1.0464108397478782,1.5073433806268703,19.530279958908732,-2.253093133922498,2.879585784612243,81.87724178987025,15.243172425517491,3486526237
1252071000,100.85001,102.09,100.55,102.06,NaN,NaN,86.1096,103.6491304347826,88.42105045000034,93.86676049999991,97.30636100000007,101.32300200000006,98.16896159078891,100.96805288247718,101.93692538461548,104.63172970225392,99.24212106697703,88.42105045000034,93.86676049999991,97.30636100000007,101.32300200000006,101.56666666666666,142687808,189307675.2,57.83485108926185,NaN,1.5,2.75,NaN,NaN,1.6253785826747953,0.75373493361668,228.41696628654267,-0.3853777985987388,1.025621132378447,1.4109989309771858,17.66389776224947,-0.8741355017350859,12.743332031080413,59.84249773987932,27.414170229040273,3629214045
1252416600,103,103.05,102.39,102.94,NaN,NaN,86.0884,103.77478260869566,88.52825045000033,94.03116049999991,97.52836100000006,101.42050150000004,98.35606113624817,101.1558573698603,102.16615538461548,104.64785856200183,99.68445220722913,88.52825045000033,94.03116049999991,97.52836100000006,101.42050150000004,102.79333333333334,132909008,189408194.4,60.961337026706374,NaN,1.5,2.75,NaN,NaN,1.5799943981980238,0.7017067472768221,233.24051961025194,-0.2745236726251048,1.0678443401958049,1.3423680128209097,18.487523404590767,-0.21326095385808344,29.546877813308626,37.296537385238445,33.15658480145292,3762123053
1252503000,103.12,104.08,102.8,103.73,NaN,NaN,86.0672,103.9004347826087,88.66965045000032,94.19766049999991,97.74896100000005,101.62050150000005,98.56680383678746,101.40101381082599,102.37692384615394,104.88850031617307,99.86534737613482,88.66965045000032,94.19766049999991,97.74896100000005,101.62050150000005,103.53666666666668,154612496,189273768.8,63.572653343174736,NaN,1.5,2.75,NaN,NaN,1.558566226898165,0.8168722849460162,237.01070338750813,-0.15247362803970388,1.1517759777712797,1.3042496058109836,18.990535764881674,0.5427934477076691,73.3080226672539,5.907183523900414,20.784793808845695,3916735549
1252589400,103.8,104.86,103.22,104.78999,NaN,NaN,86.04599999999999,104.02608695652174,88.79600040000032,94.4112604999999,98.00576080000006,101.82000100000006,98.81085035299188,101.72377344789018,102.51692307692316,105.32993705999036,99.70390909385597,88.79600040000032,94.4112604999999,98.00576080000006,101.82000100000006,104.28999666666665,162902368,186466268.8,66.78321829090766,NaN,1.5,2.75,NaN,NaN,1.5643829249768675,0.8736291504536181,241.97372453871918,-0.012226614290059556,1.288966337948409,1.3011929522384686,19.763947233184883,1.3442941338775762,99.99999999999999,0,0,4079637917
1252675800,104.99001,105.3,104.28,104.77,NaN,NaN,86.0248,104.15173913043478,88.89470040000033,94.6083604999999,98.25456080000008,101.98000050000007,99.0445424960118,102.01389026237683,102.65615307692316,105.71181262381675,99.60049353002957,88.89470040000033,94.6083604999999,98.25456080000008,101.98000050000007,104.78333333333332,152383632,185262975.2,66.66389086058334,NaN,1.5,2.75,NaN,NaN,1.5254984303356625,0.8225260974865312,242.60427220658084,0.06317999334723745,1.3801679439225154,1.316987950575278,19.782652207159753,1.3445540723544211,75.94900400005454,4.860573523312882,19.190422476632577,3927254285
1252935000,103.88,105.46001,103.14999,105.28,NaN,NaN,86.00359999999999,104.27739130434783,88.99280040000032,94.81576059999992,98.56396080000006,102.20450100000008,99.28907024126624,102.32494833262666,102.81923000000008,106.17644576461805,99.4620142353821,88.99280040000032,94.81576059999992,98.56396080000006,102.20450100000008,104.63,149593744,182758100,68.22386049009516,NaN,1.5,2.75,NaN,NaN,1.581535685311686,0.8185341388425466,245.82774930401789,0.12767167528677725,1.4765775446837495,1.3489058693969722,19.853570914451172,2.752283549455055,76.42409759378461,4.683558713091859,18.892343693123554,4076848029
1253021400,105.45,106.11,104.75999,105.72,NaN,NaN,85.9824,104.40304347826087,89.07655040000033,95.01926059999991,98.88236080000006,102.57500100000009,99.54126356513815,102.64828658666222,103.01538384615392,106.71243681743505,99.3183308748728,89.07655040000033,95.01926059999991,98.88236080000006,102.57500100000009,105.52999666666666,196795872,180703262.4,69.54785535811236,NaN,1.5,2.75,NaN,NaN,1.564998136360851,1.0890554458523156,250.2802274233924,0.17718310668094572,1.5703847527481543,1.3932016460672085,18.645272344384395,5.508982035928139,78.65861989185419,3.8850349587877413,17.45634514935807,4273643901
1253107800,106.10001,107.34,105.72881,107.32001,NaN,NaN,85.96119999999999,104.52869565217391,89.16270045000032,95.2258606999999,99.26756100000006,102.98650150000007,99.84631244493666,103.09321262602772,103.31692384615393,107.67128483558757,98.96256285672028,89.16270045000032,95.2258606999999,99.26756100000006,102.98650150000007,106.79627333333333,206406256,182350503.2,73.819691889884,NaN,1.5,2.75,NaN,NaN,1.5689268409065047,1.1319204081033762,256.4209385657059,0.28833502826604684,1.7536204313997672,1.4652854031337204,10.59360895966254,7.5135235911116425,80.27204872104853,3.3507916785768903,16.377159600374572,4480050157
1253194200,107.17,108.06,106.57001,107.16,NaN,NaN,85.94,108.06,89.28795045000032,95.4390606999999,99.65076100000006,103.34650100000007,100.13312372160581,103.48052570926318,103.60769307692317,108.42074078613602,98.79464536771032,89.28795045000032,95.4390606999999,99.65076100000006,103.34650100000007,107.26333666666666,229170880,184168409.6,72.7210254781326,NaN,1.5,2.75,NaN,NaN,1.5632884951274693,1.244354992790251,254.15124361890906,0.31931770900280254,1.8644325393872236,1.545114830384421,9.798488198813791,6.4679688492765814,47.247892857780556,21.17028146276285,31.58182567945659,4250879277
1253280600,107.14999,107.16,106.36,106.72,NaN,NaN,85.9188,108.23573529411765,89.39520045000032,95.65056059999989,100.02176100000005,103.63300050000007,100.39143259526833,103.78904707028573,103.9353846153847,108.96639482370442,98.90437440706499,89.39520045000032,95.65056059999989,100.02176100000005,103.63300050000007,106.74666666666667,153799056,183151800,69.65120832097189,NaN,1.5,2.75,NaN,NaN,1.5087678883326496,0.8397354325756012,256.5161099137749,0.2798316020489662,1.8949043329456288,1.6150727308966626,11.651475198828678,4.565941602978636,46.863518242617886,21.465117399017956,31.671364358364173,4097080221
1253539800,105.89,107,105.66,106.45,NaN,NaN,85.8976,108.41147058823529,89.49085040000033,95.84116059999991,100.39156080000006,103.80700050000007,100.62902347388525,104.04247115882995,104.41615384615395,109.11071179841247,99.72159589389543,89.49085040000033,95.84116059999991,100.39156080000006,103.80700050000007,106.37,151892000,179516152.8,67.76092199713791,NaN,1.5,2.75,NaN,NaN,1.496713039166032,0.846118845746565,253.21440814530746,0.20845816117598104,1.875645432366639,1.667187271190658,11.308683505835651,3.4097532543229114,25.546589935412452,41.83535356865022,32.61805649593733,3945188221
1253626200,107.08,107.37,106.60001,107.07001,NaN,NaN,85.8764,108.58720588235295,89.59970045000033,96.0376606999999,100.73092080000008,104.01250050000007,100.88161118079171,104.33080819132233,104.97384615384625,109.03118467873801,100.91650762895449,89.59970045000033,96.0376606999999,100.73092080000008,104.01250050000007,107.01334000000001,143126624,177108540,69.788558049759,NaN,1.5,2.75,NaN,NaN,1.4555192506541725,0.8081294329454695,257.20383077994353,0.17716311153067021,1.8886411606039957,1.7114780490733255,11.025037765338059,3.2199074520389397,21.66775665056173,46.620760967639804,31.71148238179845,4088314845
1253712600,107.32001,108.03,105.99001,106.17999,NaN,NaN,85.8552,108.76294117647059,89.69095045000033,96.22056059999991,101.04232060000008,104.16350000000008,101.08939074232929,104.50692074452974,105.39923076923088,108.62928962597015,102.16917191249162,89.69095045000033,96.22056059999991,101.04232060000008,104.16350000000008,106.73333333333335,225947312,177640377.6,63.60440354956074,NaN,1.5,2.75,NaN,NaN,1.4972671613217319,1.2719366793329763,253.64413576893085,0.0758585818122548,1.806301276338644,1.730442694526389,12.73727861686442,1.326462575289873,3.1227576609814984,81.00810668900768,15.869135650010815,3862367533
1253799000,106.41,106.64,104.55,105.00999,NaN,NaN,85.834,108.93867647058823,89.76100040000033,96.36186049999993,101.27732060000008,104.25549950000008,101.24313973282618,104.55483210219357,105.62615307692319,108.24206817883261,103.01023797501377,89.76100040000033,96.36186049999993,101.27732060000008,104.25549950000008,105.39999666666667,228636688,179341180.8,56.5146965796478,NaN,1.5,2.75,NaN,NaN,1.5396052212273226,1.2748699823437317,248.80129311197823,-0.08205654942958107,1.6278720077394127,1.7099285571689937,13.749598445550562,0.22906366326238994,3.1606731915604316,80.88616369449772,15.953163113941848,3633730845
1253885400,104.78,105.36,104.09,104.45,NaN,NaN,85.8128,109.11441176470589,89.83575040000032,96.50066039999994,101.48332080000007,104.30800000000008,101.36889895898986,104.54484809246085,105.74230692307704,107.97715772286698,103.5074561232871,89.83575040000032,96.50066039999994,101.48332080000007,104.30800000000008,104.63333333333331,204058944,179732628,53.44411871824523,NaN,1.5,2.75,NaN,NaN,1.5203477054253707,1.135347244797422,246.87713590624347,-0.2280595002746968,1.4248541818256228,1.6529136821003196,14.117105612515179,-0.7883738601823692,2.8447039165749675,81.92377090138203,15.231525182042999,3429671901
1254144600,104.85001,106.55,104.83,106.32001,NaN,NaN,85.7916,109.29014705882354,89.91680045000032,96.64245039999994,101.72712100000008,104.45500050000007,101.56306017628438,104.7139111312741,105.94153846153857,107.86312945554714,104.01994746753,89.91680045000032,96.64245039999994,101.72712100000008,104.45500050000007,105.90000333333334,118285744,178295696.8,61.053883213716134,NaN,1.5,2.75,NaN,NaN,1.5617514407521296,0.6634245588814457,252.4092036557297,-0.20334569447297812,1.398731564009097,1.602077258482075,17.3906174402195,0.567546348846006,10.511390571776003,63.63025778875123,25.858351639472776,3547957645
1254231000,106.50999,107.02,105.78,106,NaN,NaN,85.7704,109.46588235294118,90.00710045000032,96.79385039999994,101.94450100000007,104.63200000000009,101.7370578164301,104.83639578543847,106.03461615384626,107.83763864063141,104.2315936670611,90.00710045000032,96.79385039999994,101.94450100000007,104.63200000000009,106.26666666666667,133733808,176179808.8,59.26852610927636,NaN,1.5,2.75,NaN,NaN,1.53876919498412,0.759075679051367,251.16398809296444,-0.21222396561959633,1.3367973014575796,1.549021267077176,17.39749993784715,-1.2299756587797526,1.968437749704419,85.09132068785682,12.940241562438755,3414223837
1254317400,106.36,106.46001,104.62,105.59,NaN,NaN,85.7492,109.64161764705882,90.09010040000032,96.91995039999995,102.14490080000007,104.9015000000001,101.8881535883348,104.9081676153967,106.09769307692318,107.7721251704383,104.42326098340806,90.09010040000032,96.91995039999995,102.14490080000007,104.9015000000001,105.55667000000001,254382944,172835122.4,56.96993094981252,NaN,1.5,2.75,NaN,NaN,1.5602863953423967,1.471824363402655,248.6436482991953,-0.24695093638740362,1.2403325965929213,1.487283532980325,14.711044632646438,-1.4650989175065259,1.8501452684224515,85.56927242916476,12.580582302412786,3159840893
1254403800,105.34,105.73309,102.95,103,NaN,NaN,85.728,109.81735294117647,90.16635040000033,97.03755029999995,102.29390080000006,105.0604995000001,101.93175540840011,104.7264373663113,105.92230846153856,108.25200324009433,103.5926136829828,90.16635040000033,97.03755029999995,102.29390080000006,105.0604995000001,103.89436333333333,281840640,178336904,45.07689039009059,NaN,1.5,2.75,NaN,NaN,1.647629509960797,1.5803831606272587,242.9481591638156,-0.43461858209943527,0.9440103053560307,1.378628887455466,19.827745588150467,-3.4857571214392795,1.6672539092157006,86.33671607029645,11.99603002048784,2878000253
1254490200,102.02,103.10001,101.99001,102.49001,NaN,NaN,101.99001,109.99308823529412,90.21940045000032,97.15275039999995,102.39048100000008,105.15250050000012,101.9536477453256,104.51344428380547,105.67384769230779,108.63910917718516,102.70858620743041,90.21940045000032,97.15275039999995,102.39048100000008,105.15250050000012,102.52667666666666,224748752,182395728.8,43.166000772389594,NaN,1.5,2.75,NaN,NaN,1.609227402106454,1.2322040295496217,239.62024690535685,-0.5745766692386862,0.6604080509071082,1.2349847201457944,19.836141481901176,-3.7200469704086467,1.6107540607426072,86.58152344148597,11.807722497771417,2653251501
1254749400,102.89999,104.32001,102.60001,104.02,NaN,NaN,102.23574786885246,110.16882352941177,90.28455040000031,97.30615049999994,102.50968100000007,105.25050050000011,102.03468116707754,104.4664495901097,105.42000076923088,108.34281213454655,102.49718940391521,90.28455040000031,97.30615049999994,102.50968100000007,105.25050050000011,103.64667333333334,149874944,182755085.6,50.01230756061982,NaN,1.5,2.75,NaN,NaN,1.6249968733845643,0.8200863111849841,245.51235867721553,-0.5457981608657789,0.5527370190635708,1.0985351799293497,22.616604171359985,-2.848612790827236,2.2339444791364387,84.07619085017764,13.689864670685923,2803126445
1254835800,104.77,106.11,104.71001,105.50999,NaN,NaN,102.48148573770492,110.34455882352941,90.3656504000003,97.46685039999994,102.65288060000006,105.3790000000001,102.17096778797645,104.56583439105164,105.29307692307702,108.04067786399072,102.54547598216332,90.3656504000003,97.46685039999994,102.65288060000006,105.3790000000001,105.44333333333333,202491008,186234185.6,55.61920556696118,NaN,1.5,2.75,NaN,NaN,1.6582113824285243,1.087292364436876,250.92068559041152,-0.4140761625005609,0.5809399768036485,0.9950161393042094,24.17917508476929,-0.6310040149749512,12.491840624577252,60.130974324500954,27.377185050921785,3005617453
1254922200,105.27,105.91,105.07001,105.8,NaN,NaN,102.72722360655737,110.52029411764707,90.4537004000003,97.63775029999994,102.81108060000005,105.48250000000012,102.31328277668325,104.68337397285624,105.2223076923078,107.86462685839814,102.57998852621745,90.4537004000003,97.63775029999994,102.81108060000005,105.48250000000012,105.59333666666667,159200256,186463573.6,56.638680058898586,NaN,1.5,2.75,NaN,NaN,1.5997669979693439,0.8537874337939858,252.19674146068945,-0.30037242066412995,0.6195506134740469,0.9199230341381769,23.86093865337951,0.7523188984209933,33.54017788236207,33.15109311714203,33.308729000495894,3164817709
1255008600,106.55,107.17,105.84489,106.61,NaN,NaN,102.97296147540983,110.69602941176471,90.5514504000003,97.79155029999994,102.99024080000005,105.57350050000011,102.48178149132312,104.86686216591755,105.23461538461547,107.9010740951132,102.56815667411773,90.5514504000003,97.79155029999994,102.99024080000005,105.57350050000011,106.54163,183305744,187483742.4,59.4410455224747,NaN,1.5,2.75,NaN,NaN,1.5833550695429626,0.9777154096322327,256.44108979154345,-0.17005355446757264,0.7073560910537111,0.8774096455212838,23.192395263790427,2.0679751077070336,70.10652517223944,7.298283169374706,22.595191658385872,3348123453
1255095000,106.64,107.25999,106.36,107.25999,NaN,NaN,103.21869934426229,110.87176470588236,90.6569503500003,97.95295019999995,103.16204060000004,105.69800000000012,102.66916221715358,105.09477910249683,105.24922923076932,107.95751845961588,102.54094000192275,90.6569503500003,97.95295019999995,103.16204060000004,105.69800000000012,106.95999333333333,135008256,186614973.6,61.586468151634065,NaN,1.5,2.75,NaN,NaN,1.5345432788613225,0.7234588596807003,259.1383105833957,-0.045976058456802416,0.8199395724502807,0.8659156309070831,22.881437175364542,0.8841045067621849,99.99999999999999,0,0,3483131709
1255354200,107.75999,108.09,107.28,107.67999,NaN,NaN,103.46443721311475,111.0475,90.7620503000003,98.12465019999995,103.33944040000002,105.81799950000011,102.86566526746128,105.3409896641638,105.36461384615394,108.33665819112953,102.39256950117836,90.7620503000003,98.12465019999995,103.33944040000002,105.81799950000011,107.68333,118031008,185036836.8,62.95023116287049,NaN,1.5,2.75,NaN,NaN,1.4842194732283711,0.6378784356737339,260.85047495906616,0.05311248450351447,0.9323062365364763,0.8791937520329618,20.83334966631507,1.5848962264150979,100,0,0,3601162717
1255440600,107.39,107.7132,106.75999,107.46001,NaN,NaN,103.71017508196721,111.22323529411764,90.8635503500003,98.30715019999994,103.47984060000003,105.90500000000011,103.04583564912947,105.54280112471963,105.55307692307701,108.71586991098697,102.39028393516706,90.8635503500003,98.30715019999994,103.47984060000003,105.90500000000011,107.31106666666666,157692688,183081677.6,61.71439824994262,NaN,1.5,2.75,NaN,NaN,1.4462902251406302,0.8613242464629897,258.73045007843257,0.09038096806448215,0.9921699621135645,0.9017889940490823,20.7678710770654,1.7710105123591187,76.13262406586338,4.816209135217205,19.05116679891942,3443470029
1255527000,108.72,109.42,107.4174,109.31,NaN,NaN,103.95591295081967,111.3989705882353,90.9755503500003,98.51005019999994,103.65204060000003,106.00449950000011,103.29148915308518,105.90158196998443,105.92692307692316,109.58926336797369,102.26458278587263,90.9755503500003,98.51005019999994,103.65204060000003,106.00449950000011,108.71580000000002,191421504,182332440,67.49398770256167,NaN,1.5,2.75,NaN,NaN,1.4860266376305853,1.049848858491665,263.67658854336514,0.21884281362023517,1.1753425110743763,0.9564996974541411,22.25398287122571,6.126213592233012,77.45918741200128,4.326830286261469,18.213982301737246,3634891533
1255613400,108.78,109.71001,108.73,109.71001,NaN,NaN,104.20165081967212,111.57470588235294,91.07925040000029,98.69415029999995,103.83804080000003,106.1320000000001,103.54319585296419,106.26428940141449,106.1876923076924,110.37061050032587,102.00477411505894,91.07925040000029,98.69415029999995,103.83804080000003,106.1320000000001,109.38333999999999,173873568,179567574.4,68.59783071775638,NaN,1.5,2.75,NaN,NaN,1.4498825920855432,0.9682904532233855,263.0498053728371,0.3046955863262215,1.337369180361918,1.0326735940356966,13.166891525618125,7.044589028725823,77.31478585366733,4.378949200518224,18.30626494581444,3808765101
1255699800,108.8,109.27,108.23,108.89,NaN,NaN,104.44738868852458,111.75044117647059,91.17250035000028,98.88635029999995,104.01804080000004,106.24050000000011,103.75287444696559,106.51435707747025,106.4100000000001,110.82986370138443,101.99013629861577,91.17250035000028,98.88635029999995,104.01804080000004,106.24050000000011,108.79666666666665,192069376,181481090.4,63.81382818705023,NaN,1.5,2.75,NaN,NaN,1.4520345497937182,1.0583437402578004,259.77912219939265,0.2807879843490153,1.3836585744719656,1.1028705901229503,14.013559090121772,4.681791963084027,46.86604481045338,21.530283675629423,31.60367151391721,3616695725
1255959000,109.07001,110.13,108.73,109.78999,NaN,NaN,104.69312655737704,111.92617647058825,91.25665025000029,99.07505019999994,104.18980060000004,106.40749950000013,103.98962407649636,106.82632211771119,106.73307615384626,111.46868268589783,101.99746962179468,91.25665025000029,99.07505019999994,104.18980060000004,106.40749950000013,109.54999666666667,159530368,181863008.8,66.56949774546672,NaN,1.5,2.75,NaN,NaN,1.4483177962370235,0.8772007515582244,264.39181372137017,0.29846439108575606,1.4759510789801453,1.1774866878943893,12.981075287283817,4.05648792119116,50.20680164842915,19.061956778770792,30.73124157280006,3776226093
1256045400,109.95,109.985,108.67999,109.211,NaN,NaN,104.9388644262295,112.10191176470589,91.3384552000003,99.24186019999992,104.35422040000003,106.51454900000013,104.19438391663375,107.05343429697679,107.2108453846155,111.58282695648326,102.83886381274773,91.3384552000003,99.24186019999992,104.35422040000003,106.51454900000013,109.29199666666666,180921008,183752728,63.23332464306658,NaN,1.5,2.75,NaN,NaN,1.4380815250772359,0.984589507699717,260.592407995343,0.24621291326479677,1.4852528294753853,1.2390399162105885,12.956736231445833,3.2240075614366743,47.715579403008626,20.908081033093058,31.376339563898313,3595305085
1256131800,109.03999,110.31,108.14999,108.23,NaN,NaN,105.18460229508196,110.31,91.41225520000029,99.37646019999991,104.52422040000003,106.61704950000012,104.35264337088341,107.16548817345519,107.65238307692319,111.08701178929007,104.2177543645563,91.41225520000029,99.37646019999991,104.52422040000003,106.61704950000012,108.89666333333334,225787440,183744734.4,57.9354653030021,NaN,1.5,2.75,NaN,NaN,1.489647844714576,1.2288103968654462,257.1425913961741,0.12665459287575076,1.397358157305277,1.2707035644295261,14.812400161388286,1.5195572647969275,18.41980056262372,51.102692355734575,30.47750708164171,3369517645
1256218200,108.19,109.67999,107.5,109.33,NaN,NaN,105.43034016393442,110.40375,91.5055552000003,99.5212600999999,104.69482040000003,106.83305000000011,104.5478338269272,107.37163215693565,108.06084461538472,110.87785081276512,105.24383841800433,91.5055552000003,99.5212600999999,104.69482040000003,106.83305000000011,108.83666333333333,238443936,184235096.8,61.80023370739791,NaN,1.5,2.75,NaN,NaN,1.538957998663535,1.2942373095113764,260.8977810418994,0.10369297919860276,1.4003197884277796,1.2966268092291768,15.203757609262686,1.929899490014866,23.017370148597447,45.00896315952999,31.973666691872566,3607961581
1256304600,109.69,109.75999,107.63,108.08,NaN,NaN,105.67607803278688,110.4975,91.59074515000032,99.6655601999999,104.82502020000001,107.01455000000013,104.68635014743987,107.43909576103701,108.25853769230778,110.66211753544506,105.8549578491705,91.59074515000032,99.6655601999999,104.82502020000001,107.01455000000013,108.48999666666667,240033184,186033808.8,55.55391595175373,NaN,1.5,2.75,NaN,NaN,1.5811745701875688,1.290266460426305,256.464099248336,-0.007727851615535242,1.2869669947097577,1.294694846325293,16.94056084020407,0.37148034653420253,20.98407896645394,47.61556811001263,31.40035292353344,3367928397
1256563800,108.2,109.31,106.61,106.91,NaN,NaN,105.92181590163935,110.59125,91.6798451500003,99.7893601999999,104.94742040000001,107.04404950000011,104.77355210244222,107.3887056885573,108.34392230769241,110.45289629101381,106.234948324371,91.6798451500003,99.7893601999999,104.94742040000001,107.04404950000011,107.61000000000001,242028192,192220931.2,50.41733245822797,NaN,1.5,2.75,NaN,NaN,1.6610906723170284,1.259114657748573,252.13959942739734,-0.16362931548340542,1.090158201971036,1.2537875174544415,18.024604681596454,-0.5118276091729382,5.851422144839919,73.46227859410962,20.686299261050443,3125900205
1256650200,107.03,107.39,106.16,106.42,NaN,NaN,106.1675537704918,110.685,91.7771951500003,99.90806019999991,105.1096204,107.06504950000013,104.83811868666018,107.2964480039328,108.32930692307704,110.48818627313351,106.17042757302058,91.7771951500003,99.90806019999991,105.1096204,107.06504950000013,106.65666666666668,253266320,198197556.8,48.39900776219989,NaN,1.5,2.75,NaN,NaN,1.6302984814372412,1.2778478407560268,248.89111800080008,-0.295468810360592,0.8844515045037014,1.1799203148642934,18.151865843477136,-2.643856920684293,5.179576435711117,75.13726845764022,19.68315510664866,2872633885
1256736600,106.14999,106.4783,104.35001,104.41,NaN,NaN,106.41329163934427,110.77875,91.8636951500003,100.01056019999992,105.21602039999999,107.0060495000001,104.82132971855586,107.02154819403444,108.11007692307705,111.08381815251771,105.13633569363638,91.8636951500003,100.01056019999992,105.21602039999999,107.0060495000001,105.07943666666665,248821376,197919478.4,41.126024883858946,NaN,1.5,2.75,NaN,NaN,1.6658693041917245,1.2571848815058315,240.50959069367997,-0.5016449008731594,0.552864188772844,1.0545090896460034,16.808814429432513,-4.830926548999494,5.050444348251594,75.47028546197332,19.479270189775097,2623812509
1256823000,105.19,106.86,104.94,106.64999,NaN,NaN,106.65902950819672,110.8725,91.9750951000003,100.13066009999991,105.34982,107.18854900000011,104.89304188645563,106.98616169936449,108.03084615384628,111.09957008273557,104.962122224957,91.9750951000003,100.13066009999991,105.34982,107.18854900000011,106.14999666666667,198110560,193732974.4,50.12150158597189,NaN,1.5,2.75,NaN,NaN,1.7218786396066015,1.022595975793783,246.34878189162458,-0.4712378547864542,0.46546177116293563,0.9366996259493898,22.12900409160627,-2.0571310496831647,3.507817994280731,79.79906917549522,16.693112830224052,2821923069
1256909400,106.3,106.62,103.44,103.56,NaN,NaN,106.90476737704918,110.96625,92.07089515000031,100.22226019999991,105.40121979999999,107.2420485000001,104.8407657340456,106.6598605851393,107.7308453846155,111.61763055846838,103.84406021076263,92.07089515000031,100.22226019999991,105.40121979999999,107.2420485000001,104.54,325607936,198775933.6,40.84933036872066,NaN,1.5,2.75,NaN,NaN,1.82817230820613,1.6380651827561081,239.02828029748886,-0.6332118950596415,0.14518475712483792,0.7783966521844794,26.868935272311596,-5.674460850210479,3.0898092214793076,81.11462106562121,15.79556971289948,2496315133
1257172200,104.13,105.41,103.08,104.32001,NaN,NaN,103.08,111.06,92.1671952000003,100.31726019999991,105.42822,107.2570490000001,104.82034394055361,106.4370176722689,107.34700000000012,111.50994111271628,103.18405888728397,92.1671952000003,100.31726019999991,105.42822,107.2570490000001,104.27000333333335,254489744,204006673.6,43.61237613960776,NaN,1.5,2.75,NaN,NaN,1.8640171433342636,1.247457936101557,240.56834356625248,-0.6601345026892629,-0.0467714761770992,0.6133630265121637,26.708183777861397,-4.478477442748443,15.313041395496082,55.60531615617154,29.081642448332392,2750804877
1257258600,103.74001,104.8,103.53999,104.64999,NaN,NaN,103.13190428571428,111.15375,92.2875951000003,100.4129600999999,105.4620196,107.21404900000009,104.81366339386524,106.26682456062424,106.95776769230783,111.11036759039801,102.80516779421764,92.2875951000003,100.4129600999999,105.4620196,107.21404900000009,104.32999333333333,228362496,205300248,44.81763876218679,NaN,1.5,2.75,NaN,NaN,1.8208737759532443,1.1123342432591703,243.63785085570464,-0.6269370910478778,-0.17030833729768347,0.45662875375019424,27.12320249981624,-3.3077797283562793,37.93159451412494,29.008906192481028,33.059499293394005,2979167373
1257345000,105.50999,106.33,104.64999,104.92,NaN,NaN,103.18380857142857,111.2475,92.3919451000003,100.53316019999991,105.49721960000001,107.17004900000009,104.81783345685092,106.13855555485051,106.6523830769232,110.77548414186418,102.52928201198222,92.3919451000003,100.53316019999991,105.49721960000001,107.17004900000009,105.29999666666667,247996688,209740069.6,45.837805272798796,NaN,1.5,2.75,NaN,NaN,1.8108120776708694,1.1824001416274919,244.88741218223964,-0.5601961080724203,-0.24361638134033115,0.3165797267320891,27.19535783856793,-4.033659562791545,67.01231090310279,8.794035697519924,24.193653399377286,3227164061
1257431400,105.66,106.88,105.44,106.8501,NaN,NaN,103.23571285714286,111.34125,92.5124456000003,100.68526119999991,105.5708216,107.18205400000008,104.89753018403324,106.2063216924838,106.42623769230782,110.13815405394142,102.71432133067422,92.5124456000003,100.68526119999991,105.5708216,107.18205400000008,106.39003333333332,180015184,209575541.6,52.58565202234262,NaN,1.5,2.75,NaN,NaN,1.8214683578372353,0.8589513004507965,250.2740743242584,-0.36870947127016684,-0.14430711235561944,0.2244023589145474,28.974946826987697,-1.1379533678756484,66.46050773743494,9.070226480124006,24.469265782441052,3407179245
1257517800,106.25999,107.39999,106.05,107.13,NaN,NaN,103.28761714285714,111.435,92.6325456000003,100.84106119999991,105.64542180000001,107.17555450000009,104.9850780199535,106.29429105510438,106.2661607692309,109.6487774256875,102.88354411277429,92.6325456000003,100.84106119999991,105.64542180000001,107.17555450000009,106.85999666666669,170954064,211372832,53.49058743116661,NaN,1.5,2.75,NaN,NaN,1.787791332277433,0.8087797394889424,251.06171026196716,-0.21354426665666465,-0.04252797440628342,0.17101629225038123,28.463153407425125,0.20578056309044884,100,0,0,3578133309
1257777000,107.95,109.63,107.87,109.57001,NaN,NaN,103.33952142857143,111.52875,92.7619957000003,101.01457139999991,105.76922200000001,107.27005550000008,105.16487927407297,106.60626428795159,106.36923846153857,110.05319286999577,102.68528405308138,92.7619957000003,101.01457139999991,105.76922200000001,107.27005550000008,109.0233366666667,159495632,213446063.2,60.55771950337178,NaN,1.5,2.75,NaN,NaN,1.838663379971902,0.7472409170205769,256.71256890378703,0.04906123586827449,0.23234283708572434,0.18328160121744985,30.542262346053366,2.9599793271941315,100,0,0,3737628941
1257863400,109.31,109.92999,108.97,109.59,NaN,NaN,103.39142571428572,111.6225,92.88729570000031,101.19007149999992,105.91182180000001,107.3765550000001,105.33841342018776,106.89042959386096,106.38923846153858,110.13949737656644,102.63897954651073,92.88729570000031,101.19007149999992,105.91182180000001,107.3765550000001,109.49666333333333,171899744,214156416,60.61052612751989,NaN,1.5,2.75,NaN,NaN,1.775900995688195,0.8026831379172875,253.72928212575178,0.2106901780096182,0.4466443237294726,0.2359541457198544,30.261157153251823,4.96121061201035,100,0,0,3909528685
1257949800,110.31,110.82001,109.62,110.14999,NaN,NaN,103.44333,111.71625,93.00109565000031,101.39877139999992,106.11082160000002,107.4185545000001,105.52710269782746,107.20086391825515,106.54846846153858,110.72401667310032,102.37292024997683,93.00109565000031,101.39877139999992,106.11082160000002,107.4185545000001,110.19666666666667,169466192,213058650.4,62.139719392806015,NaN,1.5,2.75,NaN,NaN,1.7369087817104665,0.7953969091695702,256.8597772942515,0.33453744504500166,0.6541259520261065,0.3195885069811048,26.821924160283864,3.281763083147031,100,0,0,4078994877
1258036200,110,110.57001,108.75,109.03,NaN,NaN,103.49523428571429,111.81,93.12349565000031,101.59557129999992,106.29502140000001,107.38455400000012,105.66447121948129,107.3750673546118,106.71154538461549,111.09142876782578,102.3316620014052,93.12349565000031,101.59557129999992,106.29502140000001,107.38455400000012,109.45000333333331,157144496,212222196.8,57.34466260079407,NaN,1.5,2.75,NaN,NaN,1.7428445830168615,0.7404715358219305,252.0198746573954,0.3202367343231009,0.719884424884981,0.39964769056188004,26.073690451301673,5.281962147547314,77.50348302069108,4.281369578501785,18.21514740080713,3921850381
1258122600,109.31,110.09,108.75,109.62,NaN,NaN,103.54713857142858,111.90375,93.2574456500003,101.79059129999992,106.4744216,107.42105400000011,105.8195899951879,107.5888704636964,106.95769923076932,111.59641248719952,102.31898597433913,93.2574456500003,101.79059129999992,106.4744216,107.42105400000011,109.48666666666668,150962944,210166875.2,59.133672045771235,NaN,1.5,2.75,NaN,NaN,1.7140699699442288,0.7183003689631867,255.65532440197458,0.3284948970576788,0.8102663118839786,0.48177141482629976,16.573712629187664,5.080511399490863,76.99253262705508,4.465718495242575,18.541748877702332,4072813325
1258381800,110.38,111.69,110.32001,111.21001,NaN,NaN,103.59904285714286,111.9975,93.40059570000028,101.98189139999994,106.6574218,107.4920550000001,106.03097901498445,107.93374089572531,107.480776923077,112.3787149245131,102.5828389216409,93.40059570000028,101.98189139999994,106.6574218,107.4920550000001,111.07333999999997,210922128,212736463.2,63.56824561943937,NaN,1.5,2.75,NaN,NaN,1.7394935435196406,0.991471442306088,260.8270038832182,0.4135292137764949,0.9986829320469184,0.5851537182704235,17.309065551154855,6.268533804924391,78.70646230619178,3.861099824221252,17.432437869586966,4283735453
1258468200,110.92,111.39,110.5,111.339,NaN,NaN,103.65094714285713,112.09125,93.53859065000027,102.17688139999993,106.8254018,107.5984550000001,106.23913670067134,108.2580512866086,107.84147000000009,113.11757649333731,102.56536350666286,93.53859065000027,102.17688139999993,106.8254018,107.5984550000001,111.07633333333332,147134064,211047116,63.91038991928659,NaN,1.5,2.75,NaN,NaN,1.6788154332682377,0.697162163542666,259.1606918642131,0.4480462970989685,1.1452115896441342,0.6971652925451657,17.482583970622784,6.117994662600073,78.06049277382118,4.084209904896344,17.855297321282467,4430869517
1258554600,111.25999,111.42999,110.57001,111.27,NaN,NaN,103.70285142857142,112.185,93.67829065000028,102.36258139999993,106.97620180000001,107.7504550000001,106.43642545750775,108.54490354502683,108.43454692307702,113.37488118901533,103.49421265713872,93.67829065000028,102.36258139999993,106.97620180000001,107.7504550000001,111.08999999999997,156486752,207582081.6,63.56648754860857,NaN,1.5,2.75,NaN,NaN,1.6203271880347927,0.7538548163397933,257.27086949916696,0.435434267264713,1.241458126626057,0.8060238593613439,17.81693226783757,4.136542689244089,50.233157843946245,18.930075744867036,30.836766411186726,4274382765
1258641000,110.50999,111.30589,109.13,109.82001,NaN,NaN,103.75475571428571,112.27875,93.80454065000028,102.54128149999991,107.07680220000002,107.7749555000001,106.56911504740941,108.66634225502428,108.85762384615394,113.22483046653858,104.4904172257693,93.80454065000028,102.54128149999991,107.07680220000002,107.7749555000001,110.0853,208734496,206096609.6,56.66589967671372,NaN,1.5,2.75,NaN,NaN,1.6600102460323083,1.0127992712015967,251.78263757484265,0.30481976746082373,1.1870485686873735,0.8822288012265498,18.909116971391384,2.5109773172780745,44.83297547858401,23.03272411538449,32.13430040603149,4065648269
1258727400,109.25,109.75999,109.00999,109.42999,NaN,NaN,103.80666,112.3725,93.91679560000028,102.71228139999992,107.17000200000001,107.84245500000011,106.68130622202081,108.73907061168863,109.22531615384626,112.8564403964334,105.59419191125913,93.91679560000028,102.71228139999992,107.17000200000001,107.84245500000011,109.39999,134196000,200804750.4,54.93831337224266,NaN,1.5,2.75,NaN,NaN,1.5992966570300002,0.6682909629014434,249.58546070283245,0.17404069668573052,1.099779672083713,0.9257389753979824,19.252053381400597,-0.12779044192840058,23.261911201353964,44.547344301395356,32.19074449725067,3931452269
1258986600,110.72,111.74001,110.60001,110.82001,NaN,NaN,103.85856428571428,112.46625,94.03539560000029,102.92238149999991,107.28080220000001,108.03795550000011,106.84360833096117,108.93725531533734,109.67916307692317,112.40685894906335,106.951467204783,94.03539560000029,102.92238149999991,107.28080220000001,108.03795550000011,111.05334333333333,148010128,196103847.2,59.65878890283857,NaN,1.5,2.75,NaN,NaN,1.6500626100992855,0.7547538210662906,253.94005597679305,0.16321545135578597,1.129758289592715,0.966542838236929,15.982709038020248,1.1223743042248315,18.738641635393055,50.516490235561875,30.744868129045074,4079462397
1259073000,111,111.20219,110.00999,110.99001,NaN,NaN,103.91046857142857,112.56,94.17479565000029,103.13428159999992,107.38620240000002,108.2664560000001,107.0062123179823,109.13275576149569,109.99761769230778,112.25609940294613,107.73913598166943,94.17479565000029,103.13428159999992,107.38620240000002,108.2664560000001,110.73406333333332,138420064,190361534.4,60.20780959056498,NaN,1.5,2.75,NaN,NaN,1.6173581379493365,0.7271430356783255,252.40475702963556,0.1499115899315855,1.153932325651411,1.0040207357198254,15.97208885067317,0.7626146856663315,17.970032525125006,51.60082295909282,30.429144515782166,4217882461
1259159400,111.17,111.5,110.82001,111.38,NaN,NaN,103.96237285714285,112.65375,94.3136956000003,103.36748159999992,107.46740220000001,108.61495600000012,107.17773340355163,109.34677902230563,110.32454076923085,111.97711269106125,108.67196884740045,94.3136956000003,103.36748159999992,107.46740220000001,108.61495600000012,111.23333666666667,109564752,183398703.2,61.502198950234934,NaN,1.5,2.75,NaN,NaN,1.5504032709529556,0.5974129047167658,255.58137615866394,0.14944915938352343,1.1908321849492296,1.0413830255657062,15.858652523964404,2.155370081628904,39.42527514783525,27.607237922551455,32.96748692961331,4327447213
1259332200,108.39999,110.32001,108.28999,109.57001,NaN,NaN,104.01427714285714,112.7475,94.44324565000029,103.58318169999991,107.51560240000002,108.76095700000012,107.2715481720398,109.36803911541938,110.32454076923085,111.97711269106344,108.67196884739826,94.44324565000029,103.58318169999991,107.51560240000002,108.76095700000012,109.39333666666668,126001808,179793265.6,52.90135152796402,NaN,1.5,2.75,NaN,NaN,1.660375180170601,0.7008149475427293,249.1073477776433,0.01632152139195675,1.061784927305652,1.0454634059136954,17.747218809666165,-0.045602992154723763,49.13117158029038,19.744955354489818,31.123873065219815,4201445405
1259591400,109.48,110.2,108.12,109.94,NaN,NaN,104.06618142857143,112.84125,94.5791457000003,103.80088169999992,107.58000240000001,109.07995700000012,107.37619334176372,109.42251158061754,110.35146384615395,111.96626354740818,108.73666414489972,94.5791457000003,103.80088169999992,107.58000240000001,109.07995700000012,109.42,160874816,171556609.6,54.30801157296475,NaN,1.5,2.75,NaN,NaN,1.6903483815869864,0.9377360416196987,251.48243212162473,-0.05389529698604889,0.9780942846811342,1.0319895816671831,17.580154041599187,-1.141992523874424,78.23815724671775,4.023580492763007,17.738262260519253,4362320221
1259677800,110.92,111.66,110.73,111.3,NaN,NaN,104.11808571428571,112.935,94.73954570000029,104.0342815999999,107.67700240000002,109.42895650000014,107.53006811267495,109.60132000151111,110.43992615384626,112.12534099255977,108.75451131513275,94.73954570000029,104.0342815999999,107.67700240000002,109.42895650000014,111.23,159613632,166812804,59.13887372950785,NaN,1.5,2.75,NaN,NaN,1.692466354330773,0.9568428092606128,256.80533859584847,-0.017696987128368757,1.009868347756722,1.0275653348850908,16.994918684164226,-0.03502815724948264,78.67529685821405,3.872993268096621,17.45170987368934,4521933853
1259764200,111.28,112.00999,110.92,111.25,NaN,NaN,104.16999,113.02875,94.9006457000003,104.2457614999999,107.76060220000001,109.75895700000015,107.67594779453084,109.75833714422434,110.61069538461548,112.13195453059163,109.08943623863934,94.9006457000003,104.2457614999999,107.76060220000001,109.75895700000015,111.39332999999999,132315056,162010432,58.89234970497116,NaN,1.5,2.75,NaN,NaN,1.6494323290214319,0.8167070130397529,259.8071301755842,-0.006639882683300513,1.0192654815309652,1.0259053642142657,16.982668333251162,-0.01797429675563586,50.668995934061726,18.621457559470873,30.7095465064674,4389618797
1259850600,111.55,112.17999,110.28999,110.38,NaN,NaN,104.22189428571428,113.1225,95.0616407000003,104.44346149999988,107.84460240000003,110.03195700000015,107.78198905749042,109.81754313048869,110.66915692307703,112.08864304472166,109.24967080143239,95.0616407000003,104.44346149999988,107.84460240000003,110.03195700000015,110.94999333333335,167324816,157976838.4,54.62542517336404,NaN,1.5,2.75,NaN,NaN,1.6666157340913297,1.0591730895153804,256.4597239849452,-0.06423578110551342,0.9456106378323739,1.0098464189378873,17.562398756838107,0.5099161801205437,24.128020802802812,43.48741462355206,32.384564573645115,4222293981
1259937000,111.84,112.38,110.03999,111.00999,NaN,NaN,104.27379857142857,112.38,95.2295906500003,104.62096149999988,107.96460240000002,110.23995150000015,107.9085773297457,109.93110949901357,110.65377076923087,112.05367465142747,109.25386688703428,95.2295906500003,104.62096149999988,107.96460240000002,110.23995150000015,111.14332666666667,274907904,162721474.4,57.05202338877022,NaN,1.5,2.75,NaN,NaN,1.7147153245133768,1.6894383793759429,260.268420985168,-0.06597051563868828,0.927383274389527,0.9933537900282152,15.98671401965357,1.443845512550991,56.52897802064188,14.675416891174425,28.795605088183677,4497201885
1260196200,110.91,111.53,110.49001,110.84,NaN,NaN,104.32570285714286,112.44677419354838,95.4105407000003,104.78786159999989,108.09240240000003,110.42545150000015,108.02353508152038,110.01767049910752,110.61538615384626,111.9644728720104,109.26629943568211,95.4105407000003,104.78786159999989,108.09240240000003,110.42545150000015,110.95333666666666,127973808,160572461.6,56.178984496330706,NaN,1.5,2.75,NaN,NaN,1.6665206584767074,0.7969847801100161,262.0407148775644,-0.08350411175732053,0.8889736503315646,0.9724777620888851,15.81357120227387,0.018038258614132104,35.382170605419994,31.3807717722831,33.237057622296895,4369228077
1260282600,110.03999,110.77251,109.27,109.61,NaN,NaN,104.37760714285714,112.51354838709678,95.5711907000003,104.9426615999999,108.15820220000002,110.42745100000016,108.085749392049,109.97884473728776,110.48769384615395,111.87836899625873,109.09701869604916,95.5711907000003,104.9426615999999,108.15820220000002,110.42745100000016,109.88417,169863632,161090861.6,50.1937816022336,NaN,1.5,2.75,NaN,NaN,1.6596263257283717,1.0544585230525578,258.7017126058951,-0.1774780272229799,0.7506302280601602,0.9281082552831401,15.458035106141923,-1.2433641550262033,13.553293127851672,58.38721409243517,28.05949277971315,4199364445
1260369000,109.58,110.17999,109.02,110.021,NaN,NaN,104.42951142857143,112.58032258064516,95.7369357500003,105.09156159999992,108.23862220000001,110.44900100000015,108.16164157275296,109.98285952421273,110.50315461538472,111.86802377566697,109.13828545510246,95.7369357500003,105.09156159999992,108.23862220000001,110.44900100000015,109.74033000000001,155063376,160249043.2,52.03273752622213,NaN,1.5,2.75,NaN,NaN,1.6239380167477742,0.9676399490664791,260.5062652530657,-0.20930769137810734,0.6664736410605059,0.8757813324386132,15.646045667756812,-1.2201472436703131,32.24099847841083,34.49467195129828,33.2643295702909,4354427821
1260455400,110.7,111.12,110.45,110.64,NaN,NaN,104.48141571428572,112.64709677419354,95.9120357500003,105.24226149999991,108.33962220000001,110.47350150000015,108.25883209931166,110.04544433143056,110.5962323076924,111.81262544497098,109.37983917041383,95.9120357500003,105.24226149999991,108.33962220000001,110.47350150000015,110.73666666666666,138014624,158676464.8,54.74297451823911,NaN,1.5,2.75,NaN,NaN,1.5864424441229334,0.8697863553612519,262.9608527947924,-0.18676685051364628,0.6423227692965554,0.8290896198102017,15.905404299241503,0.9765354589271319,57.12039236362179,14.33602476774443,28.54358286863377,4492442445
1260541800,111.11,111.36,110.61,111.11,NaN,NaN,104.53332,112.71387096774193,96.0979358000003,105.39786149999992,108.5018222,110.57750150000015,108.37064260522101,110.14683058558003,110.61853923076933,111.86088835311523,109.37619010842343,96.0979358000003,105.39786149999992,108.5018222,110.57750150000015,111.02666666666666,124854000,157061940,56.741570348992546,NaN,1.5,2.75,NaN,NaN,1.5266965552570095,0.7949347881479116,266.05596347858506,-0.14041241103718438,0.6535741060137212,0.7939865170509056,12.492905006520566,1.0642168455521208,46.63911170808482,21.658674261006073,31.70221403090912,4617296445
1260801000,111.87,112,105.476,111.87,NaN,NaN,105.476,112.78064516129032,96.3042857500003,105.53995149999993,108.689422,110.69000150000015,108.50787230697705,110.31094195838193,110.68623076923086,112.08785043764931,109.28461110081241,96.3042857500003,105.53995149999993,108.689422,110.69000150000015,109.782,107141504,154870868,59.830683592371614,NaN,1.5,2.75,NaN,NaN,1.8836468013100804,0.6918118648369685,270.3097376374462,-0.06273489481682915,0.7155678985298692,0.7783027933466984,12.842964355274654,0.5121293800539151,71.04262025432979,6.8781238269969025,22.079255918673297,4724437949
1260887400,111.46001,111.92,111,111.35001,NaN,NaN,105.55862068965517,112.8474193548387,96.5106857500003,105.67285159999994,108.83602219999999,110.69700150000017,108.6193286870956,110.40990081948841,110.68392384615393,112.08105997689775,109.28678771541011,96.5106857500003,105.67285159999994,108.83602219999999,110.69700150000017,111.42333666666667,120408752,150345199.2,56.839916498821474,NaN,1.5,2.75,NaN,NaN,1.814814886930789,0.8008819213430528,267.450541946347,-0.051039650673250336,0.7145032300051355,0.7655428806783858,11.346361285859174,0.08989662921348089,78.49253225830942,3.94071314810284,17.566754593587728,4604029197
1260973800,111.8,112.13,111.27,111.52,NaN,NaN,105.64124137931034,112.91419354838709,96.7096357500003,105.80455149999995,108.9562224,110.70605150000017,108.73308050328794,110.51562455096571,110.83392307692317,112.13595553827452,109.53189061557183,96.7096357500003,105.80455149999995,108.9562224,110.70605150000017,111.63999999999999,155358128,150756402.4,57.58632672497094,NaN,1.5,2.75,NaN,NaN,1.7466138235785897,1.030524246577537,270.4731837769918,-0.03716465903277466,0.7190870568874175,0.7562517159201921,11.371388837166784,1.0327957963399172,78.5832354278069,3.9095346065086893,17.507229965684417,4759387325
1261060200,110.72,110.92999,110.08,110.17999,NaN,NaN,105.72386206896552,112.98096774193547,96.91653570000031,105.92745139999995,109.0438222,110.65155100000018,108.78982205217861,110.48365935563564,110.85238384615394,112.10921592299393,109.59555176931396,96.91653570000031,105.92745139999995,109.0438222,110.65155100000018,110.39666,183390064,152101568,50.21422354382235,NaN,1.5,2.75,NaN,NaN,1.724712836180119,1.2057079122287548,266.1711537112476,-0.11893076046820206,0.6075882653349396,0.7265190258031416,12.658774287653774,-0.7476804565066606,42.93738220878674,24.600371561766067,32.46224622944721,4575997261
1261146600,110.2,110.3,109.28,110.21001,NaN,NaN,105.80648275862069,113.04774193548387,97.12298575000031,106.05303159999995,109.1158224,110.67105100000018,108.84551569719122,110.45759751224176,110.76853846153857,112.04008272335001,109.49699419972713,97.12298575000031,106.05303159999995,109.1158224,110.67105100000018,109.93000333333333,174591120,150394399.2,50.36751761457522,NaN,1.5,2.75,NaN,NaN,1.674376205024396,1.1608884435106013,268.5981085707598,-0.16865335079797827,0.5157023373056688,0.6843556881036471,12.110327305729019,-0.5683778419343256,47.04421181067078,21.32175669312095,31.634031496208255,4750588381
1261405800,110.75999,111.7,110.75999,111.33,NaN,NaN,105.88910344827586,113.11451612903225,97.33908575000032,106.17963159999995,109.1972226,110.76605150000016,108.94294645416412,110.54068346345683,110.7746923076924,112.05623250726566,109.49315210811915,97.33908575000032,106.17963159999995,109.1972226,110.76605150000016,111.26333,118104256,149589812,55.8316295726292,NaN,1.5,2.75,NaN,NaN,1.6612057618083682,0.7895207194992664,272.4278170017851,-0.12574141467204936,0.5271789197635854,0.6529203344356348,13.576338529803044,1.5691998905209368,47.05409132087605,21.29354848096401,31.65236019815994,4868692637
1261492200,111.57001,111.97,111.425,111.73,NaN,NaN,105.97172413793103,113.18129032258064,97.53688575000032,106.30883159999996,109.27822280000001,110.81155100000016,109.05224267164787,110.65395170503237,110.87853846153855,112.2320820309804,109.52499489209671,97.53688575000032,106.30883159999996,109.27822280000001,110.81155100000016,111.70833333333333,91707440,146774677.6,57.62588695877054,NaN,1.5,2.75,NaN,NaN,1.5882624931077705,0.6248178602710145,275.1364775758075,-0.07267895624619325,0.5620716391278933,0.6347505953740865,11.440086136204474,1.5533398169440409,69.07606613684338,7.765013929876857,23.158919933279755,4960400077
1261578600,112,112.11,111.5,111.95,NaN,NaN,106.0543448275862,113.24806451612902,97.73343575000034,106.42393159999996,109.3680226,110.85955050000015,109.16588021393619,110.77738487598167,110.95084692307702,112.42023091501221,109.48146293114183,97.73343575000034,106.42393159999996,109.3680226,110.85955050000015,111.85333333333334,111783056,145442827.2,58.62151098179914,NaN,1.5,2.75,NaN,NaN,1.5183866007429299,0.7685704283394184,278.91657765735374,-0.02735749828772227,0.6005537225144337,0.627911220802156,11.381702309195719,1.1840202458423736,66.7825070542343,8.874199445632328,24.34329350013336,5072183133
1261665000,112.19,112.60001,111.9948,112.48,NaN,NaN,106.13696551724138,113.31483870967742,97.91833575000034,106.54173159999995,109.43142259999999,110.91455050000016,109.29584569574261,110.93953869731675,111.07700076923086,112.75364302370028,109.40035851476145,97.91833575000034,106.54173159999995,109.43142259999999,110.91455050000016,112.35827,39677472,141948463.2,60.99894758380718,NaN,1.5,2.75,NaN,NaN,1.456359700689863,0.27952026464771196,282.5414914494321,0.03058205388546631,0.6661387881589889,0.6355567342735226,11.282440256710066,1.2330123301233054,100,0,0,5111860605
1262010600,112.89999,112.99001,112.32001,112.72,NaN,NaN,106.21958620689655,113.3816129032258,98.10148575000034,106.66483159999994,109.4916224,111.07205000000015,109.43012625669388,111.10910644042944,111.31623153846165,112.97473109982072,109.65773197710259,98.10148575000034,106.66483159999994,109.4916224,111.07205000000015,112.67667333333333,87508432,140023794.4,62.061938393324006,NaN,1.5,2.75,NaN,NaN,1.4001911506405873,0.624954011387653,282.0243436364568,0.07481627079980524,0.7290770727732792,0.6542608019734739,11.169976496292133,0.7598104943237636,100,0,0,5199369037
1262097000,113.00999,113.03,112.55,112.562,NaN,NaN,106.30220689655172,113.44838709677418,98.28499575000035,106.79155159999995,109.56506239999999,111.20315000000014,109.55294483486274,111.24747725562663,111.51169307692318,113.1114203744702,109.91196577937616,98.28499575000035,106.79155159999995,109.56506239999999,111.20315000000014,112.71399999999998,80572496,136008678.4,60.88542452595049,NaN,1.5,2.75,NaN,NaN,1.334463211309117,0.5924070209919781,280.52960813000954,0.08257146673178484,0.757475135388205,0.6749036686564202,10.709416182774993,1.0884507329635624,78.53594960593665,3.97709706391314,17.4869533301502,5118796541
1262183400,112.23,112.64999,112.17,112.52,NaN,NaN,106.3848275862069,113.51516129032257,98.45669580000035,106.90473159999996,109.6196626,111.26415000000013,109.66929993937794,111.36866989794791,111.65630846153856,113.2545884258325,110.05802849724462,98.45669580000035,106.90473159999996,109.6196626,111.26415000000013,112.44666333333333,73138368,131684915.2,60.556791309963536,NaN,1.5,2.75,NaN,NaN,1.273429410501323,0.5554042988820636,278.93635311637814,0.07427043077015538,0.7677417071191144,0.693471276348959,10.208813339613311,0.896700143472023,51.584011726187484,18.144762493129075,30.271225780683434,5045658173
1262269800,112.77,112.8,111.39,111.44,NaN,NaN,106.46744827586207,113.58193548387096,98.61424585000033,107.00923149999997,109.66424259999998,111.27365000000013,109.73873915744154,111.37546324100049,111.68169307692318,113.25474310166574,110.10864305218062,98.61424585000033,107.00923149999997,109.66424259999998,111.27365000000013,111.87666666666665,90637872,129601056,52.68230811093375,NaN,1.5,2.75,NaN,NaN,1.283184452608371,0.6993605978025365,275.43177735288674,-0.010071198637388479,0.6808822780522235,0.6909534766896119,11.886612923812732,1.1435924072964556,17.127287592257087,53.04803515806647,29.82467724967645,4955020301
1262615400,112.37,113.39,111.50999,113.33,NaN,NaN,106.55006896551724,113.64870967741935,98.78619585000035,107.14523149999997,109.76624259999998,111.42115000000013,109.87957291597324,111.56160959900045,111.79400076923086,113.59652615330812,109.9914753851536,98.78619585000035,107.14523149999997,109.76624259999998,111.42115000000013,112.74333,118944560,127182043.2,61.99581708042834,NaN,1.5,2.75,NaN,NaN,1.3308141345649163,0.9352307684894938,280.55007489181213,0.05190914455310092,0.755839907380988,0.7039307628278871,12.73583657688187,2.8309497476681122,28.85970719797443,38.0339694175291,33.10632338449648,5073964861
1262701800,113.25999,113.67999,112.85001,113.63,NaN,NaN,106.63268965517241,113.71548387096773,98.97079580000036,107.27353149999998,109.8522426,111.55215050000012,110.02664848789586,111.7585991610004,111.96938461538471,113.99487294606818,109.94389628470124,98.97079580000036,107.27353149999998,109.8522426,111.55215050000012,113.38666666666666,111579872,119015641.6,63.23288480130755,NaN,1.5,2.75,NaN,NaN,1.2950402678102797,0.9375227533117798,283.2083951634624,0.10076375652199132,0.8298854584803763,0.729121701958385,12.634901324306757,2.065930117668191,32.53906440801678,34.150504207218844,33.310431384764385,5185544733
1262788200,113.52,113.99001,113.42999,113.71001,NaN,NaN,106.71531034482759,113.78225806451611,99.12824585000035,107.39493149999998,109.96484279999999,111.69565100000011,110.17109403739013,111.94444781233369,112.13784692307702,114.34220315117781,109.93349069497623,99.12824585000035,107.39493149999998,109.96484279999999,111.69565100000011,113.71000333333335,116074368,118420669.6,63.57344032611853,NaN,1.5,2.75,NaN,NaN,1.2425388201095449,0.9801867224030627,285.790384060934,0.12456146611426022,0.8848235346012103,0.7602620684869501,11.843250037516295,1.7721381902801332,60.14373765547736,12.479774172307726,27.376488172214913,5301619101
1262874600,113.5,114.33,113.17999,114.19,NaN,NaN,106.79793103448276,113.84903225806451,99.29619580000035,107.52893159999999,110.11044279999999,111.92465100000011,110.3286981927866,112.15830992544477,112.44630923076933,114.58988979519472,110.30272866634394,99.29619580000035,107.52893159999999,110.11044279999999,111.92465100000011,113.89999666666667,131091056,116482040.8,65.63017512470263,NaN,1.5,2.75,NaN,NaN,1.2359296186731485,1.1254186061616462,288.7430624821568,0.15664836786536562,0.9560725283186571,0.7994241604532915,11.877008698812094,2.000893255917816,82.3193944866697,2.72215439341857,14.958451119911727,5432710157
1262961000,113.89,114.62,113.66,114.57001,NaN,NaN,106.88055172413793,113.9158064516129,99.46179585000034,107.6915317,110.27344299999999,112.1521015000001,110.49502414601066,112.38799564683099,112.78169384615393,114.78018105111339,110.78320664119447,99.46179585000034,107.6915317,110.27344299999999,112.1521015000001,114.28333666666667,126402752,115049009.6,67.20875154407605,NaN,1.5,2.75,NaN,NaN,1.2162203601964958,1.0986861376684116,291.32788717279226,0.18551120291684264,1.0313131640993447,0.8458019611825021,11.893619768108493,1.858116998577518,100,0,0,5559112909
1263220200,115.08,115.13,114.235,114.73,NaN,NaN,106.9631724137931,113.98258064516128,99.61989585000033,107.84793169999999,110.47984299999999,112.3566015000001,110.66110163048083,112.61104368046612,113.0432323076924,115.10232786561521,110.9841367497696,99.61989585000033,107.84793169999999,110.47984299999999,112.3566015000001,114.69833333333334,106375680,113467062.4,67.8776770146692,NaN,1.5,2.75,NaN,NaN,1.1932760487538887,0.9375027232572472,293.720404242958,0.19637623796490988,1.0912722586386394,0.8948960206737295,11.80008934613046,1.7831795599716156,100,0,0,5665488589
1263306600,113.97,114.21001,113.22,113.66,NaN,NaN,107.04579310344828,114.04935483870966,99.78014585000034,107.98493159999998,110.62004319999998,112.4841015000001,110.77870548810903,112.7109442823265,113.19169384615394,115.12511526165498,111.2582724306529,99.78014585000034,107.98493159999998,110.62004319999998,112.4841015000001,113.69666999999998,163333440,115391034.4,59.182320496127176,NaN,1.5,2.75,NaN,NaN,1.2158991881286114,1.4154777348975736,289.7685332998961,0.1164483680670948,1.040456480757598,0.9240081126905032,13.46962486536855,0.9754624118263704,71.81436018003166,6.670011353938474,21.51562846602988,5502155149
1263393000,113.95,114.94,113.37,114.62,NaN,NaN,107.12841379310345,114.11612903225806,99.95929590000033,108.1212315,110.84124319999997,112.62160150000008,110.92934448857534,112.89275911258112,113.39707846153857,115.32650744368496,111.46764947939218,99.95929590000033,108.1212315,110.84124319999997,112.62160150000008,114.31,161821936,118125056,63.67806422465882,NaN,1.5,2.75,NaN,NaN,1.2411921032622817,1.3699205018789578,293.30560406045737,0.113087663478596,1.0653676920387483,0.9522800285601523,14.038117186671428,1.866334873800221,74.06927325295037,5.711253080544852,20.21947366650479,5663977085
1263479400,114.49001,115.14,114.42,114.92999,NaN,NaN,107.21103448275862,115.14,100.13634585000032,108.2408314,111.05344279999996,112.80060050000009,111.08623254784689,113.0867811018591,113.58553923076934,115.59672491403475,111.57435354750393,100.13634585000032,108.2408314,111.05344279999996,112.80060050000009,114.82999666666667,115783744,117893805.6,65.01792578306326,NaN,1.5,2.75,NaN,NaN,1.2039640958864042,0.9821020146965211,295.1555807611494,0.11615407912283993,1.097472627463702,0.9813185483408622,13.973893558001356,3.1317211055276437,73.40636501735409,5.98613662819162,20.607498354454307,5779760829
1263565800,114.73,114.84,113.2,113.64,NaN,NaN,107.29365517241379,115.24222222222222,100.29924585000032,108.34763129999999,111.23324299999996,112.90660050000008,111.18638029106859,113.13946861596776,113.65630846153857,115.60444529482535,111.70817162825179,100.29924585000032,108.34763129999999,111.23324299999996,112.90660050000008,113.89333333333333,212283120,120740055.2,55.79425548546477,NaN,1.5,2.75,NaN,NaN,1.2415373747516611,1.7581830623512917,291.2302208153323,0.02071641824302639,1.0072140711446451,0.9864976529016187,14.500532736682636,0.273537456984031,38.18340365873031,29.06620049001767,32.75039585125203,5567477709
1263911400,113.62,115.13,113.59,115.06,NaN,NaN,107.37627586206897,115.34444444444445,100.45739590000032,108.46663129999999,111.43604299999997,113.15060100000008,111.3382869463208,113.32237636682797,113.84846230769243,115.8195892217968,111.87733539358806,100.45739590000032,108.46663129999999,111.43604299999997,113.15060100000008,114.59333333333332,139172624,118529183.2,62.15823444385149,NaN,1.5,2.75,NaN,NaN,1.2628561336979707,1.1741633599648393,296.49513280373384,0.04143932428713715,1.0382968082605402,0.996857483973403,12.995807193746039,1.2584704743465696,38.90895633427085,28.124650076706175,32.96639358902298,5706650333
1263997800,114.28,114.45,112.98,113.89,NaN,NaN,107.45889655172414,115.44666666666667,100.60554595000032,108.57383129999998,111.57684099999999,113.33460050000008,111.43835412489646,113.3764357604634,113.95384692307705,115.77000479627273,112.13768904988137,100.60554595000032,108.57383129999998,111.57684099999999,113.33460050000008,113.77333333333333,216490128,120624133.6,55.11744576251766,NaN,1.5,2.75,NaN,NaN,1.3212235527195442,1.7947497033877142,292.27977626255836,-0.031499103592900424,0.9574836044822774,0.9889827080751779,14.582708488521138,0.15828861504805394,34.34041362213438,32.41206893497995,33.24751744288567,5490160205
1264084200,113.92,114.27,111.56,111.7,NaN,NaN,107.54151724137931,115.5488888888889,100.74604590000034,108.65683139999999,111.66824099999998,113.35310050000007,111.44861474744954,113.21677521184783,113.97384692307705,115.6813052425365,112.2663886036176,100.74604590000034,108.65683139999999,111.66824099999998,113.35310050000007,112.50999999999999,344859392,131961890.4,44.871805164614365,NaN,1.5,2.75,NaN,NaN,1.4204218703824334,2.613325642385614,286.65018411993316,-0.22434131240583555,0.7085560675678835,0.932897379973719,18.402679846793088,-2.1805762325947935,8.412811305980318,67.78856327449655,23.798625419523134,5145300813
1264170600,111.2,111.74159,109.09,109.21001,NaN,NaN,107.62413793103448,115.6511111111111,100.88384600000032,108.71513150000001,111.66104099999997,113.22710100000006,111.36082632598092,112.83517852500518,113.65692461538475,116.71779336320601,110.59605586756349,100.88384600000032,108.71513150000001,111.66104099999997,113.22710100000006,110.01386666666667,345942272,144673632,36.55221543383798,NaN,1.5,2.75,NaN,NaN,1.5083624510694023,2.3911908978686593,281.0997771489211,-0.5008611226807448,0.30682097662278807,0.8076820993035329,21.371041144639808,-4.678362164758474,1.5655270444904954,86.81639600982516,11.618076945684352,4799358541
1264429800,110.21001,110.41,109.41,109.77,NaN,NaN,107.70675862068966,115.75333333333333,101.02004600000033,108.7882314,111.66464099999997,113.11810100000007,111.29844097986403,112.54325676071898,113.36000153846166,117.05658277817574,109.66342029874758,101.02004600000033,108.7882314,111.66464099999997,113.11810100000007,109.86333333333334,186937440,148431351.2,39.27890271328379,NaN,1.5,2.75,NaN,NaN,1.4863358474215878,1.2594201864275694,283.37482092340633,-0.6195486449625822,0.033246293100305024,0.6527949380628872,21.63231381084847,-4.323193584938558,8.512815385544727,67.52465558423035,23.96252903022494,4986295981
1264516200,109.34,110.47,109.03999,109.31,NaN,NaN,107.78937931034483,115.85555555555555,101.13754600000033,108.8793314,111.64784119999999,112.95960100000006,111.2204629022223,112.2353275454124,113.02153923076935,117.28952689569414,108.75355156584456,101.13754600000033,108.8793314,111.64784119999999,112.95960100000006,109.60666333333334,211168752,157005915.2,37.84031656537959,NaN,1.5,2.75,NaN,NaN,1.4823125726057598,1.3449732242954373,279.91909683350747,-0.6967694530437749,-0.21816687824183134,0.4786025748019435,21.332143478827714,-3.8272039415801467,2.2167400047658146,84.1340320576397,13.649227937594485,4775127229
1264602600,109.17,110.08,108.33,109.83,NaN,NaN,107.872,115.95777777777778,101.25754600000033,108.9794313,111.6638412,112.81510100000007,111.1659349452724,112.0062487315636,112.68615461538472,117.21161867047006,108.16069056029939,101.25754600000033,108.9794313,111.6638412,112.81510100000007,109.41333333333334,271863552,166223671.2,40.49352253151445,NaN,1.5,2.75,NaN,NaN,1.5014331031339199,1.6355285022726656,279.03875599042453,-0.6798222965800194,-0.37117529592308074,0.3086470006569386,21.76763607608123,-4.179026347932303,14.180858533553772,57.32328823156543,28.495853234880798,5046990781
1264689000,110.19,110.25,107.91,108.57001,NaN,NaN,107.95462068965517,116.06,101.37864600000033,109.05863149999999,111.6428414,112.61550150000008,111.06413396702642,111.67898789998611,112.22461615384626,117.09790080150165,107.35133150619086,101.37864600000033,109.05863149999999,111.6428414,112.61550150000008,108.91000333333334,316103936,178000243.2,36.43532437264307,NaN,1.5,2.75,NaN,NaN,1.5613307386243545,1.7758623826419582,274.52733258129183,-0.7167862331127868,-0.5873357907340448,0.12945044237874193,20.788452224914824,-5.533786264142202,15.077806912620932,55.904794673994985,29.017398413384086,4730886845
1264775400,109.03999,109.8,107.22,107.39,NaN,NaN,108.03724137931034,116.16222222222223,101.48934600000034,109.1119315,111.56644120000001,112.35900150000006,110.920050282045,111.2705128618922,111.66000076923089,116.92632991845332,106.39367162000846,101.48934600000034,109.1119315,111.56644120000001,112.35900150000006,108.13666666666666,310677504,189877200,33.09063307247145,NaN,1.5,2.75,NaN,NaN,1.6340928287226149,1.636202261250956,270.7469005072206,-0.7788650501029466,-0.8441308702499413,-0.06526582014699472,20.3065463711283,-5.49982400563182,16.111235798296672,54.3212849997786,29.567479201924733,4420209341
1265034600,108.14999,109.07001,107.50079,109.06,NaN,NaN,108.11986206896552,116.26444444444445,101.60214600000035,109.17313149999998,111.52086120000001,112.24000150000006,110.84710713372951,111.05998782742628,111.30615461538471,116.60545902750721,106.00685020326222,101.60214600000035,109.17313149999998,111.52086120000001,112.24000150000006,108.54360000000001,187864880,194738550.4,41.302940724290444,NaN,1.5,2.75,NaN,NaN,1.6373726266709991,0.9647030832576229,275.61516508507583,-0.6697749423863308,-0.9024844981299083,-0.23270955574357746,23.644425799662095,-5.214670606640014,16.492866300120838,53.736840041728335,29.770293658150827,4608074221
1265121000,109.25999,110.59,108.88,110.38,NaN,NaN,108.20248275862069,116.36666666666667,101.71864600000033,109.23963149999997,111.5030612,112.09250150000007,110.82878920691658,110.99522708195711,110.98000076923087,115.9339995394812,106.02600199898053,101.71864600000033,109.23963149999997,111.5030612,112.09250150000007,109.95,216327872,199607716,46.85533279290306,NaN,1.5,2.75,NaN,NaN,1.6425602961944998,1.083765078500272,280.04837310335483,-0.4799277822269614,-0.8326192835272792,-0.3526915013003178,23.54639769889515,-3.0819211519887655,36.40931806151797,30.349273859911243,33.2414080785708,4824402093
1265207400,109.88,110.48151,109.50999,109.83,NaN,NaN,108.28510344827586,116.4688888888889,101.85064605000034,109.29003159999998,111.50326100000001,111.90250150000006,110.78962100272378,110.88425307415167,110.58769384615394,115.00727137077045,106.16811632153743,101.85064605000034,109.29003159999998,111.50326100000001,111.90250150000006,109.94050000000001,172730624,202665253.6,44.947489654910996,NaN,1.5,2.75,NaN,NaN,1.5946288464663212,0.8522952056740722,277.2410697031232,-0.36766094680758316,-0.8122676848097967,-0.44460673800221356,23.243388570108102,-1.6741271262309798,14.74971005515458,56.40634232758569,28.843947617259722,4651671469
1265293800,108.98,109.03,106.42,106.44,NaN,NaN,108.36772413793103,116.57111111111111,101.95754605000033,109.30673159999998,111.4434612,111.53900100000007,110.61904763006794,110.46099087661342,110.03384769230777,114.58713093508959,105.48056444952596,101.95754605000033,109.30673159999998,111.4434612,111.53900100000007,107.29666666666668,356715520,214697311.2,35.384071707030714,NaN,1.5,2.75,NaN,NaN,1.7242982145758694,1.6614810777378755,269.571323944625,-0.49030936055365315,-1.05749343869428,-0.5671840781406269,26.91849968483736,-2.5364066901925924,13.90618300536889,57.754159805163916,28.33965718946719,4294955949
1265380200,106.56,106.88,104.58,106.66,NaN,NaN,104.58,116.67333333333333,102.06814610000032,109.32053159999998,111.360261,111.16250100000006,110.46379086026135,110.09899174550738,109.38769384615395,113.23369920085771,105.54168849145019,102.06814610000032,109.32053159999998,111.360261,111.16250100000006,106.04,493585664,232822041.6,36.330841666911006,NaN,1.5,2.75,NaN,NaN,1.7654197706775927,2.1200126096652183,267.405650643993,-0.5222693883026527,-1.2200208135189428,-0.6977514252162901,24.600914363878072,-2.833196683975585,51.73274849222045,17.865849998354516,30.401401509425032,4788541613
1265639400,106.74001,107.33,105.80991,105.89,NaN,NaN,104.5551111111111,116.77555555555556,102.17074610000033,109.32223159999998,111.25826079999999,110.72850050000007,110.28442651280012,109.6981353887924,108.77230923076932,112.05926412164614,105.48535433989251,102.17074610000033,109.32223159999998,111.25826079999999,110.72850050000007,106.34330333333332,224166816,237710244.8,34.429383165650165,NaN,1.5,2.75,NaN,NaN,1.747896215629193,0.9430254728339752,263.95217839302074,-0.557701424767952,-1.3948782061762302,-0.8371767814082781,24.24715205273276,-3.128716494373801,25.443965712673513,43.90399024247722,30.652044044849255,4564374797
1265725800,107.13,108.14999,106.27,107.22,NaN,NaN,104.53022222222222,116.87777777777778,102.27354610000033,109.32123149999998,111.1750608,110.35300050000005,110.16425292406286,109.4621224946217,108.42769384615394,111.33167780787548,105.5237098844324,102.27354610000033,109.32123149999998,111.1750608,110.35300050000005,107.21333000000001,337820416,249282481.6,40.24665323403817,NaN,1.5,2.75,NaN,NaN,1.7844743430842507,1.3551711048114021,268.8495874411415,-0.45816403475691625,-1.4098818248544234,-0.9517177900975071,25.92334734359767,-2.3763998907402346,30.149061281735687,38.575279031948845,31.275659686315457,4902195213
1265812200,107.05,107.60001,106.11,107.00999,NaN,NaN,104.50533333333333,116.98,102.37939605000032,109.31973139999998,111.12386039999997,110.02050000000006,110.0405563388055,109.22858606656249,108.25846153846163,111.21627780318354,105.30064527373972,102.37939605000032,109.31973139999998,111.12386039999997,110.02050000000006,106.90666666666668,240511504,253141384.8,39.6485036891616,NaN,1.5,2.75,NaN,NaN,1.7634411757210897,0.9501074041687078,267.3025714661218,-0.37648392942852293,-1.4223227018831608,-1.0458387724546379,25.575560416904317,-1.436879300278221,27.567448177903326,41.436578897565056,30.995972924531635,4661683709
1265898600,106.87,108.25,106.25,108.13,NaN,NaN,104.48044444444444,117.08222222222223,102.49219600000033,109.33383139999998,111.08766039999999,109.69600000000007,109.96563256081313,109.12395882212796,108.13230769230778,110.95845276833953,105.30616261627603,102.49219600000033,109.33383139999998,111.08766039999999,109.69600000000007,107.54333333333334,223591568,256229866.4,44.394872226927454,NaN,1.5,2.75,NaN,NaN,1.7803382345981547,0.8726210224492393,271.9386212659491,-0.22454137801659546,-1.3265154949753821,-1.1019741169587867,25.868472801253926,0.6890771952695735,55.634152321418476,16.543301443455327,27.822546235126197,4885275277
1265985000,106.99001,108.1012,106.50999,108.03999,NaN,NaN,104.45555555555555,117.18444444444445,102.59544595000034,109.34973129999997,111.02246019999998,109.35150000000007,109.89011716627144,109.02072369621101,108.03461461538471,110.77774893555213,105.2914802952173,102.59544595000034,109.34973129999997,111.02246019999998,109.35150000000007,107.55039333333333,304622080,265671783.2,44.094739234845896,NaN,1.5,2.75,NaN,NaN,1.768886217841143,1.146610589693968,273.49440227414226,-0.11323364057957352,-1.2435161676832536,-1.13028252710368,25.002278638899302,-0.9352741610122861,18.358144825696684,53.027704843360844,28.614150330942476,4580653197
1266330600,108.86,109.85001,107.821,109.74001,NaN,NaN,104.43066666666667,117.28666666666668,102.70704600000036,109.37643129999996,110.99226039999999,109.15650050000008,109.88423061073138,109.08922715371472,108.0276923076924,110.75306573137303,105.30231888401178,102.70704600000036,109.37643129999996,110.99226039999999,109.15650050000008,109.13700666666666,159317440,263023499.2,50.852876166868285,NaN,1.5,2.75,NaN,NaN,1.7874664879953472,0.6057156128048349,278.48506021339904,0.08126366229661741,-1.0287029492329083,-1.1099666115295257,25.04174449053946,-0.5798061242978777,36.95548553904605,31.319251846692396,31.725262614261567,4739970637
1266417000,110.27,110.41,109.74001,110.25999,NaN,NaN,104.40577777777777,117.3888888888889,102.81889595000035,109.41723129999997,110.98986019999998,108.91650000000008,109.89896627305563,109.20072837717046,108.15769076923087,111.124649620302,105.19073191815974,102.81889595000035,109.41723129999997,110.98986019999998,108.91650000000008,110.13666666666667,168845056,264507120.8,52.73492944065234,NaN,1.5,2.75,NaN,NaN,1.7076467388528225,0.6383384140635959,281.45995516952775,0.24221409079632106,-0.8071989980341243,-1.0494130888304454,24.16158579764839,0.3915050532641388,28.376927767933466,40.147584021059224,31.475488211007306,4908815693
1266503400,110.08,111.14,110.035,110.91,NaN,NaN,104.38088888888889,117.49111111111111,102.91904595000034,109.47623139999996,110.98786039999999,108.76750000000008,109.93861465450443,109.36351615077328,108.4284600000001,111.69328394248583,105.16363605751437,102.91904595000034,109.47623139999996,110.98786039999999,108.76750000000008,110.69500000000001,193708496,263368039.2,55.05211669791933,NaN,1.5,2.75,NaN,NaN,1.6646005432204782,0.735504948088629,284.8793568265882,0.3814468568462962,-0.5726045177725752,-0.9540513746188714,24.162649002980913,4.199549041713641,58.78789247690324,14.23540256680317,26.976704956293602,5102524189
1266589800,110.62,111.57001,110.36,111.14,NaN,NaN,104.356,117.59333333333333,103.02189590000035,109.54313139999995,110.99386039999999,108.73950000000009,109.98572780530819,109.53270508879487,108.58846000000011,112.15163927915575,105.02528072084448,103.02189590000035,109.54313139999995,110.99386039999999,108.73950000000009,111.02333666666665,222684816,257259310.4,55.87641441920755,NaN,1.5,2.75,NaN,NaN,1.6321297901333012,0.865604497088009,287.2176021739262,0.47209514962066845,-0.36393243759303573,-0.8360275872137042,12.726586562048588,4.200262516407279,59.01491246274523,14.092424129075889,26.892663408178887,5325209005
1266849000,111.55,111.58,110.83,111.16,NaN,NaN,104.33111111111111,117.69555555555556,103.11699085000035,109.59153129999996,111.0248604,108.83699950000009,110.0317776952961,109.68768555652869,108.64846000000013,112.35372460261826,104.943195397382,103.11699085000035,109.59153129999996,111.0248604,108.83699950000009,111.19,132346816,246579537.6,55.95206065005387,NaN,1.5,2.75,NaN,NaN,1.5691205194094942,0.5367307331668871,286.5201163414633,0.5130619927443811,-0.1947000962832277,-0.7077620890276088,12.893305227951133,4.976862782132398,100.00000000000001,0,0,5457555821
1266935400,110.86,111.2,109.52,109.81,NaN,NaN,104.30622222222222,117.79777777777778,103.21174085000035,109.62963129999994,111.0206404,108.83899950000009,110.02308053077468,109.699334551145,108.64692153846167,112.35023861293769,104.94360446398565,103.21174085000035,109.62963129999994,111.0206404,108.83899950000009,110.17666666666666,207496944,247607512.8,49.75175171034478,NaN,1.5,2.75,NaN,NaN,1.5770404823088167,0.8380074645295658,282.62924383148703,0.43214234461221235,-0.1675841582623434,-0.5997265028745558,14.68582108990312,2.4155941055773207,74.11783379541093,5.587118619608344,20.295047584980722,5250058877
1267021800,110.14,111,109.86,110.82001,NaN,NaN,104.28133333333334,117.9,103.30094090000036,109.68193139999994,111.02424060000001,108.91450000000009,110.05433266682273,109.80606554627404,108.9838453846155,112.61907439529317,105.34861637393784,103.30094090000036,109.68193139999994,111.02424060000001,108.91450000000009,110.56000333333334,176350624,245866606.4,53.870389673550314,NaN,1.5,2.75,NaN,NaN,1.5493947335724723,0.7172613905651565,286.691263033805,0.4286939317326038,-0.06385908820880104,-0.4925530199414048,14.065071604877094,3.560433937055778,74.38669251612359,5.479059687713598,20.134247796162832,5426409501
1267108200,109.24001,110.75,108.94,110.67,NaN,NaN,104.25644444444444,118.00222222222223,103.39809085000033,109.75863139999994,111.01544060000002,108.95650000000009,110.07847648381008,109.88834501805746,109.29230692307705,112.76325543526671,105.82135841088738,103.39809085000033,109.75863139999994,111.01544060000002,108.95650000000009,110.12,259634688,245255163.2,53.1732732601267,NaN,1.5,2.75,NaN,NaN,1.573010109745867,1.0586308749319737,287.15858605335114,0.3989769131753923,0.006168121527835524,-0.3928087916475568,13.986365878179107,2.3490243225746843,39.43908415616685,27.63547272041838,32.925443123414766,5166774813
1267194600,110.77,111.12,110.11,110.74001,NaN,NaN,104.23155555555556,118.10444444444445,103.49694090000034,109.84113139999994,110.99284080000002,109.0650000000001,110.10441897464105,109.96945596871866,109.66538461538472,112.5934999387777,106.73726929199175,103.49694090000034,109.84113139999994,110.99284080000002,109.0650000000001,110.65667,173589248,238129428.8,53.475865678312196,NaN,1.5,2.75,NaN,NaN,1.532795101906877,0.7289701607850999,289.48143008505116,0.3674848700080388,0.06654729586249175,-0.30093757414554706,13.293349674715358,2.4990931598568222,36.04757158661087,30.74873464441044,33.20369376897869,5340364061
1267453800,111.2,112,111.17,111.89,NaN,NaN,104.20666666666666,118.20666666666668,103.61299095000032,109.91983139999994,111.00364060000004,109.2900000000001,110.17444175994925,110.1523649240788,110.0246153846155,112.80678072163053,107.24245004760047,103.61299095000032,109.91983139999994,111.00364060000004,109.2900000000001,111.68666666666667,147709632,229981035.2,58.24846877187055,NaN,1.5,2.75,NaN,NaN,1.5133090231992432,0.6422687499929994,294.36873141459023,0.40461536896045563,0.2048316370550225,-0.19978373190543314,13.835824699497332,1.959166943760988,36.95426290849472,29.87967512445407,33.166061967051206,5488073693
1267540200,112.37,112.74001,112,112.2,NaN,NaN,104.18177777777778,118.3088888888889,103.72679095000034,109.98673149999993,111.01724060000002,109.44700000000009,110.25387541642182,110.34737778845225,110.42384692307704,112.82440834564231,108.02328550051176,103.72679095000034,109.98673149999993,111.01724060000002,109.44700000000009,112.31333666666666,160992368,228637409.6,59.455885397505966,NaN,1.5,2.75,NaN,NaN,1.465930521542154,0.704138348495355,297.85856627721927,0.42828230606233353,0.33556915067248383,-0.09271315538984973,11.492007057090724,1.7594868274520983,65.78080680855011,9.400010708154817,24.819182483295076,5649066061
1267626600,112.49001,112.97,112.02,112.3,NaN,NaN,104.15688888888889,118.41111111111111,103.84474090000035,110.05173149999993,111.05964080000004,109.54300000000009,110.33411559616998,110.53334180859966,110.74461615384627,112.93897032101758,108.55026198667495,103.84474090000035,110.05173149999993,111.05964080000004,109.54300000000009,112.43,150784944,225360263.2,59.85915385706027,NaN,1.5,2.75,NaN,NaN,1.4290783414320003,0.6690839896037183,299.3340605446881,0.4278920320683522,0.4421518846955905,0.01425985262723832,11.396093985184336,1.2532684158326577,64.7308642105501,9.945072775398994,25.324063014050907,5799851005
1267713000,112.45,112.8,112.03,112.64101,NaN,NaN,104.132,118.51333333333334,103.95179595000035,110.11204159999993,111.10826080000004,109.6835505000001,110.424582043379,110.73407211254255,111.09854076923088,112.8789694936971,109.31811204476466,103.95179595000035,110.11204159999993,111.10826080000004,109.6835505000001,112.49033666666666,135770368,223512250.4,61.273722374232456,NaN,1.5,2.75,NaN,NaN,1.382001317044,0.6074403875269648,301.61851890500026,0.4268490656947242,0.5478211847456436,0.12097211905091938,11.141304329299668,1.3505578549577053,100,0,0,5935621373
1267799400,113.37,114.34,113.10001,114.25,NaN,NaN,104.10711111111111,118.61555555555556,104.06744595000035,110.18194169999991,111.16666080000005,110.07405050000008,110.57459843383472,111.06892238753849,111.44546307692319,113.7206627627146,109.17026339113178,104.06744595000035,110.18194169999991,111.16666080000005,110.07405050000008,113.89667000000001,176118752,214482412,67.15506850318128,NaN,1.5,2.75,NaN,NaN,1.4046433658265722,0.82113377203162,306.8466479521196,0.5053983244071439,0.7527200245598493,0.24732170015270538,13.30187017536471,2.7797768981648106,100,0,0,6111740125
1268058600,114.25999,114.52,114.07001,114.27,NaN,NaN,104.08222222222221,118.71777777777778,104.18624600000035,110.24784179999992,111.21746080000007,110.4545505000001,110.71951614231179,111.37378692205864,111.7539253846155,114.36511195300179,109.14273881622921,104.18624600000035,110.24784179999992,111.21746080000007,110.4545505000001,114.28667,114631120,195534684.8,67.2217059985072,NaN,1.5,2.75,NaN,NaN,1.3364538396961028,0.5862444308397197,309.10342070448394,0.5271592312651177,0.9062707392341025,0.37911150796898485,13.302217179600838,4.061560877879969,100,0,0,6226371245
1268145000,113.92999,114.99001,113.87,114.46001,NaN,NaN,104.05733333333333,118.82000000000001,104.31249600000035,110.31784179999991,111.26766100000006,110.8830510000001,110.86620217594663,111.66771292948162,112.02700307692318,114.95173659855692,109.10226955528944,104.31249600000035,110.31784179999991,111.26766100000006,110.8830510000001,114.44000666666666,154556688,192054178.4,67.88827495959708,NaN,1.5,2.75,NaN,NaN,1.320993565432095,0.8047556647171598,310.9122156432304,0.5218336951624915,1.0314036269220992,0.5095699317596077,9.405769624114392,3.2846053704561124,100,0,0,6380927933
1268231400,114.50999,115.27499,114.41,114.97,NaN,NaN,104.03244444444444,118.92222222222223,104.44224600000035,110.37444179999991,111.31746100000008,111.2705510000001,111.02713542394872,111.98221646000718,112.32161846153856,115.58195325173769,109.06128367133944,104.44224600000035,110.37444179999991,111.31746100000008,111.2705510000001,114.88499666666665,186088816,184467598.4,69.67100912172683,NaN,1.5,2.75,NaN,NaN,1.2884218821869458,1.0087886307083835,314.10631131978914,0.5190410862872734,1.1583712896186995,0.6393302033314261,8.862037216990315,3.8854251377970517,100,0,0,6567016749
1268317800,114.7,115.48,114.35001,115.45,NaN,NaN,104.00755555555556,119.02444444444446,104.56299600000037,110.43184169999991,111.37206100000007,111.69255150000008,111.20058109359779,112.31248155905412,112.65161846153856,116.22797277923758,109.07526414383955,104.56299600000037,110.43184169999991,111.37206100000007,111.69255150000008,115.09333666666669,160875872,180485816.8,71.2867424279784,NaN,1.5,2.75,NaN,NaN,1.277105319173593,0.8913491090453374,315.69340549611525,0.5148855689343005,1.2829371644993017,0.7680515955650012,8.262718238707981,4.253196292830392,100,0,0,6727892621
1268404200,115.95,115.97,115.14,115.46001,NaN,NaN,103.98266666666666,119.12666666666668,104.69194605000037,110.49754179999992,111.43002120000007,112.05905200000007,111.36761752129983,112.61224617247754,113.08623461538471,116.54701221166493,109.62545701910449,104.69194605000037,110.49754179999992,111.43002120000007,112.05905200000007,115.52333666666668,162074752,177409976,71.32105493199222,NaN,1.5,2.75,NaN,NaN,1.2451692249469077,0.913560531680586,317.3508893564447,0.47892645385779553,1.3667096628872457,0.8877832090294502,8.354811429243291,3.1906425954061994,100,0,0,6889967373
1268659800,115.25999,115.575,114.60001,115.49001,NaN,NaN,103.95777777777778,119.2288888888889,104.81479610000038,110.55454199999993,111.48942140000007,112.43155300000005,111.52927997144494,112.88631891795588,113.44546538461549,116.8599118204582,110.03101894877278,104.81479610000038,110.55454199999993,111.48942140000007,112.43155300000005,115.22167333333333,146816816,169519712.8,71.43124264188003,NaN,1.5,2.75,NaN,NaN,1.225870708879272,0.866075181316612,315.37354014350586,0.42510264093269845,1.4191615101953232,0.9940588692626248,7.606265445388914,2.932272727272723,100.00000000000001,0,0,7036784189
1268746200,115.81,116.52,115.49001,116.41,NaN,NaN,103.93288888888888,119.33111111111111,104.93419610000039,110.62653199999994,111.58882140000007,112.76505250000005,111.72068075687847,113.22190759243627,113.88700384615396,117.23551768967957,110.53849000262835,104.93419610000039,110.62653199999994,111.58882140000007,112.76505250000005,116.14000333333333,168673008,169987491.2,74.64806864301056,NaN,1.5,2.75,NaN,NaN,1.2118792296736096,0.9922671768921313,318.89436766201544,0.4187313024189667,1.5174729972863332,1.0987416948673665,8.069616040055376,3.6598397150489754,100.00000000000001,0,0,7205457197
1268832600,116.75999,117.48,116.4198,117.10001,NaN,NaN,103.908,119.43333333333334,105.04584615000039,110.71523209999994,111.66422160000008,113.10705350000005,111.93163484484401,113.5912506788709,114.37623461538473,117.59870866280819,111.15376056796127,105.04584615000039,110.71523209999994,111.66422160000008,113.10705350000005,116.99993666666666,177468064,170418641.6,76.76155855342763,NaN,1.5,2.75,NaN,NaN,1.201744998982638,1.0413653244376055,322.3665686607021,0.4268050919884596,1.632248059852941,1.2054429678644814,7.947439248178329,3.958593766160303,100.00000000000001,0,0,7382925261
1268919000,117.11,117.27,116.57001,117.03751,NaN,NaN,103.8831111111111,119.53555555555556,105.15678365000038,110.79230719999994,111.73237180000007,113.41342900000006,112.13186524308543,113.91946585231177,114.77219692307705,117.93991417333594,111.60447967281816,105.15678365000038,110.79230719999994,111.73237180000007,113.41342900000006,116.95917333333334,196509056,170558669.6,76.14236729060451,NaN,1.5,2.75,NaN,NaN,1.165905356198164,1.1521493246919652,320.21569380933056,0.3945133612634921,1.6985846694438465,1.3040713081803543,8.386974905533453,2.4398336980306325,72.67512293663982,6.177686813383623,21.147190249976546,7186416205
1269005400,116.96001,117.293,115.52,115.97,NaN,NaN,103.85822222222222,119.63777777777779,105.26838370000037,110.87120719999993,111.77757160000009,113.65492900000007,112.28238033159188,114.11475481875827,115.06219692307704,117.90890303998324,112.21549080617083,105.26838370000037,110.87120719999993,111.77757160000009,113.65492900000007,116.26100000000001,226641120,170756484.8,66.30450595285326,NaN,1.5,2.75,NaN,NaN,1.2092692593268672,1.3272767957565732,316.5177621178061,0.2735775242466276,1.646043213488639,1.3724656892420113,8.539458316122637,1.487704559376917,39.787626912628745,27.312151827565135,32.90022125980612,6959775085
1269264600,115.31,116.8,115.24001,116.5925,NaN,NaN,103.83333333333333,119.74000000000001,105.37869620000038,110.96803219999994,111.82562160000009,113.92655400000008,112.45140463231377,114.3507305503051,115.39238923076935,117.85014845173289,112.93463000980582,105.37869620000038,110.96803219999994,111.82562160000009,113.92655400000008,116.21083666666668,184477680,173363028,68.83332030027188,NaN,1.5,2.75,NaN,NaN,1.2343207408035195,1.0641120089342233,319.40655645859306,0.2106498866528297,1.6357780475580483,1.4251281609052187,8.760385645420907,1.863087378727299,41.397082097317956,25.875996467706578,32.726921434975466,7144252765
1269351000,116.75999,117.50999,116.38,117.41,NaN,NaN,103.80844444444445,119.84222222222223,105.49299620000038,111.07793219999994,111.88242140000007,114.30655400000008,112.64585935261519,114.64208954551414,115.75923461538474,117.86293610309784,113.65553312767165,105.49299620000038,111.07793219999994,111.88242140000007,114.30655400000008,117.09999666666666,182941568,172135259.2,71.82392307339113,NaN,1.5,2.75,NaN,NaN,1.22686854503184,1.0627780087021244,323.2357758762178,0.19934376614016736,1.6743078685804278,1.4749641024402604,9.20317162439294,2.1222927720274836,42.42423297041273,25.006626401154346,32.569140628432926,7327194333
1269437400,116.97,117.42641,115.58,116.84,NaN,NaN,103.78355555555555,119.94444444444446,105.60639620000038,111.20223219999994,111.92462140000009,114.60755350000008,112.8103354564342,114.85141435070327,115.9584653846155,117.93971027963423,113.97722048959676,105.60639620000038,111.20223219999994,111.92462140000009,114.60755350000008,116.61547,196183312,173126893.6,66.99674132183759,NaN,1.5,2.75,NaN,NaN,1.2711215061009946,1.1331764113625846,320.10756324186667,0.13198434466560816,1.6399445332722706,1.5079601886066625,10.013105119778658,1.203984408834994,18.339119133267545,51.06176413228873,30.599116734443726,7131011021
1269523800,117.63,118.1666,116.50999,116.64999,NaN,NaN,103.75866666666667,120.04666666666668,105.7164461500004,111.30223219999995,111.98442120000009,114.90655300000007,112.96091014441717,115.0227072696839,116.14154153846165,117.89116992615729,114.39191315076602,105.7164461500004,111.30223219999995,111.98442120000009,114.90655300000007,117.10886,223396256,171314972,65.41836520504215,NaN,1.5,2.75,NaN,NaN,1.2986563985223523,1.304008945581242,317.6270509608105,0.05697214731577338,1.5791753727513793,1.522203225435606,10.024579013808173,1.030642557540057,17.347386929774125,52.48146940732228,30.171143662903592,6907614765
1269610200,116.87,117.42,116.12,116.582,NaN,NaN,103.73377777777777,120.1488888888889,105.82735620000038,111.43245219999996,112.02366120000009,115.19865250000007,113.10291366816551,115.17121133923781,116.30477153846164,117.76911505349754,114.84042802342573,105.82735620000038,111.43245219999996,112.02366120000009,115.19865250000007,116.70733333333334,205808496,172925934.4,64.82981318038219,NaN,1.5,2.75,NaN,NaN,1.2987523700564698,1.1901540200669865,318.1440874514698,-0.011247218065900011,1.5081442028532308,1.5193914209191308,10.05498282569037,0.945527669449501,18.082061348424425,51.42588889531562,30.492049756259945,6701806269
1269869400,117.16991,117.53,116.6886,117.32001,NaN,NaN,103.7088888888889,120.25111111111111,105.93985620000038,111.56245219999995,112.0714616000001,115.47015300000007,113.26828999490412,115.37585883073898,116.48554153846163,117.8206605523267,115.15042252459656,105.93985620000038,111.56245219999995,112.0714616000001,115.47015300000007,117.17953666666665,134513504,172266128,68.17663896133789,NaN,1.5,2.75,NaN,NaN,1.2736986293381511,0.7808470856209179,321.65936025128815,-0.020170124386410304,1.4941787654361178,1.5143488898225281,10.488335369729862,0.7817283738510435,15.14260796622925,55.805323873868964,29.05206815990178,6836319773
1269955800,117.46001,117.83,116.91,117.39999,NaN,NaN,103.684,120.35333333333334,106.05145615000038,111.68995219999995,112.1466614000001,115.73015250000007,113.43031744608436,115.56863322781146,116.63554076923084,117.90828906748433,115.36279247097735,106.05145615000038,111.68995219999995,112.1466614000001,115.73015250000007,117.37999666666667,145772368,171505128,68.52619078724247,NaN,1.5,2.75,NaN,NaN,1.2484344415282833,0.8499592385365876,322.41445987292525,-0.0334073709654259,1.4725896761157458,1.5059970470811717,9.674706354936808,0.25617418820032983,12.655719554796399,59.84114193666365,27.503138508539955,6982092141
1270042200,116.95,117.52,116.61,117,NaN,NaN,103.6591111111111,120.45555555555556,106.17195620000037,111.81075219999995,112.1854614000001,115.96515250000007,113.5703049972183,115.7049538727818,116.75400153846161,117.84001985411324,115.66798322280998,106.17195620000037,111.81075219999995,112.1854614000001,115.96515250000007,117.04333333333334,161078688,172019815.2,64.69870543446149,NaN,1.5,2.75,NaN,NaN,1.2242605528476915,0.9363961228113215,319.9366009289503,-0.07920926604313516,1.4069854645272528,1.486194730570388,9.364502167662133,-0.03204955402759123,13.761310251752267,58.00322909494649,28.23546065330125,6821013453
1270128600,117.8,118.25,117.10001,117.8,NaN,NaN,103.63422222222222,120.55777777777779,106.30275620000037,111.92025119999995,112.26366140000009,116.22310200000008,113.73617538948425,115.904482075374,116.93169307692315,117.87942539657243,115.98396075727388,106.30275620000037,111.92025119999995,112.26366140000009,116.22310200000008,117.71667000000001,161215184,173292056,68.489558653467,NaN,1.5,2.75,NaN,NaN,1.226099084787142,0.9303091423879234,323.73964679966195,-0.0662599485494968,1.4033697948835169,1.4696297434330137,10.15018106643572,1.5779943088729829,40.588139871351316,26.58371667799022,32.828143450658466,6982228637
1270474200,118.25,118.84,117.92,118.75999,NaN,NaN,103.60933333333332,120.66000000000001,106.43880615000036,112.03655109999995,112.40486120000008,116.44860150000008,113.93318772715153,116.17643521105268,117.1124615384616,118.42099456112874,115.80392851579447,106.43880615000036,112.03655109999995,112.40486120000008,116.44860150000008,118.50666333333334,105847632,169778500,72.32950123019275,NaN,1.5,2.75,NaN,NaN,1.2128062930166321,0.6234454421496244,327.9793765837373,-0.006804125977052156,1.4611245859616986,1.4679287119387507,8.794088164708423,1.8590303836010043,73.18542261056842,5.9558450861771215,20.858732303254456,7088076269
1270560600,118.42,119.25,118.28999,119.03999,NaN,NaN,103.58444444444444,120.76222222222223,106.57291115000037,112.13125089999996,112.6014608000001,116.6871010000001,114.13345448294952,116.44915471476195,117.26169076923085,118.92491746529775,115.59846407316395,106.57291115000037,112.13125089999996,112.6014608000001,116.6871010000001,118.85999333333332,110384128,169566150.4,73.34961754940927,NaN,1.5,2.75,NaN,NaN,1.1947494149440152,0.6509797370501607,330.02148646470783,0.03530443529278071,1.5120592560547266,1.4767548207619459,8.58924395165041,1.3882889021378133,72.16717683814841,6.385534310082352,21.44728885176923,7198460397
1270647000,118.8,119.3567,117.81,118.36,NaN,NaN,103.55955555555555,120.86444444444446,106.70451120000035,112.21895089999997,112.77326080000007,116.88210050000012,114.2992013659711,116.63113998002271,117.36342076923084,119.11859239174804,115.60824914671365,106.70451120000035,112.21895089999997,112.77326080000007,116.88210050000012,118.50890000000001,184576320,171067132,66.899267979755,NaN,1.5,2.75,NaN,NaN,1.2198887424480145,1.0789700969558547,327.14274911773236,0.0029878838498755833,1.4804896755742902,1.4775017917244146,9.017565700553442,1.3009243409791134,37.36655224292917,29.476067659925413,33.15738009714541,7013884077
1270733400,117.95,118.97,117.60001,118.77251,NaN,NaN,103.53466666666667,120.96666666666668,106.85197375000035,112.30517609999997,112.96251100000006,117.07222600000011,114.47462523397223,116.8350799819253,117.57899846153853,119.28435576777473,115.87364115530234,106.85197375000035,112.30517609999997,112.96251100000006,117.07222600000011,118.44750666666665,158704000,169697891.2,68.69763835910486,NaN,1.5,2.75,NaN,NaN,1.230610260844585,0.935214921515772,328.2518027683733,-0.004568811631026293,1.4717907771856318,1.476359588816658,8.344940770523605,1.8195629506697724,69.08080913716759,7.7709137296599895,23.148277133172424,7172588077
1270819800,119.02,119.60001,118.8,119.55,NaN,NaN,103.50977777777777,121.0688888888889,107.00297370000037,112.41037609999995,113.15691100000008,117.27722600000013,114.67365953852234,117.09364379317051,117.80649846153854,119.70310499477335,115.90989192830372,107.00297370000037,112.41037609999995,113.15691100000008,117.27722600000013,119.31667,133006496,168304422.4,71.80672022503214,NaN,1.5,2.75,NaN,NaN,1.2018166707842575,0.7902733279574239,331.58989460995844,0.02709220957694214,1.5102248507878357,1.4831326412108936,8.486549890940879,2.5458475579420528,67.72775500797596,8.417408057083765,23.854836934940284,7305594573
1271079000,119.7,120.05,119.56,119.74001,NaN,NaN,103.48488888888889,121.17111111111112,107.15108375000038,112.51157619999995,113.38031100000008,117.49122600000014,114.87233994877637,117.34567867001142,117.98573000000007,120.12361340141808,115.84784659858207,107.15108375000038,112.51157619999995,113.38031100000008,117.49122600000014,119.78333666666667,110278944,165714632,72.52494430875818,NaN,1.5,2.75,NaN,NaN,1.151686908585382,0.6654749955936299,333.36721802022254,0.044121063017581674,1.5382839699828708,1.494162906965289,8.291796590645518,2.062734225815359,69.75170574389092,7.547555590807507,22.70073866530159,7415873517
1271165400,119.62,120.03999,119,119.83,NaN,NaN,103.46,121.27333333333334,107.28983375000038,112.59777609999993,113.62911100000007,117.70822550000014,115.06675799000082,117.5822807014389,118.21573000000006,120.4521562201242,115.97930377987593,107.28983375000038,112.59777609999993,113.62911100000007,117.70822550000014,119.62333,125125056,164630044,72.87735484333732,NaN,1.5,2.75,NaN,NaN,1.1437085579721409,0.760037797232199,332.5042690929599,0.04460247297521169,1.5499159981843036,1.505313525209092,8.00897613465922,2.0698553722193638,70.53207124961891,7.1891475180199995,22.278781232361084,7540998573
1271251800,120.27,121.19,120.08,121.19,NaN,NaN,103.43511111111111,121.37555555555556,107.43658375000037,112.69628609999994,113.87171100000005,117.94722550000014,115.30688512764785,117.92587301558758,118.56496153846162,121.11081384441081,116.01910923251242,107.43658375000037,112.69628609999994,113.87171100000005,117.94722550000014,120.81999999999998,161609008,164276844,77.5615278136716,NaN,1.5,2.75,NaN,NaN,1.1591579466884165,0.9837601214203994,336.4601427221615,0.11563444279648638,1.6498565787047,1.5342221359082135,9.485285086391151,3.581196581196579,100,0,0,7702607581
1271338200,120.99001,121.5654,120.95,121.28999,NaN,NaN,103.41022222222222,121.47777777777779,107.57953370000037,112.79648599999993,114.08991080000006,118.15672450000015,115.54151669126949,118.24626510934115,118.92711461538468,121.57885212824203,116.27537710252733,107.57953370000037,112.79648599999993,114.08991080000006,118.15672450000015,121.26846333333334,144615248,162634203.2,77.86421783037471,NaN,1.5,2.75,NaN,NaN,1.1203180933535293,0.8892056231379502,335.450840196263,0.14648807464354463,1.7173322292126443,1.5708441545690996,8.688109024194144,2.9626400679117197,100,0,0,7847222829
1271424600,120.86,121.285,118.75,119.36,NaN,NaN,103.38533333333334,121.58000000000001,107.71658370000037,112.89188589999995,114.28051080000004,118.27284900000015,115.69126113474913,118.35233509892771,119.084036923077,121.57324736592639,116.5948264802276,107.71658370000037,112.89188589999995,114.28051080000004,118.27284900000015,119.79833333333333,366879744,171152737.6,60.81211029704167,NaN,1.5,2.75,NaN,NaN,1.2217232295425633,2.1435809274487467,330.7358885283486,0.020658847117296597,1.5966677134657203,1.5760088663484237,13.908914121389119,0.5052290758865823,50.240494325285766,19.10634850330556,30.653157171408676,7480343085
1271683800,119.00999,119.92999,118.47,119.81,NaN,NaN,103.36044444444444,121.68222222222224,107.85398370000037,112.99568599999994,114.54791080000007,118.46484900000016,115.85278030593544,118.49116032760126,119.26942230769237,121.58204823858144,116.9567963768033,107.85398370000037,112.99568599999994,114.54791080000007,118.46484900000016,119.40333,217947744,170718068.8,62.854722325156146,NaN,1.5,2.75,NaN,NaN,1.2387422845752378,1.2766530545476742,328.7358885283486,-0.0449416691648763,1.5198317798923284,1.5647734490572047,13.344339137452785,0.6468498527259614,54.73608363130618,15.863919949446576,29.39999641924724,7698290829
1271770200,120.56,120.98,119.871,120.88,NaN,NaN,103.33555555555556,121.78444444444446,108.00933370000037,113.09628589999993,114.83231080000007,118.67922400000016,116.04992617629091,118.71866886782972,119.56788384615392,121.61858188008927,117.51718581221857,108.00933370000037,113.09628589999993,114.83231080000007,118.67922400000016,120.577,157707936,169379581.6,67.22876275764435,NaN,1.5,2.75,NaN,NaN,1.2338321213912924,0.9310917792466669,333.2358885283486,-0.02968372587835555,1.5276687917092602,1.5573525175876157,14.111768235062272,2.1290976681311222,56.41970722650449,14.774596035075309,28.80569673842019,7855998765
1271856600,120.95,121.23,119.99001,120.66,NaN,NaN,103.31066666666666,121.88666666666668,108.16363370000037,113.19298579999993,115.12771080000006,118.84172400000016,116.23071338506382,118.90355754708403,119.78788384615392,121.63642025562642,117.93934743668142,108.16363370000037,113.19298579999993,115.12771080000006,118.84172400000016,120.62666999999999,192910064,169878006.4,65.5204030078683,NaN,1.5,2.75,NaN,NaN,1.2342719698633433,1.1355799852381596,335.2054369230627,-0.046802244331580756,1.49884971217314,1.5456519565047206,13.544106818989126,1.5891640245710053,32.42627362239549,34.30003595426988,33.273690423334614,7663088701
1271943000,119.81,121.17,119.12,121.02,NaN,NaN,103.28577777777778,121.98888888888891,108.32843370000037,113.28938579999995,115.40371080000006,119.05072400000014,116.41852854643386,119.10512349498079,119.96173076923084,121.81597172599815,118.10748981246353,108.32843370000037,113.28938579999995,115.40371080000006,119.05072400000014,120.43666666666667,239188560,172028268.8,66.99823766610537,NaN,1.5,2.75,NaN,NaN,1.292538257730247,1.3904026452657063,338.5127427155376,-0.04619540394646182,1.4879077015716433,1.5341031055181051,13.526179447423337,1.2296110414052688,38.08780380879834,28.843256300537703,33.06893989066395,7902277261
1272029400,120.94,121.86,120.63,121.8125,NaN,NaN,103.26088888888889,122.09111111111112,108.49749620000037,113.41181069999995,115.69976100000007,119.30884950000015,116.63005683873057,119.36296887641119,120.17500076923085,122.18716595979272,118.16283557866898,108.49749620000037,113.41181069999995,115.69976100000007,119.30884950000015,121.43416666666668,177335440,169725228,70.04230029246222,NaN,1.5,2.75,NaN,NaN,1.288071239320944,1.044838425552152,341.81993185436835,-0.006804035343377812,1.5255980613388829,1.5324020966822607,13.526486322691504,1.7308249765471058,77.63838076209132,4.246263493862421,18.115355744046266,8079612701
1272288600,121.85001,122.12,121.23,121.35001,NaN,NaN,103.23599999999999,122.12,108.66339625000037,113.52591079999995,115.96416120000008,119.54725000000016,116.81515304113329,119.55221088818155,120.40500153846162,122.20733701059784,118.6026660663254,108.66339625000037,113.52591079999995,115.96416120000008,119.54725000000016,121.56666999999999,143457184,166607662.4,66.20442191549938,NaN,1.5,2.75,NaN,NaN,1.2596375793694479,0.8610479370125296,340.2970566342107,-0.025243258609440655,1.5008480234204598,1.5260912820299004,13.91565204677474,1.2684720020028366,54.96417535869214,15.846836763264395,29.188987878043463,7936155517
1272375000,120.64999,121.33459,118.25,118.48,NaN,NaN,103.21111111111111,122.22115942028987,108.81599620000037,113.59771079999994,116.17296140000006,119.60524950000017,116.88044115716727,119.45009556549759,120.38250076923084,122.27103812357042,118.49396341489127,108.81599620000037,113.59771079999994,116.17296140000006,119.60524950000017,119.35486333333334,355853824,177674678.4,48.45945843050865,NaN,1.5,2.75,NaN,NaN,1.39109275227163,2.0028392745918713,335.05165048079556,-0.23254772944309643,1.2354066202260299,1.4679543496691263,20.108833418134864,-2.2361580988530356,21.02404980335421,47.666648433985664,31.30930176266013,7580301693
1272461400,119.05,119.67999,118.27,119.38,NaN,NaN,103.18622222222221,122.32231884057971,108.96238615000038,113.67901079999994,116.36576120000005,119.70425000000019,116.97846307257247,119.44341979735496,120.36942384615394,122.28302621103796,118.45582148126991,108.96238615000038,113.67901079999994,116.36576120000005,119.70425000000019,119.10999666666667,300677632,185419941.6,52.73753238519501,NaN,1.5,2.75,NaN,NaN,1.3924425556808,1.6216035309116936,337.3877683734779,-0.30623878152456285,1.0851558727634227,1.3913946542879856,19.370102309932477,-1.5747301158158291,49.33429044449782,19.77449317516294,30.891216380339237,7880979325
1272547800,120.10001,121.11,120.07001,120.8575,NaN,NaN,103.16133333333333,122.42347826086957,109.11362365000038,113.78378579999995,116.57771140000006,119.89712500000019,117.13058216776571,119.57809410236878,120.4553846153847,122.34845593166088,118.56231329910852,109.11362365000038,113.78378579999995,116.57771140000006,119.89712500000019,120.67917,193774880,187054751.2,58.785616002998985,NaN,1.5,2.75,NaN,NaN,1.4165538017036003,1.035925998975641,341.65048249799025,-0.254767843551889,1.0729348498481244,1.3277026934000133,20.92790132793905,1.2546079088471869,47.02797599020456,21.513365147417318,31.458658862378122,8074754205
1272634200,120.88,121.00999,118.78,118.8125,NaN,NaN,103.13644444444444,122.52463768115942,109.24138620000038,113.86181089999995,116.73576140000006,119.94775000000018,117.19653972981412,119.50518037833366,120.37711538461548,122.44335773972088,118.31087302951008,109.24138620000038,113.86181089999995,116.73576140000006,119.94775000000018,119.53416333333332,270000896,192494036.8,49.36879296139449,NaN,1.5,2.75,NaN,NaN,1.4746563872962004,1.4026455078217779,336.9136586676162,-0.35176303997221803,0.8879988934347409,1.239761933406959,21.2146575817275,-0.8325682330356416,22.628885771182016,45.60057259643704,31.77054163238093,7804753309
1272893400,119.38,120.67999,119.2,120.35001,NaN,NaN,103.11155555555555,122.62579710144928,109.37238630000036,113.95691099999995,116.91996160000006,120.02725100000018,117.32020523060572,119.58564034230189,120.31250076923085,122.32485411415954,118.30014742430217,109.37238630000036,113.95691099999995,116.91996160000006,120.02725100000018,120.07666666666665,182747808,196339045.6,55.18175518477272,NaN,1.5,2.75,NaN,NaN,1.5027159310607578,0.9307766951883361,341.9761711128418,-0.3073001267639188,0.8556367749520604,1.1629369017159792,22.478162737049015,-0.43844308405029614,35.9521867949411,30.78715797156365,33.26065523349525,7987501117
1272979800,119.00999,119.03,116.92,117.52,NaN,NaN,103.08666666666666,122.72695652173914,109.48933630000036,114.03601099999995,117.04716160000007,119.95125150000017,117.32804031960157,119.38891269065408,120.02250153846163,122.43467391402447,117.61032916289878,109.48933630000036,114.03601099999995,117.04716160000007,119.95125150000017,117.82333333333332,360353280,208837503.2,44.951660313634534,NaN,1.5,2.75,NaN,NaN,1.640379793127846,1.7255199591947623,335.90810481694257,-0.4545293542488471,0.5947752089049203,1.0493045631537674,25.589502403798438,-2.6023537212000667,35.86637008970513,30.86871917447179,33.26491073582307,7627147837
1273066200,116.56,117.8,115.97,116.82001,NaN,NaN,103.06177777777778,122.82811594202899,109.59778135000035,114.10400109999993,117.18736180000008,119.87425200000015,117.30811756197014,119.14425529154417,119.82711769230778,122.77440543377215,116.87982995084342,109.59778135000035,114.10400109999993,117.18736180000008,119.87425200000015,116.86333666666668,328973312,216057352.8,42.83629861068408,NaN,1.5,2.75,NaN,NaN,1.653924093618714,1.5226203030661216,330.4148873083697,-0.5772206378117964,0.3277787658890219,0.9049994037008183,25.641057425595463,-3.4704924805817217,10.140403855551893,64.3263797587424,25.533216385705703,7298174525
1273152600,116.25999,117,105,112.942,NaN,NaN,103.03688888888888,122.92927536231885,109.68464130000035,114.12702109999992,117.22980160000006,119.58272650000018,117.13689726542229,118.55356431139711,119.29881000000009,124.0058350850425,114.59178491495767,109.68464130000035,114.12702109999992,117.22980160000006,119.58272650000018,111.64733333333335,647356416,240489973.6,33.44590790926709,NaN,1.5,2.75,NaN,NaN,2.3929295155030914,2.6918228910313293,317.33564166243633,-0.879598543053832,-0.19449877511647173,0.6850997679373603,30.565024132350047,-7.282093381221144,1.2047413116002548,88.47387841683086,10.321380271568884,6650818109
1273239000,112.64,113.77,109.41,111.25999,NaN,NaN,103.012,123.0304347826087,109.76319125000035,114.12852099999992,117.24160140000005,119.16822600000016,116.9064303138371,117.85893818650214,118.55880923076931,124.81023189021269,112.30738657132594,109.76319125000035,114.12852099999992,117.24160140000005,119.16822600000016,111.47999666666666,637558784,265717588,30.33933134261433,NaN,1.5,2.75,NaN,NaN,2.5334345501100133,2.399384959041552,312.2387089177108,-1.1366010194596934,-0.7356515063872564,0.4009495130724369,29.586157402903304,-8.314807720246579,0.8425457387205826,90.43098202146591,8.726472239813507,6013259325
1273498200,115.81,116.64999,114.91,116.16,NaN,NaN,102.9871111111111,123.13159420289855,109.85568625000035,114.17142099999992,117.35000120000004,118.98922550000016,116.87715853682388,117.69713454969242,118.21265538461547,124.45870072761086,111.96661004162009,109.85568625000035,114.17142099999992,117.35000120000004,118.98922550000016,115.90666333333334,396159488,280011615.2,46.05809624292593,NaN,1.5,2.75,NaN,NaN,2.7374749393878695,1.414796624479455,323.36568172299457,-0.9290508784142874,-0.7603640849454223,0.16868679346886506,42.1664077465568,-1.9581363943281629,3.079664272208392,81.16841944966767,15.751916278123941,6409418813
1273584600,115.07001,117.36,114.91,115.83,NaN,NaN,102.96222222222222,123.23275362318842,109.94453625000034,114.21622089999991,117.42880120000004,118.78922550000016,116.83609349616412,117.51931221162647,117.81342461538469,123.95324102674694,111.67360820402244,109.94453625000034,114.21622089999991,117.42880120000004,118.78922550000016,116.03333333333333,317849600,289647842.4,45.31646425429895,NaN,1.5,2.75,NaN,NaN,2.7169410151458786,1.0973656746976688,325.5318552368913,-0.7728578030475888,-0.797385460340621,-0.024527657293032162,40.28548758339493,-2.973697436756573,3.2191491154530754,80.72064791609219,16.060202968454732,6091569213
1273671000,116.28999,117.62,116.09,117.45,NaN,NaN,102.93733333333333,123.33391304347826,110.04003620000036,114.27552089999992,117.53380120000003,118.60222550000015,116.86016826102043,117.51271104861442,117.47784769230778,123.1670247932548,111.78867059136076,110.04003620000036,114.27552089999992,117.53380120000003,118.60222550000015,117.05333333333334,235607008,293347742.4,49.60633469518427,NaN,1.5,2.75,NaN,NaN,2.6507309426354593,0.8031662561041071,331.6258896068273,-0.5308362968934968,-0.688073028409903,-0.15723673151640633,41.00499250307304,-2.8194361127774434,9.783607372542377,65.07716243327197,25.13923019418567,6327176221
1273757400,117.13,117.67999,115.89,115.99001,NaN,NaN,102.91244444444445,123.43507246376812,110.13053625000038,114.3336210999999,117.60760140000004,118.33722650000013,116.82604440764709,117.36769190112733,117.06554000000008,122.33378866856872,111.79729133143145,110.13053625000038,114.3336210999999,117.60760140000004,118.33722650000013,116.52,234456064,297839783.2,46.09658690665546,NaN,1.5,2.75,NaN,NaN,2.5892494467329263,0.7871885396940486,328.23759807856123,-0.44305424345305894,-0.71105453583273,-0.2680002923796711,40.389483488029235,-2.3755833771699124,15.105655242867973,55.93441536321255,28.959929393919484,6092720157
1273843800,115.12,115.33,112.87,113.89,NaN,NaN,102.88755555555555,123.53623188405798,110.21172630000038,114.3704209999999,117.63258120000005,118.06372650000012,116.71090541126877,117.03648314863901,116.71246307692317,122.16617535483076,111.25875079901559,110.21172630000038,114.3704209999999,117.63258120000005,118.06372650000012,114.02999999999999,345602048,296775898.4,41.54357485283034,NaN,1.5,2.75,NaN,NaN,2.627160914823431,1.1645219502770783,321.337692597167,-0.4963829421081956,-0.8884789700149156,-0.39209602790672,40.536250718849914,-5.367685470071833,21.54518769674801,46.813806430457255,31.641005872794725,5747118109
1274103000,114.2,114.52,111.77,113.95,NaN,NaN,102.86266666666667,123.63739130434783,110.28812630000039,114.39662099999991,117.62658120000003,117.77072650000011,116.60263461082685,116.74253237257815,116.29477076923087,121.69881646219034,110.8907250762714,110.28812630000039,114.39662099999991,117.62658120000003,117.77072650000011,113.41333333333336,325944064,302175714.4,41.72069134073752,NaN,1.5,2.75,NaN,NaN,2.6359351351931863,1.0786573786950233,318.50670465059727,-0.4963833987464774,-1.0125752763398168,-0.5161918775933394,39.234025776163655,-3.0377808032675233,18.81998639404668,50.40971037530167,30.770303230651624,6073062173
1274189400,114.88,115.22,112.03,112.39999,NaN,NaN,102.83777777777777,123.73855072463769,110.35607625000038,114.40332089999991,117.58918100000002,117.3467260000001,116.4378250182454,116.3289569085231,115.64419307692316,120.7208548779432,110.56753127590312,110.35607625000038,114.40332089999991,117.58918100000002,117.3467260000001,113.21666333333333,360595968,312320116,38.477300629807026,NaN,1.5,2.75,NaN,NaN,2.6755111969651013,1.1545717023235225,313.2528062621754,-0.5645744412398841,-1.2219099291431945,-0.6573354879033104,37.91653901384836,-3.783615495324811,17.95911391221501,51.62299645680414,30.417889630980856,5712466205
1274275800,111.77,112.77,110.36,111.75999,NaN,NaN,102.81288888888889,123.83971014492754,110.41267620000039,114.40142079999991,117.53518060000002,116.90172550000011,116.25438050772598,115.89381720294946,115.10169230769239,120.2152784818046,109.98810613358017,110.41267620000039,114.40142079999991,117.53518060000002,116.90172550000011,111.62999666666667,394759424,322412584,37.191648830425976,NaN,1.5,2.75,NaN,NaN,2.656546111467594,1.224392109955609,307.60983388452706,-0.612569843144297,-1.4230477918336817,-0.8104779486893847,37.912979473811305,-1.0465637229728455,4.419903326832643,77.13438490941587,18.445711763751483,5317706781
1274362200,109.38,109.89,107.47,107.53999,NaN,NaN,102.788,123.9408695652174,110.44687615000039,114.3520206999999,117.38658040000001,116.22772500000012,115.91263970350144,115.09821461219238,114.11630615384624,119.71837083977941,108.51424146791307,110.44687615000039,114.3520206999999,117.38658040000001,116.22772500000012,108.29999666666667,530423552,336974333.6,30.059536090541414,NaN,1.5,2.75,NaN,NaN,2.7732206749341946,1.574077011543647,297.3980759555513,-0.8724620763901929,-1.901055544177126,-1.028593467786933,39.31978247423055,-3.3435199841380525,3.223883352439822,80.66595756305844,16.110159084501745,4787283229
1274448600,105.91,109.38,105.36121,109.11501,NaN,NaN,102.7631111111111,124.04202898550726,110.49040120000039,114.3159707999999,117.25988060000003,115.59285050000013,115.64606598963864,114.5283856015074,113.46976846153855,119.2872185242419,107.6523183988352,110.49040120000039,114.3159707999999,117.25988060000003,115.59285050000013,107.95207333333333,500909312,353153027.2,35.06463172755612,NaN,1.5,2.75,NaN,NaN,2.8621899124388945,1.4183916699553638,301.9631608397566,-0.8797300023491634,-2.1282559707233872,-1.2485259683742238,40.18552365298337,-6.064901859504131,19.642794644598762,49.27673281094365,31.08047254445759,5288192541
1274707800,108.52,109.39,107.61,107.71001,NaN,NaN,102.73822222222222,124.1431884057971,110.5295012500004,114.26745089999991,117.10488060000003,114.91085050000011,115.33484810769203,113.87901649660193,112.76899923076932,118.98450214330295,106.5534963182357,110.5295012500004,114.26745089999991,117.10488060000003,114.91085050000011,108.23667,269822976,359471316.8,32.809079672006334,NaN,1.5,2.75,NaN,NaN,2.7848906329789735,0.7506105866858971,298.97206293653335,-0.9164497418618456,-2.394088145701531,-1.4776384038396853,28.35173077142835,-7.010265043598379,6.457571905905245,72.11152277176168,21.43090532233306,5018369565
1274794200,105.11,107.87,104.38,107.81799,NaN,NaN,104.38,124.24434782608697,110.56258120000038,114.2204307999999,116.95144020000002,114.3777500000001,115.04006935837077,113.30177587787794,112.37484461538472,119.12348457927719,105.62620465149224,110.56258120000038,114.2204307999999,116.95144020000002,114.3777500000001,106.68933000000001,396505088,361503880,33.16490741737776,NaN,1.5,2.75,NaN,NaN,2.8352555877661905,1.096821112957349,295.5627831877012,-0.871060774768528,-2.566464372300345,-1.6954035975318171,28.668842445053905,-8.200945083014055,22.395998827028606,45.79783894438397,31.806162228587432,5414874653
1274880600,108.48,109.47,106.85001,107.17,NaN,NaN,104.37733333333333,124.34550724637681,110.59348115000037,114.17773079999989,116.76664020000003,113.7672500000001,114.73143918745427,112.71779722284195,112.0602300000001,119.34729325680966,104.77316674319054,110.59348115000037,114.17773079999989,116.76664020000003,113.7672500000001,107.83000333333331,349719296,363955963.2,32.06741180660295,NaN,1.5,2.75,NaN,NaN,2.8198794743543196,0.9608835446057064,298.6205601579853,-0.8228459413543572,-2.7239610242247636,-1.9011150828704064,25.417649197837164,-7.604111767901387,23.869238390279797,43.960523915642575,32.17023769407762,5065155357
1274967000,109.19,110.8,108.78011,110.75999,NaN,NaN,104.37466666666666,124.44666666666667,110.64863110000037,114.1520306999999,116.6398398,113.2623745000001,114.57569608206391,112.5313393920951,111.64484461538471,118.55567491677174,104.73401431399769,110.64863110000037,114.1520306999999,116.6398398,113.2623745000001,110.11336666666666,300870400,369310739.2,43.26844983888046,NaN,1.5,2.75,NaN,NaN,2.877745226186154,0.8146808854022082,307.12142516587437,-0.5030539956642643,-2.5299325774507366,-2.0268785817864723,34.838792953763274,-2.7482746509790137,54.432725859510946,16.135203251653284,29.432070888835767,5366025757
1275053400,110.64,110.724,108.85001,109.369,NaN,NaN,104.372,124.54782608695653,110.69147610000036,114.10942069999992,116.4864696,112.79019950000011,114.37151192198297,112.23016421189557,111.14784461538471,117.70343990836378,104.59224932240565,110.69147610000036,114.10942069999992,116.4864696,112.79019950000011,109.64766999999999,297933312,370707360,40.48316256193397,NaN,1.5,2.75,NaN,NaN,2.8086191386014288,0.8036886885655575,303.2031422286083,-0.346534744855834,-2.460047012856265,-2.113512268000431,34.1761083324225,-4.020184291355861,23.111857005449828,44.8970062928437,31.99113670170648,5068092445
1275399000,108.35001,109.95,107.37,107.53,NaN,NaN,104.36933333333333,124.64898550724638,110.72127605000036,114.04762059999992,116.31766959999999,112.14919900000011,114.10321733680716,111.78252952504837,110.38476769230778,116.08155114209299,104.68798424252256,110.72127605000036,114.04762059999992,116.31766959999999,112.14919900000011,108.28333333333335,277909248,375465432,37.08431759241924,NaN,1.5,2.75,NaN,NaN,2.792289200129898,0.74017266122118,297.94115357505115,-0.32835778263131754,-2.523959496289578,-2.1956017136582604,34.78515759733526,-4.332731702200331,23.400961322884516,44.45670834392692,32.142330333188546,4790183197
1275485400,108.08,110.34,107.50909,110.33,NaN,NaN,104.36666666666666,124.75014492753624,110.76897610000036,114.00902059999991,116.1924196,111.78969900000011,113.9552480294814,111.64419337980567,109.94938230769239,114.64285840119955,105.25590621418523,110.76897610000036,114.00902059999991,116.1924196,111.78969900000011,109.39303,240243632,369459949.6,44.69744511103436,NaN,1.5,2.75,NaN,NaN,2.795047828692048,0.650256224687148,303.6603910608839,-0.10104541689480806,-2.3219084847767704,-2.2208630678819623,38.63760544151889,-1.279518725798028,17.188335477906726,52.79270005005773,30.018964472035535,5030426829
1275571800,110.64999,111.06,109.58,110.71001,NaN,NaN,104.36399999999999,124.85130434782609,110.83097615000035,113.97042059999993,116.0584198,111.4841990000001,113.82798379303115,111.5552235341099,109.70476769230777,113.85077773495584,105.5587576496597,110.83097615000035,113.97042059999993,116.0584198,111.4841990000001,110.45000333333333,226618256,364342196.8,45.658520222304645,NaN,1.5,2.75,NaN,NaN,2.7011158409283307,0.621992890174065,306.4280243123161,0.09122507299157245,-2.106831726642497,-2.1980567996340694,38.660539902269335,2.9477592475134076,42.289497811823665,25.187043735766927,32.5234584524094,5257045085
1275658200,108.61,109.33,106.465,106.82001,NaN,NaN,104.36133333333333,124.95246376811595,110.86962620000035,113.89132069999992,115.85802,111.1780995000001,113.55316129134366,111.10425081657563,109.15630692307698,112.76206545574551,105.55054839040845,110.86962620000035,113.89132069999992,115.85802,111.1780995000001,107.53833666666667,398475520,351898152,38.31761149547685,NaN,1.5,2.75,NaN,NaN,2.811393995147735,1.1323603654502852,299.9472836139082,-0.021257125895071116,-2.224628207002908,-2.203371081107837,37.715607324193584,-2.1032853316880984,13.004747754783295,59.31732289277136,27.677929352445346,4858569565
1275917400,107.2,107.61,105.41,105.49001,NaN,NaN,104.35866666666666,125.05362318840581,110.89727620000036,113.80962079999992,115.63482040000001,110.8896005000001,113.23695927991841,110.569561214997,108.62477000000007,112.19827081114887,105.05126918885126,110.89727620000036,113.80962079999992,115.63482040000001,110.8896005000001,106.17000333333333,264609056,333250665.6,36.17602527554665,NaN,1.5,2.75,NaN,NaN,2.7677229954943257,0.7940240885148288,295.9242020605234,-0.155434234667287,-2.397663874441946,-2.242229639774659,36.91318817614698,-2.0610897724361914,15.038524487000243,55.95599382928183,29.00548168371793,4593960509
1276003800,105.57001,106.83,104.64999,106.62,NaN,NaN,104.356,125.15478260869565,110.92542615000035,113.72962079999992,115.43558039999999,110.4126005000001,112.97747068070592,110.19341252785442,108.22938615384622,111.44757630182613,105.01119600586631,110.92542615000035,113.72962079999992,115.43558039999999,110.4126005000001,106.03332999999998,357774336,331331408,39.28107697991503,NaN,1.5,2.75,NaN,NaN,2.725743495816159,1.0798080935327448,298.569953371588,-0.13883042601978923,-2.4157676722993955,-2.2769372462796063,37.15647774290215,-1.1111225501421331,41.92442343277047,25.4283267432699,32.647249823959655,4951734845
1276090200,107.24001,108.28,105.60001,106.05,NaN,NaN,104.35333333333332,125.25594202898552,110.94082615000033,113.64082089999991,115.2101802,109.9236005000001,112.7058051638155,109.7988018109159,108.1147715384616,111.52349847261095,104.70604460431224,110.94082615000033,113.64082089999991,115.2101802,109.9236005000001,106.64333666666666,268023248,328840090.4,38.26967295163422,NaN,1.5,2.75,NaN,NaN,2.7224753889721476,0.8150564843659343,299.266479404735,-0.13676342622118964,-2.4478915290560934,-2.3111281028349038,37.20918743480836,-1.045068582625739,20.175946468701365,48.53466161430583,31.289391916992805,4683711597
1276176600,107.86,109.28,106.0426,109.14999,NaN,NaN,104.35066666666665,125.35710144927536,110.97177605000036,113.59592079999992,115.04518019999999,109.50860000000011,112.56636143190117,109.73701020987629,108.11746230769236,111.52939696856761,104.70552764681712,110.97177605000036,113.59592079999992,115.04518019999999,109.50860000000011,108.15753000000001,317890560,332954268,46.3589333905392,NaN,1.5,2.75,NaN,NaN,2.7592557183312807,0.9547574263261884,305.19501556331636,0.09060572741764528,-2.1978709435628474,-2.2884766709804927,40.89021907991457,-1.4535934862399313,24.04398394514566,43.58665392164692,32.369362133207424,5001602157
1276263000,108.19,109.75,108.12,109.67999,NaN,NaN,104.348,125.45826086956522,111.00437600000036,113.54212069999993,114.89877999999999,109.19309900000012,112.45317039535603,109.7315797136976,108.2689992307693,111.76894075209142,104.76905770944717,111.00437600000036,113.54212069999993,114.89877999999999,109.19309900000012,109.18332999999998,214128128,331937871.2,47.62266229823609,NaN,1.5,2.75,NaN,NaN,2.678594595593332,0.6450849588987785,308.4479577166694,0.2830535728968293,-1.934659704859456,-2.2177132777562854,35.95884896860022,0.28434931287659565,52.18529540469707,17.552606186857012,30.262098408445933,5215730285
1276522200,110.52,111.12,109.39999,109.509,NaN,NaN,104.34533333333333,125.55942028985508,111.03607100000036,113.49831069999993,114.73295999999999,108.97404900000012,112.33771273279305,109.7103816457264,108.39907692307699,111.94765841753731,104.85049542861667,111.03607100000036,113.49831069999993,114.73295999999999,108.97404900000012,110.00966333333332,207196000,325017568.8,47.23602002166461,NaN,1.5,2.75,NaN,NaN,2.6101242673366656,0.6374916924183207,311.2910780682081,0.3981443043866961,-1.7200328972729153,-2.1181772016596114,35.20047605215914,1.8404166279177896,54.572129606958114,15.94485433887597,29.483016054165912,5008534285
1276608600,110.28,112.10001,110.09,112,NaN,NaN,104.34266666666666,125.66057971014493,111.07907105000035,113.50131069999992,114.5977602,108.87654900000014,112.32446909621294,109.9284405366096,108.77061538461544,112.71589048189928,104.8253402873316,111.07907105000035,113.50131069999992,114.5977602,108.87654900000014,111.39667000000001,238268624,320633796.8,53.197479660959935,NaN,1.5,2.75,NaN,NaN,2.6087589625269034,0.7431176200948758,317.1065464183195,0.6276903806612428,-1.333564225833058,-1.9612546064943008,35.47221011531359,1.5136408954953338,50.26085224911964,18.918785821655856,30.820361929224507,5246802909
1276695000,111.42,112.42,111.2,111.96001,NaN,NaN,104.33999999999999,125.76173913043479,111.12197110000034,113.52881069999992,114.45616059999999,108.85455000000013,112.31017658263596,110.12192334264678,108.86292461538467,113.03944283430816,104.68640639646118,111.12197110000034,113.52881069999992,114.45616059999999,108.85455000000013,111.86000333333334,216373936,313422695.2,53.093769577967905,NaN,1.5,2.75,NaN,NaN,2.5095618937749817,0.6903582264900389,314.71024342386386,0.7539891627609965,-1.0187681530430552,-1.7727573158040517,32.70825924630813,1.12907586224588,53.19291011990396,16.868136697088747,29.938953183007285,5030428973
1276781400,112.28,112.33,111.05,112.14,NaN,NaN,104.33733333333333,125.86289855072465,111.17037105000034,113.55251069999991,114.3317606,108.87355050000012,112.30350299116004,110.31412111953756,109.07607846153853,113.60235051839004,104.54980640468702,111.17037105000034,113.55251069999991,114.3317606,108.87355050000012,111.83999999999997,263185744,306844011.2,53.532863565547856,NaN,1.5,2.75,NaN,NaN,2.421736044219626,0.8577183663149819,313.9046776784323,0.8212738661163215,-0.7461649831586499,-1.5674388492749713,32.68479352717856,4.980330932378686,51.042037128221416,18.360614719766744,30.59734815201184,5293614717
1276867800,111.83,112.13,111.37,111.729,NaN,NaN,104.33466666666666,125.9640579710145,111.22801605000033,113.5767006999999,114.1908904,109.08300100000011,112.28097346209495,110.44887148910541,109.39907846153854,114.03587304271434,104.76228388036273,111.22801605000033,113.5767006999999,114.1908904,109.08300100000011,111.743,174006560,289023161.6,52.32826749469833,NaN,1.5,2.75,NaN,NaN,2.303754898203938,0.602050572821635,315.7021117469781,0.8084550624676297,-0.5568700211904343,-1.365325083658064,23.206762341643383,5.914294633207449,27.405296708517465,39.64842277171717,32.94628051976536,5119608157
1277127000,113.12,113.2,110.78999,111.41,NaN,NaN,104.332,113.2,111.28596600000033,113.5925006999999,114.0280904,109.1977505000001,112.24681764005202,110.54040753776204,109.48215538461547,114.22028307088915,104.74402769834178,111.28596600000033,113.5925006999999,114.0280904,109.1977505000001,111.79999666666667,213140624,274634727.2,51.36222039343316,NaN,1.5,2.75,NaN,NaN,2.3113445483322286,0.776087664415369,313.1439280558667,0.7501295078111867,-0.42766319889408067,-1.1777927067052674,21.192259460748847,4.492590508347394,28.50690762019485,38.441731299117606,33.05136108068754,4906467533
1277213400,111.41,111.89999,109.41,109.57001,NaN,NaN,104.32933333333332,112.97128205128206,111.33056610000033,113.60250069999991,113.8246904,109.2907505000001,112.14184479142253,110.44798872464185,109.39446307692316,114.08035508307637,104.70857107076995,111.33056610000033,113.60250069999991,113.8246904,109.2907505000001,110.29333333333334,239355312,273111344,46.07817348793511,NaN,1.5,2.75,NaN,NaN,2.3241049377370695,0.8764019410339836,308.08015564344765,0.5675629998149294,-0.46833895693660565,-1.035901956751535,24.30081443223667,3.3191984912776986,7.4069515687240886,69.87848842519608,22.71456000607982,4667112221
1277299800,109.64,110.03,108.48,109.23,NaN,NaN,104.32666666666667,112.7425641025641,111.36641610000032,113.62090069999991,113.61269039999999,109.3613510000001,112.02765479960203,110.33198979848548,109.57984692307701,114.02834239549082,105.1313514506632,111.36641610000032,113.62090069999991,113.61269039999999,109.3613510000001,109.24666666666667,254698752,266021027.2,45.15373615505334,NaN,1.5,2.75,NaN,NaN,2.268811727898707,0.957438420115987,306.79478646961337,0.41112673572897995,-0.5219935370903102,-0.9331202728192901,24.06022319046224,0.07330280103553052,6.965246740436162,70.85457523982733,22.180178019736495,4412413469
1277386200,108.69,108.83,107.14,107.42,NaN,NaN,104.324,112.51384615384616,111.38881610000031,113.60450069999992,113.3372904,109.3738510000001,111.8469624545196,110.05465743672495,109.72830769230778,113.72700974210981,105.72960564250575,111.38881610000031,113.60450069999992,113.3372904,109.3738510000001,107.79666666666667,268691968,261969660.8,40.49608625283891,1.9066292467032713,1.5,2.75,NaN,NaN,2.256039461620228,1.0256606325307727,302.5655591600019,0.18452068113268372,-0.7024694214034355,-0.8869901025361192,20.008585638022197,-2.060530822440813,0,100.00000000000001,0,4143721501
1277472600,107.74001,108.42,106.77,107.86749,NaN,NaN,104.32133333333333,112.2851282051282,111.40950355000032,113.57937559999993,113.06884039999998,109.22922600000011,111.6909047112051,109.84635577608448,109.82426846153857,113.57199041345923,106.0765465096179,111.40950355000032,113.57937559999993,113.06884039999998,109.22922600000011,107.68583000000001,238726496,258862465.6,42.08661507241744,1.677065393380631,1.5,2.75,NaN,NaN,2.2127509286473552,0.9222136374490285,307.10044806617196,0.06945980302467814,-0.8001653487552716,-0.8696251517799497,19.931603661780365,-1.4989726871763935,4.743601676639735,76.26606445025084,18.990333873109424,4382447997
1277731800,108.03,108.32001,107.14,107.53,NaN,NaN,104.31866666666666,112.05641025641026,111.4232036000003,113.55637559999994,112.83224039999999,109.13727600000011,111.52773197743235,109.62575046407643,109.93811461538472,113.28924243885731,106.58698679191212,111.4232036000003,113.55637559999994,112.83224039999999,109.13727600000011,107.66333666666667,169333248,252432462.4,41.19233272984572,1.4422119284084505,1.5,2.75,NaN,NaN,2.1389837194582584,0.6708061490589017,305.17277872447744,-0.019908940775081763,-0.8945113277488019,-0.8746023869737202,19.948939641762085,-3.9910714285714275,5.158270916458561,75.17354255703812,19.668186526503312,4213114749
1277818200,106.02,107.5114,103.55,104.21001,NaN,NaN,104.31599999999999,111.82769230769232,111.4204036500003,113.53407569999995,112.52024059999998,108.97127650000009,111.24076248812128,109.10996565797392,109.55811615384626,114.0921089523671,105.02412335532541,111.4204036500003,113.53407569999995,112.52024059999998,108.97127650000009,105.09047,373760512,257225025.6,33.62342575298106,4.046927983151908,1.5,2.75,NaN,NaN,2.2704848823540975,1.4530487891999262,297.88656647881174,-0.27878030113796504,-1.2230777633961765,-0.9442974622582114,19.868372932395946,-6.922114422819362,4.207991416737027,77.72830652172539,18.06370206153759,3839354237
1277904600,103.92,104.88,102.88,103.22,NaN,NaN,104.31333333333333,111.59897435897436,111.41010365000031,113.49967569999994,112.16704059999998,108.61577650000008,110.92622278270476,108.54901654769068,109.06119384615394,114.71144352810215,103.41094416420573,111.41010365000031,113.49967569999994,112.16704059999998,108.61577650000008,103.66000000000001,284101632,259417925.6,31.749953099729098,3.9576525178681794,1.5,2.75,NaN,NaN,2.2511645336145194,1.0951503499340294,294.9802271127641,-0.4809928762367417,-1.5455385575541385,-1.0645456813173968,19.404297827455018,-7.954342785803462,4.113128279774768,77.99708920551811,17.889782514707136,3555252605
1277991000,103.14999,103.49001,101.13,102.75999,NaN,NaN,101.13,111.37025641025642,111.3953036000003,113.46837559999994,111.80904039999997,108.21827550000009,110.6059783598536,107.99768068600585,108.54203923076933,115.09966907090578,101.98440939063289,111.3953036000003,113.46837559999994,111.80904039999997,108.21827550000009,102.46,382924800,267233252.8,30.888725841266833,4.450109365614451,1.5,2.75,NaN,NaN,2.258939209784911,1.4329234703683553,292.37986083819726,-0.6021728631847745,-1.817261760298365,-1.2150888971135905,18.587304035776295,-8.027468249066937,3.5320070075317043,79.7091300629825,16.758862929485815,3172327805
1278077400,103.11,103.42,101.62,102.2,NaN,NaN,101.005,111.14153846153846,111.36970355000031,113.41817559999996,111.43264039999997,107.9872750000001,110.27633214966326,107.44552062067196,107.78819307692318,114.81855429438907,100.75783185945728,111.36970355000031,113.41817559999996,111.43264039999997,107.9872750000001,102.41333333333334,233385120,258978732.8,29.82801569242254,3.858139005868297,1.5,2.75,NaN,NaN,2.2261578376574174,0.901174847357968,289.88370995518375,-0.671218754852019,-2.054112340678614,-1.3828935858265952,18.436851855060922,-8.266762409119464,0,99.99999999999999,0,2938942685
1278423000,103.64,104.37,101.88,102.87,NaN,NaN,100.88,110.91282051282052,111.3482535500003,113.37677569999997,111.05379039999997,107.85627450000008,109.98588775163725,107.00975675203654,107.08896153846163,114.12869440667673,100.04922867024653,111.3482535500003,113.37677569999997,111.05379039999997,107.85627450000008,103.04,256936432,258595101.6,32.80130247327244,3.201255815346033,1.5,2.75,NaN,NaN,2.2450037063961736,0.9935858429268871,289.02694712149435,-0.6239435742334183,-2.162823053618368,-1.5388794793849496,20.25899689597509,-6.114821017174309,3.4043485851041626,80.09828427493886,16.497367139956985,3195879117
1278509400,103.13,106.24001,103.02,106.1075,NaN,NaN,100.755,110.68410256410257,111.34519105000028,113.35655069999997,110.74894019999996,107.83064950000009,109.83379411431814,106.92382753755686,106.62492307692317,113.03918462621218,100.21066152763416,111.34519105000028,113.35655069999997,110.74894019999996,107.83064950000009,105.12250333333333,253769680,253394868.8,44.94130125728598,0.7174146729352454,1.5,2.75,NaN,NaN,2.3253612987964467,1.0014791586024412,295.37729538571756,-0.3409648966379304,-1.9650856001823627,-1.6241207035444323,29.226285536345102,-2.858646891879522,18.022485203261127,51.53153798194235,30.445976814796538,3449648797
1278595800,107,107.28,105.91,107.16,NaN,NaN,100.63,110.45538461538462,111.34874105000029,113.34775079999997,110.52254019999997,107.88614950000007,109.7289394431684,106.94632015302764,106.27346153846163,111.99367723588529,100.55324584103798,111.34874105000029,113.34775079999997,110.52254019999997,107.88614950000007,106.78333333333335,210842064,250535809.6,48.21656057767201,0.669350062499988,1.5,2.75,NaN,NaN,2.257121206025272,0.8415645824707687,299.5749959056656,-0.06375051082457239,-1.7038088420751478,-1.6400583312505754,30.174227390903255,-0.2420405883448195,40.500972997114204,26.66661938868053,32.832407614205266,3660490861
1278682200,107.13,107.97,106.92999,107.96001,NaN,NaN,100.505,110.22666666666667,111.35319105000028,113.32995079999999,110.29414039999996,107.82665050000007,109.65956966108337,107.04286204321548,106.00807769230778,111.02765985427085,100.98849553034471,111.35319105000028,113.32995079999999,110.29414039999996,107.82665050000007,107.62,144999872,241891275.2,50.621032696803255,1.232006214333898,1.5,2.75,NaN,NaN,2.170184691309181,0.5994423398698921,303.8138332386478,0.17935087076549805,-1.4158697427937028,-1.5952206135592009,29.003631698250118,0.08577190402779676,75.86540080978067,4.890694948853467,19.243904241365854,3805490733
1278941400,107.60001,108.24001,107.14999,108.03,NaN,NaN,100.38,109.99794871794872,111.36244110000027,113.30765089999998,110.03759039999996,107.74415100000007,109.59566496849186,107.13687518195687,105.88961538461548,110.63241693993182,101.14681382929915,111.36244110000027,113.30765089999998,110.03759039999996,107.74415100000007,107.80666666666666,131283568,237749047.2,50.83611284518231,1.2191720435998097,1.5,2.75,NaN,NaN,2.093030070501382,0.552193876468246,300.998410445427,0.34133015820459156,-1.1685579158034614,-1.509888074008053,28.91178233759189,0.4649865153910537,100,0,0,3936774301
1279027800,109.14999,110.09,108.92999,109.66,NaN,NaN,100.255,109.76923076923077,111.38569115000027,113.2951509,109.85454039999995,107.75170100000007,109.59818791090395,107.37717278367526,105.9226923076924,110.76320878108686,101.08217583429794,111.38569115000027,113.2951509,109.85454039999995,107.75170100000007,109.55999666666668,213025872,238040540.8,55.67799301015507,2.500876339272794,1.5,2.75,NaN,NaN,2.0906707797512833,0.8949142498335309,306.4687159601348,0.5427506999779721,-0.8314496990355877,-1.3742003990135598,30.003430179524834,5.229814295191028,100,0,0,4149800173
1279114200,109.31,110.08,108.86,109.651,NaN,NaN,100.13,109.54051282051282,111.41169615000028,113.28026089999999,109.64056019999994,107.63425100000006,109.60025897322144,107.59372775665857,106.0943076923078,111.28082640379196,100.90778898082363,111.41169615000028,113.28026089999999,109.64056019999994,107.63425100000006,109.53033333333335,184426752,235348447.2,55.64540658407069,1.9475915642458117,1.5,2.75,NaN,NaN,2.0284800097690487,0.783632754726754,304.5697529257235,0.6524992686030258,-0.5585763132597776,-1.2110755818628034,21.464150552847926,6.230381708971127,75.62891278936691,4.989013541166993,19.382073669466113,3965373421
1279200600,109.61,110.06,108.17,109.67999,NaN,NaN,100.005,109.31179487179487,111.42849605000029,113.2654608,109.48375999999993,107.52025000000008,109.60338568015393,107.79241939888156,106.23373076923086,111.69365922490131,100.77380231356041,111.42849605000029,113.2654608,109.48375999999993,107.52025000000008,109.30333,232337872,236146644,55.73527380902054,1.442461546106866,1.5,2.75,NaN,NaN,2.018588580499831,0.9838711576184839,303.4705107625341,0.6999736743499647,-0.3361084889253476,-1.0360821632753123,19.68547953678425,6.734138452134924,76.44791533881994,4.679498024948692,18.87258663623136,4197711293
1279287000,109.09,109.2059,106.45,106.66,NaN,NaN,99.88,109.08307692307693,111.43179605000029,113.2339608,109.28055979999992,107.24625000000007,109.48795879073613,107.68456993232141,106.1668076923078,111.5826911523058,100.7509242323098,111.43179605000029,113.2339608,109.28055979999992,107.24625000000007,107.43863333333333,282693376,237122025.6,45.41281565368704,0.6797242729966938,1.5,2.75,NaN,NaN,2.105117253321272,1.1921852273515667,298.2743583398275,0.509752992238204,-0.39889092297755724,-0.9086439152157613,27.36119706205408,4.363992172211344,42.379509288613264,25.086062346944786,32.53442836444196,3915017917
1279546200,107.05,107.63,106.22,107.28999,NaN,NaN,99.755,108.85435897435897,111.44029600000029,113.1986606,109.16751959999992,107.0242995000001,109.40176393619745,107.64699089114794,106.40372923076933,111.72512572352306,101.0823327380156,111.44029600000029,113.1986606,109.16751959999992,107.0242995000001,107.04666333333336,186709008,237757148,47.593298392746064,0.4502009318591315,1.5,2.75,NaN,NaN,2.055466020941181,0.7852929326019674,301.4804571791401,0.41229268285620635,-0.3932780616455034,-0.8055707445017097,26.736063619705316,4.296675415573052,43.31756776768703,24.278950890693324,32.403481341619646,4101726925
1279632600,105.87,108.56,105.82001,108.48,NaN,NaN,99.63,108.62564102564103,111.46769600000029,113.1767606,109.11191979999992,106.87779950000011,109.36561633085638,107.72632509199099,106.80834461538471,111.89460328652821,101.72208594424121,111.46769600000029,113.1767606,109.11191979999992,106.87779950000011,107.62000333333333,258162320,240008232.8,51.531711618401665,0.34317477560501497,1.5,2.75,NaN,NaN,2.104360590873954,1.0756394353152372,306.18774265862464,0.41288127816620934,-0.2894691467939481,-0.7023504249601574,26.962047718186895,2.2359399665433664,45.60619970536296,22.433745349526667,31.960054945110397,4359889245
1279719000,109.03999,109.07001,106.63,107.07001,NaN,NaN,99.505,108.39692307692307,111.49059600000028,113.1400606,108.93011999999993,106.75279950000011,109.27559255317574,107.66381889275375,107.13988461538472,111.65747206812189,102.62229716264754,111.49059600000028,113.1400606,108.93011999999993,106.75279950000011,107.59000666666667,264526944,241266814.4,47.022597989924435,0.27740364107587784,1.5,2.75,NaN,NaN,2.1283355486686717,1.096408325603523,302.3071726580433,0.30802720639929837,-0.3173164169610345,-0.6253436233603329,23.21424671607464,-0.08397723030981732,40.3830321092539,26.76657604405916,32.850391846686925,4095362301
1279805400,108.34,109.94,108.33,109.461,NaN,NaN,99.38,108.16820512820513,111.51780100000028,113.11577059999999,108.80273999999994,106.7643495000001,109.28286343344335,107.83497899820577,107.69842307692316,111.34671064672254,104.05013550712378,111.51780100000028,113.11577059999999,108.80273999999994,106.7643495000001,109.24366666666667,274781440,242270948.8,54.321751032618955,1.579857084248995,1.5,2.75,NaN,NaN,2.1813108666209096,1.1341906297929187,308.87679974030607,0.3844479448844451,-0.1447836922547765,-0.5292316371392216,25.843329914441597,1.390320360288964,42.503437582746066,24.955131698271966,32.54143071898197,4370143741
1279891800,109.24001,110.57001,108.92999,110.41,NaN,NaN,99.255,107.93948717948719,111.54230105000028,113.0978706,108.66193999999994,106.91384950000008,109.32706486742596,108.08021909361474,108.27842307692316,110.93423163836573,105.62261451548059,111.54230105000028,113.0978706,108.66193999999994,106.91384950000008,109.96999999999998,222020816,239937391.2,56.8622136242919,1.8317396644429316,1.5,2.75,NaN,NaN,2.142647233290844,0.9253281236809581,313.6699572564283,0.477581453487587,0.06774517972026217,-0.40983627376732484,25.941853869326575,2.2030917337776503,73.41821945136681,5.8588220093721475,20.72295853926105,4592164557
1280151000,110.60001,111.67,110.28999,111.56,NaN,NaN,99.13,107.71076923076923,111.5711010500003,113.09047059999999,108.57333979999994,107.09847500000008,109.41463095105631,108.41162679898477,108.69784615384623,111.56367791084206,105.8320143968504,111.5711010500003,113.09047059999999,108.57333979999994,107.09847500000008,111.17333,182126496,237107391.2,59.781304706482324,2.3806928995279213,1.5,2.75,NaN,NaN,2.088173145198641,0.7681181724376377,318.29095915391605,0.5880468358937827,0.32522227109990354,-0.26282456479387917,26.31842627482027,1.7326281232901748,75.07600841060062,5.207957968551856,19.71603362084754,4774291053
1280237400,112.17,112.28999,111.11,111.55,NaN,NaN,99.005,107.48205128205129,111.59580105000028,113.07956049999999,108.52653979999994,107.29947500000007,109.49837091375998,108.71051948479574,109.03553846153854,112.12296031014465,105.94811661293242,111.59580105000028,113.07956049999999,108.52653979999994,107.29947500000007,111.64999666666667,204855568,238883507.2,59.74344590142771,2.285123498343592,1.5,2.75,NaN,NaN,2.0233029205415956,0.8575542547962056,316.204416909775,0.6282159554272921,0.522445379490236,-0.10577057593705613,25.256299866107977,1.731858350585039,48.092161848916966,20.55687345981406,31.350964691268985,4569435485
1280323800,111.32001,111.66,110.46001,110.83,NaN,NaN,98.88,107.25333333333333,111.6136511000003,113.04536049999999,108.46413979999994,107.63047450000008,109.55059166223998,108.91237477195806,109.25630692307699,112.41416851190523,106.09844533424875,111.6136511000003,113.04536049999999,108.46413979999994,107.63047450000008,110.98333666666667,163056192,228348291.2,56.94710359686441,1.4755814234258875,1.5,2.75,NaN,NaN,1.9644948547886243,0.714067931680673,312.7806438124126,0.5754766350868509,0.6135752179215075,0.038098582834656614,25.6839733519121,1.0485139540949946,55.72113726972882,15.231163003308504,29.047699726962666,4406379293
1280410200,111.52,111.82001,109.41,110.28999,NaN,NaN,98.755,107.02461538461539,111.6267011000003,113.00556039999998,108.42193979999995,107.9839740000001,109.57958767548547,109.04357622224776,109.43015230769237,112.54740332047545,106.31290129490928,111.6267011000003,113.00556039999998,108.42193979999995,107.9839740000001,110.50666666666666,220149008,225150660,54.872621171141546,0.9285880945268558,1.5,2.75,NaN,NaN,1.9963173651608652,0.977785310511637,313.7450088885119,0.477443700541079,0.6349032085110053,0.15745950796992636,25.91140281026703,3.40332833302082,23.11992731599822,44.79281303564725,32.08725964835454,4186230285
1280496600,109.17,110.86,108.98,110.27,NaN,NaN,98.63,106.79589743589744,111.6407510500003,112.96366029999997,108.39213999999997,108.3594745000001,109.60666266860369,109.1603784867956,109.47707538461545,112.6249668013218,106.32918396790909,111.6407510500003,112.96366029999997,108.39213999999997,108.3594745000001,110.03666666666666,220070496,217007944.8,54.793049355892215,0.6559058138914329,1.5,2.75,NaN,NaN,1.9880089819350888,1.0141126224794328,316.2478808021527,0.3882589252831668,0.6427831645738848,0.25452423929071805,18.64279023045539,2.777528453493185,4.355026420985661,77.34514002134247,18.299833557671864,3966159789
1280755800,111.99001,112.94,111.53999,112.75999,NaN,NaN,98.505,106.56717948717949,111.6580010000003,112.94156019999998,108.49653999999995,108.88747400000011,109.73032256395257,109.5031986309103,109.71622846153852,113.32001793214503,106.112438990932,111.6580010000003,112.94156019999998,108.49653999999995,108.88747400000011,112.41332666666665,188263184,214751848,62.15483907093796,2.35380843932787,1.5,2.75,NaN,NaN,2.036722626082583,0.8766545468796152,321.9061604905613,0.46859135734105084,0.8402634359670316,0.37167207862598073,21.611922081572537,3.945418510324482,4.772994820053763,76.23325398896473,18.993751190981513,4154422973
1280842200,112.48,112.77,111.85001,112.22,NaN,NaN,98.38,106.33846153846154,111.6705509500003,112.90926019999998,108.55863979999995,109.35497400000011,109.82795697320933,109.76194161844266,109.9116138461539,113.75388873891102,106.06933895339678,111.6705509500003,112.90926019999998,108.55863979999995,109.35497400000011,112.28000333333334,146657248,209237888.8,59.87756590037293,1.7130962091794537,1.5,2.75,NaN,NaN,1.9569560099338268,0.7009115263067021,319.25211526789536,0.45652847251500067,0.9423326692697316,0.4858041967547309,21.89508253411318,4.809927635198692,5.415464650360918,74.57416622187608,20.010369127763003,4007765725
1280928600,112.53,113.11,112.16,112.97,NaN,NaN,98.255,106.10974358974359,111.69095095000031,112.88436009999995,108.66383959999996,109.6980990000001,109.95117434680895,110.06747098811479,110.3969984615385,114.06381239950417,106.73018452357283,111.69095095000031,112.88436009999995,108.66383959999996,109.6980990000001,112.74666666666666,158171632,204457986.4,61.96213613644808,1.9019427177397141,1.5,2.75,NaN,NaN,1.8850305806528393,0.7736143487716555,323.51641011303866,0.468469976829474,1.0713916677915734,0.6029216909620994,19.236241067819513,3.205707969048337,19.780370231378047,49.1670699997798,31.052559768842134,4165937357
1281015000,112.25,112.91,112.08,112.85001,NaN,NaN,98.13,105.88102564102564,111.7062510500003,112.85796009999996,108.76447999999996,109.9825995000001,110.06485417634586,110.33247470353243,110.82469230769236,114.22983467092557,107.41954994445915,111.7062510500003,112.85796009999996,108.76447999999996,109.9825995000001,112.61333666666667,140473744,200939570.4,61.41240060532051,1.4766551969832495,1.5,2.75,NaN,NaN,1.8139569677490652,0.6990845243690239,321.30053277899003,0.43824250664269404,1.1507248242654669,0.7124823176227728,16.23248114786503,2.2099538085318366,23.53355637749913,44.31164729267939,32.15479632982149,4025463613
1281101400,111.74001,112.57001,110.92,112.392,NaN,NaN,98.005,105.65230769230769,111.72215605000031,112.81778009999996,108.86891999999996,110.2041990000001,110.15611479688131,110.52861996986267,111.12561538461544,114.33451610593993,107.91671466329096,111.72215605000031,112.81778009999996,108.86891999999996,110.2041990000001,111.96067,239728256,205675989.6,59.25146843772481,0.6522541996475855,1.5,2.75,NaN,NaN,1.822246470052703,1.1655626719785088,319.70259721763205,0.3605984240794209,1.163230347722049,0.802631923642628,16.269955900235242,0.7457870204374271,22.240811463144443,45.93321101768889,31.825977519166674,3785735357
1281360600,112.92,113.17999,112.32001,112.992,NaN,NaN,97.88,113.17999,111.74596605000029,112.77669999999996,108.91356019999998,110.45229900000011,110.26732598131734,110.76322759178052,111.58115307692313,113.9216434473807,109.24066270646556,111.74596605000029,112.77669999999996,108.91356019999998,110.45229900000011,112.83066666666667,120800368,205151829.6,61.178624783933394,1.3321057576144262,1.5,2.75,NaN,NaN,1.7535131507632247,0.5888339784028911,323.9074224881463,0.3240026083454104,1.207635184074391,0.8836325757289807,15.53981082148999,1.2926938592559456,15.996115731610711,54.494348253933225,29.509536014456042,3906535725
1281447000,112.03,112.98,111.3701,112.375,NaN,NaN,97.755,113.17940147058823,111.76119105000029,112.73007489999996,108.97368019999998,110.58804900000011,110.34997986440294,110.91672972589666,111.80530692307698,113.82712018967045,109.78349365648351,111.76119105000029,112.73007489999996,108.97368019999998,110.58804900000011,112.2417,242916192,206646345.6,58.13386668735559,0.706081129809254,1.5,2.75,NaN,NaN,1.7441122114229952,1.1755165149167777,319.36803259455263,0.23664889980589177,1.1794437004863454,0.9427948006804536,16.01192925277211,1.394026888026709,12.579475545806664,59.968609854815206,27.451914599378135,3663619533
1281533400,110.64999,110.69,109.12,109.3,NaN,NaN,97.63,113.17881294117647,111.76729105000028,112.66337489999997,109.00908019999999,110.57049900000013,110.30880418344596,110.76275546628746,111.71992230769236,114.04172686597552,109.3981177494092,111.76729105000028,112.66337489999997,109.00908019999999,110.57049900000013,109.70333333333333,273408256,211095420.8,45.878931518680936,1.7229131485283669,1.5,2.75,NaN,NaN,1.8520327677499238,1.2951880005916263,312.8974897635143,-0.03534283522914805,0.8986162566440186,0.9339590918731666,22.737173170158282,-0.897624526033601,1.6694534247978732,86.33138532843996,11.999161246762181,3390211277
1281619800,107.64999,109.02,107.60001,108.63,NaN,NaN,97.505,113.17822441176472,111.77589105000028,112.58374989999994,108.9750802,110.51799950000013,110.24296872527161,110.5596358980696,111.49453769230776,114.34365043529688,108.64542494931864,111.77589105000028,112.58374989999994,108.9750802,110.51799950000013,108.41667,239542560,211455655.2,43.71650381773536,2.2857056874956427,1.5,2.75,NaN,NaN,1.8411725700535004,1.1328264537235229,310.53515084598143,-0.2552418170909305,0.6149068205095034,0.8701486376004339,22.8195007371582,-1.487258547202322,1.3949801175123135,87.55880942126801,11.046210461219673,3150668717
1281706200,108.28999,108.96001,108.17999,108.31,NaN,NaN,97.38,113.17763588235294,111.7853410500003,112.49274989999995,108.92708,110.60049950000014,110.16716603016292,110.3453848601582,111.24530692307698,114.56018655547408,107.93042729067989,111.7853410500003,112.49274989999995,108.92708,110.60049950000014,108.48333333333332,158698496,205255911.2,42.68176549164521,1.889346610473361,1.5,2.75,NaN,NaN,1.7653759579068213,0.7731738154199381,308.626754841835,-0.40804467240558095,0.36009279709345776,0.7681374694990387,22.815545348314185,-3.9464263875865897,1.6567557834908286,86.38602030289371,11.957223913615461,2991970221
1281965400,107.57001,108.61,107.17999,108.25999,NaN,NaN,97.255,113.17704735294117,111.80459100000029,112.40694979999995,108.95587959999999,110.64899950000013,110.09237481329379,110.14677582585742,111.04761384615391,114.72473444970234,107.37049324260548,111.80459100000029,112.40694979999995,108.95587959999999,110.64899950000013,108.01666,147895248,203315223.2,42.51241267450036,2.021783444362844,1.5,2.75,NaN,NaN,1.7414212466277623,0.7274184671086646,311.232222465595,-0.4926226498966234,0.15235915712825943,0.6449818070248828,17.024504891063,-3.5287916592407744,0,100,0,2844074973
1282051800,109.19,110.39,108.88,109.59,NaN,NaN,97.13,113.17645882352942,111.81929105000029,112.33634989999995,109.03787939999998,110.70449950000014,110.07267384022344,110.09374955672814,110.99376846153852,114.73365347761927,107.25388344545777,111.81929105000029,112.33634989999995,109.03787939999998,110.70449950000014,109.62,172270256,199020620,48.37868049747329,0.4539850257626764,1.5,2.75,NaN,NaN,1.7691775861543506,0.865589987610329,315.87380665609163,-0.44081243927671987,0.09396625792898305,0.5347786972057029,19.38695581638922,-2.991944764096659,3.568814078174792,79.57883171336861,16.8523542084566,3016345229
1282138200,109.53999,110.38,108.91,109.78999,NaN,NaN,97.005,113.17587029411766,111.85044100000029,112.26842979999994,109.1012792,110.84049850000015,110.06158819943037,110.06482007513499,110.95684461538468,114.7338773443937,107.17981188637566,111.85044100000029,112.26842979999994,109.1012792,110.84049850000015,109.69333,182922064,194940376,49.21782577150332,0.3437488945160456,1.5,2.75,NaN,NaN,1.747807758571897,0.9383487800392875,317.8626146264239,-0.37734326723110084,0.06309961316682688,0.4404428803979277,18.752142620744017,-2.711581505398178,20.689578091653033,47.8471604496694,31.46326145867757,3199267293
1282224600,109.22,109.49001,107.42999,107.88,NaN,NaN,96.88,113.17528176470589,111.86824095000028,112.17402969999993,109.13787919999999,110.76144850000017,109.97603572102135,109.85674197274118,110.58146076923084,114.53302103987438,106.6299004985873,111.86824095000028,112.17402969999993,109.13787919999999,110.76144850000017,108.26666666666667,265847568,194493682.4,42.16771951656688,1.6901510528278239,1.5,2.75,NaN,NaN,1.7915357758167614,1.366869940038731,313.1568120048456,-0.44368759557920884,-0.1141666140760833,0.32952098150312553,20.47835128246643,-4.014520606448858,19.554660781975713,49.37322913777983,31.07211008024447,2933419725
1282311000,107.56,107.93761,106.74989,107.53,NaN,NaN,96.755,113.17469323529411,111.88264100000028,112.07532979999995,109.10547939999998,110.61744850000018,109.88011275156953,109.63514749914678,110.22069153846161,114.3599143262968,106.08146875062641,111.88264100000028,112.07532979999995,109.10547939999998,110.61744850000018,107.40583333333332,209714128,193878348,41.00849202575537,1.8912712396460987,1.5,2.75,NaN,NaN,1.7484060775441363,1.0816789505551183,311.1978309335724,-0.4873524605898546,-0.2796695942341927,0.2076828663556619,20.49007222386186,-4.833970546587372,17.519012380277406,52.23134479284076,30.24964282688184,2723705597
1282570200,108.03999,108.57001,107.07001,107.1236,NaN,NaN,96.63,113.17410470588236,111.89365900000028,111.97656579999995,109.05435159999999,110.39562850000019,109.77201421229229,109.39595249922804,109.77096846153852,113.88798026690166,105.65395665617537,111.89365900000028,111.97656579999995,109.05435159999999,110.39562850000019,107.58787333333335,163490256,192946536,39.64562293591228,1.5082665082024143,1.5,2.75,NaN,NaN,1.7306627862909836,0.8473344968473546,308.17757412006927,-0.5170018343785336,-0.4385694266175051,0.0784324077610285,19.55217541210698,-4.673103448275865,16.772967481547198,53.3251328310327,29.901899687420105,2560215341
1282656600,105.95,106.39,104.97,105.53,NaN,NaN,96.505,113.1735161764706,111.88705850000028,111.85386579999997,108.97477159999998,110.09462850000018,109.60566071377103,109.02776654692062,109.20789076923081,113.48557481285813,104.9302067256035,111.88705850000028,111.85386579999997,108.97477159999998,110.09462850000018,105.63,280795648,196743540,34.76640287630438,2.811933209894701,1.5,2.75,NaN,NaN,1.760872587270199,1.4272166089926002,303.92642261058074,-0.6108982793522619,-0.6851904414292989,-0.07429216207703698,20.32240042351045,-3.449222323879228,3.283547338886294,80.46463236847327,16.251820292640428,2279419693
1282743000,104.95,106.34,104.28999,105.94,NaN,NaN,104.28999,113.17292764705883,111.88110850000027,111.72566589999997,108.85357159999998,109.85012850000018,109.46190931323099,108.73369354245199,108.71158307692312,112.89244676321812,104.53071939062812,111.88110850000027,111.72566589999997,108.85357159999998,109.85012850000018,105.52333,272330752,202207268,36.91746769582357,2.5433923107973846,1.5,2.75,NaN,NaN,1.781525259608042,1.346790126257974,306.4799316008264,-0.6108839050944019,-0.8378970434450395,-0.2270131383506375,15.687338919282574,-2.476295682592284,6.127609124702192,72.76075102900793,21.11163984628988,2551750445
1282829400,106.44,106.58,104.88,105.23,NaN,NaN,104.37314763157895,113.17233911764706,111.85940845000026,111.58756599999997,108.71897139999997,109.59712900000018,109.29595208526115,108.40000844317085,108.11450615384621,111.87559066970464,104.35342163798778,111.85940845000026,111.58756599999997,108.71897139999997,109.59712900000018,105.56333333333335,224492688,202424452,34.77874140960431,2.29044018145098,1.5,2.75,NaN,NaN,1.7757020267788963,1.109019615871308,303.6531885650206,-0.6220922577064055,-1.0046284604836444,-0.3825362027772389,15.73128488136111,-2.8436894100267733,6.687505771534696,71.45605291325091,21.856441315214372,2327257757
1282915800,105.89,106.97,104.31,106.86,NaN,NaN,104.4563052631579,113.1717505882353,111.84575845000026,111.47256599999997,108.61337139999996,109.42662900000019,109.20042455250581,108.25334097239268,107.69027538461543,110.5755725736706,104.80497819556027,111.84575845000026,111.47256599999997,108.61337139999996,109.42662900000019,106.04666666666667,272704000,205056127.2,42.950064793495194,1.5078689003626398,1.5,2.75,NaN,NaN,1.8388661677232605,1.329899299883003,308.8569321567458,-0.4889960303102666,-0.9937812406650721,-0.5047852103548055,18.99510014471805,-1.2931739602045063,26.63882511979471,40.51454207989075,32.84663280031454,2599961757
1283175000,106.58,106.91,105.3,105.311,NaN,NaN,104.53946289473684,113.17116205882354,111.82156350000027,111.33795089999995,108.48501139999995,109.05417950000019,109.04789809946637,107.97311802264099,107.38342923076927,110.36551849763869,104.40133996389984,111.82156350000027,111.33795089999995,108.48501139999995,109.05417950000019,105.84033333333333,167238560,204004896,38.06891416954044,1.4472435625104225,1.5,2.75,NaN,NaN,1.8225185843144562,0.8197771880925838,304.007073729888,-0.47419144439004846,-1.097524515842366,-0.6233330714523176,20.42908975434204,-3.904553335158314,28.639198184656287,38.36255302532081,32.998248790022906,2432723197
1283261400,104.92,105.98,104.49001,105.31,NaN,NaN,104.6226205263158,113.17057352941177,111.80296350000027,111.19555089999996,108.36301139999996,108.7086795000002,108.9013138602716,107.71948773477042,107.12804461538465,110.20645961489039,104.04962961587891,111.80296350000027,111.19555089999996,108.36301139999996,108.7086795000002,105.26000333333333,273933056,210368686.4,38.06590651585344,1.6917929605689683,1.5,2.75,NaN,NaN,1.7987665425777097,1.302156992505706,305.7614026337463,-0.43443532670380935,-1.1663772298320794,-0.73194190312827,18.24392049154223,-4.080508614674253,28.989943891733635,37.97742544121989,33.03263066704647,2158790141
1283347800,106.73,108.61,106.66,108.46001,NaN,NaN,104.70577815789474,113.169985,111.79716355000028,111.08275089999998,108.34081139999995,108.4831800000002,108.88400782653545,107.79001366479228,107.1395838461539,110.23670204560409,104.0424656467037,111.79716355000028,111.08275089999998,108.34081139999995,108.4831800000002,107.91000333333334,267834944,215851852,51.15653315936744,0.9717095221955251,1.5,2.75,NaN,NaN,1.9059975038221588,1.2408276395052658,312.1041756259611,-0.17904389082821404,-0.9557467666635375,-0.7767028758353235,26.480106169187337,0.537643678160921,29.098083301527204,37.85925957788665,33.042657120586156,2426625085
1283434200,108.72,109.49001,108.49001,109.47,NaN,NaN,104.78893578947368,113.16939647058824,111.78846350000029,110.97915089999996,108.34561139999997,108.31417950000018,108.90698791176935,107.9500123633835,107.23266153846158,110.52542111395543,103.93990196296774,111.78846350000029,110.97915089999996,108.34561139999997,108.31417950000018,109.15000666666667,156112128,216633771.2,54.47879762251943,1.5014329869851022,1.5,2.75,NaN,NaN,1.8434262535491475,0.7206269231950665,315.8287015049497,0.061952544176185786,-0.6992621956150913,-0.7612147397912771,24.85445706012674,1.804147679717286,51.98730495570059,17.76140028288043,30.251294761418993,2582737213
1283520600,110.53999,110.99001,109.95,110.89,NaN,NaN,104.87209342105264,113.16880794117648,111.78621850000029,110.87615089999996,108.41501139999997,108.23907950000019,108.98475309169996,108.2300111859184,107.33266153846161,110.96696152487193,103.69836155205128,111.78621850000029,110.87615089999996,108.41501139999997,108.23907950000019,110.61000333333334,212197248,215257220.8,58.72916907104188,2.396713438900564,1.5,2.75,NaN,NaN,1.8203250925813512,0.9857845753623146,320.28854947348395,0.30731771812335684,-0.37706759213708096,-0.6843853102604378,25.451446670765197,3.51593859803069,49.31816638925729,19.672599080934646,31.009234529808072,2794934461
1283866200,110.37,110.50999,109.55,109.64,NaN,NaN,104.95525105263158,113.16821941176471,111.77806850000029,110.75965099999996,108.45046159999998,108.07147950000017,109.01044904888819,108.36429583487855,107.32112384615392,110.92497052355702,103.71727716875083,111.77806850000029,110.75965099999996,108.45046159999998,108.07147950000017,109.89999666666667,141973680,216315886.4,53.95345038934586,1.493029568964298,1.5,2.75,NaN,NaN,1.786016157396969,0.6563257205135166,316.31419989833904,0.3714650835015385,-0.22005395588351462,-0.5915190393850531,26.53918165597606,3.894627120250165,49.21889150021191,19.669729178202786,31.111379321585314,2652960781
1283952600,109.86,110.85001,109.81,110.41,NaN,NaN,105.03840868421054,113.16763088235294,111.78101845000029,110.67015099999995,108.50806159999998,107.97322950000016,109.06533339991218,108.55912480298535,107.51573923076931,111.4750125423614,103.55646591917723,111.78101845000029,110.67015099999995,108.50806159999998,107.97322950000016,110.35667000000001,150268944,211683524,56.31028695683443,1.693095447687815,1.5,2.75,NaN,NaN,1.7448728604400423,0.709875483743364,319.6172288113218,0.44673096319612976,-0.03310533538989091,-0.47983629858602067,24.192976928566488,4.219369454408154,82.57990731852394,2.6443364921496495,14.775756189326415,2803229725
1284039000,111.64999,111.67999,110.62,110.92,NaN,NaN,105.12156631578948,113.16704235294118,111.78846850000028,110.58125099999995,108.6422614,108.05422950000016,109.13806542344503,108.7839700598439,107.77650846153855,112.13192161264342,103.42109531043369,111.78846850000028,110.58125099999995,108.6422614,108.05422950000016,111.07333,147017872,205364004.8,57.84915983250739,1.9544103177662266,1.5,2.75,NaN,NaN,1.710952656122897,0.7158891946189783,322.53929341335606,0.5074093676561903,0.15442541098421714,-0.35298395667197313,24.1895139989013,5.407203269029742,79.74344904666064,3.515357460509874,16.74119349282948,2950247597
1284125400,111.12,111.61,110.87,111.48199,NaN,NaN,105.20472394736842,113.16645382352942,111.79177840000028,110.48727089999997,108.80750119999999,108.19682900000016,109.22998403429033,109.04092433985876,108.11176923076934,112.86715108450882,103.35638737702986,111.79177840000028,110.48727089999997,108.80750119999999,108.19682900000016,111.32066333333334,127818944,199777824,59.540336260446175,1.9473054014903013,1.5,2.75,NaN,NaN,1.6415988949712612,0.639805467097289,325.25542273475554,0.5579251547720981,0.3444224867931496,-0.2135026679789486,23.095238626771927,4.325276062137373,78.98448201039773,3.7673492735831977,17.248168716019084,3078066541
1284384600,112.58,112.95,112.13,112.72,NaN,NaN,105.28788157894738,113.16586529411765,111.80042835000027,110.40787089999996,109.0067014,108.41732900000015,109.36684740549462,109.39131249796745,108.66484615384626,113.75142031463552,103.57827199305699,111.80042835000027,110.40787089999996,109.0067014,108.41732900000015,112.59999999999998,178503440,200768071.2,63.056735656861996,2.514269225546882,1.5,2.75,NaN,NaN,1.6291996881876003,0.8891027290000683,329.62077930990137,0.641293481994971,0.5881141845147653,-0.053179297480205806,22.565828284019688,7.0353524323195025,76.72168235474845,4.593649361135735,18.684668284115816,3256569981
1284471000,112.5,113.28999,112.08,112.64999,NaN,NaN,105.37103921052632,113.16527676470588,111.80677830000027,110.32417079999996,109.2157012,108.63682900000015,109.49559809547523,109.70166273625627,109.18099923076933,114.41641772644212,103.94558073509654,111.80677830000027,110.32417079999996,109.2157012,108.63682900000015,112.67332666666668,209823568,203864487.2,62.724737715992006,2.4289331775496557,1.5,2.75,NaN,NaN,1.5992561390313436,1.0292305976477105,328.0498273983977,0.6559464212321869,0.7667537290600279,0.11080730782784096,19.233217932341486,6.969888899439749,66.3189741547725,9.15576510378198,24.525260741445525,3046746413
1284557400,112.32001,113.21001,111.98,113.08,NaN,NaN,105.45419684210528,113.16468823529412,111.82432825000029,110.23684579999995,109.4199012,108.81132900000014,109.63616287604484,110.0234091423271,109.78484538461547,114.86672395761943,104.7029668116115,111.82432825000029,110.23684579999995,109.4199012,108.81132900000014,112.75667,168608320,203681390.4,63.97920785000839,2.081458591200576,1.5,2.75,NaN,NaN,1.5728814148148185,0.8278042469607965,329.37480119268787,0.6571768289144188,0.9322783439708644,0.27510151505644564,18.865284674072644,4.25962527571222,67.3348138771508,8.647931442134983,24.01725468071423,3215354733
1284643800,112.73,113.12,112.35001,113.05,NaN,NaN,105.53735447368422,113.16409970588236,111.8398782500003,110.15384569999995,109.5587512,108.97432950000014,109.77003884169014,110.3116558906769,110.26099923076933,115.31735741491397,105.20464104662469,111.8398782500003,110.15384569999995,109.5587512,108.97432950000014,112.84000333333334,199962880,204533431.2,63.81784293195081,1.743000764468686,1.5,2.75,NaN,NaN,1.515532028042332,0.977653769492916,327.11257948409616,0.6190751513927262,1.0489454542973533,0.4298703029046272,12.693399806423827,3.2703023659450063,36.38835067365407,30.47045932658369,33.14118999976225,3015391853
1284730200,113.03999,113.14999,112.17999,112.49001,NaN,NaN,105.62051210526316,113.16351117647059,111.8458283000003,110.09394579999994,109.66535140000002,109.20483000000013,109.87670437731013,110.51911818680291,110.81323076923087,115.09533969137213,106.53112184708961,111.8458283000003,110.09394579999994,109.66535140000002,109.20483000000013,112.60666333333334,195836816,201032893.6,60.73836524058075,1.282039194183733,1.5,2.75,NaN,NaN,1.4765654546107367,0.974153097500856,329.5714363346457,0.5230845166072795,1.0837259486637265,0.560641432056447,13.207540481032964,1.4428803318604,16.05752384443907,54.49943317926294,29.44304297629799,2819555037
1284989400,112.88,114.46001,112.52161,114.21001,NaN,NaN,105.70366973684212,113.16292264705882,111.8606283500003,110.04224589999995,109.79035140000002,109.5388305000001,110.0466379311411,110.87063169282169,111.49784692307702,114.76789534879694,108.2277984973571,111.8606283500003,110.04224589999995,109.79035140000002,109.5388305000001,113.73054333333333,214786688,201286521.6,66.14246262539459,2.1822901216916586,1.5,2.75,NaN,NaN,1.5118107792813984,1.0670694008356296,335.59752341418545,0.540153612501998,1.2358334476839445,0.6956798351819465,13.89694404200272,4.168195913900033,20.66850261942549,47.90343691954154,31.428060461032974,3034341725
1285075800,114.3,114.84,113.50999,113.98,NaN,NaN,105.78682736842106,113.16233411764706,111.87862835000028,109.97347089999995,109.90935140000002,109.88165050000012,110.20088742403753,111.16676200779105,111.92246153846165,114.92716127216359,108.9177618047597,111.87862835000028,109.97347089999995,109.90935140000002,109.88165050000012,114.10999666666667,268632320,206543624.8,64.85683994063135,1.9139221070469639,1.5,2.75,NaN,NaN,1.498825009332727,1.3006081415493778,332.6368974461765,0.5015153650781274,1.322574041529606,0.8210586764514785,11.156065171200925,3.233402771488097,18.20802560324521,51.273780195979775,30.518194200775014,2765709405
1285162200,113.8,114.44,113.10001,113.42,NaN,NaN,105.86998500000001,113.1617455882353,111.89067840000028,109.91954589999996,109.98455140000002,110.27615050000011,110.32712713289881,111.38135610228714,112.2263076923078,114.96461588027954,109.48799950433606,111.89067840000028,109.91954589999996,109.98455140000002,110.27615050000011,113.65333666666668,191322368,202069960.8,61.711791678896915,1.324478579573863,1.5,2.75,NaN,NaN,1.4874796515232467,0.9468125160342981,329.4894116770797,0.40778406902304043,1.330788762730279,0.9230046937072386,12.001512887550817,2.253876667868734,5.101685750434514,75.31934376895559,19.5789704806099,2574387037
1285248600,112.49001,113.67,112.17999,112.498,NaN,NaN,105.95314263157896,113.16115705882353,111.89896840000029,109.84102579999995,110.04149140000001,110.60405050000011,110.4122594021969,111.48770314016456,112.35000000000011,114.97876276021248,109.72123723978774,111.89896840000029,109.84102579999995,110.04149140000001,110.60405050000011,112.78266333333335,202354256,198571136,56.8258834708002,0.5173380813181938,1.5,2.75,NaN,NaN,1.4876603907001573,1.0190517115236728,325.54648552171403,0.260403650156925,1.2485092564033948,0.9881056062464698,13.406121810238625,0.9113669391800492,5.08750543308277,75.35599657091616,19.55649799600106,2372032781
1285335000,113.75,114.89999,113.64999,114.82001,NaN,NaN,106.0363002631579,113.16056852941176,111.92501845000028,109.81402589999995,110.14429180000003,111.0835510000001,110.58511236681663,111.80506569824412,112.74846230769239,115.17597068666534,110.32095392871945,111.92501845000028,109.81402589999995,110.14429180000003,111.0835510000001,114.45666333333332,209671680,197830085.6,64.45788232670878,1.8808150161243666,1.5,2.75,NaN,NaN,1.5529696485072886,1.0598573991619402,330.7549950425435,0.2935545525688277,1.3550487969575045,1.0614942443886768,17.270365934181722,1.8630322924059595,21.029442642002014,47.42723031483498,31.543327043163004,2581704461
1285594200,114.86,114.99001,114.16,114.27,NaN,NaN,106.11945789473685,113.15998,111.94626345000027,109.78852579999995,110.29649180000004,111.45405100000009,110.72961776419638,112.0398213460304,113.04538538461546,115.18311516031338,110.90765560891754,111.94626345000027,109.78852579999995,110.29649180000004,111.45405100000009,114.47333666666667,128799440,190634857.6,61.6767141645471,1.5755124712771504,1.5,2.75,NaN,NaN,1.501329673613911,0.6756342550440262,328.52532498367185,0.2541664875583076,1.3792023538365612,1.1250358662782536,16.944781117534774,1.4380915613041718,5.76494199628477,73.68115969220523,20.553898311509997,2452905021
1285680600,114.42,115.03999,113.17999,114.67,NaN,NaN,106.2026155263158,113.15939147058825,111.96641345000027,109.80580579999996,110.44409200000004,111.9220010000001,110.8841425577573,112.29031455117035,113.333846923077,115.24675986704061,111.4209339791134,111.96641345000027,109.80580579999996,110.44409200000004,111.9220010000001,114.29666,209207440,192733301.6,62.92943558410651,1.2731023452438976,1.5,2.75,NaN,NaN,1.5269489826414888,1.0854763461386168,331.9894265988096,0.23142531249997056,1.4143175069032168,1.1828921944032462,16.932811905805618,1.4060841881853585,28.0144133813127,39.01508517692595,32.97050144176136,2662112461
1285767000,114.38,114.91,114.02,114.47,NaN,NaN,106.28577315789474,113.15880294117648,111.98321345000028,109.83790589999995,110.56389200000005,112.38000100000008,111.02476441823741,112.49790364153509,113.56369384615392,115.23399567262183,111.89339201968602,111.98321345000028,109.83790589999995,110.56389200000005,112.38000100000008,114.46666666666665,179665744,188019936,61.840950188335874,1.064734429954906,1.5,2.75,NaN,NaN,1.4814526267385253,0.9555675202442362,333.65781059376974,0.18149215214405534,1.4097573845833153,1.22826523243926,16.988688327086166,1.2560813799203907,28.618712818451048,38.344644168290394,33.03664301325856,2482446717
1285853400,115.05,115.78999,113.59,114.13,NaN,NaN,106.3689307894737,113.1582144117647,111.99451345000028,109.81760589999995,110.70509180000005,112.6635005000001,111.14653836262026,112.65334138996032,113.67215538461545,115.29157163337646,112.05273913585444,111.99451345000028,109.81760589999995,110.70509180000005,112.6635005000001,114.50333,287106560,188983516.8,59.94276260067308,0.9654359473442035,1.5,2.75,NaN,NaN,1.5327767248286306,1.5192148228664988,334.2809875466195,0.10778503071512313,1.362996520833164,1.255211490118041,17.145492107551696,1.45789835026239,23.839642733556794,43.89829071937263,32.26206654707059,2195340157
1285939800,114.99001,115.12,113.92999,114.61,NaN,NaN,106.45208842105264,113.15762588235295,112.0108134000003,109.80540589999995,110.80807180000004,112.92050050000012,111.28236038761554,112.83968982901172,113.82292538461546,115.39795885906634,112.24789191016458,112.0108134000003,109.80540589999995,110.80807180000004,112.92050050000012,114.55333,174638624,189909841.6,61.728766642325326,0.9236150559549973,1.5,2.75,NaN,NaN,1.5082933873408713,0.9195870131250744,337.4596309026608,0.07512552060714084,1.349118390876967,1.2739928702698262,16.79203692774607,0.3502232422534614,21.390801538686887,46.990876999373995,31.618321461939118,2369978781
1286199000,114.37,114.85001,113.17999,113.75,NaN,NaN,106.53524605263159,113.15703735294119,112.02196340000029,109.76840589999995,110.87487180000004,113.06350050000012,111.37913056849337,112.92638603577251,113.87446384615393,115.3916701009561,112.35725759135175,112.02196340000029,109.76840589999995,110.87487180000004,113.06350050000012,113.92666666666666,166153184,187607638.4,56.838983045997885,0.3095112526906443,1.5,2.75,NaN,NaN,1.5198452882450941,0.8856418929262531,333.43145631903235,-0.015780972235566848,1.2542666549753676,1.2700476272109344,15.190827738838458,-0.20178978768205297,20.02955737156112,48.81896363176229,31.1514789966766,2203825597
1286285400,114.8,116.32001,114.67,116.03999,NaN,NaN,106.61840368421053,113.15644882352942,112.0512634000003,109.76890569999995,110.96447160000004,113.38350000000014,111.56190936972892,113.22291974665131,114.10446307692315,115.92767163101887,112.28125452282744,112.0512634000003,109.76890569999995,110.96447160000004,113.38350000000014,115.67666666666666,229634064,191990657.6,64.82838345091108,1.8259111198589009,1.5,2.75,NaN,NaN,1.5948570533704445,1.1960689487215965,338.5207989534699,0.06263089402273847,1.3483362447393574,1.285705350716619,19.056969809704626,2.309989419855406,21.57774664630636,46.773767451319884,31.648485902373753,2433459661
1286371800,116.02,116.33,115.56,116.03,NaN,NaN,106.70156131578948,113.15586029411764,112.0803633500003,109.79030569999995,111.05407160000003,113.66450000000016,111.7371286101317,113.49026072316072,114.37677000000008,116.21152511449272,112.54201488550744,112.0803633500003,109.79030569999995,111.05407160000003,113.66450000000016,115.97333333333331,148626496,191908535.2,64.77205513319245,1.4892423216681538,1.5,2.75,NaN,NaN,1.5359386924154124,0.7744652724544375,337.23852333207225,0.09613564902135141,1.4058749119933083,1.3097392629719569,18.631541424885175,3.139611370868812,22.871703085081798,45.12435504151199,32.00394187340621,2284833165
1286458200,116.5,116.53,115.19,115.89,NaN,NaN,106.78471894736843,113.15527176470589,112.10316335000029,109.80970569999994,111.15527160000003,113.91300000000015,111.89998631169517,113.71880732095494,114.50600000000009,116.50488519704271,112.50711480295746,112.10316335000029,109.80970569999994,111.15527160000003,113.91300000000015,115.87,164860000,192800641.6,63.93367974435313,1.1991429304869707,1.5,2.75,NaN,NaN,1.5219430715285973,0.855080142015461,335.7514516748139,0.09122107499341814,1.4237656067137294,1.3325445317203113,17.607734985520874,0.9318846079180835,29.497780041282088,37.40940115422994,33.09281880448797,2119973165
1286544600,116.05,116.86,115.61,116.53751,NaN,NaN,106.86787657894737,113.15468323529413,112.12720090000028,109.85108089999994,111.28022200000004,114.16577600000014,112.08184998574635,113.9872551951497,114.70273153846162,116.94448398507893,112.46097909184431,112.12720090000028,109.85108089999994,111.28022200000004,114.16577600000014,116.33583666666667,177760064,195297697.6,66.11803164135188,1.5519273389713246,1.5,2.75,NaN,NaN,1.5025185664194116,0.9102005102184062,339.344487982717,0.11253277708022269,1.4732105030705895,1.3606777259903668,13.898781844551374,1.984344097313382,29.973637322004997,36.896953260286445,33.129409417708565,2297733229
1286803800,116.72,116.97,116.25,116.64999,NaN,NaN,106.95103421052633,113.15409470588236,112.15070085000029,109.89998089999993,111.40782180000002,114.36227550000015,112.26099273140335,114.24084898608783,114.95119230769237,117.28334978489866,112.61903483048607,112.15070085000029,109.89998089999993,111.40782180000002,114.36227550000015,116.62333000000001,103098320,191527441.6,66.49761745557407,1.3836997650248182,1.5,2.75,NaN,NaN,1.4466243831037393,0.5382952914669957,340.83005068813344,0.11476455667467778,1.5041334218337141,1.3893688651590363,13.328037406891385,1.726685270777013,51.70971026564422,17.919572929604875,30.3707168047509,2400831549
1286890200,116.27,117.35001,115.64999,117.00999,NaN,NaN,107.03419184210527,113.15350617647059,112.17335080000028,109.99468089999995,111.49282180000002,114.58027550000016,112.44722791840714,114.50457670169851,115.29826846153853,117.39816636557998,113.19837055749707,112.17335080000028,109.99468089999995,111.49282180000002,114.58027550000016,116.66999666666668,182210000,190146763.2,67.74320548343987,1.3637173987565947,1.5,2.75,NaN,NaN,1.4647240700249005,0.9582598038145306,342.61624110084875,0.12045499342526034,1.5399376069406117,1.4194826135153513,13.31392537817239,2.2189132523805393,48.464043638333195,20.26714903147176,31.268807330195056,2583041549
1286976600,117.66,118.55,117.38,117.92,NaN,NaN,107.11734947368421,113.15291764705883,112.19935080000026,110.08273079999995,111.60682180000002,114.82227550000016,112.66184643141078,114.82985511106055,115.5367292307693,118.03205566402922,113.04140279750938,112.19935080000026,110.08273079999995,111.60682180000002,114.82227550000016,117.95,194347120,191433703.2,70.70788535403854,2.064696841954812,1.5,2.75,NaN,NaN,1.470101636451693,1.0152189335070023,346.6997444986678,0.1628407593593164,1.6230335627144967,1.4601928033551803,13.44496393967196,3.320774555331645,77.21220392966033,4.399386122809436,18.388409947530235,2777388669
1287063000,117.80991,118.00999,116.72,117.46001,NaN,NaN,107.20050710526317,113.15232911764707,112.22384085000026,110.18023079999995,111.696622,115.04277600000015,112.85000970861036,115.08034605286431,115.78211461538469,118.35703804487515,113.20719118589422,112.22384085000026,110.18023079999995,111.696622,115.04277600000015,117.39666666666666,217764256,192323772,67.33882316063409,1.2346068825782648,1.5,2.75,NaN,NaN,1.4572365195622865,1.1322794563326264,344.2243756412261,0.1382031683694127,1.6329467638169461,1.4947435954475334,13.605354821589755,2.486702731000783,70.37462515767379,7.187088091952591,22.438286750373617,2559624413
1287149400,118.28,118.35001,116.75999,117.7,NaN,NaN,107.28366473684211,113.1517405882353,112.24974085000025,110.27905089999996,111.7936218,115.30327550000013,113.04020540631191,115.32983690497248,116.01519153846161,118.69178593168625,113.33859714523696,112.24974085000025,110.27905089999996,111.7936218,115.30327550000013,117.60333333333334,243704944,194717178.4,68.19040951900861,1.1948476198271734,1.5,2.75,NaN,NaN,1.4667210538792657,1.2515842002361308,341.75827899813584,0.11720427429189417,1.6412489383124012,1.524044664020507,13.585050354852918,3.472527472527475,72.84393264345151,6.109083194524241,21.046984162024234,2803329357
1287408600,117.74001,118.67,117.31,118.28,NaN,NaN,107.36682236842107,113.15115205882353,112.28394085000025,110.39015089999997,111.9113818,115.50677500000015,113.24568754724086,115.61080481878463,116.30826846153853,119.07669647558208,113.53984044749498,112.28394085000025,110.39015089999997,111.9113818,115.50677500000015,118.08666666666666,141502192,191052953.6,70.21184551701405,1.6074983450666886,1.5,2.75,NaN,NaN,1.4590981214593182,0.740643833731341,345.1985252273536,0.12101835329790522,1.6753176056428885,1.5542992523449832,11.951426442759384,1.9303776224041367,75.26231730451072,5.187284099634428,19.550398595854865,2944831549
1287495000,117.19,117.85001,116.02,116.73,NaN,NaN,107.44998000000001,113.15056352941177,112.30094085000025,110.44985099999997,111.98614179999998,115.64427500000015,113.38232725127064,115.71739483604324,116.50826846153852,118.9778765540269,114.03866036905013,112.30094085000025,110.44985099999997,111.98614179999998,115.64427500000015,116.86667,280604672,191651571.2,59.356184329583655,0.28995769667864996,1.5,2.75,NaN,NaN,1.5163053984979389,1.4641396897663421,340.1434234426163,0.003977333563255581,1.5592709192990526,1.555293585735797,10.757467177322377,0.6032922520037945,41.76669384874112,25.77108613818295,32.46222001307594,2664226877
1287581400,116.94,118.44,116.87,117.87,NaN,NaN,107.53313763157895,113.14997500000001,112.32214085000024,110.53486099999996,112.09604179999998,115.86677500000015,113.55831441788747,115.92240485165817,116.75903769230776,119.06321552748908,114.45485985712644,112.32214085000024,110.53486099999996,112.09604179999998,115.86677500000015,117.72666666666667,200051744,192088040,63.7904968125105,1.1871578022883251,1.5,2.75,NaN,NaN,1.5301407271766572,1.0414586144978104,344.54947988044523,-0.011017386532296669,1.5415218525704262,1.5525392391027228,11.934978169673665,1.7085166968677228,42.105390389101245,25.483440994800826,32.411168616097925,2864278621
1287667800,118.39999,119.09,117.21001,118.13,NaN,NaN,107.61629526315791,113.14938647058824,112.34424080000025,110.64086099999994,112.27264179999999,116.14837500000014,113.7375962054213,116.1326520086431,117.09596076923081,118.72308868731997,115.46883285114166,112.34424080000025,110.64086099999994,112.27264179999999,116.14837500000014,118.14333666666666,221546128,193047633.6,64.73547766089122,1.0344572126981177,1.5,2.75,NaN,NaN,1.5551299609497538,1.1476241581860034,344.1818725693983,-0.017399848281463903,1.530789428750893,1.5481892770323569,11.804311402447702,1.3665042268364906,70.73742340767646,7.095410254833328,22.167166337490208,3085824749
1287754200,118.31,118.53,118,118.347,NaN,NaN,107.69945289473685,113.14879794117647,112.36502580000025,110.72103099999995,112.46698179999997,116.32472450000016,113.91835713854204,116.34354229353424,117.27342307692312,118.90438689521429,115.64245925863196,112.36502580000025,110.72103099999995,112.46698179999997,116.32472450000016,118.29233333333333,108212320,187974665.6,65.54371691075946,0.986365659035972,1.5,2.75,NaN,NaN,1.4819063923104856,0.5756750233048427,346.39841119488193,-0.020754235925181774,1.5222464821258797,1.5430007180510614,11.573775402514366,1.4547879515463238,65.7627596572994,9.502539485296499,24.734700857404107,3194037069
1288013400,119.14,119.75999,118.61,118.7,NaN,NaN,107.7826105263158,113.14820941176471,112.38567575000026,110.80093089999995,112.67478179999996,116.54622450000015,114.10587254487372,116.56796683700718,117.47880769230775,119.10416289798366,115.85345248663185,112.38567575000026,110.80093089999995,112.67478179999996,116.54622450000015,119.02333,151145680,189091977.6,66.87378361123814,1.4097141652420109,1.5,2.75,NaN,NaN,1.4769837928597371,0.7993235985914191,348.8354983782617,-0.013308337458954655,1.5263652962273682,1.5396736336863228,11.59471587645681,1.4443296679198083,64.6590625188973,9.98219276976611,25.35874471133658,3345182749
1288099800,118.10001,118.84,117.87,118.72,NaN,NaN,107.86576815789475,113.14762088235295,112.40562575000027,110.91993079999995,112.88398199999997,116.74872450000014,114.28681871958456,116.77292237633982,117.69650000000004,119.16262652941806,116.23037347058202,112.40562575000027,110.91993079999995,112.88398199999997,116.74872450000014,118.47666666666667,158982880,186580749.6,66.95162222872838,0.9008553899258103,1.5,2.75,NaN,NaN,1.4407706647983272,0.8520861897105381,347.2918084082858,-0.02070430485491892,1.513793252617674,1.534497557472593,11.592106964212318,0.6784260515603775,100,0,0,3504165629
1288186200,117.89,118.50999,117.25999,118.38,NaN,NaN,107.94892578947369,113.14703235294118,112.42922575000028,111.04883069999994,113.05978199999998,116.94422450000016,114.44733563254202,116.92597738811698,117.83823000000005,119.1797264173877,116.4967335826124,112.42922575000028,111.04883069999994,113.05978199999998,116.94422450000016,118.04999333333335,190023936,187098659.2,64.19024391413043,0.32530486469473324,1.5,2.75,NaN,NaN,1.442144903027018,1.015634942615345,344.268092624212,-0.05994232708195746,1.4595696486201462,1.5195119757021036,11.07260278730206,0.7832367799049214,73.08859197728854,6.003209392404479,20.90819863030696,3314141693
1288272600,119.06,119.11,117.83,118.39999,NaN,NaN,108.03208342105265,113.14644382352941,112.44812570000029,111.16663059999993,113.23198199999997,117.15772400000014,114.60234168616782,117.06635954162965,117.97284538461544,119.15173980149333,116.79395096773754,112.44812570000029,111.16663059999993,113.23198199999997,117.15772400000014,118.44666333333335,168576000,181172131.2,64.28351608063882,0.5715816996132156,1.5,2.75,NaN,NaN,1.430563124239374,0.9304742339974197,344.70739030931895,-0.09397106894488294,1.4020481395209998,1.4960192084658828,10.736453641129524,0.5947238742565842,70.96925087502144,6.916378963779149,22.114370161199407,3482717693
1288359000,118.28,118.72,118.07001,118.49001,NaN,NaN,108.11524105263159,113.14585529411765,112.46592580000029,111.29103069999994,113.44418219999997,117.35172450000013,114.75479926710241,117.20194529956969,118.08669307692313,119.15204907175693,117.02133708208932,112.46592580000029,111.29103069999994,113.44418219999997,117.35172450000013,118.42667333333333,144305504,179655475.2,64.7290479571466,0.5290289285405955,1.5,2.75,NaN,NaN,1.374807901079419,0.8032346569975286,347.2282708518432,-0.11826756184617682,1.3481847561581617,1.4664523180043385,10.707342262313562,0.17755326344267577,72.46583655056703,6.265420171674089,21.268743277758894,3627023197
1288618200,119.07001,119.75,117.85001,118.53,NaN,NaN,108.19839868421055,113.1452667647059,112.4903758000003,111.38483079999995,113.66418219999997,117.59072450000015,114.90284635466702,117.32842669961067,118.13361615384619,119.21901681087112,117.04821549682126,112.4903758000003,111.38483079999995,113.66418219999997,117.59072450000015,118.71000333333332,174074688,180051550.4,64.93828583528901,0.62712651132757,1.5,2.75,NaN,NaN,1.4123209081451749,0.9668047157232366,347.99412884229474,-0.13811364936163573,1.2938102563022937,1.4319239056639295,10.360483283807215,1.5420200462605989,73.11817715774313,5.984932369161614,20.896890473095244,3801097885
1288704600,119.42,119.75,119.10001,119.47501,NaN,NaN,108.28155631578949,113.14467823529412,112.51245085000028,111.48278099999995,113.91121039999999,117.76247550000014,115.08214688977812,117.53286320440965,118.28861615384618,119.51173632598193,117.06549598171043,112.51245085000028,111.48278099999995,113.91121039999999,117.76247550000014,119.44167333333333,158345872,176487140.8,69.53726738036006,1.1066974472049693,1.5,2.75,NaN,NaN,1.3985837004205195,0.8972091183654101,352.25842368743804,-0.0960588932456008,1.3118502891069284,1.4079091823525292,6.876627847031378,1.3616781199626646,73.13195776198329,5.979197633365554,20.888844604651155,3959443757
1288791000,119.675,120.02,118.45,119.95,NaN,NaN,108.36471394736843,113.14408970588235,112.54275085000029,111.58719099999995,114.19961039999998,117.95847550000012,115.27304309017897,117.7630667087516,118.46169307692311,119.91733238517364,117.00605376867259,112.54275085000029,111.58719099999995,114.19961039999998,117.95847550000012,119.47333333333334,226702752,180390953.6,71.55675159025265,0.9616956396759895,1.5,2.75,NaN,NaN,1.4108277218190535,1.256730160109315,354.1074903760806,-0.047187108066909955,1.3489252972688917,1.3961124053358016,5.206681277914125,1.540675526961828,100.00000000000001,0,0,4186146509
1288877400,121.28,122.32001,119.9724,122.25999,NaN,NaN,108.44787157894739,113.1435011764706,112.59555080000027,111.68979089999995,114.52601019999999,118.27697500000014,115.54704100821117,118.19134511744191,118.7678461538462,121.25237921897835,116.28331308871404,112.59555080000027,111.68979089999995,114.52601019999999,118.27697500000014,121.51746666666666,215039312,182899919.2,78.88716506989148,2.4558863259834722,1.5,2.75,NaN,NaN,1.4793407416891207,1.1757211973661714,359.6113351860573,0.12060848119425405,1.5468730068286192,1.4262645256343651,11.234273139663763,3.306370250196463,100.00000000000001,0,0,4401185821
1288963800,122.34,122.92,122.17999,122.72501,NaN,NaN,108.53102921052633,113.14291264705884,112.66312580000027,111.79744089999994,114.8759104,118.58635000000012,115.82852998828132,118.62312272530458,119.22900076923081,122.20602261721109,116.25197892125053,112.66312580000027,111.79744089999994,114.8759104,118.58635000000012,122.60833333333335,180654128,183044622.4,80.00436449809031,2.5197233196604216,1.5,2.75,NaN,NaN,1.4265314029970406,0.9869403735075256,362.0069834145714,0.23613051852032707,1.721427673784774,1.485297155264447,11.188390127591065,3.390909856781798,100.00000000000001,0,0,4581839949
1289226600,122.34,122.69,121.94,122.49001,NaN,NaN,108.61418684210528,113.14232411764706,112.72672585000028,111.90094099999995,115.18851060000001,118.87835100000014,116.0897644985448,118.991397703847,119.5843861538462,122.91023161501262,116.25854069267977,112.72672585000028,111.90094099999995,115.18851060000001,118.87835100000014,122.37333666666665,155901632,185684788,77.76487743385046,2.070835946410465,1.5,2.75,NaN,NaN,1.3807084456401093,0.839603683636163,360.3154201912144,0.26762081987108166,1.819823180103299,1.5522023602322172,11.635676494188779,3.175547506738544,82.25232904301663,2.7911983010945707,14.956472655888803,4425938317
1289313000,122.82001,122.95,121.12,121.61,NaN,NaN,108.69734447368423,122.95,112.78822585000027,111.99975099999996,115.5144906,119.10835150000014,116.30624432213128,119.24078839871872,119.85207846153851,123.22643238219722,116.4777245408798,112.78822585000027,111.99975099999996,115.5144906,119.10835150000014,121.89333333333333,186621568,185905366.4,69.87678123377363,1.4094433424724007,1.5,2.75,NaN,NaN,1.4128006995229587,1.003852506325498,356.22311180207663,0.20301789012405425,1.8059747228872851,1.6029568327632309,13.011409842446492,2.728501436053391,57.096629461723325,14.50069085866612,28.40267967961056,4239316749
1289399400,121.58,122.16,120.66,122.10001,NaN,NaN,108.78050210526317,123.10030784615385,112.84957590000026,112.10665109999997,115.8502908,119.31735200000014,116.5334508193026,119.51309521788836,120.14077153846159,123.59196202481732,116.68958105210586,112.84957590000026,112.10665109999997,115.8502908,119.31735200000014,121.64000333333333,221387376,187257379.2,71.604002044449,1.1907812891967364,1.5,2.75,NaN,NaN,1.4190292209856046,1.1822624931834997,358.8518210594025,0.16854093403440706,1.8136330003062398,1.6450920662718327,12.584458217677005,3.1250171558291475,57.02652038972506,14.54495369555805,28.4285259147169,4460704125
1289485800,121.05,121.82001,120.67999,121.63499,NaN,NaN,108.86365973684212,123.25061569230769,112.91490080000025,112.22730089999997,116.1137904,119.52610100000015,116.73351117932995,119.71518043523233,120.36654000000006,123.79511064949845,116.93796935050166,112.91490080000025,112.22730089999997,116.1137904,119.52610100000015,121.37833,158017568,184270044.8,67.64027945700118,0.7529859026034768,1.5,2.75,NaN,NaN,1.4190999909152038,0.8575325857846646,355.794952654573,0.09342177124800322,1.7618692803318368,1.6684475090838335,13.11842688155495,2.6542153216123485,29.442523303880865,37.67977781643,32.877698879689135,4302686557
1289572200,120.82001,121.35001,119.64999,120.198,NaN,NaN,108.94681736842107,123.40092353846154,112.97894080000026,112.33698089999999,116.3283504,119.65100100000015,116.8693734860229,119.76116325092448,120.48023230769238,123.77840610539941,117.18205850998534,112.97894080000026,112.33698089999999,116.3283504,119.65100100000015,120.39933333333332,239068816,184038238.4,57.11808361891614,0.36511640854962685,1.5,2.75,NaN,NaN,1.4595214201355464,1.299017085136368,350.49523978294127,-0.06547505049854885,1.5866036959606475,1.6520787464591964,15.571748744646493,1.4072386737534734,7.596295197789687,69.69189301675635,22.711811785453957,4063617741
1289831400,120.58,121.05,119.98,120.03,NaN,NaN,109.02997500000001,123.55123138461539,113.03379080000025,112.46308089999998,116.51115039999999,119.73850100000016,116.99331962382591,119.78676675083643,120.60715538461545,123.69238815764761,117.52192261158329,113.03379080000025,112.46308089999998,116.51115039999999,119.73850100000016,120.35333333333335,163940688,185160163.2,56.02087033175224,0.1103962310987054,1.5,2.75,NaN,NaN,1.4316984615544353,0.8853993492267564,348.89836784067415,-0.18741924378555286,1.4178046917272553,1.6052239355128082,15.647863755988446,0.4645239201068103,6.364790713851313,72.20032036969894,21.434888916449744,3899677053
1289917800,119.28999,119.49001,117.59,118.16,NaN,NaN,117.59,123.70153923076923,113.07269080000023,112.56600599999997,116.68155039999998,119.81000100000014,117.03907179544058,119.63183658409011,120.58869461538468,123.72891553601521,117.44847369475416,113.07269080000023,112.56600599999997,116.68155039999998,119.81000100000014,118.41333666666667,300332032,186146531.2,45.53548480429945,1.8216698874337163,1.5,2.75,NaN,NaN,1.5037200000148325,1.613417290474871,341.98943642305727,-0.3880002267802276,1.1202236520375237,1.5082238788177513,17.695540524298465,-1.4922884535223062,5.094551459375217,75.31863424352396,19.58681429710082,3599345021
1290004200,118.21001,118.71001,117.86,118.218,NaN,NaN,117.81931051724138,123.85184707692308,113.11463080000023,112.67288599999998,116.83771039999998,119.82740100000015,117.08530427405076,119.49718548084343,120.56777076923085,123.76672413161856,117.36881740684314,113.11463080000023,112.67288599999998,116.83771039999998,119.82740100000015,118.26267,172308816,184759384.8,45.87387096311409,1.365610600802188,1.5,2.75,NaN,NaN,1.4570264285852015,0.9326119817216451,344.74140541513066,-0.5034296527012709,0.8789368129411628,1.3823664656424337,17.441999203109095,-3.3060611243302067,3.111720016855528,81.01247291850015,15.875807064644322,3771653837
1290090600,119.36,120.39,119.35001,119.9575,NaN,NaN,118.04862103448276,124.00215492307693,113.18221830000024,112.83036089999997,117.01846039999998,119.91877600000014,117.19793940055857,119.54102495885834,120.67757846153853,123.68123795883076,117.6739189642463,113.18221830000024,112.83036089999997,117.01846039999998,119.91877600000014,119.89916999999998,197723680,183568262.4,54.9200208221954,0.17656463350501075,1.5,2.75,NaN,NaN,1.508095969400544,1.0771125542886872,350.5755922349931,-0.4509799113422557,0.8186415764646142,1.26962148780687,15.61490815425585,-2.2550497245834418,15.158902611837764,55.768280155310826,29.072817232851413,3969377517
1290177000,119.89999,120.34,119.25,120.28999,NaN,NaN,118.27793155172414,124.15246276923077,113.25036825000025,113.00106079999998,117.19462039999999,120.01592550000014,117.31919628681118,119.61235496277659,120.74026923076931,123.67412287446977,117.80641558706886,113.25036825000025,113.00106079999998,117.19462039999999,120.01592550000014,119.95999666666667,156852816,186000287.2,56.41932449631718,0.14004739265502164,1.5,2.75,NaN,NaN,1.4782319715862198,0.8432934075598568,352.8782175482678,-0.3848204791294254,0.7885958888950881,1.1734163680245135,15.488556179848125,-1.7960811661293807,37.55055330933837,29.289015542328126,33.160431148333494,4126230333
1290436200,119.69,120.24001,118.77,120.19,NaN,NaN,118.50724206896552,124.30277061538462,113.32186825000025,113.17536089999997,117.34402039999998,120.09042550000015,117.43177682458328,119.66736877584549,120.75873076923085,123.67543100744187,117.84203053101983,113.32186825000025,113.17536089999997,117.34402039999998,120.09042550000015,119.73333666666667,181592192,187522612.8,55.818090488635974,0.20587347968607037,1.5,2.75,NaN,NaN,1.4812146879014902,0.9683749031039525,353.61361970119543,-0.3402590445849072,0.7480925622933796,1.0883516068782868,15.503270120031113,-1.16766713263712,40.13869236945727,27.274976853022107,32.58633077752064,3944638141
1290522600,118.77,119.015,117.99001,118.44749,NaN,NaN,118.7365525862069,124.45307846153847,113.37800570000023,113.33783579999998,117.45997039999996,120.07680000000016,117.47160871381531,119.55118984481258,120.46546153846162,123.48428309059115,117.4466399863321,113.37800570000023,113.33783579999998,117.45997039999996,120.07680000000016,118.48416666666667,222308944,190688916,46.515270799883254,1.1576120446741156,1.5,2.75,NaN,NaN,1.5325557816228124,1.1658199577787731,348.4475259554177,-0.4156170705730995,0.5688302686619124,0.9844473392350119,16.94095653061148,-2.991416626419601,46.25519403415993,22.191484269284828,31.55332169655526,3722329197
1290609000,119.2,120.23,119.17999,120.2,NaN,NaN,118.96586310344829,124.6033863076923,113.44395575000024,113.51113579999998,117.60237039999997,120.16780000000014,117.57860445052845,119.61298128816377,120.27123000000007,122.99393485324705,117.5485251467531,113.44395575000024,113.51113579999998,117.60237039999997,120.16780000000014,119.86999666666667,140159056,188195672,54.69367184450439,0.1923463383747616,1.5,2.75,NaN,NaN,1.5504096543640402,0.7447517496576648,353.63689754211185,-0.3381966121811111,0.5617015740086231,0.8998981861897342,19.39572166203693,-1.1797509910593975,44.229882838637074,23.809960994842726,31.9601561665202,3862488253
1290781800,119.16,119.81,118.8,118.8,NaN,NaN,119.19517362068966,124.75369415384615,113.49730575000024,113.63806079999996,117.71737039999996,120.18780050000017,117.6265023152136,119.53555449881483,119.98738307692315,122.48579984470794,117.48896630913836,113.49730575000024,113.63806079999996,117.71737039999996,120.18780050000017,119.13666666666667,76007680,183567256,48.335179509272855,0.7012001749479657,1.5,2.75,NaN,NaN,1.5396661076237521,0.41405903022268853,350.134845598452,-0.3694910728233737,0.4380343451605171,0.8075254179838908,20.239948914764863,-1.163080916487792,22.074399635614167,46.404782506477275,31.52081785790856,3786480573
1291041000,118.5,119.48,117.74001,119.162,NaN,NaN,119.42448413793103,124.904002,113.55291580000022,113.75808079999997,117.85081019999996,120.22140000000016,117.68671791069542,119.49997787988009,119.79907538461546,122.14422913957543,117.4539216296555,113.55291580000022,113.75808079999997,117.85081019999996,120.22140000000016,118.79400333333335,223642256,187534093.6,49.955274940811485,0.6799907005491825,1.5,2.75,NaN,NaN,1.5539749570791987,1.1925418557599279,347.976937895012,-0.35399656267778257,0.36502971463666256,0.7190262773144451,19.46915790086359,-0.7231525451970299,25.930265326666415,41.388225338602,32.68150933473157,4010122829
1291127400,117.98,119.17,117.81,118.49249,NaN,NaN,119.65379465517242,125.05430984615384,113.59667820000023,113.86340559999996,117.93645979999995,120.21952450000015,117.71831681615835,119.40402665322485,119.52157384615394,121.54345019098524,117.49969750132264,113.59667820000023,113.86340559999996,117.93645979999995,120.21952450000015,118.49083,233930624,190526890.4,47.01864665150123,0.8056499869474069,1.5,2.75,NaN,NaN,1.5401196030021131,1.2278089644400136,345.02890311046326,-0.3750096085527307,0.25026426662353174,0.6252738751762624,19.661886663031897,0.28138964116452864,23.082334997243457,44.82747813033181,32.09018687242473,3776192205
1291213800,120.2,121.24001,120.19,121.00999,NaN,NaN,119.88310517241379,125.20461769230769,113.65042820000022,113.99320549999997,118.07705959999996,120.29627350000014,117.8474020390541,119.5569755433939,119.47349692307702,121.31362690013988,117.63336694601416,113.65042820000022,113.99320549999997,118.07705959999996,120.29627350000014,120.81333333333333,221037120,193661452.8,57.205739131980366,1.1219503821907086,1.5,2.75,NaN,NaN,1.6263624885019616,1.141358369485494,350.1079655239408,-0.21356108916720618,0.35832251371725476,0.5718836028844609,21.053652041280387,2.361730024192592,57.00479096525341,14.406480222558162,28.588728812188418,3997229325
1291300200,121.2,122.64999,121.13,122.56,NaN,NaN,120.11241568965518,125.35492553846154,113.70867820000024,114.12220549999996,118.25985959999997,120.42677350000015,118.03220980222845,119.84297787259449,119.65518923076932,122.10952253427519,117.20085592726346,113.70867820000024,114.12220549999996,118.25985959999997,120.42677350000015,122.11333,191213568,191886993.6,62.04467256446272,1.960652153474383,1.5,2.75,NaN,NaN,1.627336596466107,0.996490509401571,354.0808465671868,-0.00746879635733444,0.5625476074377929,0.5700164037951273,21.806871137813097,2.169518371089766,59.88904663195953,12.651104459831148,27.45984890820932,4188442893
1291386600,122.14,123.03,122.11,122.89,NaN,NaN,120.34172620689655,125.5052333846154,113.76742820000023,114.25459549999997,118.46769959999997,120.45827400000015,118.22271137861165,120.13317045615692,119.87518923076934,122.87629218110791,116.87408628043076,113.76742820000023,114.25459549999997,118.46769959999997,120.45827400000015,122.67666666666668,151288816,188699468.8,63.003819472517684,1.7849679142275952,1.5,2.75,NaN,NaN,1.5768125538613853,0.801744790073304,356.5974580456104,0.13796048506431657,0.7424670101255231,0.6045065250612065,20.651800775915813,2.1614516719138455,73.7255873880782,5.744358207684768,20.53005440423703,4339731709
1291645800,122.63,123.03999,122.5,122.75999,NaN,NaN,120.57103672413794,125.65554123076923,113.82542815000022,114.38539549999996,118.62649919999996,120.46002300000013,118.40064387356806,120.38334374604673,120.2290346153847,123.41670449672294,117.04136473404647,113.82542815000022,114.38539549999996,118.62649919999996,120.46002300000013,122.76666,103050432,184819284,62.3354829127358,1.671889155473495,1.5,2.75,NaN,NaN,1.5027538000141438,0.5575740245806817,356.69599097342683,0.2080725195582923,0.8645971745090719,0.6565246549507796,20.744189582057246,2.1382727348365123,53.89244684985416,16.473336402123753,29.63421674802208,4236681277
1291732200,123.94,124.00999,122.75999,122.83,NaN,NaN,120.80034724137931,125.80584907692308,113.89052815000022,114.54709549999995,118.79769919999995,120.47702250000013,118.57434411382029,120.61635862737562,120.58380384615393,123.82339511432879,117.34421257797906,113.89052815000022,114.54709549999995,118.79769919999995,120.47702250000013,123.19999333333334,206580944,187353249.6,62.56576771317923,1.7281864770334614,1.5,2.75,NaN,NaN,1.4846999571559907,1.1026280272215785,357.46938016466333,0.23959234386871298,0.9560150847866709,0.7164227409179579,20.68903262945865,3.6999602102163553,87.57411354869994,1.402690533185729,11.023195918114316,4443262221
1291818600,122.98,123.38,122.41,123.28,NaN,NaN,121.02965775862069,125.95615692307693,113.95282810000022,114.70699559999997,118.96989919999994,120.56052250000013,118.75887963876852,120.87003875810176,120.83938076923086,124.35360047761502,117.3251610608467,113.95282810000022,114.70699559999997,118.96989919999994,120.56052250000013,123.02333333333333,138019184,184923130.4,64.08574417278844,1.4034310128677294,1.5,2.75,NaN,NaN,1.4479356745019913,0.7463597641974592,354.6781064784748,0.26897499187489715,1.0526414807615794,0.7836664888866822,17.718210979927257,2.5623960066555727,86.1839690149348,1.717083010301117,12.098947974764084,4581281405
1291905000,123.97,124.02,123.14999,123.75999,NaN,NaN,121.25896827586207,126.10646476923077,114.01827805000022,114.85979549999998,119.15569899999993,120.64352150000013,118.95500161371878,121.14527220971111,121.10630384615393,124.92683786040847,117.2857698318994,114.01827805000022,114.85979549999998,119.15569899999993,120.64352150000013,123.64332666666667,123705056,180039014.4,65.68619089364236,1.533981036043786,1.5,2.75,NaN,NaN,1.4066552691804202,0.6871013841764287,356.60065752633943,0.29677865553993443,1.1546398083116003,0.8578611527716659,16.370175653338215,4.175075757575762,84.76513802721797,2.067707673506645,13.167154299275381,4704986461
1291991400,124.14,124.60001,123.73,124.48,NaN,NaN,121.48827879310345,126.25677261538462,114.08697800000022,115.03389539999998,119.36269899999992,120.78577200000014,119.17166821710235,121.46286533259577,121.43630384615393,125.60819046976027,117.26441722254759,114.08697800000022,115.03389539999998,119.36269899999992,120.78577200000014,124.27000333333335,117571632,178016717.6,67.99051744948852,1.8526378851603158,1.5,2.75,NaN,NaN,1.368323464238961,0.6604527573875455,359.79048510788675,0.33677622549863273,1.2788314346449567,0.942055209146324,13.477605004595198,4.462832110907837,83.96527899237572,2.278389987414973,13.756331020209313,4822558093
1292250600,125.05,125.2,124.52,124.56,NaN,NaN,121.71758931034483,126.40708046153847,114.15032800000023,115.18488539999998,119.56169899999993,121.00387200000014,119.38297534584343,121.75783053901522,121.906496923077,126.00210369021103,117.81089015594297,114.15032800000023,115.18488539999998,119.56169899999993,121.00387200000014,124.75999999999999,133812624,172753908,68.24567832052779,1.9368464931614222,1.5,2.75,NaN,NaN,1.3220146453647494,0.7745852209606743,358.05004659601906,0.34070843681620966,1.367940755166586,1.0272323183503764,13.65247643232175,5.120586123221816,100,0,0,4956370717
1292337000,124.75,125.23,124.28999,124.67,NaN,NaN,121.94689982758621,126.5573883076923,114.21267800000021,115.32748539999999,119.78009899999994,121.23587200000013,119.59030964600643,122.03518001148996,122.25034307692316,126.46399518445294,118.03669096939338,114.21267800000021,115.32748539999999,119.78009899999994,121.23587200000013,124.72999666666668,147249568,171919352,68.61612808805253,1.5643749881171094,1.5,2.75,NaN,NaN,1.2947285992672675,0.8565037401955773,356.035564147626,0.322967433493496,1.4309416102172463,1.1079741767237503,12.34746639594259,3.0245519398852934,100,0,0,5103620285
1292423400,124.44,124.92999,123.89,124.09801,NaN,NaN,122.1762103448276,126.70769615384616,114.27166805000023,115.45286549999999,119.94125939999992,121.53277250000015,119.76708220890814,122.23164001039568,122.65788230769239,126.46286556089898,118.8528990544858,114.27166805000023,115.45286549999999,119.94125939999992,121.53277250000015,124.30599999999998,160823008,164943900.8,64.40838395101872,1.0679157743010712,1.5,2.75,NaN,NaN,1.2765329850338916,0.9750163978176026,352.61345319479386,0.24831297516644257,1.4183653956818034,1.1700524205153608,8.363403422013421,1.2549037206266318,73.07403461634635,6.045494928949878,20.880470454703755,4942797277
1292509800,124.17999,124.91,123.75,124.82001,NaN,NaN,122.40552086206897,126.85800400000001,114.33256305000023,115.5855656,120.11705959999993,121.86287300000015,119.96523623993134,122.47815143797705,123.09311384615391,126.469239332001,119.71698836030683,114.33256305000023,115.5855656,120.11705959999993,121.86287300000015,124.49333666666666,185035184,165580219.2,67.14700259194812,1.1747259315895138,1.5,2.75,NaN,NaN,1.2682092003886134,1.1174957062745574,356.3074442099769,0.22391323921013995,1.4499439695280358,1.226030730317896,5.838915824908306,1.5705183497436697,75.69249221896455,4.993510109291288,19.313997671744165,5127832461
1292596200,124.08,124.46001,123.82001,124.3,NaN,NaN,122.63483137931036,127.00831184615384,114.38281305000022,115.72026559999999,120.28525959999993,122.07999800000016,120.13522697562031,122.65166082483637,123.53984538461545,125.66953747143896,121.41015329779194,114.38281305000022,115.72026559999999,120.28525959999993,122.07999800000016,124.19333999999999,141075248,162747797.6,63.36524118425967,0.7262079286302654,1.5,2.75,NaN,NaN,1.2490514003608553,0.8668335306554097,358.43025581582515,0.15251874391422482,1.416679160210677,1.2641604162964521,6.726891287356141,1.254488534904569,50.89280257240571,18.56815691832402,30.539040509270276,4986757213
1292855400,124.64,124.89999,123.98,124.60001,NaN,NaN,122.86414189655173,127.1586196923077,114.43446310000022,115.8633658,120.44650959999994,122.29549900000015,120.31031650598814,122.83721788913766,123.81600076923084,125.43064906539259,122.2013524730691,114.43446310000022,115.8633658,120.44650959999994,122.29549900000015,124.49333333333334,119085440,160859428.8,64.60384469260406,0.8622220500228116,1.5,2.75,NaN,NaN,1.225547014620794,0.7403074901382467,357.7047795657151,0.10739560093623757,1.398404917466749,1.2910093165305114,6.6056659367403245,1.4410241797606442,49.65853109654149,19.447814793569243,30.89365410988928,5105842653
1292941800,124.99001,125.47,124.87,125.39,NaN,NaN,123.0934524137931,127.30892753846155,114.48911305000021,116.01456579999999,120.62130979999995,122.55549900000014,120.50951978026312,123.08033999493408,124.03369307692316,125.67516577931553,122.39222037453078,114.48911305000021,116.01456579999999,120.62130979999995,122.55549900000014,125.24333333333334,94965440,156528091.2,67.7005809981902,1.1899389904035427,1.5,2.75,NaN,NaN,1.200150085005023,0.6066990229802279,361.2188708009141,0.11212886496677577,1.4311703977389811,1.3190415327722054,7.116483206769083,1.7115509409474363,45.40959972817245,22.684311102127044,31.906089169700497,5200808093
1293028200,125.48,125.82001,125.41,125.78,NaN,NaN,123.32276293103449,127.45923538461538,114.5431630500002,116.14476589999998,120.79670999999995,122.92212450000015,120.71620527907633,123.33745047160703,124.25600076923084,125.99744056619082,122.51456097227086,114.5431630500002,116.14476589999998,120.79670999999995,122.92212450000015,125.67000333333333,78878064,149356547.2,69.13615586818841,1.252938168334062,1.5,2.75,NaN,NaN,1.1451400789332353,0.5281192252949993,363.8804888287903,0.12208104179428436,1.4716428350150608,1.3495617932207764,7.078312149830605,1.632199550113085,74.07034762036625,5.6295876216707255,20.300064757963035,5279686157
1293114600,125.64,125.78,125.28999,125.60001,NaN,NaN,123.55207344827586,127.60954323076923,114.5939131000002,116.278566,120.95031019999995,123.19212500000017,120.90772703283804,123.55293233145397,124.4744638461539,126.1203317653337,122.82859592697409,114.5939131000002,116.278566,120.95031019999995,123.19212500000017,125.55666666666667,70079248,145852556.8,67.64193225458746,0.9849868367845259,1.5,2.75,NaN,NaN,1.098345073295147,0.4804800789066455,362.6938282769449,0.09812894491318169,1.4722229743622535,1.3740940294490718,7.218091844638386,0.8997509640102775,47.02835135091104,21.419812000420357,31.55183664866861,5209606909
1293460200,125.13,125.77,125.03999,125.64999,NaN,NaN,123.78138396551725,127.75985107692308,114.6448630000002,116.40536589999999,121.11410979999995,123.53462450000015,121.09369812958948,123.75265210941073,124.69138615384621,126.14526643487615,123.23750587281627,114.6448630000002,116.40536589999999,121.11410979999995,123.53462450000015,125.48665999999997,58125968,144958471.2,67.84972368623313,0.9242989148692071,1.5,2.75,NaN,NaN,1.0720354252026358,0.40098358873972456,364.47485130058965,0.06863440703716339,1.459887038245526,1.3912526312083626,6.680682398863909,0.8750722543352603,81.29681459143121,3.0324042632486554,15.670781145320133,5267732877
1293546600,125.89999,125.95,125.5,125.83,NaN,NaN,124.01069448275862,127.91015892307692,114.69656295000021,116.5351658,121.27670979999995,123.86802450000016,121.27943545784088,123.95049476565733,124.88754000000004,126.20884284076818,123.5662371592319,114.69656295000021,116.5351658,121.27670979999995,123.86802450000016,125.76,55309008,136541808.8,68.63104587490214,0.8839653528406812,1.5,2.75,NaN,NaN,1.0276043234024477,0.40507012823459826,363.3442493062675,0.04535390606259648,1.4479450137866081,1.4025911077240116,6.683357854614474,0.9304564049089569,77.507367722096,4.290989975512341,18.201642302391637,5323041885
1293633000,125.98,126.2,125.89999,125.92,NaN,NaN,124.240005,128.06046676923077,114.7441129500002,116.6704458,121.42950979999996,124.23940000000016,121.4614183810628,124.13806669273758,125.05369461538467,126.30757387697625,123.7998153537931,114.7441129500002,116.6704458,121.42950979999996,124.23940000000016,126.00666333333334,58033040,127746929.6,69.03620920644698,0.9802245254638801,1.5,2.75,NaN,NaN,0.9806325860165589,0.454281290217405,366.1099952543529,0.021341046715948053,1.4292674161189467,1.4079263694029986,6.685255370295006,1.4681863149940917,74.5234501568558,5.419186260722006,20.05736358242217,5381074925
1293719400,125.8,126.13,125.53,125.72,NaN,NaN,124.46931551724138,128.21077461538462,114.78721290000021,116.7977258,121.60930979999998,124.47490050000015,121.62842158180544,124.28872700771495,125.14907923076929,126.40253639942648,123.8956220621121,114.78721290000021,116.7977258,121.60930979999998,124.47490050000015,125.79333333333335,76616880,120525917.6,66.96626637960219,0.6359681617378896,1.5,2.75,NaN,NaN,0.9534445441582328,0.6356880040878444,366.38602147808984,-0.020427809973305955,1.3823916069363662,1.4028194169096722,5.947632170309263,0.7210302258427976,39.955737849837,27.16345767656782,32.880804473595184,5304458045
1293805800,125.53,125.87,125.33,125.75,NaN,NaN,124.69862603448276,128.36108246153847,114.83077535000022,116.93147579999999,121.76690979999998,124.63440050000015,121.79005210800915,124.42789586412306,125.24061769230775,126.4823799637351,123.9988554208804,114.83077535000022,116.93147579999999,121.76690979999998,124.63440050000015,125.64999999999999,91270256,115528752,67.12549333853325,0.531572643957049,1.5,2.75,NaN,NaN,0.9239127910040736,0.7900220024881771,367.80993261849846,-0.056411567529534024,1.3323049574977546,1.3887165250272886,5.220665849901516,1.1665325824617883,73.54341850988197,5.8156144281192415,20.640967061998786,5395728301
1294065000,126.71001,127.60001,125.6969,127.05,NaN,NaN,124.92793655172414,128.51139030769232,114.88617535000022,117.1089758,121.94530979999998,124.84240050000017,121.99632457436174,124.6776200675399,125.42369461538466,126.94522731516375,123.90216191560557,114.88617535000022,117.1089758,121.94530979999998,124.84240050000017,126.78230333333335,138725184,114900570.4,73.1623425088879,1.4360525980161236,1.5,2.75,NaN,NaN,0.9938554487894968,1.2073498287872728,372.2332559701973,-0.005706002572023916,1.3815840218122588,1.3872900243842827,6.635985727270014,1.9662839513415766,78.70676676994171,3.8610255324139415,17.43220769764435,5534453485
1294151400,127.33,127.37,126.19,126.98,NaN,NaN,125.15724706896552,128.66169815384615,114.93811285000021,117.29247579999999,122.11796979999997,125.05340100000016,122.19176282634756,124.89689434682182,125.6453861538462,127.16951865993799,124.12125364775441,114.93811285000021,117.29247579999999,122.11796979999997,125.05340100000016,126.84666666666666,137409680,116618532.8,72.39147827263407,0.9749409080767678,1.5,2.75,NaN,NaN,1.007151488161676,1.1782833885901882,369.1435129990253,0.009259486487657842,1.398864382493855,1.389604896006197,6.814477986964389,1.2680437036446315,43.632802288543324,24.00435812125823,32.36283959019843,5397043805
1294237800,126.58,127.72501,126.46001,127.64,NaN,NaN,125.3865575862069,128.812006,114.98926285000022,117.4857758,122.29676979999998,125.29390100000016,122.40541918609863,125.15814250426736,125.86230846153853,127.63693340773168,124.08768351534539,114.98926285000022,117.4857758,122.29676979999998,125.29390100000016,127.27500666666667,133975248,112988248,75.05970350122618,1.321488940159413,1.5,2.75,NaN,NaN,1.0255692390072706,1.1857449811948584,371.9139506314806,0.04760506305328294,1.4491112248228006,1.4015061617695177,6.571828969871139,1.4787724598505323,51.91722848952212,17.737276094142143,30.34549541633573,5531019053
1294324200,127.69,127.83,127.00999,127.39,NaN,NaN,125.61586810344828,128.96231384615385,115.0420128500002,117.67707589999998,122.47016979999998,125.49940100000015,122.60089294350652,125.3707003610038,126.10000076923085,127.80011560704891,124.39988593141278,115.0420128500002,117.67707589999998,122.47016979999998,125.49940100000015,127.40999666666664,122519008,112213239.2,72.21279036616178,1.0190002324437928,1.5,2.75,NaN,NaN,1.0108864362210368,1.0918409349331037,369.27450624550335,0.0404121113911633,1.4520213010084717,1.4116091896173084,6.8346421025174955,1.4251511604179037,44.993992183692285,22.904184513796793,32.101823302510915,5408500045
1294410600,127.56,127.77,126.14999,127.14,NaN,NaN,125.84517862068967,129.1126216923077,115.0944629000002,117.85257589999998,122.64536979999998,125.66840150000014,122.77889714180039,125.53920508852724,126.29538461538469,127.83752319815723,124.75324603261215,115.0944629000002,117.85257589999998,122.64536979999998,125.66840150000014,127.01999666666664,156034560,113829714.4,69.37892244356102,0.598735144983874,1.5,2.75,NaN,NaN,1.054395262205248,1.370771778023542,367.3961287842905,0.004961451499309932,1.4178110039914458,1.4128495524921358,6.917824890568246,1.1858417179340786,20.719662946771717,47.80758256813416,31.472754485094118,5252465485
1294669800,126.58,127.16,126.2,126.98,NaN,NaN,126.07448913793104,129.26292953846155,115.1464529000002,118.02447599999998,122.81696999999998,125.79340150000014,122.9436462734945,125.67642365152464,126.41769230769238,127.9044160955842,124.93096851980056,115.1464529000002,118.02447599999998,122.81696999999998,125.79340150000014,126.78,122401632,114071214.4,67.55180241955459,0.49655998087454317,1.5,2.75,NaN,NaN,1.0476527434763012,1.0730282187650664,368.41230234016183,-0.04060992870515934,1.3620871416106866,1.402697070315846,7.05345738815869,0.9139314948740409,4.95878769143549,75.68524983163688,19.35596247692763,5130063853
1294756200,127.44,127.74001,126.95,127.42999,NaN,NaN,126.30379965517241,129.4132373846154,115.1970028000002,118.2199759,122.99576959999996,125.93690100000015,123.11958132159275,125.84342997042705,126.5446146153847,128.07304310644116,125.01618612432824,115.1970028000002,118.2199759,122.99576959999996,125.93690100000015,127.37333333333333,110286944,112894930.4,69.94880671402169,0.6740455138415596,1.5,2.75,NaN,NaN,1.0292496903708508,0.9768989945716818,370.7113704743663,-0.051115158282988515,1.3388031224621102,1.3899182807450987,7.196544234491117,1.1991661372299889,19.421636943705824,49.57571453263586,31.002648523658316,5240350797
1294842600,128.21001,128.72,127.4621,128.58,NaN,NaN,126.5331101724138,129.56354523076922,115.25290285000021,118.43047589999998,123.19676959999997,126.13240100000014,123.33371538741264,126.10405568752924,126.77384461538469,128.54191327457482,125.00577595619454,115.25290285000021,118.43047589999998,123.19676959999997,126.13240100000014,128.25403333333335,107929120,110928908,75.02625340639587,1.3015713594433704,1.5,2.75,NaN,NaN,1.0478754267729324,0.9729575630547089,374.7548837981974,0.005699240312169174,1.3970423311353102,1.391343090823141,8.422680857427144,2.2748965956093015,16.789260015949274,53.3175501310072,29.89318985304352,5348279917
1294929000,128.63,128.69,128.05,128.36749,NaN,NaN,126.76242068965517,129.71385307692307,115.30974030000021,118.64291479999999,123.37461919999996,126.34587500000013,123.53111831339646,126.3196208601455,126.98288307692316,128.81156999068324,125.15419616316309,115.30974030000021,118.64291479999999,123.37461919999996,126.34587500000013,128.36916333333332,129229120,109349213.6,72.5856519264311,1.0416248176032992,1.5,2.75,NaN,NaN,1.018741467717722,1.1818020061188625,373.16810809166003,0.014764139966178647,1.4097982657808643,1.3950341258146857,8.433048218374106,2.081502982107359,16.356337105992267,53.960916854367994,29.68274603963974,5219050797
1295015400,128.19,129.33,128.10001,129.3,NaN,NaN,126.99173120689656,129.86416092307692,115.36724030000022,118.88061479999996,123.56161919999997,126.56987450000015,123.75734896777307,126.6034664925126,127.24980615384624,129.32396806519264,125.17564424249983,115.36724030000022,118.88061479999996,123.56161919999997,126.56987450000015,128.91000333333335,117677872,105981348,76.23838819672534,1.3923734321740695,1.5,2.75,NaN,NaN,1.0338306485950286,1.1103639859345815,375.30011525521616,0.06646423268953461,1.478114416676604,1.4116501839870694,8.819368713918065,1.770956316410873,44.34935510262533,23.43804685433682,32.21259804303784,5336728669
1295361000,129.17999,129.64,129.03,129.52,NaN,NaN,127.22104172413793,130.01446876923077,115.42104035000023,119.11641479999997,123.70681939999999,126.83087450000014,123.98333528276235,126.88123158846378,127.5267292307693,129.77106928641123,125.28238917512738,115.42104035000023,119.11641479999997,123.70681939999999,126.83087450000014,129.39666666666665,114401248,104647648,77.01644527853232,1.4057690582506024,1.5,2.75,NaN,NaN,1.0035570308382398,1.0932041970021151,376.865675982929,0.0965548250795405,1.532343715336495,1.4357888902569544,7.415091168922632,2.0003150102378378,76.5000000163309,4.818711567448218,18.68128841622087,5451129917
1295447400,129.41,129.53571,127.91,128.25,NaN,NaN,127.4503522413793,130.16477661538462,115.46709040000022,119.34661479999997,123.81731919999999,127.01337400000014,124.15065546775206,127.01159048480056,127.7213446153847,129.73184976405372,125.71083946671567,115.46709040000022,119.34661479999997,123.81731919999999,127.01337400000014,128.56523666666666,151958320,106291292,63.99031206756781,0.6366531874328575,1.5,2.75,NaN,NaN,1.0479965286355082,1.429640350970614,372.42425836282274,0.016215215665059457,1.4560579098382789,1.4398426941732194,10.011516918406695,0.47790661234722615,45.04059121114127,23.38299729537903,31.5764114934797,5299171597
1295533800,127.96001,128.39999,127.13,128.08,NaN,NaN,127.6796627586207,130.31508446153848,115.51569040000022,119.55881479999996,123.92911899999997,127.14787400000014,124.30474741019316,127.11334377196242,127.90057538461545,129.56113617929685,126.24001458993406,115.51569040000022,119.55881479999996,123.92911899999997,127.14787400000014,127.86999666666668,175745632,110330301.6,62.46726124753026,0.16497856056747806,1.5,2.75,NaN,NaN,1.063853205161544,1.59290448273369,369.6974207137581,-0.05896589732861668,1.3661353225124486,1.4251012198410653,9.708018347973724,0.5416437710966417,17.88539415529767,52.34369681437293,29.770909030329392,5123425965
1295620200,128.88,129.17,128.23,128.37,NaN,NaN,127.90897327586207,130.4653923076923,115.56367785000022,119.78940479999997,124.06431899999998,127.27737400000012,124.46416908038167,127.2330253174898,128.00211384615392,129.60255630536335,126.40167138694449,115.56367785000022,119.78940479999997,124.06431899999998,127.27737400000012,128.59,151462880,113959542.4,64.039642743146,0.5546110758247469,1.5,2.75,NaN,NaN,1.065720833364289,1.3290934379883925,370.96233177782545,-0.0974821259646641,1.3032485623852352,1.4007306883498993,9.643561805326492,0.9674374705049583,43.889298690232266,24.321255461030137,31.789445848737593,5274888845
1295879400,128.285,129.25,128.25999,129.10001,NaN,NaN,128.13828379310345,130.61570015384615,115.61142790000022,120.02730489999998,124.20431899999998,127.45237400000012,124.64596676350395,127.41083338249078,128.16519153846158,129.74774401650728,126.58263906041589,115.61142790000022,120.02730489999998,124.20431899999998,127.45237400000012,128.87,113715440,116141352,67.70713905375533,0.7354417605642902,1.5,2.75,NaN,NaN,1.060312916695412,0.979112418116159,374.57517436766346,-0.08269583931195568,1.2973608892099548,1.3800567285219105,9.845192139788255,1.6695621357694073,40.59369130618829,26.66696779281896,32.73934090099275,5388604285
1295965800,128.75999,129.28,128.11,129.17,NaN,NaN,128.36759431034483,130.766008,115.6585778500002,120.23440479999998,124.35501919999999,127.62837450000013,124.82337983160183,127.5783730603488,128.2828838461539,129.91838233851996,126.64738535378785,115.6585778500002,120.23440479999998,124.35501919999999,127.62837450000013,128.85333333333332,167552128,121612660,68.04364657163539,0.4963183449533786,1.5,2.75,NaN,NaN,1.0681477083600244,1.3777523491386505,376.0243120422824,-0.07720814422459865,1.283546548241162,1.3607546924657608,9.712168280460487,1.365463498820006,45.17201395112004,22.85517401885932,31.97281203002064,5556156413
1296052200,129.49001,130.05,129.23,129.67,NaN,NaN,128.5969048275862,130.91631584615385,115.70777785000018,120.43640479999998,124.54445919999998,127.82037450000014,125.01344336761744,127.77757562602986,128.45826846153852,130.16077814963324,126.7557587734438,115.70777785000018,120.43640479999998,124.54445919999998,127.82037450000014,129.64999999999998,141281440,125911281.6,70.41541571165689,1.0744070045016847,1.5,2.75,NaN,NaN,1.05470858633431,1.1220713362987484,379.4496110463588,-0.050218093634680105,1.2979820754224107,1.3482001690570908,9.736315901146076,0.8477212630268898,73.10484654433458,6.020079203573113,20.87507425209232,5697437853
1296138600,129.7,130.21001,129.47,129.99001,NaN,NaN,128.8262153448276,131.0666236923077,115.75177790000019,120.62740489999999,124.7436594,128.02387500000015,125.20860284339714,127.98828366164607,128.67750000000004,130.37852601171997,126.9764739882801,115.75177790000019,120.62740489999999,124.7436594,128.02387500000015,129.89000666666666,123302624,129174760.8,71.85518159405004,1.0305237921716455,1.5,2.75,NaN,NaN,1.03223011588186,0.9545411443873949,381.40266839054783,-0.022537730353539898,1.320028006115166,1.3425657364687058,8.619401422660161,1.2639648870598066,100,0,0,5820740477
1296225000,130.14,130.35001,127.50999,127.72,NaN,NaN,129.05552586206898,131.21693153846155,115.78392795000019,120.80820489999998,124.93485940000001,128.12387500000014,125.30708900640118,127.9627328367274,128.73442307692312,130.24306666269288,127.22577949115336,115.78392795000019,120.80820489999998,124.93485940000001,128.12387500000014,128.52666666666667,295637248,140125779.2,52.38133078042878,0.5117610793457203,1.5,2.75,NaN,NaN,1.1613579647474412,2.1097991368029447,375.54227059730187,-0.16111340042860345,1.1411739859329515,1.302287386361555,13.783598268771616,-1.2219644238205818,56.92164883213228,14.495379716183265,28.58297145168444,5525103229
1296484200,128.07001,128.78,127.75,128.67999,NaN,NaN,129.28483637931035,131.3672393846154,115.83052790000019,120.9909048,125.1440992,128.27037450000014,125.43935963360114,128.03104304275337,128.83057692307696,130.14068470182647,127.52046914432745,115.83052790000019,120.9909048,125.1440992,128.27037450000014,128.40332999999998,149249120,143024722.4,57.61310478541512,0.10350360260949039,1.5,2.75,NaN,NaN,1.1541181101226243,1.0435197320823466,378.8050941749896,-0.19013250152541938,1.0646217594547807,1.2547542609802,13.835539503833747,-0.6485562075355208,56.38187974671853,14.773306919220357,28.844813334061115,5674352349
1296570600,129.46001,130.97,129.3801,130.74001,NaN,NaN,129.51414689655172,131.51754723076922,115.8851779500002,121.18910489999999,125.3597494,128.45487500000013,125.6472282754207,128.2890398958245,128.99673153846157,130.64247130889498,127.35099176802815,115.8851779500002,121.18910489999999,125.3597494,128.45487500000013,130.36337,167194192,144448172.8,66.19592773815317,1.4600350378465496,1.5,2.75,NaN,NaN,1.2352532451138651,1.1574683760901128,383.99465165605824,-0.07832774325865488,1.1568445819068813,1.2351723251655362,16.735290623127373,1.941528265107222,56.47638109320912,14.713316537183227,28.810302369607644,5841546541
1296657000,130.39999,130.84,130.33,130.485,NaN,NaN,129.7434574137931,131.66785507692308,115.9332029500002,121.37913499999999,125.56364959999999,128.63012500000013,125.8369448136395,128.49817895336503,129.15961692307698,130.93782515636525,127.3814086897887,115.9332029500002,121.37913499999999,125.56364959999999,128.63012500000013,130.55166666666668,118323632,143493870.4,64.45599553548138,1.1242506308742477,1.5,2.75,NaN,NaN,1.1834494418914456,0.8245901491831249,382.6359192150847,-0.031679589828127463,1.195572837880377,1.2272524277085044,15.438071705595254,1.8777326670830738,35.06799083755444,31.640363107551273,33.2916460548943,5723222909
1296743400,130.25999,130.98,129.57001,130.78,NaN,NaN,129.9727679310345,131.81816292307693,115.9838029500002,121.559735,125.77544959999999,128.78712500000015,126.0307901150654,128.71549524352073,129.27346307692312,131.25134238358467,127.29558377026157,115.9838029500002,121.559735,125.77544959999999,128.78712500000015,130.44333666666668,145886624,144089439.2,65.58299476439174,1.0305013744128735,1.5,2.75,NaN,NaN,1.1996309103277707,1.0124727031347902,384.05307599305013,0.006856850168687423,1.2358234904193637,1.2289666402506763,15.31545796059569,1.8773856820129287,36.84289169584218,29.9547564185444,33.20235188561342,5869109533
1296829800,130.83,131.2,130.23,131.14999,NaN,NaN,130.20207844827587,131.96847076923078,116.03445290000019,121.744735,126.0294996,128.97512450000016,126.2315430517295,128.94735188699494,129.39884692307697,131.61558185509975,127.18211199105421,116.03445290000019,121.744735,126.0294996,128.97512450000016,130.85999666666666,134634688,144695223.2,66.99641415894575,1.0727215391712908,1.5,2.75,NaN,NaN,1.1832287024472155,0.9304708546867911,383.3678277041859,0.043058939933336315,1.2827903151673468,1.2397313752340104,15.3212184765131,1.5879007290549436,80.44323847537851,3.2921501864166327,16.264611338204872,6003744221
1297089000,131.44,132.39999,131.42999,131.97,NaN,NaN,130.43138896551724,132.11877861538463,116.0852404000002,121.933635,126.2648996,129.21662450000014,126.45658057911265,129.23522313585255,129.6850007692308,132.17786481876917,127.19213671969247,116.0852404000002,121.933635,126.2648996,129.21662450000014,131.93332666666666,112439008,142515445.6,69.94261907261031,1.5870099327017815,1.5,2.75,NaN,NaN,1.1879980808438428,0.7889601546458626,386.88177506960795,0.10452121586695684,1.3703828950677064,1.2658616792007495,15.371790722631248,2.167685995200133,80.39999444806885,3.3120844429808525,16.287921108950286,6116183229
1297175400,132.09,132.64,131.73,132.57001,NaN,NaN,130.66069948275862,132.26908646153845,116.1413404000002,122.1288351,126.54029980000001,129.49612500000015,126.69632290934354,129.55282188481897,130.0303861538462,132.77001966456962,127.29075264312277,116.1413404000002,122.1288351,126.54029980000001,129.49612500000015,132.3133366666667,99072688,141348998.4,71.91801284638414,1.6091056162417017,1.5,2.75,NaN,NaN,1.1681410750692824,0.7009083129095592,389.6506496905806,0.16431602202081064,1.4712567067267628,1.3069406847059521,15.385128104232715,2.236454075730708,77.94510130787586,4.135214112926633,17.919684579197504,6215255917
1297261800,132.21001,132.63,131.61,132.269,NaN,NaN,130.89001000000002,132.4193943076923,116.21028540000022,122.326625,126.80243980000002,129.73807550000012,126.91485926583987,129.8115055148362,130.33030923076927,133.1302148862076,127.53040357533095,116.21028540000022,122.326625,126.80243980000002,129.73807550000012,132.16966666666667,146436624,143156482.4,69.45200501345667,1.197517662876863,1.5,2.75,NaN,NaN,1.1575595697071894,1.0229129798735541,387.1122489616039,0.16205564697126906,1.5095102434200385,1.3474545964487694,15.601432186181361,1.7532039577502863,72.8910994587809,6.086043732434627,21.022856808784475,6068819293
1297348200,131.60001,132.47,131.3,132.321,NaN,NaN,131.1193205172414,132.56970215384615,116.2749904000002,122.5077349,127.07901000000001,129.92512550000012,127.12686478482654,130.0505049896137,130.57807769230774,133.4672850237077,127.68887036090779,116.2749904000002,122.5077349,127.07901000000001,129.92512550000012,132.03033333333335,162708496,145895451.2,69.64564049924,1.0204394320172219,1.5,2.75,NaN,NaN,1.1584481718709607,1.1152403632992776,388.43424122761826,0.14317769505158884,1.5264267152632556,1.3832490202116667,15.623323136113802,3.6024115252113993,73.77880540649228,5.718789461923332,20.502405131584382,6231527789
1297434600,131.8,133.28,131.77,133.11,NaN,NaN,131.34863103448276,132.72001,116.33625290000022,122.6990349,127.32101020000002,130.16225100000014,127.36149753836276,130.34188546679334,130.88115461538467,133.93771182747594,127.82459740329341,116.33625290000022,122.6990349,127.32101020000002,130.16225100000014,132.72,137716432,146319816.8,72.49455405820643,1.4400137764000558,1.5,2.75,NaN,NaN,1.18355901673732,0.9412015064797429,392.3919119939576,0.1615810686243644,1.5852253559921223,1.423644287367758,9.636903898006375,3.4426564689661614,74.01330748051483,5.623511077270365,20.363181442214817,6369244221
1297693800,133.03,133.53999,132.88,133.42999,NaN,NaN,131.57794155172414,132.87031784615385,116.40934035000022,122.89913480000001,127.53841,130.36875050000012,127.59947763489755,130.63599066043207,131.17038461538465,134.41930992304393,127.92145930772537,116.40934035000022,122.89913480000001,127.53841,130.36875050000012,133.28332666666665,101691120,145520479.2,73.57766628587032,1.4036870871866272,1.5,2.75,NaN,NaN,1.146161229827511,0.6988096834139618,394.05660008506595,0.17208752105668124,1.6387536886886096,1.4666661676319284,9.429375669780233,2.0575032845721757,73.90238917230884,5.680608195529927,20.41700263216123,6470935341
1297780200,133.02,133.22,132.3167,133.00999,NaN,NaN,131.8072520689655,133.0206256923077,116.47264025000023,123.10425470000001,127.7408098,130.5432500000001,127.81165459039177,130.86208583562902,131.40269076923082,134.71210529695028,128.09327624151135,116.47264025000023,123.10425470000001,127.7408098,130.5432500000001,132.84889666666666,119575376,145779185.6,69.69818378771348,0.9290212424427174,1.5,2.75,NaN,NaN,1.1438132848398321,0.8202499932198826,391.79295532688485,0.12947691539070516,1.6285123118703098,1.4990353964796046,6.133266337994111,1.9350806606123108,49.44435977045859,19.563682570743445,30.99195765879796,6351359965
1297866600,133.46001,134.00999,133.19,133.85001,NaN,NaN,132.0365625862069,133.17093353846155,116.55429030000022,123.29455470000002,127.9626102,130.82325050000014,128.04845284174894,131.14665004175959,131.87423000000007,134.6550074006251,129.09345259937504,116.55429030000022,123.29455470000002,127.9626102,130.82325050000014,133.6833333333333,130183440,144690441.6,72.78851514061617,1.327439939730761,1.5,2.75,NaN,NaN,1.1335409073512728,0.8997376644954549,395.6209895683522,0.1359237137997249,1.6689400387292608,1.5330163249295359,6.1518117607470115,2.347461385532953,79.43696303740246,3.6335685383610548,16.929468424236482,6481543405
1297953000,133.46001,134.42999,133.34,134.25,NaN,NaN,132.26587310344829,133.32124138461538,116.64144025000022,123.49435470000002,128.1910102,131.13175050000012,128.2916507695235,131.44220718063963,132.30269230769235,134.66820894797786,129.93717566740685,116.64144025000022,123.49435470000002,128.1910102,131.13175050000012,134.00666333333334,109810432,141393681.6,74.14088131216494,1.4540984805767785,1.5,2.75,NaN,NaN,1.1304301282547533,0.7766289890566086,398.3568895144122,0.1443893066096833,1.71350295819164,1.5691136515819566,6.1534746129289095,2.363713485605296,77.4206703936998,4.3314765520031235,18.247853054297092,6591353837
1298039400,134.37,134.69,134.06,134.53,NaN,NaN,132.49518362068966,134.69,116.74938025000021,123.69295470000003,128.4160102,131.43975050000014,128.5362919158167,131.73628268724536,132.59423000000004,135.04998761728527,130.1384723827148,116.74938025000021,123.69295470000003,128.4160102,131.43975050000014,134.42666666666668,130002320,140320653.6,75.07472792196018,1.3258118720009169,1.5,2.75,NaN,NaN,1.0946851190936993,0.9264660380686824,400.2792090768159,0.1456898863575713,1.7512260095289207,1.6055361231713494,6.159073815436895,1.9398348109418824,77.1435334044729,4.431723802445503,18.424742793081595,6721356157
1298385000,133.12,134.56149,131.47,131.83,NaN,NaN,132.72449413793103,134.85771428571428,116.85223030000023,123.86655470000004,128.57741040000002,131.57625000000013,128.66545693872584,131.74520814560296,132.69769153846158,134.88829829135958,130.5070847855636,116.85223030000023,123.86655470000004,128.57741040000002,131.57625000000013,132.62049666666667,233116368,146290700,54.599082922011114,0.599814730330706,1.5,2.75,NaN,NaN,1.2373140391584345,1.5935146116602081,393.8532380647216,-0.04807729870964428,1.545439499784294,1.5935167984939382,14.04897245040451,-0.5582031712903875,36.16202919533805,30.596533910593966,33.24143689406797,6488239789
1298471400,131.75,132.07001,130.21001,131.02,NaN,NaN,132.9538046551724,135.02542857142856,116.92653030000024,124.03545470000005,128.7082104,131.66875000000013,128.7577919607366,131.67614070316458,132.71615307692312,134.8449765596032,130.58732959424304,116.92653030000024,124.03545470000005,128.7082104,131.66875000000013,131.10000666666667,227610128,149293600,50.17767769797372,0.9247621288980999,1.5,2.75,NaN,NaN,1.2817916077899738,1.5245806116270222,390.7321522808015,-0.23322662114187653,1.3019835220665925,1.535210143208469,14.096806222568175,-0.9442877771813465,27.624694770096035,39.40399806589964,32.97130716400431,6260629661
1298557800,130.88,131.44,129.7,130.92999,NaN,NaN,133.1831151724138,135.19314285714285,117.00203025000023,124.19865460000004,128.83561020000002,131.73174950000015,128.84297619757047,131.60507873143462,132.69923000000003,134.88043850717474,130.5180214928253,117.00203025000023,124.19865460000004,128.83561020000002,131.73174950000015,130.68999666666664,260467056,155252880.8,49.69607656352042,1.0877998213317075,1.5,2.75,NaN,NaN,1.3145207786621191,1.6776954775836919,391.3062860889243,-0.35678895038501723,1.0892239552271974,1.4460129056122146,14.081053748457022,-1.0512390323531369,8.232244002385778,68.10497367604228,23.662782321571953,6000162605
1298644200,131.48,132.41,131.39999,132.33,NaN,NaN,133.41242568965518,135.36085714285713,117.07643025000023,124.38445460000004,128.98881020000002,131.84874900000014,128.9797222290383,131.67411885225036,132.72692230769232,134.87934594789633,130.5744986674883,117.07643025000023,124.38445460000004,128.98881020000002,131.84874900000014,132.04666333333333,141693808,156172440,56.663273772301736,0.17097305825318357,1.5,2.75,NaN,NaN,1.3263414373291103,0.9072907358046016,396.77190735946766,-0.3393696143290814,1.0218008877008629,1.3611705020299443,15.597730354986945,-0.5859815190444002,9.900429127181047,64.78934206979059,25.310228803028355,6141856413
1298903400,132.82001,133.32001,132.38,133.14999,NaN,NaN,133.64173620689655,135.52857142857144,117.16223015000023,124.55555460000005,129.1698498,132.12024850000014,129.14326214162503,131.8146780091789,132.7715361538462,134.93312418289858,130.60994812479382,117.16223015000023,124.55555460000005,129.1698498,132.12024850000014,132.95000000000002,141600752,148470615.2,60.145048223722455,0.496708014307087,1.5,2.75,NaN,NaN,1.3023177632341727,0.953729138989922,398.41309793143256,-0.2707408814816019,1.0227444001779418,1.2934852816595437,15.630554489781677,-0.2098478760284709,10.918500673406987,62.95222562013672,26.129273706456296,6283457165
1298989800,133.57001,133.69,130.89,130.92999,NaN,NaN,133.87104672413793,135.69628571428572,117.24743010000024,124.70455450000004,129.2920494,132.23274850000013,129.21332990077698,131.7304220083047,132.66853538461544,135.03407872533677,130.3029920438941,117.24743010000024,124.70455450000004,129.2920494,132.23274850000013,131.83666333333335,258582256,153937272,48.730164053550716,0.6441959924896808,1.5,2.75,NaN,NaN,1.409295065860304,1.679789778267605,393.61420099935475,-0.3670007089904641,0.8347343954214637,1.2017351044119278,18.230155665696348,-1.563792313645001,10.389966366351219,63.924872368500104,25.685161265148675,6024874909
1299076200,130.75,131.82001,130.35001,131.21001,NaN,NaN,134.1003572413793,135.864,117.33373015000024,124.85775460000006,129.4302496,132.25624850000014,129.29163108113866,131.68085895989475,132.58307461538467,135.06983364974386,130.0963155810255,117.33373015000024,124.85775460000006,129.4302496,132.25624850000014,131.12667666666667,200277808,155591452.8,50.01870983678444,0.6413406460296203,1.5,2.75,NaN,NaN,1.413631132584568,1.2872031489894282,396.42175383789163,-0.4011814877387141,0.700258244738535,1.1014397324772491,18.348253890005495,-1.9723569688190434,32.88182067487374,33.861888618691545,33.25629070643471,6225152717
1299162600,132.39999,133.62,132.39,133.47,NaN,NaN,134.3296677586207,136.0317142857143,117.43908020000022,125.02707950000006,129.60764939999999,132.40549850000014,129.45548868579988,131.85125334466667,132.610766923077,135.12820891873434,130.09332492741964,117.43908020000022,125.02707950000006,129.60764939999999,132.40549850000014,133.16,176485184,158499530.4,58.97941055701148,0.9260857235297338,1.5,2.75,NaN,NaN,1.4847996231142413,1.1134744914045498,400.8109799795308,-0.2673890749015324,0.7672033888503336,1.034592463751866,20.859588876632294,-0.5810055865921796,66.46513710477764,9.067647193657667,24.467215701564697,6401637901
1299249000,133.37,133.63,131.60001,132.47,NaN,NaN,134.55897827586207,136.19942857142857,117.54263025000024,125.18527960000004,129.7492494,132.48999850000013,129.5737048157685,131.91018159755555,132.5369215384616,135.00983443941317,130.06400863751003,117.54263025000024,125.18527960000004,129.7492494,132.48999850000013,132.56667000000002,277371392,165073768.8,54.33734676309887,0.416723276200593,1.5,2.75,NaN,NaN,1.5237417928917953,1.6802875103436785,397.8109799795308,-0.2427634512024971,0.7311381497487446,0.9739016009512417,21.126020986691895,-1.5312569687058666,34.030863211696236,32.7147686360974,33.25436815220637,6124266509
1299508200,132.86,133.15939,130.735,131.42999,NaN,NaN,134.78828879310345,136.36714285714285,117.66208025000023,125.32947960000006,129.86224919999998,132.50399850000014,129.64650031318936,131.86444906445502,132.41538307692315,134.93815274495063,129.89261340889567,117.66208025000023,125.32947960000006,129.86224919999998,132.50399850000014,131.77479333333335,216888944,169186481.6,49.93543146202855,0.5334930952891033,1.5,2.75,NaN,NaN,1.5880738076852376,1.281951973638064,393.6613076768327,-0.2898524096273756,0.6115860889170222,0.9014384985443977,21.30879916918556,-0.30342865812031317,15.666442517337241,55.10451176090613,29.22904572175664,5907377565
1299594600,131.64,133,131.07001,132.58,NaN,NaN,135.01759931034482,136.53485714285713,117.77940520000024,125.47607960000005,130.001849,132.53449850000013,129.7615395165937,131.93259677260215,132.31769000000006,134.70541922260628,129.92996077739383,117.77940520000024,125.47607960000005,130.001849,132.53449850000013,132.21667000000002,174706432,172299852.8,54.34022729924913,0.40127038203078,1.5,2.75,NaN,NaN,1.6124963928505782,1.0139673897620416,398.0315211077876,-0.23899960538713305,0.6026889918104814,0.8416885971976145,18.719037667674336,1.190657914822166,39.22845528733353,27.87530393714999,32.89624077551649,6082083997
1299681000,132.32001,132.8,131.60001,132.39,NaN,NaN,135.24690982758622,136.70257142857142,117.90280515000023,125.62537950000004,130.1366492,132.52549800000014,129.8646163982959,131.9761589847353,132.17461307692312,134.2893488454472,130.05987730839905,117.90280515000023,125.62537950000004,130.1366492,132.52549800000014,132.26333666666667,153903440,175041390.4,53.502683479244176,0.13707936483960417,1.5,2.75,NaN,NaN,1.5830316505041093,0.8792402736764366,396.9256768302037,-0.214396169031145,0.5736933859086832,0.7880895549398282,18.28971370765975,1.1151073944174155,17.5227377115023,52.34808666322587,30.129175625271824,5928180557
1299767400,131,131.17999,129.81,129.9375,NaN,NaN,135.4762203448276,136.8702857142857,118.01340270000024,125.74775450000003,130.2187992,132.40892300000013,129.8674745787549,131.78200098618908,131.8213438461539,133.7721848777203,129.8705028145875,118.01340270000024,125.74775450000003,130.2187992,132.40892300000013,130.30916333333334,301665792,182802848.8,44.06223352884431,1.3139571197382345,1.5,2.75,NaN,NaN,1.6542436754681005,1.6502247857747827,391.9256768302037,-0.35143389286967985,0.34879718885272837,0.7002310817224082,21.535885541228385,-1.807980049875321,3.1364519418379935,81.00674035105156,15.856807707110438,5626514765
1299853800,129.52,131.31,129.49001,130.84,NaN,NaN,135.70553086206897,137.038,118.13175270000025,125.87335450000002,130.3171992,132.33487300000016,129.90561283056843,131.69228660655202,131.74519000000006,133.76481341361102,129.7255665863891,118.13175270000025,125.87335450000002,130.3171992,132.33487300000016,130.54667000000003,225758496,185955348.8,47.718108214975935,0.9077881273081715,1.5,2.75,NaN,NaN,1.6660826986489496,1.2140467991744048,394.88240949333664,-0.36769216944284244,0.2406158699188552,0.6083080393616976,20.914672151524666,-1.7348780874861494,19.79377664911327,49.17100867465778,31.03521467622896,5852273261
1300109400,129.99001,130.48,129.06,130.05,NaN,NaN,135.93484137931034,137.2057142857143,118.22820275000025,126.00655450000002,130.40379919999998,132.18187300000017,129.91127507250692,131.53587835830896,131.67057461538468,133.8566668478354,129.48448238293395,118.22820275000025,126.00655450000002,130.40379919999998,132.18187300000017,129.86333333333332,235607744,190849914.4,44.94881470839126,1.322034548035683,1.5,2.75,NaN,NaN,1.6742196487454533,1.2345184682985637,391.08438369037003,-0.41456929381408447,0.09009642209409208,0.5046657159081765,20.525762788598936,-0.672107284205851,17.327214660158837,52.51929492414974,30.153490415691415,5616665517
1300195800,126.59,129.33,126.5,128.56,NaN,NaN,136.16415189655174,137.37342857142858,118.32415775000027,126.1134545,130.4599992,131.93837350000015,129.85828389319292,131.25246137180335,131.48826769230774,134.2185475223919,128.7579878622236,118.32415775000027,126.1134545,130.4599992,131.93837350000015,128.13,359794688,203755092.8,40.20908261246863,2.290507084561825,1.5,2.75,NaN,NaN,1.8082039595493504,1.7658193621357177,386.29550769141855,-0.5219078198722188,-0.1477190589320969,0.3741887609401219,19.356308284698613,-2.019670602875504,3.6002658453445275,79.48998157476183,16.909752579893645,5256870829
1300282200,128.14999,128.57001,125.28,126.175,NaN,NaN,125.28,137.54114285714286,118.41738275000027,126.1939045,130.44249920000001,131.59662400000016,129.7138413875775,130.76889362210778,131.0148061538462,134.89116588004268,127.13844642764971,118.41738275000027,126.1939045,130.44249920000001,131.59662400000016,126.67500333333334,469160704,221234359.2,34.02445534406908,3.008250903266146,1.5,2.75,NaN,NaN,1.914047248152968,2.1206502719402187,381.3181395567125,-0.7174427938954353,-0.5226147314291723,0.19482806246626305,21.384231730903597,-5.465647711096128,2.3009668761394497,83.81753332816314,13.881499795697419,4787710125
1300368600,128,128.39,127.10001,127.85001,NaN,NaN,125.37378048780488,137.70885714285714,118.50498280000025,126.2889346,130.4598994,131.29662400000015,129.64074996061368,130.49090470571656,130.60711538461544,134.61215863138892,126.60207213784194,118.50498280000025,126.2889346,130.4598994,131.29662400000015,127.78000666666667,254521632,227451268.8,40.899765215721615,1.7890413850817972,1.5,2.75,NaN,NaN,1.935543873284898,1.1190161010875839,385.90694581293457,-0.6972717758821136,-0.6767616573863791,0.020510118495734614,20.066251319893663,-3.487574545180042,12.195360605615038,60.62534363121011,27.17929576317485,5042231757
1300455000,128.84,128.88,127.50999,127.75999,NaN,NaN,125.46756097560976,137.87657142857142,118.59023270000026,126.3795345,130.4622992,130.97212350000015,129.5669946680406,130.2308175908864,130.36326923076928,134.63698459181524,126.08955386972332,118.59023270000026,126.3795345,130.4622992,130.97212350000015,128.04999333333333,230654368,233493465.6,40.65456272659262,1.4549096387421974,1.5,2.75,NaN,NaN,1.8951485966216903,0.98784078349814,389.76375796806997,-0.6540086868223616,-0.7970007400322174,-0.1429920532098558,20.047476875762488,-2.7923611650582956,3.0350709591214686,81.2665732427665,15.698355798112031,4811577389
1300714200,129.35001,130.00999,129.2,129.74001,NaN,NaN,125.56134146341464,138.0442857142857,118.70483270000027,126.4897346,130.5092994,130.73262400000016,129.5737795830194,130.184074010802,130.25019230769237,134.50606060995057,125.99432400543418,118.70483270000027,126.4897346,130.5092994,130.73262400000016,129.64999999999998,154065312,234696615.2,48.03422846661609,0.03768565471909637,1.5,2.75,NaN,NaN,1.9204951254344258,0.6564445416850648,394.874852534915,-0.4649441227170739,-0.7241722066061982,-0.25922808388912427,22.52286867420658,-2.1420953386634483,9.773063001351424,65.01965059880132,25.207286399847252,4965642701
1300800600,129.72,129.89,129.17,129.28999,NaN,NaN,125.65512195121951,138.212,118.82383260000026,126.59883450000001,130.5522992,130.60562350000015,129.56265057976373,130.09892315263036,129.92865307692313,133.77477553852393,126.08253061532233,118.82383260000026,126.59883450000001,130.5522992,130.60562350000015,129.44999666666664,129743440,229527968.8,46.61541331491199,0.2142446630464021,1.5,2.75,NaN,NaN,1.8347454736176811,0.5652620056645575,392.7597439772929,-0.3484248696412827,-0.6947591709407277,-0.346334301299445,21.611333457585022,-2.3415741370194105,14.126561517033316,57.398807830250746,28.474630652715938,4835899261
1300887000,128.92999,130,128.32001,129.66,NaN,NaN,125.74890243902439,138.37971428571427,118.93903260000026,126.71143460000002,130.6058992,130.53762350000014,129.5664682040867,130.05712094761796,129.71249923076928,133.26788415858022,126.15711430295835,118.93903260000026,126.71143460000002,130.6058992,130.53762350000014,129.32667,148648752,225579900,47.97605755794038,0.2441750543688838,1.5,2.75,NaN,NaN,1.8236915112164185,0.6589627533304164,393.9943580241351,-0.23035721425032252,-0.6342808191123481,-0.4039236048620256,21.828434015783316,-0.21356421356421618,48.42592105233579,20.25562967478677,31.318449272877444,4984548013
1300973400,130.39999,131.09,129.67,130.89999,NaN,NaN,125.84268292682927,138.54742857142855,119.06328255000028,126.83553440000001,130.6752992,130.53612350000012,129.61876317647545,130.13739419070197,129.67173000000005,133.15890335578356,126.18455664421654,119.06328255000028,126.83553440000001,130.6752992,130.53612350000012,130.55333,159238320,220518463.2,52.35838277439625,0.7620413898065231,1.5,2.75,NaN,NaN,1.795570688986675,0.722108787124905,396.9617736599293,-0.061463230023040105,-0.4807526423908257,-0.4192894123677856,19.894427447499154,0.04584989299908216,42.20324176987817,25.19146779348154,32.605290436640274,5143786333
1301059800,131.24001,131.87,130.89211,131.3,NaN,NaN,125.93646341463415,138.71514285714287,119.17403260000026,126.9632344,130.72969920000003,130.48462350000014,129.68469403229994,130.24811855349225,129.57326846153853,132.78806246493514,126.35847445814191,119.17403260000026,126.9632344,130.72969920000003,130.48462350000014,131.35403666666667,155770000,221222272.8,53.7129428239684,1.0908754898946529,1.5,2.75,NaN,NaN,1.7371649254876267,0.70413344022022,400.0068889734646,0.07696853659235525,-0.3230787416273415,-0.40004727821969677,19.57646237839509,0.9611687812379853,79.8195947222074,3.4901244210573945,16.690280856735217,5299556333
1301319000,131.58,131.92,130.94,130.98,NaN,NaN,126.03024390243903,138.88285714285715,119.28053265000025,127.07828429999999,130.7819494,130.37612400000015,129.73549034475877,130.31782154839775,129.464806923077,132.37264317210511,126.55697067404887,119.28053265000025,127.07828429999999,130.7819494,130.37612400000015,131.28,109839056,219634188,52.428707152575406,0.8986140577555898,1.5,2.75,NaN,NaN,1.683081716524224,0.5000999935401678,397.9252229739985,0.14292557041683968,-0.22139031519864716,-0.36431588561548683,19.251496883115035,1.8823895457373891,57.651921963060836,14.008128698574557,28.3399493383646,5189717277
1301405400,130.87,131.89999,130.44,131.86,NaN,NaN,126.1240243902439,139.05057142857143,119.39228765000027,127.1973843,130.8331494,130.42262450000015,129.81880444888588,130.46469568664557,129.6126915384616,132.78515070709025,126.44023236983296,119.39228765000027,127.1973843,130.8331494,130.42262450000015,131.39999666666668,129844560,213197303.2,55.57440098786188,0.9942927780892046,1.5,2.75,NaN,NaN,1.6671465939153511,0.6090347206605754,401.3357330454348,0.23625470939029236,-0.06899749887762141,-0.30525220826791377,17.802413623633853,4.505646918961772,82.75290568562488,2.605049524993292,14.642044789381824,5319561837
1301491800,132.55,133.16,132.36,132.77,NaN,NaN,126.21780487804878,139.2182857142857,119.49613765000028,127.3024844,130.8981494,130.50062400000016,129.9345376077531,130.6842484783936,129.76115307692314,133.30799981153757,126.2143063423087,119.49613765000028,127.3024844,130.8981494,130.50062400000016,132.76333333333332,135895872,209978206.4,58.62152010895943,1.6143542147516172,1.5,2.75,NaN,NaN,1.6409218372071106,0.6471903647996872,405.36181082977794,0.34322374354366997,0.1237774711616737,-0.21944627238199627,11.614730062235315,3.848251556648304,82.48872471478406,2.6810126770950027,14.83026260812093,5455457709
1301578200,132.60001,132.96001,132.45,132.59,NaN,NaN,126.31158536585366,139.386,119.59928760000028,127.4011343,130.9849494,130.45662400000018,130.03867338784121,130.86574862330852,129.95653769230776,133.81192597615254,126.10114940846299,119.59928760000028,127.4011343,130.9849494,130.45662400000018,132.66666999999998,132756496,207791772,57.77735079551928,1.3224096046770777,1.5,2.75,NaN,NaN,1.560142420263747,0.6388919769161986,407.76319931702164,0.38279097631905945,0.2590424480168281,-0.12374852830223139,10.884192116650134,3.780534109309183,53.95848147443901,16.38732899952241,29.654189526038596,5322701213
1301664600,133.41,133.77,132.83,133.14999,NaN,NaN,126.40536585365854,139.55371428571428,119.70433755000029,127.5077341,131.0863492,130.49062350000017,130.16068580400432,131.08329542108865,130.30961384615392,134.4209589474933,126.19826874481456,119.70433755000029,127.5077341,131.0863492,130.49062350000017,133.24999666666668,154038944,201625149.6,59.72068293621819,1.4521793309807303,1.5,2.75,NaN,NaN,1.5329893902449085,0.7639867561442345,411.23176210801324,0.4243898610395278,0.4067387979971784,-0.017651063042349438,10.52676585102272,2.6283179722276806,53.99339537518952,16.36397111799135,29.642633506819134,5476740157
1301923800,133.42999,133.67,132.88,133.25999,NaN,NaN,126.49914634146342,139.72142857142856,119.81199250000029,127.624234,131.184149,130.58212350000016,130.28222714502377,131.29059966669925,130.85461307692316,134.4786201644877,127.23060598935862,119.81199250000029,127.624234,131.184149,130.58212350000016,133.26999666666666,100773312,195819368,60.10907713546357,1.2576346295006786,1.5,2.75,NaN,NaN,1.479918719513129,0.5146238241357208,412.5596773081017,0.43539688268373206,0.5265950403123156,0.09119815762858358,7.804066503735632,3.070616681152191,76.40777655779087,4.6880910139475915,18.904132428261537,5577513469
1302010200,133,133.83,132.94,133.24001,NaN,NaN,126.5929268292683,139.88914285714284,119.9211425500003,127.73563399999999,131.266949,130.61512400000018,130.39821862953264,131.47625779368028,131.26922846153855,134.64841092354555,127.89004599953152,119.9211425500003,127.73563399999999,131.266949,130.61512400000018,133.33667,121083808,193138236.8,59.995915347088804,1.1736887071135131,1.5,2.75,NaN,NaN,1.4377816681193352,0.6269282044103242,414.2289061079745,0.4173651334413754,0.6129045744303028,0.1955394409889274,7.043038336374513,2.7610751195434333,49.29430170064171,19.632893071567366,31.07280522779091,5456429661
1302096600,133.88,134,133.12,133.66,NaN,NaN,126.68670731707317,140.05685714285713,120.04159250000029,127.85588409999998,131.356749,130.67862400000018,130.52613162445292,131.6842332419012,131.72307538461547,134.64959463224932,128.79655613698162,120.04159250000029,127.85588409999998,131.356749,130.67862400000018,133.59333333333333,120453632,191465746.4,61.63110158051595,1.1241842608211203,1.5,2.75,NaN,NaN,1.3979401203965252,0.6291132187600528,416.2264774489123,0.40920429725959756,0.7070448125634243,0.29784051530382677,7.042717096392892,2.108487556034186,47.96989644268402,20.617975764726832,31.412127792589164,5576883293
1302183000,133.42,133.97749,132.66,133.32001,NaN,NaN,126.78048780487805,140.22457142857144,120.1620425500003,127.98710419999998,131.4297492,130.84774950000016,130.63569548231752,131.8400215045773,131.99846000000008,134.7977153059229,129.19920469407725,120.1620425500003,127.98710419999998,131.4297492,130.84774950000016,133.31916666666666,170973184,184931116,59.51045624625522,0.7896858484385141,1.5,2.75,NaN,NaN,1.392193683225344,0.9245236155931704,413.33395836225674,0.3582253551554845,0.7456222092481823,0.38739685409269786,6.352059253588175,1.538469154607757,42.957187083042406,24.58393196671509,32.4588809502425,5405910109
1302269400,133.91,133.99001,132.31,132.86,NaN,NaN,126.87426829268293,140.39228571428572,120.28924255000031,128.11540419999997,131.487149,130.94874950000016,130.72292311046192,131.93716231366517,132.27307615384623,134.61943224102296,129.9267200666695,120.28924255000031,128.11540419999997,131.487149,130.94874950000016,133.0533366666667,148014816,181043932,56.66925854818298,0.5285060729132477,1.5,2.75,NaN,NaN,1.4127519915663918,0.817562976924297,410.4094701029287,0.27460539011029955,0.7306535917305723,0.45604820162027276,6.9618790633079435,1.4353336387234876,15.036449686656404,55.983844899537594,28.979705413806006,5257895293
1302528600,133,133.45,132.14,132.46001,NaN,NaN,126.9680487804878,140.56,120.4122051500003,128.2584043,131.58194919999997,131.06925000000015,130.7910441649536,131.98695733141133,132.48846153846162,134.285570621384,130.69135245553923,120.4122051500003,128.2584043,131.58194919999997,131.06925000000015,132.68333666666666,121518496,175339469.6,54.24416900428565,0.23903340201660295,1.5,2.75,NaN,NaN,1.405412563597364,0.6930470148975516,407.1439354125358,0.1781146159417778,0.678691471547495,0.5005768556057172,7.077883161443439,0.455035643864703,3.917568214934978,78.57082895697101,17.511602828094016,5136376797
1302615000,131.72,131.98,130.99001,131.47,NaN,NaN,127.06182926829268,140.72771428571428,120.53190515000031,128.39092429999997,131.6377494,131.21475000000015,130.81766988397504,131.93772329984836,132.53230846153855,134.19504321756244,130.86957370551465,120.53190515000031,128.39092429999997,131.6377494,131.21475000000015,131.48000333333334,161480688,165423769.6,48.690274770300384,0.5907618121972846,1.5,2.75,NaN,NaN,1.4100259519118379,0.9761637544015924,403.42503924845096,0.04055521654476979,0.5512708762866794,0.5107156597419096,7.652532122722517,-0.9791368532047987,3.4889837849514915,79.85095891246193,16.660057302586576,4974896109
1302701400,132.08,132.17999,130.96001,131.46001,NaN,NaN,127.15560975609756,140.89542857142857,120.66815515000032,128.50594939999996,131.65214939999998,131.47900050000013,130.8428596924466,131.8922267951009,132.54461692307703,134.17268824009633,130.91654560605772,120.66815515000032,128.50594939999996,131.65214939999998,131.47900050000013,131.53333666666666,162172944,150074381.6,48.63616017500503,0.46806391426577026,1.5,2.75,NaN,NaN,1.396451241060992,1.080617106470889,404.5420833884112,-0.05308395713881653,0.4443607133183889,0.4974446704572054,6.166860732043915,-0.8522437589561749,0,100,0,4812723165
1302787800,130.7,131.75999,130.27,131.56,NaN,NaN,127.24939024390244,141.06314285714285,120.80985515000032,128.61864949999998,131.6736494,131.66450000000012,130.87098284176244,131.86058614794842,132.58923230769238,134.06832455938826,131.1101400559965,120.80985515000032,128.61864949999998,131.6736494,131.66450000000012,131.19666333333333,161271248,145411862.4,49.24420222060033,0.6458379781982098,1.5,2.75,NaN,NaN,1.4031325809852053,1.109065280770381,405.7538871961575,-0.10714640826274102,0.3635116601287791,0.47065806839152013,6.240045168146507,-1.19413452453132,5.796395057875557,73.58910948422437,20.61449545790008,4973994413
1302874200,131.8,132.37,131.41,132.03999,NaN,NaN,127.34317073170732,141.23085714285713,120.95625515000033,128.73714939999996,131.6988492,131.8785000000001,130.91682625973255,131.8776722290962,132.60307769230778,134.05777464330674,131.1483807413088,120.95625515000033,128.73714939999996,131.6988492,131.8785000000001,131.93999666666664,170146624,142386475.2,52.171222385622286,0.09997165832593599,1.5,2.75,NaN,NaN,1.371480253771977,1.1949633823086592,408.96455865473956,-0.1090739728043032,0.3343156023861411,0.4433895751904443,6.0792809251310205,-0.9155035956403711,25.168385202766082,42.27406957828583,32.557545218948086,5144141037
1303133400,130.59,132.03011,129.50999,130.56,NaN,NaN,129.50999,141.39857142857142,121.09805515000033,128.85827449999996,131.6870494,131.9194995000001,130.90283307307638,131.75217963584893,132.4330776923078,134.24314091793732,130.62301446667826,121.09805515000033,128.85827449999996,131.6870494,131.9194995000001,130.70003333333332,210908192,145228619.2,43.786453414926925,1.082815097009218,1.5,2.75,NaN,NaN,1.454231664216836,1.4522495163955949,403.9762606601209,-0.20305609742010222,0.1895694534153165,0.3926255508354187,8.387453550173216,-2.0114153398817742,19.78733217686119,49.06898068796957,31.14368713516925,4933232845
1303219800,130.75999,131.35001,130.44,131.31,NaN,NaN,129.69390260869565,141.5662857142857,121.24025515000034,128.96937449999993,131.67384940000002,132.02050000000008,130.91880040354397,131.7100672895776,132.33461615384624,134.2367378021118,130.43249450558068,121.24025515000034,128.96937449999993,131.67384940000002,132.02050000000008,131.03333666666666,124321872,144957540.8,48.31934434164799,0.5522328224303706,1.5,2.75,NaN,NaN,1.4153586882013478,0.8576433575920598,407.21170268654987,-0.2070339805700086,0.13383307512290799,0.3408670556929166,9.478348404146871,-1.758192428550048,41.029954924504246,26.200138609620062,32.7699064658757,5057554717
1303306200,132.88,133.39,132.78999,133.10001,NaN,NaN,129.8778152173913,141.73399999999998,121.37521770000033,129.11237459999995,131.6844494,132.1925005000001,131.00433803477753,131.84244278580832,132.33077153846165,134.22647664879224,130.43506642813105,121.37521770000033,129.11237459999995,131.6844494,132.1925005000001,133.09333333333333,156473008,145348753.6,57.19173720458532,0.8589117974986855,1.5,2.75,NaN,NaN,1.462833067615536,1.076534914297332,411.8104999391163,-0.08754754076576765,0.231432629735707,0.31898017050147465,12.659622799277345,-0.16501648927268972,69.15782437280517,7.7312272366093655,23.110948390585477,5214027725
1303392600,133.78999,133.84,133.1046,133.78,NaN,NaN,130.06172782608695,141.9017142857143,121.50831770000033,129.25855459999994,131.7146694,132.3365010000001,131.11318752360978,132.02697204430277,132.3707723076924,134.36272020992018,130.3788244054646,121.50831770000033,129.25855459999994,131.7146694,132.3365010000001,133.57486666666668,136214496,144197562.4,60.00100765997318,1.1049497636097174,1.5,2.75,NaN,NaN,1.4112014199287124,0.9446379934089648,414.5563481759427,0.032420923511768784,0.3595063248911856,0.32708540137941683,12.945538037437059,0.6924582267047925,68.13905151386797,8.2145987918492,23.64634969428282,5350242221
1303738200,133.67999,133.86,133.2,133.64,NaN,NaN,130.2456404347826,142.06942857142857,121.63671765000034,129.41002969999994,131.7410494,132.4535010000001,131.21227820895842,132.18059375436917,132.40154076923088,134.45757063575152,130.34551090271023,121.63671765000034,129.41002969999994,131.7410494,132.4535010000001,133.56666666666666,65231072,139670616,59.1404875162679,0.886622894034581,1.5,2.75,NaN,NaN,1.357544175648092,0.46703504193036566,412.99633909949983,0.09399882625829459,0.44458393420228504,0.35058510794399045,12.759659715335406,0.8908273523457949,48.63796420928591,20.105902348177917,31.256133442536168,5285011149
1303824600,134.05,135.06,133.91,134.791,NaN,NaN,130.42955304347825,142.23714285714286,121.77052265000034,129.54783979999993,131.77466940000002,132.6440510000001,131.35262023997967,132.4292038730007,132.48854076923087,134.82658662777175,130.15049491068999,121.77052265000034,129.54783979999993,131.77466940000002,132.6440510000001,134.58700000000002,146658432,141511584.8,63.744235443151425,1.508068174433797,1.5,2.75,NaN,NaN,1.3620053059589436,1.036370500742212,416.71062481378556,0.19792500248525602,0.5979913610505605,0.4000663585653045,13.284486758751903,2.5260515707005387,88.74272687995744,1.1518689239178181,10.105404196124734,5431669581
1303911000,135.05,135.87,134.5,135.67,NaN,NaN,130.6134656521739,142.40485714285714,121.90057265000034,129.67893979999994,131.81946960000002,132.8345510000001,131.52192925017656,132.7378511231911,132.66930923076933,135.53939513661186,129.7992233249268,121.90057265000034,129.67893979999994,131.81946960000002,132.8345510000001,135.34666666666666,143104816,142174597.6,66.8189623858625,1.6119839909295088,1.5,2.75,NaN,NaN,1.362576355533305,1.0065427890474297,419.4933146692776,0.30513675854447786,0.7814873067459018,0.476350548201424,12.098302915638682,3.202487205044314,89.17826064252485,1.0678799615816874,9.753859395893453,5574774397
1303997400,135.42999,136.28999,135.41,136.11,NaN,NaN,130.79737826086955,142.57257142857142,122.03286765000034,129.81113979999995,131.88146980000002,133.00155100000012,131.70185359330688,133.05900815907765,132.91930923076933,136.32794160246618,129.51067685907248,122.03286765000034,129.81113979999995,131.88146980000002,133.00155100000012,135.9366633333333,124865744,141623091.2,68.26958269716746,1.7410677091330695,1.5,2.75,NaN,NaN,1.3281059015666397,0.8816764479717839,421.9774988756462,0.38007621216718224,0.9514458134104018,0.5713696012432196,11.92414479925946,3.4584980237154235,88.63312120933462,1.173468464861111,10.19341032580427,5699640141
1304083800,136.16,136.57001,135.98,136.42999,NaN,NaN,130.9812908695652,142.7402857142857,122.16661765000033,129.94783979999994,131.93306940000002,133.1935505000001,131.88727070729485,133.3800540486893,133.2246923076924,137.09420138288658,129.35518323249823,122.16661765000033,129.94783979999994,131.93306940000002,133.1935505000001,136.32666666666668,115094368,140739984.8,69.32006008701113,1.764554788896401,1.5,2.75,NaN,NaN,1.2753847657404516,0.8177801650579686,424.96580943514294,0.42233453344679206,1.0992877680517097,0.6769532346049176,11.82647577484325,3.3247503275333594,88.24382478089595,1.2516827742529697,10.504492444851088,5814734509
1304343000,137.07001,137.17999,135.95,136.22,NaN,NaN,131.16520347826085,137.17999,122.31441765000034,130.08173979999995,131.97246940000002,133.3470510000001,132.05718165994995,133.65052509167126,133.59007692307702,137.62148907205912,129.55866477409492,122.31441765000034,130.08173979999995,131.97246940000002,133.3470510000001,136.4499966666667,126310064,139353540.8,67.73526666155396,1.5678020252190918,1.5,2.75,NaN,NaN,1.2721422824732775,0.906400104904977,422.83782872874724,0.40710903178112845,1.1858395243313282,0.7787304925501998,12.192664483841567,4.335171568627448,77.54741722267727,4.268917232572011,18.18366554475072,5688424445
1304429400,135.96001,136.19,135.045,135.73,NaN,NaN,131.3491160869565,137.230806122449,122.45661770000034,130.20623979999993,131.99646940000002,133.4705515000001,132.2012137517166,133.8485703210359,133.9185376923078,137.89769431736664,129.93938106724897,122.45661770000034,130.20623979999993,131.99646940000002,133.4705515000001,135.655,138445808,141237165.6,64.05524338298935,0.8387428310954046,1.5,2.75,NaN,NaN,1.2652035480109014,0.9802363805012525,419.7924207422992,0.3378544616176522,1.201048569572265,0.8631941079546128,9.350528230512875,3.3660802680679214,46.83638565228047,21.471056465010157,31.69255788270937,5549978637
1304515800,135.67,135.73,134.23,134.83,NaN,NaN,131.53302869565215,137.28162224489796,122.58836770000035,130.31693989999994,132.05646940000003,133.5500510000001,132.30430340851203,133.94203981427057,134.17007615384625,137.92834977245406,130.41180253523845,122.58836770000035,130.31693989999994,132.05646940000003,133.5500510000001,134.92999999999998,182821184,144324034.4,57.83952213186427,0.27341878851405765,1.5,2.75,NaN,NaN,1.28197472315298,1.2667410855028038,418.093124396995,0.21143067621827605,1.1274824532274579,0.9160517770091818,11.005269286736684,1.2997669947583137,16.33404900178848,53.98797149712786,29.67797950108366,5367157453
1304602200,134.08,134.95,133.02,133.61,NaN,NaN,131.7169413043478,137.33243836734695,122.72106765000035,130.40823989999993,132.1082694,133.5475510000001,132.35550719641353,133.91041697481623,134.29084615384627,137.86390022748125,130.7177920802113,122.72106765000035,130.40823989999993,132.1082694,133.5475510000001,133.86,227065680,149654636.8,50.66277241467419,0.42320364009097367,1.5,2.75,NaN,NaN,1.3282622429277655,1.517264582342697,415.11966455791287,0.03489813229603411,0.9596744423792245,0.9247763100831904,10.457867258989143,-0.12707430109133463,2.568445086762577,82.85257781859598,14.578977094641452,5140091773
1304688600,134.94,135.63,133.22,134.2,NaN,NaN,131.90085391304345,137.38325448979592,122.84476265000036,130.50463989999994,132.1736696,133.5915505000001,132.42784024753456,133.93799631054802,134.57084615384628,137.42966059841936,131.7120317092732,122.84476265000036,130.50463989999994,132.1736696,133.5915505000001,134.35,222951248,152253540,53.65751363164736,0.13099656707972113,1.5,2.75,NaN,NaN,1.4055292255757819,1.464341965382217,418.3976056737939,-0.04835705143446034,0.8643299957901149,0.9126870472245753,10.351328404527724,0.4190362167015881,7.773913752411111,69.0682497703675,23.157836477221398,5363043021
1304947800,134.19,135.11,133.98,134.72,NaN,NaN,132.0847665217391,137.4340706122449,122.96631265000036,130.60513989999993,132.2214696,133.68455050000009,132.51772886527831,134.01247285240058,134.83315384615398,136.98552821254555,132.6807794797624,122.96631265000036,130.60513989999993,132.2214696,133.68455050000009,134.60333333333335,114134432,150559520.8,56.18200052138678,0.30263484383165035,1.5,2.75,NaN,NaN,1.3858485666060847,0.7580685126622693,421.81755866051355,-0.07314043954110816,0.82126149779819,0.8944019373392982,10.497753770561518,-0.05267413996483293,19.07797519573968,50.02929482753261,30.892729976727722,5477177453
1305034200,135.17,136.11,135,135.87,NaN,NaN,132.26867913043475,137.48488673469387,123.08786265000035,130.72285979999995,132.2758698,133.85505000000006,132.64919047840465,134.189380199791,135.04623000000012,137.01032060049127,133.08213939950897,123.08786265000035,130.72285979999995,132.2758698,133.85505000000006,135.66,114887008,150227946.4,61.2140756340849,0.8716935367327783,1.5,2.75,NaN,NaN,1.386145097562794,0.7647512380559307,426.2956376559492,-0.019603822718865294,0.8698971589407165,0.8895009816595818,10.4773387616091,0.14741652539250907,36.99268353441065,29.804408088851446,33.20290837673791,5592064461
1305120600,135.67,135.69,133.82001,134.44,NaN,NaN,132.4525917391304,137.53570285714287,123.20231265000035,130.81905969999997,132.34607000000003,134.00355000000008,132.71941830278092,134.21324875219187,135.09699923076937,136.95901115671856,133.23498730482018,123.20231265000035,130.81905969999997,132.34607000000003,134.00355000000008,134.65000333333333,193745632,151841193.6,53.054954251913074,0.28389175891856205,1.5,2.75,NaN,NaN,1.4335625905940237,1.275975428054064,421.27530861257924,-0.08438911360888268,0.7840145896484785,0.8684037032573612,11.597714909137972,-1.226948791418717,36.13349255656058,30.610597680299545,33.2559097631399,5398318829
1305207000,134.08,135.36,133.39,135.08,NaN,NaN,132.63650434782608,137.58651897959183,123.32356265000035,130.92685969999997,132.42346980000002,134.1845495000001,132.8119901340444,134.29579649007837,135.2077684615386,136.8705716427666,133.54496528031058,123.32356265000035,130.92685969999997,132.42346980000002,134.1845495000001,134.61,171648128,152314952.8,55.88875943362562,0.3054593620445733,1.5,2.75,NaN,NaN,1.4718795484087381,1.1269289379972154,424.413670457315,-0.08764522801292618,0.7588471682412035,0.8464923962541296,11.825151517121485,-0.9895111771246125,71.2877330640692,6.760398168996507,21.951868766934304,5569966957
1305293400,135.14999,135.34,133.56,134.03999,NaN,NaN,132.8204169565217,137.63733510204082,123.44231265000035,131.02125949999996,132.4348696,134.3085490000001,132.86014699153287,134.27143396721377,135.1499984615386,136.9157056940347,133.38429122904247,123.44231265000035,131.02125949999996,132.4348696,134.3085490000001,134.31332999999998,157499056,152126343.2,50.54885181902825,0.3890086696077603,1.5,2.75,NaN,NaN,1.4938881520938285,1.035317438695917,420.85602197199523,-0.1591799079031333,0.647517511375213,0.8066974192783463,12.260960824185307,-1.600359712230223,38.248391497934385,28.65010816637285,33.10150033569276,5412467901
1305552600,133.56,134.61,132.97,133.19,NaN,NaN,133.00432956521738,137.68815122448981,123.55691265000034,131.09925949999996,132.4492696,134.3660495000001,132.8730824036296,134.16844025605056,134.95922923076935,136.97689591646463,132.94156254507408,123.55691265000034,131.09925949999996,132.4492696,134.3660495000001,133.59,141770624,150707543.2,46.62769505117755,0.6744514716686234,1.5,2.75,NaN,NaN,1.5043247126585562,0.9407002528855504,417.6513379002028,-0.2572708680516109,0.48510883421383255,0.7423797022654435,12.53665821213279,-1.8713622633168734,18.257542766396192,51.185144394543144,30.557312839060653,5270697277
1305639000,132.69,133.35001,132.12,133.17,NaN,NaN,133.188242173913,137.73896734693878,123.65896270000034,131.17315949999997,132.48406980000001,134.4965495000001,132.88472623093824,134.07335070785527,134.73307538461552,136.84114463224387,132.62500613698717,123.65896270000034,131.17315949999997,132.48406980000001,134.4965495000001,132.88000333333332,192852320,149804749.6,46.536221636331504,1.0029151242045082,1.5,2.75,NaN,NaN,1.484730804611516,1.2873578475645342,415.1731502274439,-0.3133103048258745,0.3507418212331004,0.6640521260589749,12.55674042705173,-1.2311800044500667,4.992467286695949,75.58929584226983,19.418236871034207,5077844957
1305725400,133.24001,134.5,132.95,134.36,NaN,NaN,133.37215478260867,137.78978346938777,123.76966270000034,131.26075939999998,132.5196698,134.6490495000001,132.9425801042348,134.10065064044048,134.5738453846155,136.44450288889692,132.7031878803341,123.76966270000034,131.26075939999998,132.5196698,134.6490495000001,133.93666666666667,135228128,150350062.4,52.50640461488339,0.22294536626038886,1.5,2.75,NaN,NaN,1.4893928899964084,0.8994218282412897,419.79971086047783,-0.26212151076585877,0.3364002376016515,0.5985217483675103,13.534855724794431,0.561335229398997,19.994250935454694,48.78639224347739,31.219356821067926,5213073085
1305811800,134.8,135.03,133.94,134.67999,NaN,NaN,133.5560673913043,137.84059959183674,123.87821265000034,131.35105939999997,132.5654696,134.7280485000001,133.01071382563734,134.1558258175414,134.4553830769232,136.0718299775016,132.8389361763448,123.87821265000034,131.35105939999997,132.5654696,134.7280485000001,134.54999666666666,119584880,148505656,53.99410543476625,0.188540226489269,1.5,2.75,NaN,NaN,1.4608648264252366,0.805254717032461,422.23570468930126,-0.20133211789827232,0.34685660099466986,0.5481887188929422,12.378359217202004,0.35766766020865504,15.537003637036346,55.191668395945875,29.271327967017793,5332657965
1305898200,134.33,134.6781,133.36,133.61,NaN,NaN,133.73997999999997,137.89141571428573,123.98201260000035,131.4288594,132.63891959999998,134.71954850000012,133.0342152442398,134.10384240634698,134.29230615384628,135.784462885352,132.80014942234055,123.98201260000035,131.4288594,132.63891959999998,134.71954850000012,133.8827,182638320,150826847.2,48.52094928095026,0.23830273897786977,1.5,2.75,NaN,NaN,1.4508023388234332,1.210913861759752,419.28348580678676,-0.22595833584772224,0.2657407990832894,0.49169913493101164,13.075695146733532,-0.8239311163895378,14.502002539581554,56.807458899847056,28.690538560571405,5150019645
1306157400,131.98,133.64751,131.59,132.06,NaN,NaN,133.92389260869564,137.9422318367347,124.08035260000035,131.49025939999999,132.6633196,134.6405485000001,132.99601072485783,133.90919074859966,134.07922923076936,135.94718418635392,132.2112742751848,124.08035260000035,131.49025939999999,132.6633196,134.6405485000001,132.43250333333336,168800000,156005293.6,41.89576086839678,1.3424184113391462,1.5,2.75,NaN,NaN,1.4941386003360457,1.082014565690353,414.710011562116,-0.33294856889919006,0.07551342380702408,0.40846199270621414,14.191755607296804,-2.804151026716716,13.030935865230557,59.19840506021713,27.77065907455232,4981219645
1306243800,132.44,132.73,131.7,131.95,NaN,NaN,134.10780521739127,137.99304795918368,124.17514260000036,131.55255939999998,132.70131959999998,134.4984985000001,132.95499069643202,133.72260115349494,133.95153692307707,136.13127246756315,131.771801378591,124.17514260000036,131.55255939999998,132.70131959999998,134.4984985000001,132.12666666666664,147200320,156032388,41.46307163674705,1.1328968721027335,1.5,2.75,NaN,NaN,1.4609858431691853,0.9433959313626604,413.2169081503708,-0.39329807311640297,-0.0831605986892896,0.31013747442711337,12.590528253762288,-1.8521273430526697,14.841236132578956,56.26534620542401,28.89341766199704,4834019325
1306330200,131.42,132.94,131.38,132.39,NaN,NaN,134.29171782608694,138.04386408163265,124.27521760000036,131.6189594,132.7779196,134.33449850000008,132.93283419853273,133.595686757924,133.81230615384627,136.1371690190839,131.48744328860863,124.27521760000036,131.6189594,132.7779196,134.33449850000008,132.23666666666665,151102192,156432256.8,43.956384757876066,0.9104431312375689,1.5,2.75,NaN,NaN,1.468058282942815,0.9659273291261499,416.38402233285586,-0.3852543303830811,-0.171430438551738,0.2138238918313431,12.015406236496236,-1.991412496298509,15.965537986458106,54.53186033449747,29.502601679044425,4985121517
1306416600,132.03,133.24001,131.78,133,NaN,NaN,134.47563043478257,138.09468020408164,124.39371760000036,131.67845939999998,132.91441959999997,134.1789985000001,132.93546815153144,133.53895468574075,133.6799984615386,135.97879900499476,131.38119791808242,124.39371760000036,131.67845939999998,132.91441959999997,134.1789985000001,132.67333666666667,164984624,158438200.8,47.307269127616706,0.5304680238459499,1.5,2.75,NaN,NaN,1.4674834055897574,1.041318464656536,419.93606699425806,-0.32303761634741796,-0.18997312860292936,0.1330644877444886,11.986630660661033,-0.7758803921128231,19.52408903950716,49.418048320004694,31.057862640488167,5150106141
1306503000,133.37,133.87,132.9588,133.50999,NaN,NaN,134.65954304347824,138.1454963265306,124.51811755000035,131.7437593,133.02761919999998,134.03299850000008,132.95799842009885,133.53619614424161,133.49845923076936,135.41830974891033,131.57860871262838,124.51811755000035,131.7437593,133.02761919999998,134.03299850000008,133.44626333333335,120921872,158729576,49.998981545728526,0.06069800104872342,1.5,2.75,NaN,NaN,1.4277488766190611,0.7618105903590393,423.57866476487703,-0.2357739728492541,-0.16165297831707903,0.07412099453217506,11.637784471979014,0.24025076957728808,44.44310708058045,23.348235614249248,32.20865730517031,5271028013
1306848600,134.77,134.92,133.84,134.89999,NaN,NaN,134.84345565217387,138.1963124489796,124.65106750000035,131.8163592,133.17041919999997,133.96699800000007,133.034154952644,133.66608127336147,133.5338430769232,135.5369520298083,131.5307341240381,124.65106750000035,131.8163592,133.17041919999997,133.96699800000007,134.55333,164731184,160650632,56.518562308584244,0.6976350499488196,1.5,2.75,NaN,NaN,1.4264818140034141,1.0254001615132147,427.91703180460854,-0.08068834467970486,-0.02673943631745601,0.053948908362248846,12.428004605170205,1.2990838777502554,78.84211896298557,3.8765583625720716,17.281322674442354,5435759197
1306935000,134.50999,134.9234,131.75999,131.87,NaN,NaN,135.02736826086954,138.2471285714286,124.76911755000036,131.86115920000003,133.21301899999997,133.77399800000006,132.9885018172462,133.49502591399371,133.28692000000012,135.2579093866582,131.31593061334203,124.76911755000036,131.86115920000003,133.21301899999997,133.77399800000006,132.85112999999998,233094256,165383054.4,43.27303497454934,0.7592642425879872,1.5,2.75,NaN,NaN,1.5505481130031702,1.409420432133463,422.9430736483451,-0.17311258618212066,-0.162441824365402,0.010670761816718673,18.580605194569312,-1.8532301280142967,68.02622582903766,8.376898892023975,23.59687527893836,5202664941
1307021400,131.96001,132.24001,130.96001,131.73,NaN,NaN,135.2112808695652,138.29794469387755,124.87981755000035,131.90705920000002,133.26181919999996,133.6189980000001,132.93914880480517,133.32692820789907,133.10922846153858,135.1900579604923,131.02839896258484,124.87981755000035,131.90705920000002,133.26181919999996,133.6189980000001,131.64334,200466752,166265332.8,42.77422875633851,1.1285649828850786,1.5,2.75,NaN,NaN,1.531223247788658,1.205703850730812,421.699220838998,-0.2309992186111624,-0.27807826144723435,-0.047079042836071935,17.493202426830372,-2.1903699280049054,38.261597896680314,28.879595962774516,32.858806140545155,5002198189
1307107800,130.14999,131.42,130.08,130.42,NaN,NaN,135.39519347826084,138.34876081632655,124.98296760000034,131.94145920000003,133.27701919999996,133.45949800000008,132.84035865559713,133.05007790238488,132.89615153846165,135.420325106923,130.3719779700003,124.98296760000034,131.94145920000003,133.27701919999996,133.45949800000008,130.64,234690128,166646555.2,38.32279768485303,1.6123723258622935,1.5,2.75,NaN,NaN,1.5397073015180378,1.4083107071630607,417.84093577483236,-0.33834400657375646,-0.4700090510532675,-0.13166504447951105,17.803430900503372,-2.387545842377087,13.38492641096774,58.86773524149805,27.747338347534203,4767508061
1307367000,130.09,130.36,128.87,129.045,NaN,NaN,135.5791060869565,138.3995769387755,125.08879260000032,131.95760930000003,133.23991939999996,133.2017480000001,132.69152106125998,132.66864191168156,132.57884384615397,135.8206240135054,129.33706367880254,125.08879260000032,131.95760930000003,133.23991939999996,133.2017480000001,129.42499999999998,179951120,164496548.8,34.28921392165293,2.251365367861561,1.5,2.75,NaN,NaN,1.5404424942667483,1.0939507321748745,413.6076401226002,-0.47443801081443027,-0.7247125579975489,-0.2502745471831186,18.120098961069164,-2.283053157655622,2.9440709428983,81.62004188213255,15.435887174969151,4587556941
1307453400,129.7,130.07001,128.85001,128.96001,NaN,NaN,135.76301869565214,138.4503930612245,125.19594265000032,131.96140940000004,133.19311959999996,132.91374850000008,132.54518729415173,132.3154388724738,132.1634600000001,135.75126297760514,128.57565702239506,125.19594265000032,131.96140940000004,133.19311959999996,132.91374850000008,129.29334333333335,161805936,166880124,34.050647638305364,1.9047047159004633,1.5,2.75,NaN,NaN,1.5175537446762664,0.9695938145395913,415.48024970995857,-0.5380104295693449,-0.9227875841447997,-0.3847771545754548,17.387187958914318,-2.2660022735884637,0,100,0,4425751005
1307539800,128.75999,129.19,128.17999,128.42,NaN,NaN,135.9469313043478,138.50120918367347,125.30242465000032,131.9619345,133.14191959999997,132.5412485000001,132.3834152434007,131.94444469414296,131.68192230769242,135.4645230231986,127.89932159218623,125.30242465000032,131.9619345,133.14191959999997,132.5412485000001,128.59666333333334,198696320,171070589.6,32.50326683338656,2.1452546120936016,1.5,2.75,NaN,NaN,1.4813006200565326,1.1614873162277335,411.5672166207822,-0.5806072310718076,-1.1105361934152143,-0.5299289623434067,17.385155486778032,-2.9987159150993272,0,100,0,4227054685
1307626200,128.77,129.92999,128.46001,129.39999,NaN,NaN,136.13084391304344,138.55202530612246,125.42177460000033,131.96293440000002,133.09271939999996,132.2892480000001,132.26641817503204,131.70211567565315,131.35807538461546,135.14581082525137,127.57033994397955,125.42177460000033,131.96293440000002,133.09271939999996,132.2892480000001,129.26333,160964368,169431526.4,38.00888166310713,1.346941814898619,1.5,2.75,NaN,NaN,1.4833498614810672,0.9500260749583851,414.71083761275565,-0.5094977569958005,-1.1668011585881573,-0.6573034015923568,18.085496947196415,-2.7067744360902237,3.14621081769682,80.96130748285672,15.892481699446455,4388019053
1307712600,128.85001,128.92999,127.25999,127.60001,NaN,NaN,136.3147565217391,138.60284142857142,125.53007465000033,131.94373450000003,132.98931959999996,131.9152485000001,132.0834217760112,131.31143894463855,131.01499923076932,135.26589217952235,126.76410628201629,125.53007465000033,131.94373450000003,132.98931959999996,131.9152485000001,127.92999666666668,238629312,172780585.6,32.7283473803234,2.05485453167543,1.5,2.75,NaN,NaN,1.5302534428038481,1.3811118371391837,409.96870677545803,-0.5470970108119115,-1.3411746651072463,-0.7940776542953347,18.636859189110996,-4.426620060416446,3.1551160272911187,80.93273522662348,15.912148746085395,4149389741
1307971800,127.89,128.24001,127.05,127.7,NaN,NaN,136.49866913043473,138.65365755102042,125.64242465000034,131.93823450000002,132.89151959999995,131.59824900000007,131.91152288283428,130.9674923784825,130.68807615384625,135.24382875350935,126.13232355418316,125.64242465000034,131.93823450000002,132.89151959999995,131.59824900000007,127.66333666666667,207599744,175285620,33.28285029238616,1.921313921173352,1.5,2.75,NaN,NaN,1.5059503397464316,1.1843512548262658,408.212478615623,-0.528363182740305,-1.454531632720716,-0.926168449980411,18.239025595092386,-5.337279861918448,18.022458284333197,51.56984136126687,30.407700354399946,4356989485
1308058200,128.87,129.77,128.82001,129.32001,NaN,NaN,136.6825817391304,138.7044736734694,125.75472470000034,131.95063460000003,132.81491999999997,131.40474950000007,131.8098949266447,130.8105892948175,130.45192307692318,134.94819292660958,125.95565322723677,125.75472470000034,131.95063460000003,132.81491999999997,131.40474950000007,129.30334000000002,160570368,176225607.2,41.671606275054145,0.5410451245303444,1.5,2.75,NaN,NaN,1.5462396011931154,0.9111636529517942,413.040192171937,-0.377094556591838,-1.3975366457202085,-1.0204420891283705,18.937562725749114,-1.9337150223705226,38.64243942003296,28.346443495533247,33.01111708443379,4517559853
1308144600,128.24001,129.2991,126.67999,127.02,NaN,NaN,136.86649434782606,138.75528979591837,125.86326970000033,131.93713460000004,132.6901202,131.09724950000006,131.6220559099135,130.44958079054916,129.99192307692317,134.57409717709504,125.40974897675132,125.86326970000033,131.93713460000004,132.6901202,131.09724950000006,127.66636333333332,300957952,181630888.8,34.952194732434265,1.9701831040826636,1.5,2.75,NaN,NaN,1.6243667725364637,1.6569756057924436,407.48853516502567,-0.3999924817224234,-1.5204326912813997,-1.1204402095589763,17.369375963280532,-3.5754953313595945,31.716741242645885,35.03473523622734,33.248523521126764,4216601901
1308231000,127.06,127.97,126.32001,127.3,NaN,NaN,137.0504069565217,138.80610591836736,125.97321970000031,131.9191345,132.57132,130.74424950000008,131.45256352128945,130.14962071525878,129.51423153846164,133.81597478523798,125.21248829168532,125.97321970000031,131.9191345,132.57132,130.74424950000008,127.19667,308038400,190271402.4,36.29883429771113,1.7151029084806222,1.5,2.75,NaN,NaN,1.6261970030695736,1.6189421852918449,405.5032955143567,-0.3652924053533315,-1.5770557162506407,-1.2117633108973092,17.652003265333295,-2.3922711240607195,39.834546581301744,27.28345109874744,32.8820023199508,4524640301
1308317400,127.92999,127.94,126.62,127.05,NaN,NaN,137.23431956521736,138.85692204081633,126.06616965000032,131.89793450000002,132.43911999999997,130.36275000000006,131.27991397143495,129.854418742377,128.91038615384625,132.0710626277988,125.74970967989371,126.06616965000032,131.89793450000002,132.43911999999997,130.36275000000006,127.20333333333333,234996064,196041961.6,35.590370133322324,1.4393389378680173,1.5,2.75,NaN,NaN,1.6043257885646036,1.1987028801491038,408.7974344536474,-0.32930083938588406,-1.6233893601296643,-1.2940885207437802,17.153450816812455,-1.5459723352318886,40.13672391272588,27.017844435907854,32.84543165136627,4289644237
1308576600,126.62,127.97,126.58,127.7,NaN,NaN,137.418232173913,138.90773816326532,126.15731965000032,131.87823450000002,132.32671979999998,130.06725000000006,131.13952518824144,129.64923600500777,128.58961692307702,131.29773628716595,125.8814975589881,126.15731965000032,131.87823450000002,132.32671979999998,130.06725000000006,127.41666666666667,159478944,194883992.8,38.927906802813,1.0522295254776832,1.5,2.75,NaN,NaN,1.589016803667132,0.8183275686662758,412.17418422589736,-0.23620008946019544,-1.5893386325690244,-1.353138543108829,16.8449456482522,-0.9770548249802463,37.51873100907303,29.376106003655345,33.10516298727163,4449123181
1308663000,128.36,129.7,127.75349,129.45,NaN,NaN,137.60214478260866,138.95855428571429,126.25011965000033,131.87283440000002,132.2585198,129.93675000000005,131.0732692985065,129.63026114738798,128.4142323076924,130.5128461607783,126.3156184546065,126.25011965000033,131.87283440000002,132.2585198,129.93675000000005,128.96783,193157248,196101855.2,46.90489743460341,0.45134938255888024,1.5,2.75,NaN,NaN,1.6183727462623358,0.984984297078695,417.80628758390617,-0.041447126589353456,-1.404947451345521,-1.3635003247561674,18.83334137776828,0.8020557545553662,39.29899190048974,27.76294686707009,32.93806123244016,4642280429
1308749400,129.05,129.81,128.59,128.67,NaN,NaN,137.7860573913043,139.00937040816328,126.34526965000032,131.88233440000005,132.18271959999998,129.77275000000006,130.9790234436631,129.5388077047796,128.27961692307701,130.044254300776,126.51497954537803,126.34526965000032,131.88233440000005,132.18271959999998,129.77275000000006,129.0233333333333,176886432,197586160.8,44.13765763250128,0.26473228305547186,1.5,2.75,NaN,NaN,1.5899175501007403,0.8952369502186308,415.7924465883071,0.04544597882389256,-1.3066928512263019,-1.3521388300501944,19.025951192351627,-0.5641345103658933,48.31733242687894,20.386247296386976,31.296420276734075,4465393997
1308835800,127.16,128.63609,126.19,128.30099,NaN,NaN,126.19,139.06018653061224,126.43472460000032,131.87854440000004,132.11933939999997,129.56829950000008,130.87400252430376,129.4209203043244,128.22238538461548,129.93140095460944,126.51336981462151,126.43472460000032,131.87854440000004,132.11933939999997,129.56829950000008,127.70902666666666,334286848,206745393.6,42.84969127698452,0.8910595136171748,1.5,2.75,NaN,NaN,1.653494867950687,1.6169010693740555,412.73034427319163,0.08630437607951125,-1.2442583599508055,-1.3305627360303167,18.476628197524253,0.5493573237180902,12.463483268771983,60.217983986122896,27.318532745105113,4131107149
1308922200,128.27,128.37,126.62,126.81,NaN,NaN,126.11782630434783,139.11100265306123,126.51417460000033,131.83924430000002,132.0263392,129.25879950000007,130.71462987629184,129.17226122772206,128.05700000000007,129.8619119629711,126.25208803702905,126.51417460000033,131.83924430000002,132.0263392,129.25879950000007,127.26666666666667,226129376,209802631.2,38.021881801166145,1.224090727369394,1.5,2.75,NaN,NaN,1.660388091668495,1.077819542617824,409.8753585646063,0.024368397822150056,-1.300102238752629,-1.3244706365747791,17.913253736309308,-0.6969459671104155,12.694208020512635,59.825542312723904,27.48024966676346,3904977773
1309181400,126.89,128.42999,126.64,127.94,NaN,NaN,126.04565260869565,139.1618187755102,126.59646465000033,131.81379430000004,131.95393919999998,128.98030000000008,130.6058208615353,129.05490301555807,128.020076923077,129.81337601467925,126.22677783147475,126.59646465000033,131.81379430000004,131.95393919999998,128.98030000000008,127.66999666666666,168908192,212201947.2,43.241312833572316,0.5715077917303312,1.5,2.75,NaN,NaN,1.6696453708350312,0.7959785205967234,413.60362894106777,0.06845960095745829,-1.2388961353779564,-1.3073557363354147,18.726095286891994,-1.0671279719201991,13.717291425068542,58.07082629783931,28.21188227709215,4073885965
1309267800,128.45,129.63,128.27,129.61,NaN,NaN,125.97347891304348,139.2126348979592,126.68091465000032,131.80209430000002,131.90533939999995,128.71580050000009,130.56676906304372,129.10776939502873,128.03623153846164,129.8819790804701,126.19048399645317,126.68091465000032,131.80209430000002,131.90533939999995,128.71580050000009,129.17,165556256,212243200.8,49.94964625213425,0.6538699820457549,1.5,2.75,NaN,NaN,1.671099272918243,0.7800309049994312,417.9221338369875,0.21100075875925017,-1.043604787886352,-1.254605546645602,18.814726165248793,2.0390489686663655,12.216964729234869,60.58778421336997,27.195251057395154,4239442221
1309354200,130.2,130.92999,129.6321,130.72,NaN,NaN,125.9013052173913,139.26345102040818,126.77126470000032,131.79779440000002,131.90853939999997,128.65830050000008,130.57277811939494,129.26131516693076,128.27623076923086,130.58578128748852,125.96668025097321,126.77126470000032,131.79779440000002,131.90853939999997,128.65830050000008,130.42736333333335,244295376,212803256.8,53.853655130212346,1.3103567450036886,1.5,2.75,NaN,NaN,1.6460200391383677,1.1479870170859152,421.8565969515687,0.3715573926751481,-0.7901588058016671,-1.1617161984768152,15.267077889885739,2.686567164179106,34.35124990130362,32.334845159574336,33.31390493912204,4483737597
1309440600,131.14,132.17999,130.705,131.97,NaN,NaN,125.82913152173913,139.31426714285715,126.86571470000031,131.79779440000002,131.92173939999995,128.67030050000008,130.62757113432062,129.5192851510326,128.6046923076924,131.60443256053995,125.60495205484487,126.86571470000031,131.79779440000002,131.92173939999995,128.67030050000008,131.61833000000001,223496496,213954744,57.841686719009154,1.9511751803120838,1.5,2.75,NaN,NaN,1.633803607771341,1.0445970574038779,426.00560716055656,0.5430767524227273,-0.4828702579484059,-1.0259470103711332,15.719010710014604,3.872491145218419,73.70469856319056,5.738328437014758,20.55697299979468,4707234093
1309527000,132.09,134.10001,131.78,133.92,NaN,NaN,125.75695782608696,139.36508326530614,126.97006470000031,131.81129430000001,131.93813919999994,128.84530050000006,130.75668599179824,129.93840085093424,128.9585376923078,133.08567364771847,124.83140173689715,126.97006470000031,131.81129430000001,131.93813919999994,128.84530050000006,133.26666999999998,202385632,212339519.2,63.186555189793914,2.8591008990641282,1.5,2.75,NaN,NaN,1.6828183500733878,0.9531227760263291,431.3325961406656,0.755910590978527,-0.08105877164797448,-0.8369693626265015,16.442622291049695,4.870790916209854,100,0,0,4909619725
1309872600,133.78,134.08,133.39,133.81,NaN,NaN,125.68478413043478,139.4158993877551,127.07666465000031,131.82670430000002,131.93873919999996,129.08355050000006,130.87642379604145,130.3071245794167,129.4808453846155,134.17422387218542,124.78746689704556,127.07666465000031,131.82670430000002,131.93873919999996,129.08355050000006,133.76000000000002,165935936,211638760,62.7036196525614,2.4518925275580625,1.5,2.75,NaN,NaN,1.6119027536395762,0.7840526754173007,430.47055248396657,0.8502951823422423,0.22589961530130154,-0.6243955670409408,16.81061377838784,3.3680957898802735,81.1256338471786,3.084438006218909,15.789928146602477,4743683789
1309959000,133.49001,134.14,133.11,133.97,NaN,NaN,125.61261043478261,139.4667155102041,127.17546460000032,131.84319430000002,131.94533919999995,129.33405000000008,130.99774050992218,130.6559698575675,129.99392230769243,135.0646392887627,124.92320532662218,127.17546460000032,131.84319430000002,131.94533919999995,129.33405000000008,133.74,143332688,210715097.6,63.14485931094068,2.1087054861764924,1.5,2.75,NaN,NaN,1.5703382712367475,0.6802203052013298,432.26503945417244,0.8807830585799981,0.47658325618405684,-0.4041998023959413,15.881845443672798,4.119064272946306,80.75330713730636,3.20018239465092,16.046510468042722,4887016477
1310045400,135.16,135.7,134.88,135.36,NaN,NaN,125.54043673913043,135.7,127.28236460000034,131.8656943,131.95671919999995,129.68105000000008,131.16880950953308,131.10397272827535,130.6331530769232,136.13505927347154,125.13124688037489,127.28236460000034,131.8656943,131.95671919999995,129.68105000000008,135.31333333333333,170464192,209303491.2,66.8176371823719,2.841068022343449,1.5,2.75,NaN,NaN,1.581742680434122,0.8144354927988894,436.79658264837576,0.9461117305518238,0.7784398607938385,-0.16767186975798531,15.066844382972109,5.501913897936407,79.1410567867966,3.7235676659047585,17.13537554729867,5057480669
1310131800,133.83,135.3558,133.39,134.39999,NaN,NaN,125.46826304347826,135.6678263043478,127.38726455000034,131.8753943,131.93131899999995,129.93105000000008,131.29552246994353,131.41787913510626,131.14853692307705,136.70975607974657,125.58731776640752,127.38726455000034,131.8753943,131.93131899999995,129.93105000000008,134.38192999999998,194171504,210963848,62.206796992233784,1.7478376618054723,1.5,2.75,NaN,NaN,1.609475346117401,0.9204017932020276,433.4060940635201,0.8777247732152575,0.9294840967610867,0.0517593235458291,16.048085447846777,5.985324501222301,47.09432721623847,21.294897193346035,31.61077559041549,4863309165
1310391000,132.75,133.17999,131.66,131.97,NaN,NaN,125.39608934782609,135.63565260869564,127.48462455000035,131.8649944,131.84851899999995,130.14954950000006,131.32197256916143,131.47046207461995,131.3423830769232,136.82843663264345,125.85632952120295,127.48462455000035,131.8649944,131.84851899999995,130.14954950000006,132.26999666666666,195918560,208828310.4,52.357957397720384,0.2590166869621475,1.5,2.75,NaN,NaN,1.6902263928233014,0.938180075415675,427.78052219716466,0.6333012054757843,0.8433858303905595,0.21008462491477517,18.704001059618985,3.149914022197906,17.04676239426962,52.91915090341255,30.03408670231782,4667390605
1310477400,131.69,132.78,131.36,131.39999,NaN,NaN,125.32391565217391,135.60347891304346,127.56752445000036,131.8404942,131.74791899999997,130.33454900000007,131.32503207625314,131.46375044846567,131.55238230769243,136.81773898932204,126.28702562606283,127.56752445000036,131.8404942,131.74791899999997,130.33454900000007,131.84666333333334,214675632,209182104.8,50.344413145879805,0.06702599724339978,1.5,2.75,NaN,NaN,1.6709245076216361,1.0262619367237573,425.94624213857674,0.4086105448400041,0.7208478059647803,0.3122372611247762,18.974327804328052,1.3810585602962646,15.309350564709549,55.53361237304231,29.157037062248133,4452714973
1310563800,132.09,133.22,131.519,131.84,NaN,NaN,125.25174195652174,135.57130521739128,127.65537445000037,131.8163942,131.66031899999996,130.46054850000007,131.34522689679224,131.499583739088,131.82461384615397,136.74398466464882,126.90524302765911,127.65537445000037,131.8163942,131.66031899999996,130.46054850000007,132.193,204062560,211356714.4,51.88272457419331,0.20615758039493082,1.5,2.75,NaN,NaN,1.6815734713629475,0.9654888919866744,429.5687029350826,0.2715925545251156,0.6517279542811707,0.3801353997560551,17.834967372082346,0.8567931456548382,19.206131336021976,49.85190514207199,30.94196352190603,4656777533
1310650200,132.17,132.78,130.67999,130.92999,NaN,NaN,125.17956826086957,135.5391315217391,127.73667440000037,131.7803941,131.56431879999997,130.65604800000008,131.32894309691804,131.4453367163177,132.1415361538463,136.17977503593414,128.10329727175844,127.73667440000037,131.7803941,131.56431879999997,130.65604800000008,131.4633266666667,226111744,207614404,48.53391989407701,0.4935043210180089,1.5,2.75,NaN,NaN,1.7114617948370225,1.0890946853571875,425.0884920966704,0.10993466805287111,0.517553734822144,0.40761906676927284,17.876831986547785,-0.7880654694248657,4.567642044716703,76.71389860306782,18.71845935221548,4430665789
1310736600,131.66,131.87,130.77,131.69,NaN,NaN,125.10739456521739,135.50695782608693,127.82277440000036,131.7789941,131.50151879999996,130.87554800000007,131.34310219115656,131.4686379814303,132.42999769230784,135.6866222402579,129.17337314435778,127.82277440000036,131.7789941,131.50151879999996,130.87554800000007,131.44333333333333,220124624,203218715.2,51.35774975420207,0.3192019506513594,1.5,2.75,NaN,NaN,1.6677859523486636,1.0831907080180183,427.72563931564497,0.04763355714197698,0.4671610131967441,0.4195274560547671,17.28232684539708,-1.6651732377538755,20.988009171658224,47.45401458018392,31.557976248157853,4650790413
1310995800,131.08,131.28,129.63,130.61,NaN,NaN,125.03522086956522,135.47478413043476,127.90517440000036,131.7748941,131.44151879999995,131.05354800000006,131.314353085621,131.3868629355798,132.5069207692309,135.53251887864545,129.48132265981636,127.90517440000036,131.7748941,131.44151879999995,131.05354800000006,130.50666666666666,196872064,201312515.2,47.37945778426216,0.9424072580413919,1.5,2.75,NaN,NaN,1.6958012414666164,0.9779424980330285,422.6217797254868,-0.06666043063917282,0.3362019177558011,0.4028623483949739,14.906517430830277,-2.391450564232859,20.670460929127138,47.8843819612752,31.445157109597655,4453918349
1311082200,131.34,132.89,131.31,132.73,NaN,NaN,124.96304717391304,135.4426104347826,127.99577440000036,131.79289419999998,131.41211879999994,131.30504800000008,131.36986865089077,131.51478075123887,132.6615361538463,135.50608258645292,129.81698972123968,127.99577440000036,131.79289419999998,131.41211879999994,131.30504800000008,132.30999999999997,166554880,201666312,54.78372723953064,0.6023291414801941,1.5,2.75,NaN,NaN,1.737529724218999,0.8258934194224765,427.581338397609,-0.0031826098498967115,0.39888408608260306,0.4020666959324998,18.358868130638555,-0.9255803538105614,44.56942074860876,23.253597002541635,32.17698224884959,4620473229
1311168600,133.07001,133.14999,132.42,132.64999,NaN,NaN,124.89087347826087,135.41043673913043,128.09027435000036,131.7960941,131.37071859999995,131.46504750000008,131.42006948811073,131.62289591778756,132.7138430769232,135.53047156888346,129.89721458496297,128.09027435000036,131.7960941,131.37071859999995,131.46504750000008,132.73999333333333,137145312,198865715.2,54.4722008001872,0.6877793817618345,1.5,2.75,NaN,NaN,1.6655626010605002,0.6896377883038937,429.21549094417696,0.027999279517340547,0.43706579532917544,0.4090665158118349,18.316054386431233,-2.0020759456264856,21.684770840712837,46.55725194715247,31.75797721213469,4483327917
1311255000,133.39999,134.82001,132.6693,134.49001,NaN,NaN,124.8186997826087,135.37826304347826,128.18252445000036,131.80949429999998,131.34311879999996,131.75604800000008,131.54045931210638,131.89595440180778,132.75769000000014,135.6643665812823,129.85101341871797,128.18252445000036,131.80949429999998,131.34311879999996,131.75604800000008,133.99310666666668,245270320,202284909.6,60.09251562755487,1.6801122465825622,1.5,2.75,NaN,NaN,1.7015952724133212,1.2124993430552964,433.6546937711641,0.15977211161726523,0.6087816553334164,0.4490095437161512,19.18120887319269,0.06697917165024325,55.114933657006524,15.588436328457048,29.296630014536436,4728598237
1311341400,134.52,134.72,133.75999,134.58,NaN,NaN,124.74652608695652,135.34608934782608,128.27527445000038,131.8459944,131.34591879999996,132.06999850000005,131.6596569861414,132.1515777921118,132.8169207692309,135.83615898895695,129.79768254950486,128.27527445000038,131.8459944,131.34591879999996,132.06999850000005,134.35333,126019312,191871532.8,60.35031397597885,1.4597313623317343,1.5,2.75,NaN,NaN,1.6486248958123704,0.6567900415501345,432.4393484621332,0.23563866907691722,0.7435578800622977,0.5079192109853805,18.736156175081163,1.9777222095930997,49.86427652405141,19.20525312961711,30.930470346331482,4854617549
1311600600,133.3,134.49001,133.16,133.83,NaN,NaN,124.67435239130435,135.3139156521739,128.3649744500004,131.87219429999996,131.32091879999996,132.42099850000005,131.74476847688098,132.31142752619638,132.80615153846168,135.80981997567721,129.80248310124614,128.3649744500004,131.87219429999996,131.32091879999996,132.42099850000005,133.82667,136653680,187397748,57.04296829149441,0.9456467912270311,1.5,2.75,NaN,NaN,1.632294546111488,0.729217300946434,426.35175258778247,0.21834393874915814,0.7808491344218282,0.5625051956726701,15.292081097636844,1.849322819583175,58.240310927868116,13.649815008327453,28.109874063804426,4717963869
1311687000,133.74001,133.96001,133.03,133.33,NaN,NaN,124.60217869565217,135.28174195652173,128.4489369000004,131.87079429999997,131.30671899999996,132.69049850000005,131.8069344189641,132.4084344284634,132.6499976923078,135.29614794101485,130.00384744360076,128.4489369000004,131.87079429999997,131.30671899999996,132.69049850000005,133.44000333333335,131278128,185516244.8,54.883555265662814,0.5108062817124556,1.5,2.75,NaN,NaN,1.5821313642463823,0.7076368333216714,423.5137860527342,0.15902090236383004,0.7612813236274576,0.6022604212636276,15.215518359414173,1.1301577669902982,32.27425393642937,34.471770390928064,33.25397567264258,4586685741
1311773400,132.59,132.63,130.42999,130.60001,NaN,NaN,124.530005,135.24956826086955,128.5186870000004,131.8520944,131.25491919999996,132.73999900000007,131.75960404959295,132.2362035305145,132.35769153846167,135.00554001913176,129.70984305779157,128.5186870000004,131.8520944,131.25491919999996,132.73999900000007,131.22,249020000,189689432,44.89114948940598,1.2219158189074162,1.5,2.75,NaN,NaN,1.6762655525144985,1.3127774034348945,416.8068898898023,-0.06621004338065128,0.5194978670378134,0.5857079104184647,19.701543029431736,-0.25202782036415505,24.911329283520804,42.607853161242794,32.48081755523642,4337665741
1311859800,130.60001,131.77,130.00999,130.22,NaN,NaN,124.45783130434783,135.21739456521738,128.5847370500004,131.8399945,131.19591919999996,132.71499900000006,131.69922742019716,132.04418414665597,132.22307615384628,135.1037771147746,129.34237519291796,128.5847370500004,131.8399945,131.19591919999996,132.71499900000006,130.66666333333333,207939872,187871656.8,43.69849951697192,1.1901302515172192,1.5,2.75,NaN,NaN,1.6822472987634645,1.1068187481912917,414.5649962802566,-0.23350073448867859,0.2938319923076165,0.5273327267962951,19.388653426933192,-1.1162578783506711,2.833957849837532,81.97072540976521,15.195316740397264,4129725869
1311946200,128.91,130.55,127.96671,129.33,NaN,NaN,124.38565760869565,135.1852208695652,128.64178705000043,131.80749449999996,131.09531919999998,132.58299900000006,131.60631654097375,131.78569041840302,132.0638461538463,135.31406450831082,128.81362779938178,128.64178705000043,131.80749449999996,131.09531919999998,132.58299900000006,129.28223666666668,307042560,192048960,40.954206640299994,1.937857056097939,1.5,2.75,NaN,NaN,1.7466074917089318,1.5987723130601696,410.80352733200664,-0.38772011698134146,0.04268258056961827,0.4304026975509597,19.235453205648064,-0.9800168440395077,0,100,0,3822683309
1312205400,130.84,130.96001,127.53,128.78,NaN,NaN,124.31348391304348,135.15304717391302,128.69838700000042,131.77139449999999,130.97731939999997,132.32599900000008,131.49548059819045,131.49943418807894,131.82846153846168,135.52236501608434,128.13455806083903,128.69838700000042,131.77139449999999,130.97731939999997,132.32599900000008,129.09000333333333,325790720,198219214.4,39.3112062378281,2.2086442795493086,1.5,2.75,NaN,NaN,1.8668505280154373,1.6435879891167604,412.5015654156,-0.5030805233291628,-0.19844795661049375,0.304632566718669,18.882499659735963,-2.9759662472688833,0,100,0,3496892589
1312291800,127.81,128.5,125.49001,125.49001,NaN,NaN,124.2413102173913,135.12087347826085,128.73733705000043,131.72691959999997,130.8149196,131.90999950000008,131.25997194728103,130.92710807492855,131.41000153846167,136.4157920992693,126.40421097765403,128.73733705000043,131.72691959999997,130.8149196,131.90999950000008,126.49333999999999,346653696,207255102.4,31.23810491024446,3.2841191979559654,1.5,2.75,NaN,NaN,1.9685033474429063,1.6725942666104416,410.0322623505392,-0.7617506315364742,-0.6475557227019237,0.11419490883455044,19.970232421042386,-5.397648352630863,0,100,0,3150238893
1312378200,125.66,126.31,123.53,126.17,NaN,NaN,124.16913652173913,135.08869978260867,128.77678705000042,131.6802196,130.69711959999998,131.5199995000001,131.0603652042504,130.4740501630306,130.9853861538463,136.7091192622356,125.261653045457,128.77678705000042,131.6802196,130.69711959999998,131.5199995000001,125.33666666666666,371029504,218639943.2,34.243855930275046,3.6158874634969016,1.5,2.75,NaN,NaN,2.0264673940541273,1.6969886589322898,412.3544176130682,-0.8415935372162737,-0.9377970126857917,-0.09620347546951799,20.799431512153863,-6.186340531910147,6.269275068198746,72.47799104776057,21.25273388404069,3521268397
1312464600,124.42,124.62,120.06,120.25999,NaN,NaN,124.09696282608697,135.0565260869565,128.7944370000004,131.58231949999998,130.4633194,130.76499900000007,130.6368210785935,129.50128252845624,130.18923153846166,138.2872206891259,122.09124238779741,128.7944370000004,131.58231949999998,130.4633194,130.76499900000007,121.64666333333334,520721920,236152829.6,24.30118622530277,5.808496403506887,1.5,2.75,NaN,NaN,2.3181482944788323,2.205020879411051,402.3294487851865,-1.2238057624107945,-1.6259606784830112,-0.40215491607221665,28.956207734605634,-10.640518650616741,4.39163958082876,77.2450210130684,18.36333940610284,3000546477
1312551000,121.75999,122.07001,116.86,120.08,NaN,NaN,124.02478913043478,135.02435239130432,128.80548700000043,131.4975195,130.21711939999997,130.0489995000001,130.22282809511924,128.60401752574612,129.21615461538474,138.76857318581287,119.66373604495661,128.80548700000043,131.4975195,130.21711939999997,130.0489995000001,119.67000333333333,655561472,259222328,24.07195354501043,6.3673150607699,1.5,2.75,NaN,NaN,2.5247098448732013,2.5289544965432142,396.65237500843614,-1.4070352318780266,-2.16094895591975,-0.7539137240417233,28.65759127481973,-10.274228498841824,3.1539889396120038,80.91819457317341,15.927816487214585,2344985005
1312810200,116.91,120.1218,112.02,112.25999,NaN,NaN,123.95261543478262,134.99217869565214,128.77613695000042,131.35836940000002,129.80231919999997,129.0634990000001,129.51840307178122,127.04744347567505,127.6476930769232,140.54131271570608,114.75407343814034,128.77613695000042,131.35836940000002,129.80231919999997,129.0634990000001,114.80059666666666,702263808,284539590.4,16.700864870800544,10.188994015399318,1.5,2.75,NaN,NaN,2.9230734273822585,2.4680706365422536,380.7176121715858,-1.940302283443009,-3.1792915783454845,-1.2389892949024754,42.567080933876795,-15.80290257256432,2.3893045822769516,83.53340293801142,14.077292479711637,1642721197
1312896600,114.07001,117.64,110.27,117.48,NaN,NaN,110.27,134.96000499999997,128.7718019500004,131.25466930000002,129.48171939999997,128.3674995000001,129.04630883367216,126.13625838275362,126.3392307692309,139.6359089398051,113.0425525986567,128.7718019500004,131.25466930000002,129.48171939999997,128.3674995000001,115.13,717828608,309697239.2,31.72900515784731,8.175645607174324,1.5,2.75,NaN,NaN,3.2407110397120973,2.317839867911874,390.5061163890245,-1.8284054161645305,-3.5244960651081385,-1.696090648943608,55.710549118904,-10.045948694797184,17.058171366883276,52.984991406907646,29.95683722620908,2360549805
1312983000,115.25999,116.28,111.95,112.28999,NaN,NaN,109.7725,134.92783130434782,128.7397519000004,131.0999693,129.02951939999997,127.3899990000001,128.3891982911752,124.81756615582471,124.62461461538474,138.93821698053702,110.31101225023248,128.7397519000004,131.0999693,129.02951939999997,127.3899990000001,113.50666333333334,662607360,332624479.2,26.59212598147235,7.906363218854608,1.5,2.75,NaN,NaN,3.4042316797326615,1.9920583163140808,384.1163924960404,-1.9781739730439782,-4.168808115248581,-2.1906341422046025,58.68901129278054,-13.769013976347715,5.52474670189755,74.28834475079238,20.186908547310072,1697942445
1313069400,113.25999,118.92,112.317,117.33,NaN,NaN,109.27499999999999,134.89565760869564,128.73280190000042,130.9758692,128.73871939999998,126.7099995000001,127.95550424054089,124.10446461717474,123.35538384615398,137.0934546522177,109.61731304009027,128.73280190000042,130.9758692,128.73871939999998,126.7099995000001,116.18900000000001,487979776,345717880.8,37.2213750036351,4.665145536629661,1.5,2.75,NaN,NaN,3.634644416894614,1.4114970705906282,392.36579438823526,-1.6267335974155333,-4.224051138974019,-2.597317541558486,67.68445936221708,-9.278589654372546,17.632333529950778,52.15138008656134,30.21628638348788,2185922221
1313155800,118.39999,119.215,117.28,118.12,NaN,NaN,108.77749999999999,134.86348391304347,128.7315019000004,130.86416930000001,128.46651939999998,126.03149950000008,127.56979819189223,123.53451560601525,122.185383846154,134.877089100863,109.49367859144499,128.7315019000004,130.86416930000001,128.46651939999998,126.03149950000008,118.205,313731584,350398228.8,38.71921233525428,2.535060503179162,1.5,2.75,NaN,NaN,3.5132412442592846,0.8953572199106961,395.8923535779143,-1.2470863126186909,-4.15617543233185,-2.9090891197131588,68.38845962295186,-8.277682870010867,36.926067028335105,29.94133965518887,33.13259331647603,2499653805
1313415000,119.19,120.74001,119,120.62,NaN,NaN,108.28,134.8313102173913,128.7426019500004,130.77376930000003,128.27051939999998,125.53199950000007,127.29725708632783,123.25694269115665,121.4176907692309,133.15180803572642,109.68357350273538,128.7426019500004,130.77376930000003,128.27051939999998,125.53199950000007,120.12000333333333,258810560,353495153.6,43.327335553434644,0.7957861585762714,1.5,2.75,NaN,NaN,3.4494390125264784,0.7321474067303875,403.33050435324293,-0.7576906545259017,-3.856202437870536,-3.0985117833446343,70.52729180829304,-3.880794973241291,66.95072057693592,8.797684628478496,24.251594794585575,2758464365
1313501400,119.47,120.69,118.31,119.59,NaN,NaN,107.7825,134.79913652173911,128.7481019000004,130.66066940000002,128.0814194,124.87499950000009,126.99501171039341,122.90771005390364,120.59999846153859,131.1925740559479,110.00742286712929,128.7481019000004,130.66066940000002,128.0814194,124.87499950000009,119.53000000000002,294095104,359872164.8,41.92842423238242,1.1180203297992077,1.5,2.75,NaN,NaN,3.3730505116317295,0.8172210378189272,398.4788591128671,-0.44871119432534634,-3.659400776251317,-3.210689581925971,69.48557761107129,-5.215185860347149,37.19728289479653,29.629075924097265,33.17364118110621,2464369261
1313587800,120.25,121.2,118.72,119.67,NaN,NaN,107.285,134.76696282608694,128.75380190000038,130.54436940000002,127.89561919999998,124.22600000000008,126.70775634920152,122.59935671543663,119.85692153846168,129.17410970460247,110.53973337232088,128.75380190000038,130.54436940000002,127.89561919999998,124.22600000000008,119.86333333333334,238201056,364924952,42.08483187461913,0.9791249306517228,1.5,2.75,NaN,NaN,3.3092611893723207,0.6527398433418168,400.2808555088779,-0.19715001517470654,-3.457127100894354,-3.2599770857196475,69.28408250851483,-0.49059541747841506,77.65288675575043,4.232145323333042,18.114967920916516,2702570317
1313674200,116.5,119.714,113.39,114.50999,NaN,NaN,106.7875,134.73478913043476,128.7289768000004,130.37966930000005,127.61741899999997,123.22699900000009,126.22941257080146,121.828940837776,118.7592284615386,126.9009867532518,110.6174701698254,128.7289768000004,130.37966930000005,127.61741899999997,123.22699900000009,115.87133,512956160,378309244,35.452239943807285,4.905171775661075,1.5,2.75,NaN,NaN,3.524599675845726,1.3559175942314536,391.69582768698336,-0.3287206067227033,-3.6708778441230265,-3.342157237400323,68.43832263616738,-4.638582611592269,33.60608504049273,33.07772866807943,33.316186291427854,2189614157
1313760600,112.96001,115.88,112.5,112.64,NaN,NaN,106.28999999999999,134.7026154347826,128.69242680000036,130.18746930000003,127.28221919999999,122.12999900000008,125.69649443077003,120.95380361513067,117.7707661538463,125.51428011605881,110.02725219163378,128.69242680000036,130.18746930000003,127.28221919999999,122.12999900000008,113.67333333333333,428281344,393422345.6,33.39799823273424,4.9406213330908315,1.5,2.75,NaN,NaN,3.514271127571031,1.088604520790087,386.7918313240291,-0.48282301076024403,-3.9456860008506283,-3.4628629900903842,68.70392208674336,0.3385088489674715,10.690444018208689,63.312653244092324,25.996902737698996,1761332813
1314019800,115.17,115.23,112.41,112.73,NaN,NaN,105.79249999999999,134.6704417391304,128.64477685000037,129.98706930000003,126.98481899999997,121.07499900000009,125.18800445309277,120.17058422321347,116.73692000000014,123.202065116521,110.27177488347928,128.64477685000037,129.98706930000003,126.98481899999997,121.07499900000009,113.45666666666666,275090688,400344196,33.59742373809881,4.309933594277628,1.5,2.75,NaN,NaN,3.4646803327445292,0.6871354468193664,385.9730946934026,-0.516787181478152,-4.108846966938074,-3.5920597854599223,56.69178459560186,-4.043241402791964,9.887989091256456,64.95969729188049,25.152313616863033,2036423501
1314106200,113.14999,116.5665,112.58,116.44,NaN,NaN,105.295,134.63826804347823,128.61335180000037,129.8255693,126.75961899999997,120.2304990000001,124.84494545493227,119.81529048766933,116.44307461538476,122.57991124243503,110.30623798833449,128.61335180000037,129.8255693,126.75961899999997,120.2304990000001,115.1955,331136512,410337115.2,41.388418976138645,2.1599565906770355,1.5,2.75,NaN,NaN,3.501953166119921,0.8069864989877962,388.66871956393317,-0.2414727715216496,-3.8939007498619844,-3.652427978340335,53.295506787217974,3.6957969272238733,28.3124556174384,38.79600357290306,32.891540809658544,2367560013
1314192600,116.19,118.24001,115.92,118.08,NaN,NaN,104.7975,134.60609434782606,128.59130175000038,129.67486940000003,126.53481879999995,119.60449850000009,124.57965347630747,119.65002472693892,116.28922846153861,122.14761071295283,110.4308462101244,128.59130175000038,129.67486940000003,126.53481879999995,119.60449850000009,117.41333666666667,246869680,410229599.2,44.48899051781353,0.2964048657616358,1.5,2.75,NaN,NaN,3.417528654254212,0.6017841727691696,392.1695905357023,0.0817068259630167,-3.550294445886564,-3.632001271849581,45.57706445820999,0.6392227051904884,28.517796640097664,38.568523293845814,32.9136800660565,2614429693
1314279000,118.73,119.39999,115.87,116.28,NaN,NaN,104.3,134.57392065217388,128.56465175000037,129.50506950000002,126.32001879999994,118.90749850000012,124.25417686939345,119.32906999103997,116.59846000000014,121.97831693746345,111.21860306253684,128.56465175000037,129.50506950000002,126.32001879999994,118.90749850000012,117.18332999999998,312365312,415450871.2,41.870903978440936,0.8591589789472485,1.5,2.75,NaN,NaN,3.425561607521768,0.7518706389945825,389.70580322063546,0.1982267972417211,-3.3842177752974294,-3.5824445725391505,39.358582976318125,-1.5577378936674597,36.26682666424658,30.64679339668182,33.08637993907159,2302064381
1314365400,115.69,118.50999,113.85001,117.97,NaN,NaN,103.8025,134.5417469565217,128.5440017000004,129.35236940000001,126.13341879999994,118.3394985000001,124.00773856078979,119.19963475379807,116.63615230769246,122.04696305708886,111.22534155829605,128.5440017000004,129.35236940000001,126.13341879999994,118.3394985000001,116.77666666666669,314495744,415823530.4,45.13544542600582,0.868592132396096,1.5,2.75,NaN,NaN,3.5137343498416422,0.7563202200161013,394.90596347457637,0.40138019679782655,-3.0807193265418675,-3.482099523339694,40.14407203521571,-2.196982258331956,73.14354519169315,6.024140783363809,20.83231402494304,2616560125
1314624600,119.56,121.42999,118.0569,121.36,NaN,NaN,103.30499999999999,134.50957326086953,128.5426267500004,129.22936940000002,126.01961879999993,117.9684985000001,123.90390567605293,119.40538382486491,117.33384538461551,122.66149067684844,112.00620009238258,128.5426267500004,129.22936940000002,126.01961879999993,117.9684985000001,120.2822966666667,190977184,409082853.6,51.0713819028646,2.38518850355595,1.5,2.75,NaN,NaN,3.509895467710097,0.46684230912972197,403.9852439159623,0.755759315760641,-2.5374003786388926,-3.2931596943995336,41.75041111622658,1.480056860941547,72.33695224783236,6.325993268513161,21.33705448365448,2807537309
1314711000,120.83,122.42999,119.25999,121.67999,NaN,NaN,102.80749999999999,134.47739956521735,128.5500367000004,129.11296920000004,125.89921859999993,117.77799750000011,123.81669329659988,119.6220129844016,117.66846000000015,123.47775632093943,111.85916367906087,128.5500367000004,129.11296920000004,125.89921859999993,117.77799750000011,121.12332333333332,241315680,403815952.8,51.60365115297481,2.5510198752549127,1.5,2.75,NaN,NaN,3.4856172200165187,0.5975882783400527,406.4766083115745,0.9887032524669275,-2.0572806288158745,-3.045983881282802,41.34238495821864,1.6796105958051324,70.45675680364867,7.152263879483876,22.39097931686744,3048852989
1314797400,122.46001,123.50999,121.3,122.22,NaN,NaN,102.31,123.50999,128.5609867000004,129.00656920000003,125.75461859999994,117.58049750000009,123.75407787320381,119.86944031922049,117.98384461538475,124.28159276596583,111.68609646480368,128.5609867000004,129.00656920000003,125.75461859999994,117.58049750000009,122.34332999999998,301828352,400355895.2,52.54192290990942,2.6035314753817587,1.5,2.75,NaN,NaN,3.394500990015339,0.7539001064271078,408.22271030757906,1.145110371128164,-1.614595917372597,-2.759706288500761,41.36322104408048,6.733045736882867,72.0546962085967,6.447078219197059,21.49822557220624,3350681341
1314883800,122.28999,123.39999,120.78,120.94,NaN,NaN,101.8125,123.19742564102565,128.5748867000004,128.89136910000002,125.60001859999993,117.6144980000001,123.64372187817621,119.97139838405663,118.00846000000016,124.34958258369298,111.66733741630733,128.5748867000004,128.89136910000002,125.60001859999993,117.6144980000001,121.70666333333334,254585872,387049092.8,50.0642900191999,1.8945498769877576,1.5,2.75,NaN,NaN,3.339178776442815,0.657761190339625,403.87351578930947,1.126587850900008,-1.3514714748757513,-2.4780593257757593,30.815232575052104,7.368607954545452,75.917997134976,4.88110636169472,19.200896503329272,3096095469
1314970200,118.42,120.8726,117.42999,117.85001,NaN,NaN,101.315,122.88486128205129,128.5730467500004,128.75516920000004,125.39099899999994,117.5029985000001,123.41651749079675,119.76936139509885,117.87461461538479,124.14966689882499,111.59956233194458,128.5730467500004,128.75516920000004,125.39099899999994,117.5029985000001,118.71753333333334,255517184,367046878.4,44.597041320050415,1.068780023972441,1.5,2.75,NaN,NaN,3.3513810066968994,0.696143187796145,398.1693669980492,0.8813167481528006,-1.3764133905847586,-2.2577301387375592,33.60725286291038,4.541834471746645,45.22046785517118,22.771743642464475,32.00778850236434,2840578285
1315315800,114.39,117.16,114.38,116.99001,NaN,NaN,100.8175,122.57229692307692,128.55820930000039,128.6104692,125.19459919999994,117.73949950000011,123.16449758919688,119.5046612622323,117.6684615384617,123.8696907523756,111.4672323245478,128.55820930000039,128.6104692,125.19459919999994,117.73949950000011,116.17667,285142784,346190827.2,43.18357513436499,2.3083692540396323,1.5,2.75,NaN,NaN,3.3598545062185496,0.8236578256744753,393.64749034990274,0.6470855962256241,-1.448873143455529,-2.095958739681153,34.251973934617055,0.4723548608725527,20.19473165776276,48.79111414194531,31.014154200291934,2555435501
1315402200,118.75999,120.34,118.36,120.28999,NaN,NaN,100.32,122.25973256410256,128.55820930000039,128.49776910000003,125.04159899999995,117.87999900000011,123.05177180138524,119.57945447535303,118.11307692307709,124.17192002980097,112.0542338163532,128.55820930000039,128.49776910000003,125.04159899999995,117.87999900000011,119.66332999999997,209803120,320789552.8,49.763169864193046,0.7683490381621577,1.5,2.75,NaN,NaN,3.359149898631511,0.6540210495283935,400.8706415350489,0.6960582217881566,-1.2258859624459575,-1.921944184234114,32.93207661318751,1.871603997289977,18.5688788353295,51.01993701215306,30.411184152517446,2765238621
1315488600,119.57001,120.94,118.77,119.03999,NaN,NaN,99.82249999999999,121.94716820512821,128.55245925000042,128.36776910000003,124.83019879999996,118.21749900000012,122.89444702486033,119.52807690627179,118.605383846154,123.78106579409656,113.42970189821143,128.55245925000042,128.36776910000003,124.83019879999996,118.21749900000012,119.58332999999999,250568192,300187594.4,47.51840683210882,0.4283069134322662,1.5,2.75,NaN,NaN,3.274210620157832,0.8347053531669862,398.4988345941715,0.62801471105426,-1.136925795416289,-1.764940506470549,33.00272135375921,2.37357241142071,2.8439120225148113,82.06222976447576,15.093858213009433,2514670429
1315575000,117.67999,119.05701,115.28,115.92,NaN,NaN,99.32499999999999,121.63460384615385,128.5398218000004,128.22136910000003,124.53419879999996,118.14699900000012,122.62093929839521,119.18445053424591,118.85076846153862,123.11035839932431,114.59117852375293,128.5398218000004,128.22136910000003,124.53419879999996,118.14699900000012,116.7523366666667,380195072,294798359.2,42.3797593709602,2.3867098529662245,1.5,2.75,NaN,NaN,3.31012486157513,1.2896783856997804,392.94149188645457,0.36942494061509934,-1.303159330701675,-1.6725842713167742,35.5325283105922,-1.7377299313384735,2.367480885426685,83.72228888938001,13.910230225193315,2134475357
1315834200,114.47,116.75999,114.05,116.67,NaN,NaN,98.8275,121.3220394871795,128.5221718000004,128.07496910000003,124.22819879999996,118.07449900000013,122.3875691298307,118.94497905479392,118.86846076923092,123.08958796833232,114.64733357012952,128.5221718000004,128.07496910000003,124.22819879999996,118.07449900000013,115.82666333333334,305793536,294401456.8,43.94890692222983,2.6349020408337793,1.5,2.75,NaN,NaN,3.267258085748335,1.0386957297148809,392.0093192259748,0.2510918957839936,-1.3587194015867823,-1.6098112973707759,34.60659121393022,-3.8645352669742894,15.502646662243512,55.41299497568006,29.084358362076426,2440268893
1315920600,117.05,118.17999,116.22,117.74001,NaN,NaN,98.33,121.00947512820514,128.5168718500004,127.92136910000004,123.90459899999996,117.93049950000014,122.20531190905302,118.8302200971945,118.84230769230786,123.08679958615606,114.59781579845965,128.5168718500004,127.92136910000004,123.90459899999996,117.93049950000014,117.38,272514560,295086656.8,46.19994425615602,0.7454551956313463,1.5,2.75,NaN,NaN,3.1738817939091684,0.923506887621494,397.1183010144777,0.2467222644629432,-1.3014084667920969,-1.54813073125504,30.101209214399532,-3.237985144476101,38.841194332758896,28.27422091174921,32.8845847554919,2712783453
1316007000,118.34,120.8,116.72,119.37,NaN,NaN,97.8325,120.69691076923077,128.5179118500004,127.77726910000003,123.61579899999995,117.91949950000011,122.09412320673722,118.8816277069855,119.08000000000015,123.06186780296377,115.09813219703653,128.5179118500004,127.77726910000003,123.61579899999995,117.91949950000011,118.96333333333331,319389440,296351373.6,49.52541517147195,1.06782334595952,1.5,2.75,NaN,NaN,3.2386045229156566,1.0777390235116493,401.48178586033197,0.34918604162325906,-1.1116481792259663,-1.4608342208492253,31.50575744064947,-2.331860579283255,43.38177066397108,24.359888060325076,32.258341275703835,3032172893
1316093400,120.64999,121.47,119.4034,121.42999,NaN,NaN,97.335,120.38434641025641,128.5325993500004,127.65516900000004,123.36499879999994,118.00749900000012,122.06807876725733,119.12432887774878,119.34615307692323,123.4561445579671,115.23616159587937,128.5325993500004,127.65516900000004,123.36499879999994,118.00749900000012,120.76779666666668,326777088,300780175.2,53.442183529742344,1.9007723458909025,1.5,2.75,NaN,NaN,3.1572756284216807,1.0864316033552202,406.3070922847523,0.539885338820173,-0.7859775473240092,-1.3258628861441821,33.22925768726057,0.4051513147015098,70.01560302206516,7.398856867537887,22.585540110396956,3358949981
1316179800,121.28999,121.97,120.32001,121.521,NaN,NaN,96.83749999999999,120.07178205128206,128.5351544000004,127.52246900000006,123.08821879999994,118.35804950000013,122.04662469795312,119.35258327034414,119.35853769230786,123.49362147724675,115.22345390736898,128.5351544000004,127.52246900000006,123.08821879999994,118.35804950000013,121.27033666666667,284528128,289358773.6,53.613443534392786,1.679763199551098,1.5,2.75,NaN,NaN,3.0496123692487034,0.983305688160409,407.19519835632605,0.6490059666967818,-0.5146054277732048,-1.1636113944699866,32.62863404443247,3.114967915573366,100,0,0,3643478109
1316439000,119.53,120.92999,118.72,120.31,NaN,NaN,96.33999999999999,119.7592176923077,128.52390440000042,127.36886900000005,122.80641899999995,118.74154950000013,121.97852176862163,119.44376581602565,119.25315384615399,123.2123009218678,115.29400677044019,128.52390440000042,127.36886900000005,122.80641899999995,118.74154950000013,119.98666333333334,241516944,280020553.6,50.928918176255046,0.5470185256411971,1.5,2.75,NaN,NaN,3.031854342873796,0.8624972020625273,402.2526715300386,0.6167039291125702,-0.39273148307927386,-1.009435412191844,29.01719699245204,2.837840598526322,80.4564768810638,3.285509893305642,16.258013225630574,3401961165
1316525400,120.82001,121.99001,120.00999,120.17,NaN,NaN,95.8425,119.44665333333334,128.5103044000004,127.20946900000004,122.57041899999994,119.11354950000013,121.90759934632274,119.51293097640415,119.09546153846169,122.71839743384271,115.47252564308067,128.5103044000004,127.20946900000004,122.57041899999994,119.11354950000013,120.72333333333334,218932128,277212625.6,50.61339746313077,1.1498230071285087,1.5,2.75,NaN,NaN,2.9567233183828106,0.7897624703281191,399.34224402960257,0.5643973557644664,-0.3039387174862611,-0.8683360732507275,28.499790509959425,-0.09975061100262904,57.47220584153066,14.081067474704163,28.446726683765178,3183029037
1316611800,120.23,120.60001,116.44,116.63,NaN,NaN,95.345,119.13408897435897,128.47965445000042,127.01146910000003,122.27501919999995,119.12304950000014,121.70063466607479,119.23836612150852,118.76392307692322,122.43944113874133,115.08840501510511,128.47965445000042,127.01146910000003,122.27501919999995,119.12304950000014,117.89000333333333,316251136,276468356.8,43.30731467489757,1.025840929059372,1.5,2.75,NaN,NaN,3.0426723670697524,1.1438963202171424,393.15491674975675,0.28402789123954053,-0.5133012092013018,-0.7973291004408424,29.112652204700655,-2.024521339425522,26.273762130437543,40.93304326069822,32.79319460886424,2866777901
1316698200,113.25,114.21001,111.3,112.86,NaN,NaN,94.8475,118.82152461538462,128.4298044500004,126.77786910000005,121.89541919999994,118.86204950000015,121.35394311054245,118.63090268136484,118.3800761538463,123.21620072835087,113.54395157934174,128.4298044500004,126.77786910000005,121.89541919999994,118.86204950000015,112.79000333333333,513920000,289820872.8,37.15596500238682,5.064859557328108,1.5,2.75,NaN,NaN,3.2060529122790555,1.7732332217308815,385.42348738643716,-0.13991496423874872,-0.9722228057392783,-0.8323078415005296,33.65875216634094,-2.639751552795033,4.093669346585307,78.03390024200017,17.872430411414502,2352857901
1316784600,112.11,114.16,112.02,113.53999,NaN,NaN,94.35,118.50896025641026,128.38110440000042,126.55596900000005,121.54761919999996,118.72504900000015,121.04751357679568,118.1460538545682,118.11469000000014,123.56629217667808,112.6630878233222,128.38110440000042,126.55596900000005,121.54761919999996,118.72504900000015,113.23999666666667,307242496,289564732,38.84329148227914,3.7798781652958144,1.5,2.75,NaN,NaN,3.1299062756876945,1.0610494374708588,388.4156339698235,-0.34731619435393113,-1.2664530844429436,-0.9191368900890124,31.251291569044277,-2.6827890631696225,4.157296551682588,77.85282355610455,17.989879892212862,2660100397
1317043800,114.61,116.39999,112.98,116.24001,NaN,NaN,93.85249999999999,118.1963958974359,128.34350450000045,126.37006910000004,121.23861939999998,118.63854950000015,120.85898402476448,117.96452586841885,117.80315307692322,123.18433587959265,112.4219702742538,128.34350450000045,126.37006910000004,121.23861939999998,118.63854950000015,115.20666666666666,260673632,286873626.4,45.141644298911494,1.8414317409381369,1.5,2.75,NaN,NaN,3.1506265417100017,0.908670606187171,393.0632139852724,-0.27841581429964446,-1.267156657963568,-0.9887408436639236,34.32606124977347,-1.2739934368954104,15.092851213912699,55.91040632310838,28.99674246297893,2920774029
1317130200,118.53,119.56,116.84,117.53999,NaN,NaN,93.35499999999999,117.88383153846155,128.30880445000045,126.20936900000002,120.97721919999998,118.44754900000017,120.72882739634234,117.92409388095038,117.68776846153861,123.02204310659437,112.35349381648285,128.30880445000045,126.20936900000002,120.97721919999998,118.44754900000017,117.97999666666668,311753728,292912453.6,47.92255427181152,0.8251006999460698,1.5,2.75,NaN,NaN,3.162723931587859,1.0643239103303186,399.4464026899259,-0.12865952571051698,-1.1495652508020697,-1.0209057250915528,34.545550868623856,-1.5330568819636436,34.56177941194133,32.15933277901672,33.278887809041926,3232527757
1317216600,117.78,118.49001,114.97,115.145,NaN,NaN,92.85749999999999,117.5712671794872,128.26172945000044,126.01881900000002,120.6255192,118.12079950000016,120.50985377295636,117.65941827324082,117.62815307692321,123.05661209204303,112.1996940618034,128.26172945000044,126.01881900000002,120.6255192,118.12079950000016,116.20167,286696704,295181504.8,43.54314389460129,0.9293974228705228,1.5,2.75,NaN,NaN,3.188244365045869,0.9712556489413221,393.4817632978986,-0.17158590439150823,-1.2353881055809381,-1.06380220118943,35.09689199800556,-5.175813651965225,35.97554724906533,30.79808821427486,33.226364536659794,2945831053
1317303000,117.05,117.63,113.92999,116.05,NaN,NaN,92.35999999999999,117.25870282051282,128.21862945000044,125.83211900000002,120.29351940000001,117.81229950000018,120.33495754656592,117.50614034245598,117.5804607692309,123.05247303419854,112.10844850426325,128.21862945000044,125.83211900000002,120.29351940000001,117.81229950000018,115.86999666666667,298108928,294995533.6,45.56739489790471,1.5356945703283176,1.5,2.75,NaN,NaN,3.224799053256878,1.0105540391137637,397.81358807301973,-0.12204304292486268,-1.2163560048455082,-1.0943129619206455,33.462673584424216,-4.502102517260394,76.17337961050994,4.779781972990347,19.046838416499707,3243939981
1317389400,114.45,115.45,113.07001,113.14999,NaN,NaN,91.8625,116.94613846153847,128.16388935000043,125.60491890000002,119.86671899999999,117.42279900000017,120.05319411336725,117.0912688812697,117.22738230769245,123.18356751741815,111.27119709796675,128.16388935000043,125.60491890000002,119.86671899999999,117.42279900000017,113.89,288685568,296700518.4,40.55004269165348,2.1961454738121344,1.5,2.75,NaN,NaN,3.207312692309958,0.9729863956988625,391.60960856772414,-0.2596880600455884,-1.4189230369776311,-1.1592349769320427,35.24667189131131,-5.9513008062505195,47.243350778566864,21.18064469580625,31.57600452562687,2955254413
1317648600,112.49001,113.95,109.81,109.92999,NaN,NaN,91.365,116.63357410256411,128.08943925000045,125.35981880000001,119.37371879999999,117.02679800000017,119.65620571676462,116.40924232114878,116.50122769230785,123.45389578906563,109.54855959555007,128.08943925000045,125.35981880000001,119.37371879999999,117.02679800000017,111.22999666666664,365136640,302181491.2,35.83228192872866,4.2876878618234135,1.5,2.75,NaN,NaN,3.2739332142878186,1.2083355553975108,382.67255269109813,-0.5272723664146368,-1.8183254349503386,-1.2910530685357018,37.39960828631033,-8.52126986768744,19.86983758692115,49.05804645872256,31.072115954356292,2590117773
1317735000,108.35001,112.58,107.42999,112.34,NaN,NaN,107.42999,116.32100974358976,128.02963925000046,125.13241880000001,118.94391879999999,116.79429750000017,119.3692956886562,116.02169543342032,115.80199769230784,122.45310063660429,109.15089474801138,128.02963925000046,125.13241880000001,118.94391879999999,116.79429750000017,110.78333000000002,459177472,310883225.6,41.3337730057615,4.666085396261489,1.5,2.75,NaN,NaN,3.4079386989815457,1.4770094819808766,385.2254415212884,-0.5017770445908478,-1.9182743742742616,-1.4164973296834138,41.24734984722819,-3.6782988939380883,25.126944799138617,42.39198855142824,32.481066649433146,3049295245
1317821400,112.62,114.72,111.58,114.42,NaN,NaN,107.35716923076923,116.0084453846154,127.97873920000046,124.93621890000003,118.5657188,116.50079800000017,119.17520566165007,115.86915301118981,115.25576692307708,121.04952880062477,109.46200504552938,127.97873920000046,124.93621890000003,118.5657188,116.50079800000017,113.57333333333334,284108032,314598471.2,45.66372289680107,1.1814510746085158,1.5,2.75,NaN,NaN,3.388800220482864,0.9030814133212482,389.3290382574261,-0.31383841246351585,-1.8087953452628085,-1.4949569327992926,40.622669171285956,1.3822434875066474,48.382349207567636,20.37243650449674,31.245214287935617,3333403277
1317907800,114.36,116.66,113.50999,116.49001,NaN,NaN,107.28434846153847,115.69588102564103,127.93423925000046,124.769219,118.2835188,116.37329900000016,119.06990387099712,115.92828224821935,114.9619215384617,120.04433607066834,109.87950700625505,127.93423925000046,124.769219,118.2835188,116.37329900000016,115.55333333333333,257800752,314960099.2,49.64677336625446,0.6257617294514479,1.5,2.75,NaN,NaN,3.371743776162659,0.8185187668368629,394.97068030562446,-0.03385775137434566,-1.5372791220172246,-1.503421370642879,36.7455455523834,2.5982211201533443,47.01340263189796,21.41115535116345,31.575442016938574,3591204029
1317994200,117.17,117.245,115.06,115.71001,NaN,NaN,107.2115276923077,115.38331666666667,127.88388930000046,124.59461910000002,117.99331899999999,116.36279950000014,118.93814332703646,115.9074944150556,114.61884538461553,118.76450059571447,110.47319017351658,127.88388930000046,124.59461910000002,117.99331899999999,116.36279950000014,116.00500333333333,312657920,311583241.6,48.212626705107915,0.7436093792773957,1.5,2.75,NaN,NaN,3.286976363579612,1.0034490892208496,390.7459335855849,0.1073322100244094,-1.369256108112367,-1.4765883181367765,37.10844724745238,-0.455953161050142,45.36238444721611,22.70099625962067,31.93661929316321,3278546109
1318253400,117.67999,119.63,117.67,119.58,NaN,NaN,107.13870692307692,115.07075230769232,127.85378925000049,124.44681910000001,117.79831899999999,116.50829950000013,118.9633141769566,116.25725685171696,114.84576846153861,119.67372789110873,110.0178090319685,127.85378925000049,124.44681910000001,117.79831899999999,116.50829950000013,118.96,230666192,307826874.4,55.13714227055438,2.6003716968903055,1.5,2.75,NaN,NaN,3.3321916233239253,0.7493374074294276,397.6509495365454,0.45063630535579446,-0.9132929364420335,-1.363929241797828,39.424167189385095,1.7355880326346762,74.94538031786674,5.252797656774956,19.801822025358323,3509212301
1318339800,118.87,120.03999,118.75,119.7,NaN,NaN,107.06588615384617,114.75818794871796,127.82403930000048,124.29701920000001,117.61671899999999,116.60629900000012,118.99220381707595,116.58513715155344,115.37192230769247,120.68594642282193,110.05789819256302,127.82403930000048,124.29701920000001,117.61671899999999,116.60629900000012,119.49666333333334,209087936,304655543.2,55.3365645719526,2.690695392587241,1.5,2.75,NaN,NaN,3.186320078800788,0.686309311177503,399.3764270725547,0.6622823638404336,-0.5360762869972859,-1.1983586508377195,39.07267435886931,3.9558817143601606,69.86678751086728,7.415946469945687,22.717266019187015,3718300237
1318426200,120.60001,122.14,120.33,120.75,NaN,NaN,106.99306538461539,114.4456235897436,127.79863930000047,124.1684192,117.52191879999998,116.67529900000014,119.06113700072002,116.9817907561674,115.92653846153863,121.83208280905885,110.02099411401841,127.79863930000047,124.1684192,117.52191879999998,116.67529900000014,121.07333333333334,281544704,302763306.4,57.132170460621154,3.571209168621196,1.5,2.75,NaN,NaN,3.1330115017435887,0.9299168626069676,405.1415258259468,0.8381538312325695,-0.15066636179700765,-0.9888201930295771,36.461952275934195,4.049978457561399,70.2024277052277,7.262549507912115,22.535022786860164,3999844941
1318512600,120.03999,120.87,119.12,120.50999,NaN,NaN,106.92024461538462,114.13305923076925,127.77158925000047,124.05291910000001,117.40871859999997,116.62929900000013,119.11795476539767,117.31780973177051,116.25499846153863,122.64856425611032,109.86143266696695,127.77158925000047,124.05291910000001,117.40871859999997,116.62929900000013,120.16666333333333,212538816,297051392.8,56.572300129442496,2.297262883989559,1.5,2.75,NaN,NaN,3.034224965904761,0.715495100011529,403.7824604031178,0.8981472584385033,0.1338638800185521,-0.7642833784199512,36.593659849447626,6.504640433463583,43.74953811657179,23.946972935596328,32.30348894783188,3787306125
1318599000,121.91,122.60001,121.23,122.57001,NaN,NaN,106.84742384615384,113.82049487179488,127.75583930000046,123.9591192,117.45491899999999,116.68174950000011,119.25332948048012,117.8180192811257,116.64192307692323,123.85589244249398,109.42795371135249,127.75583930000046,123.9591192,117.45491899999999,116.68174950000011,122.13334000000002,211397568,293394864.8,60.17927164859096,3.1751890002525234,1.5,2.75,NaN,NaN,2.966781754054421,0.7205223859119159,409.1525847307398,1.027101102429905,0.51959299961743,-0.5075081028124749,32.07325457702092,11.498245383266196,77.44106361348175,4.31506895536777,18.243867431150484,3998703693
1318858200,121.99001,122.54919,119.92999,120.23,NaN,NaN,106.77460307692309,113.50793051282052,127.72823930000045,123.8375192,117.45791899999999,116.67774950000012,119.29163028516717,118.0477317305423,117.03307692307709,124.42910289390974,109.63705095224444,127.72823930000045,123.8375192,117.45791899999999,116.67774950000012,120.90306,202311568,291434596,54.62881604076971,1.97744285961079,1.5,2.75,NaN,NaN,2.943441628764819,0.6941920100659567,404.2444543749176,0.9093774195877318,0.6292136716721899,-0.28016374791554194,28.296807296686655,7.023322058038098,51.802684406143634,17.8171121811129,30.380203412743473,3796392125
1318944600,120.14,123.5,119.2,122.58,NaN,NaN,106.70178230769231,113.19536615384617,127.70588930000048,123.73331920000001,117.6643192,116.79824950000011,119.42058596025866,118.4793763276335,117.53538461538477,125.46392598240652,109.60684324836302,127.70588930000048,123.73331920000001,117.6643192,116.79824950000011,121.75999999999999,318857984,296430888.8,58.744124099796714,2.5071461196431577,1.5,2.75,NaN,NaN,3.040338655281617,1.0756570790945184,409.7441047134531,0.9404451382419702,0.8953926748869208,-0.045052463355049394,27.943661302854988,7.131620346093337,56.93556988406913,14.415692880573664,28.648737235357217,4115250109
1319031000,122.38,123.08,120.71001,121.13,NaN,NaN,106.62896153846154,112.88280179487181,127.67663930000047,123.60951929999999,117.7373192,117.0232495000001,119.4876218049544,118.7318166773827,118.14923153846169,125.85720574950719,110.4412573274162,127.67663930000047,123.60951929999999,117.7373192,117.0232495000001,121.64000333333333,226601248,291948394.4,55.40482986764383,1.8541264847397112,1.5,2.75,NaN,NaN,2.9924566084757873,0.776168844722374,405.52167089296273,0.8184932164272033,0.9780640571789547,0.15957084075175143,29.47708255406234,3.983165595058321,27.792947533311605,39.20002774490913,33.00702472177927,3888648861
1319117400,121.42999,122.10001,119.82001,121.66,NaN,NaN,106.55614076923078,112.57023743589745,127.64673930000048,123.47711939999999,117.9247194,117.4632495000001,119.5728131067209,119.01069127953673,119.05154000000016,125.30951441718547,112.79356558281485,127.64673930000048,123.47711939999999,117.9247194,117.4632495000001,121.19334,262075632,279356176,56.38085269880861,1.448563869810237,1.5,2.75,NaN,NaN,2.9415668507275172,0.9381415358434746,407.90371986461946,0.7315179324616365,1.073968256328797,0.34245032386716057,28.429398987720674,5.142156672529888,55.03014264850107,15.636353331219292,29.333504020279637,4150724493
1319203800,123.09,124.12,122.72,123.97,NaN,NaN,106.48332,112.25767307692308,127.62963930000049,123.39811939999998,118.0575194,117.98475000000008,119.74525180841812,119.48300639577133,119.94615538461555,125.38163413493747,114.51067663429363,127.62963930000049,123.39811939999998,118.0575194,117.98475000000008,123.60333333333334,278999296,277944016,60.44436268656809,2.6442496148357475,1.5,2.75,NaN,NaN,2.907169218532695,1.0037967358145965,413.8956499214919,0.7829528798516844,1.321141423681766,0.5381885438300816,28.568879768650497,3.6711824719852824,57.85097418813486,13.846627769054138,28.302398042810992,4429723789
1319463000,124.17,125.8,124.06,125.49001,NaN,NaN,106.41049923076923,111.94510871794873,127.6213893500005,123.33571949999998,118.20491960000001,118.44725000000008,119.97053644338212,120.05510197712644,120.79769461538477,125.96530908982677,115.63008014094277,127.6213893500005,123.33571949999998,118.20491960000001,118.44725000000008,125.11667000000001,203215568,275071112.8,62.893924127075955,3.4560050032696945,1.5,2.75,NaN,NaN,2.830228560066074,0.7387746606011476,419.0591731209155,0.8662445496416635,1.620994230882161,0.7547496812404975,23.74744862840922,4.837101086048451,80.49967745834762,3.281140182285757,16.219182359366627,4632939357
1319549400,124.89,124.95,122.78,123.049,NaN,NaN,106.33767846153847,111.63254435897437,127.6017343500005,123.26200949999999,118.25349960000001,118.72270050000006,120.09126050442596,120.34023512216201,121.30223230769246,125.94291360446714,116.66155101091779,127.6017343500005,123.26200949999999,118.25349960000001,118.72270050000006,123.593,268596736,272913263.2,56.80963622822549,1.8627704150975841,1.5,2.75,NaN,NaN,2.8216415200613545,0.9841835198869148,413.55805549974366,0.7103797196143657,1.6427243307584547,0.932344611144089,27.59645687142805,1.9039337474120137,49.142896396353194,19.759062383701952,31.098041219944854,4364342621
1319635800,124.35001,124.77,122.21001,124.3,NaN,NaN,106.2648576923077,111.31998000000002,127.58608440000049,123.21455949999998,118.34769960000001,119.18045050000008,120.25630911209554,120.71735558671801,121.96300076923093,125.55912756346657,118.36687397499529,127.58608440000049,123.21455949999998,118.34769960000001,119.18045050000008,123.76000333333333,289053696,273031112.8,58.998760824604915,1.8537181170145103,1.5,2.75,NaN,NaN,2.8029521257712573,1.0586840929434178,418.79284155789605,0.6467832745928033,1.7408237043850932,1.0940404297922899,27.71673327814796,3.1449757816758552,76.29856893788538,4.734242815641806,18.967188246472837,4653396317
1319722200,127.63,129.42,124.3187,128.63,NaN,NaN,106.19203692307693,129.42,127.58633440000048,123.21125939999996,118.52689960000002,119.80945050000007,120.58468914691532,121.47094076893535,122.65915461538476,127.44694066259032,117.87136856817921,127.58633440000048,123.21125939999996,118.52689960000002,119.80945050000007,127.45623333333333,390025728,277626952.8,65.51414320631446,4.575817207397846,1.5,2.75,NaN,NaN,2.968455545359024,1.4048554150323116,425.4488078132532,0.839373133474314,2.1432568466351825,1.3038837131608685,32.713739438279134,4.94410500578404,79.05163903709675,3.7547698505336466,17.19359111236961,5043422045
1319808600,128,128.85001,127.8,128.60001,NaN,NaN,106.11921615384617,129.56775025,127.58749700000048,123.21305949999996,118.80870000000003,120.58195150000009,120.89901545487943,122.14989974332246,123.34377076923093,128.74871111780135,117.93883042066051,127.58749700000048,123.21305949999996,118.80870000000003,120.58195150000009,128.41667333333334,225906496,274487999.2,65.43658338587252,3.7799165628090545,1.5,2.75,NaN,NaN,2.8314237206905224,0.8230104655154629,424.6008095092481,0.9022822486192947,2.431736523934987,1.5294542753156921,32.19259132333372,6.961665141811522,54.85182570964853,15.783797508468561,29.364376781882896,4817515549
1320067800,127.16,128.6239,125.32001,125.5,NaN,NaN,106.0463953846154,129.7155005,127.56849700000048,123.17405959999996,119.06590000000001,121.36045200000008,121.07944622135474,122.46895691062508,123.70915538461554,129.0044242839241,118.41388648530697,127.56849700000048,123.17405959999996,119.06590000000001,121.36045200000008,126.48130333333332,228146624,267638498.4,57.81704078798575,2.090004652215346,1.5,2.75,NaN,NaN,2.86517131206977,0.8524432223462213,418.7819050485436,0.682634198124408,2.382747022971202,1.700112824846794,33.69096095828512,2.3821178006200046,31.55229562935023,35.14675363031865,33.30095074033112,4589368925
1320154200,122.03,123.50999,121.52,122.002,NaN,NaN,105.97357461538462,129.86325075,127.53090700000048,123.11807949999996,119.25134000000004,121.84355200000007,121.11562480090946,122.42448482389888,123.82392538461553,128.89687229599386,118.75097847323723,127.53090700000048,123.11807949999996,119.25134000000004,121.84355200000007,122.34399666666667,416565760,265507912.8,50.65015536657597,1.0238834845976348,1.5,2.75,NaN,NaN,2.944801932636216,1.568939153665781,411.73224729666623,0.2704444505635055,2.038168388051176,1.7677239374876703,36.82853832447264,0.7198877239329645,25.9394376274706,41.321466361965456,32.73909601056396,4172803165
1320240600,123.83,124.39999,122.7905,123.99001,NaN,NaN,105.90075384615385,130.011001,127.50960705000048,123.08097959999995,119.40234020000005,122.32205250000007,121.22834578910908,122.57358245971804,123.93315615384631,128.95428815320693,118.91202415448569,127.50960705000048,123.08097959999995,119.40234020000005,122.32205250000007,123.72683333333333,245529376,263578980,54.13020057376051,0.06208949069600554,1.5,2.75,NaN,NaN,2.9057439374479155,0.9315210795640836,417.4753828999214,0.10866890938480323,1.9035600742186745,1.7948911648338712,37.16120734517603,1.91518165378925,24.00824203484095,43.627867855230036,32.36389010992901,4418332541
1320327000,125.27,126.5,123.595,126.25,NaN,NaN,105.82793307692309,130.15875125,127.50045705000048,123.05027949999996,119.56574020000005,122.81005200000007,121.42527340522246,122.92371746355441,124.39623307692324,129.06379439486923,119.72867175897723,127.50045705000048,123.05027949999996,119.56574020000005,122.81005200000007,125.44833333333335,291174912,265247688,57.77552349265407,1.561581900483397,1.5,2.75,NaN,NaN,2.9056907990587786,1.0977472195723719,422.0209851702482,0.12943813240626656,1.9566888303417045,1.827250697935438,38.24795687517245,1.839154634185691,19.11446162687984,49.977750089766445,30.907788283353725,4709507453
1320413400,125.23,125.7,124.00999,125.481,NaN,NaN,105.75511230769231,130.3065015,127.48601205000048,123.03488949999995,119.74976020000005,123.29860150000009,121.58432150697844,123.16726818131113,124.61938692307709,129.19475796358577,120.04401588256842,127.48601205000048,123.03488949999995,119.74976020000005,123.29860150000009,125.06366333333334,249401504,262084867.2,56.14062455931278,0.8345683215931573,1.5,2.75,NaN,NaN,2.8581421705545798,0.951605892642702,420.868236789712,0.0699360389448791,1.9146707466165367,1.8447347076716576,37.310860071123116,-0.007179854396380648,18.607006806216642,50.68363833575815,30.709354858025208,4460105949
1320676200,125.39,126.39,124.2,126.25999,NaN,NaN,105.68229153846154,130.45425175,127.47181195000049,123.02448939999996,119.91556000000004,123.6326010000001,121.76768105572438,123.46181311642435,125.0140015384617,129.1844821911056,120.84352088581781,127.47181195000049,123.02448939999996,119.91556000000004,123.6326010000001,125.61666333333334,196617184,260382416.8,57.454020805862946,0.9666811489290954,1.5,2.75,NaN,NaN,2.810417729800681,0.7551092981482764,422.2935714687851,0.06187034452140483,1.9220726383234137,1.8602022938020089,36.82206882280567,2.6095214101699282,36.17575427408031,30.599179300149807,33.225066425769874,4656723133
1320762600,126.92,128.02,125.71001,127.88,NaN,NaN,105.60947076923078,130.60200199999997,127.4653619500005,123.03278939999997,120.04596000000005,124.0416010000001,122.00737983785284,123.88259281962203,125.49246307692323,129.43495521859163,121.54997093525485,127.4653619500005,123.03278939999997,120.04596000000005,124.0416010000001,127.20333666666666,224426192,261149329.6,60.128079748585414,1.9188372188552367,1.5,2.75,NaN,NaN,2.7746728919577763,0.8593787789681541,425.98049519913354,0.1399977221495381,2.0351994464889316,1.8952017243393935,34.951207057275035,2.880128720836684,74.72735564006747,5.334434358022871,19.938210001909656,4881149325
1320849000,124.89,125.8,122.86,123.161,NaN,NaN,105.53665000000001,130.74975224999997,127.4328169500005,122.98739939999996,120.07558020000006,124.16215100000011,122.05261984421155,123.81386969394374,125.43023230769246,129.4906614437572,121.36980317162771,127.4328169500005,122.98739939999996,120.07558020000006,124.16215100000011,123.94033333333334,337981952,263971192,50.22539832673524,0.9710367296448675,1.5,2.75,NaN,NaN,2.935053399675078,1.2803743826712728,418.25660132458,-0.13680621097652734,1.7241939606187344,1.8610001715952618,41.848480868496935,-4.251729767550334,39.61396524847774,27.45349855959035,32.932536191931916,4543167373
1320935400,124.78999,124.94,123.02,124.32001,NaN,NaN,105.46382923076924,130.89750249999997,127.4044669500005,122.93609949999994,120.11758040000007,124.3526520000001,122.14153710522287,123.86207353261577,125.34023230769246,129.44301731674912,121.23744729863579,127.4044669500005,122.93609949999994,120.11758040000007,124.3526520000001,124.09333666666664,231866496,264937576,52.303119833622965,0.4699518852614353,1.5,2.75,NaN,NaN,2.8625495854125727,0.8751740674188097,422.51854678463434,-0.24613101882515354,1.55333639806382,1.7994674168889735,36.27734156342691,-3.3281490413569963,36.43700542617064,30.352727347358652,33.210267226470705,4775033869
1321021800,125.83,126.99001,125.78999,126.66,NaN,NaN,105.39100846153848,131.04525274999997,127.39916695000049,122.91599949999994,120.23198040000007,124.5571515000001,122.31873172854746,124.12854271998569,125.6180015384617,129.54799516855124,121.68800790837214,127.39916695000049,122.91599949999994,120.23198040000007,124.5571515000001,126.48000000000002,189924320,263863913.6,56.27185482239757,1.3051893061807849,1.5,2.75,NaN,NaN,2.848796043597389,0.7197813350404275,428.07218137315897,-0.16882380148714482,1.5884376650300425,1.7572614665171873,38.430546980195835,0.9243027888446188,63.88776750089383,10.387085090352583,25.72514740875357,4964958189
1321281000,126.19,127.45,124.92,125.46001,NaN,NaN,105.3181876923077,131.19300299999998,127.38306705000048,122.88758969999995,120.38418040000006,124.81865200000009,122.44191911174168,124.2553491276061,125.70723307692325,129.56549438620127,121.84897176764522,127.38306705000048,122.88758969999995,120.38418040000006,124.81865200000009,125.94333666666667,159258256,261711248,53.79962040993804,0.726315091900891,1.5,2.75,NaN,NaN,2.826024897626147,0.6085266002781814,423.7288879763385,-0.20412028847042185,1.5021111059291599,1.7062313943995817,36.07055976875769,2.834387960853102,43.683884710836836,23.973019252189584,32.343096036973584,4805699933
1321367400,125.17,126.75,124.72,126.08299,NaN,NaN,105.24536692307693,131.34075324999998,127.35978195000047,122.88031959999996,120.56604000000004,124.99380150000009,122.58470620539887,124.42941016307218,125.5113092307694,128.9966496449117,122.02596881662708,127.35978195000047,122.88031959999996,120.56604000000004,124.99380150000009,125.85099666666666,184709376,255003817.6,54.90722946398677,0.9144246654504559,1.5,2.75,NaN,NaN,2.7691659763671366,0.724339650042949,426.41293000891795,-0.19134137761727854,1.4670546723779836,1.6583960499952621,31.286715477924183,1.6880230915377756,41.27956278895874,25.98637089687954,32.734066314161716,4990409309
1321453800,124.81,126.34,123.89999,124.08,NaN,NaN,105.17254615384617,131.48850349999998,127.32775695000048,122.84171959999996,120.64184020000005,125.14130150000008,122.64334517773618,124.39613300468434,125.1636161538463,128.22286142756872,122.1043708801239,127.32775695000048,122.84171959999996,120.64184020000005,125.14130150000008,124.77333,235782432,255462876.8,50.69872894734642,0.28276295382633726,1.5,2.75,NaN,NaN,2.7456548351980556,0.922961625397307,422.5594826427569,-0.3162467953498558,1.2630875558079424,1.5793343511577982,31.884097261639916,-1.7188118811881201,49.11950305336045,19.7506383609428,31.129858585696745,4754626877
1321540200,123.85001,124.16,121.23,122.105,NaN,NaN,105.0997253846154,131.63625374999998,127.28438195000048,122.76666959999994,120.70314040000002,125.16355150000008,122.62223360213868,124.17792986138107,124.90246230769246,128.35642554844625,121.44849906693865,127.28438195000048,122.76666959999994,120.70314040000002,125.16355150000008,122.49833333333333,331219712,258920080.8,46.88292903818054,2.3185247190204072,1.5,2.75,NaN,NaN,2.7588223469696227,1.2792353183909557,417.77818998347834,-0.5183952876303017,0.931340241619921,1.4497355292502228,30.835326503590746,-2.6904471593308874,15.847894767753303,54.720154707076716,29.431950525169984,4423407165
1321626600,122.5,122.75,121.47,121.979,NaN,NaN,105.02690461538462,131.78400399999998,127.23852700000047,122.67925959999995,120.82432040000003,125.06400150000009,122.59700875499598,123.96850796982098,124.90069307692323,128.36061576598235,121.44077038786412,127.23852700000047,122.67925959999995,120.82432040000003,125.06400150000009,122.06633333333333,215580368,255749134.4,46.64174340973196,1.7755530602731957,1.5,2.75,NaN,NaN,2.6531921793289355,0.8429368431911298,419.6237292102611,-0.6391808964704779,0.6507594086621253,1.2899403051326033,30.806064030115046,-3.3906148733260655,3.361560673606933,80.22550252056237,16.412936805830693,4207826797
1321885800,120.2,120.35001,118.64999,119.661,NaN,NaN,104.95408384615385,131.93175424999998,127.17698200000046,122.55616959999996,120.88414040000004,124.77255100000009,122.48187115676085,123.5582691155523,124.56769230769247,129.00839348275406,120.12699113263086,127.17698200000046,122.55616959999996,120.88414040000004,124.77255100000009,119.55366666666667,229611632,257068937.6,42.32766016650655,3.364044441938611,1.5,2.75,NaN,NaN,2.70146488080544,0.8931908854630907,413.19064166347493,-0.841069541559375,0.2386033781833845,1.0796729197427595,31.519180511297293,-6.427119174225832,3.0567931694028516,81.20668811844413,15.736518712153003,3978215165
1321972200,119.39999,120.10001,118.52,119.19,NaN,NaN,104.88126307692309,132.07950449999998,127.11008195000046,122.40886959999996,120.91314020000002,124.5796010000001,122.3527781702212,123.1422434854997,124.02461538461556,129.1789930555578,118.87023771367329,127.11008195000046,122.40886959999996,120.91314020000002,124.5796010000001,119.27000333333332,216494816,254463841.6,41.48795290140176,3.0892658761731853,1.5,2.75,NaN,NaN,2.6213609607479085,0.850788130206394,410.3329036302279,-0.963420469474031,-0.1246026670997793,0.8388178023742517,29.397676336976282,-3.224234944503539,0,99.99999999999999,0,3761720349
1322058600,118.07001,119.19,116.56,116.56,NaN,NaN,104.80844230769232,132.22725475,127.03153695000046,122.23636959999996,120.85694020000003,124.19260100000008,122.12561039883998,122.51536315354736,123.33838461538478,129.75524442296287,116.92152480780668,127.03153695000046,122.23636959999996,120.85694020000003,124.19260100000008,117.43666666666667,224531632,251237738.4,37.06613842675253,4.268729226043123,1.5,2.75,NaN,NaN,2.6219780349802,0.8937018516004919,403.6290855785063,-1.1650913654013726,-0.6175464043774639,0.5475449610239087,24.493389546571414,-6.241963783625817,0,99.99999999999999,0,3537188717
1322231400,116.38,117.7,116.2,116.34,NaN,NaN,116.2,132.375005,126.95163195000046,122.06006959999996,120.75514040000003,123.57810100000009,121.89872371653253,121.92723332939998,122.57530846153863,129.73704854240037,115.41356838067686,126.95163195000046,122.06006959999996,120.75514040000003,123.57810100000009,116.74666666666667,99557008,236714302.4,36.71363968777916,4.491103199696158,1.5,2.75,NaN,NaN,2.5418367467673284,0.4205787609392883,402.5280449331197,-1.2494505102899942,-1.0142681768385842,0.2351823334514101,22.78858928221598,-8.147797252486967,0,99.99999999999999,0,3437631709
1322490600,119.53999,120.17999,118.82001,119.71001,NaN,NaN,116.4370272972973,132.52275525,126.88463200000045,121.90356969999998,120.71892060000003,123.13360100000007,121.81289180608027,121.71606920279046,121.94684769230784,128.54824283527876,115.34545254933694,126.88463200000045,121.90356969999998,120.71892060000003,123.13360100000007,119.57000333333333,210686000,235953277.6,45.295756698434865,1.3785063860185458,1.5,2.75,NaN,NaN,2.6345619791410906,0.8929140639324605,408.8175355569852,-1.023904874829047,-1.0446987600848985,-0.02079388525585163,27.100257925540078,-4.583133701328415,5.0597349298924446,75.52882998589531,19.41143508421224,3648317709
1322577000,120.05,121,119.61,120.05,NaN,NaN,116.6740545945946,132.6705055,126.81773205000044,121.76006979999997,120.71372060000003,122.86110100000008,121.74375879407712,121.55739594538184,121.70754000000014,128.34100381428541,115.07407618571484,126.81773205000044,121.76006979999997,120.71372060000003,122.86110100000008,120.22,199241504,234508021.6,46.09003554194934,0.5593204734593952,1.5,2.75,NaN,NaN,2.545664694916727,0.8496148773104485,408.25954334256346,-0.8069755132020222,-1.0295132767583794,-0.2225377635563572,27.379063716298663,-4.784935699890998,23.301432438046955,44.66461707695185,32.033950485001185,3847559213
1322663400,123.49001,125.22,119.9971,124.99001,NaN,NaN,116.9110818918919,132.81825575,126.77763215000046,121.69026989999996,120.81012080000004,123.01050150000007,121.87106276293684,121.8843115696312,121.7590784615386,128.48272939516048,115.03542752791672,126.77763215000046,121.69026989999996,120.81012080000004,123.01050150000007,123.40236999999999,324439552,229901711.2,56.07057220039277,2.30621921226545,1.5,2.75,NaN,NaN,2.73689578813696,1.4112098179110901,415.3947455899501,-0.3114166703409321,-0.6118086014825224,-0.30039193114159024,37.44797982393826,0.7334058671824627,60.59047003282518,12.300887592148163,27.108642375026655,4171998765
1322749800,124.85001,125.64,124.42999,124.97,NaN,NaN,117.14810918918919,132.966006,126.73323210000048,121.62596999999997,120.97692080000004,123.05950100000007,121.99258971340991,122.17818665823775,121.62907846153861,128.02608740925731,115.23206951381991,126.73323210000048,121.62596999999997,120.97692080000004,123.05950100000007,125.01333,176954752,226472980,56.025326929571754,2.442208616454672,1.5,2.75,NaN,NaN,2.6278325175557486,0.781350393322859,412.87525633874134,0.016976612688597736,-0.27917116528084307,-0.2961477779694408,36.18924377345635,2.3463412636665124,64.05941422493572,10.36004595602662,25.580539819037657,3995044013
1322836200,126.12,126.5,124.78,124.86,NaN,NaN,117.38513648648649,133.11375624999997,126.68628210000048,121.55616999999997,121.21692080000004,122.99000100000008,122.10503717562914,122.4335974526913,121.58292384615399,127.87652806253496,115.28931962977302,126.68628210000048,121.55616999999997,121.21692080000004,122.99000100000008,125.38,221109680,222969718.4,55.75895826390419,2.406373841319463,1.5,2.75,NaN,NaN,2.562987337730338,0.9916578878363063,415.9303068020452,0.21759719810890168,-0.024151280333313707,-0.2417484784422154,34.63625408737853,2.361881963288763,51.5101486687389,18.138255065925424,30.35159626533567,3773934333
1323095400,126.84,127.17999,125.44,126.22,NaN,NaN,117.62216378378379,133.26150649999997,126.6447321000005,121.50907009999996,121.47052100000005,123.02695100000005,122.26640826678093,122.79420721910165,121.59346307692323,127.91756012996667,115.26936602387978,126.6447321000005,121.50907009999996,121.47052100000005,123.02695100000005,126.27999666666666,225263872,221762836.8,58.39284823851715,2.6583478887538243,1.5,2.75,NaN,NaN,2.545630385035314,1.0157872944381454,420.14148746228665,0.42093148722080714,0.2844158805837935,-0.13651560663701362,34.894872818872216,5.481318056843915,55.0391912505637,15.630714172883748,29.330094576552554,3999198205
1323181800,126.21001,127.11,125.75999,126.25999,NaN,NaN,117.85919108108108,133.40925674999997,126.61688205000047,121.45476999999995,121.67092060000003,123.02695100000005,122.42301931514245,123.1242817696634,121.76115461538477,128.4454462646405,115.07686296612903,126.61688205000047,121.45476999999995,121.67092060000003,123.02695100000005,126.37666,178842064,220874080.8,58.471140613380015,2.5080884608376155,1.5,2.75,NaN,NaN,2.460228928961363,0.8097014523036783,420.64148746228665,0.530108211383181,0.5261196575919627,-0.003988553791218347,31.949755336686703,5.931697290041115,54.554223469032536,15.94919792876992,29.496578602197552,4178040269
1323268200,125.84,127.25999,124.97,126.73,NaN,NaN,118.09621837837838,127.25999,126.59543205000047,121.41596999999994,121.85472080000001,122.96945100000005,122.5919205184702,123.46768350588593,122.116923846154,129.30954753318204,114.92430015912593,126.59543205000047,121.41596999999994,121.85472080000001,122.96945100000005,126.31999666666667,237802496,221542896,59.437234674062104,1.9479338702351714,1.5,2.75,NaN,NaN,2.448069005464123,1.0733925587033943,421.3638025808013,0.6007802216350466,0.74698672325259,0.1462065016175433,31.432342731407665,8.72512010981469,50.44670931489391,18.776950161127008,30.77634052397908,4415842765
1323354600,125.89999,126.17999,123.64999,123.95,NaN,NaN,118.33324567567568,127.18284678571429,126.56053210000047,121.32816999999996,122.0308208,123.00890100000004,122.64517853735373,123.51361841008728,122.26853923076939,129.5259445026453,115.0111339588935,126.56053210000047,121.32816999999996,122.0308208,123.00890100000004,124.59332666666667,240862752,216686936,51.76644412973161,0.569733481328628,1.5,2.75,NaN,NaN,2.493207647930972,1.111570251747895,415.8348384423352,0.43483613437621077,0.6897516695878068,0.254915535211596,31.38876186112447,6.54117242564896,45.40941765594622,22.574418967480018,32.01616337657376,4174980013
1323441000,124.50999,126.37,124.39999,126.05,NaN,NaN,118.57027297297297,127.10570357142858,126.52913210000047,121.26217009999995,122.2308208,123.09540050000005,122.77870094765358,123.75517856150753,122.76000076923091,130.10925533322606,115.41074620523577,126.52913210000047,121.26217009999995,122.2308208,123.09540050000005,125.60666333333334,209111312,215549176.8,56.349259169300225,1.469580342466438,1.5,2.75,NaN,NaN,2.487978530221617,0.9701327330701269,420.82895262510954,0.4397238443985873,0.8045703407098301,0.36484649631124283,31.469915509707572,5.296123523838984,73.91197230726358,5.6511617614487735,20.43686593128764,4384091325
1323700200,124.95,124.97,123.16,124.21001,NaN,NaN,118.80730027027028,127.02856035714287,126.48443220000044,121.15937009999996,122.4520212,122.97290100000005,122.83483071441226,123.79849584136396,123.14615538461553,130.22715129125575,116.0651594779753,126.48443220000044,121.15937009999996,122.4520212,122.97290100000005,124.11333666666667,215826064,216844264,51.71303988720603,0.3224271981276951,1.5,2.75,NaN,NaN,2.5166943494915013,0.9953044642213824,416.1385368652861,0.29898621670569264,0.7385792671933586,0.439593050487666,30.92734418575632,3.465231153685964,43.304337793425546,24.333626168690184,32.36203603788428,4168265261
1323786600,124.86,125.57001,122.45,123.05,NaN,NaN,119.04432756756756,126.95141714285715,126.44503225000044,121.04407009999996,122.7144214,122.85240050000007,122.84326872561178,123.72721052313882,123.6453861538463,129.6286559124176,117.662116395275,126.44503225000044,121.04407009999996,122.7144214,122.85240050000007,123.69000333333334,245159680,221139335.2,48.97714040851847,0.32541120298370135,1.5,2.75,NaN,NaN,2.559788324527822,1.1086208601390424,412.45406370542275,0.11706443254221877,0.5859235911654395,0.4688591586232207,31.830264677862047,-1.5521320463931485,19.2751703731961,49.82861675139229,30.896212875411607,3923105581
1323873000,122.56,123.03,121.47,121.74001,NaN,NaN,119.28135486486487,126.87427392857143,126.39768225000046,120.92317019999994,122.90242160000001,122.63525150000007,122.80000367754857,123.53795333045893,124.0607715384617,128.51108307336426,119.61046000355913,126.39768225000046,120.92317019999994,122.90242160000001,122.63525150000007,122.08000333333332,238618816,223834807.2,46.016378812556376,1.487667268096536,1.5,2.75,NaN,NaN,2.489803444204406,1.0660487481144534,408.496940567408,-0.0909723292308195,0.3551437470846963,0.4461160763155158,21.4088053795718,-2.5846123069536695,3.740238815353689,79.11092619902938,17.148834985616936,3684486765
1323959400,123.03,123.2,121.99001,122.185,NaN,NaN,119.51838216216217,126.79713071428571,126.34125725000045,120.81172019999994,123.05772160000002,122.54050150000008,122.77588588627216,123.40910063231999,124.25115538461553,128.11361101033063,120.38869975890042,126.34125725000045,120.81172019999994,123.05772160000002,122.54050150000008,122.45833666666665,199109120,222001141.6,47.18436965035716,0.9321908140695753,1.5,2.75,NaN,NaN,2.416245341046949,0.8968833158468767,411.1348058659654,-0.19226575423489023,0.20578388352190302,0.39804963775679325,21.6790724725522,-2.142399487425915,16.88540460594829,53.22713565476576,29.887459739285944,3883595885
1324045800,122.23,122.95,121.3,121.59,NaN,NaN,119.75540945945946,126.7199875,126.28685725000045,120.72162009999994,123.15972140000002,122.51475150000007,122.72938055739874,123.23585295305142,124.36961692307706,127.77707218349595,120.96216166265818,126.28685725000045,120.72162009999994,123.15972140000002,122.51475150000007,121.94666666666669,220481312,216464221.6,45.75875222974846,1.266013053591488,1.5,2.75,NaN,NaN,2.361513530972167,1.0185577568907582,414.3225581627856,-0.28727607464457616,0.03895454445107305,0.3262306190956492,21.70783657724817,-3.668198383774359,3.40395248290248,80.13114584804389,16.464901669053635,3663114573
1324305000,122.06,122.32001,120.03,120.28999,NaN,NaN,119.99243675675676,126.64284428571429,126.23115725000045,120.62231999999995,123.25132100000002,122.4303010000001,122.63371818259878,122.95529457657034,124.00807692307707,128.01937500279024,119.9967788433639,126.23115725000045,120.62231999999995,123.25132100000002,122.4303010000001,120.87999999999998,183902944,214880350.4,42.721598721579504,1.8254967883373188,1.5,2.75,NaN,NaN,2.3564061359027266,0.8558388128912879,409.8985974292993,-0.4177049997094592,-0.1959006305411748,0.2218043691682844,20.291732995891657,-4.728338723929884,3.731323751036916,79.11887120855761,17.149805040405475,3479211629
1324391400,122.17999,124.14,120.37019,123.92999,NaN,NaN,120.22946405405406,126.56570107142858,126.18790720000044,120.56831989999995,123.33832080000002,122.6437505000001,122.68455237151647,123.04812271213507,123.9280761538463,127.9007429537775,119.95540935391512,126.18790720000044,120.56831989999995,123.33832080000002,122.6437505000001,122.81339333333334,225418064,214670672,52.273531251865755,0.8450347438478593,1.5,2.75,NaN,NaN,2.4630921261953884,1.050064556559454,415.8376821460488,-0.24728438860107813,-0.08730111658306328,0.15998327201801485,28.42459425355385,-2.209429495778427,20.27836000691425,48.43909355007646,31.282546443009288,3704629693
1324477800,123.92999,124.36,122.75,124.17,NaN,NaN,120.46649135135135,126.48855785714287,126.14680720000044,120.52221989999994,123.42772080000003,122.8927505000001,122.7428052196923,123.15496816812221,123.87499923076939,127.81474490397397,119.9352535575648,126.14680720000044,120.52221989999994,123.42772080000003,122.8927505000001,123.75999999999999,194230880,213557475.2,52.83207826834205,0.5988266071812333,1.5,2.75,NaN,NaN,2.402156974324289,0.9095016684295395,418.13675028025324,-0.11364665434566995,0.017924954085927425,0.13157160843159738,28.31514539858519,0.17749092375957956,47.55859219350509,20.941633077186864,31.49977472930804,3898860573
1324564200,124.63,125.39999,124.23241,125.27,NaN,NaN,120.70351864864865,126.41141464285715,126.12346970000044,120.52001979999996,123.51812080000003,123.32825050000011,122.84191089735143,123.3563997711582,123.80192230769246,127.59757821989727,120.00626639548766,126.12346970000044,120.52001979999996,123.51812080000003,123.32825050000011,124.96746666666667,119465312,208304159.2,55.40784722551028,1.4341706974451975,1.5,2.75,NaN,NaN,2.3184307618725546,0.5735138100881473,421.9471135076278,0.04507235086563405,0.18791204701363995,0.1428396961480059,25.72301006111519,-0.6188020626735432,42.97702851242623,24.58107168201312,32.44189980556065,4018325885
1324650600,125.67,126.42999,125.41,126.39,NaN,NaN,120.94054594594594,126.33427142857144,126.10121970000044,120.52221979999995,123.63572100000005,123.8307505000001,122.9810516464749,123.64531407866694,123.81192307692324,127.63402525822305,119.98982089562342,126.10121970000044,120.52221979999995,123.63572100000005,123.8307505000001,126.07666333333333,92187184,207935668,57.927104855084025,1.7746206666191835,1.5,2.75,NaN,NaN,2.235684993167373,0.44334473679619024,424.91043090541024,0.21236512255476003,0.40829609934145594,0.1959309767866959,24.318710099213614,1.755083990412692,72.69660037801064,6.16788432333435,21.135515298655005,4110513069
1324996200,126.17,126.82001,126.06,126.49001,NaN,NaN,121.17757324324324,126.25712821428573,126.08341975000044,120.58451999999994,123.71412100000005,124.1697505000001,123.11865785641706,123.91623749974629,123.79346230769247,127.56093678364064,120.02598783174429,126.08341975000044,120.58451999999994,123.71412100000005,124.1697505000001,126.45667333333334,86075680,201705152,58.154443662477114,1.8690316844108334,1.5,2.75,NaN,NaN,2.1302796365125602,0.42674011618701735,425.47004439683667,0.3106845994518627,0.5842867261015243,0.2736021266496616,22.380596622926834,2.795619666802114,100.00000000000001,0,0,4196588749
1325082600,126.50999,126.53,124.73,124.83,NaN,NaN,121.41460054054055,126.17998500000002,126.06476975000045,120.63201999999994,123.80612100000006,124.40875050000008,123.18576931302816,124.00326249977046,123.86115461538476,127.66885510741388,120.05345412335565,126.06476975000045,120.63201999999994,123.80612100000006,124.40875050000008,125.36333333333333,119107008,197698427.2,53.03217257498138,0.8350314784184059,1.5,2.75,NaN,NaN,2.10668823390452,0.6024681616688148,420.4202919276556,0.247590404244376,0.5830901319551316,0.3354997277107556,23.173325184287997,2.5381877330222005,77.73497951847143,4.210024487682405,18.05499599384616,4077481741
1325169000,125.24001,126.25,124.8566,126.12,NaN,NaN,121.65162783783784,126.10284178571429,126.06449475000045,120.77062009999995,123.87692100000005,124.46525000000008,123.30083718310549,124.20485654741137,123.86653923076939,127.6867831336131,120.04629532792568,126.06449475000045,120.77062009999995,123.87692100000005,124.46525000000008,125.74220000000001,123507120,187651805.6,56.25662263026884,1.115238446803039,1.5,2.75,NaN,NaN,2.0576390743399116,0.6581717644820786,424.7361201942081,0.27433118626026853,0.6784137105360912,0.4040825242758227,22.264276264166185,3.2205262511764965,74.48098144461605,5.4363204300228904,20.082698125361055,4200988861
1325255400,126.02,126.33,125.5,125.5,NaN,NaN,121.88865513513514,126.02569857142858,126.05274470000046,120.85082009999995,123.96432100000006,124.4917500000001,123.38707886219939,124.328203542896,123.9657692307694,127.88234436369558,120.04919409784321,126.05274470000046,120.85082009999995,123.96432100000006,124.4917500000001,125.77666666666666,95599008,183584018.4,54.32620526551401,0.9323019181997809,1.5,2.75,NaN,NaN,1.9699505690299177,0.5207370926575164,424.0027613965856,0.23346000147002915,0.6959075261133592,0.46244752464333,22.78483251502514,3.2157249773830054,46.71379056123224,21.590488683021846,31.695720755745917,4105389853
1325601000,127.75999,128.38,127.42999,127.495,NaN,NaN,122.12568243243243,125.94855535714287,126.05141975000046,121.00287019999996,124.08102100000005,124.62350000000008,123.54817380877981,124.62980320547734,124.30769230769246,128.60261098589245,120.01277362949249,126.05141975000046,121.00287019999996,124.08102100000005,124.62350000000008,127.76832999999998,193697808,182213424.8,59.18005042151019,2.1205014288302606,1.5,2.75,NaN,NaN,2.0349540998134947,1.0630270970023499,429.06749388226683,0.31870456910604095,0.8608282360258812,0.5421236669198403,23.351903875489256,5.989700389866191,56.712252695508994,14.582725759530042,28.705021544960953,4299087661
1325687400,127.2,127.81,126.71001,127.7,NaN,NaN,122.36270972972973,125.87141214285715,126.04121970000045,121.10657019999996,124.15562100000005,124.69750000000008,123.710990522161,124.92220290019378,124.76615307692325,129.1385454309193,120.3937607229272,126.04121970000045,121.10657019999996,124.15562100000005,124.69750000000008,127.40667,127186432,177309552.8,59.654521059272405,1.6828419165479174,1.5,2.75,NaN,NaN,1.968170949826817,0.7173129140056124,428.14704713083455,0.36356737558532626,0.9965828864014981,0.6330155108161718,21.34787926339172,3.0420481757482585,59.91888781032892,12.626253955957058,27.45485823371401,4426274093
1325773800,127.00999,128.23,126.42999,128.03999,NaN,NaN,122.59973702702703,125.79426892857144,126.03496970000046,121.20577009999995,124.20662060000004,124.78650000000009,123.88075520756645,125.21913500493723,125.21653692307709,129.6385643903113,120.79450945584287,126.03496970000046,121.20577009999995,124.20662060000004,124.78650000000009,127.56666,173894944,177062196.8,60.47507085843649,1.6408248170482662,1.5,2.75,NaN,NaN,1.9561594534106148,0.9821122020553175,430.707135811731,0.388553996896036,1.1187080069362167,0.7301540100401808,15.016940202419546,3.1166868003543424,85.58593029846284,1.8509427092300015,12.563126992307156,4600169037
1325860200,128.2,128.22,127.28999,127.71001,NaN,NaN,122.83676432432432,125.71712571428573,126.02521975000045,121.27667019999996,124.29984080000004,124.83550050000008,124.03092206217168,125.45636119494321,125.6873069230771,129.75353115225332,121.62108269390089,126.02521975000045,121.27667019999996,124.29984080000004,124.83550050000008,127.74000000000002,148049936,172574568.8,59.21626930803633,1.3709847335921013,1.5,2.75,NaN,NaN,1.8828630638812849,0.8578896475272548,429.3903704690287,0.3561312570480142,1.1753180813501984,0.8191868243021843,15.3812378433104,1.9478007503791817,59.0227638209361,13.159258515553837,27.817977663510064,4452119101
1326119400,128,128.17999,127.41,128.02,NaN,NaN,123.07379162162162,125.63998250000002,126.01081980000045,121.36097019999995,124.37424080000004,125.03900050000009,124.18735649110613,125.70051727161528,126.28192307692325,129.08028092086838,123.48356523297814,126.01081980000045,121.36097019999995,124.37424080000004,125.03900050000009,127.8699966666667,99530128,165507937.6,60.057397123416855,1.2617596913036409,1.5,2.75,NaN,NaN,1.803372130746908,0.6013616594059958,431.3392238644,0.3294547905693277,1.2310053125138438,0.9015505219445161,14.898515053870856,1.289658992008869,76.48639820844036,4.652351105208716,18.861250686350925,4551649229
1326205800,129.39,129.64999,128.95,129.13,NaN,NaN,123.31081891891893,125.5628392857143,125.99996980000046,121.45557019999995,124.38424080000004,125.19300050000008,124.38118564831765,126.02713467431859,126.68192384615402,129.50763364046827,123.85621405183977,125.99996980000046,121.45557019999995,124.38424080000004,125.19300050000008,129.24333,115281936,160816468.8,63.00003195687054,1.9109732089972953,1.5,2.75,NaN,NaN,1.790987692836414,0.7168540439932853,435.6371198743518,0.3580822764895275,1.3491533675564256,0.9910710910668981,14.85508995100002,2.0871134408163914,73.34721529326286,5.882976042041769,20.769808664695365,4666931165
1326292200,128.73,129.37,128.52,129.2,NaN,NaN,123.54784621621621,125.48569607142859,125.99106980000046,121.60247029999995,124.39624060000004,125.44250000000008,124.57015876014833,126.32931232438348,127.06884692307709,129.788280660301,124.34941318585315,125.99106980000046,121.60247029999995,124.39624060000004,125.44250000000008,129.03,111540688,155602200,63.18423364202179,1.5792622897686908,1.5,2.75,NaN,NaN,1.7237742862052412,0.7168323327048075,437.5480582284748,0.3526859959300521,1.4319285859794633,1.0792425900494111,14.864056218015188,3.500761035007603,72.67064634913042,6.165301695232207,21.16405195563738,4778471853
1326378600,129.57001,129.7,128.53999,129.50999,NaN,NaN,123.78487351351352,125.40855285714287,125.97931975000046,121.77117019999996,124.47644040000003,125.76549950000008,124.76387763229938,126.63223400777552,127.39500000000018,130.1892376420572,124.60076235794315,125.97931975000046,121.77117019999996,124.47644040000003,125.76549950000008,129.24999333333332,118983632,149293397.6,64.03806025361038,1.5171314694289462,1.5,2.75,NaN,NaN,1.6835054086191525,0.7969785262627046,439.85545374595205,0.34075891804869207,1.5051912376102763,1.1644323195615842,11.238122849005324,2.6879083412622764,69.81852112475785,7.421469904103422,22.76000897113873,4897455485
1326465000,128.64,129.05,127.72,128.84,NaN,NaN,124.02190081081082,125.33140964285715,125.95966975000044,121.93227019999996,124.61320040000003,126.12049900000008,124.92372556828764,126.84249743560643,127.5834615384617,130.41142640777386,124.75549666914954,125.95966975000044,121.93227019999996,124.61320040000003,126.12049900000008,128.53666666666666,179836128,146354263.2,60.75826649073556,0.8010296748329966,1.5,2.75,NaN,NaN,1.6911114508606409,1.2287727331471407,437.41363065653707,0.2620470073689487,1.4919910787727702,1.2299440714038214,11.41753049735552,2.6613545816733093,64.13920371976609,10.238394091842077,25.62240218839185,4717619357
1326810600,130.08,130.32001,128.89571,129.34,NaN,NaN,124.25892810810811,125.25426642857144,125.94341975000044,122.06127019999997,124.72020020000002,126.47824900000009,125.09691280090381,127.08035482269153,127.80269153846169,130.69865637165162,124.90672670527175,125.94341975000044,122.06127019999997,124.72020020000002,126.47824900000009,129.51857333333336,132209184,143009266.4,62.30966967317885,1.2515088684718283,1.5,2.75,NaN,NaN,1.676032775799166,0.9244798419579894,440.10400149307526,0.21967063610506998,1.5045323665351589,1.2848617304300889,10.508792660583257,1.4471155731597307,68.24295413765473,8.244145314174526,23.512900548170748,4849828541
1326897000,129.31,130.84,129.08,130.77,NaN,NaN,124.49595540540541,125.17712321428573,125.93151980000044,122.18817019999997,124.81060020000002,126.9372490000001,125.3193868087115,127.43174960148282,128.25961461538478,131.00582271271867,125.51340651805089,125.93151980000044,122.18817019999997,124.81060020000002,126.9372490000001,130.23000000000002,163395120,140154956.8,66.40090776566345,1.742621929499338,1.5,2.75,NaN,NaN,1.6820304346706536,1.1658176330728247,442.7917039119151,0.26113986995189165,1.6112865678699535,1.3501466979180619,8.570268677227611,2.4040720438527856,70.88118331198102,7.014673427480138,22.104143260538837,5013223661
1326983400,131.22,131.57001,130.8,131.46001,NaN,NaN,124.7329827027027,125.09998000000002,125.92251990000044,122.33997029999996,124.93018040000003,127.49575000000009,125.56019556131105,127.81539344896065,128.67038461538476,131.6046100001471,125.73615923062243,125.92251990000044,122.33997029999996,124.93018040000003,127.49575000000009,131.27667333333332,126328816,137276250.4,68.19491973879936,2.0003537375590654,1.5,2.75,NaN,NaN,1.6190289750513203,0.9202525246129537,445.8780890459961,0.30516839532466644,1.731607192073895,1.4264387967492285,8.68096789574264,2.6710561286360788,71.68334450541938,6.6588732538628275,21.65778224071778,5139552477
1327069800,131.24001,131.95,130.92,131.53999,NaN,NaN,124.97001,125.0228367857143,125.91401980000045,122.47567019999997,125.03578040000004,127.8762500000001,125.79469730400473,128.170116930012,129.13499923076938,131.81589944129095,126.4540990202478,125.91401980000045,122.47567019999997,125.03578040000004,127.8762500000001,131.46999666666667,138230128,132916853.6,68.40550111666829,1.7583510302536207,1.5,2.75,NaN,NaN,1.576955476833369,1.0399744220246876,447.3637204241367,0.30886675702963307,1.8125222430362697,1.5036554860066367,8.780911764979825,2.998966173442467,72.6381666802097,6.246367226336833,21.115466093453467,5277782605
1327329000,131.50999,132.25,130.98,131.61,NaN,NaN,125.2070372972973,124.94569357142859,125.90376980000045,122.57817019999997,125.11038040000003,128.2482500000001,126.02274839012219,128.49772484143944,129.45153769230785,132.2521947505155,126.65088063410018,125.90376980000045,122.57817019999997,125.11038040000003,128.2482500000001,131.61333333333334,129295744,129670096.8,68.60147404781281,1.6000696809291934,1.5,2.75,NaN,NaN,1.555030085630986,0.9971130367815072,449.89084599212174,0.28575284731601824,1.8608465451516594,1.5750936978356411,8.264135316395516,2.804249336041246,100,0,0,5407078349
1327415400,130.8,131.5,130.60001,131.46001,NaN,NaN,125.4440645945946,124.86855035714288,125.89446980000044,122.67597039999997,125.27636060000003,128.55775050000008,126.2359743356076,128.77984723749282,129.7407692307694,132.53474754183662,126.94679091970217,125.89446980000044,122.67597039999997,125.27636060000003,128.55775050000008,131.18667333333335,103083248,128850993.6,67.63356663015733,1.2093612653342656,1.5,2.75,NaN,NaN,1.5160986509430594,0.8000190384251721,451.3485839658331,0.23235402007759332,1.8655362229326329,1.6331822028550396,8.60169178356894,1.8043909238751767,83.00057693683928,2.542542115994646,14.456880947166074,5303995101
1327501800,131.25999,132.87,130.75,132.56,NaN,NaN,125.6810918918919,124.79140714285717,125.89296980000044,122.77937039999998,125.44116040000003,128.8662505000001,126.48397534205435,129.13986178630302,130.08846230769245,133.06810395173665,127.10882066364826,125.89296980000044,122.77937039999998,125.44116040000003,128.8662505000001,132.06,198613184,134172293.6,70.87863071243729,1.6371938381116107,1.5,2.75,NaN,NaN,1.559234461589984,1.4802846300899786,455.63609093951635,0.24201366961885884,1.9356992898786132,1.6936856202597543,8.526824746813341,2.6006191950464506,84.0346414133746,2.257707943370151,13.707650643255239,5502608285
1327588200,133.14999,133.39999,131.36,131.88,NaN,NaN,125.91811918918918,124.71426392857144,125.89006975000046,122.88877039999996,125.54556040000003,129.1357500000001,126.69558415216987,129.40082733046464,130.4092307692309,133.1865748081138,127.63188673034801,125.89006975000046,122.88877039999996,125.54556040000003,129.1357500000001,132.21333,184880496,139112534.4,66.44369749894656,1.3559367043794632,1.5,2.75,NaN,NaN,1.5935741429049843,1.3289995527534577,454.8543549795458,0.17654437444297377,1.9143660883134714,1.7378217138704977,9.58924579640698,1.8299823820540855,52.10090315392813,17.688170013578112,30.210926832493747,5317727789
1327674600,131.24001,132.05,131.14999,131.82001,NaN,NaN,126.15514648648649,124.63712071428573,125.89181980000045,123.02847039999995,125.67276040000004,129.4852505000001,126.89654202855537,129.6312256799442,130.70153923076936,133.19710015128257,128.20597831025614,125.89181980000045,123.02847039999995,125.67276040000004,129.4852505000001,131.67333333333332,135259056,139920136.8,66.0510470446814,0.8559717073953701,1.5,2.75,NaN,NaN,1.5440338469832005,0.966687562586774,457.90039347494667,0.10658293024686527,1.8710503766790794,1.764467446432214,9.690708981174296,2.312954051536784,27.113061773084883,40.08067493238487,32.806263294530254,5182468733
1327933800,130.50999,131.44,130.06,131.37,NaN,NaN,126.39217378378379,124.55997750000002,125.89136975000045,123.17227029999997,125.77850060000004,129.7477505000001,127.07197175292575,129.79682323423523,130.87384692307705,133.21620365978035,128.53149018637376,125.89136975000045,123.17227029999997,125.77850060000004,129.7477505000001,130.95666666666668,147311744,141110368,63.04146230261657,0.3591044502351171,1.5,2.75,NaN,NaN,1.5594607150558286,1.0439469904861987,455.4479037436016,0.012340299283158274,1.779892820536162,1.7675525212530037,9.271705376509486,1.5695067264573999,8.786356136357801,66.99138452529792,24.222259338344283,5035156989
1328020200,132.02,132.17999,130.67999,131.32001,NaN,NaN,126.62920108108108,124.4828342857143,125.89016980000044,123.28257049999996,125.92330080000005,130.0387510000001,127.23856148810513,129.94188864049855,131.03692461538475,133.17688404327725,128.89696518749224,125.89016980000044,123.28257049999996,125.92330080000005,130.0387510000001,131.39333,157211936,144191014.4,62.699689174534875,0.44034881356054373,1.5,2.75,NaN,NaN,1.5552135211232694,1.0903032803686274,457.6295580206619,-0.06668073885598025,1.6842015976830282,1.7508823365390085,9.269296191924647,0.42059340827405833,7.604732918721588,69.45064556596509,22.944621515313308,4877945053
1328106600,132.28999,133.14,132.13,132.47,NaN,NaN,126.86622837837838,124.40569107142859,125.89231985000043,123.41687059999997,126.13060080000007,130.28750100000008,127.44371593955199,130.18266115092726,131.2646176923078,133.3350199275491,129.19421545706652,125.89231985000043,123.41687059999997,126.13060080000007,130.28750100000008,132.58,166234432,142817845.6,67.11628915361345,1.2659338789982184,1.5,2.75,NaN,NaN,1.5741261267573208,1.1639612073800951,462.71024038953055,-0.055286864988717044,1.6817737553031122,1.7370606202918293,8.477896362565158,0.7682868729433291,5.661982643403193,73.91370165522385,20.424315701372954,5044179485
1328193000,132.73,133.02,132.21001,132.67999,NaN,NaN,127.10325567567568,124.32854785714288,125.90291980000043,123.58447049999997,126.34462060000006,130.5365005000001,127.64906002035387,130.4205019936961,131.56000153846168,133.21683581374202,129.90316726318133,125.90291980000043,123.58447049999997,126.34462060000006,130.5365005000001,132.63666666666666,113090368,142113042.4,67.864543624167,1.0303846493150033,1.5,2.75,NaN,NaN,1.5195449748460834,0.7957775450453659,463.6422184805915,-0.04768255563926771,1.6774574257427446,1.7251399813820123,8.102854680595938,0.8666565962183933,20.85982179268844,47.660223116234995,31.479955091076576,5157269853
1328279400,134,134.62,133.77,134.53999,NaN,NaN,127.34028297297297,124.25140464285717,125.91906975000043,123.76317039999996,126.64220040000005,130.8615005000001,127.91929256857529,130.81283418477264,131.9600007692309,133.782383554422,130.1376179840398,125.91906975000043,123.76317039999996,126.64220040000005,130.8615005000001,134.30999666666665,160598496,141448220,73.59569906358645,1.9923054372637625,1.5,2.75,NaN,NaN,1.549578190928506,1.1353871826736315,467.65164134406115,0.06255635929013748,1.803335430494684,1.7407790712045466,10.99149047589029,2.2262670009877477,47.73174053310598,20.80563713735809,31.462622329535932,5317868349
1328538600,133.98,134.5134,133.83,134.45,NaN,NaN,127.57731027027027,124.17426142857146,125.92581970000045,123.93027029999998,126.94740040000006,131.1985000000001,128.17539874235663,131.15923092908,132.24307769230785,134.35791742529693,130.12823795931877,125.92581970000045,123.93027029999998,126.94740040000006,131.1985000000001,134.26446666666666,107694432,139430444.8,72.91812125035632,1.6460644549553636,1.5,2.75,NaN,NaN,1.4896076058621825,0.7723882123052654,464.8903010897643,0.10675936568806854,1.8742282783146322,1.7674689126265637,11.08141012231731,2.274448328430811,53.34087685479437,16.856808437599394,29.80231470760623,5210173917
1328625000,134.17,135.02,133.64,134.78999,NaN,NaN,127.81433756756756,124.09711821428574,125.93086965000046,124.08447019999996,127.31200020000006,131.53699950000012,128.4347944779505,131.50501750726286,132.49923000000015,134.95225722199427,130.04620277800603,125.93086965000046,124.08447019999996,127.31200020000006,131.53699950000012,134.48333,135528064,141230341.6,73.89596824682278,1.6979875186941735,1.5,2.75,NaN,NaN,1.4817784911577425,0.9596242738253067,466.7212519226326,0.1344521422079581,1.9355340903865113,1.8010819481785532,10.88335438295552,1.6822495473747636,82.86192484523446,2.5868867631588697,14.55118839160668,5345701981
1328711400,134.86,135.22,134.31,135.19,NaN,NaN,128.05136486486487,124.01997500000002,125.93861965000046,124.22207029999996,127.68900020000005,131.83999950000012,128.69970449842305,131.85596822085688,132.78000000000014,135.54525985987792,130.01474014012237,125.93861965000046,124.22207029999996,127.68900020000005,131.83999950000012,134.90666666666667,139361376,142434313.6,75.03795651067188,1.5635308822709044,1.5,2.75,NaN,NaN,1.4409371703607605,0.9784255807302883,468.984484615535,0.15386881794464324,1.9934179706093573,1.839549152664714,10.249978432952648,2.5098574461631804,82.15873277885706,2.7910485786021044,15.050218642540841,5485063357
1328797800,135.41,135.59,134.56,135.36,NaN,NaN,128.28839216216215,123.9428317857143,125.94146465000046,124.36046029999996,128.00200000000004,132.14799950000014,128.96089255730843,132.18968553315622,133.06846153846166,136.0585693848206,130.07835369210272,125.94146465000046,124.36046029999996,128.00200000000004,132.14799950000014,135.17,148602816,144287420,75.5279465154181,1.5866243445231556,1.5,2.75,NaN,NaN,1.411584515334992,1.0299083315787336,469.3178179488683,0.1520509408032258,2.0296128286687463,1.8775618878655205,9.236414017262925,2.685472410448169,83.26257436070092,2.4737194489564316,14.263706190342653,5633666173
1328884200,134.16,134.47,133.84,134.36099,NaN,NaN,128.52541945945947,123.86568857142859,125.93491960000047,124.50097019999995,128.28821980000004,132.39054950000013,129.1726610844728,132.3964764347604,133.29161384615398,136.2001463401214,130.38308135218657,125.93491960000047,124.50097019999995,128.28821980000004,132.39054950000013,134.22366333333332,167907504,146733613.6,67.18217069029544,0.6074955820639758,1.5,2.75,NaN,NaN,1.4193284785253506,1.144301567176834,464.745437095673,0.06206891139278614,1.9551480271065032,1.893079115713717,10.803709672060213,2.276767907436996,50.6933440793499,18.70338593422901,30.603269986421097,5465758669
1329143400,135.32001,135.52,134.74001,135.36,NaN,NaN,128.76244675675676,123.78854535714288,125.93116960000047,124.65287019999997,128.49561960000003,132.71654950000013,129.41530182625817,132.67871677430702,133.5069984615386,136.57712547775105,130.43687144532612,125.93116960000047,124.65287019999997,128.49561960000003,132.71654950000013,135.20667,115841808,143533897.6,70.67215786662791,1.217552601730571,1.5,2.75,NaN,NaN,1.400734301487827,0.8070693399745037,469.9938134679861,0.04891180709022436,1.9542188745764975,1.905307067486273,10.63537674671965,3.0764466131247,70.55188549390809,7.0949632787090176,22.353151227382874,5581600477
1329229800,135,135.27,134.25,135.19,NaN,NaN,128.99947405405405,123.71140214285717,125.92496965000046,124.83847019999997,128.70001960000002,133.00904950000012,129.64176057816962,132.9178866053254,133.76161384615398,136.79861909791734,130.72460859439062,125.92496965000046,124.83847019999997,128.70001960000002,133.00904950000012,134.90333333333334,165996128,145223244.8,69.32119384844026,0.7412996697159583,1.5,2.75,NaN,NaN,1.379967565667269,1.143041034709066,466.9143417491006,0.009881827566064816,1.917659351943854,1.9077775243777892,10.748038909422712,2.0532950856797756,39.127553290464036,27.876058843163584,32.99638786637237,5415604349
1329316200,135.63,135.83,134.28999,134.56,NaN,NaN,129.23650135135136,123.63425892857146,125.91666965000046,125.05547019999996,128.89401960000004,133.19854950000013,129.83463271235905,133.07427835719918,133.97238230769244,136.8152489216732,131.12951569371168,125.91666965000046,125.05547019999996,128.89401960000004,133.19854950000013,134.89333000000002,195195120,146813244.8,64.40749905630966,0.6673908761820603,1.5,2.75,NaN,NaN,1.3913991681196085,1.3295470736711077,464.91966799024794,-0.07269740092551502,1.8169057732208955,1.8896031741464105,10.843507953981929,1.4169506645274834,13.886759762796006,57.80606504633374,28.307175190870247,5220409229
1329402600,134.57001,136.17,134.33,136.049,NaN,NaN,129.47352864864865,123.55711571428574,125.91826465000045,125.28056029999998,129.09059960000002,133.42799900000014,130.07833339030574,133.35758518032307,134.33230538461552,136.9412846538373,131.72332611539375,125.91826465000045,125.28056029999998,129.09059960000002,133.42799900000014,135.51633333333334,186567744,149825191.2,69.84755652364717,1.2340307948265163,1.5,2.75,NaN,NaN,1.4234420846824918,1.245236148245276,469.68221123748657,-0.04284819365596659,1.8360429320764524,1.878891125732419,12.118792721157376,1.1216070404048772,16.83459549324241,53.25131014546049,29.91409436129708,5406976973
1329489000,136.52,136.6275,135.96001,136.41,NaN,NaN,129.71055594594594,123.47997250000003,125.92616465000044,125.48226019999998,129.29359980000004,133.67149950000012,130.3266340416663,133.64829135362564,134.72384307692323,136.89866262244274,132.54902353140372,125.92616465000044,125.48226019999998,129.29359980000004,133.67149950000012,136.33250333333334,129869376,149407153.6,71.00465532956508,1.3082567351780332,1.5,2.75,NaN,NaN,1.3694455072051699,0.8692313110233834,471.93152356364186,-0.0159844308063124,1.8589105872245284,1.8748950180308408,9.73060940346373,1.4577910003718915,38.91808594536682,28.06350899875704,33.01840505587613,5536846349
1329834600,136.73,137.05,136.05,136.47,NaN,NaN,129.94758324324323,123.40282928571432,125.94046465000045,125.67156029999998,129.48839980000005,133.9144995000001,130.5675503537578,133.9170255104232,135.03153538461555,136.9618973542227,133.1011734150084,125.94046465000045,125.67156029999998,129.48839980000005,133.9144995000001,136.52333333333334,134042256,149644479.2,71.20245797064604,1.2187920807449968,1.5,2.75,NaN,NaN,1.3430565424048007,0.8957380634193153,472.07294491987915,-0.01157281457820969,1.8604289998080787,1.8720018143862884,9.665904767126886,1.2463907742704115,43.838530691753895,23.980608952592405,32.18086035565369,5670888605
1329921000,136.25999,136.55,135.78999,136.032,NaN,NaN,130.18461054054055,123.3256860714286,125.94962465000044,125.88043029999997,129.73003980000004,134.14309900000012,130.7818424967477,134.11845165228766,135.28938230769245,136.7270432948676,133.8517213205173,125.94962465000044,125.88043029999997,129.73003980000004,134.14309900000012,136.12399666666667,124455248,150713079.2,67.57820894189707,0.8099325401632449,1.5,2.75,NaN,NaN,1.3014103608044594,0.8257760286009737,469.29723862155697,-0.05321985289048792,1.8054769982731784,1.8586968511636663,9.995982655353163,0.6228271321843427,48.04803231844457,20.671905353345743,31.280062328209677,5546433357
1330007400,135.96001,136.73,135.5,136.631,NaN,NaN,130.42163783783784,123.24854285714288,125.95917965000044,126.08624029999997,129.94165980000005,134.34664900000013,131.01122122236544,134.3577419711174,135.45022923076937,136.98137674388602,133.91908171765272,125.95917965000044,126.08624029999997,129.94165980000005,134.34664900000013,136.287,137704256,147667632.8,69.83922156311785,0.9284233038608894,1.5,2.75,NaN,NaN,1.2963096207469973,0.9325283637918518,473.185560575697,-0.055252140808575545,1.7896316751529469,1.8448838159615224,10.135500636665467,0.9389775413711484,81.03577518908209,3.137719724177971,15.826505086739934,5684137613
1330093800,136.92999,137.2,136.63,136.92999,NaN,NaN,130.65866513513512,123.17139964285717,125.96447960000044,126.32404029999998,130.19605940000005,134.59914850000013,131.24332980188052,134.60271797386812,135.64099769230785,137.24248458224923,134.03951080236646,125.96447960000044,126.32404029999998,130.19605940000005,134.59914850000013,136.91999666666666,105539056,143700560.8,70.92900548759252,1.040230727382366,1.5,2.75,NaN,NaN,1.2444303621222113,0.7344373286537653,475.08825686374644,-0.051368141270596857,1.7806736393732763,1.8320417806438731,10.156045354665975,1.9120133008844435,78.24582757595165,4.061244419999675,17.692928004048667,5789676669
1330353000,136.02,137.53,135.8,137.16,NaN,NaN,130.89569243243244,123.09425642857146,125.97807960000046,126.59634039999997,130.47825940000004,134.86614800000012,131.47535608415973,134.84626864302354,135.82330615384632,137.53179643496242,134.11481587273022,125.97807960000046,126.59634039999997,130.47825940000004,134.86614800000012,136.83,145728816,144224048.8,71.7739396217401,1.0821738869322992,1.5,2.75,NaN,NaN,1.2791139076849096,1.010433538737265,474.5762647521567,-0.048264597111991936,1.771711034253883,1.819975631365875,8.572150836598517,1.3297872340425405,76.92429166622716,4.4944594721516955,18.581248861621145,5935405485
1330439400,137.2,137.72,136.92999,137.55901,NaN,NaN,131.13271972972973,123.01711321428574,125.99047465000045,126.84853049999998,130.79463940000002,135.17559850000012,131.713930747526,135.10462496273558,136.00553769230785,137.90018072361568,134.11089466100003,125.99047465000045,126.84853049999998,130.79463940000002,135.17559850000012,137.403,129355808,143326252,73.22762877520414,1.0377981667431817,1.5,2.75,NaN,NaN,1.2441779142788445,0.9025269704254877,475.24318012864984,-0.03491773021346245,1.776328468599047,1.8112461988125095,7.910098776995034,1.7523559434869465,76.77554903834252,4.548961277897955,18.675489683759512,6064761293
1330525800,137.75999,138.19,136.53999,137.02,NaN,NaN,131.36974702702702,122.93997000000003,126.00537470000044,127.07453049999998,131.09133940000004,135.46059800000012,131.92201189468184,135.28704163295126,136.13323000000017,138.06011511756603,134.2063448824343,126.00537470000044,127.07453049999998,131.09133940000004,135.46059800000012,137.24999666666668,185934688,144762389.6,68.1235618900003,0.8095664954929851,1.5,2.75,NaN,NaN,1.273165920401785,1.2844129508622038,471.84039489175626,-0.07563287232912708,1.7167051084011007,1.7923379807302278,8.396402775302382,1.828180737217604,66.65674449858423,8.943624923482716,24.39963057793306,5878826605
1330612200,137.31,137.99001,136.9312,137.73,NaN,NaN,131.60677432432433,122.86282678571432,126.02807470000045,127.28693039999999,131.4141394,135.72359800000012,132.14977613410608,135.51970433457495,136.39238461538477,138.1985812702778,134.58618796049174,126.02807470000045,127.28693039999999,131.4141394,135.72359800000012,137.55040333333332,145026128,143701974.4,70.99175897724508,0.9514023433704166,1.5,2.75,NaN,NaN,1.2578547832302305,1.0092145818144027,475.58376509957975,-0.06821739641152669,1.7070662352158195,1.7752836316273461,7.687287411549617,1.2355842380318731,67.11101080291148,8.717642904078522,24.171346293009993,6023852733
1330698600,137.64,137.82001,137,137.312,NaN,NaN,131.84380162162162,122.7856835714286,126.04878470000047,127.50295029999998,131.75457960000003,135.9551985000001,132.35221628570977,135.69039915985354,136.54253846153864,138.30447793586043,134.78059898721685,126.04878470000047,127.50295029999998,131.75457960000003,135.9551985000001,137.37733666666668,120638256,144079368.8,67.16038123077806,0.6370010484561244,1.5,2.75,NaN,NaN,1.2265801558566423,0.8373041678677869,472.30135842940814,-0.10285415659776631,1.6467159358801382,1.7495700924779045,5.910619548397424,0.6612418444395683,43.55457991439979,24.08141198570128,32.364008099898925,5903214477
1330957800,137.10001,137.2,136.28,136.75,NaN,NaN,132.0808289189189,122.7085403571429,126.06073470000047,127.67465029999998,132.01097980000003,136.06569900000014,132.52467839215254,135.79131352558178,136.66253846153862,138.24278964034073,135.0822872827365,126.06073470000047,127.67465029999998,132.01097980000003,136.06569900000014,136.74333333333334,140765008,143087694.4,62.292629535965084,0.16242532351163466,1.5,2.75,NaN,NaN,1.2126815732954543,0.9837673923691372,469.57363480145824,-0.17098804564477188,1.5358350354219397,1.7068230810667115,6.434458749774238,0.20517329816076876,19.347410861207102,49.66272738594902,30.989861752843886,5762449469
1331044200,135.35001,135.42999,134.36,134.75,NaN,NaN,132.31785621621623,122.63139714285718,126.06108475000046,127.82515029999996,132.22257980000003,136.08069900000015,132.61194590618578,135.6921408088597,136.677153846154,138.1810194572597,135.1732882350483,126.06108475000046,127.82515029999996,132.22257980000003,136.08069900000015,134.84666333333334,202129808,147809463.2,48.750848032844054,1.221602234939067,1.5,2.75,NaN,NaN,1.2967757466314924,1.3675024834269205,462.62464483611353,-0.34792567929120755,1.2719159819527022,1.6198416612439097,10.719880407897987,-0.9424253116913746,4.0781699316741795,78.08161884784303,17.84021122048278,5560319661
1331130600,135.06,135.91,134.92999,135.69,NaN,NaN,132.55488351351352,122.55425392857146,126.07148475000045,127.97455029999998,132.43097980000002,136.12569950000017,132.73265390986478,135.69193692230164,136.64953846153864,138.21062484965705,135.08845207342023,126.07148475000045,127.97455029999998,132.43097980000002,136.12569950000017,135.50999666666667,143692128,148217666.4,53.83095198517649,0.5069762759428825,1.5,2.75,NaN,NaN,1.2870060504435283,0.9694669433818586,467.4468158547869,-0.39536710441722045,1.125632780722384,1.5209998851396045,11.594109069442506,-0.6887163235283372,19.74848937243167,49.11516321062895,31.13634741693939,5704011789
1331217000,136.52,137.32001,136.24001,137.03999,NaN,NaN,132.7919108108108,122.47711071428574,126.09638470000046,128.13985029999995,132.6439796,136.21819900000017,132.9015690506544,135.8203229297015,136.6979992307694,138.26543356168816,135.13056489985064,126.09638470000046,128.13985029999995,132.6439796,136.21819900000017,136.86667,116968816,147098038.4,59.96825809456851,0.5266885351800977,1.5,2.75,NaN,NaN,1.311506332554705,0.7951759063022285,472.5230463402977,-0.3320901313086684,1.1058872210037691,1.4379773523124375,12.769313212035357,0.08033302273664462,17.1769372948765,52.7338656957969,30.08919700932662,5820980605
1331303400,137.3,137.92999,137.13,137.57001,NaN,NaN,133.0289381081081,122.39996750000003,126.12448475000045,128.28985029999996,132.8655796,136.32869950000014,133.084645166315,135.98695979353946,136.78261538461555,138.4093255387145,135.1559052305166,126.12448475000045,128.28985029999996,132.8655796,136.32869950000014,137.54333333333332,122836752,145809735.2,62.09850338713572,0.8142072041603748,1.5,2.75,NaN,NaN,1.281398737372227,0.8424454775362626,474.5230463402977,-0.25430576386546067,1.1200951474806118,1.3744009113460725,12.895058096827027,0.29892825896762887,37.85625558378501,29.011694660289397,33.132049755925614,5943817357
1331559000,137.55,137.75999,137.09,137.58,NaN,NaN,133.2659654054054,122.32282428571432,126.15043475000046,128.46335029999997,133.1205796,136.48965000000015,133.26093359116538,136.13867790844046,136.90169230769246,138.5177817901732,135.28560282521173,126.15043475000046,128.46335029999997,133.1205796,136.48965000000015,137.47666333333333,104003504,142614535.2,62.13939841895478,0.6533371750448292,1.5,2.75,NaN,NaN,1.2377266847027812,0.7292630015176742,472.7811821351741,-0.20411351322068216,1.1192590198202197,1.3233725330409019,12.872792650323452,0.01525890597788675,64.30949172672082,10.158324948834071,25.532183324445082,6047820861
1331645400,138.32001,140.13,138.09,140.062,NaN,NaN,133.5029927027027,122.2456810714286,126.18574475000047,128.63817029999996,133.3994196,136.72475000000014,133.52764207778634,136.51232763144614,137.16561538461553,139.4858887277745,134.84534204145658,126.18574475000047,128.63817029999996,133.3994196,136.72475000000014,139.42733333333334,184090432,146026966.4,70.6209136933157,1.6338531058140333,1.5,2.75,NaN,NaN,1.3314604929382958,1.2606605241372733,478.832628243337,-0.015623508436128919,1.3038431474957406,1.3194666559318695,16.36414189760857,2.220113851992411,100.00000000000001,0,0,6231911293
1331731800,140.10001,140.44501,139.48,139.91,NaN,NaN,133.74002000000002,122.1685378571429,126.21774480000047,128.82597029999997,133.6876196,136.96075000000013,133.7779306237555,136.8359154760703,137.39484692307707,140.128677010422,134.66101683573214,126.21774480000047,128.82597029999997,133.6876196,136.96075000000013,139.94500333333335,145163504,144985335.2,69.59271694910079,1.7226857424390056,1.5,2.75,NaN,NaN,1.305285457728418,1.0012288746289701,474.794458090679,0.08160777449505163,1.421476374050684,1.3398685995556323,16.079678957440514,1.5828069411166825,74.40934499979143,5.458508188026489,20.132146812182096,6086747789
1331818200,140.12,140.78,139.75999,140.72,NaN,NaN,133.9770472972973,122.09139464285718,126.24684485000047,129.01657029999996,133.9521196,137.26875000000013,134.0501686385102,137.20582828787315,137.6686930769232,140.91814439988835,134.41924175395806,126.24684485000047,129.01657029999996,133.9521196,137.26875000000013,140.41999666666666,165118432,143481500.8,71.93746361963922,1.858410181753565,1.5,2.75,NaN,NaN,1.2849086393192464,1.1507994485655673,477.44703129010503,0.1777494259924286,1.562055382046168,1.3843059560537394,16.125615721120607,2.481938941971559,76.50939433731526,4.649593359941051,18.84101230274369,6251866221
1331904600,140.36,140.48,140,140.3,NaN,NaN,134.2140745945946,122.01425142857147,126.28899485000048,129.17987029999998,134.2041196,137.48130000000012,134.29526006445099,137.50051130807572,137.8795384615386,141.41617553569145,134.34290138738575,126.28899485000048,129.17987029999998,134.2041196,137.48130000000012,140.26000000000002,152893376,141797782.4,68.96775817499268,1.4222204004986205,1.5,2.75,NaN,NaN,1.2445580222250143,1.0782494155564453,475.5461542995206,0.1892673599861363,1.6208901560364097,1.4316227960502734,16.119720078731596,2.5959780621572297,48.68975606833287,20.077385072971826,31.232858858695298,6098972845
1332163800,140.21001,141.28,140.11,140.85001,NaN,NaN,134.45110189189188,121.93710821428576,126.33459490000047,129.33347029999996,134.46032000000002,137.70330050000013,134.55230908153135,137.81951118349707,138.17415461538474,142.00146006680015,134.34684916396932,126.33459490000047,129.33347029999996,134.46032000000002,137.70330050000013,140.74667,125291008,141568864,70.67502678949268,1.6516472408227358,1.5,2.75,NaN,NaN,1.239232449208941,0.8850181068063102,478.4033314971164,0.20861339163145964,1.692389535589598,1.4837761439581383,15.631879837275017,4.526909090909089,51.7274168812125,17.962661001152284,30.30992211763522,6224263853
1332250200,140.05,140.61,139.64,140.44,NaN,NaN,134.6881291891892,121.85996500000005,126.38469490000047,129.50738029999997,134.71491980000002,137.90180050000015,134.7831989214713,138.06908154697354,138.3826161538463,142.38179757105914,134.38343473663346,126.38469490000047,129.50738029999997,134.71491980000002,137.90180050000015,140.23,121729632,140953232.8,67.6855629945602,1.0609520891767197,1.5,2.75,NaN,NaN,1.237145131408303,0.8636171699071523,475.0161323179169,0.17011006654680627,1.6964137271416462,1.52630366059484,11.732194093872616,3.5006264278870955,23.918627013829628,43.87098784150676,32.2103851446636,6102534221
1332336600,140.52,140.64999,139.92,140.21001,NaN,NaN,134.9251564864865,121.78282178571432,126.44051995000046,129.66648039999998,134.95872,138.11070100000015,134.9960150421979,138.27297949488081,138.60554000000013,142.66380157589904,134.54727842410122,126.44051995000046,129.66648039999998,134.95872,138.11070100000015,140.26,122388368,140849888.8,65.99914656907433,0.9410942772017893,1.5,2.75,NaN,NaN,1.2009197648791397,0.868927686366764,475.11466524573336,0.10846703390581758,1.661887452977112,1.5534204190712944,12.009553125260135,2.313207991331598,25.525101043544055,41.940670749431895,32.53422820702405,5980145853
1332423000,139.17999,139.55,138.74001,139.2,NaN,NaN,135.16218378378377,121.7056785714286,126.49171990000048,129.7721804,135.16011999999998,138.23915100000016,135.16087719740582,138.36126716203503,138.79400153846166,142.71532219671275,134.87268088021057,126.49171990000048,129.7721804,135.16011999999998,138.23915100000016,139.16333666666668,135216688,140725510.4,59.041998720913035,0.02597775872592068,1.5,2.75,NaN,NaN,1.2201397816734867,0.9608541309650137,473.2144957117962,-0.014474361951505532,1.5353274666319123,1.5498018285834179,12.561834490654745,1.1848439932511399,4.822788834330418,76.1247474356426,19.05246373002697,5844929165
1332509400,139.32001,139.81,138.55,139.64999,NaN,NaN,135.3992110810811,121.6285353571429,126.5478698500005,129.88268019999998,135.3691198,138.37515100000013,135.33692083672324,138.48400267041265,139.17092384615398,142.33350839317401,136.00833929913395,126.5478698500005,129.88268019999998,135.3691198,138.37515100000013,139.33666333333335,120520944,141474604.8,61.01381101059871,0.3117443902810626,1.5,2.75,NaN,NaN,1.2229869401253797,0.8518910101949264,475.02861303761244,-0.07618481403176713,1.454570811043709,1.5307556250754761,12.52479974892018,1.5045718854484589,22.0389320058058,46.22392817667119,31.73713981752302,5965450109
1332768600,140.64999,141.61,140.60001,141.61,NaN,NaN,135.63623837837838,121.55139214285718,126.60891990000049,130.04378020000001,135.61112,138.59765100000016,135.58292394116546,138.7817167018019,139.6263084615386,142.32346896523848,136.92914795783872,126.60891990000049,130.04378020000001,135.61112,138.59765100000016,141.27333666666667,120163936,140196360.8,68.19588988316943,1.2322288809935404,1.5,2.75,NaN,NaN,1.275631444402139,0.8571116633435466,477.3623126425646,0.0002576563964302725,1.531077695571014,1.5308200391745836,14.337608834475672,1.1052248290042992,19.563455716895987,49.36712331745341,31.069420965650593,6085614045
1332855000,141.74001,141.83,141.08,141.17,NaN,NaN,135.87326567567567,121.47424892857147,126.6767698500005,130.2354602,135.85772,138.77820050000017,135.80202496308053,139.00917225401125,139.9440015384617,142.29900000919153,137.58900306773185,126.6767698500005,130.2354602,135.85772,138.77820050000017,141.36,119868432,139721992,65.28816750892946,1.1916902001895113,1.5,2.75,NaN,NaN,1.2380863412305576,0.8579066923122596,475.37517451230843,0.006120842980887442,1.5384710929006928,1.5323502499198054,10.98073864245764,0.9005789436065977,19.646897281999344,49.2533825534462,31.09972016455446,5965745613
1332941400,141.10001,141.32001,139.64,140.47,NaN,NaN,136.11029297297299,121.39710571428576,126.7406198500005,130.4002601,136.08032,138.95070050000015,135.9850828076656,139.14829870601017,140.16707769230786,142.09009437546948,138.24406100914624,126.7406198500005,130.4002601,136.08032,138.95070050000015,140.47667,148562000,137853357.6,60.84350291187298,0.4270654822936344,1.5,2.75,NaN,NaN,1.269652316856947,1.0776814042576501,471.92995097567234,-0.04916759936102477,1.4708907507185245,1.5200583500795493,11.43893291596327,-0.17765776009096076,17.970752279749757,51.5887313105892,30.440516409661036,5817183613
1333027800,139.64,140.49339,139.09,140.23,NaN,NaN,136.34732027027027,121.31996250000005,126.7951698000005,130.5400601,136.26951999999997,139.07570050000015,136.15155014854147,139.25131787686635,140.370923846154,141.58485245958337,139.15699523272463,126.7951698000005,130.5400601,136.26951999999997,139.07570050000015,139.93779666666669,164963632,138850232.8,59.35161920327093,0.01680530140123839,1.5,2.75,NaN,NaN,1.2792050085100222,1.1880688182756867,469.2373685721051,-0.11041819824201671,1.3820356022770284,1.492453800519045,10.94949083489719,-0.04989308624377876,16.267058104626496,54.08018610955807,29.652755785815426,5652219981
1333114200,140.92,141.05,140.05,140.81,NaN,NaN,136.58434756756756,121.24281928571433,126.8641198000005,130.69335009999998,136.4565198,139.25060050000016,136.3342344564418,139.39976379335528,140.42846230769248,141.64925509702366,139.2076695183613,126.8641198000005,130.69335009999998,136.4565198,139.25060050000016,140.63666666666668,135486688,139592654.4,61.78998788989721,0.5486898996062258,1.5,2.75,NaN,NaN,1.2592617936164492,0.9705860855096684,471.7751779011281,-0.11961275399081694,1.342937858030524,1.462550612021341,11.082059038728351,-0.028406103769531302,17.75303210068794,51.90021054728666,30.346757352025406,5787706669
1333373400,140.64,142.21001,140.36,141.84,NaN,NaN,136.82137486486488,142.21001,126.9368198000005,130.8491502,136.66251999999997,139.50510050000017,136.550146830699,139.63216724160716,140.576923846154,141.96707531385064,139.18677237845733,126.9368198000005,130.8491502,136.66251999999997,139.50510050000017,141.47000333333335,151741056,140141456.8,65.72241152017986,1.159744690307451,1.5,2.75,NaN,NaN,1.301458094072417,1.0827706480642207,475.99418252307385,-0.06670702621240321,1.379166829255837,1.4458738554682402,11.631959471507404,0.9968669894616959,21.26747572788557,47.08970780339672,31.642816468717697,5939447725
1333459800,141.64,141.8826,140.42999,141.25999,NaN,NaN,137.05840216216217,142.39925075949367,127.0078697500005,130.9829501,136.8555198,139.83060000000017,136.73484656282844,139.78719798050173,140.6184615384617,142.05473580319335,139.18218727373005,127.0078697500005,130.9829501,136.8555198,139.83060000000017,141.19086000000001,155806624,137825297.6,61.86152795533544,0.5283627955290097,1.5,2.75,NaN,NaN,1.3122546587815296,1.1304646295935152,473.14147660859845,-0.08024648759114061,1.3455657459793144,1.425812233570455,11.784838760724746,0.7488623672446614,19.18837643092339,49.87816334444445,30.93346022463215,5783641101
1333546200,140.22,140.339,139.34,139.86,NaN,NaN,137.29542945945946,142.58849151898735,127.0686697500005,131.1499401,137.0235196,140.03910000000016,136.85740159958027,139.79413150616824,140.58461538461555,142.06923666007722,139.09999410915387,127.0686697500005,131.1499401,137.0235196,140.03910000000016,139.84633333333332,146895936,137985488,53.66649700617317,0.36798382810350116,1.5,2.75,NaN,NaN,1.3556643260114192,1.0645752544644405,467.67161785002804,-0.18686905533778675,1.1922259143982217,1.3790949697360084,13.233322527562256,0.47413793103450075,19.311885683187395,49.70818320503492,30.97993111177767,5636745165
1333632600,139.38,140.2,139.25999,139.78999,NaN,NaN,137.53245675675674,142.777732278481,127.1203697000005,131.3046399,137.16811939999997,140.17660000000015,136.9724050662634,139.79373707700935,140.50307538461553,142.03608521917727,138.9700655500538,127.1203697000005,131.3046399,137.16811939999997,140.17660000000015,139.74999333333332,137439376,139009016,53.286337674573986,0.3787323867119814,1.5,2.75,NaN,NaN,1.325974731296318,0.9887083583125285,465.78343952388815,-0.2609428507486251,1.052916406300227,1.313859257048852,12.47837370629981,0.10025063374511259,20.901442894445744,47.56973961027006,31.528817495284212,5499305789
1333978200,138.03,139.84441,137.84,138.22,NaN,NaN,137.76948405405406,142.9669730379747,127.16811970000052,131.42023989999998,137.29491939999997,140.20909950000015,137.0213303577825,139.64385735538943,140.3323061538463,142.2908954626772,138.3737168450154,127.16811970000052,131.42023989999998,137.29491939999997,140.20909950000015,138.63480333333334,127555872,139244972,45.502111451249284,1.0821619965636498,1.5,2.75,NaN,NaN,1.3744343933465815,0.9160537013860723,461.6846592175043,-0.40586311331035585,0.8065303654109073,1.2123934787212631,13.9734151484745,-2.3938987359649846,5.592442901982097,74.06166080806396,20.34589628995394,5371749917
1334064600,137.95,138.34,135.75999,135.89999,NaN,NaN,135.75999,143.15621379746835,127.20611470000053,131.5246397,137.37651899999997,140.12509900000015,136.97735622610475,139.28729855963806,140.0007661538463,143.0726616032772,136.92887070441543,127.20611470000053,131.5246397,137.37651899999997,140.12509900000015,136.66666,235360256,145812809.6,36.91928209890888,2.423315733005978,1.5,2.75,NaN,NaN,1.4605469366789696,1.6141260609794876,456.1195367358967,-0.6345310894088549,0.41922961696019456,1.0537607063690495,13.075787193332864,-3.733094850180623,0,100,0,5136389661
1334151000,137.28999,137.53999,136.75,137,NaN,NaN,135.9725985869565,143.34545455696204,127.25706470000051,131.6338098,137.48911899999996,139.97199900000015,136.9782442172379,139.0694606015773,139.83153538461553,143.28049615359717,136.3825746156339,127.25706470000051,131.6338098,137.48911899999996,139.97199900000015,137.09666333333334,154132944,144314935.2,42.46109640985342,1.5002282035172514,1.5,2.75,NaN,NaN,1.4733650126304707,1.0680318276579874,461.7135606407684,-0.6839994454115204,0.1987613996046491,0.8827608450161695,14.83836957139802,-2.4702783512493762,4.423408537753337,77.11279241985785,18.463799042388803,5290522605
1334237400,137.13,138.89999,137.03,138.78999,NaN,NaN,136.18520717391303,143.5346953164557,127.31131465000053,131.78090969999997,137.63851859999997,139.91599850000017,137.04929307146386,139.04284435380805,139.76538153846167,143.25844233020973,136.2723207467136,127.31131465000053,131.78090969999997,137.63851859999997,139.91599850000017,138.23999333333333,154321504,144772835.2,50.13765695696719,0.5621240168037399,1.5,2.75,NaN,NaN,1.5038382260140088,1.0659562188362808,464.0522468908254,-0.5729638534715074,0.16655602817678528,0.7395198816482926,17.326097804559133,-1.0268915353348078,19.43967879143325,49.53697674532791,31.023344463238832,5444844109
1334323800,138.47,138.8168,137.00999,137.14,NaN,NaN,136.39781576086955,143.72393607594938,127.34896465000053,131.93125969999997,137.73191859999997,139.73699850000017,137.05285020591626,138.8616210820168,139.4215353846155,142.9995798937093,135.84349087552172,127.34896465000053,131.93125969999997,137.73191859999997,139.73699850000017,137.65559666666664,169246624,144979244.8,44.27399172218564,0.8685721368791169,1.5,2.75,NaN,NaN,1.5254790670130092,1.1673851952634808,459.95089923041195,-0.5853737523051116,0.007802691266903139,0.5931764435720147,18.398265113906596,-2.6063489808962546,18.045878239172573,51.48236030068885,30.47176146013858,5275597485
1334583000,137.84,138.03999,136.58,137.05,NaN,NaN,136.61042434782607,143.91317683544304,127.38061465000051,132.08196969999997,137.8193188,139.57449850000017,137.05273843313523,138.68908574087234,139.1046123076924,142.73648559617928,135.47273901920553,127.38061465000051,132.08196969999997,137.8193188,139.57449850000017,137.22333,147825184,144725835.2,43.97190869033166,0.9382335789547225,1.5,2.75,NaN,NaN,1.5208012765120782,1.0214153112035385,461.36676394753584,-0.5736172432464588,-0.12384511048605873,0.4497721327604,17.99495171991598,-3.377044557247597,17.119711252446237,52.815158096189414,30.06513065136434,5127772301
1334669400,137.84,139.36,137.698,139.082,NaN,NaN,136.8230329347826,144.10241759493672,127.4161746500005,132.27617969999997,137.910159,139.48609800000014,137.13231731811032,138.72650614650354,138.99784307692317,142.5434652408678,135.45222091297856,127.4161746500005,132.27617969999997,137.910159,139.48609800000014,138.71333333333334,147877568,145855163.2,51.94429732540109,0.42410764022213865,1.5,2.75,NaN,NaN,1.577172613904073,1.0138658430433953,465.3715687540728,-0.41060152118433185,-0.06347976872001482,0.34712175246431703,19.90375912205062,-1.5418307760038736,46.57239838384703,21.666554402081385,31.761047214071574,5275649869
1334755800,138.46001,139.08,138.38,138.61,NaN,NaN,137.0356415217391,144.29165835443038,127.43962465000051,132.47037969999997,137.99335899999997,139.39459800000014,137.19026565857658,138.71541032302702,138.8732276923078,142.35007433465594,135.39638104995967,127.43962465000051,132.47037969999997,137.99335899999997,139.39459800000014,138.69000000000003,123884192,145962891.2,50.15890501820164,0.09516266914429364,1.5,2.75,NaN,NaN,1.5146602843394963,0.8487375865298016,461.9762646605283,-0.32018859458726107,-0.05311399076975931,0.26707460381750175,19.880447757605236,-0.8937508937508937,22.346788716035213,45.7007230965207,31.95248818744409,5151765677
1334842200,138.63,139.14999,137.07001,137.72,NaN,NaN,137.24825010869563,144.48089911392407,127.45917465000052,132.68197969999997,138.05195919999997,139.27009750000016,137.21103955431866,138.62060933988158,138.63553538461548,141.9698272030696,135.30124356616136,127.45917465000052,132.68197969999997,138.05195919999997,139.27009750000016,137.98000000000002,198666752,149776810.4,46.8864349224252,0.5594982204952126,1.5,2.75,NaN,NaN,1.5550402640295327,1.3264186322931604,459.94777899423417,-0.30596729755150986,-0.11538451812188555,0.1905827794296243,19.457136535144258,-1.4807855698394357,4.313463946112345,77.41552036507302,18.271015688814632,4953098925
1334928600,138.33,138.83,137.87,137.95,NaN,NaN,137.46085869565215,144.67013987341772,127.47907465000051,132.89807969999998,138.10715919999998,139.20759750000016,137.24001839532576,138.5567417837024,138.33630461538473,141.1191774461346,135.55343178463488,127.47907465000051,132.89807969999998,138.10715919999998,139.20759750000016,138.21666666666667,143199568,150175954.4,47.83363286426591,0.1833015431212978,1.5,2.75,NaN,NaN,1.5232516737417099,0.953545250117618,463.2442417449211,-0.2680737969001188,-0.14450946669552422,0.12356433020459458,19.53906471893845,-0.19534076110549142,19.52386912611582,49.41877287758026,31.05735799630392,5096298493
1335187800,136.53999,136.91,135.94,136.78999,NaN,NaN,137.67346728260867,144.8593806329114,127.48622460000051,133.06887949999998,138.135759,139.06459750000016,137.22237022296005,138.38847970906406,137.99245846153858,140.31130427711005,135.6736126459671,127.48622460000051,133.06887949999998,138.135759,139.06459750000016,136.54666333333333,171844880,152742151.2,43.60952296109699,1.1832287169268474,1.5,2.75,NaN,NaN,1.558019411331587,1.1250652072785525,459.1896689635346,-0.305425654023742,-0.2582177373250829,0.04720791669865908,19.070940633842916,0.6548933520892727,18.84104269007448,50.39153406905609,30.767423240869434,4924453613
1335274200,136.91,137.66,136.8,137.31,NaN,NaN,137.8860758695652,145.04862139240507,127.50077465000051,133.24147949999997,138.19473920000001,138.84959750000016,137.22580668480475,138.28576735581987,137.7963046153847,139.86833409798248,135.72427513278694,127.50077465000051,133.24147949999997,138.19473920000001,138.84959750000016,137.2566666666667,137484192,153608164,45.91526743006369,0.6140589502145214,1.5,2.75,NaN,NaN,1.50887588195076,0.895031803127339,462.67577584320287,-0.2800707191707308,-0.3028804822647544,-0.02280976309402362,16.261270759497002,0.2262773722627754,17.800054886976234,51.86151308514369,30.33843202788008,5061937805
1335360600,138.64999,139.25,138.53,139.19,NaN,NaN,138.09868445652174,145.23786215189875,127.5368746500005,133.38347939999997,138.2713392,138.75059750000017,137.30283387363593,138.37188475050368,137.75015153846164,139.66311614082366,135.8371869360996,127.5368746500005,133.38347939999997,138.2713392,138.75059750000017,138.98999999999998,150255008,155127492.8,53.34295272762828,0.5830642464731038,1.5,2.75,NaN,NaN,1.5396704618114199,0.9685904496227375,466.91972578531,-0.1293118070843949,-0.18444952194951725,-0.055137714865122346,17.404430665781597,0.28821242800003727,39.806471739949714,27.28546178309976,32.90806647695053,5212192813
1335447000,138.89,140.32001,138.81,140.16,NaN,NaN,138.31129304347826,145.4271029113924,127.58067470000049,133.53537939999998,138.3707392,138.73509750000017,137.4148796040816,138.5421814409319,137.8993823076924,140.1992327001873,135.5995319151975,127.58067470000049,133.53537939999998,138.3707392,138.73509750000017,139.76333666666665,136292688,154514027.2,56.65089209851979,1.130769410574931,1.5,2.75,NaN,NaN,1.537551857396318,0.8820732361314055,469.4671918465821,0.03436551085554556,-0.012180826295690395,-0.046546337151235954,16.268721738950457,2.2021292110252375,72.82509778495708,6.110684445263409,21.06421776977952,5348485501
1335533400,140.58,140.78999,139.8,140.39,NaN,NaN,138.52390163043478,145.6163436708861,127.62342470000048,133.69067939999996,138.4873392,138.74309750000015,137.5315509921568,138.71816416084314,138.24476769230782,140.58801241829448,135.90152296632115,127.62342470000048,133.69067939999996,138.4873392,138.74309750000015,140.32666333333336,130725008,152802096,57.421740506777844,1.2474624529526432,1.5,2.75,NaN,NaN,1.4984402961537222,0.8555184216844774,470.49443275337904,0.15025620266731743,0.14127391618291085,-0.00898228648440659,14.033670482253658,2.4370667639547428,72.38637448161448,6.296331514590391,21.317294003795148,5479210509
1335792600,140.11,140.21001,139.49001,139.87,NaN,NaN,138.7365102173913,145.80558443037975,127.66812475000047,133.82717939999998,138.5637592,138.69609750000015,137.62325487481732,138.82786281219143,138.46553692307705,140.83868233681227,136.09239150934184,127.66812475000047,133.82717939999998,138.5637592,138.69609750000015,139.85667333333333,115092192,151782371.2,55.03877494861001,0.6719739105886978,1.5,2.75,NaN,NaN,1.4556938464284546,0.7582711423604378,467.8292699471878,0.18191426929481277,0.21841055013410937,0.0364962808392966,14.376878576577774,0.5665722379603478,80.68766135336855,3.224458047585569,16.08788059904587,5364118317
1335879000,139.78999,141.66,139.63,140.74001,NaN,NaN,138.94911880434782,141.66,127.7133748000005,133.97197959999997,138.6503594,138.64109800000014,137.74548056600096,139.0099720681732,138.6155384615386,141.28034408189342,135.95073284118376,127.7133748000005,133.97197959999997,138.6503594,138.64109800000014,140.67666999999997,138837312,151137184,58.166785670475576,1.3582628935170122,1.5,2.75,NaN,NaN,1.4967157145407077,0.9186178300106478,470.9339720677997,0.24740996161489598,0.3457587328579166,0.0983487712430206,12.315850695538716,1.5366928793016366,80.84228585082035,3.175967705052948,15.981746444126689,5502955629
1335965400,139.92,140.46001,139.46001,140.325,NaN,NaN,139.16172739130434,141.6324995,127.7619498000005,134.10792959999998,138.72745940000001,138.59434850000014,137.84663819086367,139.13521282358528,138.8605384615386,141.52330649681076,136.19777042626643,127.7619498000005,134.10792959999998,138.72745940000001,138.59434850000014,140.08167333333333,121080944,149400900,56.15966445348091,0.639686253425658,1.5,2.75,NaN,NaN,1.4812360206449429,0.8104432034880646,468.743081837779,0.2481101580500113,0.40848646880553474,0.16037631075552344,12.257728184334225,1.8915190241068762,53.60242803138993,16.62414609543074,29.773425873179317,5381874685
1336051800,140.34,140.45,138.99001,139.25,NaN,NaN,139.37433597826086,141.604999,127.7945498000005,134.26092959999997,138.7918194,138.56384850000012,137.9016719873004,139.14614493562476,139.02976923076938,141.48207786414775,136.577460597391,127.7945498000005,134.26092959999997,138.7918194,138.56384850000012,139.5633366666667,143762688,149244237.6,51.22854892743793,0.1876748399376503,1.5,2.75,NaN,NaN,1.4797184477417311,0.9632712814367314,465.32695787740795,0.16547657432689705,0.3672220286641448,0.20174545433724772,12.560127263237773,0.9423704240666991,24.105379047102975,43.57085635653818,32.323764596358835,5238111997
1336138200,138.515,139.30119,136.92,137,NaN,NaN,139.58694456521738,141.5774985,127.81629985000049,134.3704296,138.7991994,138.42434900000012,137.86631230152392,138.94175017985097,138.8696153846155,141.54880596717953,136.1904248020515,127.81629985000049,134.3704296,138.7991994,138.42434900000012,137.74039666666667,193931312,152068834.4,42.76474983112462,1.3150988560425336,1.5,2.75,NaN,NaN,1.5441092729030363,1.2752863712355778,461.0605330330704,-0.04042012892262367,0.15122029318396812,0.1916404221065918,16.009689040642968,0.15352731585111684,4.950243746261988,75.7373949278586,19.31236132587942,5044180685
1336397400,136.50999,137.56,136.46001,137.10001,NaN,NaN,139.7995531521739,141.549998,127.82934985000047,134.49932959999998,138.8025998,138.36834950000014,137.83626123087592,138.7663463531985,138.75346230769244,141.59369063882863,135.91323397655626,127.82934985000047,134.49932959999998,138.8025998,138.36834950000014,137.04000666666667,127765872,152079334.4,43.213848041454995,1.2288691479279557,1.5,2.75,NaN,NaN,1.512386467695676,0.840126454419832,462.2818710971078,-0.16271804827720532,-0.011757138239914866,0.15096091003729045,15.232617267565638,-0.15293132328308556,17.30107569255545,52.55594787234006,30.1429764351045,5171946557
1336483800,136.28,136.77,134.92,136.55,NaN,NaN,140.01216173913042,141.5224975,127.83919985000045,134.63432959999997,138.79039980000002,138.40085000000016,137.78581961397882,138.55526574813197,138.66346230769244,141.69657784036326,135.63034677502162,127.83919985000045,134.63432959999997,138.79039980000002,138.40085000000016,136.08,213383872,150980515.2,41.29480379679881,1.7093391586730968,1.5,2.75,NaN,NaN,1.5600738628602713,1.413320597809167,461.21617213130446,-0.2673187009319854,-0.18318746612769132,0.08413123480429409,15.222957455984238,-1.8966879804583565,2.833968318564588,81.93366676586338,15.232364915572024,4958562685
1336570200,135.10001,136.61,134.49001,135.74001,NaN,NaN,140.22477032608694,141.49499699999998,127.84874990000046,134.7743296,138.75401980000004,138.33785050000014,137.70559178597964,138.28714615307177,138.4934630769232,141.89306329292566,135.09386286092075,127.84874990000046,134.7743296,138.75401980000004,138.33785050000014,135.61334,220778192,154312777.6,38.57778238389731,1.7818986381190747,1.5,2.75,NaN,NaN,1.6000678726559663,1.4307188000483506,457.901025667205,-0.37132575346268315,-0.38002595702405984,-0.008700203561376699,12.461609068086796,-3.1535316780821807,2.2372051398472084,84.05483282646641,13.707962033686362,4737784493
1336656600,136.67999,136.85001,135.71001,136.02,NaN,NaN,140.43737891304346,141.46749649999998,127.86219990000045,134.9126796,138.73401980000003,138.19935100000015,137.63949014731378,138.07122747182683,138.4342330769232,141.97440942431422,134.89405672953217,127.86219990000045,134.9126796,138.73401980000003,138.19935100000015,136.19334,150600944,154126749.6,40.046240692629596,1.140499961921157,1.5,2.75,NaN,NaN,1.5672058817519676,0.9771239865295908,460.2258823676676,-0.3991022236668173,-0.5075779831448983,-0.10847575947808104,11.376221401003152,-3.1127573188973408,11.716893861142648,61.45837241465889,26.824733724198463,4888385437
1336743000,135.17,136.87,135.11,135.61,NaN,NaN,140.64998749999998,141.43999599999998,127.88724985000046,135.05287959999998,138.6916198,138.12285100000017,137.55990229839952,137.83682485546237,138.303463846154,142.11526102470182,134.49166666760615,127.88724985000046,135.05287959999998,138.6916198,138.12285100000017,135.86333333333334,153032368,153316036.8,38.59127977049336,1.162425332718572,1.5,2.75,NaN,NaN,1.5809768901982548,0.9981497773754089,457.8612686889746,-0.4207666683936066,-0.6344340949700893,-0.2136674265764827,10.989779863944115,-3.045685279187811,13.001685400659975,59.25279349037261,27.745521108967424,4735353069
1337002200,134.31,135.6144,133.91,134.11,NaN,NaN,140.8625960869565,141.41249549999998,127.90669985000046,135.19107970000002,138.62757980000003,137.97585100000018,137.42461201218777,137.48188915494214,137.91269461538474,142.28167364092766,133.5437155898418,127.90669985000046,135.19107970000002,138.62757980000003,137.97585100000018,134.5448,163909936,154120274.4,33.7588134576084,1.9013843192626647,1.5,2.75,NaN,NaN,1.5897928266126649,1.0635196221789234,452.6021913234244,-0.5060667691810941,-0.8462508880528503,-0.34018411887175626,11.838787198309518,-4.710821038026072,2.9626447006074397,81.56094021083976,15.476415088552795,4571443133
1337088600,134.02,134.81,133.13,133.34,NaN,NaN,141.07520467391302,141.384995,127.92674985000045,135.2851798,138.55937980000002,137.6887510000002,137.26443114896472,137.08742352113813,137.38807923076936,142.1700069154233,132.60615154611543,127.92674985000045,135.2851798,138.55937980000002,137.6887510000002,133.76,207629248,157107858.4,31.573157411588042,2.062938398661906,1.5,2.75,NaN,NaN,1.5962361961403322,1.3215713721421334,449.39838611459976,-0.5790405710042631,-1.063984832627085,-0.484944261622822,9.812826091635618,-4.97773026901834,3.039554181164949,81.3086954365012,15.651750382333844,4363813885
1337175000,133.94,134.55,132.8,132.82899,NaN,NaN,141.28781326086954,141.3574945,127.94699480000047,135.37176970000002,138.52095960000003,137.39970050000016,137.09049228037787,136.6818584238869,136.8064630769232,141.820086547585,131.7928396062614,127.94699480000047,135.37176970000002,138.52095960000003,137.39970050000016,133.39299666666668,207265568,161276927.2,30.176816618870987,2.098049006852976,1.5,2.75,NaN,NaN,1.6072193249874513,1.2851532553256633,446.4067310542694,-0.6226151928202566,-1.2632132526481428,-0.6405980598278862,9.745014855435171,-4.611138240574503,3.175486049006387,80.8698421741346,15.954671776859005,4156548317
1337261400,132.86,133.02,130.78999,130.86,NaN,NaN,141.50042184782606,141.329994,127.97384475000047,135.4276697,138.42435960000003,137.0567005000002,136.84615924977481,136.12739571685006,136.1133861538463,141.6997406156583,130.5270316920343,127.97384475000047,135.4276697,138.42435960000003,137.0567005000002,131.55666333333332,247992944,163743236.8,25.49761494213911,2.872383035970915,1.5,2.75,NaN,NaN,1.651704373202635,1.514523279534926,440.368600847538,-0.737104536011652,-1.5619787298424512,-0.8248741938307992,11.128375585416613,-4.481751824817509,0,100,0,3908555373
1337347800,131.37,131.60001,129.55,129.74001,NaN,NaN,141.71303043478258,141.3024935,127.99169480000047,135.4611698,138.27836000000002,136.6462010000002,136.5674867301758,135.51907326762625,135.26723230769247,141.1200551805714,129.41440943481354,127.99169480000047,135.4611698,138.27836000000002,136.6462010000002,130.29667333333336,319631104,172564813.6,23.285818448322345,3.337615635894606,1.5,2.75,NaN,NaN,1.6801547751167316,1.8522379929717028,435.781351438267,-0.8341789252402538,-1.8675978503811166,-1.0334189251408628,9.311013443294607,-5.368343882688254,0,100,0,3588924269
1337607000,130.16,132.02,129.95,131.97,NaN,NaN,141.9256390217391,141.274993,128.0502448500005,135.5159697,138.16635980000004,136.4052015000002,136.387193132914,135.1810662897571,134.62454000000014,139.9233504113456,129.32572958865467,128.0502448500005,135.5159697,138.16635980000004,136.4052015000002,131.31333333333336,177861056,172865622.4,35.317021835742395,2.091825571472055,1.5,2.75,NaN,NaN,1.7230001483226793,1.0288977850578114,441.1948120279042,-0.6995599988739301,-1.9078689237332753,-1.2083089248593453,15.736378231568928,-3.35408275357013,2.390989147050567,83.5836422502362,14.025368602713245,3766785325
1337693400,132.31,133.23,131.34,132.2,NaN,NaN,142.13824760869562,141.2474925,128.1108448500005,135.5896697,138.05875980000002,136.1497015000002,136.22298948064287,134.89715521454212,134.08223230769246,138.78613471507865,129.37832990030628,128.1108448500005,135.5896697,138.05875980000002,136.1497015000002,132.25666666666666,197531120,175867968.8,36.424494056694456,1.2112948299803066,1.5,2.75,NaN,NaN,1.7349287091567727,1.1231784920688752,443.0425906169905,-0.552817388220302,-1.8993306601347228,-1.3465132719144208,16.052084907512473,-2.607934094008114,12.47504763678572,60.31137904596546,27.213573317248827,3964316445
1337779800,131.25,132.46001,129.99001,132.27,NaN,NaN,142.35085619565217,141.219992,128.21089490000048,135.6511697,137.90291980000003,135.8037015000002,136.06797028532353,134.6469499560143,133.7183861538463,138.18920068511432,129.24757162257828,128.21089490000048,135.6511697,137.90291980000003,135.8037015000002,131.57334,204958320,178603134.4,36.779272489013856,1.595933107653345,1.5,2.75,NaN,NaN,1.7874338013598603,1.1475628391883361,443.60666669180824,-0.4151192208209158,-1.8654122979405656,-1.4502930771196498,16.08203472868527,-2.756947507719453,32.25280056677551,34.60310868549497,33.144090747729514,4169274765
1337866200,132.63,132.84,131.42,132.53,NaN,NaN,142.5634647826087,141.1924915,128.2861449000005,135.72146970000003,137.75531980000002,135.4222015000002,135.92922635256573,134.44533567448914,133.36684692307705,137.41775137577886,129.31594247037523,128.2861449000005,135.72146970000003,137.75531980000002,135.4222015000002,132.26333333333332,167357632,180156381.6,38.159654478133675,1.0918566517239965,1.5,2.75,NaN,NaN,1.7611885298341572,0.9289575562834239,445.72448361374734,-0.2772368039042503,-1.7968390819999627,-1.5196022780957124,16.07190859732704,-2.271218936656598,60.59423277034974,12.309760767063608,27.096006462586644,4336632397
1337952600,132.48,132.85001,131.78,132.10001,NaN,NaN,142.7760733695652,141.164991,128.38519500000046,135.7675198,137.58292000000003,135.00770200000022,135.7790610054063,134.2219713245378,133.02454000000014,136.67382179530108,129.3752582046992,128.38519500000046,135.7675198,137.58292000000003,135.00770200000022,132.24334,135465568,180393409.6,36.73126902409206,0.8064143371797107,1.5,2.75,NaN,NaN,1.7118186348460027,0.750945216348968,446.4376950271664,-0.18986859819653312,-1.7569380258413787,-1.5670694276448456,16.07465361467042,-1.4987622101260278,81.2481761013667,3.0736156875312544,15.67820821110204,4201166829
1338298200,133.16,133.92999,131.17,133.7,NaN,NaN,142.98868195652173,141.13749049999998,128.46704500000047,135.8275198,137.45092000000002,134.6992020000002,135.69752920127272,134.17225976981993,132.8676161538463,136.19782427601874,129.5374080316739,128.46704500000047,135.8275198,137.45092000000002,134.6992020000002,132.93332999999998,152883440,182282972,44.98360185641555,0.30335382435339525,1.5,2.75,NaN,NaN,1.7866880180712894,0.8387148745852135,450.8622255772062,-0.00876037702566368,-1.5780198989269252,-1.5692595219012615,17.05580895618053,0.26998650067495517,81.41864941563811,2.991357962211926,15.58999262214995,4354050269
1338384600,132.56,133.6924,131.49001,131.75999,NaN,NaN,143.20129054347825,141.10998999999998,128.53524495000048,135.86471980000002,137.2691196,134.25020100000023,135.54311589926203,133.94251979174183,132.53992307692323,135.3649086286213,129.71493752522517,128.53524495000048,135.86471980000002,137.2691196,134.25020100000023,132.31413333333333,162370368,183459624.8,38.43709595776471,0.8755556488731595,1.5,2.75,NaN,NaN,1.8169238739233384,0.8850468770826789,445.29446121437616,-0.004286285672546963,-1.5746173789919453,-1.5703310933193984,18.759895480771743,-0.8047941943998947,52.28976686327232,17.495405215391024,30.214827921336656,4191679901
1338471000,131.71001,132.45,130.34,131.47,NaN,NaN,143.41389913043477,141.08248949999998,128.58949495000047,135.90231970000002,137.08971960000002,133.8074510000002,135.38338586399686,133.70704171633784,132.2214615384617,134.463555220125,129.97936785679843,128.58949495000047,135.90231970000002,137.08971960000002,133.8074510000002,131.42,196186192,187214887.2,37.55723769584712,1.0932706228769953,1.5,2.75,NaN,NaN,1.837857882928813,1.0479198258972644,444.3326920112926,-0.005447393214738527,-1.5771403348378215,-1.571692941623083,18.698941759238327,0.46614702735746993,19.906489795463504,48.919748014914184,31.17376218962232,3995493709
1338557400,129.41,131.5042,128.16,128.16,NaN,NaN,143.6265077173913,141.05498899999998,128.6323449500005,135.9037197,136.84871940000002,133.25295100000022,135.10011583011465,133.17875202906757,131.7637692307694,134.6215963412367,128.90594212030211,128.6323449500005,135.9037197,136.84871940000002,133.25295100000022,129.27473333333333,253245008,192689003.2,29.310013182928287,2.9267096554389815,1.5,2.75,NaN,NaN,1.9454537484338978,1.3142680889637817,438.3587046837061,-0.20279723427155516,-1.825189484462527,-1.6223922501909718,22.216275499585564,-1.2178278697527583,3.3454562754477344,80.28301325010347,16.371530474448797,3742248701
1338816600,128.39,128.74001,127.13499,128.10001,NaN,NaN,127.13499,141.02748849999998,128.6744950000005,135.8934198,136.62671960000003,132.80795150000023,134.8256018759925,132.6950623120135,131.36069307692327,134.65963624457711,128.06174990926942,128.6744950000005,135.8934198,136.62671960000003,132.80795150000023,127.99167,202548256,193119850.4,29.184927287485777,2.818777583715847,1.5,2.75,NaN,NaN,1.9211370521171918,1.0488215249777346,435.78317884742853,-0.3048987064119826,-2.00351563320595,-1.6986169267939675,21.831948952931107,-2.932477078123817,2.651952940214253,82.67716656483752,14.670880494948234,3539700445
1338903000,127.85001,129.25999,127.78,129.07001,NaN,NaN,126.90801631578948,140.99998799999997,128.74729510000049,135.8921199,136.41512000000003,132.4064515000002,134.59989239065948,132.34981923467888,131.07154076923095,134.4626717327921,127.6804098056698,128.74729510000049,135.8921199,136.41512000000003,132.4064515000002,128.70333333333335,164149376,194939025.6,34.08344187925981,1.9659123499136024,1.5,2.75,NaN,NaN,1.8896265483945343,0.8420549733167436,439.7052929104568,-0.27552153691673853,-2.0430188479398907,-1.7674973110231522,19.475196446650195,-2.367617246596061,2.8283975838359146,82.07573414371043,15.095868272453643,3703849821
1338989400,129.97,132.03,129.92999,131.97,NaN,NaN,126.68104263157895,140.97248749999997,128.8439451000005,135.91672,136.22232000000005,132.1774515000002,134.49675935573165,132.31364597423328,131.15692538461556,134.57821405358317,127.73563671564796,128.8439451000005,135.91672,136.22232000000005,132.1774515000002,131.30999666666665,184202752,193479969.6,46.08997635844351,0.13398390414750813,1.5,2.75,NaN,NaN,1.9660810806520679,0.9520507594704523,442.2108423068523,-0.0414806794709055,-1.819348160361784,-1.7778674808908785,24.006075215336864,-0.2268088001814556,14.320284760594346,57.29865992078083,28.381055318624817,3888052573
1339075800,133.47,133.53,131.78,132.05,NaN,NaN,126.45406894736843,140.94498699999997,128.9405451000005,135.94881999999998,136.03992000000005,131.9929510000002,134.40080800844805,132.2885368338301,131.3346169230771,134.68224156396357,127.98699228219063,128.9405451000005,135.94881999999998,136.03992000000005,131.9929510000002,132.45333333333335,184772688,191679694.4,46.38012936958422,0.7758094582389424,1.5,2.75,NaN,NaN,1.9506467177483486,0.9639658941359414,440.73205456454,0.1286999731763918,-1.6169925144203887,-1.7456924875967805,24.00693531145829,-0.3621821474383081,36.892927065134586,30.093703288231843,33.01336964663358,4072825261
1339162200,131.71001,133.125,131.28999,133.10001,NaN,NaN,126.22709526315789,140.91748649999997,129.02384515000048,135.98642009999998,135.89252020000006,131.84695150000022,134.34979632184223,132.36581999251297,131.42154076923094,134.88724509942787,127.95583643903403,129.02384515000048,135.98642009999998,135.89252020000006,131.84695150000022,132.505,143915632,191345428.8,50.17090995397586,0.8711548958503731,1.5,2.75,NaN,NaN,1.942386952194896,0.7521247458199012,444.3081187829396,0.31154357441932623,-1.3562630195726229,-1.667806593991949,24.438705064245212,0.7570022137015735,70.8605179482092,7.028382572611823,22.111099479178957,4216740893
1339421400,134.17,134.25,131.28,131.41499,NaN,NaN,126.00012157894737,140.88998599999996,129.09052010000048,135.99286999999995,135.71622000000008,131.6372010000002,134.23470587784843,132.2752647551308,131.36115538461556,134.79773405653717,127.92457671269395,129.09052010000048,135.99286999999995,135.71622000000008,131.6372010000002,132.31499666666664,169756064,192181613.6,44.70844393190609,0.5107156776674439,1.5,2.75,NaN,NaN,2.0157878841809747,0.8833106394523477,439.0519682291533,0.31748580691192485,-1.270949335352043,-1.5884351422639678,25.540738631187384,-1.7090575916230366,76.35797824478878,4.7001632143581205,18.94185854085311,4046984829
1339507800,131.78999,133.00999,131.16,132.92,NaN,NaN,125.77314789473685,140.86248549999996,129.17372010000048,136.00746989999996,135.55842000000007,131.57770100000022,134.18314878459947,132.336668111785,131.41115538461557,134.9173799659066,127.90493080332453,129.17372010000048,136.00746989999996,135.55842000000007,131.57770100000022,132.36333,181931744,193082704,49.94999591045703,0.544333072735235,1.5,2.75,NaN,NaN,2.0039451781680473,0.9422477530664787,443.63454392410915,0.4150948347080483,-1.0695665988789074,-1.4846614335869557,25.426205716569317,0.8803962416815604,77.06497889904016,4.439943434348758,18.495077666611074,4228916573
1339594200,132.53,133.36,131.62,132.07001,NaN,NaN,125.54617421052632,140.83498499999996,129.24422015000047,136.01277009999995,135.36302020000005,131.51420150000018,134.1002805969681,132.3112721011388,131.37577153846172,134.84520887091253,127.90633420601092,129.24422015000047,136.01277009999995,135.36302020000005,131.51420150000018,132.35000333333335,172223872,191312435.2,47.22697884694758,0.37027151590092644,1.5,2.75,NaN,NaN,1.9850919511560445,0.9002230922415231,440.01125741484645,0.4138053240071755,-0.9674047785779862,-1.3812101025851617,24.178145326162394,0.45638548718338595,47.78851129130495,20.736384435382085,31.475104273312965,4056692701
1339680600,132.34,134,131.98,133.47,NaN,NaN,125.3192005263158,140.8074845,129.30477015000048,136.03137009999995,135.20722040000007,131.54625200000018,134.0755637108125,132.42162713912558,131.48115538461556,135.111672692401,127.85063807683014,129.30477015000048,136.03137009999995,135.20722040000007,131.54625200000018,133.15,230616256,192479969.6,51.88001268246592,0.85243268589215,1.5,2.75,NaN,NaN,1.9875853832163277,1.1981311950498148,443.29984598972396,0.49324104484008213,-0.7646587965350591,-1.2578998413751412,24.804753287569433,4.143258426966294,50.90744996345941,18.449889688686966,30.64266034785362,4287308957
1339767000,133.38,134.25999,133.10001,134.14,NaN,NaN,125.09222684210526,140.77998399999998,129.36707020000048,136.05816999999993,135.09282040000008,131.71025200000017,134.07809062411397,132.58528169730408,131.51500153846172,135.23473778638115,127.7952652905423,129.36707020000048,136.05816999999993,135.09282040000008,131.71025200000017,133.83333333333334,169444432,188552544,53.97164000744408,1.1065389328114312,1.5,2.75,NaN,NaN,1.9284707129865895,0.8986589541852058,445.3549687139827,0.5713991726195153,-0.543650875600747,-1.1150500482202623,17.874826242589407,4.715058179932998,52.51880191524709,17.322908030345037,30.15829005440789,4456753389
1340026200,133.58,134.73,133.28,134.39999,NaN,NaN,124.86525315789474,140.75248349999998,129.42797015000048,136.07656989999995,134.98502040000008,131.94325100000017,134.09071412905067,132.7581110594656,131.71807846153862,135.7447372673889,127.69141965568836,129.42797015000048,136.07656989999995,134.98502040000008,131.94325100000017,134.13666333333333,131365440,179139260.8,54.79280957158883,1.2906483729216145,1.5,2.75,NaN,NaN,1.8942942334875466,0.7333146258020061,447.0517247046071,0.6171911369773119,-0.3435611269986225,-0.9607522639759344,17.679986400776713,4.129526293520862,77.08884829830465,4.430653053105496,18.480498648589847,4588118829
1340112600,135.08,136.25,134.3714,135.7,NaN,NaN,124.63827947368422,140.72498299999998,129.50177015000048,136.11476989999994,134.93462040000009,132.12975100000017,134.15382337889181,133.03829095856412,132.04346307692325,136.58771449172826,127.49921166211821,129.50177015000048,136.11476989999994,134.93462040000009,132.12975100000017,135.44046666666665,137382560,177115336,58.75515015330604,2.0024888068216784,1.5,2.75,NaN,NaN,1.8931732168098652,0.7756672183373212,452.5956668144823,0.7052610699774509,-0.07917592650412075,-0.7844369964815716,17.83749696866897,2.8263999393801544,75.79773954338691,4.910452662047924,19.291807794565162,4725501389
1340199000,135.71001,136.10001,134.27,135.48,NaN,NaN,124.41130578947369,140.69748249999998,129.58992010000048,136.15136979999997,134.92622060000008,132.29375100000019,134.2058303052098,133.2708346767961,132.60654000000017,136.89319174950634,128.319888250494,129.58992010000048,136.15136979999997,134.92622060000008,132.29375100000019,135.28333666666666,206466624,177562111.2,57.83137039829346,1.357900057801929,1.5,2.75,NaN,NaN,1.8886615584663022,1.1627853634125973,452.01508206469515,0.7166023234281378,0.11131590780360057,-0.6052864156245372,14.330629941621876,2.5975009466111154,70.87292810021486,6.943854626604286,22.183217273180848,4519034765
1340285400,135.64,135.78,132.33,132.44,NaN,NaN,124.18433210526317,140.66998199999998,129.66717005000046,136.16206979999995,134.83502060000006,132.30225100000018,134.13658205794667,133.1917075647203,132.94038538461558,136.35933856538358,129.52143220384758,129.66717005000046,136.16206979999995,134.83502060000006,132.30225100000018,133.51666666666668,205272320,177577811.2,46.866150023628784,0.46622811979063344,1.5,2.75,NaN,NaN,2.0001857328615658,1.1559570343437142,446.72075956353706,0.4976579061576816,0.016785967072564745,-0.48087193908511683,20.446314195727542,-0.4958752444872091,35.449193532291936,31.26213156453382,33.28867490317423,4313762445
1340371800,133.13,133.71001,132.62,133.46001,NaN,NaN,123.95735842105263,140.64248149999997,129.73302015000047,136.18346979999995,134.72842100000005,132.3487515000002,134.11004982038014,133.2172601776041,133.27807769230787,135.867866377611,130.68828900700476,129.73302015000047,136.18346979999995,134.72842100000005,132.3487515000002,133.26334,130029184,175711388.8,50.273063577600574,0.06318503330729493,1.5,2.75,NaN,NaN,1.9480303233714549,0.7400156864504845,450.462416950311,0.4038184102382253,0.02390107371266481,-0.3799173365255605,20.41302366333457,1.5561542865087328,32.251854893032096,34.42746246479493,33.320682642172976,4443791629
1340631000,132.05,132.10001,130.85001,131.32001,NaN,NaN,123.73038473684211,140.61498099999997,129.79442025000046,136.17196989999997,134.61202120000004,132.30975150000017,134.0006364940907,133.03656968449894,133.22807846153864,135.93920825729833,130.51694866577895,129.79442025000046,136.17196989999997,134.61202120000004,132.30975150000017,131.42334333333335,146375680,176256894.4,43.91152230263849,1.2929639977299139,1.5,2.75,NaN,NaN,1.9953138717020662,0.8304678265113016,445.83128658925955,0.19072663709353777,-0.1415090401586383,-0.33223567725217606,21.285310746993648,-1.2037240445380615,13.676004981055037,58.1289633703906,28.19503164855436,4297415949
1340717400,131.7,132.38,130.92999,131.98,NaN,NaN,123.50341105263159,140.58748049999997,129.87472025000045,136.16496999999995,134.51062120000003,132.2237515000002,133.92139584726363,132.93594400026095,133.22269384615404,135.94342251338412,130.50196517892397,129.87472025000045,136.16496999999995,134.51062120000003,132.2237515000002,131.76333,141633936,175694419.2,46.1737153683565,0.8505968917047108,1.5,2.75,NaN,NaN,1.956363595151918,0.8061379333783643,448.29596240276356,0.09231458567718753,-0.21684244515569162,-0.30915703083287915,20.324590153107057,-0.06815324690291656,13.703465662690391,58.08410255694716,28.21243178036245,4439049885
1340803800,132.42,133.42999,131.96671,133.173,NaN,NaN,123.27643736842106,140.55997999999997,129.95723525000048,136.15130009999996,134.39244120000004,132.2944020000002,133.8920469905082,132.95852076214086,133.22830846153863,135.9483024040494,130.50831451902786,129.95723525000048,136.15130009999996,134.39244120000004,132.2944020000002,132.85656666666668,108087936,172980297.6,50.09215033978029,0.18748366879988568,1.5,2.75,NaN,NaN,1.9211433383553522,0.624856920121289,453.25068699396417,0.10474553385553298,-0.17822511351346293,-0.2829706473689959,20.66245030767398,-0.22252191503708477,36.2233822499902,30.524691266572006,33.25192648343779,4547137821
1340890200,132.28999,132.99001,131.28,132.78999,NaN,NaN,123.04946368421054,140.53247949999997,130.03248515000047,136.13469999999995,134.27604100000005,132.3604015000002,133.8488290693118,132.94247021336554,133.33407769230786,135.86409802923666,130.80405735537906,130.03248515000047,136.13469999999995,134.27604100000005,132.3604015000002,132.35333333333332,169242688,171633122.4,48.86231592909575,0.6158590285758018,1.5,2.75,NaN,NaN,1.9191330999013985,0.9860724179192581,454.04841102918164,0.0851830633366813,-0.1764918181981443,-0.2616748815348256,19.772543492723205,-1.0064186670642594,39.92044282449816,27.155032648486156,32.92452452701569,4377895133
1340976600,135.2,136.27,134.85001,136.105,NaN,NaN,122.82249000000002,140.50497899999996,130.11616015000047,136.14785009999997,134.24374100000003,132.7576515000002,133.93730636071132,133.24366352637836,133.57907769230786,136.48950903978124,130.66864634483449,130.11616015000047,136.14785009999997,134.24374100000003,132.7576515000002,135.74167,212251056,169583424.8,58.38548002020598,1.7760497714703265,1.5,2.75,NaN,NaN,2.0306243070513,1.2516026035582222,459.7430200086087,0.28239808254284837,0.0913227216437349,-0.19107536089911348,24.43270788405528,1.2686087253429017,47.12890942602422,21.23568090879881,31.635409665176972,4590146189
1341235800,136.48,136.64999,135.52,136.50999,NaN,NaN,122.59551631578948,140.47747849999996,130.19156015000047,136.16104999999996,134.21494080000002,133.17815050000019,134.03819591519323,133.55474223815185,133.9206146153848,137.074417159802,130.7668120709676,130.19156015000047,136.16104999999996,134.21494080000002,133.17815050000019,136.22666,129524432,165932233.6,59.38069485718459,1.7676872404668198,1.5,2.75,NaN,NaN,1.9662932851190635,0.780586322439524,463.5013441032019,0.41879237502560657,0.33241510788289474,-0.08637726714271182,24.44735480760996,0.5968975681650694,74.10542087783817,5.581089438988606,20.31348968317323,4719670621
1341322200,136.48,137.50999,136.34,137.412,NaN,NaN,122.36854263157896,140.44997799999996,130.27101515000047,136.18156999999997,134.22738100000004,133.5952500000002,134.17050195773467,133.9221001202326,134.22384538461557,137.86622042422596,130.5814703450052,130.27101515000047,136.18156999999997,134.22738100000004,133.5952500000002,137.08732999999998,80450192,161747274.4,61.584293581185236,2.2768233809036733,1.5,2.75,NaN,NaN,1.9094144790391294,0.4973820566586314,467.58660056863334,0.5406795428335639,0.5894721613992431,0.04879261856567918,24.14129885610515,1.42604074402127,71.6680286924005,6.603108386987521,21.728862920611974,4800120813
1341495000,136.89999,137.8,136.28999,136.78999,NaN,NaN,122.14156894736843,140.42247749999996,130.35341510000046,136.20585999999994,134.21698080000002,133.83624950000018,134.273226979,134.19523248973428,134.42769076923094,138.31674015585142,130.53864138261045,130.35341510000046,136.20585999999994,134.21698080000002,133.83624950000018,136.95999333333333,126177440,158846008.8,59.199299592405296,1.7221061505985407,1.5,2.75,NaN,NaN,1.8808855876791932,0.7943381200019172,466.6571761299434,0.5485926851418456,0.7345334749929862,0.18594078985114057,24.325121502100984,3.284498640893983,47.17465112787842,21.22139702340025,31.603951848721337,4673943373
1341581400,135.47,135.77,134.85001,135.49001,NaN,NaN,121.9145952631579,140.39497699999995,130.4300151500005,136.20716009999995,134.14298100000005,134.00825000000017,134.3209439602157,134.3185446335691,134.51153846153863,138.44137113879674,130.58170578428053,130.4300151500005,136.20716009999995,134.14298100000005,134.00825000000017,135.37000666666665,151192000,157166974.4,54.452919825081366,0.42423427580103035,1.5,2.75,NaN,NaN,1.885106617130679,0.9619832701952172,463.67262205517613,0.44013748107827616,0.7361126411989858,0.2959751601207096,20.529608569299153,1.5210548837812923,48.96327880979413,19.87630980974381,31.160411380462065,4522751373
1341840600,135.38,135.57001,134.7,135.32001,NaN,NaN,121.68762157894739,140.36747649999995,130.52346520000046,136.20846019999993,134.04618120000004,134.11925000000016,134.3601230205994,134.4139222875149,134.48230846153862,138.38188355176354,130.5827333713137,130.52346520000046,136.20846019999993,134.04618120000004,134.11925000000016,135.19667333333334,103780432,155160214.4,53.84494196736118,0.24127291295551584,1.5,2.75,NaN,NaN,1.8125997159070597,0.6688598130733183,461.54061489162,0.3355397743597069,0.7153998780703432,0.37986010371063633,20.309721202463475,3.0459942852578217,16.069252727967825,54.386838375744695,29.543908896287483,4418970941
1341927000,136.00999,136.23,133.67999,134.14,NaN,NaN,121.46064789473685,140.33997599999995,130.62986520000047,136.20426019999994,133.92118120000004,134.25550050000015,134.35149074528175,134.38783445060872,134.3792315384617,138.23850180523212,130.5199612716913,130.62986520000047,136.20426019999994,133.92118120000004,134.25550050000015,134.68332999999998,167884816,155066652,49.697127451029786,0.43839821576504306,1.5,2.75,NaN,NaN,1.8652718790565543,1.0826622864082989,458.41605306666946,0.17362181521961378,0.5968873727351536,0.4232655575155398,18.32006332762331,1.6366116078193642,1.8201528379778733,85.69843881235299,12.481408349669117,4251086125
1342013400,134.21001,134.60001,133.38,134.16,NaN,NaN,121.23367421052633,140.31247549999995,130.73296525000046,136.18537019999994,133.80698120000005,134.31750050000014,134.3439813042903,134.36613593150312,134.51153923076942,138.21040670820577,130.81267175333306,130.73296525000046,136.18537019999994,133.80698120000005,134.31750050000014,134.04666999999998,141734000,153056764.8,49.76775692583053,0.4948829407503733,1.5,2.75,NaN,NaN,1.819181744838229,0.9260224478493615,459.1689667276504,0.06045075483524048,0.4988290010595904,0.4383782462243499,18.252131069271254,0.7411412223198357,4.784577317876814,76.14088747888763,19.07453520323556,4392820125
1342099800,133.38,134.2269,132.60001,133.50999,NaN,NaN,121.0067005263158,140.28497499999997,130.81931515000045,136.15637009999992,133.66238080000002,134.38949950000014,134.3112757629456,134.28459822374091,134.51538384615404,138.20997290357414,130.82079478873393,130.81931515000045,136.15637009999992,133.66238080000002,134.38949950000014,133.44563333333335,143583120,151624727.2,47.43654904033533,0.798919834141464,1.5,2.75,NaN,NaN,1.8054466202069273,0.9469637482717925,456.2474339903097,-0.0591303322344206,0.36446533093132416,0.42359566316574476,17.93759487959787,0.5422095445597962,4.580527622615655,76.68904732766674,18.7304250497176,4249237005
1342186200,133.86,135.89,133.84,135.75,NaN,NaN,120.77972684210528,140.25747449999997,130.91036520000043,136.14917009999994,133.57088080000003,134.50349950000015,134.36769632126146,134.42416029767034,134.8561523076925,138.098503028489,131.613801586896,130.91036520000043,136.14917009999994,133.57088080000003,134.50349950000015,135.16,129644128,146576120.8,55.22090750297263,0.6792470841850291,1.5,2.75,NaN,NaN,1.8464868616207182,0.8844832793528261,461.2726866761914,0.008108633109347674,0.43373145455242934,0.42562282144308167,20.056690376966124,-0.2608280371771719,20.131454175768006,48.60701409492965,31.261531729302355,4378881133
1342445400,135.44,135.83,134.89999,135.42999,NaN,NaN,120.55275315789476,140.22997399999997,131.01179015000042,136.14314999999996,133.49448060000003,134.56799900000016,134.40935489689826,134.5199536026541,135.12153615384634,137.91208008338947,132.3309922243032,131.01179015000042,136.14314999999996,133.49448060000003,134.56799900000016,135.38666,97525184,142980158.4,53.99076142967302,0.5212472434758652,1.5,2.75,NaN,NaN,1.7810242286478104,0.6820889352155033,459.22102824322036,0.025525033387955587,0.45752911317802614,0.43200407979007055,14.114511617586583,-0.7911508893964347,21.044177687994207,47.37953790512928,31.576284406876514,4281355949
1342531800,135.97,136.64,134.55,136.36,NaN,NaN,120.32577947368422,140.20247349999997,131.11334015000045,136.14043999999996,133.4816806,134.66599950000017,134.4858507832944,134.69519611668704,135.3666900000002,137.9840218399627,132.7493581600377,131.11334015000045,136.14043999999996,133.4816806,134.66599950000017,135.85,138860192,143354896,56.98948568727753,0.9566234258689289,1.5,2.75,NaN,NaN,1.8030939266015362,0.9686463167606079,462.1476675088806,0.09051579803648768,0.5451488273356802,0.45463302929919247,14.627038753154736,-0.7655808808546506,51.98750002595015,17.688194833600168,30.324305140449688,4420216141
1342618200,136.03999,137.64,135.96001,137.37,NaN,NaN,120.0988057894737,140.17497299999997,131.23444020000042,136.14484009999995,133.48708040000002,134.74949950000018,134.5989546741456,134.94993934366923,135.71899846153866,138.07397199793573,133.3640249251416,131.23444020000042,136.14484009999995,133.48708040000002,134.74949950000018,136.99000333333333,113349632,142153249.6,60.035841311304026,1.4232702227703566,1.5,2.75,NaN,NaN,1.794300788987139,0.7973762985999302,464.9760946336268,0.18681680044402016,0.6881540298542177,0.5013372294101975,14.76606041846369,0.42401494436838233,49.78683745783974,19.25288627199891,30.960276270161355,4533565773
1342704600,137.64999,138.17999,137.21001,137.73,NaN,NaN,119.87183210526317,140.14747249999996,131.3734402500004,136.15054009999997,133.5106804,134.8619995000002,134.72174076535558,135.21470702522453,135.84399846153866,138.42893596476793,133.2590609583094,131.3734402500004,136.15054009999997,133.5106804,134.8619995000002,137.70666666666668,129847184,138322277.6,61.09361475091949,1.4800850297798325,1.5,2.75,NaN,NaN,1.7354207326309141,0.9387293663244308,466.0885800323518,0.2557869208638859,0.8210708804900548,0.565283959626169,14.53669084866628,1.6532510404272442,81.66460350517299,2.9126597967509773,15.422736698076031,4663412957
1342791000,136.95,137.16,136.32001,136.47,NaN,NaN,119.64485842105265,140.11997199999996,131.49409025000043,136.13964999999996,133.5252802,135.06349950000018,134.79029995102792,135.33425873710792,135.84092230769252,138.42277562785358,133.25906898753146,131.49409025000043,136.13964999999996,133.5252802,135.06349950000018,136.65000333333333,142904432,135203883.2,55.55155816525376,0.6194127600041681,1.5,2.75,NaN,NaN,1.7121756803001342,1.0569550860355763,462.6458670429679,0.20004344074328828,0.8153382605552792,0.615294819811991,14.44574329926762,0.8498299697140154,49.621967733717426,19.372885895765194,31.005146370517373,4520508525
1343050200,134.47,136.38519,133.84,135.09,NaN,NaN,119.41788473684213,140.09247149999996,131.59744025000043,136.12034999999995,133.5066802,135.14499900000018,134.80205289412487,135.3109960002405,135.66230692307713,138.10205757969572,133.22255626645853,131.59744025000043,136.12034999999995,133.5066802,135.14499900000018,135.10506333333333,145210816,135962964.8,50.1822482401083,0.4670959546957335,1.5,2.75,NaN,NaN,1.7777345602786956,1.068017428228367,457.44661151313323,0.060939998123332506,0.6914698174661567,0.6305298193428241,15.735255743266904,0.7082152974504378,43.354773465156256,24.232455569876006,32.41277096496773,4375297709
1343136600,135.19,135.25,133.03,133.925,NaN,NaN,119.19091105263159,140.06497099999996,131.68461520000042,136.08229999999995,133.4729802,135.2752485000002,134.7676586629827,135.17899638116998,135.44192307692327,137.95100898609223,132.93283716775431,131.68461520000042,136.08229999999995,133.4729802,135.2752485000002,134.06833333333333,173301120,137309236.8,46.128789057201,1.4253149998136792,1.5,2.75,NaN,NaN,1.8093249488302174,1.2621228115368854,452.6523599047121,-0.10953791858253104,0.4936074211146604,0.6031453396971914,15.715997314596104,-0.1751639833035072,15.760360662936893,54.84059879584837,29.399040541214735,4201996589
1343223000,134.21001,134.56,133.25,133.96001,NaN,NaN,118.96393736842107,140.03747049999996,131.77586520000042,136.04878009999996,133.4699804,135.37424900000022,134.73598616639515,135.06290244010617,135.32423076923098,137.95388995207662,132.69457158638534,131.77586520000042,136.04878009999996,133.4699804,135.37424900000022,133.92333666666667,129122256,136683652.8,46.26924802647918,0.9798825538422148,1.5,2.75,NaN,NaN,1.7736588810566307,0.9446795820487466,454.2053456438232,-0.21391251989421012,0.3357546898294288,0.5496672097236389,15.716936239073215,0.3370684096373788,16.89082796508555,53.14750909826259,29.961662936651877,4331118845
1343309400,135.89,136.46001,135.25999,136.17,NaN,NaN,118.73696368421054,140.00996999999995,131.8588152000004,136.04298009999994,133.5265804,135.5240990000002,134.7922220030071,135.1683403029532,135.38961461538483,138.0575917384389,132.72163749233076,131.8588152000004,136.04298009999994,133.5265804,135.5240990000002,135.96333333333334,156526432,139105577.6,54.35892982643812,0.4895174238082005,1.5,2.75,NaN,NaN,1.8255403895525857,1.1252347655684514,458.2083932633129,-0.13209366232621433,0.38455013181587105,0.5166437941420854,17.944735102426915,0.30939226519336094,19.12586612605149,49.96197472695545,30.912159146993062,4487645277
1343395800,136.89,139.07001,136.1364,138.675,NaN,NaN,118.50999000000002,139.98246949999995,131.9536902000004,136.08223009999995,133.6435006,135.8183495000002,134.94448780681074,135.50230789314813,135.73846076923098,138.81612393870506,132.6607975997569,131.9536902000004,136.08223009999995,133.6435006,135.8183495000002,137.96047000000002,236768880,142481887.2,61.444805445359705,2.0557532006328483,1.5,2.75,NaN,NaN,1.9046882188702572,1.6617472203161556,463.68696113113685,0.08126648556696969,0.6182269011007975,0.5369604155338278,18.435571646459078,2.3960793322070004,51.01074260869722,18.37424030487681,30.61501708642598,4724414157
1343655000,138.52,139.339,138.27,138.67999,NaN,NaN,118.2830163157895,139.95496899999995,132.0433401500004,136.11212999999995,133.7999004,135.9470990000002,135.0909780888966,135.80494428427687,136.08615230769254,139.38526771076027,132.7870369046248,132.0433401500004,136.11212999999995,133.7999004,135.9470990000002,138.76299666666668,106781936,137208431.2,61.45764214808494,1.8141584905817618,1.5,2.75,NaN,NaN,1.8449962032366665,0.778246169467172,462.68696113113685,0.20615945386427836,0.7946597328641758,0.5885002789998974,18.27290892726158,1.7013713699031898,75.22415881713516,5.139081372482028,19.63675981038281,4831196093
1343741400,138.49001,138.87,137.71001,137.71001,NaN,NaN,118.05604263157896,139.92746849999995,132.1293402500004,136.11883019999996,133.9593004,136.0071000000002,135.19368522266538,135.98637911434574,136.409230769231,139.4483041861339,133.37015735232808,132.1293402500004,136.11883019999996,133.9593004,136.0071000000002,138.09667333333334,120575808,136761000,57.45328877185955,1.3311304183502384,1.5,2.75,NaN,NaN,1.7960671887197612,0.8816534538355233,460.68696113113685,0.20636562532156777,0.8464573106518571,0.6400916853302894,18.75553624600718,0.24751401324889463,81.85162382299035,2.8620735256663763,15.28630265134326,4710620285
1343827800,138.7,138.73,137.39999,137.59,NaN,NaN,117.82906894736844,139.89996799999994,132.20444020000042,136.11903009999997,134.0717004,136.01600000000022,135.2876583511883,136.1391049129795,136.55076923076945,139.62503429657852,133.47650416496037,132.20444020000042,136.11903009999997,134.0717004,136.01600000000022,137.90666333333334,138293744,139653177.6,56.958799731764074,1.0196310494480756,1.5,2.75,NaN,NaN,1.7627773895254915,0.9902656450546815,458.2398187676593,0.18218247096723483,0.867819774039333,0.6856373030720981,18.31991936145049,-0.10164815218179508,57.0373467705626,14.36993415102043,28.592719078416987,4572326541
1343914200,136.55,137.57001,135.58,136.64,NaN,NaN,117.6020952631579,139.87246749999994,132.2864902000004,136.10963009999995,134.1605004,136.00850050000022,135.34069135702404,136.18680920698145,136.64384692307715,139.64924128429624,133.63845256185806,132.2864902000004,136.10963009999995,134.1605004,136.00850050000022,136.59667,199556560,143322133.6,53.06527407390173,0.20120939275788818,1.5,2.75,NaN,NaN,1.7804361474165271,1.3923638658418633,455.5311966708421,0.09059702711088047,0.7988835869606987,0.7082865598498183,18.666279825399084,0.1245695024547428,25.474869286478924,41.896801934942346,32.628328778578734,4372769981
1344000600,138.56,139.64,136.6794,139.349,NaN,NaN,117.37512157894739,139.84496699999994,132.3703352000004,136.10250009999996,134.3020804,136.20145000000022,135.49787993125838,136.48797023488797,136.8737700000002,140.19759211098977,133.54994788901064,132.3703352000004,136.10250009999996,134.3020804,136.20145000000022,138.55613333333332,157825008,143653784,61.208381979401054,1.6972154340923764,1.5,2.75,NaN,NaN,1.8675478511724894,1.0986484560685155,460.1627852647509,0.19486853725687114,0.9518722314209072,0.757003694164036,21.08722823616109,3.1527130061440416,18.46912178730863,50.906994763225484,30.623883449465872,4530594989
1344259800,139.72,140.17,139.56,139.62,NaN,NaN,117.14814789473687,139.81746649999994,132.46278520000038,136.09960009999998,134.4438804,136.41644950000023,135.65953169866,136.78625878394627,137.04684692307714,140.67627538226222,133.41741846389206,132.46278520000038,136.09960009999998,134.4438804,136.41644950000023,139.78333333333333,86327744,142781149.6,61.92014618757433,1.848935168826546,1.5,2.75,NaN,NaN,1.7927944332315973,0.6046158350863986,462.6866440194554,0.26040169772771093,1.0825058163236747,0.8221041185959638,19.609820569413134,4.252380063468354,17.05063275485382,52.99036236160188,29.959004883544303,4616922733
1344346200,140.17999,140.92,140.03,140.32001,NaN,NaN,116.92117421052633,139.78996599999994,132.55608525000036,136.09560019999998,134.6082804,136.72545000000022,135.84229555361452,137.12280651880852,137.24607846153867,141.26688309898853,133.22527382408882,132.55608525000036,136.09560019999998,134.6082804,136.72545000000022,140.42333666666664,109545056,139864161.6,63.76938740389923,1.941926255324738,1.5,2.75,NaN,NaN,1.7575948308579104,0.7832246284311907,466.0205520158968,0.3250039623598773,1.2283590715458104,0.9033551091859331,18.0716224707527,4.747685521970314,37.17378025875117,29.705709564670695,33.120510176578144,4726467789
1344432600,139.85001,140.64999,139.81,140.49001,NaN,NaN,116.69420052631581,139.76246549999993,132.6386853000004,136.09750029999998,134.74408060000002,137.04195050000024,136.02455886523748,137.44349256463627,137.55531000000022,141.8954626896796,133.21515731032085,132.6386853000004,136.09750029999998,134.74408060000002,137.04195050000024,140.3166666666667,89754624,137265192.8,64.22377055580972,1.5819362536749852,1.5,2.75,NaN,NaN,1.692051628653774,0.6538775210899641,466.56155379669724,0.351071452280841,1.3421944245369843,0.9911229722561433,17.9952201798871,3.1725123008004883,62.73339882008929,11.038602722335852,26.22799845757486,4816222413
1344519000,140.28999,140.89,140.14999,140.61,NaN,NaN,116.46722684210528,139.73496499999993,132.7142852500004,136.0951002,134.92108080000003,137.39695100000023,136.20438008620857,137.74506470133758,137.9799253846156,142.35219844697806,133.60765232225313,132.7142852500004,136.0951002,134.92108080000003,137.39695100000023,140.54999666666666,90291632,134600618.4,64.56160305516805,1.468170081283833,1.5,2.75,NaN,NaN,1.6240486551785032,0.6708114202839353,468.4899598742649,0.3476279068375956,1.4256578558031379,1.0780299489655423,16.476484967456724,1.395348837209304,100,0,0,4906514045
1344605400,140.03999,140.89,139.81,140.84,NaN,NaN,116.24025315789476,139.70746449999996,132.80324025000039,136.09910019999998,135.10848080000002,137.65145100000024,136.3861691024357,138.03982044406735,138.51184846153868,142.44157215440026,134.5821247686771,132.80324025000039,136.09910019999998,135.10848080000002,137.65145100000024,140.51333333333332,99792624,133108043.2,65.23918874999733,1.199144479683953,1.5,2.75,NaN,NaN,1.5851880369514662,0.7497114494430491,469.47126663719024,0.33209619937317236,1.4931501981820077,1.1610539988088353,13.415647862292882,1.5575498671437744,100,0,0,5006306669
1344864600,140.60001,140.84,140.03999,140.77,NaN,NaN,116.01327947368424,139.67996399999996,132.88559025000038,136.10470009999997,135.36068080000004,137.91845150000023,136.5580840395951,138.29983754463237,139.03569384615406,142.12420855725608,135.94717913505204,132.88559025000038,136.10470009999997,135.36068080000004,137.91845150000023,140.54999666666666,79426880,132203128,64.83289470186782,1.0366227056091533,1.5,2.75,NaN,NaN,1.529103891454934,0.6007942565473943,466.2144057471394,0.2898998503508581,1.523428811747408,1.2335289613965499,13.441051557164645,2.2220534295219343,80.29287187537155,3.3374160112142266,16.36971211341422,4926879789
1344951000,141.28999,141.38,140.37,140.78999,NaN,NaN,115.7863057894737,139.65246349999995,132.9463902000004,136.12059999999997,135.61448040000002,138.13995100000022,136.72404113608155,138.53699492133404,139.39107769230787,142.12125007922123,136.66090530539452,132.9463902000004,136.12059999999997,135.61448040000002,138.13995100000022,140.84666333333334,102379376,130379087.2,64.90012065516335,1.04797162112818,1.5,2.75,NaN,NaN,1.4920250420652952,0.7852438469902097,467.0081311404588,0.2382848340892294,1.5313850040080865,1.2931001699188571,12.369160260159967,2.3257431499382117,79.96395470843312,3.4431465886135677,16.592898702953292,5029259165
1345037400,140.64,141.19,140.55,140.95,NaN,NaN,115.55933210526318,139.62496299999995,133.0081401500004,136.13360009999997,135.85208020000002,138.31895100000023,136.88976501309796,138.76680492882605,139.56607769230789,142.38056387863853,136.75159150597725,133.0081401500004,136.13360009999997,135.85208020000002,138.31895100000023,140.89666666666668,71085808,128265896,65.46913964621623,0.9577288632044375,1.5,2.75,NaN,NaN,1.4311661104892015,0.5542066146717597,470.0474567235446,0.1918647740649031,1.532931137499986,1.341066363435083,12.239305587245655,3.1542740046838427,79.01815653498677,3.7554807171401126,17.22636274787312,5100344973
1345123800,141.14999,142.16,140.8,141.99001,NaN,NaN,115.33235842105265,139.59746249999995,133.0905902000004,136.13740019999995,136.05248040000004,138.53195150000022,137.08977462042745,139.07377684036643,139.8206946153848,142.85849948725254,136.78288974351707,133.0905902000004,136.13740019999995,136.05248040000004,138.53195150000022,141.65000333333333,112014192,127374246.4,68.98817431311852,1.430913810935442,1.5,2.75,NaN,NaN,1.426082816882829,0.8794100468962617,473.0340447482305,0.20685647374826277,1.5996369556204115,1.3927804818721488,10.927545041762375,1.8952486203704533,80.17779631541946,3.374236944497408,16.44796674008314,5212359165
1345210200,142.23,142.3,141.86,142.17999,NaN,NaN,115.10538473684213,139.56996199999995,133.19148015000042,136.14750009999997,136.2550802,138.81745100000023,137.28939090982246,139.36960666509344,140.16453923076944,143.1807083007514,137.14837016078747,133.19148015000042,136.14750009999997,136.2550802,138.81745100000023,142.11333000000002,90813680,124769708.8,69.59768022201507,1.3041784544187494,1.5,2.75,NaN,NaN,1.3556483299626267,0.7278503802999979,475.34614214940615,0.20483558848153693,1.64882496747407,1.443989378992533,4.297213065794323,1.8335410399656202,79.77936484391826,3.503137710895734,16.717497445186005,5303172845
1345469400,141.98,142.22,141.59,142.19,NaN,NaN,114.8784110526316,139.54246149999994,133.28248010000038,136.16470009999998,136.43688,139.17245100000022,137.48157165845686,139.63821555413216,140.51838538461558,143.31468476937934,137.72208599985183,133.28248010000038,136.16470009999998,136.43688,139.17245100000022,142,78255680,121421952,69.63154779857626,1.103380402869499,1.5,2.75,NaN,NaN,1.3038163063938675,0.6444936744222329,474.17036787639887,0.18030535600428865,1.669371073997894,1.4890657179936053,4.439733826119398,1.3326609654603085,100,0,0,5381428525
1345555800,142.53999,143.09,141.45,141.75999,NaN,NaN,114.65143736842107,139.51496099999994,133.36003005000038,136.17999999999998,136.64378,139.56420050000023,137.64935276988993,139.84028931088147,140.91223076923097,142.65719430938907,139.16726722907288,133.36003005000038,136.17999999999998,136.64378,139.56420050000023,142.09999666666667,105581008,118035946.4,66.2189220253063,0.9805900765053792,1.5,2.75,NaN,NaN,1.3278294273657352,0.8944818186335142,473.21205302889894,0.11446061528334228,1.6321414870977833,1.517680871814441,4.718971898504346,0.9039646306523683,73.78390103993785,5.757646809416007,20.458452150646153,5275847517
1345642200,141.39999,142.05,141.07001,141.82001,NaN,NaN,114.42446368421055,139.48746049999994,133.44172510000038,136.1901001,136.8217802,139.95720050000023,137.81290795538445,140.02883413841658,141.10230846153866,142.65215773699072,139.5524591860866,133.44172510000038,136.1901001,136.8217802,139.95720050000023,141.64667333333333,133243440,118242005.6,66.46596389420662,0.5938448005289934,1.5,2.75,NaN,NaN,1.3029837539824694,1.1268706017280208,470.15310829956127,0.05718412220746272,1.5891610245737695,1.5319769023663068,4.7289848589616374,0.8605433468458734,77.41684584062419,4.355833582987582,18.227320576388227,5409090957
1345728600,141.47,141.48,140.44,140.66499,NaN,NaN,114.19749000000002,139.45995999999994,133.5137501000004,136.17834999999997,136.9936798,140.18195000000023,137.92475431007526,140.08942041094835,141.18269230769252,142.5089496525216,139.85643496286343,133.5137501000004,136.17834999999997,136.9936798,140.18195000000023,140.86166333333333,111466368,115989002.4,57.718357723113336,0.07759535901929884,1.5,2.75,NaN,NaN,1.308485628698007,0.9610080757104605,466.7949499169396,-0.06939077925372628,1.4452384282991488,1.5146292075528751,7.052726381838015,-0.12426157341665332,47.53504406587895,21.059693395434493,31.405262538686575,5297624589
1345815000,140.31,141.83,140.22,141.50999,NaN,NaN,113.9705163157895,139.43245949999994,133.5819000500004,136.18084999999996,137.15447959999997,140.32369950000023,138.0653517881115,140.2247127527628,141.27422923076944,142.51092348163897,140.0375349798999,133.5819000500004,136.18084999999996,137.15447959999997,140.32369950000023,141.1866633333333,99481184,109124617.6,61.69069467089263,0.39481277590795344,1.5,2.75,NaN,NaN,1.3300223695052933,0.9116291647834375,469.5987172238164,-0.1049705554570235,1.3834160132315958,1.4883865686886193,7.812952266761013,0.5256730837536246,48.46988315038744,20.35366231071889,31.176454538893655,5397105773
1346074200,141.89,142.08,141.34,141.53999,NaN,NaN,113.74354263157898,139.40495899999993,133.67379500000038,136.19764989999996,137.30247939999998,140.4666995000002,138.20161211014636,140.34997725249968,141.35499692307715,142.51077381143705,140.19922003471726,133.67379500000038,136.19764989999996,137.30247939999998,140.4666995000002,141.65333,68785872,107224814.4,61.82781142441054,0.44994679236933754,1.5,2.75,NaN,NaN,1.28787791454063,0.6415107583529657,468.5202722886153,-0.13342334623799368,1.3216073858911273,1.455030732129121,7.791302208569985,0.5327083267780615,46.22569163133583,21.977179407109897,31.797128961554275,5465891645
1346160600,141.17999,141.84,140.97,141.39999,NaN,NaN,113.51656894736844,139.37745849999993,133.7591949000004,136.21374989999995,137.44247939999997,140.6511985000002,138.3270386940622,140.44997846654732,141.4157653846156,142.4885637649383,140.34296700429292,133.7591949000004,136.21374989999995,137.44247939999997,140.6511985000002,141.40333,75689568,104980502.4,60.7353175367138,0.33169097247612994,1.5,2.75,NaN,NaN,1.2580294920734425,0.7209869096606647,470.41324173721534,-0.16646244237432795,1.246952679161211,1.413415121535539,7.839538400187386,0.31925505498404677,51.4279969582294,18.119113770734906,30.452889271035687,5390202077
1346247000,141.52,141.89,141.12,141.50999,NaN,NaN,113.28959526315792,139.34995799999993,133.8334448500004,136.24664979999997,137.55867919999997,140.8471980000002,138.4518603139029,140.55093194592376,141.46730307692332,142.48759804892933,140.4470081049173,133.8334448500004,136.24664979999997,137.55867919999997,140.8471980000002,141.50666333333334,65421296,101336880,61.31373484379725,0.35928657659874247,1.5,2.75,NaN,NaN,1.2231702426396238,0.6455822993563647,472.7436997357123,-0.1843103643094106,1.1830271661487757,1.3673375304581863,7.830487586330509,-0.33806603718108375,42.51067664503509,24.98011254085808,32.50921081410684,5455623373
1346333400,140.89999,140.94,140.19,140.49001,NaN,NaN,113.06262157894739,139.32245749999993,133.9085948500004,136.29254999999998,137.6588794,141.03969850000018,138.53178775257336,140.5451298558358,141.4457653846156,142.5336137600639,140.35791700916732,133.9085948500004,136.29254999999998,137.6588794,141.03969850000018,140.54000333333332,96589808,96188542.4,53.45092032007014,0.35958603581167736,1.5,2.75,NaN,NaN,1.2300859395939356,1.0041716569353065,469.5399519304068,-0.26339373815525247,1.0380953577641208,1.3014890959193732,7.559609438524803,-1.1886201426797058,45.43417755237839,22.59914226336613,31.966680184255505,5359033565
1346419800,141.28999,141.82001,140.36,141.16,NaN,NaN,112.83564789473687,139.29495699999993,133.9839799000004,136.33414999999997,137.83327939999998,141.13024850000016,138.63485489953126,140.60368891718477,141.47422769230792,142.510075163602,140.43838022101383,133.9839799000004,136.33414999999997,137.83327939999998,141.13024850000016,141.11333666666667,151970368,95895810.4,57.32243769571801,0.04706341451643056,1.5,2.75,NaN,NaN,1.2465090867657962,1.5847446031907144,473.64956126571946,-0.2682623608645778,0.9661611448386509,1.2344235057032287,8.184235869471728,-0.7243828679935306,52.41496156944024,17.430868729900933,30.154169700658834,5511003933
1346765400,141.03999,141.46001,140.13,141.03,NaN,NaN,140.13,139.26745649999992,134.0687299000004,136.3565501,137.9846792,141.2007485000002,138.72878215837318,140.64428997269098,141.48038153846176,142.50458347301517,140.45617960390834,134.0687299000004,136.3565501,137.9846792,141.2007485000002,140.87333666666666,120226192,97590732.8,56.343237200249085,0.13028334989469778,1.5,2.75,NaN,NaN,1.2524734377110975,1.2319427116751807,475.4742996934593,-0.27680146278591633,0.8884216772208333,1.1652231400067496,8.169002539235702,-0.5149478354223831,24.792037011429226,42.69764293215399,32.51032005641679,5390777741
1346851800,141.09,141.47,140.63,140.91,NaN,NaN,140.33304703125,139.23995599999992,134.1627549000004,136.3942501,138.17647899999997,141.2302480000002,138.81432011294677,140.66959568957756,141.39730384615407,142.4178776517241,140.37673004058405,134.1627549000004,136.3942501,138.17647899999997,141.2302480000002,141.00333333333333,100660256,97146492.8,55.40243483130791,0.07625233371783735,1.5,2.75,NaN,NaN,1.2230110493031623,1.0361697380803438,475.59966752162074,-0.28592445297241875,0.8078175737912261,1.0937420267636448,8.048467317735025,-0.6416654462229976,22.48483622973242,45.54044746767035,31.97471630259723,5290117485
1346938200,141.75999,143.78,141.75,143.77,NaN,NaN,140.53609406249998,139.21245549999992,134.27170990000042,136.4614501,138.412279,141.39424750000018,139.00866050067435,140.96487229057018,141.51961230769254,143.10877978660864,139.93044482877644,134.27170990000042,136.4614501,138.412279,141.39424750000018,143.1,158272432,100572383.2,68.78176610663674,1.5021885491558347,1.5,2.75,NaN,NaN,1.3406531172100797,1.5737166303920298,480.27406587862885,-0.10410685294956079,0.9636084605766939,1.0677153135262547,14.373334272484001,2.207379391275698,33.723338790925894,32.96200774859664,33.31465346047746,5448389917
1347024600,144.00999,144.39,143.88,144.33,NaN,NaN,140.73914109375,139.18495499999995,134.39505490000042,136.5139301,138.635419,141.58024750000018,139.21734048104005,141.2853606438492,141.6842276923079,143.85425467173587,139.51420071287993,134.39505490000042,136.5139301,138.635419,141.58024750000018,144.20000000000002,107272000,101421401.6,70.63913746927255,1.6362953833747584,1.5,2.75,NaN,NaN,1.2891778945522152,1.057686033792694,483.23459047443157,0.04131408464594033,1.1193579193336802,1.07804383468774,13.052175943915453,1.9927992362942186,56.508360707806006,14.696254874469345,28.795384417724648,5555661917
1347283800,144.19,144.44,143.46001,143.50999,NaN,NaN,140.942188125,139.15745449999994,134.5166548500004,136.56293,138.849819,141.71374700000018,139.38567967786202,141.49723010633974,141.8188430769233,144.1980088454572,139.43967730838938,134.5166548500004,136.56293,138.849819,141.71374700000018,143.8033333333333,86458432,100754692,64.58008348169363,1.2339917929733086,1.5,2.75,NaN,NaN,1.2670930449413418,0.8581082457182242,481.3585894496554,0.06813591610610414,1.1632137298203702,1.095077813714266,13.640908761605326,1.391832795805623,31.549795499460565,35.334773459141296,33.115431041398146,5469203485
1347370200,143.60001,144.37,143.56,143.91,NaN,NaN,141.14523515624998,139.12995399999994,134.6534048500004,136.62483,139.005919,141.87074700000016,139.56310400422038,141.72701771525976,141.97961153846177,144.60688436487072,139.3523387120528,134.6534048500004,136.62483,139.005919,141.87074700000016,143.9466666666667,88760000,101221348,66.10730461852363,1.148663881416565,1.5,2.75,NaN,NaN,1.23801568458839,0.8768901200564925,484.843008550537,0.09691961143659245,1.2162273280100067,1.1193077165734142,13.638549054698775,1.7751132797109774,58.3055909168694,13.68166801139796,28.01274107173263,5557963485
1347456600,144.39,144.55,143.89999,144.39,NaN,NaN,141.3482821875,139.10245349999994,134.7936548500004,136.68922999999998,139.1635192,142.05074750000017,139.75239404327056,141.9806350757112,142.26615076923102,145.0643759971707,139.46792554129132,134.7936548500004,136.68922999999998,139.1635192,142.05074750000017,144.27999666666668,87640880,100484423.2,67.89612572674842,1.1400287945696113,1.5,2.75,NaN,NaN,1.1960152785463627,0.8721837396186596,488.1653533074134,0.1303079516908403,1.2821926561869645,1.1518847044961242,13.556640645707155,2.0351990696911213,82.48003535309732,2.7051056955127133,14.81485895138996,5645604365
1347543000,144.37,147.03999,143.99001,146.59,NaN,NaN,141.55132921875,139.07495299999994,134.9280548000004,136.7872301,139.3470792,142.33274750000018,140.02053545333837,142.41962221135776,142.656920769231,146.23404840675673,139.07979313170526,134.9280548000004,136.7872301,139.3470792,142.33274750000018,145.87333333333333,225470128,108203639.2,74.53107423772529,2.1993166939601227,1.5,2.75,NaN,NaN,1.3284413300787636,2.083757345566248,492.57092828794555,0.2743015057946212,1.4947615867394006,1.2204600809447794,15.414369834154922,4.341938618980802,84.8239396601733,2.061296785257091,13.114763554569603,5871074493
1347629400,146.88,148.11,146.75999,147.24001,NaN,NaN,141.75437625,148.11,135.06400485000043,136.8865302,139.5560796,142.5952475000002,140.30365210222706,142.87870676265703,143.09538384615408,147.35049520456332,138.84027248774484,135.06400485000043,136.8865302,139.5560796,142.5952475000002,147.37,169777008,111091780,76.1025704602666,2.440679811856724,1.5,2.75,NaN,NaN,1.3421240922159954,1.5282589584935986,496.1330749565836,0.3805299557581261,1.696122525642437,1.315592569884311,13.808340411602998,4.307176253896299,86.5003696948761,1.650135897701106,11.849494407422808,6040851501
1347888600,146.94,147.19,146.37,146.74001,NaN,NaN,141.95742328125,148.17789473684212,135.17275485000042,136.96203029999998,139.7810796,142.82324850000018,140.55605829429658,143.24644992811827,143.50615461538484,148.04859809778372,138.96371113298596,135.17275485000042,136.96203029999998,139.7810796,142.82324850000018,146.76667,119427744,112522483.2,72.40184395461372,1.7493157937025432,1.5,2.75,NaN,NaN,1.3084016570577106,1.0613678315979433,492.06347499643806,0.3832610428874361,1.794668873493606,1.41140783060617,14.565476446540876,4.048791037367944,81.5484001637266,3.0013460380645824,15.450253798208813,5921423757
1347975000,146.49001,146.81,146.25,146.62,NaN,NaN,142.1604703125,148.24578947368423,135.28100485000041,137.0266303,140.0070794,143.04474850000017,140.79385992981435,143.56774041115463,143.89923230769253,148.56539711533352,139.23306750005153,135.28100485000041,137.0266303,140.0070794,143.04474850000017,146.56,98326496,113526024,71.50308228380828,1.3739751957113837,1.5,2.75,NaN,NaN,1.254944395839303,0.8661141519410562,489.9707948142727,0.34435536460078664,1.841852036357153,1.4974966717563665,14.553183894157895,4.052231921084386,63.36582060892375,10.799604555783555,25.8345748352927,5823097261
1348061400,146.78999,147.17,146.41,146.7,NaN,NaN,142.36351734375,148.31368421052633,135.3902048500004,137.0897303,140.2582794,143.29174900000015,141.02547326590005,143.8660508481875,144.37692384615406,148.81513550212094,139.93871219018718,135.3902048500004,137.0897303,140.2582794,143.29174900000015,146.76,128318256,114662886.4,71.75479024658974,1.4486909298434867,1.5,2.75,NaN,NaN,1.2195912247079235,1.119091451721906,492.14686790993085,0.2933713837422711,1.8642109014342054,1.5708395176919343,14.40849386876067,2.037977324893913,65.82601578527452,9.490333751667603,24.683650463057873,5951415517
1348147800,146.03,146.78999,145.63,146.71001,NaN,NaN,142.56656437499998,148.38157894736844,135.4926549000004,137.1581304,140.50927959999999,143.53624900000017,141.24839627508044,144.13690410074108,144.8038476923079,148.98228535172248,140.6254100328933,135.4926549000004,137.1581304,140.50927959999999,143.53624900000017,146.37666666666667,154009744,115701201.6,71.78836834093738,0.9809401793693601,1.5,2.75,NaN,NaN,1.2153339943716428,1.331098915743672,489.3527995174576,0.2323543703338733,1.861282480609276,1.6289281102754027,10.220975674269326,1.649005750710177,61.456524685988725,11.870011150542615,26.673464163468655,6105425261
1348234200,146.64,146.67,145.81,145.87,NaN,NaN,142.76961140625,148.44947368421055,135.5907049500004,137.2094303,140.7564798,143.79649950000015,141.429635636842,144.30196085305144,145.1761553846156,148.76398285010671,141.5883279191245,135.5907049500004,137.2094303,140.7564798,143.79649950000015,146.11666666666667,108737440,115564755.2,64.82399426263649,0.6106781288109385,1.5,2.75,NaN,NaN,1.1928108519165261,0.9409221679379285,492.2890593189094,0.11347158595531859,1.770767592719551,1.6572960067642324,11.037768185321301,1.6444917876449,31.706497247604098,35.26877836606485,33.024724386331066,5996687821
1348493400,145.14999,145.98,145.03999,145.645,NaN,NaN,142.9726584375,148.51736842105265,135.6852799500004,137.2626303,140.9543798,144.00325000000015,141.59494404324036,144.42986934323702,145.54038615384636,148.1498803613861,142.93089194630662,135.6852799500004,137.2626303,140.9543798,144.00325000000015,145.55499666666665,95682000,115374796,63.05933784731015,0.26883798625982047,1.5,2.75,NaN,NaN,1.1747536482082028,0.8293145757761513,489.65014753150786,0.0035415661077380367,1.6617229643989049,1.6581813982911668,10.344297896179626,1.205614620248776,33.02929519378672,33.73910753933655,33.23159726687673,5901005821
1348579800,145.96001,146.24001,144.06,144.10001,NaN,NaN,143.17570546874998,148.58526315789476,135.78603000000038,137.31113040000002,141.12778020000002,144.13125100000016,141.6931819238976,144.39845416769063,145.56577153846177,148.1115241980551,143.02001887886846,135.78603000000038,137.31113040000002,141.12778020000002,144.13125100000016,144.8000066666667,133165120,118593758.4,52.49241040100622,0.2879832717699834,1.5,2.75,NaN,NaN,1.2465576733361892,1.1228678624962103,486.56671182477163,-0.179261071092768,1.4341050594252067,1.6133661305179747,12.392966391285327,-0.2008380081723034,29.68557519574765,37.22312021193204,33.09130459232029,5767840701
1348666200,144.065,144.11,142.95,143.295,NaN,NaN,143.3787525,148.65315789473686,135.8722550000004,137.37408040000003,141.26648020000002,144.22600150000017,141.7559983190389,144.29336329457723,145.4861561538464,148.23791945560274,142.73439285209005,135.8722550000004,137.37408040000003,141.26648020000002,144.22600150000017,143.45166666666668,146502128,122134386.4,47.98084272114268,0.9907634436649527,1.5,2.75,NaN,NaN,1.240374982383606,1.1995158146551264,483.83826090081413,-0.35052366965022697,1.175211543455191,1.525735213105418,12.607218059300957,-2.2477658776178564,7.988472314169225,68.69200158942903,23.31952609640176,5621338573
1348752600,143.89,144.97,143.50999,144.64,NaN,NaN,143.58179953125,148.72105263157897,135.97440495000038,137.4494803,141.41188020000004,144.38250200000016,141.86909642417461,144.3263763141413,145.57308000000023,148.1344604497807,143.01169955021976,135.97440495000038,137.4494803,141.41188020000004,144.38250200000016,144.37332999999998,111830256,124454834.4,54.947932121612936,0.31246640535464415,1.5,2.75,NaN,NaN,1.2714196264990636,0.8985609642175539,487.8683203681601,-0.3675677974080922,1.066275466345303,1.433843263753395,10.144315148418448,-1.7658311759147705,4.575280238299744,76.76805965822,18.65666010348027,5733168829
1348839000,144.09,144.56,143.46001,143.97,NaN,NaN,143.7848465625,148.78894736842108,136.0790049500004,137.52368030000002,141.53668020000003,144.55650150000014,141.95148479969717,144.29243571279451,145.5776953846156,148.1272612815769,143.0281294876543,136.0790049500004,137.52368030000002,141.53668020000003,144.55650150000014,143.99667,150696064,127160147.2,51.264584447769934,0.49067746774920623,1.5,2.75,NaN,NaN,1.2648889388919857,1.1850887822816234,484.9997117049488,-0.4148121252668655,0.9153281071698132,1.3301402324366787,9.579422993460915,-1.887699203509672,3.9823371703824453,78.42501946563581,17.59264336398174,5582472765
1349098200,144.52,145.69,144.00819,144.345,NaN,NaN,143.98789359375,148.85684210526318,136.1920299000004,137.6097302,141.69418020000003,144.71575150000015,142.04534814088552,144.2974418353855,145.57423384615407,148.13035423394925,143.0181134583589,136.1920299000004,137.6097302,141.69418020000003,144.71575150000015,144.68106333333333,135911120,126357184.8,53.15725425171965,0.10149817066383224,1.5,2.75,NaN,NaN,1.2973968718282725,1.0756105417758564,487.80081039049236,-0.4108738283090949,0.8165479470503101,1.227421775359405,9.926653934705628,-1.5516300641113119,17.52014793444973,52.229750503942824,30.250101561607448,5718383885
1349184600,144.92,145.14999,143.83,144.5,NaN,NaN,144.190940625,148.9247368421053,136.30360490000038,137.6945302,141.88238020000006,144.88925150000014,142.1416089981057,144.31673308915833,145.41346461538484,147.956683771954,142.87024545881567,136.30360490000038,137.6945302,141.88238020000006,144.88925150000014,144.49333000000001,113422128,126016981.6,53.95325635744531,0.2857028664197537,1.5,2.75,NaN,NaN,1.2990106666976808,0.9000543145845353,488.9282091830157,-0.3881651271967046,0.7422153663635243,1.1303804935602288,10.042714773824727,-1.4996591683708171,40.24812562952041,26.867694844394745,32.88417952608485,5831806013
1349271000,144.89,145.42999,144.13,145.09,NaN,NaN,144.39398765625,148.9926315789474,136.4211049000004,137.7893302,142.10568020000005,145.09825150000015,142.2572321746506,144.39037755685754,145.24807923076943,147.56415436168524,142.93200409985363,136.4211049000004,137.7893302,142.10568020000005,145.09825150000015,144.88332999999997,121283008,127048119.2,56.95193873020958,0.20294181735756944,1.5,2.75,NaN,NaN,1.2990806190764186,0.9546226167195397,488.3814285394621,-0.3262365374367313,0.7225848217643147,1.048821359201046,10.493117893877585,-1.1042259488633446,71.07548200927006,6.853641593686888,22.070876397043047,5953089021
1349357400,145.64,146.34,145.44,146.125,NaN,NaN,144.59703468749998,149.0605263157895,136.55027995000037,137.9094802,142.34898000000004,145.21600150000015,142.40890934427213,144.5555796942997,145.20077076923099,147.41594226649448,142.9855992719675,136.55027995000037,137.9094802,142.34898000000004,145.21600150000015,145.96833333333333,124311632,125350079.2,61.6678704893992,0.8236262161218955,1.5,2.75,NaN,NaN,1.2955748605709603,0.9917156239020549,491.9904022658869,-0.21382966083674826,0.7815342831551106,0.9953639439918589,11.506877041270167,0.17481318982655478,71.78379375253257,6.543423168874412,21.67278307859302,6077400653
1349443800,146.91,147.16,145.7,146.14,NaN,NaN,144.80008171875,149.1284210526316,136.6613300000004,138.0374802,142.54838000000007,145.30650150000014,142.55522662488892,144.70647686627115,145.1638476923079,147.29767180293777,143.03002358167805,136.6613300000004,138.0374802,142.54838000000007,145.30650150000014,146.33333333333334,124842064,126228582.4,61.733299525843336,0.8595385399315902,1.5,2.75,NaN,NaN,1.307319513387321,0.9890158126342072,494.43769614113523,-0.14028318223101677,0.820009966203088,0.9602931484341047,10.992508458942327,0.3398674860104886,100,0,0,6202242717
1349703000,145.60001,146.12309,145.31,145.642,NaN,NaN,145.00312875,149.1963157894737,136.7686900000004,138.1656103,142.68772000000004,145.41310200000015,142.67627656116778,144.79557430757865,145.0824630769233,147.0499431624817,143.11498299136488,136.7686900000004,138.1656103,142.68772000000004,145.41310200000015,145.69169666666667,78415568,125826439.2,58.18252643179277,0.3665204895960863,1.5,2.75,NaN,NaN,1.2732252624310827,0.6232042208184811,491.8900728143099,-0.1273678039651377,0.8010833934776826,0.9284511974428203,11.150932403663463,1.0700832012433577,84.38585836169777,2.1499765780817,13.46416506022052,6123827149
1349789400,145.53,145.64999,144.14999,144.2,NaN,NaN,145.20617578124998,149.2642105263158,136.8633400000004,138.2990103,142.79812020000006,145.42760200000015,142.73603042151413,144.7388529449521,144.8893853846156,146.66320206838213,143.11556870084905,136.8633400000004,138.2990103,142.79812020000006,145.42760200000015,144.66666,148872816,128832080,49.33401021837548,0.40509526489316566,1.5,2.75,NaN,NaN,1.2894234579717196,1.1555570320684103,487.64743212719065,-0.2130854478978066,0.662094387570562,0.8751798354683686,10.906484686595745,0.6315642555567195,51.07547731856727,18.334934702430246,30.589587979002463,5974954333
1349875800,144.17999,144.32001,143.09,143.28,NaN,NaN,145.4092228125,149.3321052631579,136.9477900000004,138.4344102,142.90952000000004,145.37210200000015,142.75736256184692,144.59991456924237,144.6901546153848,146.5579704430467,142.8223387877229,136.9477900000004,138.4344102,142.90952000000004,145.37210200000015,143.56333666666666,124247440,130662408,44.66667736909489,1.0051189841995287,1.5,2.75,NaN,NaN,1.2851796395451678,0.9509042570224177,486.4771478807824,-0.3223324134173675,0.4722643186966593,0.7945967321140268,11.066437708250506,-0.9402654867256536,23.554177672986125,44.19459322289813,32.25122910411574,5850706893
1349962200,144.28,144.49001,143.327,143.36,NaN,NaN,145.61226984375,149.4,137.03213995000038,138.5483102,143.02492000000004,145.21060200000016,142.7809954025588,144.48182746740977,144.5143853846156,146.41938615503483,142.60938461419636,137.03213995000038,138.5483102,143.02492000000004,145.21060200000016,143.72567,123601440,125568973.6,45.15259791074308,0.6928749779215592,1.5,2.75,NaN,NaN,1.2798103795776565,0.9843310529377458,489.53339710829306,-0.37604787082532043,0.32453689358237625,0.7005847644076967,9.372216975211423,-0.42369938181564576,23.205784097665834,44.62638897203306,32.16782693030111,5974308333
1350048600,143.46001,143.95,142.58,142.89,NaN,NaN,145.81531687499998,149.4678947368421,137.12243995000037,138.6552102,143.14992000000004,144.99310150000014,142.78527009265454,144.33022485146597,144.4213076923079,146.50779438011037,142.33482100450541,137.12243995000037,138.6552102,143.14992000000004,144.99310150000014,143.14,124181872,123289216.8,42.775919519117735,0.9753227920713875,1.5,2.75,NaN,NaN,1.286252495322108,1.007240334744344,487.1889562628679,-0.42638402767052197,0.16760472981954422,0.5939887574900662,9.204383045229916,-1.0080016626831636,5.19829872143835,75.05686434450223,19.744836934059425,5850126461
1350307800,143.23,144.23,142.77,144.08,NaN,NaN,146.01836390625,149.53578947368422,137.2122399500004,138.7733102,143.24454000000003,144.86010100000016,142.8360438145112,144.30639391323112,144.4816923076925,146.47777745846463,142.48560715692037,137.2122399500004,138.7733102,143.24454000000003,144.86010100000016,143.69333333333336,107689056,122702282.4,49.95808463922678,0.4173847341894082,1.5,2.75,NaN,NaN,1.2986630313705274,0.8776450926066881,490.1906918719226,-0.365054262487558,0.13767092938061865,0.5027251918681767,10.454811089440287,-0.29065743944635813,17.403203317935677,52.40358880950991,30.193207872554414,5957815517
1350394200,144.75999,145.64,144.66,145.53999,NaN,NaN,146.2214109375,149.60368421052632,137.31243990000038,138.90341009999997,143.36293980000005,144.80610050000013,142.9420809198245,144.42387925482817,144.55092230769247,146.62506963144372,142.47677498394123,137.31243990000038,138.90341009999997,143.36293980000005,144.80610050000013,145.27999666666665,108815440,123226729.6,57.07616212907264,0.6467385727436599,1.5,2.75,NaN,NaN,1.3173299577012023,0.8830506202121914,494.6613564875321,-0.21888730477802226,0.22911606089564884,0.4480033656736711,12.009630554445986,0.31014542697634945,44.06290218734823,23.657190561681517,32.27990725097025,6066630957
1350480600,145.64,146.32001,145.42,146.2,NaN,NaN,146.42445796875,149.67157894736843,137.4059649000004,139.04441,143.48053960000004,144.78110050000015,143.06984245238039,144.5930336115112,144.72246076923096,146.93996032299188,142.50496121547005,137.4059649000004,139.04441,143.48053960000004,144.78110050000015,145.98000333333331,128834064,123252520,59.85609148526063,0.9801895761455355,1.5,2.75,NaN,NaN,1.2875213892939743,1.0452854351375533,497.9489210584692,-0.07776231807187084,0.3508004680838326,0.4285627861557034,12.058212972089366,0.051325919589384865,74.95534146128396,5.2366279487699305,19.80803058994611,6195465021
1350567000,145.82001,146.52,145.33,145.82001,NaN,NaN,146.62750499999999,149.73947368421054,137.4965649500004,139.16561009999998,143.58713960000003,144.73660050000012,143.17769216013016,144.709888505653,144.83592307692325,147.11465541842512,142.5571907354214,137.4965649500004,139.16561009999998,143.58713960000003,144.73660050000012,145.89000333333334,148108432,122957454.4,57.545347832677464,0.6949650327547194,1.5,2.75,NaN,NaN,1.2805555757729759,1.2045502464468718,497.0866045599666,-0.013388680430348576,0.41182693561776773,0.4252156160481163,11.462604546066167,-0.21896127001504723,41.296699172349555,25.96454489377173,32.73875593387872,6047356589
1350653400,145.55,145.56,143.05,143.3896,NaN,NaN,146.83055203125,149.80736842105264,137.57331300000038,139.28190619999998,143.64273160000005,144.61258050000012,143.1860022714976,144.58414674320986,144.75050769230785,147.15308191495416,142.34793346966154,137.57331300000038,139.28190619999998,143.64273160000005,144.61258050000012,143.99986666666666,185645120,126802838.4,45.45767509273244,0.8236338741137128,1.5,2.75,NaN,NaN,1.3869451775034765,1.4640454609886713,492.14118821175657,-0.1313183726534327,0.2610676502313254,0.3923860228847581,14.882278857337305,-1.5465319070048438,34.29331397306402,32.386831145192744,33.319854881743225,5861711469
1350912600,143.14999,143.67,142.28,143.41,NaN,NaN,147.0335990625,149.87526315789475,137.6518129500004,139.4013062,143.69413160000005,144.50083050000012,143.19478649614476,144.47232324385655,144.62127692307712,147.1158727783443,142.12668106780993,137.6518129500004,139.4013062,143.69413160000005,144.50083050000012,143.12,125578624,128297669.6,45.56104106468872,1.1252974832338876,1.5,2.75,NaN,NaN,1.3871633791103701,0.9788067420984551,491.42061151963367,-0.20062592110207966,0.14160362150715855,0.3422295426092382,14.889825027245715,-0.5478502080443773,35.39834751903361,31.335006983370032,33.26664549759636,5987290093
1350999000,141.86,142.06,140.83,141.42,NaN,NaN,147.23664609374998,149.94315789473686,137.71881295000037,139.5339062,143.70713160000003,144.3668300000001,143.1251870257077,144.1816257920607,144.25935384615403,147.11532843841564,141.4033792538924,137.71881295000037,139.5339062,143.70713160000003,144.3668300000001,141.43666666666664,192056320,131242229.6,37.996317724201354,1.8459079317470668,1.5,2.75,NaN,NaN,1.4723659948881997,1.4633728837535689,486.70639041779566,-0.3636665998678432,-0.11235370722556581,0.2513128926422774,15.865410595177108,-1.2981574539363578,13.291697473298358,58.78711342821133,27.921189098490306,5795233773
1351085400,141.92999,142.10001,140.8,141.02,NaN,NaN,147.439693125,150.01105263157896,137.77826295000037,139.6631061,143.71173180000002,144.25308000000012,143.0426306717584,143.8805185737692,143.86550769230786,146.97623411797096,140.75478126664476,137.77826295000037,139.6631061,143.71173180000002,144.25308000000012,141.30667000000003,120179312,129926088.8,36.67806867133663,1.7110840695825895,1.5,2.75,NaN,NaN,1.4600548523961845,0.9249821426164566,485.0855515473129,-0.47461157179760854,-0.34195157210473326,0.13265999969287529,15.629869121238837,-1.6322544642857164,2.937996150926265,81.59650256622098,15.465501282852767,5675054461
1351171800,142.02,142.28,140.57001,141.42999,NaN,NaN,147.64274015625,150.07894736842107,137.83941290000038,139.7867059,143.72133160000004,144.0925795000001,142.9793898611012,143.64713490007688,143.5415069230771,146.72125720064219,140.361756645512,137.83941290000038,139.7867059,143.72133160000004,144.0925795000001,141.42666666666665,134457312,131057441.6,39.013606288461844,1.4720443708188051,1.5,2.75,NaN,NaN,1.4779073629393145,1.0259418340423334,487.1656315153111,-0.49431463989588936,-0.4852333001769864,0.009081339718902959,15.804308599784841,-1.0217719924417263,14.667983188269844,56.56146748516188,28.770549326568293,5809511773
1351258200,141.3,141.84,140.39,141.35001,NaN,NaN,147.84578718749998,150.14684210526318,137.89861300000038,139.880506,143.70853160000001,143.96158000000014,142.91549261164624,143.42836110006957,143.32227692307708,146.67829932896532,139.96625451718884,137.89861300000038,139.880506,143.70853160000001,143.96158000000014,141.19333666666668,146023440,130823810.4,38.71362828583271,1.2948852769933556,1.5,2.75,NaN,NaN,1.4759139798722216,1.1161839695199705,484.81632719929945,-0.48593828062134825,-0.5983415110577823,-0.11240323043643409,15.759973256313371,-1.894773736812892,16.591073186260108,53.617401533531094,29.79152528020881,5663488333
1351690200,141.85001,142.03,140.67999,141.35001,NaN,NaN,148.04883421875,150.21473684210528,137.96116305000035,139.9735061,143.69193200000004,143.81183050000016,142.85410113667973,143.23042290006293,143.1738161538463,146.69106606038645,139.65656624730616,137.96116305000035,139.9735061,143.69193200000004,143.81183050000016,141.35333333333332,103438496,129200179.2,38.71362828583271,1.0435397984702297,1.5,2.75,NaN,NaN,1.466920838452777,0.8006064437409077,487.1639565645025,-0.4541896944639979,-0.6801403485164315,-0.22595065405243359,14.635560861341336,-2.8789200823773533,6.261086924913448,72.44188156112092,21.297031513965642,5663488333
1351776600,141.64999,143.00999,141.52,142.83,NaN,NaN,148.25188125,150.2826315789474,138.02861305000036,140.070806,143.70473200000004,143.72833050000014,142.85315599406485,143.19228738577124,143.13304692307707,146.65300495919877,139.61308888695538,138.02861305000036,140.070806,143.70473200000004,143.72833050000014,142.45333000000002,100995568,128578851.2,47.39429196466801,0.2364527384013079,1.5,2.75,NaN,NaN,1.4807107785632923,0.7854757377082554,489.65393648410026,-0.3139714681799028,-0.6184149892773121,-0.3044435210974093,14.736309693432924,-2.3050615595075077,29.553394587012505,37.26202881721564,33.18457659577186,5764483901
1351863000,143.67999,143.72,141.41,141.56,NaN,NaN,148.45492828124998,150.3505263157895,138.08256305000037,140.17225610000003,143.70073220000006,143.55183050000014,142.8024439942976,143.0368314442692,143.0307392307694,146.64894853954,139.4125299219988,138.08256305000037,140.17225610000003,143.70073220000006,143.55183050000014,142.23,137702128,129399807.2,41.908707463186474,0.4772253405540494,1.5,2.75,NaN,NaN,1.5399457229516287,1.0641602254257454,486.51646138459745,-0.2878993768279901,-0.6643177421323969,-0.3764183653044068,14.619534416488955,-2.921416614907648,27.5005362991466,39.5288507255289,32.97061297532451,5626781773
1352125800,141.35001,142.17,140.92999,141.8486,NaN,NaN,148.65797531249999,150.4184210526316,138.13450600000039,140.2615421,143.70130400000005,143.33801050000014,142.7650383474624,142.923666544815,142.85909307692324,146.4736222718489,139.24456388199758,138.13450600000039,140.2615421,143.70130400000005,143.33801050000014,141.64953,98378432,128103147.2,43.50883532617673,0.6035642725558298,1.5,2.75,NaN,NaN,1.5185217427407969,0.7679626469005283,485.63889945371807,-0.23461622184213093,-0.6696886426070705,-0.43507242076493957,14.930150918200045,-1.074694399035911,23.26637067627867,44.55828090937455,32.17534841434678,5725160205
1352212200,142.28,143.52,142.13,142.96001,NaN,NaN,148.86102234375,150.4863157894737,138.19160610000037,140.37044210000002,143.74720440000004,143.17901100000014,142.77268429462075,142.9271278262612,142.66063307692326,145.93155965985702,139.3897064939895,138.19160610000037,140.37044210000002,143.74720440000004,143.17901100000014,142.87000333333333,107068064,127214447.2,49.30057865627797,0.34421392264123496,1.5,2.75,NaN,NaN,1.5294416182593118,0.8416344712143669,489.46758376159875,-0.11402634057366157,-0.5776053464820166,-0.463579005908355,13.020460053315944,-0.31377867652185026,61.462137317312504,11.718899974816384,26.818962707871105,5832228269
1352298600,141.66,141.67999,139.06,139.72,NaN,NaN,149.064069375,150.5542105263158,138.23215610000037,140.43294210000002,143.71140460000007,142.88291100000015,142.65297118502778,142.621687080903,142.1621715384617,145.07958853184408,139.24475454507933,138.23215610000037,140.43294210000002,143.71140460000007,142.88291100000015,140.15333,264304432,136508890.4,37.2959822860376,1.4422005313222002,1.5,2.75,NaN,NaN,1.6987679312407902,1.9361701001709994,484.1563734264792,-0.23500899765480399,-0.75734025297686,-0.522331255322056,18.354061966479637,-1.2020930561448089,25.9042284785445,41.37902112385462,32.71675039760088,5567923837
1352385000,139.7,140.41,137.92999,138.03999,NaN,NaN,149.26711640624998,150.62210526315792,138.26505600000038,140.471942,143.64140460000007,142.57491050000016,142.47206996208553,142.18533497795985,141.56370846153865,144.42557121886463,138.70184570421267,138.26505600000038,140.471942,143.64140460000007,142.57491050000016,138.79332666666667,181517248,138141112,32.831813402426334,2.1348729462358653,1.5,2.75,NaN,NaN,1.7545709361521618,1.3139987464412477,480.27606181762377,-0.40097134233847265,-1.0235454332451468,-0.6225740909066741,17.95710929109585,-2.113182527301107,8.970043532508491,66.60444789525782,24.425508572233678,5386406589
1352471400,137.62,139.44,137.55,138.16,NaN,NaN,149.4701634375,150.69000000000003,138.29305600000038,140.5095421,143.57660480000007,142.31891050000016,142.30296917925864,141.8019697419637,141.16143153846173,144.3366211230963,137.98624195382715,138.29305600000038,140.5095421,143.57660480000007,142.31891050000016,138.38333333333333,201055184,141981499.2,33.44465992377458,1.9565813416627398,1.5,2.75,NaN,NaN,1.7642444407127207,1.4160660729239576,479.68543739440514,-0.4706390974395449,-1.2108729627061052,-0.7402338652665603,18.051080696594425,-2.31209095044128,31.312016811629235,35.412282760687035,33.27570042768373,5587461773
1352730600,138.59,138.81,137.96001,138.265,NaN,NaN,149.67321046875,150.75789473684213,138.32498100000038,140.53519210000002,143.51170500000006,142.06416050000013,142.1446174467387,141.4651154808243,140.7656623076925,144.00308610581985,137.52823850956517,138.32498100000038,140.53519210000002,143.51170500000006,142.06416050000013,138.34500333333332,97677440,140685299.2,34.01195616081573,1.6912919142344884,1.5,2.75,NaN,NaN,1.6989405520903829,0.694297418105786,478.5403997919173,-0.4761843919138984,-1.3354643551589334,-0.859279963245035,17.877425589360147,-2.182532565791832,29.162080345823817,37.73606109940334,33.10185855477285,5685139213
1352817000,137.53999,139.25,137.36,137.78999,NaN,NaN,149.87625749999998,150.82578947368424,138.35483090000037,140.558292,143.45770460000006,141.80916000000013,141.97384774294503,141.1151035302696,140.48643076923096,144.05879569797938,136.91406584048255,138.35483090000037,140.558292,143.45770460000006,141.80916000000013,138.13333,123018192,140627115.2,32.65587267600512,1.5507542198610487,1.5,2.75,NaN,NaN,1.7125876555124973,0.8747828740214392,474.9312944975762,-0.47717783946590786,-1.4557522625774197,-0.9785744231115119,17.853718198917566,-2.5185848943342903,14.441352908835432,56.94376956339233,28.614877527772244,5562121021
1352903400,138.21001,138.42999,135.62,135.9299,NaN,NaN,150.07930453125,150.89368421052635,138.37763040000038,140.593191,143.35310260000008,141.40165500000015,141.73683018439817,140.6212746226249,140.0948846153848,144.39014457161704,135.79962465915258,138.37763040000038,140.593191,143.35310260000008,141.40165500000015,136.6599633333333,191504944,144817909.6,27.95544740760772,2.3468922910446737,1.5,2.75,NaN,NaN,1.7909735372616047,1.3223843965774245,469.390073674948,-0.5625711843699366,-1.6817884035739326,-1.119217219203996,18.818316851047303,-4.830987887698669,17.738529961855146,51.965697161922385,30.29577287622245,5370616077
1352989800,135.98,136.4901,135.17999,135.7,NaN,NaN,150.2823515625,150.96157894736845,138.3995303500004,140.6155909,143.24650260000007,140.90965550000016,141.50009174579432,140.1525818014225,139.65411615384636,144.4569036238096,134.8513286838831,138.3995303500004,140.6155909,143.24650260000007,140.90965550000016,135.79003,178128368,148283556,27.429926262718084,2.540123868651489,1.5,2.75,NaN,NaN,1.7566261417429192,1.2012685209680296,465.60871131480565,-0.5910711586862534,-1.8580561675618128,-1.2669850088755594,16.60306878739733,-4.139587454083084,18.051984973054555,51.51774811678146,30.43026691016398,5192487709
1353076200,135.89999,136.64,134.7,136.37,NaN,NaN,134.7,151.02947368421056,138.41903035000038,140.6660908,143.15570260000007,140.41815550000015,141.2989116773318,139.79233591557275,139.27103846153867,144.2623733084797,134.27970361459762,138.41903035000038,140.6660908,143.15570260000007,140.41815550000015,135.90333333333334,239483808,153816043.2,31.47295006880502,2.049191989706501,1.5,2.75,NaN,NaN,1.7697242744755677,1.5569494769060606,467.1433454864623,-0.5236407683767585,-1.9215359693465075,-1.397895200969749,17.326010622111074,-3.8622869735760523,20.877722116624113,47.649472878272675,31.47280500510321,5431971517
1353335400,137.89999,139.14999,136.4057,139.13,NaN,NaN,134.5935294117647,151.09736842105266,138.45128040000037,140.7375908,143.06290260000006,140.08365500000016,141.21385631743644,139.7292563045658,139.10026846153866,143.9451637809972,134.25537314208012,138.45128040000037,140.7375908,143.06290260000006,140.08365500000016,138.22856333333334,151495744,153985408.8,45.05325864875685,0.3816528595910463,1.5,2.75,NaN,NaN,1.841886112013027,0.9838318135503757,474.9223441696361,-0.2650454958715447,-1.7292020708091798,-1.464156574937635,21.965239131570545,-2.679077876393556,26.00103385816663,41.251657069938865,32.74730907189449,5583467261
1353421800,138.91,139.42,138.08,139.19,NaN,NaN,134.4870588235294,151.16526315789477,138.47453045000037,140.7977608,142.96010260000006,139.87367500000016,141.13448940302717,139.67789856127382,138.82026846153866,143.1655661510352,134.47497077204213,138.47453045000037,140.7977608,142.96010260000006,139.87367500000016,138.89666666666668,119807376,150693521.6,45.30700869543637,0.057974592214279974,1.5,2.75,NaN,NaN,1.8060371040120948,0.7950399906242552,476.69599389078553,-0.07189137018782299,-1.554020787672414,-1.482129417484591,21.16378514523234,-0.37933008874892726,44.74294440271403,23.10647851637404,32.15057708091193,5703274637
1353508200,139.31,139.57001,139.03,139.45,NaN,NaN,134.3805882352941,151.23315789473688,138.49953045000038,140.8643609,142.87890280000008,139.67567500000015,141.0684309950653,139.6561939363906,138.65796076923098,142.73088082210097,134.585040716361,138.49953045000038,140.8643609,142.87890280000008,139.67567500000015,139.35000333333332,81710752,148500128,46.46084053520166,0.3893091058945993,1.5,2.75,NaN,NaN,1.7156065965826592,0.5502402799275702,478.1250682489373,0.08304744177177481,-1.3783201152698723,-1.4613675570416471,16.831219521435518,1.0214503782563298,72.12517928694558,6.396981050720657,21.477839662333768,5784985389
1353681000,140.13,141.39999,140.03999,141.35001,NaN,NaN,134.2741176470588,151.30105263157898,138.53233055000035,140.91681100000002,142.82770300000007,139.67217550000015,141.07947330898432,139.81750975197244,138.61960769230788,142.57944570802294,134.65976967659282,138.53233055000035,140.91681100000002,142.82770300000007,139.67217550000015,140.92999666666665,65409152,142167769.6,54.08410698726375,1.319664112905136,1.5,2.75,NaN,NaN,1.7323482682553275,0.46008425245773854,479.9829757085487,0.310383811814648,-1.073387792273337,-1.383771604087985,16.624270907794575,2.308924435437175,100,0,0,5850394541
1353940200,140.64999,141.35629,140.19,141.05,NaN,NaN,134.16764705882352,151.36894736842106,138.56163055000036,140.9622111,142.76090300000007,139.67367550000017,141.07831749294573,139.93488977559412,138.47268384615404,141.88073400699437,135.0646336853137,138.56163055000036,140.9622111,142.76090300000007,139.67367550000017,140.86543,100124320,141165020,52.80556851368768,0.9573048550698291,1.5,2.75,NaN,NaN,1.6919155348085186,0.7092714611594289,477.5267658166691,0.43007265627369606,-0.846180783745865,-1.276253440019561,16.8104102553102,2.014248002025115,77.542826017894,4.274731869776118,18.18244211232989,5750270221
1354026600,140.91,141.39,140.24001,140.33,NaN,NaN,134.06117647058824,151.43684210526317,138.58648055000037,140.9913911,142.63570300000006,139.61867600000016,141.04897170890865,139.97251932077563,138.5196069230771,142.01084085975174,135.02837298640247,138.58648055000037,140.9913911,142.63570300000006,139.61867600000016,140.65333666666666,128646192,140874464,49.765034300343416,0.7426525512940513,1.5,2.75,NaN,NaN,1.6532065680364796,0.9131973840198604,476.32780793584095,0.44823282696775246,-0.7159624063098704,-1.1641952332776229,17.307801245734208,1.8433922522238544,39.42175502669495,27.622723540610316,32.955521432694724,5621624029
1354113000,139.75999,141.53999,139,141.46001,NaN,NaN,133.95470588235293,151.50473684210527,138.62197565000034,141.03809130000002,142.52010300000006,139.62417600000018,141.0650908575789,140.1141850997494,138.78268538461558,142.59075479509025,134.9746159741409,138.62197565000034,141.03809130000002,142.52010300000006,139.62417600000018,140.66666666666666,177086432,142427613.6,54.2203371970603,0.8711411983678219,1.5,2.75,NaN,NaN,1.7165482417481588,1.2433433905403861,477.81271139115546,0.5188465086856116,-0.5156370974206084,-1.03448360610622,17.364239893283912,4.068354350293797,46.50895351942867,21.737170192431833,31.753876288139498,5798710461
1354199400,141.99001,142.50999,141.37,142.12,NaN,NaN,133.84823529411764,151.57263157894738,138.65577565000035,141.10439120000004,142.42770280000005,139.66267550000015,141.1064598435562,140.30521509024945,139.08730076923095,143.26317215299164,134.91142938547026,138.65577565000035,141.10439120000004,142.42770280000005,139.66267550000015,141.99999666666668,151085872,144809982.4,56.63918379004716,1.354084657106024,1.5,2.75,NaN,NaN,1.6753655101947176,1.043338791262777,480.8895062602793,0.5874572145479069,-0.30016208792133625,-0.8876193024692431,13.958360624163896,4.731024318349312,53.387645730912226,16.74888360842666,29.863470660661118,5949796333
1354285800,142.14,142.42,141.66,142.155,NaN,NaN,133.74176470588233,151.6405263157895,138.69060065000033,141.17274110000005,142.33840280000004,139.62892550000018,141.14757906537753,140.48138508165425,139.38653153846172,143.83257639160695,134.9404866853165,138.69060065000033,141.17274110000005,142.33840280000004,139.62892550000018,142.07833333333335,136568320,146588620,56.769632574103085,1.1182643353422708,1.5,2.75,NaN,NaN,1.609982259466523,0.9316433976934908,482.2398874700733,0.6099914718411439,-0.1251299626678133,-0.7351214345089572,13.688370297875462,4.242135367016203,58.90906346376245,13.220556548150213,27.870379988087347,6086364653
1354545000,142.8,142.92,141.34,141.45,NaN,NaN,133.63529411764705,151.7084210526316,138.72505065000033,141.24584110000006,142.23340280000005,139.62342550000017,141.15943870987252,140.5736341214967,139.66807076923095,144.1375327580306,135.1986087804313,138.72505065000033,141.24584110000006,142.23340280000005,139.62342550000017,141.90333333333334,124656320,145936329.6,53.29179954011222,0.9030293721929082,1.5,2.75,NaN,NaN,1.6078406695046272,0.8541829189597488,480.7398874700733,0.5538492556390132,-0.04280986496019068,-0.5966591205992039,14.749196701517814,1.6675052109537793,53.26298816273833,16.847693894830524,29.889317942431134,5961708333
1354631400,141.44,141.87,140.87,141.25,NaN,NaN,133.52882352941174,151.7763157894737,138.75105565000035,141.31674110000006,142.12420260000005,139.5934955000002,141.16299013301477,140.6380499194494,140.0773092307694,144.04927576085353,136.10534270068527,138.75105565000035,141.31674110000006,142.12420260000005,139.5934955000002,141.33,127622496,147398532.8,52.31270332821572,0.4352981321670013,1.5,2.75,NaN,NaN,1.5644234788257252,0.8658328789009492,480.1680622109389,0.4823028035526858,0.006219383841653325,-0.47608341971103246,10.592821620570774,1.4799913786909995,53.28790026754968,16.830792378514502,29.88130735393582,5834085837
1354717800,141.37,142.16,140.37,141.5,NaN,NaN,133.42235294117646,151.8442105263158,138.77650565000033,141.39664120000006,142.03680260000004,139.52049500000015,141.1762062062299,140.72014040331138,140.52346307692326,143.6391407778788,137.40778537596773,138.77650565000033,141.39664120000006,142.03680260000004,139.52049500000015,141.34333333333333,147300432,149410151.2,53.463641715951454,0.6620272140747407,1.5,2.75,NaN,NaN,1.5805360874810301,0.9858796796398664,481.70733780983903,0.4324705411558521,0.06450475673378264,-0.36796578442206945,10.570711186702303,1.470060953746871,51.03742437187934,18.392451820259144,30.570123807861524,5981386269
1354804200,141.37,142.03999,141.16,141.98,NaN,NaN,133.31588235294117,151.9121052631579,138.80405565000035,141.45894120000006,141.96350260000003,139.63349500000018,141.20772753147577,140.84012703156745,140.95500153846172,143.03038976908508,138.87961330783835,138.80405565000035,141.45894120000006,141.96350260000003,139.63349500000018,141.72666333333333,103220560,141355957.6,55.67560590506551,0.5797088797053123,1.5,2.75,NaN,NaN,1.5304970812323846,0.7302172596933403,482.7223762476841,0.4125529765563677,0.1477254362733902,-0.2648275402829775,10.618078309150452,0.44569505159567535,46.97621047203175,21.393091603654355,31.630697924313893,6084606829
1354890600,142.53,142.69,141.67,142.41499,NaN,NaN,133.20941176470586,151.98000000000002,138.83597060000034,141.52879120000003,141.92980220000004,139.85224500000018,141.2550711576924,140.99011398094197,141.20769307692325,143.12677655336216,139.28860960048434,138.83597060000034,141.52879120000003,141.92980220000004,139.85224500000018,142.25833,108726320,137716411.2,57.640586883433635,0.7464780346772164,1.5,2.75,NaN,NaN,1.4940330040015009,0.78949428795455,483.5607259293082,0.40861675190786684,0.24594339960185607,-0.16267335230601077,7.684745435834109,0.9677348457993459,44.37454350350576,23.44355535547403,32.1819011410202,6193333149
1355149800,142.21001,142.81,142.14999,142.47301,NaN,NaN,133.10294117647058,152.04789473684212,138.86518065000035,141.58992130000001,141.9133624,140.0678955000002,141.30283346523387,141.1313421732332,141.46023230769248,143.09355994067658,139.82690467470837,138.86518065000035,141.58992130000001,141.9133624,140.0678955000002,142.47766666666666,98840688,132605686.4,57.90862207671174,0.8124194519870999,1.5,2.75,NaN,NaN,1.4344599322871079,0.7453729224088538,485.3161838903717,0.389914999969445,0.3247203976557955,-0.0651946023136495,7.47306343857695,1.5271217843654068,75.21379776232925,5.1661477357672085,19.620054501903535,6292173837
1355236200,143.06,144.11,142.99001,143.44,NaN,NaN,132.99647058823527,152.11578947368423,138.89773070000035,141.6506213,141.8893624,140.3266455000002,141.38664391757766,141.351214347211,141.76715538461556,143.26833854536463,140.2659722238665,138.89773070000035,141.6506213,141.8893624,140.3266455000002,143.51333666666667,152570368,135350332.8,62.2014720872717,1.283435510693871,1.5,2.75,NaN,NaN,1.4489263656951734,1.1272256583620308,489.11226824273484,0.42005852504496194,0.45987855399255295,0.039820028947591,7.009130435440344,1.3996817899277587,100,0,0,6444744205
1355322600,144,144.55,143.31,143.50999,NaN,NaN,132.89,152.18368421052634,138.92948065000033,141.70842120000003,141.8801622,140.61264550000018,141.46991239139814,141.556812028429,141.93330769230786,143.67232748075673,140.194287903859,138.92948065000033,141.70842120000003,141.8801622,140.61264550000018,143.78999666666667,145880000,136493423.2,62.49958946173678,1.3005762542920045,1.5,2.75,NaN,NaN,1.4340030538598045,1.0687694438306095,489.4630914504577,0.4210353072761767,0.5661141630428119,0.1450788557666352,5.9764918174676245,0.9780396847734191,100,0,0,6590624205
1355409000,143.42,143.83,142.27499,142.63,NaN,NaN,132.7835294117647,152.25157894736844,138.95483560000034,141.77002120000003,141.8458622,140.94765050000018,141.51540602310803,141.65902040667385,142.0548461538463,143.75024570766698,140.35944660002565,138.95483560000034,141.77002120000003,141.8458622,140.94765050000018,142.91166333333334,135714944,133703923.2,56.46913598894664,0.6152067445631078,1.5,2.75,NaN,NaN,1.4426464071555336,1.0150408510974793,485.83172625444485,0.34209460670219227,0.5726971141443755,0.23060250744218327,6.97898545084037,0.3341423094509474,76.00152917168661,4.863116005559378,19.135354822754003,6454909261
1355495400,142.32001,142.58,141.88,142.1051,NaN,NaN,132.6770588235294,152.31947368421055,138.98026110000035,141.84017220000004,141.7979642,141.26790550000018,141.5385312771038,141.7015041774668,142.1913923076925,143.56440493802455,140.81837967736044,138.98026110000035,141.84017220000004,141.7979642,141.26790550000018,142.18836666666667,137701680,131682588.8,53.173411848283486,0.10136390453149849,1.5,2.75,NaN,NaN,1.3931716637872813,1.045709089218635,484.7767174970116,0.23908268956996775,0.529455869404643,0.2903731798346752,7.355922102559461,0.4631318487097946,48.47779446433965,20.2990284443001,31.223177091360245,6317207581
1355754600,142.47,143.85001,142.42999,143.77,NaN,NaN,132.5705882352941,152.38736842105266,139.01046110000033,141.93862220000005,141.7715642,141.6379055000002,141.62603985447228,141.8985037796128,142.369083846154,143.90565329780497,140.83251439450305,139.01046110000033,141.93862220000005,141.7715642,141.6379055000002,143.35,143735744,126895185.6,60.95698963942558,0.7366984635569004,1.5,2.75,NaN,NaN,1.4182958306596185,1.132712350908922,485.99857235456597,0.26558645756812116,0.6223562517948267,0.3567697942267055,9.21696519712503,1.7840707964601843,51.3141059866952,18.181584093511827,30.504309919792966,6460943325
1355841000,144,145.5,143.78999,145.37,NaN,NaN,132.4641176470588,152.45526315789476,139.05075110000033,142.05272210000004,141.75646419999998,141.94990550000017,141.77286182096356,142.22912246726872,142.61908384615404,144.82427725886328,140.4138904334448,139.05075110000033,142.05272210000004,141.75646419999998,141.94990550000017,144.88666333333333,177762752,128208536,66.68769355103021,1.6451206748149465,1.5,2.75,NaN,NaN,1.4405604141839308,1.3865126109855899,490.3762867766867,0.36713168491516096,0.8156844003706567,0.44855271545549574,10.412427875332586,2.73498233215548,53.374589608570275,16.757717811727563,29.867692579702172,6638706077
1355927400,145.53,145.58,144.24001,144.28999,NaN,NaN,132.35764705882352,152.52315789473687,139.08845105000034,142.13392200000004,141.719464,142.20490500000017,141.87157272994537,142.4253955656241,142.78331384615404,145.1386859454651,140.42794174684298,139.08845105000034,142.13392200000004,141.719464,142.20490500000017,144.70333333333335,150895312,129762932.8,60.25824626806428,1.2127342609871556,1.5,2.75,NaN,NaN,1.4333768131707927,1.1628537421589473,491.7246865016132,0.33851953199338947,0.8717021304472325,0.5331825984538431,11.992934671418055,1.6269826736160018,25.83413156390523,41.475505667367706,32.69036276872706,6487810765
1356013800,144.38,145.14,143.98,145.12,NaN,NaN,132.25117647058823,152.59105263157898,139.14030105000032,142.19837200000006,141.709024,142.48840500000017,141.9989620346534,142.68202455937418,143.06562153846173,145.5879272448517,140.54331583207176,139.14030105000032,142.19837200000006,141.709024,142.48840500000017,144.74666666666667,168486944,134101742.4,63.19504676023845,1.1044326350318925,1.5,2.75,NaN,NaN,1.413849897944307,1.2564112962636642,494.63877906772547,0.35094861077822503,0.9718683619266244,0.6209197511483994,12.169758591620292,1.8993857317969238,53.056370632576716,16.973763314572736,29.969866052850556,6656297709
1356100200,142.17,144.0881,141.94,142.78999,NaN,NaN,132.14470588235292,152.65894736842108,139.17580100000035,142.23947200000003,141.68082379999998,142.56040400000015,142.0299827391768,142.69230698229092,143.18408230769248,145.4895038458261,140.87866076955885,139.17580100000035,142.23947200000003,141.68082379999998,142.56040400000015,142.93936333333332,245883808,143125475.2,51.65518771605653,0.38403442063678545,1.5,2.75,NaN,NaN,1.5400034766625712,1.7179597668158522,491.33272401676214,0.18598500875734192,0.8534010120950768,0.6674160033377349,16.047617482420275,0.22248424455972465,41.96568735101738,25.417544413828747,32.61676823515387,6410413901
1356359400,142.48,142.56,142.19,142.35001,NaN,NaN,132.03823529411764,152.7268421052632,139.20235110000033,142.28587200000004,141.662224,142.62540450000014,142.04253282783654,142.65970726969178,143.2494676923079,145.4033631034696,141.0955722811462,139.20235110000033,142.28587200000004,141.662224,142.62540450000014,142.36667,53874544,140812986.4,49.805679898315326,0.6300179349589384,1.5,2.75,NaN,NaN,1.4728596569009582,0.3825964165475578,489.1617530924754,0.03867617737155338,0.7157612250521765,0.6770850476806232,16.16065706474288,-0.75989263803681,25.080920496811036,42.339378491126396,32.57970101206258,6356539357
1356532200,142.64,142.71001,141.35001,141.75,NaN,NaN,131.93176470588233,152.7947368421053,139.22325105000033,142.32747200000003,141.63002400000002,142.69640450000014,142.0310609522351,142.5730684821021,143.23177538461556,145.43040422970077,141.03314653953035,139.22325105000033,142.32747200000003,141.63002400000002,142.69640450000014,141.93667333333335,106947680,139728060.8,47.31754094500244,0.736123896008871,1.5,2.75,NaN,NaN,1.464798252836605,0.7653987279840643,486.1668594791559,-0.10014570502470632,0.5519029163997402,0.6520486214244465,15.680517082084245,-1.2263884904458484,6.583411815868156,71.69580400905481,21.720784175077043,6249591677
1356618600,141.78999,142.08,139.92,141.5616,NaN,NaN,131.82529411764705,152.8626315789474,139.24315905000032,142.37668800000003,141.603456,142.70148400000016,142.01265071881411,142.47673815047332,143.16613000000018,145.5048821282159,140.82737787178445,139.24315905000032,142.37668800000003,141.603456,142.70148400000016,141.1872,167920560,139269767.2,46.531491573513975,1.1468858185071327,1.5,2.75,NaN,NaN,1.514455520491135,1.2057215530406948,485.0757700279759,-0.19987461882323443,0.4022053478954035,0.602079966718638,15.64429728232725,-0.7490710229264509,6.318990444858492,72.30995237037232,21.371057184769196,6081671117
1356705000,140.64,141.42,139.87,140.03,NaN,NaN,131.71882352941174,152.9305263157895,139.24299905000032,142.38349800000003,141.522456,142.5969840000002,141.93489971023317,142.24371546947586,142.97820615384634,145.8429800683051,140.11343223938758,139.24299905000032,142.38349800000003,141.522456,142.5969840000002,140.43999999999997,148806624,139155804.8,40.62333050037319,1.3392787646774933,1.5,2.75,NaN,NaN,1.5271086975989105,1.0693526167583918,481.1774135667744,-0.35513719415892286,0.1581584740199844,0.5132956681789073,16.388867996593817,-1.460257232147187,0,100,0,5932864493
1356964200,139.66,142.56,139.53999,142.41,NaN,NaN,139.53999,152.9984210526316,139.2554990500003,142.41139800000002,141.4598562,142.60973400000017,141.9535310941456,142.25955209143055,142.89897538461557,145.76525241898503,140.0326983502461,139.2554990500003,142.41139800000002,141.4598562,142.60973400000017,141.50333,243952192,144524998.4,51.028813855165524,0.5797187522011061,1.5,2.75,NaN,NaN,1.633744504913275,1.6879584480244492,485.8597987690827,-0.28662946863042443,0.1550088323908767,0.44163830102130114,19.480619803129443,-0.945955345343266,14.441456487863308,56.911629126895726,28.646914385240976,6176816685
1357137000,145.11,146.14999,144.73,146.06,NaN,NaN,139.70688620689654,153.06631578947372,139.28219905000032,142.46879790000003,141.4570562,142.84023400000018,142.1145690904536,142.6214995112943,143.09513000000018,146.41495667067738,139.77530332932298,139.28219905000032,142.46879790000003,141.4570562,142.84023400000018,145.64666333333335,192058944,147895129.6,62.021126940310836,1.9065744491770384,1.5,2.75,NaN,NaN,1.7841906117051844,1.2986157456262848,495.73011167815895,0.00024357773936450888,0.4419427731955068,0.4416991954561423,23.554061882969574,0.47465089083029355,34.24411810760545,32.44740261105229,33.308479281342265,6368875629
1357223400,145.99001,146.37,145.34,145.7341,NaN,NaN,139.8737824137931,153.13421052631583,139.30936955000033,142.52123880000002,141.45533799999998,143.06443900000016,142.25651147906328,142.9179376530758,143.3339069230771,146.92130747963245,139.74650636652177,139.30936955000033,142.52123880000002,141.45533799999998,143.06443900000016,145.81470000000002,144761744,148752092,60.710767715687844,1.7445937344410074,1.5,2.75,NaN,NaN,1.7303198537262428,0.9731745083625446,497.9744461089061,0.15521221291172327,0.6357144615957964,0.4805022486840731,22.820903523758385,1.0008386583158149,31.109847807964183,35.624545280389945,33.265606911645875,6224113885
1357309800,145.97,146.61,145.67,146.37,NaN,NaN,140.04067862068965,153.20210526315793,139.33696950000032,142.57883880000003,141.51494599999998,143.30793900000018,142.41782475439413,143.24670549564001,143.66197615384633,147.51042843828202,139.81352386941063,139.33696950000032,142.57883880000003,141.51494599999998,143.30793900000018,146.21666666666667,116817680,147227954.4,62.38089040849772,1.8014902665961494,1.5,2.75,NaN,NaN,1.6738684356029414,0.7934476878121999,501.8487074565824,0.2804080756597406,0.8310123432587488,0.5506042675990083,22.364415311568358,0.8613561190738699,54.80872883514156,15.792746363245183,29.398524801613263,6340931565
1357569000,145.85001,146.4442,145.42999,145.9695,NaN,NaN,140.2075748275862,153.27000000000004,139.36461700000032,142.6301338,141.566136,143.50741400000018,142.55710613657476,143.50601925796002,143.83116846153865,147.87231300130045,139.79002392177685,139.36461700000032,142.6301338,141.566136,143.50741400000018,145.94789666666668,110002432,147567048,60.632733694678244,1.3091927557168601,1.5,2.75,NaN,NaN,1.6267499759170165,0.7454403506126923,500.113652222111,0.31360023393923864,0.9426045600230566,0.629004326083818,22.29646093870445,2.2267037066113824,61.064951992768876,11.982028512164709,26.953019495066425,6230929133
1357655400,145.71001,145.91,144.98,145.54961,NaN,NaN,140.37447103448275,153.33789473684214,139.39131500000033,142.6779299,141.6487282,143.6641450000002,142.6744592292581,143.7006469476781,143.84498461538482,147.908246555086,139.78172267568362,139.39131500000033,142.6779299,141.6487282,143.6641450000002,145.47987,121265056,148193984.8,58.773109632127735,0.8429362251063073,1.5,2.75,NaN,NaN,1.581232120494374,0.8182859524538542,499.87009107188726,0.2854340820120099,0.9857969285988304,0.7003628465868205,19.809209196191144,2.247699174731357,28.66382092484817,38.31472790843597,33.02145116671584,6109664077
1357741800,145.87,146.32001,145.64,145.92,NaN,NaN,140.5413672413793,153.40578947368425,139.4249150000003,142.72923000000003,141.74672819999998,143.83649450000019,142.80173533791464,143.9120139050421,143.9703700000002,148.1788265704622,139.7619134295382,139.4249150000003,142.72923000000003,141.74672819999998,143.83649450000019,145.96000333333333,90745568,147789228.8,59.94028017900123,1.006632368272156,1.5,2.75,NaN,NaN,1.5233155404590613,0.6140201741143397,501.5847163778769,0.2700695075331111,1.0379497310032093,0.7678802234700982,19.55163619177893,2.941798941798933,17.622359984078237,52.166121770648886,30.21151824527288,6200409645
1357828200,146.73,147.09,145.97,147.08,NaN,NaN,140.70826344827586,153.47368421052636,139.46206505000032,142.79053000000002,141.8597284,144.01849450000017,142.96951042270229,144.21372686646666,144.12113923076942,148.61433883429294,139.6279396272459,139.46206505000032,142.79053000000002,141.8597284,144.01849450000017,146.71333333333334,130735376,146697479.2,63.43199252280251,1.3304365640671794,1.5,2.75,NaN,NaN,1.498078716140558,0.8911903375092216,504.3866580605288,0.31330967266398146,1.159517314300075,0.8462076416360935,19.26920603584365,3.898232288982333,48.427709328884276,20.317022261626434,31.255268409489293,6331145021
1357914600,147.03999,147.14999,146.61,147.07001,NaN,NaN,140.8751596551724,153.54157894736844,139.4893651000003,142.84133000000003,141.97412839999998,144.19649550000017,143.13031432769435,144.48575383156506,144.45037153846172,149.12858613471943,139.77215694220402,139.4893651000003,142.84133000000003,141.97412839999998,144.19649550000017,146.94333333333336,113917312,145099344.8,63.38075594108483,1.210285317388005,1.5,2.75,NaN,NaN,1.429643807844803,0.7850987346429423,504.9924405933442,0.31563530770253423,1.2407517762642613,0.925116468561727,19.162450897094406,5.027501249732197,21.430813352303964,46.959112845023874,31.610073802672165,6217227709
1358173800,146.89,147.07001,146.42999,146.97,NaN,NaN,141.04205586206896,153.60947368421054,139.51836510000032,142.8892301,142.0865282,144.41349550000015,143.2808902364122,144.72234870474935,144.80575538461557,149.4936657786959,140.11784499053522,139.51836510000032,142.8892301,142.0865282,144.41349550000015,146.82333333333335,89567120,142791953.6,62.83358096453435,0.985334096843825,1.5,2.75,NaN,NaN,1.3732421072844596,0.6272560725018332,504.49669598987947,0.2857303314841817,1.282279382916954,0.9965490514327724,17.086860658493556,3.202022329892565,23.958088042782936,43.91342837734461,32.128483579872466,6127660589
1358260200,146.28999,147.21001,146.2,147.07001,NaN,NaN,141.20895206896552,153.67736842105265,139.55136515000032,142.9380302,142.1713284,144.66174100000018,143.4294831683176,144.9459354947732,145.21498692307708,149.68835184723952,140.74162199891464,139.55136515000032,142.9380302,142.1713284,144.66174100000018,146.82667333333333,93172560,140565497.6,63.17594263370236,0.8631371297397586,1.5,2.75,NaN,NaN,1.3472969567641429,0.6628408933260164,506.25709648436646,0.24930507270375424,1.3081803923124653,1.058875319608711,15.36285018934775,0.6915034917157292,51.23763255554533,18.371912975703747,30.39045446875091,6220833149
1358346600,146.77,147.28,146.61,147.05,NaN,NaN,141.37584827586207,153.74526315789475,139.58546515000032,142.99093029999997,142.2811284,144.82574100000016,143.57146422054043,145.1463225905091,145.6371715384617,149.66548092273328,141.60886215419012,139.58546515000032,142.99093029999997,142.2811284,144.82574100000016,146.98,104849504,138621185.6,63.05079767880622,0.8640338016388605,1.5,2.75,NaN,NaN,1.2989186027095605,0.7563743128164386,505.01063255934326,0.2024748866861319,1.311968927966376,1.109494041280244,6.199376837958718,0.9029458445209454,25.78092041260297,41.72992079443097,32.489158792966066,6115983645
1358433000,147.7,148.42,147.14461,148,NaN,NaN,141.54274448275862,153.81315789473686,139.6214151500003,143.05273019999998,142.4041564,144.95724100000018,143.74513229032317,145.418101391413,146.25024846153863,148.85172799383074,143.64876892924653,139.6214151500003,143.05273019999998,142.4041564,144.95724100000018,147.85487,133833440,136424720,66.44885116904824,1.3414966324654949,1.5,2.75,NaN,NaN,1.3039958453731617,0.981005788393775,508.8143005138652,0.21302030044393994,1.375769416835169,1.1627491163912291,6.687613125852826,1.1136161781785854,26.304438237303142,41.1192138487889,32.57634791390796,6249817085
1358519400,147.97,148.49001,147.42999,148.33,NaN,NaN,141.70964068965517,153.88105263157897,139.6538651500003,143.12938029999998,142.5115562,145.15924150000018,143.924931024036,145.6954250684213,146.70563307692322,148.35832249373465,145.0529436601118,139.6538651500003,143.12938029999998,142.5115562,145.15924150000018,148.08333333333334,169905936,137375251.2,67.5647315912355,1.105916460607743,1.5,2.75,NaN,NaN,1.2865689992750793,1.2368016401487025,511.29300985543796,0.21892235265505322,1.4364020572100458,1.2174797045549925,6.4688298434413385,1.6171186446483694,60.67861539281577,12.281376091482663,27.04000851570155,6419723021
1358865000,148.33,149.13,147.98,149.13,NaN,NaN,141.87653689655173,153.94894736842107,139.6932152000003,143.20558039999997,142.6997562,145.3597415000002,144.1290513760346,146.02252744285735,146.94178692307707,148.98837606318028,144.89519778297387,139.6932152000003,143.20558039999997,142.6997562,145.3597415000002,148.74666666666667,111797312,134540769.6,70.15608577586588,1.3714500720328382,1.5,2.75,NaN,NaN,1.2768140707554312,0.8309549018664154,514.3307133097637,0.25109997414512897,1.5313546722364038,1.2802546980912748,6.275051032071071,2.4599104044318594,81.63851847426156,2.954525754396749,15.406955771341693,6531520333
1358951400,149.13,149.5,148.86,149.37,NaN,NaN,142.04343310344825,154.01684210526318,139.7407652000003,143.2838805,142.92635639999997,145.6887420000002,144.33457877305284,146.34133435306143,147.22147153846166,149.5108126497245,144.9321304271988,139.7407652000003,143.2838805,142.92635639999997,145.6887420000002,149.24333333333334,104596064,127476382.4,70.90702257647992,1.4322180160863802,1.5,2.75,NaN,NaN,1.2313273514157566,0.8205132749358598,512.6655624839442,0.2617496099561165,1.6074417105364205,1.345692100580304,5.434758843865636,2.3643092105263275,82.07166414606189,2.824447549217899,15.10388830472021,6636116397
1359037800,149.14999,150.14,149.00999,149.41,NaN,NaN,142.2103293103448,154.0847368421053,139.7888652500003,143.3639806,143.1513564,146.04174150000017,144.5336148995998,146.63358822419843,147.4553176923078,149.95991528568314,144.95072009893246,139.7888652500003,143.3639806,143.1513564,146.04174150000017,149.51999666666666,146426320,132103971.2,71.03782392678272,1.3323420798120789,1.5,2.75,NaN,NaN,1.2240903977432025,1.1084172464302118,514.3464541596321,0.24498753683180086,1.6519265216200552,1.4069389847882543,5.596158295156529,1.584171879249377,100,0,0,6782542717
1359124200,149.88,150.25,149.3726,150.25,NaN,NaN,142.37722551724136,154.1526315789474,139.8490152500003,143.4513807,143.39105639999997,146.46674150000018,144.75778686432136,146.9780083933224,147.78458692307706,150.53471629817525,145.03445754797886,139.8490152500003,143.4513807,143.39105639999997,146.46674150000018,149.95753333333334,147211568,134117165.6,73.71085773758736,1.4162089226401757,1.5,2.75,NaN,NaN,1.1993267979044018,1.0976340525943833,515.9615998658066,0.26241878607289704,1.7349624673793755,1.4725436813064785,4.868138233350208,2.1622287235854567,100,0,0,6929754285
1359383400,150.28999,150.33,149.50999,150.07001,NaN,NaN,142.5441217241379,154.2205263157895,139.9198653500003,143.54718069999998,143.63665679999997,146.89216200000016,144.96610934023033,147.2724847368155,148.13231000000013,150.80620816452017,145.4584118354801,139.9198653500003,143.54718069999998,143.63665679999997,146.89216200000016,149.97,113357632,131389019.2,72.17374307205446,1.2038405462486377,1.5,2.75,NaN,NaN,1.1722327409112319,0.8627633624956689,514.20245388136,0.23467648803619823,1.7658892913517263,1.5312128033155281,5.092640558458749,2.1092808056065846,79.24328279033384,3.688422169059695,17.068295040606476,6816396653
1359469800,149.77,150.85001,149.67,150.66,NaN,NaN,142.71101793103446,154.2884210526316,139.9881653500003,143.64218069999998,143.93125879999997,147.42366200000015,145.1893991700252,147.59510523807117,148.4969253846155,151.15736209302105,145.83648867620997,139.9881653500003,143.64218069999998,143.93125879999997,147.42366200000015,150.39333666666664,105694368,129233406.4,74.08167423885277,1.3860866118329545,1.5,2.75,NaN,NaN,1.172788259417573,0.8178563959914315,516.3347089383143,0.2286780324277955,1.8170603438502724,1.5883823114224769,4.881094713506959,2.4410075174401635,79.05154859582257,3.7527654846285783,17.195685919548865,6922091021
1359556200,150.64,150.94,149.92999,150.07001,NaN,NaN,142.87791413793101,154.3563157894737,140.04456545000028,143.73258079999997,144.218659,147.80666250000016,145.3807956731615,147.83081045349297,148.72692615384628,151.37456454245674,146.07928776523582,140.04456545000028,143.73258079999997,144.218659,147.80666250000016,150.31333333333336,137447632,123908178.4,68.987617894775,1.0170422043549407,1.5,2.75,NaN,NaN,1.1611612408877459,1.109270056059512,513.3469663950908,0.16079787451591399,1.7893796545673695,1.6285817800514555,6.069265564444197,2.0537300238014176,50.60379374273168,18.691605999087237,30.70460025818108,6784643389
1359642600,149.89,150.38,149.60001,149.7,NaN,NaN,143.04481034482757,154.42421052631582,140.1073654500003,143.82048079999998,144.48525899999999,147.98866250000015,145.5501762349983,148.00882850554126,148.9292330769232,151.43779691700618,146.4206692368402,140.1073654500003,143.82048079999998,144.48525899999999,147.98866250000015,149.89333666666667,108975808,119754021.6,65.92591788914731,0.6743104699366606,1.5,2.75,NaN,NaN,1.133934723681478,0.9099970635140657,514.4820705922734,0.07136197329689908,1.7177842466725792,1.6464222733756801,6.5033393825621895,1.148648648648641,23.51377115522322,44.27381789016934,32.21241095460744,6675667581
1359729000,150.64999,151.42,150.39,151.24001,NaN,NaN,143.21170655172412,154.49210526315792,140.1783155000003,143.89518089999999,144.7274592,148.26395800000014,145.77330697088072,148.3165600764421,149.2576953846155,151.77229638702445,146.74309438220652,140.1783155000003,143.89518089999999,144.7274592,148.26395800000014,151.01666999999998,131173008,119074584.8,71.57943765954519,1.293905097428783,1.5,2.75,NaN,NaN,1.175796529132801,1.1016037403810457,519.0118594771744,0.09483409337768522,1.7649648900977866,1.6701307967201013,7.740626181024722,1.9618485808669854,21.796504502217562,46.44000860565376,31.76348689212867,6806840589
1359988200,150.32001,151.2679,149.42999,149.535,NaN,NaN,143.37860275862067,154.56000000000003,140.23058050000031,143.94723089999997,144.9343592,148.42220800000013,145.92082434457168,148.4326019739238,149.44731000000013,151.6222718232633,147.27234817673695,140.23058050000031,143.94723089999997,144.9343592,148.42220800000013,150.07763,159073568,121187379.2,59.75780501815501,0.5266611100054404,1.5,2.75,NaN,NaN,1.2230903484804576,1.3126248710888864,514.2204352130466,-0.019461415026523543,1.645804027936947,1.6652654429634706,10.943124901827742,0.27157513578756864,18.57322972166383,50.75641052613055,30.67035975220563,6647767021
1360074600,150.35001,151.48,150.28999,151.05,NaN,NaN,143.54549896551723,154.62789473684214,140.2927805000003,144.02263099999996,145.16635920000002,148.67623300000014,146.1219684879218,148.68187797640724,149.75500230769245,151.59178396636548,147.91822064901942,140.2927805000003,144.02263099999996,145.16635920000002,148.67623300000014,150.93999666666667,113912320,121382873.6,65.24965519971954,1.1102744959552804,1.5,2.75,NaN,NaN,1.274655323588996,0.9384546322027427,517.6182955023249,-0.00857757237673451,1.6545434774925525,1.663121049869287,11.945601882608113,1.1247238401285444,19.451564143867525,49.53972209514369,31.008713760988783,6761679341
1360161000,150.52,151.25999,150.41,151.16,NaN,NaN,143.71239517241378,154.69578947368424,140.3599805000003,144.09513099999995,145.362559,148.95675250000014,146.31953835114055,148.9178895977018,149.99807923076938,151.67053524502165,148.3256232165171,140.3599805000003,144.09513099999995,145.362559,148.95675250000014,150.94332999999997,138762752,122257758.4,65.61655806652274,0.7858092819928867,1.5,2.75,NaN,NaN,1.2443220861897812,1.135001604937,518.9624048112184,-0.009448554271032528,1.6513103570304963,1.6607589113015289,11.947409897837826,1.1712736764607456,47.06236937948599,21.306168082085662,31.631462538428345,6900442093
1360247400,151.205,151.35001,149.86,150.96001,NaN,NaN,143.87929137931033,154.76368421052635,140.4250305500003,144.16083109999997,145.5607592,149.20875300000012,146.50151763148799,149.11237725506354,150.20038769230786,151.63633860709683,148.76443677751888,140.4250305500003,144.16083109999997,145.5607592,149.20875300000012,150.72334,162490000,125844980,64.28757541285829,0.5402324532225115,1.5,2.75,NaN,NaN,1.26187122289051,1.2911917503582582,516.4861438936517,-0.037402876591034584,1.6140053155627356,1.6514081921537702,12.026879958750403,0.4725524126455981,40.53419274419202,26.640366505725176,32.82544075008281,6737952093
1360333800,151.22,151.89,151.22,151.8,NaN,NaN,144.04618758620688,154.83157894736846,140.50008060000027,144.21293109999996,145.7901592,149.44475300000013,146.70930125378257,149.36834132600987,150.40577230769247,151.93155146768797,148.87999314769698,140.50008060000027,144.21293109999996,145.7901592,149.44475300000013,151.63666666666668,103133680,124464895.2,67.28471578166202,0.9879589469071841,1.5,2.75,NaN,NaN,1.2381654212554718,0.8286166138193157,519.6078578522354,-0.014412757491359729,1.6333922452895706,1.6478050027809303,12.018944122458912,1.1527886217905996,37.93530309305734,28.95703415562904,33.10766275131361,6841085773
1360593000,151.74001,151.89999,151.3938,151.77,NaN,NaN,144.21308379310344,154.89947368421056,140.57238060000026,144.25823099999997,145.996359,149.67975250000012,146.90776002814403,149.59707072353274,150.59038769230787,152.15058715161024,149.0301882330055,140.57238060000026,144.25823099999997,145.996359,149.67975250000012,151.68793000000002,73774944,122457776.8,67.06822650389789,0.8535592381849142,1.5,2.75,NaN,NaN,1.185881462594367,0.6024520935121207,517.6158525544555,-0.016184709255278484,1.6275741162118322,1.6437588254671107,11.964878015147576,0.7367582636399932,48.4213706724649,20.27539457574566,31.303234751789425,6767310829
1360679400,151.78,152.3,151.61,152.02,NaN,NaN,144.37998,154.96736842105267,140.63653060000027,144.3110309,146.19435900000002,149.93225250000015,147.10824002704035,149.82782589272009,150.7911569230771,152.3637775874461,149.2185362587081,140.63653060000027,144.3110309,146.19435900000002,149.93225250000015,151.9766666666667,65392608,121249051.2,67.99244758839593,0.9149235935693935,1.5,2.75,NaN,NaN,1.1504613581233407,0.5393246986496831,520.5853949128302,-0.015478324580801228,1.6244109197411092,1.6398892443219104,11.841086757245607,1.2993868661700054,43.3483024543913,24.256253815948956,32.39544372965975,6832703437
1360765800,152.33,152.61,151.72,152.151,NaN,NaN,144.54687620689654,155.03526315789478,140.6964856000003,144.36634089999998,146.394279,150.18630200000013,147.3059953200976,150.0490805696039,150.93738769230788,152.63045308580445,149.2443222988113,140.6964856000003,144.36634089999998,146.394279,150.18630200000013,152.16033333333334,82322560,120706551.2,68.49145282302908,0.8472662928243946,1.5,2.75,NaN,NaN,1.131856975400246,0.6820057335877227,522.8773732192202,-0.020814620253614136,1.6138709690048927,1.6346855892585068,11.440626719298756,1.637274549098211,36.38883646080885,30.388980279085317,33.22218326010584,6915025997
1360852200,151.69,152.47,151.52,152.28999,NaN,NaN,144.7137724137931,155.10315789473688,140.7559855500003,144.42224079999997,146.61107880000003,150.44830150000013,147.50144609185847,150.2625005153559,151.1081553846156,152.86350912645585,149.35280164277535,140.7559855500003,144.42224079999997,146.61107880000003,150.44830150000013,152.09333,80834192,119505785.6,69.04290739925139,0.8149042285746642,1.5,2.75,NaN,NaN,1.1188671914430848,0.6764040049957214,522.2640651490052,-0.0291012696011399,1.598309002257082,1.627410271858222,11.187080695927946,0.6942475076535478,79.16658575614008,3.7105534616724487,17.122860782187463,6995860189
1360938600,152.42999,152.59,151.55,152.11,NaN,NaN,144.88066862068965,155.171052631579,140.81718555000032,144.47624069999995,146.82827880000002,150.65380150000013,147.6821736960993,150.43845284722676,151.21969384615406,153.0303661039757,149.40902158833242,140.81718555000032,144.47624069999995,146.82827880000002,150.65380150000013,152.08333333333334,215226432,123575435.2,67.39786531396615,0.5663176389852519,1.5,2.75,NaN,NaN,1.113233820625721,1.7416603198820861,520.8833950218568,-0.05909297434684335,1.5535440539246679,1.6126370282715112,9.847135401645756,1.722004881800259,26.67809139922219,40.48778609133306,32.83412250944475,6780633757
1361284200,152.37,153.28,152.1629,153.25,NaN,NaN,145.0475648275862,155.2389473684211,140.8797355000003,144.55004069999995,147.06327880000003,150.89980150000014,147.90051982566405,150.70621924272896,151.46430846153868,153.4393631780953,149.48925374498205,140.8797355000003,144.55004069999995,147.06327880000003,150.89980150000014,152.89763333333335,95105376,119835407.2,71.95556580308019,1.0328432409617565,1.5,2.75,NaN,NaN,1.117288547723883,0.7936333527975862,524.1518338399613,-0.016743409693120714,1.5917077661551104,1.6084511758482312,7.043987997350406,1.4564713670969802,48.62357655061783,20.132472783885834,31.24395066549633,6875739133
1361370600,153.14,153.19,151.25999,151.34,NaN,NaN,145.21446103448275,155.3068421052632,140.93481050000028,144.60699069999995,147.25047880000002,151.01030150000014,148.0354014011282,150.76657931485002,151.59046230769255,153.28874285187783,149.89218176350727,140.93481050000028,144.60699069999995,147.25047880000002,151.01030150000014,151.92999666666665,160574816,122274282.4,57.46150868469882,0.2926396848081269,1.5,2.75,NaN,NaN,1.179625794315035,1.3132345808802717,519.8153746796809,-0.12587748604793236,1.4511043182883157,1.576981804336248,9.580526914602054,0.11907912146070841,22.86828793021993,45.07175191885408,32.059960150925974,6715164317
1361457000,150.96001,151.4218,149.94,150.42,NaN,NaN,145.3813572413793,155.3747368421053,140.99066050000027,144.67019059999996,147.41057900000004,151.06280150000015,148.1289150716722,150.73357176105478,151.52738461538485,153.33071064309505,149.72405858767465,140.99066050000027,144.67019059999996,147.41057900000004,151.06280150000015,150.59393333333333,183256944,126207326.4,52.02549047706842,0.5697368256735582,1.5,2.75,NaN,NaN,1.2012096661496747,1.4520309496073756,516.3966760968865,-0.2607711978104865,1.25101780707314,1.5117890048836264,10.218570097601527,-0.3577172524034833,7.48164555360953,69.71243329629401,22.80592115009648,6531907373
1361543400,151.14999,151.89,150.4913,151.89,NaN,NaN,145.54825344827586,155.4426315789474,141.0651105000003,144.75614059999995,147.59891880000004,151.18680150000014,148.2764085982733,150.84370778381145,151.70853846153867,153.10129186410552,150.3157850589718,141.0651105000003,144.75614059999995,147.59891880000004,151.18680150000014,151.42376666666667,106356496,124203835.2,58.74176865642852,0.0798755206675392,1.5,2.75,NaN,NaN,1.2204089757104124,0.8563060539051696,520.3413483976536,-0.25162063189503825,1.1972632150148286,1.4488838469098668,11.738960445628363,0.05928853754939063,9.25993082450434,66.04463930623643,24.69542986925924,6638263869
1361802600,152.63,152.86,149,149,NaN,NaN,145.7151496551724,155.51052631578952,141.1246104500003,144.79974059999995,147.71011880000006,151.12430150000014,148.30478473167435,150.6681165663056,151.55084615384638,153.54186175032805,149.5598305573647,141.1246104500003,144.79974059999995,147.71011880000006,151.12430150000014,150.28666666666666,245824752,129134494.4,45.3113315212885,0.5251537737526953,1.5,2.75,NaN,NaN,1.4089511917310982,1.9036335190080707,515.3236378285955,-0.43033711104558403,0.9109624581028868,1.3412995691484708,15.810998489671077,-1.8251301311194637,8.55325272921147,67.4504562889507,23.996290981837834,6392439117
1361889000,149.72,150.2,148.73,150.02,NaN,NaN,148.73,155.5784210526316,141.1919604500003,144.86024059999997,147.84031900000008,151.12180100000015,148.37204807553024,150.6063911790384,151.46315384615409,153.60965189522753,149.31665579708064,141.1919604500003,144.86024059999997,147.84031900000008,151.12180100000015,149.64999999999998,186596192,132796422.4,49.68390457673809,0.8460657376491929,1.5,2.75,NaN,NaN,1.4133118208931623,1.4051296610833997,518.4333732748119,-0.46692851045058537,0.7576389310852392,1.2245674415358245,16.574195074923903,-1.3156163662675964,14.763339894613619,56.40671927115731,28.82994083422907,6579035309
1361975400,149.89,152.33,149.75999,151.91,NaN,NaN,148.97184236842105,155.6463157894737,141.27281040000028,144.93589059999996,148.02591900000007,151.18430100000015,148.51079128825455,150.73054440008238,151.53623000000024,153.6739009995484,149.39855900045208,141.27281040000028,144.93589059999996,148.02591900000007,151.18430100000015,151.33333000000002,150781872,135050797.6,56.6070742256327,0.58964412428103,1.5,2.75,NaN,NaN,1.4959331194007954,1.116482647119146,522.6441139553397,-0.3559348896235741,0.7796488295063568,1.135583719129931,18.325280723433917,-0.15839527837478154,35.661250565657966,31.07905732662312,33.25969210771892,6729817181
1362061800,151.89999,152.87,151.41,151.61,NaN,NaN,149.21368473684208,155.7142105263158,141.3507604000003,145.00699059999997,148.21601700000008,151.26130050000015,148.6323288847936,150.81430207626502,151.52161461538486,153.65446476407467,149.38876446669505,141.3507604000003,145.00699059999997,148.21601700000008,151.26130050000015,151.96333333333334,126865936,134521712.8,55.30625652041605,0.8044059527111052,1.5,2.75,NaN,NaN,1.4933664680150247,0.9430889137474615,523.5959452985843,-0.2972057424731742,0.7640765410384631,1.0612822835116373,18.344684633656794,-0.44650997744498855,40.4599337139768,26.702331245880277,32.83773504014292,6602951245
1362148200,151.09,152.34,150.41,152.11,NaN,NaN,149.45552710526314,155.78210526315792,141.43326040000028,145.07719059999997,148.38281700000005,151.38180050000017,148.76870814421346,150.9377018785255,151.5477684615387,153.70040701873333,149.3951299043441,141.43326040000028,145.07719059999997,148.38281700000005,151.38180050000017,151.62,170634752,137604660,57.0766616351553,0.530938200100039,1.5,2.75,NaN,NaN,1.5245545774425235,1.2400361441247703,524.2929355815477,-0.22258211077129864,0.783054645047514,1.0056367558188126,18.455135749049546,0,45.23888297619456,22.72698892379553,32.03412810000991,6773585997
1362407400,151.75999,152.92,151.52,152.92,NaN,NaN,149.6973694736842,155.85000000000002,141.5273104000003,145.1451406,148.53381700000006,151.46580000000017,148.93150390326392,151.12649217580878,151.61699923076947,153.88094612741588,149.35305233412305,141.5273104000003,145.1451406,148.53381700000006,151.46580000000017,152.45333333333335,99010192,135996519.2,59.85124455704097,0.6813547224466907,1.5,2.75,NaN,NaN,1.5156578219109131,0.7280347510541285,525.5452062464527,-0.12161723272574798,0.8536152149116276,0.9752324476373756,18.69220185920734,-0.2153344208809217,79.11412719214476,3.7347710713395608,17.151101736515663,6872596189
1362493800,153.66,154.7,153.64,154.28999,NaN,NaN,149.93921184210527,155.91789473684213,141.63206035000027,145.22664049999997,148.73381700000004,151.70354950000018,149.14164061293985,151.42777768287462,151.78153692307714,154.4513400787476,149.1117337674067,141.63206035000027,145.22664049999997,148.73381700000004,151.70354950000018,154.20999666666665,121663056,134125993.6,64.08039235292085,1.5620630500344095,1.5,2.75,NaN,NaN,1.5345394060601336,0.9070803707358333,529.6295444035864,0.026579526304845058,1.008456855518432,0.9818773292135868,18.90620119419331,1.9492467292189675,76.96722889633688,4.48812699381033,18.544644109852793,6994259245
1362580200,154.84,154.92,154.16,154.5,NaN,NaN,150.1810542105263,155.98578947368424,141.74041540000027,145.31522049999998,148.92141700000005,151.8760495000002,149.35177235360888,151.7203702845056,151.95153769230794,154.98576918602703,148.91730619858885,141.74041540000027,145.31522049999998,148.92141700000005,151.8760495000002,154.52666666666667,94469872,133153871.2,64.69434143377262,1.4586453421646244,1.5,2.75,NaN,NaN,1.4792151627701233,0.7094789745774962,531.8012295134068,0.12252380051919687,1.135032079862583,1.0125082793433862,16.934890130481513,2.712405265257288,74.63337966742777,5.37756294385121,19.989057388721026,7088729117
1362666600,154.7,154.98,154.52,154.776,NaN,NaN,150.42289657894736,156.05368421052634,141.8599954000003,145.42098049999996,149.16113720000004,152.05684950000017,149.56448716327128,152.01138263836222,152.15661461538485,155.54560422697824,148.76762500379147,141.8599954000003,145.42098049999996,149.16113720000004,152.05684950000017,154.75866666666667,86101312,130520799.2,65.52824898046634,1.403246413246716,1.5,2.75,NaN,NaN,1.4078426511436852,0.6596750290202023,534.2426484278477,0.1846197432647898,1.2432829584243734,1.0586632151595836,16.131444812648997,1.900059253407087,100.00000000000001,0,0,7174830429
1362753000,155.46001,155.64999,154.66,155.44,NaN,NaN,150.66473894736842,156.12157894736845,141.98849535000028,145.54258049999996,149.42293700000005,152.28084900000016,149.7948994313783,152.33791762518487,152.3250761538464,156.10938633891683,148.54076596877596,141.98849535000028,145.54258049999996,149.42293700000005,152.28084900000016,155.24999666666665,123487632,128570680.8,67.51610690069883,1.520897565324974,1.5,2.75,NaN,NaN,1.377996033204851,0.9604649460641264,537.6478265575846,0.24658550349113284,1.3668950945234997,1.1203095910323668,15.57738511398145,4.32214765100671,100.00000000000001,0,0,7298318061
1363008600,155.325,156.03999,155.13,156.03,NaN,NaN,150.90658131578945,156.18947368421055,142.10879535000026,145.66928049999996,149.70853700000004,152.49234900000016,150.03941317916738,152.6895445180244,152.68584538461565,156.8959920880458,148.4756986811855,142.10879535000026,145.66928049999996,149.70853700000004,152.49234900000016,155.73333,83746688,127601331.2,69.2148654963303,1.5374753014974996,1.5,2.75,NaN,NaN,1.3445670308330757,0.6563151591948282,538.898358359353,0.2999367949277485,1.4952305846920524,1.195293789764304,7.423034070989763,4.0061325156645715,100,0,0,7382064749
1363095000,155.92,156.10001,155.21001,155.67999,NaN,NaN,151.1484236842105,156.25736842105266,142.22619530000026,145.79718039999997,149.99090480000004,152.68784850000017,150.26061227018042,152.97434884964113,153.09046000000023,157.36236886712703,148.81855113287344,142.22619530000026,145.79718039999997,149.99090480000004,152.68784850000017,155.66333666666665,105755680,129200368,66.97715741341926,1.2092476691690297,1.5,2.75,NaN,NaN,1.3120979572021407,0.8185400834152423,536.5297034001431,0.2844190825691748,1.5508176429757725,1.2663985604065977,8.214035590453083,2.481726021986707,74.64627012826864,5.361330267828188,19.992399603903173,7276309069
1363181400,155.75999,156.12,155.23,155.905,NaN,NaN,151.39026605263157,156.32526315789477,142.34437030000024,145.9154304,150.30840480000003,152.88209850000018,150.48196080860473,153.25345848300864,153.39930615384642,157.85594964217867,148.94266266551418,142.34437030000024,145.9154304,150.30840480000003,152.88209850000018,155.75166666666667,92550880,130558281.6,67.70011216422316,1.1713525643934783,1.5,2.75,NaN,NaN,1.2819481031162745,0.7088855556750833,538.5579844582396,0.2625972613969243,1.594645137152753,1.3320478757558287,6.040366658970943,2.832926587955931,74.58270681845573,5.386518665887,20.03077451565725,7368859949
1363267800,156.31,156.8,155.90781,156.73,NaN,NaN,151.63210842105264,156.39315789473687,142.46537030000025,146.02733049999998,150.59480480000002,153.1110485000002,150.7269819533653,153.58455767510307,153.99392153846182,157.98212264751328,150.00572042941036,142.46537030000025,146.02733049999998,150.59480480000002,153.1110485000002,156.47927,126329872,132758647.2,70.27007742083222,1.361562677353814,1.5,2.75,NaN,NaN,1.2543089528936842,0.9515754692022803,542.0201863739666,0.2756595307131344,1.6766222891472466,1.4009627584341122,5.436767998375835,3.0372756557754097,76.8480947255879,4.522059276949267,18.62984599746282,7495189821
1363354200,155.85001,156.03999,155.31,155.83,NaN,NaN,151.87395078947367,156.46105263157898,142.58402025000026,146.1236305,150.7902048,153.28804900000017,150.9271003081353,153.79840932509325,154.4408446153849,157.8001572706481,151.08153196012168,142.58402025000026,146.1236305,150.7902048,153.28804900000017,155.72666333333333,138601056,135646990.4,64.26303480049405,0.6860414715742226,1.5,2.75,NaN,NaN,1.2661440276869915,1.0217775978021255,540.3535197072999,0.1991879724722534,1.649947724024429,1.4507597515521755,7.527429188661613,1.902955793879169,41.5027201958614,25.79718428223122,32.70009552190738,7356588765
1363613400,154.34,155.64,154.2,154.97,NaN,NaN,152.11579315789473,156.5289473684211,142.69037025000026,146.2151304,150.97492280000003,153.43104900000017,151.08564539409076,153.90998938937008,154.67622923076948,157.70586459634487,151.6465938651941,142.69037025000026,146.2151304,150.97492280000003,153.43104900000017,154.93666666666664,126704256,131220881.6,59.06695855189745,0.29272110283452835,1.5,2.75,NaN,NaN,1.2921337399950654,0.9655799782402925,537.6947670829963,0.07270582799519132,1.5416420365461647,1.4689362085509734,8.507713155601056,0.4407350081492714,19.107644356861698,50.0460793128059,30.846276330332405,7229884509
1363699800,155.3,155.50999,153.59,154.61,NaN,NaN,152.3576355263158,156.5968421052632,142.80462030000027,146.32733439999998,151.13972280000002,153.49904900000018,151.22385537863622,153.97665706657293,154.90699846153868,157.37158211370374,152.44241480937362,142.80462030000027,146.32733439999998,151.13972280000002,153.49904900000018,154.56999666666667,167567248,134843975.2,56.98965923941846,0.24763976800834278,1.5,2.75,NaN,NaN,1.3369806157097024,1.2426750824533688,535.4924955284419,-0.046748459433378464,1.4105006342592503,1.4572490936926288,7.1858458027217305,0.07119741100324507,15.56355320508566,55.1992832626978,29.23716353221654,7062317261
1363786200,155.52,155.95,155.25999,155.69,NaN,NaN,152.59947789473682,156.6647368421053,142.92572030000028,146.4501344,151.33413280000002,153.71654900000016,151.3989983049642,154.13983258404218,155.1823830769233,157.06714586325765,153.29762029058892,142.92572030000028,146.4501344,151.33413280000002,153.71654900000016,155.63332999999997,113759248,132503196.8,61.377953019689635,0.5409992799482414,1.5,2.75,NaN,NaN,1.3371962860161504,0.8585396484562401,539.5720613316686,-0.06353184598757844,1.3778342862081558,1.4413661321957343,8.164275496909184,0.5905308316534781,17.644736807349027,52.10865587804595,30.24660731460502,7176076509
1363872600,154.75999,155.6389,154.10001,154.35899,NaN,NaN,152.84132026315788,156.7326315789474,143.05671525000028,146.5795243,151.5103204,153.91349850000017,151.5150764106519,154.16070471889532,155.29307461538485,156.7549374867767,153.831211743993,143.05671525000028,146.5795243,151.5103204,153.91349850000017,154.69930000000002,128604944,129770596.8,54.057751534334855,0.10120059122944185,1.5,2.75,NaN,NaN,1.3552529798721396,0.9910175892787448,536.6711831302229,-0.1688035117960982,1.2303617424506115,1.3991652542467097,9.709916159404187,-0.6954516212043181,3.578820155444659,79.58653789667696,16.834641947878374,7047471565
1363959000,154.85001,155.60001,154.73,155.60001,NaN,NaN,153.08316263157894,156.8005263157895,143.19421525000027,146.72532439999998,151.7039206,154.0989990000002,151.67526988474398,154.29778141233385,155.39384538461562,156.7413683302899,154.04632243894133,143.19421525000027,146.72532439999998,151.7039206,154.0989990000002,155.31000666666668,111163504,130010947.2,58.971151399208196,0.2738912797816727,1.5,2.75,NaN,NaN,1.3470934813098432,0.8550318753465708,539.332077179759,-0.15949371884570285,1.199798105689581,1.3592918245352839,10.546344585756446,-0.2755816189194409,16.651794491480818,53.55889423599095,29.78931127252823,7158635069
1364218200,156.00999,156.27,154.35001,154.95,NaN,NaN,153.32500499999998,156.86842105263162,143.3236152000003,146.8605245,151.8613206,154.39649900000018,151.80369067357756,154.35989746830205,155.428460769231,156.703531931087,154.153389607375,143.3236152000003,146.8605245,151.8613206,154.39649900000018,155.19000333333332,151322256,125285822.4,55.61612070926585,0.20388879391363676,1.5,2.75,NaN,NaN,1.3880146612162838,1.20781628041578,536.96516511395,-0.19917212044874222,1.110326673974356,1.3094987944230982,10.519539678450338,-0.468904192504133,14.991350976644974,56.044220258305614,28.964428765049416,7007312813
1364304600,155.59,156.23,155.42,156.19,NaN,NaN,153.56684736842104,156.93631578947372,143.44471520000027,147.00892439999998,152.04372039999998,154.70499900000019,151.9757028040255,154.53419294751137,155.53723000000025,156.812353918277,154.2621060817235,143.44471520000027,147.00892439999998,152.04372039999998,154.70499900000019,155.94666666666666,86856560,120298840.8,60.260863279844166,0.6041139377853807,1.5,2.75,NaN,NaN,1.3802993282722635,0.7220066246889388,540.4466133654267,-0.1464053896184443,1.1264920574000428,1.272897447018487,11.549014569991932,0.18280363041595624,38.0039518510067,28.88709348084034,33.10895466815297,7094169373
1364391000,155.25999,156.245,155,156.19,NaN,NaN,153.8086897368421,157.00421052631583,143.56541520000027,147.1573243,152.22812039999997,154.91899900000018,152.1409693607304,154.6918888572722,155.59492230769254,156.9143270734766,154.27551754190847,143.56541520000027,147.1573243,152.22812039999997,154.91899900000018,155.81166666666667,99950560,117757275.2,60.26086327984417,0.5131018915436822,1.5,2.75,NaN,NaN,1.370635090538531,0.8487845853281089,540.7668696730369,-0.11726217559798369,1.1263197275210075,1.2435819031189912,11.527664651724912,-0.34454156830217064,23.507504059335957,44.26031587316756,32.23218006749647,7094169373
1364477400,156.09,156.85001,155.75,156.67,NaN,NaN,154.05053210526316,157.07210526315794,143.68326515000027,147.2957243,152.42012019999996,155.1719990000002,152.31857840540764,154.88028039467486,155.64415307692332,157.06841383478016,154.21989231906647,143.68326515000027,147.2957243,152.42012019999996,155.1719990000002,156.42333666666664,102932816,116560619.2,62.04408276255791,0.7362905086779437,1.5,2.75,NaN,NaN,1.3513047269286356,0.883083984166069,543.8913696330305,-0.07355371683580447,1.1516397570742356,1.22519347391004,11.23713615210026,0.5390489636141789,57.94157296769645,13.801097422505329,28.257329609798223,7197102189
1364823000,156.59,156.91,155.67,156.05,NaN,NaN,154.2923744736842,157.14000000000004,143.80644020000025,147.4406243,152.60012019999996,155.3689990000002,152.4649086640191,154.99168226184867,155.6726153846156,157.11329704988665,154.23193371934454,143.80644020000025,147.4406243,152.60012019999996,155.3689990000002,156.21,99194064,112988584.8,58.39884575326283,0.43650065404042016,1.5,2.75,NaN,NaN,1.3433543892908766,0.8779122614517427,540.3184216279781,-0.09303910087868483,1.108894597811684,1.2019336986903688,10.947125458805138,0.6969090791766229,25.63321436550038,41.706852365544165,32.65993326895546,7097908125
1364909400,156.61,157.21001,156.37,156.82001,NaN,NaN,154.53421684210525,157.20789473684215,143.92594025000025,147.5903384,152.77652039999998,155.5639995000002,152.63569695170463,155.16580871310117,155.74300076923097,157.3063984852744,154.17960305318755,143.92594025000025,147.5903384,152.77652039999998,155.5639995000002,156.8000066666667,101504320,113113291.2,61.42971764295262,0.6929684447473288,1.5,2.75,NaN,NaN,1.3302583614843855,0.8973686374355978,539.6178927272604,-0.062192459480025386,1.1241931243403371,1.1863855838203625,10.603615518664064,1.4294094819222447,69.49879135350066,7.577988024769859,22.923220621729484,7199412445
1364995800,156.91,157.03,154.82001,155.23,NaN,NaN,154.7760592105263,157.27578947368426,144.04174020000025,147.7130383,152.91452039999996,155.6110000000002,152.7374343261476,155.1719221689963,155.62761615384636,157.10145110389197,154.15378120380075,144.04174020000025,147.7130383,152.91452039999996,155.6110000000002,155.69333666666668,154167312,114738504,52.86490564473119,0.22620109462048807,1.5,2.75,NaN,NaN,1.3930963356640726,1.343640596882804,534.5929549166999,-0.15188492530935083,0.996529427183674,1.1484143524930248,12.366259167255068,-0.2954589247864397,27.569068314072847,39.477753257471775,32.95317842845538,7045245133
1365082200,155.42999,156.17,155.09,155.86,NaN,NaN,155.01790157894737,157.34368421052636,144.15369020000026,147.8744383,153.04912039999996,155.6790000000002,152.85988788198495,155.23745339099665,155.62992384615407,157.10511244374032,154.15473524856782,144.15369020000026,147.8744383,153.04912039999996,155.6790000000002,155.70666666666668,131884944,116609257.6,55.511644222881685,0.03863311486540009,1.5,2.75,NaN,NaN,1.3707323116880663,1.1309989165045504,536.9673876983306,-0.17040511273025127,0.9354079615802107,1.105813074310462,11.906586652709057,0.9724150177453272,44.25491576729699,23.51932152662132,32.22576270608168,7177130077
1365168600,153.95,155.35001,153.77,155.158,NaN,NaN,155.2597439473684,157.41157894736847,144.25878020000025,148.0456184,153.16488039999996,155.6981000000002,152.95000992582868,155.2298864013779,155.6443853846156,157.09692516663512,154.19184560259606,144.25878020000025,148.0456184,153.16488039999996,155.6981000000002,154.75933666666666,159665936,120287488.8,52.007258714789835,0.5425879157693108,1.5,2.75,NaN,NaN,1.422108575138919,1.3273694346173766,535.1274034134318,-0.2279617765369386,0.8208608536392887,1.0488226301762273,11.016744766771774,-0.28406810513701797,17.724570400923593,51.96168848427885,30.31374111479755,7017464141
1365427800,155.27,156.22,154.75,156.21001,NaN,NaN,155.50158631578947,157.47947368421057,144.36783030000024,148.2261185,153.30088059999997,155.73660050000018,153.07785306599226,155.3232315060086,155.76746307692326,157.1159820312105,154.41894412263602,144.36783030000024,148.2261185,153.30088059999997,155.73660050000018,155.72667,86571120,118441663.2,56.44473350945717,0.05310933391562675,1.5,2.75,NaN,NaN,1.4255293912004248,0.7309178008908608,538.3091814289769,-0.1945121405419472,0.8056824544987933,1.0001945950407405,10.725884173163639,0.8131719909648419,34.201311143309894,32.47282716452851,33.3258616921616,7104035261
1365514200,156.5,157.32001,155.98,156.75,NaN,NaN,155.74342868421053,157.54736842105268,144.47308030000025,148.41096850000002,153.43088059999997,155.77260050000018,153.22185882811021,155.45911421972207,155.84900153846172,157.29368233477123,154.4043207421522,144.47308030000025,148.41096850000002,153.43088059999997,155.77260050000018,156.68333666666666,101922128,119350435.2,58.56262223967946,0.716769880248219,1.5,2.75,NaN,NaN,1.4194208632575376,0.8539736602485384,540.426362606947,-0.13800759182190758,0.827685105263356,0.9656926970852636,10.425194085952757,0.35853767846853335,34.24054436744335,32.434281344005996,33.325174288550656,7205957389
1365600600,157.17,158.87,157.13,158.67,NaN,NaN,155.98527105263156,157.6152631578948,144.58903030000022,148.61976860000001,153.60288039999995,155.92210100000017,153.4355114230863,155.76491286546283,156.1806176923079,158.02797595919242,154.33325942542336,144.58903030000022,148.61976860000001,153.60288039999995,155.92210100000017,158.22333333333333,135711008,120848201.6,65.06690892390901,1.5219302018504044,1.5,2.75,NaN,NaN,1.4694622301677138,1.1229874024041746,544.6427328205049,0.0183688291959323,0.988653733580179,0.9702849043842467,11.63636013852997,1.5878097189320635,68.21499306227508,8.173050570108833,23.61195636761608,7341668397
1365687000,158.7,159.71001,158.53999,159.19,NaN,NaN,156.22711342105262,157.6831578947369,144.72278030000024,148.85236960000003,153.77348039999995,156.08635100000018,153.66117764178878,156.09111164018066,156.45677076923096,158.86312585762045,154.05041568084147,144.72278030000024,148.85236960000003,153.77348039999995,156.08635100000018,159.14666666666665,110142496,121727782.4,66.5961997617249,1.6434524542893378,1.5,2.75,NaN,NaN,1.4480734994414501,0.9048262757146884,547.3507456220502,0.13975889891869153,1.1449835280326113,1.0052246291139197,11.625785667608906,1.6084764153954239,67.02398230495481,8.753812156262404,24.222205538782788,7451810893
1365773400,158.67999,159.03999,157.92,158.8,NaN,NaN,156.46895578947368,157.751052631579,144.84948025000023,149.08336960000003,153.94808019999994,156.18985100000017,153.86270008720882,156.3491010077825,156.7529246153848,159.28878698767713,154.2170622430925,144.84948025000023,149.08336960000003,153.94808019999994,156.18985100000017,158.58666333333332,116359808,121229279.2,64.32184853047227,1.0353542074600266,1.5,2.75,NaN,NaN,1.4353539637670616,0.9598325484393377,545.2294252784906,0.17446412053049487,1.2233047797770382,1.0488406592465433,11.852170842717873,1.762255687279718,74.50355189797826,5.413499143770551,20.082948958251198,7335451085
1366032600,158,158.13,155.10001,155.118,NaN,NaN,156.71079815789471,157.81894736842108,144.96847020000024,149.27084960000002,154.05644019999997,156.1542510000002,153.91192753476926,156.2318532927556,156.67046307692328,159.34036016584403,154.00056598800253,144.96847020000024,149.27084960000002,154.05644019999997,156.1542510000002,156.11600333333334,217258944,125162173.6,47.74392685253084,0.48183476509481044,1.5,2.75,NaN,NaN,1.597113680640844,1.7358195191969725,539.4628204417357,-0.057467734662537406,0.9770059909183715,1.0344737255809089,18.465024771150063,-1.0853270574335516,33.949096758369734,32.76364973170755,33.28725350992271,7118192141
1366119000,156.28999,157.49001,155.91,157.41,NaN,NaN,156.95264052631578,157.88684210526318,145.09562020000024,149.45364960000003,154.17983999999996,156.27625100000017,154.04910684713124,156.3440577410646,156.7643092307694,159.4457965790732,154.08282188246562,145.09562020000024,149.45364960000003,154.17983999999996,156.27625100000017,156.93667000000002,147507808,126202351.2,55.442464543168,0.17201214143265361,1.5,2.75,NaN,NaN,1.6524634177379276,1.168819808802421,544.1167532849438,-0.06298658864127415,0.9557404897793162,1.0187270784205904,20.283884292742677,1.4043677124267262,38.16545586809982,28.76466528597402,33.069878845926155,7265699949
1366205400,156.28999,156.32001,154.28,155.11,NaN,NaN,157.19448289473684,157.9547368421053,145.20530520000023,149.61284960000003,154.29133999999993,156.30125100000018,154.0907105001849,156.22652843239177,156.6443092307694,159.4678019721665,153.8208164893723,145.20530520000023,149.61284960000003,154.29133999999993,156.30125100000018,155.23667000000003,226834752,129165726.4,47.82781506030864,0.9391153838041366,1.5,2.75,NaN,NaN,1.7580017450423608,1.756152799369849,540.067985155687,-0.21921200543690222,0.7447120716244626,0.9639240770613648,21.28621265961233,-0.48120107789041444,12.265791310165993,60.53691747371045,27.19729121612356,7038865197
1366291800,155.37,155.41,153.55,154.14,NaN,NaN,153.55,158.0226315789474,145.31205525000024,149.75974960000002,154.35313999999994,156.22375100000016,154.0926434217463,156.02781143883064,156.49738615384632,159.61295992650392,153.38181238118872,145.31205525000024,149.75974960000002,154.35313999999994,156.22375100000016,154.36666666666667,167583120,131856920,45.0195559409155,1.3349718517808613,1.5,2.75,NaN,NaN,1.7652873346821913,1.2709467201266342,538.4068833348285,-0.37633066025628137,0.4935107517410131,0.8698414119972945,21.377708896763796,-0.6561053893450552,3.1679870388524964,80.85776977792727,15.97424318322022,6871282077
1366378200,154.5,155.55,154.12,155.48,NaN,NaN,153.6838888888889,158.0905263157895,145.40893025000022,149.9010495,154.43953999999994,156.27980150000016,154.14704956206995,155.97563892084676,156.39430846153863,159.54879064912336,153.2398262739539,145.40893025000022,149.9010495,154.43953999999994,156.27980150000016,155.04999999999998,149687568,132911051.2,49.436402850589545,0.6831550897114003,1.5,2.75,NaN,NaN,1.7413382393477497,1.1262236409127129,541.9712573198029,-0.3774962227347447,0.3979711335788636,0.7754673563136083,21.937483760378466,-0.46732600554856973,13.219797541649578,58.92377606185472,27.85642639649571,7020969645
1366637400,155.78,156.53999,154.75,156.17,NaN,NaN,153.8177777777778,158.1584210526316,145.50723030000023,150.05224950000002,154.54373979999994,156.30830100000017,154.2263809517927,155.99414949981374,156.46661615384633,159.55339659979325,153.37983570789942,145.50723030000023,150.05224950000002,154.54373979999994,156.30830100000017,155.81999666666664,106553440,132680548,51.592867942210916,0.23595793195178125,1.5,2.75,NaN,NaN,1.7448133651086237,0.8030826040905409,543.2541892731376,-0.3214733987664854,0.3736256078555016,0.695099006621987,21.72320944082103,-0.37001594896332535,33.695125243105345,32.991312540859944,33.313562216034704,7127523085
1366723800,156.95,157.92999,156.17,157.78,NaN,NaN,153.95166666666668,158.22631578947372,145.6090703000002,150.2267495,154.66333979999993,156.44980100000018,154.3657385615263,156.1642304998315,156.61430846153866,159.75413298791025,153.47448393516706,145.6090703000002,150.2267495,154.66333979999993,156.44980100000018,157.29333,166141248,133421497.6,56.27842992975838,0.8305967868820276,1.5,2.75,NaN,NaN,1.7458974104580087,1.2452359701289997,547.8725346396136,-0.1730978574869252,0.47872668476333047,0.6518245422502557,22.458504388873944,-0.5609125858700362,35.256616300966755,31.464513944812303,33.27886975422095,7293664333
1366810200,157.83,158.3,157.53999,157.88,NaN,NaN,154.08555555555557,158.29421052631582,145.7145203500002,150.3909494,154.78553979999992,156.5343010000002,154.5035527355841,156.32763711889515,156.82369307692326,159.90970691086258,153.73767924298394,145.7145203500002,150.3909494,154.78553979999992,156.5343010000002,157.90666333333334,96781184,133917728.8,56.55968741133699,0.9244003892956527,1.5,2.75,NaN,NaN,1.675476881139581,0.7226913483915058,550.5197505238937,-0.07058566055228743,0.5635924665598964,0.6341781271121838,21.238844291479708,-0.8229160123123326,69.92298950030353,7.379850570661778,22.6971599290347,7390445517
1366896600,158.34,159.27,158.10001,158.52,NaN,NaN,154.21944444444446,158.36210526315793,145.8296703000002,150.5549494,154.91553979999992,156.65080100000017,154.66106047144353,156.5364335837623,157.0013846153848,160.18990725746914,153.81286197330047,145.8296703000002,150.5549494,154.91553979999992,156.65080100000017,158.63000333333332,131060560,135473228.8,58.4039594610715,1.1779107848682338,1.5,2.75,NaN,NaN,1.6550856753438978,0.9674277431852276,553.4170304153143,0.03242883937087593,0.6747141763257787,0.6422853369549028,21.293539132757758,-0.17632241813602084,99.99999999999999,0,0,7521506077
1366983000,158.33,158.60001,157.73,158.24001,NaN,NaN,154.35333333333335,158.43000000000004,145.94427030000023,150.7157995,155.03731999999994,156.7293015000002,154.8014114333477,156.6986789567373,157.116000769231,160.36665364946234,153.86534788899965,145.94427030000023,150.7157995,155.03731999999994,156.7293015000002,158.19000666666668,95918752,135122525.6,57.25865638924763,0.8051866402255543,1.5,2.75,NaN,NaN,1.5990088413907628,0.7098650027009265,551.0087114995558,0.0715724583464149,0.7317509098879214,0.6601784515415065,21.273297915432988,2.012667775499953,80.93539994465785,3.1389289649103733,15.925671090431797,7425587325
1367242200,158.67,159.64999,158.42,159.3,NaN,NaN,154.48722222222224,158.49789473684214,146.07007030000022,150.8942995,155.17752019999995,156.89180150000018,154.97782667125566,156.94642381800043,157.16446230769253,160.52332322916467,153.8056013862204,146.07007030000022,150.8942995,155.17752019999995,156.89180150000018,159.12332999999998,88572688,134591456.8,60.42287383731613,1.2799308410004984,1.5,2.75,NaN,NaN,1.5855067812914219,0.6580855137902036,554.9443347583018,0.1539823383923179,0.8526563745319038,0.6986740361395859,15.57465632215404,1.200686106346493,81.26127120948262,3.0396564600108635,15.699072330506528,7514160013
1367328600,159.27,159.72,158.61,159.67999,NaN,NaN,154.62111111111113,158.56578947368425,146.19767025000021,151.07859939999997,155.32891999999995,157.0348005000002,155.1622252331672,157.20676345438133,157.20215384615406,160.660607697791,153.74369999451713,146.19767025000021,151.07859939999997,155.32891999999995,157.0348005000002,159.33666333333335,116010624,135316772,61.522586200090494,1.1579408528046888,1.5,2.75,NaN,NaN,1.5515420111991765,0.8573262743808284,558.1000855226363,0.21544364228986423,0.9679785890019161,0.7525349467120519,13.581755425313496,2.9462897298691186,79.29787084446048,3.667463705790037,17.034665449749497,7630170637
1367415000,159.33,159.41,158.10001,158.28,NaN,NaN,154.75500000000002,158.63368421052635,146.32152030000023,151.2463994,155.42951999999994,157.1873005000002,155.28449091029788,157.30897645872597,157.1621538461541,160.55720793624428,153.7670997560639,146.32152030000023,151.2463994,155.42951999999994,157.1873005000002,158.59667,138874128,134552112.8,55.413352649235755,0.5130882916561589,1.5,2.75,NaN,NaN,1.5535732961135214,1.0321214963485879,554.5204590770143,0.14646767650594494,0.9356195423444831,0.7891518658385381,11.23530126711583,2.685869988322314,46.841185219271715,21.476553765473994,31.682261015254298,7491296509
1367501400,158.67999,159.89,158.53,159.75,NaN,NaN,154.8888888888889,158.70157894736846,146.44152030000024,151.4240994,155.59771999999992,157.3818005000002,155.4596089138156,157.54145489122826,157.51846153846176,160.95262207550272,154.0843010014208,146.44152030000024,151.4240994,155.59771999999992,157.3818005000002,159.39,96407568,132778244,59.91443760720973,1.0502257138449336,1.5,2.75,NaN,NaN,1.5576037749625544,0.7260795526110437,558.7321851321651,0.18217421869723793,1.0168696392100856,0.8346954205128476,10.552441029946765,2.74633393362491,43.12401392706285,24.444354013426477,32.43163205951067,7587704077
1367587800,161.14,161.88,159.782,161.368,NaN,NaN,155.0227777777778,158.76947368421057,146.57121035000023,151.6136295,155.81667999999993,157.6923005000002,155.69131052503852,157.90588775873033,157.8229230769233,161.82026312032673,153.82558303351988,146.57121035000023,151.6136295,155.81667999999993,157.6923005000002,161.01000000000002,144202256,132005060,64.19853255117889,1.829163342926459,1.5,2.75,NaN,NaN,1.5984892196080858,1.0923994580207759,562.5153716197705,0.29065173525682153,1.1980100895838746,0.907358354327053,10.830074409508967,3.3284241531664263,71.95784956810253,6.477121539073319,21.565028892824152,7731906333
1367847000,161.49001,162.00999,161.42,161.78,NaN,NaN,155.1566666666667,158.83736842105267,146.6983103500002,151.8066994,156.01447999999993,157.9708000000002,155.93008266131153,158.27485082932745,158.33600000000024,162.5168040154314,154.15519598456908,146.6983103500002,151.8066994,156.01447999999993,157.9708000000002,161.73666333333333,66882064,131020607.2,65.21789891973589,1.7637483550995967,1.5,2.75,NaN,NaN,1.5301678467789361,0.510469806462628,564.899962676913,0.3614275614122039,1.3591428060923079,0.997715244680104,10.838562203397204,2.535175560907593,70.73597615454145,7.013387241085533,22.25063660437303,7798788397
1367933400,162.13,162.64999,161.67,162.5999,NaN,NaN,155.29055555555558,158.90526315789478,146.8244598500002,151.9982984,156.28647799999993,158.2632950000002,156.19164412557382,158.68676027415341,158.9867615384618,162.98199704209776,154.99152603482582,146.8244598500002,151.9982984,156.28647799999993,158.2632950000002,162.30662999999998,90359184,130442460,67.21826621642336,1.8624863526695759,1.5,2.75,NaN,NaN,1.4908694291518703,0.692712970914532,569.132147975912,0.43006997121627055,1.535302708700442,1.1052327374841715,10.040835413200801,2.9895490245756244,69.21937236821734,7.707021611206054,23.0736060205766,7889147581
1368019800,162.42,163.39,162.33,163.34,NaN,NaN,155.42444444444448,158.9731578947369,146.9525098500002,152.1965985,156.55287799999994,158.4967950000002,156.47197180692388,159.12992596232928,159.5913769230772,163.65915759045694,155.52359625569747,146.9525098500002,152.1965985,156.55287799999994,158.4967950000002,163.02,97419184,128527868.8,68.95396468874995,1.8939006053938223,1.5,2.75,NaN,NaN,1.4600930413553062,0.7579615604736457,571.9293897251193,0.4877039824030711,1.7148627154880103,1.2271587330849392,9.95280092850702,3.0406257885440278,99.99999999999999,0,0,7986566765
1368106200,163.27,163.7,162.47,162.881,NaN,NaN,155.55833333333337,159.041052631579,147.08456485000022,152.3991085,156.77229799999995,158.6813450000002,156.72330624586803,159.4871711087741,160.10760769230794,164.00745399339547,156.2077613912204,147.08456485000022,152.3991085,156.77229799999995,158.6813450000002,163.01699999999997,106738560,128357672,66.59882907192454,1.5720787875364892,1.5,2.75,NaN,NaN,1.4436578241156408,0.831571329838391,569.1408953402264,0.45778153579055525,1.7993856528231333,1.341604117032578,10.549041175745716,2.9328802494388033,75.18082908592422,5.154211895015959,19.66495901905982,7879828205
1368192600,162.99001,163.5498,162.50999,163.41,NaN,NaN,155.69222222222226,159.1089473684211,147.22616485000023,152.6121575,157.00829799999994,158.91184500000017,156.9855295303438,159.86077386031943,160.54068461538483,164.5590431825714,156.52232604819827,147.22616485000023,152.6121575,157.00829799999994,158.91184500000017,163.15659666666667,103202880,127699825.6,67.95718928494404,1.3902369350270103,1.5,2.75,NaN,NaN,1.4148115509645247,0.808167744279206,571.8615889857961,0.43655745690789116,1.8873009381674422,1.450743481259551,10.15561734179604,2.580037664783418,72.73973981105203,6.143055187848161,21.117205001099784,7983031085
1368451800,163.2,163.81,162.82001,163.53999,NaN,NaN,155.82611111111115,159.1768421052632,147.37423980000023,152.80985739999997,157.23689779999995,159.3329445000002,157.2425671958205,160.21117539743187,160.9760684615387,164.9734037304532,156.97873319262416,147.37423980000023,152.80985739999997,157.23689779999995,159.3329445000002,163.39,81843184,120929037.6,68.29836170965045,1.3744961595271175,1.5,2.75,NaN,NaN,1.384467154467059,0.6767868629759112,568.7531327773222,0.39543905889844355,1.9450423048826053,1.5496032459841618,9.981898067455045,2.4173348207248666,74.89119866537821,5.312175887729106,19.796625446892683,8064874269
1368538200,163.67,165.35001,163.67,165.23,NaN,NaN,155.96000000000004,159.2447368421053,147.53058975000025,153.00845739999997,157.48309779999994,159.7239445000002,157.55579985480793,160.68915869291456,161.49222230769254,165.80788284213878,157.1765617732463,147.53058975000025,153.00845739999997,157.48309779999994,159.7239445000002,164.75000333333332,119000816,119503688,72.41118770728393,1.954832921007518,1.5,2.75,NaN,NaN,1.414863786290841,0.9957919959758899,572.4840843985577,0.4426623277504267,2.102931155672195,1.6602688279217683,10.896003268626524,4.390952741976237,76.62811542732874,4.645558355426591,18.72632621724467,8183875085
1368624600,164.96001,166.45,164.91,166.11501,NaN,NaN,156.0938888888889,159.31263157894742,147.68031480000025,153.22670759999997,157.71959819999995,160.2741950000002,157.8914551546194,161.2059064364465,162.09799153846177,166.62326611472415,157.5727169621994,147.68031480000025,153.22670759999997,157.71959819999995,160.2741950000002,165.82500333333334,120718432,114197872,74.29210110448821,2.050479101889612,1.5,2.75,NaN,NaN,1.4238020872700663,1.0570987872698714,574.3350920992971,0.49039878378310986,2.2732673076506558,1.782868523867546,7.631501677379898,3.9843568075117446,77.90725514313793,4.1805971205829575,17.91214773627912,8304593517
1368711000,165.78,166.36,165.09,165.34,NaN,NaN,156.2277777777778,159.38052631578952,147.81363980000026,153.42890759999997,157.93639819999996,160.8341950000002,158.18355495247746,161.5996296329754,162.56260692307717,167.08364978309191,158.04156406306242,147.81363980000026,153.42890759999997,157.93639819999996,160.8341950000002,165.5966666666667,109913568,111314394.4,69.80402636069326,1.686416713177349,1.5,2.75,NaN,NaN,1.4128162238936337,0.9874155862092171,572.2583052835018,0.4288981553762734,2.3189912180878878,1.8900930627116144,8.778054882707966,2.4614545634822322,76.98456565496964,4.513765818121112,18.50166852690925,8194679949
1368797400,165.95,167.03999,165.73,166.94,NaN,NaN,156.36166666666668,159.44842105263163,147.95493985000024,153.67040769999997,158.17967819999996,161.4071950000002,158.5269449543411,162.1082363345968,163.12106923076948,167.86779573511672,158.37434272642224,147.95493985000024,153.67040769999997,158.17967819999996,161.4071950000002,166.56999666666667,129801008,110320066.4,73.37948132901936,1.9412946852320316,1.5,2.75,NaN,NaN,1.433328636472659,1.1765856587628014,576.1745635297983,0.4527438473731418,2.4560228719280417,2.0032790245549,8.657622564973579,3.1895166275188505,78.35607945268488,4.022716060966556,17.62120448634856,8324480957
1369056600,166.78,167.58,166.61,166.92999,NaN,NaN,156.49555555555557,159.51631578947374,148.10103975000027,153.91620749999998,158.40947799999995,161.9451945000002,158.85647613260224,162.5674509693971,163.7864530769233,168.03066916516087,159.54223698868572,148.10103975000027,153.91620749999998,158.40947799999995,161.9451945000002,167.03999666666667,85071184,109245953.6,73.32098759320724,1.8579410338967948,1.5,2.75,NaN,NaN,1.4002337338674689,0.7787124483482929,578.3292925482267,0.4250539572565226,2.5345964711255533,2.1095425138690307,8.877020256505604,2.663033618101864,57.1425439164073,14.34290604133808,28.51455004225462,8239409773
1369143000,167.08,167.8,166.5,167.17,NaN,NaN,156.62944444444446,159.58421052631584,148.24893975000023,154.17040749999998,158.63227799999996,162.4146945000002,159.18249667642175,163.00578897231165,164.35722230769255,168.25845610890158,160.45598850648352,148.24893975000023,154.17040749999998,158.63227799999996,162.4146945000002,167.15666666666667,95804192,105729100.8,73.85905410426582,1.7805753453998552,1.5,2.75,NaN,NaN,1.3930741814483647,0.9061288829196209,579.7553407400414,0.38150102083613957,2.5864187899142053,2.2049177690780657,8.833292176798679,2.3448022529692567,55.1195462501401,15.63807758749816,29.24237616236175,8335213965
1369229400,167.34,169.07001,165.17,165.92999,NaN,NaN,156.76333333333335,169.07001,148.39538970000024,154.4140914,158.83727799999994,162.8171940000002,159.44710425773854,163.28428430828197,164.70814461538487,168.27728697988454,161.1390022508852,148.39538970000024,154.4140914,158.83727799999994,162.8171940000002,166.72333333333333,244031744,113091628.8,66.40723744048807,1.2683750057327396,1.5,2.75,NaN,NaN,1.572141025630625,2.1578232322709283,575.3551764495709,0.23496761440617275,2.4986272870857817,2.263659672679609,10.475805900278043,1.8719126233262342,16.120266727276793,54.387705132406396,29.492028140316798,8091182221
1369315800,164.16,165.91,163.94,165.45,NaN,NaN,156.89722222222224,169.19330417647058,148.52589470000026,154.6682914,159.02817799999994,163.1636940000002,159.68251193390566,163.49054294558846,164.99045230769252,168.14499848989797,161.83590612548707,148.52589470000026,154.6682914,159.02817799999994,163.1636940000002,165.1,211064320,117091816.8,63.72699816440312,0.41067697086102006,1.5,2.75,NaN,NaN,1.6019873809427236,1.802553976598645,572.783274643692,0.07953672986986904,2.363080585016945,2.283543855147076,10.488573870588695,1.2483936111621028,11.971772972211031,61.09185746345554,26.936369564333436,7880117901
1369402200,164.47,165.38049,163.98,165.308,NaN,NaN,157.03111111111113,169.31659835294118,148.65433470000028,154.8972714,159.19973799999997,163.5170935000002,159.90311930904662,163.66363409362765,165.19876769230788,168.03605960587035,162.36147577874542,148.65433470000028,154.8972714,159.19973799999997,163.5170935000002,164.88949666666667,151573872,119874572.8,62.91795151088944,0.15817356601657942,1.5,2.75,NaN,NaN,1.5925597108753862,1.2644372235043326,570.5750426224149,-0.051934525868196246,2.218625697811831,2.270560223680027,10.512512235290814,1.081087261898453,1.8506261359565392,85.61231602688066,12.537057837162806,7728544029
1369747800,167.03999,167.78,165.81,166.3,NaN,NaN,157.16500000000002,169.43989252941176,148.78423465000026,155.09967139999998,159.40913799999996,163.86709350000018,160.15397737535852,163.9147165609012,165.4264600000002,168.10095253790792,162.75196746209247,148.78423465000026,155.09967139999998,159.40913799999996,163.86709350000018,166.63000000000002,143679744,122629925.6,66.15094387085301,0.9617848532505198,1.5,2.75,NaN,NaN,1.6553768743842878,1.1716531939247952,573.989772093177,-0.08900880991997573,2.1592992112800573,2.248308021200033,10.862412702478924,0.6475821582037291,9.27905980475824,66.08541020106398,24.635529994177777,7872223773
1369834200,165.42,165.8,164.34,165.22,NaN,NaN,157.2988888888889,169.56318670588234,148.90788460000027,155.29453039999999,159.61413799999997,164.14409400000017,160.35264492926603,164.03902926938682,165.60638307692327,167.85202005237156,163.36074610147497,148.90788460000027,155.29453039999999,159.61413799999997,164.14409400000017,165.12,160363312,124847560,60.01607458084221,0.19202742689643995,1.5,2.75,NaN,NaN,1.677135669071125,1.2844729364354417,568.1510300119655,-0.1970007360074657,2.002057101190701,2.1990578371981666,10.25331624338179,-0.5387893604557549,2.60861518945657,82.77278054808761,14.618604262455824,7711860461
1369920600,165.35001,166.59,165.22,165.83,NaN,NaN,157.4327777777778,169.68648088235292,149.03398460000028,155.48913039999996,159.83853799999997,164.52159400000016,160.56744316733403,164.2095979103976,165.79253692307714,167.64599865166988,163.9390751944844,149.03398460000028,155.48913039999996,159.83853799999997,164.52159400000016,165.88000000000002,107793744,123293540.8,62.15114767083321,0.6276773369610946,1.5,2.75,NaN,NaN,1.6551974069946165,0.8742854110651026,570.2232553006489,-0.2354804946278235,1.9047072189133871,2.1401877135412106,9.978192905764868,0.29635901778154655,12.500350596811684,60.20720378312062,27.29244562006768,7819654205
1370007000,165.37,166.31,163.13,163.44501,NaN,NaN,157.5666666666667,169.80977505882353,149.14700965000029,155.6638855,159.9936382,164.70634450000017,160.6802889254778,164.13678001416926,165.78523076923096,167.6745539942747,163.89590754418722,149.14700965000029,155.6638855,159.9936382,164.70634450000017,164.2950033333333,176850000,127315662.4,50.74236228358896,0.3835038345672216,1.5,2.75,NaN,NaN,1.764111877923573,1.3890671160659962,563.7634436418878,-0.41897075809978457,1.6164742659164801,2.0354450240162647,12.784318159543325,-2.093560560680485,13.886765246557982,57.902921263911644,28.210313489530357,7642804205
1370266200,163.83,164.46001,162.6599,164.35001,NaN,NaN,157.70055555555558,169.9330692352941,149.26490970000026,155.85188949999997,160.19345859999999,164.85544500000017,160.82419955585124,164.15708763186743,165.71753923076943,167.739953772515,163.69512468902386,149.26490970000026,155.85188949999997,160.19345859999999,164.85544500000017,163.82330666666667,168390688,128525084,54.17949888565178,0.6232162552130738,1.5,2.75,NaN,NaN,1.7666831723576046,1.3101776148226443,561.048491019477,-0.47281753898764345,1.4444231002817105,1.917240639269354,11.689369245554484,-1.5455461298476123,39.54903812054456,27.54587844109394,32.905083438361494,7811194893
1370352600,164.44,165.10001,162.73,163.56,NaN,NaN,157.83444444444447,170.0563634117647,149.37875975000026,156.02828949999997,160.3526584,164.94444500000014,160.93148584777865,164.10022214311815,165.52100000000019,167.82736942138268,163.2146305786177,149.37875975000026,156.02828949999997,160.3526584,164.94444500000014,163.79667,157631440,133062552.8,50.844210340299135,0.6807346547475418,1.5,2.75,NaN,NaN,1.8097779457606333,1.1846416342013844,557.6985324791033,-0.5496774909067899,1.2301437756358666,1.7798212665426565,11.783737198877853,-2.1594783753065654,15.785345970395339,54.873611287191785,29.341042742412885,7653563453
1370439000,163.09,163.42,161.13,161.272,NaN,NaN,157.96833333333336,170.1796575882353,149.48036975000025,156.17020949999997,160.4790984,164.87805000000014,160.94483934394418,163.83086765329736,165.2080769230771,168.444224852736,161.9719289934182,149.48036975000025,156.17020949999997,160.4790984,164.87805000000014,161.94066666666666,211737680,139131477.6,42.6544548050504,1.5690942448168166,1.5,2.75,NaN,NaN,1.8540795210634458,1.52185316833004,552.300326758681,-0.7312779229366029,0.8657238628719028,1.5970017858085057,13.36528945283108,-2.807202001277775,13.895827486816058,57.84069067880963,28.263481834374307,7441825773
1370525400,161.2,162.74001,160.25,162.73,NaN,NaN,158.10222222222225,170.30295176470588,149.58406970000024,156.32680939999997,160.6098984,164.84755000000013,161.01484564418166,163.72602311488808,164.88423076923092,168.2038247670256,161.56463677143626,149.58406970000024,156.32680939999997,160.6098984,164.84755000000013,161.90667,200225440,144271790.4,48.36242216924367,1.2663576270757422,1.5,2.75,NaN,NaN,1.899503126701772,1.387834998407284,555.5247899885175,-0.7282801650423527,0.6866515795055648,1.4149317445479175,14.873218610922954,-1.6440012088244176,20.341510564916963,48.38296720381163,31.275522231271417,7642051213
1370611800,163.85001,164.95,163.14,164.8,NaN,NaN,158.23611111111114,170.42624594117646,149.69716975000026,156.50510939999998,160.78209840000002,164.94350000000014,161.16328306990002,163.8283066277559,164.72038538461555,167.82308961303636,161.61768115619475,149.69716975000026,156.50510939999998,160.78209840000002,164.94350000000014,164.29666666666665,188337744,148351749.6,55.18301244542831,0.19511133391761817,1.5,2.75,NaN,NaN,1.9223957605087882,1.269535037556443,559.542894179591,-0.5690206773188065,0.7036558978994094,1.2726765752182159,17.021853226264632,-0.30730515159579774,46.37832040081692,21.87076602267081,31.750913576512264,7830388957
1370871000,165.31,165.39999,164.37,164.8,NaN,NaN,158.37000000000003,170.54954011764704,149.81021975000024,156.6824093,160.94469840000002,165.01300000000018,161.30589942010002,163.9208488536839,164.53807769230787,167.3038393184904,161.77231606612534,149.81021975000024,156.6824093,160.94469840000002,165.01300000000018,164.85666333333333,105667056,148474958.4,55.18301244542831,0.40555785290618557,1.5,2.75,NaN,NaN,1.8586524919010174,0.7116826779323078,557.4201544177772,-0.45097366101924985,0.7089594989441537,1.1599331599634035,17.020405876998396,-0.9019843656043295,34.35212177481981,32.354209600994565,33.29366862418563,7830388957
1370957400,163.3,164.53999,162.739,163.09801,NaN,NaN,158.50388888888892,170.67283429411765,149.91690985000025,156.8428894,161.08565860000002,164.99090100000018,161.3761782663706,163.84248324857114,164.32023307692327,167.05913319047116,161.5813329633754,149.91690985000025,156.8428894,161.08565860000002,164.99090100000018,163.459,159505376,152358068,49.01000411172081,0.3516583109806719,1.5,2.75,NaN,NaN,1.8731058853366596,1.0469112538234602,550.6792345992361,-0.4725352084928336,0.5692641493473616,1.0417993578401952,17.392935895458002,-1.2843420893354383,34.221668281502026,32.482250803167496,33.29608091533048,7670883581
1371043800,164.22,164.39,161.60001,161.75,NaN,NaN,158.6377777777778,170.79612847058823,150.01655980000027,156.98038939999998,161.1842584,164.81690100000017,161.3908379421992,163.6431991296596,164.03561769230788,167.0050394334887,161.06619595112707,150.01655980000027,156.98038939999998,161.1842584,164.81690100000017,162.58000333333334,177363504,155276202.4,44.74107748399921,1.048979421440157,1.5,2.75,NaN,NaN,1.9385976078126117,1.1422452459463293,545.0379083896016,-0.5568032271623602,0.3457953238872449,0.9025985510496051,17.5929687414494,-2.460350961828386,37.46141451073532,29.397498611104744,33.141086878159946,7493520077
1371130200,161.66,164.5,161.3,164.21001,NaN,NaN,158.7716666666667,170.9194226470588,150.13428490000027,157.1391895,161.36385860000001,164.72165100000018,161.50139370917177,163.69718111731106,163.95115692307712,166.83215470217783,161.0701591439764,150.13428490000027,157.1391895,161.36385860000001,164.72165100000018,163.33667,163587744,157419668,52.81788603508844,0.2690054191608849,1.5,2.75,NaN,NaN,2.0286977786831386,1.039182372052773,552.4391094933264,-0.43166897101100243,0.363012337285852,0.7946813082968545,20.016059027051792,0.46804732674311367,34.25227286055602,32.452182450793394,33.29554468865057,7657107821
1371216600,164.03,164.67,162.91,163.175,NaN,NaN,158.9055555555556,171.04271682352942,150.24260995000026,157.2796395,161.5101586,164.61340100000018,161.56702532841993,163.64744958232905,163.71077230769248,166.27139936469626,161.1501452506887,150.24260995000026,157.2796395,161.5101586,164.61340100000018,163.585,141197440,158983861.6,49.53722466769234,0.19662605876196665,1.5,2.75,NaN,NaN,2.009505080205771,0.8881243579002361,550.447323080391,-0.4039053207735229,0.28979965732995083,0.6937049781034738,18.494696727392423,-0.7149436741743953,7.7711855424539165,69.08864894073866,23.14016551680742,7515910381
1371475800,164.28999,165.22,163.21919,164.44,NaN,NaN,159.03944444444448,171.166011,150.35711000000026,157.4303395,161.6957986,164.48840100000018,161.67969100181523,163.72293057448817,163.6507723076925,166.10131951857744,161.20022509680757,150.35711000000026,157.4303395,161.6957986,164.48840100000018,164.29306333333332,136295568,159308589.6,53.35098608022626,0.33137967732386614,1.5,2.75,NaN,NaN,2.0120404316196434,0.8555443767484086,554.0339925007397,-0.29092524947849774,0.33004841625535164,0.6209736657338494,18.78247782139079,0.538028857911467,18.677192998678642,50.65054134468328,30.672265656638082,7652205949
1371562200,164.53,165.99001,164.52,165.735,NaN,NaN,159.17333333333337,171.28930517647058,150.47878505000025,157.5935895,161.8862984,164.42865150000017,161.83872272723423,163.91455623406074,163.64346461538483,166.06840666475748,161.21852256601218,150.47878505000025,157.5935895,161.8862984,164.42865150000017,165.41500333333335,114695504,160789805.6,56.938819311281264,1.0084524537026247,1.5,2.75,NaN,NaN,1.9790382579325272,0.713325720943592,558.071693616849,-0.12787817100283383,0.46112595198030704,0.5890041229831409,18.984422393127172,2.7673743737288694,41.42998126333376,25.902035519276698,32.66798321738955,7766901453
1371648600,165.60001,165.89,163.38,163.45,NaN,NaN,159.30722222222226,171.41259935294116,150.58848510000024,157.7255895,162.0202984,164.24265150000016,161.90191007126427,163.87031278319782,163.64384846153868,166.06866631175436,161.219030611323,150.58848510000024,157.7255895,162.0202984,164.24265150000016,164.23999999999998,206149440,166307068,49.67844673014474,0.29593175880883876,1.5,2.75,NaN,NaN,2.016964096651632,1.2395711287508238,552.4401498041556,-0.17017303591007915,0.37628782809554195,0.5464608640056211,18.92409931897515,0.4424506851840465,38.21307686357965,28.739209384636254,33.047713751784094,7560752013
1371735000,161.86,163.4668,158.98,159.39999,NaN,NaN,159.44111111111116,171.53589352941177,150.68303500000025,157.81888930000002,162.0348982,163.91615150000015,161.80379555866568,163.4445677562266,163.2630776923079,166.53232873907152,159.99382664554426,150.68303500000025,157.81888930000002,162.0348982,163.91615150000015,160.61559666666668,321255936,170168277.6,39.953992997971305,2.229002533124455,1.5,2.75,NaN,NaN,2.193380946890802,1.8878720554200403,543.0926902562356,-0.4512060421313753,-0.017546688658597986,0.4336593534727773,23.437150941745845,-3.2767050970873837,9.000142394467131,66.58705678033151,24.412800825201348,7239496077
1371821400,159.64,159.75999,157.47,159.07001,NaN,NaN,159.57500000000005,171.65918770588235,150.77258505000026,157.9029894,162.03249839999998,163.59715200000016,161.69658828185527,163.02794320801453,162.91769384615404,166.866555088902,158.96883260340607,150.77258505000026,157.9029894,162.03249839999998,163.59715200000016,158.76666666666665,271956736,173212898.4,39.27934436918815,2.486743842884193,1.5,2.75,NaN,NaN,2.2002815935414586,1.5700720818837126,542.5965513178788,-0.6287112618595192,-0.35222972385162166,0.2764815380078975,21.504482254423266,-3.4769356796116595,6.825724311222195,71.19132798135814,21.98294770741965,6967539341
1372080600,157.41,158.42999,155.73,157.06,NaN,NaN,155.73,171.78248188235293,150.85273505000026,157.97288930000002,161.9976984,163.18475200000017,161.51476129040998,162.45956766439411,162.59369384615405,167.583482575521,157.6039051167871,150.85273505000026,157.97288930000002,161.9976984,163.18475200000017,157.07333,222334752,176750942.4,35.362342634277084,3.0816859869114177,1.5,2.75,NaN,NaN,2.281690765431355,1.2578985378015162,535.8330390617197,-0.8378047833512576,-0.7707744411811746,0.06703034217008305,21.970739373702862,-3.7020745991934456,1.1179312206561902,88.93369159801898,9.948377181324835,6745204589
1372167000,158.48,160.10001,157.42,158.575,NaN,NaN,155.77739130434782,171.90577605882353,150.94106005000026,158.0616393,162.06683839999997,162.79850200000016,161.39947653392332,162.08960883921372,162.27407846153864,167.70112728474354,156.84702963833374,150.94106005000026,158.0616393,162.06683839999997,162.79850200000016,158.69833666666665,162262128,177680061.6,40.2026255553353,1.7679662455392195,1.5,2.75,NaN,NaN,2.3358564250434006,0.9132264281024991,540.8092984897174,-0.8288687828084205,-0.9690556363404426,-0.1401868535320221,23.078292953119504,-1.9629057187017072,1.9610867369977576,85.14624821868827,12.892665044313961,6907466717
1372253400,159.87,160.5,159.25,160.14,NaN,NaN,155.82478260869564,172.0290702352941,151.02291005000026,158.1506392,162.12143839999996,162.54450200000014,161.35008529729888,161.90393180690765,161.91561692307707,167.24262711101886,156.58860673513527,151.02291005000026,158.1506392,162.12143839999996,162.54450200000014,159.96333333333334,134847936,176404292.8,44.80098444887384,0.8042707919373772,1.5,2.75,NaN,NaN,2.3065095375403013,0.7644254788792758,546.8092984897174,-0.678664498892766,-0.9885174771479797,-0.30985297825521363,23.830370896999867,-2.4785395238694794,8.392869812236341,67.80584772213703,23.80128246562663,7042314653
1372339800,161.10001,161.82001,160.95,161.08,NaN,NaN,155.87217391304347,172.1523644117647,151.10666005000027,158.2660892,162.24083839999997,162.30700200000015,161.33949371701266,161.8254621110117,161.6294630769232,166.6994189138693,156.5595072399771,151.10666005000027,158.2660892,162.24083839999997,162.30700200000015,161.28333666666666,129483680,177488789.6,47.416563836052454,0.035084712956776586,1.5,2.75,NaN,NaN,2.2617595705731377,0.7295315962873635,553.1191966517177,-0.4861291747574522,-0.9175144467020289,-0.43138527194457665,22.076307736872,-1.2838976558909139,27.6979838621241,39.35930545016304,32.94271068771285,7171798333
1372426200,160.63,161.39999,159.86,160.42,NaN,NaN,155.9195652173913,172.27565858823527,151.19121010000026,158.35978920000002,162.36643839999996,162.15575150000015,161.3034351398749,161.69160857662962,161.42346230769243,166.4554818858021,156.39144272958276,151.19121010000026,158.35978920000002,162.36643839999996,162.15575150000015,160.55999666666665,160402816,176666430.4,45.77643010619596,0.3438257252879775,1.5,2.75,NaN,NaN,2.210204601246484,0.9079416821680458,554.4302077119304,-0.3781548699268804,-0.9040788593531772,-0.5259239894262968,21.95129312817893,-2.4446606665045065,35.99781936496058,30.787163743829872,33.215016891209565,7011395517
1372685400,161.25999,162.48,161.08,161.36,NaN,NaN,155.96695652173912,172.39895276470588,151.27846010000027,158.46178920000003,162.48403839999995,162.00625100000016,161.3056533696837,161.6600268074268,161.39346230769246,166.42198614559356,156.36493846979135,151.27846010000027,158.46178920000003,162.48403839999995,162.00625100000016,161.64000000000001,131954816,174844636.8,48.50827014037879,0.30549513323874483,1.5,2.75,NaN,NaN,2.1994757011574495,0.754697532706934,559.156592131063,-0.22587181170595672,-0.8082637540587427,-0.582391942352786,21.6814444585372,-2.6397562373668806,73.18669235485078,5.94925545207058,20.86405219307865,7143350333
1372771800,161.12,162.3,160.5,161.21001,NaN,NaN,156.01434782608695,172.52224694117646,151.36256015000026,158.56428920000002,162.58483859999996,161.88875150000015,161.30190264930397,161.61716806386232,161.16269307692326,165.9211050652933,156.40428108855323,151.36256015000026,158.56428920000002,162.58483859999996,161.88875150000015,161.33667,154863632,174706246.4,48.09192029083792,0.1543044653581035,1.5,2.75,NaN,NaN,2.1709417225033465,0.8864229825270861,556.4139251402997,-0.12284562264749144,-0.7359489706621503,-0.6131033480146588,20.809124983929365,-1.3704435607219196,41.49213480187184,25.795766837487747,32.71209836064041,6988486701
1372858200,160.48,161.77,160.22,161.28,NaN,NaN,156.06173913043477,172.64554111764704,151.43601015000024,158.65908920000004,162.65483859999998,161.88915150000017,161.3010437218803,161.58505681968495,161.01692384615401,165.63382337806445,156.40002431424358,151.43601015000024,158.65908920000004,162.65483859999998,161.88915150000017,161.09,75216320,167880178.4,48.31484940093728,0.24440095680855126,1.5,2.75,NaN,NaN,2.126588742324537,0.44803574023364273,553.1877120809645,-0.04177488827935094,-0.6653219583638474,-0.6235470700844965,19.60075178896071,1.1794291831511399,35.92944085071971,30.80538299728989,33.26517615199039,7063703021
1373031000,162.47,163.08,161.3,163.02,NaN,NaN,156.1091304347826,172.76883529411765,151.51491010000026,158.77158920000002,162.75763859999998,161.90365150000017,161.36845377200262,161.72171807495306,160.90769307692324,165.25478689714564,156.56059925670084,151.51491010000026,158.77158920000002,162.75763859999998,161.90365150000017,162.46666666666667,122416880,163989750.4,53.64485539982898,0.7243532126161317,1.5,2.75,NaN,NaN,2.103260975015642,0.7464910441134497,555.3340012919166,0.12795608075086717,-0.46360196914591256,-0.5915580498967797,13.585117696516292,2.483177061471244,35.36017827397216,31.34920800285806,33.290613723169784,7186119901
1373290200,163.86,164.39,163.0838,163.94501,NaN,NaN,156.15652173913043,172.89212947058823,151.60093510000024,158.89083930000004,162.86613879999996,161.86090200000015,161.4694951927084,161.93346016305276,160.77000153846168,164.57655118553484,156.96345189138853,151.60093510000024,158.89083930000004,162.86613879999996,161.86090200000015,163.80626999999998,108092432,159977484.8,56.22907546694764,1.2820124635354682,1.5,2.75,NaN,NaN,2.050885191085952,0.6756727806736964,557.8557019797411,0.2920575937437466,-0.2264860577170964,-0.518543651460843,13.40968453318197,4.383681395644973,68.05494006939743,8.251049265055782,23.694010665546788,7294212333
1373376600,164.98,165.33,164.27,165.13,NaN,NaN,156.20391304347825,173.0154236470588,151.69348510000026,159.02062930000002,163.00393859999994,161.87740200000013,161.61304440083748,162.2378925284763,160.89923230769247,165.14919168629436,156.64927292909059,151.69348510000026,159.02062930000002,163.00393859999994,161.87740200000013,164.91,119297872,160659025.6,59.35508778679932,1.7458087351329046,1.5,2.75,NaN,NaN,2.003321248865528,0.7425531902391919,562.1761957786797,0.45995385818314194,0.0563986712680844,-0.40355518691505754,9.0196091421726,4.133690682642287,67.43099765215598,8.554323360887004,24.014678986957026,7413510205
1373463000,164.97,165.75,164.63,165.192,NaN,NaN,156.25130434782608,173.13871782352942,151.78594510000025,159.14964940000004,163.12177859999994,161.98210150000014,161.75339560080465,162.51923609719285,161.3447715384617,166.06140534861825,156.62813772830518,151.78594510000025,159.14964940000004,163.12177859999994,161.98210150000014,165.19066666666666,121410368,158754275.2,59.51799064853917,1.5142896460297335,1.5,2.75,NaN,NaN,1.940226873946562,0.7647691241514358,563.5740595018322,0.5487122735227906,0.28233515498843076,-0.26637711853435986,8.85449196487992,3.154739602847522,99.99999999999999,0,0,7534920573
1373549400,167.11,167.61,165.1774,167.44,NaN,NaN,156.2986956521739,173.262012,151.88959505000025,159.30294940000005,163.27697879999994,162.26660150000015,161.97639969489074,162.98788027841258,161.98861692307713,167.50474300611393,156.47249084004034,151.88959505000025,159.30294940000005,163.27697879999994,162.26660150000015,166.74246666666667,135592192,156665709.6,64.99607340758041,2.3291207708739177,1.5,2.75,NaN,NaN,1.9753963829503796,0.8654873638028063,572.0094759112336,0.7214705422442154,0.6354610592709093,-0.08600948297330602,9.917455735366586,3.948348646635203,99.99999999999999,0,0,7670512765
1373635800,167.39,167.9332,167.13,167.50999,NaN,NaN,156.34608695652173,173.38530617647058,151.99779500000025,159.44554930000004,163.46157859999994,162.43160050000014,162.19340323626759,163.41855739475423,162.79246230769252,168.2467188609137,157.33820575447135,151.99779500000025,159.44554930000004,163.46157859999994,162.43160050000014,167.52439666666666,104212624,153696953.6,65.15417695880944,2.1281091932239256,1.5,2.75,NaN,NaN,1.8916680698824955,0.6780396199082505,570.9455829975115,0.7971821305260814,0.9104681801842958,0.11328604965821434,10.125420585877116,4.419642189253211,99.99999999999999,0,0,7774725389
1373895000,167.97,168.39,167.67999,168.155,NaN,NaN,156.39347826086956,173.50860035294116,152.11034500000022,159.61369930000004,163.62967859999992,162.68060050000014,162.42719134464926,163.8696471666824,163.5293853846156,169.0928395244559,157.9659312447753,152.11034500000022,159.61369930000004,163.62967859999992,162.68060050000014,168.07499666666664,69450560,150109609.6,66.64919462353032,2.1777334698497746,1.5,2.75,NaN,NaN,1.8194067791766029,0.4626656493549364,574.2446825672448,0.8429773067694325,1.167007683120005,0.3240303763505724,8.760312644931401,4.211080813088738,100,0,0,7844175949
1373981400,168.25999,168.36,167.07001,167.52499,NaN,NaN,156.44086956521738,173.63189452941177,152.22746990000024,159.78474920000005,163.7528183999999,162.83485000000013,162.6271050174081,164.2177750555698,164.09746153846177,169.66869970029285,158.5262233766307,152.22746990000024,159.78474920000005,163.7528183999999,162.83485000000013,167.65166666666667,88702064,147729934.4,63.77122607959229,1.5931962924404741,1.5,2.75,NaN,NaN,1.781591294949704,0.6004339226187323,570.9501934510713,0.7843306831929838,1.3044437303418022,0.5201130471488183,9.95255988383406,3.917238141725809,80.56478309155743,3.2564556900874275,16.17876121835513,7755473885
1374067800,168.16,168.48,167.73,167.9501,NaN,NaN,156.4882608695652,173.75518870588235,152.35074540000025,159.94535020000004,163.8762203999999,162.94560500000014,162.83584991868622,164.57323457408697,164.62593076923102,170.2550547657978,158.99680677266423,152.35074540000025,159.94535020000004,163.8762203999999,162.94560500000014,168.05336666666665,92873872,146638852.8,64.87343859144352,1.5759339269916013,1.5,2.75,NaN,NaN,1.7225497738818671,0.6333510541484542,574.4281792966676,0.7288439609466821,1.431167998332171,0.7023240373854889,9.547871345631407,4.1357266865079305,79.36303608676405,3.6460057667004464,16.990958146535498,7848347757
1374154200,168.31,169.27,168.2,168.87,NaN,NaN,156.53565217391304,173.87848288235293,152.47189540000025,160.14405020000007,164.00162239999995,163.21660500000013,163.07248325520834,164.98245032893584,165.275930769231,170.7619308575225,159.7899306809395,152.47189540000025,160.14405020000007,164.00162239999995,163.21660500000013,168.78,103620256,141512393.6,67.19897476572767,1.7719613943033796,1.5,2.75,NaN,NaN,1.6937890757474494,0.7322344945481863,577.9621756796288,0.7081616683676704,1.5875261228450768,0.8793644544774064,9.275028957704253,3.5885167464114796,77.76375181674496,4.195157419825731,18.0410907634293,7951968013
1374240600,168.52,169.23,168.31,169.17,NaN,NaN,156.58304347826086,174.00177705882354,152.59789540000023,160.33555020000006,164.11822239999995,163.70510550000014,163.31160155892567,165.3812645833229,165.87670000000023,171.22459372889932,160.52880627110113,152.59789540000023,160.33555020000006,164.11822239999995,163.70510550000014,168.9033333333333,103831632,130641178.4,67.94432049588721,1.5384510647156993,1.5,2.75,NaN,NaN,1.6385184274797735,0.794784870066665,577.2955090129622,0.6692037044939563,1.7158690850948517,1.0466653806008954,8.501974911393463,3.187038141630533,77.79954541379142,4.182485869772476,18.017968716436094,8055799645
1374499800,169.41,169.74001,169.00999,169.5,NaN,NaN,156.6304347826087,174.12507123529412,152.72367040000023,160.51145020000004,164.25060239999996,164.22660500000015,163.5542838507325,165.7735250991969,166.51439153846178,171.445103601177,161.58367947574655,152.72367040000023,160.51145020000004,164.25060239999996,164.22660500000015,169.41666666666666,79428560,121014769.6,68.78458653270347,1.553091988711901,1.5,2.75,NaN,NaN,1.5736256826597914,0.6563542637195584,579.5535536166179,0.6212224240585131,1.8231934106740368,1.2019709866155237,8.456334189300316,2.646399806213289,79.00784942137075,3.7848433078625328,17.207307270766705,8135228205
1374586200,169.8,169.83,169.05,169.14,NaN,NaN,156.67782608695651,174.2483654117647,152.84687040000023,160.68675020000003,164.36520239999993,164.83060500000016,163.77333154286063,166.09414175641624,167.11900692307714,171.18600100451056,163.05201284164372,152.84687040000023,160.68675020000003,164.36520239999993,164.83060500000016,169.34,80829632,113939513.6,66.72962474998145,1.3126244984069442,1.5,2.75,NaN,NaN,1.5169381338983778,0.709408259225709,581.8406411162053,0.5246506820196579,1.857784339140096,1.3331336571204382,8.587328791467703,2.3899462443701744,80.58500168634185,3.2676767381877165,16.147321575470432,8054398573
1374672600,169.78999,169.86,168.17999,168.52,NaN,NaN,156.72521739130434,174.37165958823527,152.96402040000024,160.85085020000005,164.46480259999996,165.32785500000017,163.95947540392493,166.3251758748528,167.54208384615407,170.89746682596896,164.18670086633918,152.96402040000024,160.85085020000005,164.46480259999996,165.32785500000017,168.85333,112914000,111472107.2,63.22627049014648,0.8957730310282744,1.5,2.75,NaN,NaN,1.5285861243342087,1.0129350098084446,577.902341472751,0.38489745267350206,1.8142554729623157,1.4293580202888136,9.225233929729319,0.6450071667463046,49.05837742733082,19.872190994672764,31.069431577996415,7941484573
1374759000,168.22,169.08,167.94,168.92999,NaN,NaN,156.77260869565217,174.49495376470588,153.07804535000022,161.01095010000006,164.53880239999998,165.76735450000018,164.15439754494747,166.5732534105811,167.92554384615408,170.62404692780495,165.22704076450322,153.07804535000022,161.01095010000006,164.53880239999998,165.76735450000018,168.64999666666665,111156560,110287538.4,64.55161294442057,0.7143738473932989,1.5,2.75,NaN,NaN,1.5008299725960519,1.0078795992059244,579.9179059098257,0.29025929526533445,1.7921821393704818,1.5019228441051473,5.677254756367924,0.8477106350492982,49.960576428066425,19.21134539023596,30.82807818169762,8052641133
1374845400,168.22,169.16,167.52,169.11,NaN,NaN,156.82,174.61824794117646,153.19289535000024,161.15915020000006,164.59870220000002,166.16885450000018,164.348734896126,166.81484832385908,168.23169769230793,170.45296656338803,166.01042882122783,153.19289535000024,161.15915020000006,164.59870220000002,166.16885450000018,168.59666666666666,107814496,109204079.2,65.14557191340486,0.5787555657853491,1.5,2.75,NaN,NaN,1.5107706888391899,0.9872753544539754,577.7681101935723,0.2135211335450704,1.7688242610364853,1.5553031274914149,5.669893748006537,0.5679283993934242,50.42051861835272,18.87892967600712,30.70055170564016,8160455629
1375104600,168.67999,169.06,168.11,168.59,NaN,NaN,156.8673913043478,174.74154211764704,153.30763535000023,161.30005020000007,164.66370220000002,166.57735450000018,164.51505901784654,166.98391038825346,168.49308230769253,169.85589033663885,167.1302742787462,153.30763535000023,161.30005020000007,164.66370220000002,166.57735450000018,168.58666666666667,79845120,105176194.4,61.91805401409347,0.4286675305210068,1.5,2.75,NaN,NaN,1.474287068207819,0.7591558190091731,573.1796930995657,0.10686542287937639,1.6888849060906352,1.5820194832112588,5.7683041310737,0.6357320182499344,26.37939325110816,40.810190992847495,32.81041575604434,8080610509
1375191000,169.10001,169.28,168.19,168.588,NaN,NaN,156.91478260869562,174.86483629411765,153.42957535000022,161.43817020000006,164.6966622,166.9387545000002,164.67478219361726,167.13668082746742,168.58139000000025,169.80106188437472,167.3617181156258,153.42957535000022,161.43817020000006,164.6966622,166.9387545000002,168.686,85216944,102839300.8,61.90535051734539,0.40560670944567057,1.5,2.75,NaN,NaN,1.4468379919072607,0.8286418065572846,573.6715624764037,0.019863022669377672,1.6068482615479809,1.5869852388786032,5.187858378799721,0.3798151951085483,25.930229498364195,41.33241525690016,32.73735524473564,7995393565
1375277400,168.94,169.85001,168.49001,168.71001,NaN,NaN,156.96217391304344,174.98813047058823,153.55672540000023,161.57087030000005,164.73226259999998,167.3137545000002,164.83302642131855,167.28652170104195,168.6736992307695,169.72508229266035,167.62231616887865,153.55672540000023,161.57087030000005,164.73226259999998,167.3137545000002,169.01667666666665,142388624,102215550.4,62.41199736577894,0.6121375833044443,1.5,2.75,NaN,NaN,1.4406352781995981,1.3930231108944846,574.380443681412,-0.04239149706774503,1.533995867543922,1.576387364611667,5.047473005749112,-0.09474151714336082,60.18930709332909,12.443628653849713,27.367064252821205,8137782189
1375363800,169.99001,170.81,169.89999,170.66,NaN,NaN,157.00956521739127,175.1114246470588,153.69322540000022,161.71717030000005,164.8020626,167.78275450000018,165.06153518910997,167.60780534856175,168.86639153846178,170.31140612312987,167.4213769537937,153.69322540000022,161.71717030000005,164.8020626,167.78275450000018,170.45666333333332,110438368,103976652.8,69.41352008736158,1.234868958321584,1.5,2.75,NaN,NaN,1.4877320440424833,1.0621458281834593,578.4228327140149,0.030882991926906245,1.6149911045202998,1.5841081125933936,7.712084078444861,0.8807708222498133,60.22521397273346,12.422647848628843,27.352138178637716,8248220557
1375450200,170.28,170.9725,170.05,170.95,NaN,NaN,157.0569565217391,170.9725,153.83352540000024,161.86987040000005,164.9024628,168.17925450000016,165.29245537777234,167.92610960107967,169.12985384615408,170.74000657013474,167.51970112217342,153.83352540000024,161.86987040000005,164.9024628,168.17925450000016,170.6575,91116624,102411640,70.299566237747,1.1028629047776815,1.5,2.75,NaN,NaN,1.4473583266108763,0.889709646286301,579.4545866231581,0.07925619582169174,1.6831783573705081,1.6039221615488164,7.7095811943896155,0.8554572271386364,58.81494867571231,13.259478143354476,27.925573180933206,8339337181
1375709400,170.57001,170.96001,170.35001,170.7,NaN,NaN,157.10434782608692,171.0105498,153.96662540000023,162.01782040000006,165.00746279999998,168.51700400000016,165.50451595119304,168.1902896390721,169.34138461538484,170.99786602785244,167.68490320291724,153.96662540000023,162.01782040000006,165.00746279999998,168.51700400000016,170.67000666666664,54072640,99710650.4,68.458452508931,0.9374921098363419,1.5,2.75,NaN,NaN,1.3875470175672433,0.5422955299467187,576.0545866231581,0.07484377398915809,1.6974768790352641,1.622633105046106,7.8112413140590835,0.9223128769067059,64.82611632975339,9.89209640867242,25.281787261574195,8285264541
1375795800,170.37,170.7402,169.35001,169.73,NaN,NaN,157.15173913043475,171.0485996,154.08757545000023,162.14782040000006,165.09590279999998,168.74700400000015,165.670221208009,168.33692872106522,169.40753846153868,171.05208196432676,167.7629949587506,154.08757545000023,162.14782040000006,165.09590279999998,168.74700400000015,169.94007,87494944,98120504,61.7058565391581,0.44637266669556,1.5,2.75,NaN,NaN,1.3877358020267252,0.8917090764230073,570.7020990886544,-0.00854165102709925,1.611956041262232,1.6204976922893313,8.52014580519656,0.7180156657963325,64.22977403450518,10.207256232113206,25.562969733381603,8197769597
1375882200,169.19,169.42999,168.55,169.17999,NaN,NaN,157.19913043478257,171.0866494,154.20247540000022,162.28132030000006,165.1535026,168.94640350000014,165.80785919985178,168.41722027143996,169.40830692307716,171.05241499883616,167.76419884731817,154.20247540000022,162.28132030000006,165.1535026,168.94640350000014,169.05332666666666,84854624,96292716.8,58.200334491605666,0.10182031074445394,1.5,2.75,NaN,NaN,1.3728975304533861,0.8812153901134919,568.1332724972908,-0.11023237393309082,1.4827072248729678,1.5929395988060586,8.44989105264321,0.1479903005973066,30.81017623306003,35.959084409164184,33.230739357775775,8112914973
1375968600,169.98,170.17999,168.92999,169.8,NaN,NaN,157.2465217391304,171.1246992,154.32237535000021,162.42962030000007,165.2451026,169.06440350000017,165.96441374103406,168.54891357892186,169.4313838461541,171.0883634620856,167.7744042302226,154.32237535000021,162.42962030000007,165.2451026,169.06440350000017,169.63666,102181248,94622169.6,60.89712841744766,0.4034459993902212,1.5,2.75,NaN,NaN,1.3641191354210014,1.0798869697445619,571.4613273897301,-0.1431465222952768,1.4140064459369626,1.5571529682322394,8.58628568433107,0.4080184495298904,29.38360427676612,37.483404347631534,33.13299137560234,8215096221
1376055000,169.58,170.10001,168.72,169.31,NaN,NaN,157.29391304347823,171.162749,154.45197735000022,162.57662030000006,165.31470259999998,169.15440400000017,166.09561320216997,168.62139799997692,169.44446076923103,171.09470514462058,167.79421639384148,154.45197735000022,162.57662030000006,165.31470259999998,169.15440400000017,169.37667000000002,91856432,94004360,57.727282599915235,0.06918477300717535,1.5,2.75,NaN,NaN,1.3652541971766439,0.9771507619433822,570.479790516176,-0.2017394172462743,1.3049786966743966,1.506718113920671,8.790381243568653,0.4270715938074612,7.651085983415436,69.3515423690561,22.997371647528485,8123239789
1376314200,168.46001,169.31,168.38,169.11099,NaN,NaN,157.34130434782605,171.2007988,154.58048230000023,162.71083020000006,165.4280222,169.20220350000017,166.2138632726731,168.66802580950292,169.4899215384618,171.0667200768905,167.9131230000331,154.58048230000023,162.71083020000006,165.4280222,169.20220350000017,168.93366333333333,68593184,93961491.2,56.44226446489793,0.1885072066760441,1.5,2.75,NaN,NaN,1.334164611664027,0.7300137867543762,571.5778222820485,-0.2543256097717186,1.1888111017060226,1.4431367114777411,8.603337190661302,0.3102178090967287,7.037204672293713,70.68077065895487,22.282024668751415,8054646605
1376400600,169.41,169.89999,168.41,169.61,NaN,NaN,157.38869565217388,171.23884859999998,154.72143230000026,162.86334030000006,165.533222,169.30645400000017,166.3470451051173,168.7577376371693,169.54223000000027,171.08602946210783,167.99843053789272,154.72143230000026,162.86334030000006,165.533222,169.30645400000017,169.30666333333332,80806000,93566688,58.91206290505323,0.19444082137357246,1.5,2.75,NaN,NaN,1.3452949965451684,0.8636193257155794,568.4780326678692,-0.2552645972718035,1.1240559648879866,1.3793205621597902,8.729280669846515,0.5334538241091933,24.97919536032805,42.476905845580745,32.54389879409122,8135452605
1376487000,169.53,169.8,168.7,168.74001,NaN,NaN,157.4360869565217,171.2768984,154.86003235000027,162.99474030000007,165.63682219999998,169.34594950000016,166.44088686570095,168.7560492907722,169.51376923076947,171.10141223344755,167.9261262280914,154.86003235000027,162.99474030000007,165.63682219999998,169.34594950000016,169.08000333333334,79829184,92914453.6,53.24374135664607,0.18034852135329027,1.5,2.75,NaN,NaN,1.3277739253633722,0.8591686320802946,564.5006375239154,-0.31056747607274215,0.9911112170688625,1.3016786931416047,9.32706590379946,-1.1250380874252808,25.616221177276465,41.721774098208165,32.662004724515356,8055623421
1376573400,167.41,167.42999,166.09,166.38,NaN,NaN,157.48347826086953,171.3149482,154.98478240000026,163.10904030000006,165.73898219999995,169.22144950000018,166.43849914547738,168.52975888212723,169.34376923076948,171.61624287370233,167.07129558783663,154.98478240000026,163.10904030000006,165.73898219999995,169.22144950000018,166.63333,152931744,95380028,41.56150939248142,1.4279804166151182,1.5,2.75,NaN,NaN,1.4222193592659893,1.6033937838642698,562.4588518131003,-0.49142726978931917,0.6873946059049558,1.178821875694275,9.362398967091117,-2.6732962854635822,3.5946766850692957,79.51428250848153,16.89104080644918,7902691677
1376659800,166.06,166.63,165.5,165.83,NaN,NaN,157.53086956521736,171.35299799999999,155.10718235000027,163.20544030000008,165.80098219999996,169.05444950000017,166.41463643389002,168.2726389885913,169.1316153846156,172.0654346468898,166.1977961223414,155.10718235000027,163.20544030000008,165.80098219999996,169.05444950000017,165.98666666666668,130868128,96731852.8,39.39229691106901,1.4583507440907366,1.5,2.75,NaN,NaN,1.401346547889847,1.3528959097948758,561.3491649389426,-0.6248720642501264,0.39773179538161685,1.0226038596317433,8.966661780402433,-2.852958406561205,3.0706982622761996,81.1573174800284,15.771984257695413,7771823549
1376919000,165.64,166.21001,164.75999,164.77,NaN,NaN,157.57826086956518,171.3910478,155.22428230000028,163.29124030000006,165.80038219999997,168.81794950000017,166.35014088746297,167.93905432301116,168.8285376923079,172.57535249471266,165.08172288990312,155.22428230000028,163.29124030000006,165.80038219999997,168.81794950000017,165.24666666666667,96437568,97582303.2,35.54210971445757,1.6294843072106835,1.5,2.75,NaN,NaN,1.4048232230405737,0.9882690286818318,559.7864955932808,-0.7527254578398466,0.08169703733193501,0.8344224951717816,9.096627911502347,-2.9222883403051787,2.7268802602940814,82.29829408905924,14.974825650646697,7675385981
1377005400,165.03999,166.2,164.86,165.58,NaN,NaN,157.625652173913,171.4290976,155.3380323000003,163.38034030000006,165.8159822,168.63994950000017,166.31993928403304,167.71438248272437,168.43776846153867,172.39286853974224,164.4826683833351,155.3380323000003,163.38034030000006,165.8159822,168.63994950000017,165.54666666666665,89294368,98005540,40.3406883485872,1.2071344917871605,1.5,2.75,NaN,NaN,1.4066215642519597,0.9111155144903033,563.5281529800548,-0.7493173386091845,-0.10222417808969908,0.6470931605194854,10.145722333695597,-2.1279053155163274,3.1227188628910727,80.98113998660843,15.896141150500481,7764680349
1377091800,165.12,166.03,164.19,164.56,NaN,NaN,157.67304347826084,171.4671474,155.45303230000027,163.46544030000004,165.845222,168.44194950000016,166.25092205720821,167.4139651034173,167.9462300000002,172.11291118114482,163.7795488188556,155.45303230000027,163.46544030000004,165.845222,168.44194950000016,164.92666666666668,159530496,100336364.8,36.64147551366002,1.3322082334138017,1.5,2.75,NaN,NaN,1.4375771668053914,1.5899569046376294,561.7814027507328,-0.7788941843428316,-0.3265245699090542,0.45236961443377743,10.363978135201034,-3.0859835100117836,2.366144326856616,83.57672701759115,14.057128655552223,7605149853
1377178200,164.89999,166.3,164.89,166.06,NaN,NaN,157.72043478260866,171.5051972,155.57408930000028,163.55784020000007,165.931422,168.29845000000017,166.24343491770986,167.285016045949,167.58930692307715,171.540645373437,163.6379684727173,155.57408930000028,163.55784020000007,165.931422,168.29845000000017,165.75,101471376,99852105.6,44.67592212807371,0.7332712112175022,1.5,2.75,NaN,NaN,1.459178797747864,1.0162166875727856,567.9073535118207,-0.6649991297436484,-0.3788792977457831,0.2861198319978653,11.935509686445567,-1.919555844309255,14.430201367778348,56.921033433078286,28.648765199143373,7706621229
1377264600,166.55,166.83,165.77,166.62,NaN,NaN,157.7678260869565,171.543247,155.69238925000028,163.67174020000004,165.9796218,168.17395000000016,166.25820217583887,167.22168118443005,167.35007615384637,171.12674448227142,163.57340782542133,155.69238925000028,163.67174020000004,165.9796218,168.17395000000016,166.40666666666667,90893568,99006059.2,47.35972442456102,0.30688773200095687,1.5,2.75,NaN,NaN,1.4306660264801596,0.9180606594631533,570.133285646758,-0.5256221709495774,-0.3709078816891065,0.15471428926047093,12.340520637042284,-1.472991199448352,37.42199726413364,29.413662699590425,33.164340036275945,7797514797
1377523800,166.78999,167.3,165.89,166,NaN,NaN,157.81521739130432,171.5812968,155.8237892500003,163.77314020000006,166.0361218,168.04445000000015,166.24807660031578,167.10533059543673,167.10546153846175,170.78708851203208,163.42383456489142,155.8237892500003,163.77314020000006,166.0361218,168.04445000000015,166.39666666666668,89705056,99499056,44.77023548249172,0.2350560557395138,1.5,2.75,NaN,NaN,1.4291898817315787,0.9015669053181771,568.1087877956118,-0.4516868628170094,-0.40989428926079086,0.04179257355621857,12.394962872041901,-2.128412239844357,39.54487306057451,27.570427791815778,32.88469914760971,7707809741
1377610200,164.36,166.0024,163.21001,163.33,NaN,NaN,157.86260869565214,171.6193466,155.95023930000028,163.85486020000008,166.0139218,167.78155000000012,166.13364222383282,166.74577530063323,166.60776923076943,170.44384209794944,162.77169636358943,155.95023930000028,163.85486020000008,166.0139218,167.78155000000012,164.18080333333333,158621744,103169296,35.71400104758341,1.6331922545442812,1.5,2.75,NaN,NaN,1.5265613187507505,1.5374898361233365,561.9671267824981,-0.5524416496272095,-0.6487594884777934,-0.09631783885058384,14.389650344783872,-3.206121654253783,14.40931175813365,57.038852497858635,28.551835744007708,7549187997
1377696600,163.25999,164.49001,163.05,163.91,NaN,NaN,163.05,171.6573964,156.07898930000027,163.93186010000008,165.97742179999997,167.54154950000012,166.04644056799623,166.47570146247767,166.1923846153848,169.93642848662574,162.44834074414388,156.07898930000027,163.93186010000008,165.97742179999997,167.54154950000012,163.81667000000002,108112944,101455512,38.61866581742242,1.3031058593752023,1.5,2.75,NaN,NaN,1.5203790816971257,1.065619224315777,564.452081510456,-0.5487405375496769,-0.78224351078768,-0.23350297323800306,14.938806702698466,-1.4845534319028724,41.96532421244868,25.47274297816274,32.56193280938858,7657300941
1377783000,163.55,165.03999,163.39999,164.17,NaN,NaN,163.20913043478262,171.6954462,156.20851430000027,164.00606010000007,165.99182179999997,167.21704950000012,165.97285466336893,166.2561108470036,165.81230846153863,169.28757886929785,162.33703805377942,156.20851430000027,164.00606010000007,165.99182179999997,167.21704950000012,164.20332666666664,119200432,101893615.2,39.92897770486697,0.9104028244193705,1.5,2.75,NaN,NaN,1.5289234330044728,1.1698518279681178,567.7264545782876,-0.49893347184500997,-0.8571698130442655,-0.35823634119925557,13.264006707360952,-1.0010251462341102,43.83326846716205,23.918942552583214,32.24778898025473,7776501373
1377869400,164.50999,164.53,163.17,163.64999,NaN,NaN,163.36826086956523,171.733496,156.33781430000028,164.0558600000001,166.07682179999995,166.85204900000014,165.8817619314721,166.0079088615747,165.35384615384632,168.22399005226075,162.4837022554319,156.33781430000028,164.0558600000001,166.07682179999995,166.85204900000014,163.78333,134928944,104084231.2,38.17377802261587,1.0455399710553022,1.5,2.75,NaN,NaN,1.5168574735041542,1.2963437635498432,563.9446130187567,-0.4714803019623699,-0.947586718652218,-0.4761064166898481,13.256712543188732,-0.6797414577896508,19.390364782812945,49.69433550210259,30.915299715084473,7641572429
1378215000,165.23,165.58,163.7,164.39,NaN,NaN,163.52739130434784,171.77154579999998,156.48011480000028,164.1078600000001,166.18322159999997,166.53654900000012,165.82326146357124,165.85382230332948,165.01923000000016,167.1517561071277,162.88670389287262,156.48011480000028,164.1078600000001,166.18322159999997,166.53654900000012,164.55666666666664,142375056,108499352,42.07596204553351,0.6348447842244407,1.5,2.75,NaN,NaN,1.5463683682538583,1.312220334735271,564.7542768721895,-0.37799112970112425,-0.9485953288162534,-0.5706041991151292,13.204472433671897,-0.7186858316221924,40.40063248662515,26.760198751184248,32.839168762190596,7783947485
1378301400,164.42999,166.03,164.13499,165.75,NaN,NaN,163.68652173913046,171.8095956,156.63036480000028,164.1773600000001,166.35702159999997,166.33754900000014,165.8203884649998,165.84393446491714,164.97076846153863,167.00370636766,162.93783055541726,156.63036480000028,164.1773600000001,166.35702159999997,166.33754900000014,165.30499666666665,97389376,108994073.6,48.508160662279415,0.2874100490646178,1.5,2.75,NaN,NaN,1.5712713419500122,0.8935290955122169,569.0424069660057,-0.2075848957377573,-0.8300853187873258,-0.6225004230495685,13.802648231225543,0.7231404958677672,72.3096568620466,6.3273429621575685,21.36300017579583,7881336861
1378387800,165.85001,166.39999,165.73,165.96001,NaN,NaN,163.84565217391307,171.8476454,156.77831485000027,164.28578010000012,166.50472179999997,166.1765500000001,165.82586381931355,165.85498927778218,164.98076923076937,167.03171561702015,162.92982284451858,156.77831485000027,164.28578010000012,166.50472179999997,166.1765500000001,166.03000000000003,63090432,107905864,49.4417975272029,0.36766076250306673,1.5,2.75,NaN,NaN,1.5068941032392977,0.5846802913324525,567.130720418858,-0.07081806124410028,-0.711022999604694,-0.6402049383605937,13.212892160278162,-0.06021317596049087,69.78820230886556,7.445522067835392,22.766275623299055,7944427293
1378474200,166.50999,166.98,164.48,166.03999,NaN,NaN,164.00478260869568,171.8856952,156.91286480000028,164.37208000000012,166.62272159999998,165.9885495000001,165.83426092443852,165.87260839418389,165.07846076923093,167.19972281739305,162.9571987210688,156.91286480000028,164.37208000000012,166.62272159999998,165.9885495000001,165.83333,159756432,110784623.2,49.81499582904824,0.5433893094679815,1.5,2.75,NaN,NaN,1.577830238722205,1.4420451808694692,569.9759336086274,0.029557903765155102,-0.6032575586541498,-0.6328154624193049,12.133902355371209,-0.3481034689713214,72.21539923005275,6.367645069645682,21.41695570030157,8104183725
1378733400,166.45,167.73,166.45,167.634,NaN,NaN,164.1639130434783,171.923745,157.0550848000003,164.49732000000012,166.75380159999997,165.9047495000001,165.90483892740173,166.0403599756902,165.23646076923094,167.75280141879628,162.7201201196656,157.0550848000003,164.49732000000012,166.75380159999997,165.9047495000001,167.27133333333333,87559248,110569764,56.6784992216674,1.0183513671753668,1.5,2.75,NaN,NaN,1.585843078813476,0.7918914252181998,575.0444778616719,0.19841739194892183,-0.3847937224831526,-0.5832111144320744,13.231438044678482,0.984337349397582,100,0,0,8191742973
1378819800,168.64,168.89999,168.25999,168.87,NaN,NaN,164.32304347826087,171.9617948,157.20218480000028,164.64462000000012,166.92280159999999,165.89270000000008,166.02111975377812,166.30984950181494,165.5679992307694,168.70070416961713,162.43529429192168,157.20218480000028,164.64462000000012,166.92280159999999,165.89270000000008,168.67666,105847744,112432492,61.1189034295548,1.4668362101660388,1.5,2.75,NaN,NaN,1.5629964303268002,0.9414337627596122,578.7125216801868,0.3780495371191474,-0.11064919303314014,-0.48869873015228754,13.428132864664356,3.391905957264429,100,0,0,8297590717
1378906200,168.64,169.39999,168.35001,169.39999,NaN,NaN,164.48217391304348,171.9998446,157.3424347000003,164.78381990000014,167.08360139999996,165.88219950000007,166.15362446931624,166.60414859688018,165.8249215384617,169.56571336414794,162.08412971277545,157.3424347000003,164.78381990000014,167.08360139999996,165.88219950000007,169.04999666666666,94545808,113119482.4,62.876046484250836,1.4478697162859064,1.5,2.75,NaN,NaN,1.526352399589172,0.8358048144675739,580.3882958827816,0.5090996009110265,0.14767577098649554,-0.3614238299245309,7.074861125829324,3.349392959550977,100,0,0,8392136525
1378992600,169.34,169.56,168.72,168.95,NaN,NaN,164.6413043478261,172.0378944,157.4819347000003,164.91161990000015,167.23840119999997,165.89269900000005,166.26328625483325,166.82756301622493,166.00415230769246,170.08771445022424,161.9205901651607,157.4819347000003,164.91161990000015,167.23840119999997,165.89269900000005,169.07666666666665,83209008,113288473.6,60.38094402192251,1.216834772357717,1.5,2.75,NaN,NaN,1.4773272281899457,0.7344878552587366,576.4598310654649,0.5391291212335643,0.31248757161742446,-0.22664154961613983,7.948104977024674,2.911616007796797,82.4475878868955,2.689671220083195,14.862740893021302,8308927517
1379079000,169.13,169.46001,168.74001,169.33,NaN,NaN,164.8004347826087,172.0759442,157.6269347000003,165.02711990000017,167.39940119999994,166.04019900000006,166.38354953895742,167.06589034801303,166.2603061538463,170.7118767524583,161.8087355552343,157.6269347000003,165.02711990000017,167.39940119999994,166.04019900000006,169.17667333333335,72727744,109278273.6,61.76093375247179,1.1362809797745397,1.5,2.75,NaN,NaN,1.423232426176378,0.665527937110456,578.9798539748682,0.5560059633960406,0.4683659046289108,-0.08764005876712971,7.9132118905439945,3.4708281986451754,78.6178794725308,3.901749008629938,17.48037151883926,8381655261
1379338200,171.16,171.24001,170.03999,170.31,NaN,NaN,164.95956521739132,172.113994,157.7711846500003,165.15141990000018,167.54520119999995,166.26419900000005,166.53752798841006,167.3748531720118,166.79722923076937,171.38715685202587,162.20730160951288,157.7711846500003,165.15141990000018,167.54520119999995,166.26419900000005,170.53,126187504,109044242.4,65.1338310971125,1.6185410341087714,1.5,2.75,NaN,NaN,1.4580022528780654,1.1572138172789945,583.4537928470767,0.6007775979752703,0.6633319387019583,0.06255434072668792,6.926540696329212,3.60119228663545,81.22335617434909,3.0748407509854965,15.701803074665422,8507842765
1379424600,170.46001,171.11,170.46001,171.07001,NaN,NaN,165.11869565217393,172.1520438,157.91593470000032,165.27692000000016,167.68770119999994,166.57919950000004,166.71527238102144,167.72677286991544,167.34799923076937,172.13407550263491,162.56192295890384,157.91593470000032,165.27692000000016,167.68770119999994,166.57919950000004,170.88000666666667,82523184,108348523.2,67.52609083236561,1.615403125379999,1.5,2.75,NaN,NaN,1.4110020919582045,0.7616456741885708,587.2353269273145,0.6452776034292955,0.8691513450133073,0.2238737415840118,6.924994780873264,3.209659125188535,80.18521633357528,3.40277745264304,16.412006213781694,8590365949
1379511000,171.00999,173.52,170.58,173.05099,NaN,NaN,165.27782608695654,172.19009359999998,158.07041465000032,165.42502980000015,167.84612099999995,166.95274900000007,166.96373189549118,168.23384116801873,168.03115230769248,173.3169404730361,162.74536414234885,158.07041465000032,165.42502980000015,167.84612099999995,166.95274900000007,172.38366333333335,203460624,114056836,72.77042575378634,2.1557697992028912,1.5,2.75,NaN,NaN,1.5202162282469038,1.7838529555562983,592.2394348288701,0.7637233279982889,1.178527901581873,0.4148045735835841,7.851788875410712,4.27270400863437,84.56476884730189,2.122876755059069,13.312354397639044,8793826573
1379597400,173.52,173.60001,172.58501,172.75999,NaN,NaN,165.43695652173915,173.60001,158.22696460000031,165.55962970000016,167.99748079999998,167.36274850000007,167.1910361348837,168.66490296154075,168.7319215384617,173.9232419212762,163.5406011556472,158.22696460000031,165.55962970000016,167.99748079999998,167.36274850000007,172.98167,146616816,113411152,70.95761512116644,2.0280303796341976,1.5,2.75,NaN,NaN,1.4841293548006953,1.2927901129158796,589.7441058592417,0.7755745403474039,1.384272749017839,0.6086982086704351,8.429835749496506,4.047217781692229,73.25294481857247,5.969764939434642,20.77729024199287,8647209757
1379683800,172.33,172.33,170.58,170.72,NaN,NaN,165.59608695652176,173.6796315151515,158.3743146000003,165.67002980000015,168.06308079999997,167.59574850000007,167.32942687469216,168.86062648901304,169.21884461538477,173.84668092744633,164.5910083033232,158.3743146000003,165.67002980000015,168.06308079999997,167.59574850000007,171.21,132867936,114980980,59.725162467128314,0.9105745821326571,1.5,2.75,NaN,NaN,1.533833686600644,1.1555644768378213,585.1812479684952,0.6066089702809428,1.3669594215216136,0.7603504512406708,12.374787177371317,1.8409153274395487,49.1486285072627,19.831851245103177,31.019520247634127,8514341821
1379943000,170.49001,170.64999,169.39,169.92999,NaN,NaN,165.75521739130437,173.75925303030303,158.5164645500003,165.7865297000002,168.11148079999995,167.76124800000008,167.4314097423513,168.96247063291656,169.54038230769248,173.71848067824072,165.36228393714424,158.5164645500003,165.7865297000002,168.11148079999995,167.76124800000008,169.98999333333336,104616432,115667123.2,56.02639124953436,0.17378256716483564,1.5,2.75,NaN,NaN,1.5192741375577417,0.9044612600860467,582.6638087934604,0.41155661725597215,1.274796222810636,0.8632396055546638,12.211251948663929,0.6276958607212644,23.94505741887648,43.71090115511733,32.344041426006186,8409725389
1380029400,169.89999,170.53,169.21001,169.53,NaN,NaN,165.91434782608698,173.83887454545453,158.65421455000032,165.88432970000017,168.13898079999996,167.93774800000008,167.51370739951398,169.01652104882928,169.8149969230771,173.44963011714938,166.18036372900482,158.65421455000032,165.88432970000017,168.13898079999996,167.93774800000008,169.75666999999996,106333008,116498520.8,54.196307126010495,0.15991738882597936,1.5,2.75,NaN,NaN,1.5050395563036165,0.91274127147544,584.7292282295092,0.23433068517397582,1.1561529620221336,0.9218222768481578,11.732148896379739,0.07674734809606461,10.838897779741561,63.030002585714406,26.131099634544032,8303392381
1380115800,169.64,169.98,168.89,169.03999,NaN,NaN,166.0734782608696,173.91849606060606,158.7873395500003,165.9610496000002,168.16928079999994,168.22324750000007,167.5735616191409,169.01875618703602,170.04576615384633,173.01182885091515,167.0797034567775,158.7873395500003,165.9610496000002,168.16928079999994,168.22324750000007,169.30333,117306496,114432758.4,51.95725059882566,0.19677766619922865,1.5,2.75,NaN,NaN,1.4753938737105012,1.0251128928479976,585.8297331641238,0.0712895314669848,1.0109341911818888,0.939644659714904,11.72636965935278,0.053264279372595584,0,100.00000000000001,0,8186085885
1380202200,169.32001,170.17,169.05,169.69,NaN,NaN,166.2326086956522,173.99811757575756,158.9234245000003,166.04014960000018,168.20407879999996,168.5122475000001,167.656559202704,169.08268416922306,170.20392000000018,172.8395781438872,167.56826185611317,158.9234245000003,166.04014960000018,168.20407879999996,168.5122475000001,169.63666666666668,77146880,112884455.2,54.63468635448701,0.15140071339479866,1.5,2.75,NaN,NaN,1.450723597016894,0.6834145575076488,588.4696331934712,-0.0017230614264942545,0.9374908329317861,0.9392138943582804,11.82242301825093,0.21260261028759533,2.2839243792272645,83.87856935596442,13.837506264808322,8263232765
1380288600,168.84,169.14,168.47,168.909,NaN,NaN,166.39173913043481,174.0777390909091,159.05076950000029,166.10324060000016,168.20485879999993,168.7491975000001,167.70567452808814,169.06614281977323,170.2069200000002,172.83658001061116,167.57725998938923,159.05076950000029,166.10324060000016,168.20485879999993,168.7491975000001,168.83966666666666,99141680,111881517.6,50.9598735070671,0.3899578632813339,1.5,2.75,NaN,NaN,1.4342433400871157,0.88613099041481,585.6268703097596,-0.10579984367226847,0.8069640897679449,0.9127639334402133,12.089909398408238,-0.8226175797075982,2.6338233727639806,82.61850519348752,14.74767143374849,8164091085
1380547800,167.48,168.53999,167.14999,168.00999,NaN,NaN,166.55086956521743,174.1573606060606,159.1732695000003,166.14994050000016,168.18165859999993,168.96719750000008,167.71760846816312,168.96555683693768,170.09999692307713,172.955537048737,167.24445679741726,159.1732695000003,166.14994050000016,168.18165859999993,168.96719750000008,167.89999,143937376,112331939.2,47.03783154145209,0.8247896928832399,1.5,2.75,NaN,NaN,1.457440958652321,1.281357528634207,581.6146341233311,-0.2311811643489443,0.6237874780040329,0.8549686423529772,11.742400091863512,-1.7887530374260274,2.3763796212632435,83.53863700618842,14.084983372548338,8020153709
1380634200,168.14,169.5,167.9671,169.34,NaN,NaN,166.71000000000004,174.23698212121212,159.3068195000003,166.21453050000014,168.17845859999994,169.2146975000001,167.78123166549005,169.00121809056267,170.12999692307716,172.94447913971146,167.31551470644285,159.3068195000003,166.21453050000014,168.17845859999994,169.2146975000001,168.9357,127160432,111571208,52.822682869631294,0.21127524365224026,1.5,2.75,NaN,NaN,1.4628308901771558,1.1397244349993951,585.5274776964358,-0.22056530332437618,0.579262013197507,0.7998273165218832,12.502733270599505,-2.1444488702433944,17.492004681911023,52.27821970191189,30.229775616177086,8147314141
1380720600,168.35001,169.34219,167.83,169.17999,NaN,NaN,166.86913043478262,174.31660363636362,159.4421939500003,166.27223040000015,168.17925839999995,169.3861970000001,167.83608493351005,169.01824398669956,170.1184576923079,172.94715921866631,167.2897561659495,159.4421939500003,166.27223040000015,168.17925839999995,169.3861970000001,168.78406,113349744,112369226.4,52.08559213564028,0.29152476564871466,1.5,2.75,NaN,NaN,1.466356540878786,1.0087258552133274,583.5159369197434,-0.21985242698904006,0.5250117827855831,0.7448642097746232,9.661820639859062,-2.0722390641490454,17.74802576568837,51.909381454652475,30.34259277965915,8033964397
1380807000,168.78999,168.94,166.84,167.62,NaN,NaN,167.02826086956523,174.39622515151515,159.5614439500003,166.31303050000014,168.16125839999998,169.4691965000001,167.82761101454886,168.88507789272816,169.91153461538485,173.03238382746548,166.79068540330422,159.5614439500003,166.31303050000014,168.16125839999998,169.4691965000001,167.79999999999998,176698432,118049626.4,45.42978738636613,0.7400727339247242,1.5,2.75,NaN,NaN,1.5287589308160157,1.4968148344771042,578.4956880662776,-0.3142262845984568,0.35208135402655216,0.666307638625009,10.441392438375063,-1.8158388003748795,4.554865898993903,76.75371648820384,18.69141761280226,7857265965
1380893400,167.75,169.06,167.53,168.89,NaN,NaN,167.18739130434784,174.47584666666665,159.67904395000028,166.34963050000013,168.16045859999994,169.6116970000001,167.8692733277038,168.8855466648493,169.74384153846177,172.83177933844115,166.65590373848238,159.67904395000028,166.34963050000013,168.16045859999994,169.6116970000001,168.49333333333334,96878368,114905723.2,50.92756496884591,0.3112529851462299,1.5,2.75,NaN,NaN,1.5288475786148719,0.8431117728694648,579.8230556724458,-0.28193189565561905,0.31389276905548513,0.5958246647111042,10.362213515207966,-0.6120108640034742,15.39374206200146,55.41033403102322,29.19592390697531,7954144333
1381152600,167.42,168.45,167.25,167.42999,NaN,NaN,167.34652173913045,174.55546818181818,159.79474395000028,166.3627803000001,168.12685839999995,169.6014965000001,167.85204653053896,168.74692222057794,169.31145692307715,171.9703267585274,166.6525870876269,159.79474395000028,166.3627803000001,168.12685839999995,169.6014965000001,167.70999666666668,96295120,115342516.8,45.27984396370587,0.6462457475094924,1.5,2.75,NaN,NaN,1.536787037285237,0.834862309853811,575.0976864885565,-0.3455175095575682,0.1639277777641439,0.5094452873217121,11.102216596767738,-1.2387247094909442,18.539917063604012,50.81891484688173,30.64116808951428,7857849213
1381239000,167.39999,167.62,165.36,165.48,NaN,NaN,167.50565217391306,174.6350896969697,159.89654395000028,166.36418030000013,168.06465839999993,169.4319965000001,167.7590250979688,168.4357867709991,168.75145769230792,171.33466122381566,166.1682541608002,159.89654395000028,166.36418030000013,168.06465839999993,169.4319965000001,166.15333333333334,178014944,118950876.8,39.050922465156056,1.469351589526873,1.5,2.75,NaN,NaN,1.5884451060505766,1.4965416715616846,571.0084051064281,-0.49634746340941654,-0.11098904194005854,0.385358421469358,12.569920710375525,-2.106004620563453,2.6567312694721306,82.55915910317954,14.784109627348332,7679834269
1381325400,165.8,166.2,164.53,165.60001,NaN,NaN,164.53,174.71471121212122,160.01059405000026,166.3507804000001,168.00489859999993,169.2419975000001,167.6743578392249,168.1657127928087,168.35761230769256,171.17115296706592,165.5440716483192,160.01059405000026,166.3507804000001,168.00489859999993,169.2419975000001,165.44333666666668,168972816,122672227.2,39.6016072191973,1.5018827865228204,1.5,2.75,NaN,NaN,1.5942704556183915,1.3774333429563754,570.5421527023079,-0.5607198835500831,-0.31554143296824577,0.24517845058183727,12.690438852605757,-2.4102716718722377,18.789401865975343,50.47002460133813,30.740573532686533,7848807085
1381411800,167.28999,169.25999,167.23,169.17,NaN,NaN,164.5810344827586,174.79433272727272,160.14469400000027,166.3731805000001,168.01409839999994,169.25299750000013,167.7330104729808,168.26135919349358,168.29915153846179,171.0092584589584,165.58904461796516,160.14469400000027,166.3731805000001,168.01409839999994,169.25299750000013,168.55333,195954752,128309514.4,53.15948766507503,0.35307045772355095,1.5,2.75,NaN,NaN,1.7418211373599344,1.527203597615673,573.047452550867,-0.3460802300329458,-0.187421836959345,0.1586583930736008,18.35215223903482,0.15452107347743205,52.89318922533198,17.092020629530904,30.01479014513711,8044761837
1381498200,168.91,170.32001,168.77,170.25999,NaN,NaN,164.63206896551725,174.87395424242425,160.28724395000026,166.40408040000008,168.00609819999994,169.29949700000014,167.83210770933448,168.4517049845894,168.35530461538485,171.19237335152502,165.51823587924468,160.28724395000026,166.40408040000008,168.00609819999994,169.29949700000014,169.78333333333333,105039744,129925114.4,56.379083806882775,0.9335667319078547,1.5,2.75,NaN,NaN,1.7281203418342237,0.80846374071001,577.4000615936656,-0.12529199884051506,0.002043394522956987,0.12733539336347205,18.496403200590144,1.3392060793527814,53.55213798547439,16.644599361260262,29.80326265326537,8149801581
1381757400,169.21001,171.08,169.08,170.94,NaN,NaN,164.68310344827586,174.95357575757575,160.43413595000027,166.45418050000006,168.00589819999993,169.33099700000014,167.9539858383802,168.68868546224758,168.50145923076946,171.64388738153312,165.3590310800058,160.43413595000027,166.45418050000006,168.00589819999993,169.33099700000014,170.36666666666667,112106368,129221057.6,58.30459237175722,1.1453893010773348,1.5,2.75,NaN,NaN,1.7475403174174935,0.8675549487222275,579.1664988984912,0.06189755780400924,0.2047073406184836,0.14280978281447437,18.136343993338674,0.9448446911538882,72.2135987480575,6.359812668195935,21.426588583746568,8261907949
1381843800,170.50999,171.14999,169.47,169.7,NaN,NaN,164.7341379310345,175.03319727272728,160.58248595000026,166.49668050000008,167.98589819999995,169.26249650000014,168.02245698197314,168.7850011325097,168.50222846153866,171.64582467958746,165.35863224348986,160.58248595000026,166.49668050000008,167.98589819999995,169.26249650000014,170.10666333333333,155484496,132869123.2,53.6536494635793,0.7116131500612118,1.5,2.75,NaN,NaN,1.7427152947448157,1.1702078876968158,574.5679484022297,0.09554370051967562,0.2622394084640689,0.16669570794439328,18.339188712055964,0.3073708657861872,74.82651692422847,5.287066603823867,19.886416471947665,8106423453
1381930200,170.72,172.16,170.63499,172.07001,NaN,NaN,164.7851724137931,175.11281878787878,160.73078600000025,166.56430060000005,168.03269839999993,169.21344750000011,168.18118455130752,169.09785911988973,168.74538307692325,172.42117200083905,165.06959415300744,160.73078600000025,166.56430060000005,168.03269839999993,169.21344750000011,171.62166666666667,161676064,130779895.2,60.19010684313864,1.4183009598739547,1.5,2.75,NaN,NaN,1.793949916548758,1.2362455540490447,579.2661577134149,0.26135266075462366,0.49338653388767284,0.23203387313304918,19.897293535457568,2.654820427156659,74.78878474689971,5.301915046251601,19.909300206848677,8268099517
1382016600,171.37,173.32001,171.34,173.22,NaN,NaN,164.83620689655172,175.1924403030303,160.86658600000027,166.63350060000008,168.1134985999999,169.2364480000001,168.3787851571386,169.49044396561453,169.14615307692324,173.48933541305973,164.80297074078675,160.86658600000027,166.63350060000008,168.1134985999999,169.2364480000001,172.62667,129389184,129918513.6,62.92263310714754,1.7329641715094084,1.5,2.75,NaN,NaN,1.8072399225095606,0.9959256799871516,585.2288392769877,0.4228522331186459,0.7605991645313566,0.33774693141271067,18.75706356391077,2.5637989223755184,72.0273617787923,6.439706456028813,21.53293176517888,8397488701
1382103000,173.86,174.50999,173.50999,174.388,NaN,NaN,164.88724137931035,175.2720618181818,161.00985550000024,166.72518060000004,168.20525859999995,169.41984800000012,168.61444064117237,169.95687787365125,169.53446076923092,174.70195419286074,164.3669673456011,161.00985550000024,166.72518060000004,168.20525859999995,169.41984800000012,174.13599333333332,138315680,130190900.8,65.51189581830545,2.136152563239241,1.5,2.75,NaN,NaN,1.7702934994731625,1.062406659375384,589.1918088964939,0.5733702805550812,1.0544597821065622,0.481089501551481,18.69430368385174,4.155772809877132,73.69756108428874,5.739503777246369,20.562935138464894,8535804381
1382362200,174.45,174.75,174.00999,174.39999,NaN,NaN,164.93827586206896,175.35168333333334,161.15000545000026,166.81088050000005,168.30705839999996,169.64334800000012,168.84132492975385,170.380031409494,169.93599923076937,175.70691853683337,164.16507992470537,161.15000545000026,166.81088050000005,168.30705839999996,169.64334800000012,174.38666000000003,104103568,130165257.6,65.5385007668618,1.8842647072482368,1.5,2.75,NaN,NaN,1.696701820939366,0.799779986760461,588.0489517536367,0.6340342317483413,1.2736322912369076,0.6395980594885663,17.283051985709175,5.3903734590282895,75.38994080625343,5.145790121325991,19.46426907242057,8639907949
1382448600,174.91,175.92999,174.42619,175.41,NaN,NaN,164.98931034482757,175.43130484848484,161.29720795000026,166.93053040000007,168.43303859999997,169.9373480000001,169.09892003054782,170.85907603716123,170.53523000000013,176.81509356081273,164.25536643918753,161.29720795000026,166.93053040000007,168.43303859999997,169.9373480000001,175.25539333333333,126663248,131181769.6,67.7924395007769,2.130833109196682,1.5,2.75,NaN,NaN,1.6847945480151256,0.9655552626422262,592.8071683313053,0.697445484192744,1.5114049147294963,0.8139594305367523,14.055054040014474,5.923906647107086,99.99999999999999,0,0,8766571197
1382535000,174.81,174.89,173.96001,174.57001,NaN,NaN,165.0403448275862,175.51092636363637,161.44230995000026,167.03273040000008,168.53223879999993,170.21384900000007,169.31347257836947,171.21249831933636,170.972153846154,177.51809014735616,164.4262175449518,161.44230995000026,167.03273040000008,168.53223879999993,170.21384900000007,174.47334000000004,105484368,130590663.2,64.04099002051422,1.3887404931656446,1.5,2.75,NaN,NaN,1.6680227945854729,0.8077481606663591,590.644749237321,0.6396022718021663,1.6134622702894603,0.973859998487294,15.104757718875204,3.1920612401726127,81.33622815199533,3.063761812385131,15.600010035619539,8661086829
1382621400,174.92,175.37,174.50999,175.14999,NaN,NaN,165.09137931034482,175.59054787878787,161.5884599000003,167.14863030000006,168.66043839999995,170.48684850000006,169.54235561451185,171.58749752701863,171.56600000000012,178.11952082943193,165.0124791705683,161.5884599000003,167.14863030000006,168.66043839999995,170.48684850000006,175.00999333333334,70350432,130250840.8,65.46213037257874,1.4898793330508853,1.5,2.75,NaN,NaN,1.610307594972226,0.5401149932538478,592.6280125414067,0.5979527318527216,1.721300913303196,1.1233481814504744,11.11946595496996,2.872078167043247,79.03850147774357,3.810788114510829,17.1507104077456,8731437261
1382707800,175.50999,176,175.17,175.95,NaN,NaN,165.14241379310346,175.6701693939394,161.7328099000003,167.29541030000007,168.8518384,170.83889850000006,169.79363578649176,172.00297395301686,172.37138461538473,178.2765517836765,166.46621744709296,161.7328099000003,167.29541030000007,168.8518384,170.83889850000006,175.70666666666662,93625056,129975009.6,67.37733741661322,1.51502323405346,1.5,2.75,NaN,NaN,1.5560006239027813,0.7203312105006376,594.343606436053,0.581315355113105,1.8499923753418557,1.2686770202287507,10.989558479786414,2.9308529308529256,76.8966311644926,4.572639640574132,18.530729194933247,8825062317
1382967000,175.89,176.47,175.7,176.23,NaN,NaN,165.19344827586207,175.7497909090909,161.8786098500003,167.43041030000006,169.05983839999996,171.24989900000006,170.04604222623718,172.40554786225334,173.18907615384626,177.9503330436678,168.42781926402472,161.8786098500003,167.43041030000006,169.05983839999996,171.24989900000006,176.13333333333333,84979018,127027091.7,68.04522481615916,1.546555978275527,1.5,2.75,NaN,NaN,1.4998577221954403,0.6689834181254423,592.5991836797557,0.5467165178438107,1.952072667533514,1.4053561496897033,11.019714788621984,3.8479670005892763,74.11589736810357,5.571923531242792,20.312179100653623,8910041335
1383053400,176.63,177.24,176.38,177.17,NaN,NaN,165.24448275862068,175.82941242424243,162.02960985000027,167.55411030000008,169.30783839999995,171.64139900000004,170.3254131193259,172.8593052087054,173.80446076923087,178.39367212835293,169.2152494101088,162.02960985000027,167.55411030000008,169.30783839999995,171.64139900000004,176.92999999999998,87401344,125039137.3,70.24745387356933,1.6697446805515506,1.5,2.75,NaN,NaN,1.4648678848957675,0.6989918987548869,594.9885540799011,0.5435470938934304,2.0847900170564913,1.5412429231630609,8.865005993492117,2.963904052774793,71.50854637844012,6.667017526084328,21.824436095475562,8997442679
1383139800,177.38,177.51,175.66,176.29,NaN,NaN,165.29551724137932,175.90903393939394,162.17570980000028,167.66901030000008,169.52203839999999,171.99689950000004,170.55931848719547,173.18603804597154,174.2683076923078,178.53861406106364,169.99800132355193,162.17570980000028,167.66901030000008,169.52203839999999,171.99689950000004,176.48666666666665,140001834,126371741.8,65.68368409779995,1.214610561373166,1.5,2.75,NaN,NaN,1.4923773216889267,1.107857120633594,591.3874313235398,0.44285616183973975,2.0948131254627356,1.6519569636229958,7.983310137637736,1.7723126659739021,63.429697986813984,10.623646517622227,25.946655495563796,8857440845
1383226200,176.15,176.89,175.53,175.79,NaN,NaN,165.34655172413792,175.98865545454547,162.31940980000027,167.79593020000007,169.74663840000002,172.40539950000004,170.76444325240348,173.4340344225457,174.6413846153847,178.5121396948775,170.7706295358919,162.31940980000027,167.79593020000007,169.74663840000002,172.40539950000004,176.06999999999996,133795417,124226591.05,63.17241843236211,0.9922489862024452,1.5,2.75,NaN,NaN,1.4829217987111452,1.0770271957808828,588.9884066990442,0.30956037633189704,2.038907434037867,1.72934705770597,7.999559604772968,0.8039544005321391,33.037480627220596,33.64041650958687,33.32210286319255,8723645428
1383312600,176.02,176.61,175.22,176.21,NaN,NaN,165.39758620689653,176.06827696969697,162.46045980000028,167.94053020000007,169.9496384,172.77139950000006,170.97799449740728,173.69841209658895,175.14215384615395,177.82985721193054,172.45445048037735,162.46045980000028,167.94053020000007,169.9496384,172.77139950000006,176.01333333333335,142805050,126522925.15,64.40355368735025,0.694994769049285,1.5,2.75,NaN,NaN,1.476284527374636,1.1286891275292332,586.7727598614161,0.2208227856740752,2.005375539798564,1.7845527541244888,7.3185660632911125,1.037849830151943,38.82028304397954,28.14223690316237,33.037480052858086,8866450478
1383575400,176.69,176.9,175.9825,176.83,NaN,NaN,165.44862068965517,176.1478984848485,162.6029598000003,168.0667301000001,170.15383839999998,173.24140000000006,171.20748490927366,173.9966585635805,175.50830692307701,177.66701432376502,173.349599522389,162.6029598000003,168.0667301000001,170.15383839999998,173.24140000000006,176.57083333333333,85676773,125992007.8,66.19985117673366,0.8736299307122376,1.5,2.75,NaN,NaN,1.4363713468478776,0.6800175225082808,589.9956617795939,0.17692541241390392,2.0057095196418686,1.8287841072279647,7.417338288302371,0.8095319537084635,39.07218905292492,27.921453125176694,33.00635782189838,8952127251
1383661800,176.14,176.75,175.57,176.27,NaN,NaN,165.49965517241378,176.22752,162.73865980000028,168.1976801000001,170.35923839999998,173.78090000000003,171.40601491283155,174.21316727181093,175.74292230769242,177.4770421848286,174.00880243055624,162.73865980000028,168.1976801000001,170.35923839999998,173.78090000000003,176.1966666666667,85824778,121382499.5,63.10244046342245,0.7090289072137601,1.5,2.75,NaN,NaN,1.423773393501602,0.7070605594177932,585.9039110244252,0.0877260994543998,1.9384417315459643,1.8507156320915645,7.2548876876790915,0.9738156055556243,20.41045353985476,48.23490904330382,31.35463741684141,8866302473
1383748200,177.03,177.5,176.54,177.17,NaN,NaN,165.55068965517242,176.3071415151515,162.8776598000003,168.3249801000001,170.6360384,174.35939950000005,171.6320535437009,174.49477038878132,175.95692230769242,177.6556726594179,174.25817195596696,162.8776598000003,168.3249801000001,170.6360384,174.35939950000005,177.06999999999996,87347728,117301245.1,65.866584654875,0.8723226592979311,1.5,2.75,NaN,NaN,1.4099324368229154,0.7446445084665176,587.2441708112934,0.06778222736396589,1.935443416296522,1.867661188932556,6.82535481941162,1.1533029490895117,46.7936840107561,21.505807881763122,31.700508107480783,8953650201
1383834600,177.5,177.64,174.76,174.93,NaN,NaN,165.60172413793103,176.38676303030303,163.0052598000003,168.4169301000001,170.8564384,174.64739950000003,171.76138477728125,174.53622082794502,175.99769230769243,177.5654068784081,174.42997773697675,163.0052598000003,168.4169301000001,170.8564384,174.64739950000003,175.77666666666664,157000422,115353528.6,54.85247338309632,0.28364966274040515,1.5,2.75,NaN,NaN,1.5149372627641353,1.361037012958787,582.72062132002,-0.10825013915447057,1.732348514989468,1.8405986541439385,10.468134338539208,-0.5797101449275259,43.38830289788962,24.218461468564453,32.39323563354592,8796649779
1383921000,174.87,177.31,174.85,177.29,NaN,NaN,165.65275862068964,176.46638454545453,163.1404598000003,168.5553301000001,171.11883840000002,174.99890000000002,171.97819321738785,174.79848551099786,176.14230769230784,177.8101408484611,174.4744745361546,163.1404598000003,168.5553301000001,171.11883840000002,174.99890000000002,176.48333333333332,136712623,116937172.55,62.0522498836937,0.5806299371149615,1.5,2.75,NaN,NaN,1.582441743995269,1.1691117547890464,582.34562132002,-0.07907986498605024,1.7417488229113758,1.820828687897426,12.864936693588778,0.6014866935255078,42.801485905675484,24.704102064364072,32.494412029960436,8933362402
1384180200,177.12,177.53,176.91,177.32,NaN,NaN,165.70379310344828,176.54600606060606,163.2767097500003,168.73453020000008,171.3922386,175.31790000000004,172.18767583631382,175.03862974804568,176.35384538461554,177.86009204632106,174.84759872291002,163.2767097500003,168.73453020000008,171.3922386,175.31790000000004,177.25333333333333,62614326,114462570.45,62.13491417237028,0.7689130197522073,1.5,2.75,NaN,NaN,1.5136959051384642,0.547028830069402,583.4305135498946,-0.07133662273099128,1.7316579094836868,1.802994532214678,12.857194290361337,0.08466444657673743,40.66411098096181,26.546712574257437,32.789176444780736,8995976728
1384266600,176.94,177.36,176.37,176.96,NaN,NaN,165.7548275862069,176.62562757575756,163.4082097500003,168.91343010000008,171.6436386,175.68090000000004,172.37482580351718,175.22161739108896,176.4930769230771,177.85629448830167,175.12985935785252,163.4082097500003,168.91343010000008,171.6436386,175.68090000000004,176.89666666666668,83989617,110887826.5,60.433631333545456,0.46079187981650493,1.5,2.75,NaN,NaN,1.4762890547714316,0.7574286524589784,580.4231964658551,-0.10215564081851936,1.6752999811915288,1.7774556220100481,12.562718996472277,0.3800555902206682,40.8825794199493,26.35759742244671,32.75982315760399,8911987111
1384353000,176.09,178.4261,176.09,178.38,NaN,NaN,165.8058620689655,176.7052490909091,163.5497597000003,169.12663010000009,171.8962386,175.99639950000005,172.61032283083023,175.52241573479478,176.68000000000018,178.33026804347824,175.0297319565221,163.5497597000003,169.12663010000009,171.8962386,175.99639950000005,177.6320333333333,103844266,107996236.6,64.5560616043815,0.812033575752368,1.5,2.75,NaN,NaN,1.537704122287757,0.9615544880940787,582.5743475485065,-0.04170087779468434,1.7253295247666927,1.767030402561377,12.925518278400073,1.4733488821889775,42.9226375886963,24.6293017842435,32.4480606270602,9015831377
1384439400,178.54,179.42,178.25,179.27,NaN,NaN,165.85689655172413,176.7848706060606,163.6976097000003,169.33358010000006,172.16243839999998,176.29889950000006,172.8714866413859,175.87932852195718,176.91384615384635,179.03666776612803,174.79102454156467,163.6976097000003,169.33358010000006,172.16243839999998,176.29889950000006,178.98,103435238,106698539.3,66.88490094666105,1.349487016929878,1.5,2.75,NaN,NaN,1.511439542124345,0.9694156890861955,585.8212773585716,0.03906506730067827,1.815861736687225,1.7767966693865467,12.81442504648438,1.736564326655696,80.86518167137905,3.166177983714147,15.96864034490681,9119266615
1384525800,179.56,180.12,179.33,180.05,NaN,NaN,165.90793103448274,176.86449212121212,163.84165965000028,169.53268010000008,172.44263859999998,176.58199950000008,173.1529969691747,176.27653532938982,177.1353846153848,179.84022489656166,174.43054433420792,163.84165965000028,169.53268010000008,172.44263859999998,176.58199950000008,179.83333333333334,102818190,104923664.8,68.81857300667812,1.4210657156011512,1.5,2.75,NaN,NaN,1.464193860544034,0.979933270497048,588.2536972784593,0.12121880331381663,1.9283201735288173,1.8071013702150007,12.88694576237446,1.8209579822428312,79.32770890522447,3.6622431544585394,17.010047940316987,9222084805
1384785000,180.35,180.5,179.02,179.42,NaN,NaN,165.95896551724138,176.94411363636362,163.99108465000026,169.71608010000003,172.6783586,176.83300000000008,173.39876179391294,176.57591291706697,177.37615384615404,180.28654412883924,174.46576356346884,163.99108465000026,169.71608010000003,172.6783586,176.83300000000008,179.64666666666668,104796009,104958286.85,65.49215608001371,1.1580802065625095,1.5,2.75,NaN,NaN,1.465322870505174,0.99845388244349,585.5969813480513,0.10967655703810264,1.9441970665126291,1.8345205094745265,13.240138324761,1.7870312588642294,53.27133982999594,16.93124089633523,29.79741927366883,9117288796
1384871400,179.33,179.87,178.72,179.03,NaN,NaN,166.01,177.02373515151515,164.13098465000024,169.90218010000004,172.88155859999998,177.0140000000001,173.61959466473988,176.80963549639392,177.62538461538483,180.50451499032096,174.7462542404487,164.13098465000024,169.90218010000004,172.88155859999998,177.0140000000001,179.20666666666668,93891416,103319695.25,63.44761855572444,0.7901854368110464,1.5,2.75,NaN,NaN,1.4427998083262334,0.9087465441396566,582.4275894434353,0.05507881213647137,1.9033690246451158,1.8482902125086444,13.124939567089879,1.049839137551512,51.35204867050889,18.263234916426377,30.384716413064726,9023397380
1384957800,179.39,179.93,177.98,178.47,NaN,NaN,166.0610344827586,177.10335666666666,164.26753465000024,170.07328010000003,173.0629588,177.2089995000001,173.80980663867166,176.9677654491183,177.79923076923097,180.58698930128696,175.01147223717498,164.26753465000024,170.07328010000003,173.0629588,177.2089995000001,178.79333333333332,124908601,104290906.9,60.525792320642225,0.5067956406014733,1.5,2.75,NaN,NaN,1.4790283934457895,1.19769407240623,579.1819630155957,-0.03461771977719108,1.8050180627871555,1.8396357825643466,13.162034869980253,2.0236666095009386,21.937830985039152,46.405293278531346,31.656875736429495,8898488779
1385044200,178.97,180.05,178.86,179.91,NaN,NaN,166.11206896551724,177.18297818181819,164.41228460000025,170.26028000000005,173.28215879999996,177.4470000000001,174.04902990774335,177.247978263488,178.03615384615404,180.97365187585874,175.09865581644934,164.41228460000025,170.26028000000005,173.28215879999996,177.4470000000001,179.60666666666668,92841271,105415448.85,64.99041872444059,0.9233519682237248,1.5,2.75,NaN,NaN,1.4862406510568054,0.8807178835059336,583.5234030147,-0.013897222572964107,1.8222642543481413,1.8361614769211054,10.531333237439762,1.4778047267189378,20.573941896291046,48.18628209056153,31.23977601314743,8991330050
1385130600,179.98,180.83,179.77,180.81,NaN,NaN,166.16310344827585,177.2625996969697,164.55733460000022,170.45558000000008,173.51175879999994,177.6900000000001,174.31416598979263,177.5872184288701,178.3853846153848,181.47548409482962,175.29528513593996,164.55733460000022,170.45558000000008,173.51175879999994,177.6900000000001,180.47000000000003,81295887,104798990.4,67.46704202518069,1.1593013725621704,1.5,2.75,NaN,NaN,1.4557948902670337,0.775731585673749,585.3823154805132,0.040514462766430226,1.8868045553791433,1.846290092612713,8.312790587350888,1.9681930972253605,17.704547982798534,52.14810312907801,30.147348888123467,9072625937
1385389800,181.13,181.17,180.37,180.63,NaN,NaN,166.2141379310345,177.34222121212122,164.7016346000002,170.63168000000007,173.71815879999994,177.9100000000001,174.5618457548988,177.87700714993008,178.65153846153865,181.87040444582442,175.43267247725288,164.7016346000002,170.63168000000007,173.71815879999994,177.9100000000001,180.72333333333333,79485709,104524324.95,66.45450217167449,1.0470371561039902,1.5,2.75,NaN,NaN,1.4089523981051015,0.7604517803680874,583.7940703726905,0.044175364086668445,1.9015092977210486,1.8573339336343802,8.43070984020415,2.0739150090415843,18.22285612218846,51.232745935320374,30.544397942491166,8993140228
1385476200,180.72,181.22,180.405,180.68,NaN,NaN,166.2651724137931,177.42184272727272,164.84493460000024,170.7990299000001,173.91035859999997,178.08550000000008,174.80177337235375,178.14395884993675,179.09384615384636,181.65960336354425,176.52808894414846,164.84493460000024,170.7990299000001,173.91035859999997,178.08550000000008,180.76833333333335,86993560,104503935.75,66.60443317872857,1.044735884898796,1.5,2.75,NaN,NaN,1.3665272268118798,0.8324429063428839,585.8949732984461,0.030412124780763605,1.8953490896103347,1.864936964829571,8.141571846801076,1.289382217737421,42.50494666876362,24.944577418293903,32.55047591294248,9080133788
1385562600,180.87,181.24,180.65,181.12,NaN,NaN,166.3162068965517,177.50146424242425,164.98977960000025,170.95892990000007,174.0717388,178.32700000000008,175.04954696559477,178.42739134041898,179.38846153846174,181.93755906990862,176.83936400701486,164.98977960000025,170.95892990000007,174.0717388,178.32700000000008,181.00333333333333,58800056,100443846.85,67.96148655320835,0.9181357329986212,1.5,2.75,NaN,NaN,1.311060996325317,0.5854022704627228,587.4996824855237,0.031268836943954215,1.9040230110095138,1.8727541740655596,7.24186303892738,1.0319629608969678,76.65100322220376,4.5927653930526064,18.75623138474365,9138933844
1385735400,181.32,181.75,180.8,181,NaN,NaN,166.36724137931034,181.75,165.13332965000026,171.11700990000008,174.23653899999996,178.5875000000001,175.28289806498321,178.67240168895052,179.67153846153863,182.05061192246797,177.2924650006093,165.13332965000026,171.11700990000008,174.23653899999996,178.5875000000001,181.1833333333333,55870903,96547621.15,67.15993468949834,0.8596635928757616,1.5,2.75,NaN,NaN,1.2852709251592223,0.578687515388876,589.5856717835192,0.005434981442865583,1.8795479008691416,1.874112919426276,6.977015702308457,0.5276312135517848,51.784111945782534,17.835608676055358,30.380279378162104,9083062941
1385994600,181.09,181.43,180.25,180.53,NaN,NaN,166.41827586206895,181.9129998,165.27542965000026,171.24790990000008,174.432739,178.8035000000001,175.48866676831722,178.84931581381238,179.94615384615403,181.76900939907637,178.1232982932317,165.27542965000026,171.24790990000008,174.432739,178.8035000000001,180.73666666666668,99725781,94393657.7,63.977235987734204,0.5784839728996597,1.5,2.75,NaN,NaN,1.2777515733621354,1.056488152169571,585.6389106966375,-0.058122321152412004,1.801460017985761,1.859582339138173,6.882899062380271,0.6186601270761418,20.601744956787616,48.06478251450415,31.333472528708228,8983337160
1386081000,179.94,180.39,179.17,179.75,NaN,NaN,166.46931034482756,182.0759996,165.40792965000026,171.3703100000001,174.6291392,178.9495000000001,175.65577787544203,178.93509526011596,180.05153846153866,181.6438632477539,178.4592136753234,165.40792965000026,171.3703100000001,174.6291392,178.9495000000001,179.76999999999998,116563302,95937984.15,58.98168002263851,0.061766235235464366,1.5,2.75,NaN,NaN,1.2836264609791268,1.214985941519806,582.7093580889834,-0.16164317399286698,1.6575283716470892,1.8191715456399562,7.061768913441725,0.4021672345416963,17.033340276200985,53.03804050675917,29.92861921703984,8866773858
1386167400,179.1,180.48,178.35,179.73,NaN,NaN,166.5203448275862,182.2389994,165.5498796500003,171.4860600000001,174.83313919999998,179.12250000000012,175.81555129209136,179.01080047343825,180.08692307692326,181.6278196114529,178.5460265423936,165.5498796500003,171.4860600000001,174.83313919999998,179.12250000000012,179.51999999999998,123032637,97798377.1,58.854780445272766,0.12895261539749514,1.5,2.75,NaN,NaN,1.344081713766332,1.2580232990389777,579.6029131755816,-0.2359158297463828,1.5242767584569776,1.7601925882033604,6.907401344074331,0.7060010085728643,2.1062299037777423,84.6019030774972,13.29186701872506,8743741221
1386253800,179.41,179.74,178.7701,178.94,NaN,NaN,166.5713793103448,182.4019992,165.6924796500003,171.60021010000008,175.0311394,179.2110000000001,175.9380786924015,179.00405757120603,180.00153846153864,181.65970883700393,178.34336808607335,165.6924796500003,171.60021010000008,175.0311394,179.2110000000001,179.15003333333334,106934067,98777694.05,53.91992854145105,0.3218113002459465,1.5,2.75,NaN,NaN,1.3173544484973079,1.082573024491454,576.3241939134307,-0.336564688095911,1.3394867280834717,1.6760514161793827,7.177474439445476,-0.5391584681229498,0,100,0,8636807154
1386340200,180.67,181.11,180.15,180.94,NaN,NaN,166.62241379310345,182.564999,165.83772965000034,171.73010910000008,175.2561394,179.51150000000013,176.13423246917006,179.188433040615,180.1184615384617,181.81013974306575,178.42678333385766,165.83772965000034,171.73010910000008,175.2561394,179.51150000000013,180.73333333333335,127727518,97314048.85,62.49389745259429,0.5673964481577431,1.5,2.75,NaN,NaN,1.378257702176073,1.3125290696400822,580.321351994777,-0.2696510787161792,1.3389875677841587,1.608638646500338,8.49116435324424,0.07189867817045266,6.6201316337416145,71.68788639858501,21.691981967673385,8764534672
1386599400,181.47,181.67,181.16,181.4,NaN,NaN,166.67344827586206,182.7279988,165.99972965000035,171.85540910000012,175.5059594,179.71700000000013,176.34073315665358,179.39905846531832,180.3007692307694,181.9947669882663,178.6067714732725,165.99972965000035,171.85540910000012,175.5059594,179.71700000000013,181.41,70123608,93984598.1,64.14629783362909,0.7510879558387213,1.5,2.75,NaN,NaN,1.331953580592067,0.7461180812348445,580.9392663754304,-0.19888489568734213,1.3600325268911604,1.5589174225785025,8.134276636040253,0.4262857775563363,18.238469912125066,51.24581906248919,30.515711025385748,8834658280
1386685800,180.98,181.36,180.635,180.75,NaN,NaN,166.72448275862067,182.8909986,166.15337965000035,171.97120910000012,175.76075959999997,179.8885000000001,176.51364558188286,179.52771956385942,180.47615384615403,181.80934062310664,179.14296706920143,166.15337965000035,171.97120910000012,175.76075959999997,179.8885000000001,180.915,80976207,94902692.15,60.11594353205911,0.4244095088993125,1.5,2.75,NaN,NaN,1.2914568962640633,0.8532551096865801,578.7672518591752,-0.1997979823119973,1.309169944688506,1.5089679270005032,8.418963658299955,0.03874252822669536,20.958289212097878,47.5359987249024,31.50571206299974,8753682073
1386772200,180.81,180.85,178.5,178.72,NaN,NaN,166.7755172413793,183.0539984,166.28742965000035,172.06340910000014,175.94835959999997,179.9765000000001,176.6001692845541,179.4507938911109,180.38461538461556,181.99526485484964,178.77396591438148,166.28742965000035,172.06340910000014,175.94835959999997,179.9765000000001,179.35666666666668,130590810,97232751.8,49.628489877844984,0.4952822798990957,1.5,2.75,NaN,NaN,1.3670671179594869,1.3430742993740923,573.1088997004153,-0.33320337703931235,1.0924637057013626,1.425667082740675,10.634214362484888,-1.325088339222618,20.387239988215665,48.29283890687914,31.319921104905195,8623091263
1386858600,178.64,178.86,177.76,178.13,NaN,NaN,166.82655172413791,183.2169982,166.42002965000032,172.15330910000014,176.12735979999994,179.9640000000001,176.66016264594415,179.32500399671937,180.17846153846173,182.16154144535997,178.1953816315635,166.42002965000032,172.15330910000014,176.12735979999994,179.9640000000001,178.25,115564840,97818780.5,47.05890559687674,0.805461652701722,1.5,2.75,NaN,NaN,1.3479908952480966,1.181417713544282,570.9730631540456,-0.45000217865543957,0.8631643594213756,1.3131665380768152,10.447321144920338,-1.5856353591160246,19.739705437287437,49.164795790052665,31.0954987726599,8507526423
1386945000,178.5,178.66,177.77,178.11,NaN,NaN,166.87758620689652,183.379998,166.5500296500003,172.24920910000014,176.33715979999994,179.90600000000012,176.71701901276987,179.20928933036515,179.98461538461558,182.2287272066566,177.74050356257456,166.5500296500003,172.24920910000014,176.33715979999994,179.90600000000012,178.18,107807610,98037399.1,46.970125381697386,0.7185457664000189,1.5,2.75,NaN,NaN,1.3152772598732316,1.099657997760979,573.1904189366539,-0.5128677888837283,0.6720818019721548,1.1849495908558831,10.471325563804884,-1.34049742425081,2.395837212417783,83.48727778340081,14.116885004181395,8399718813
1387204200,178.95,179.81,178.9,179.216,NaN,NaN,166.92862068965516,183.5429978,166.68150965000032,172.35206920000016,176.54367979999995,179.8643000000001,176.81501826717104,179.20992844175896,179.87200000000018,182.1121554891017,177.63184451089867,166.68150965000032,172.35206920000016,176.54367979999995,179.8643000000001,179.30866666666668,96194790,97706229.1,52.32639221526534,0.06489730831939479,1.5,2.75,NaN,NaN,1.3427574555965713,0.9845307805457002,576.6579150666828,-0.46560598154898414,0.6029421139196529,1.068548095468637,11.343579014559907,-0.2970792767732917,4.147346273742183,77.91906382351496,17.933589902742856,8495913603
1387290600,179.36,179.41,178.25,178.65,NaN,NaN,166.97965517241377,183.7059976,166.80330970000034,172.44746920000017,176.76807999999994,179.8258000000001,176.88697833512512,179.1566019234962,179.68200000000022,181.88521052452253,177.4787894754779,166.80330970000034,172.44746920000017,176.76807999999994,179.8258000000001,178.76999999999998,89886224,96960739.85,49.56719986662808,0.3046530055148876,1.5,2.75,NaN,NaN,1.3297033516253873,0.9270373157120666,575.3422052061989,-0.45743790813404084,0.496750710301086,0.9541886184351268,11.227563153654794,-0.6009013520280332,4.018626280491299,78.28668289977568,17.69469081973303,8406027379
1387377000,178.92,181.73,177.32,181.7,NaN,NaN,177.32,183.8689974,166.93930970000034,172.57856920000017,177.09247999999997,179.95930000000007,177.07572428276728,179.39883031173466,179.73584615384635,182.09403657430585,177.37765573338686,166.93930970000034,172.57856920000017,177.09247999999997,179.95930000000007,180.25,234906482,104011493.15,61.383930668922034,0.4897714576233208,1.5,2.75,NaN,NaN,1.5497245407950024,2.2584665875455707,580.9067614072167,-0.24239394778658252,0.6511961837018987,0.8935901314884812,15.089387723875273,1.5424164524421544,37.09976838178524,29.75476761212382,33.14546400609094,8640933861
1387463400,181.19,181.7,180.71,181.49,NaN,NaN,177.58102040816325,184.0319972,167.07287970000033,172.70758920000017,177.41027979999996,180.11030000000008,177.24883313442348,179.5979893296647,179.80969230769247,182.31807424212374,177.3013103732612,167.07287970000033,172.70758920000017,177.41027979999996,180.11030000000008,181.29999999999998,136298872,104581006.7,60.335686020222255,0.8706912912529258,1.5,2.75,NaN,NaN,1.509744216452501,1.3032851403982517,578.3210865851026,-0.11645026831377059,0.748027296096268,0.8644775644100385,14.769026984686723,0.30396816624295975,34.655833038186124,32.08055879637924,33.26360816543463,8504634989
1387549800,180.67,181.99,180.5683,181.56,NaN,NaN,177.84204081632652,184.194997,167.20347970000032,172.8360891000002,177.65807979999994,180.1928000000001,177.417898501701,179.78484748874425,179.94892307692322,182.623989771882,177.27385638196444,167.20347970000032,172.8360891000002,177.65807979999994,180.1928000000001,181.3727666666667,197086908,109793288.55,60.577352919639786,0.8819858080405973,1.5,2.75,NaN,NaN,1.5034553438487521,1.7950724548180956,582.9968767534731,-0.03482073493805793,0.8209516457374662,0.8557723806755241,13.415168780031452,0.0882028665931624,63.43563478473351,10.642972341478757,25.921392873787727,8701721897
1387809000,182.41,182.64,182.065,182.53,NaN,NaN,178.10306122448978,184.3579968,167.3359797000003,172.9547891000002,177.90347999999994,180.2788000000001,177.61837307026173,180.04629058505432,180.16430769230786,183.16522523246633,177.1633901521494,167.3359797000003,172.9547891000002,177.90347999999994,180.2788000000001,182.41166666666666,85597541,110008371.25,63.863047041745,1.0519040942682392,1.5,2.75,NaN,NaN,1.4732085335738403,0.7781002484390478,586.9235298640958,0.07226965608005631,0.9461094507755945,0.8738397946955382,13.674650420500642,0.9847856154910103,63.44421014731505,10.665629403343782,25.89016044934117,8787319438
1387895400,182.54,183.01,182.53,182.93,NaN,NaN,178.36408163265304,184.5209966,167.47222975000034,173.0745891000002,178.14327999999995,180.39380000000008,177.82667216554557,180.32092957695392,180.4712307692309,183.71484680966398,177.22761472879785,167.47222975000034,173.0745891000002,178.14327999999995,180.39380000000008,182.82333333333335,45368841,108302527.85,65.15284480273712,1.3331243970655793,1.5,2.75,NaN,NaN,1.4022650668899939,0.4189084216283138,590.0671508560694,0.15316377861308006,1.0652945179618882,0.9121307393488082,13.423980471628006,2.3556401074306224,78.15028645168061,4.079221787177789,17.770491761141592,8832688279
1388068200,183.34,183.96,183.32,183.855,NaN,NaN,178.62510204081633,184.6839964,167.61197975000036,173.20613910000017,178.4263799999999,180.55255000000008,178.06307717866144,180.6575077124821,180.6954615384617,184.40697846785255,176.98394460907085,167.61197975000036,173.20613910000017,178.4263799999999,180.55255000000008,183.71166666666667,63365227,107121111.2,67.99744457845583,1.4002030345275254,1.5,2.75,NaN,NaN,1.3756747049692801,0.5915288432892956,591.6585680533034,0.24655316626226742,1.2203221971766425,0.9737690309143751,10.903436827835886,3.213944871722896,69.74725246204643,7.495715952851949,22.757031585101615,8896053506
1388154600,184.1,184.18,183.66,183.845,NaN,NaN,178.8861224489796,184.8469962,167.74755475000035,173.3472891000002,178.66187979999992,180.68880000000007,178.28981925008648,180.9610784065314,180.8835384615386,184.94965674771424,176.81742017536294,167.74755475000035,173.3472891000002,178.66187979999992,180.68880000000007,183.89499999999998,61813841,107271800.45,67.93288259919919,1.227423179235456,1.5,2.75,NaN,NaN,1.3145550831857609,0.5762356997896365,592.8427022995118,0.2826472577855448,1.327078103146306,1.0444308453607611,10.381882831055613,3.2199202739879764,85.28243619638276,1.934331023490331,12.783232780126909,8834239665
1388413800,183.87,184.02,183.58,183.82,NaN,NaN,179.14714285714285,185.009996,167.88750475000035,173.49368920000018,178.8738797999999,180.8298000000001,178.50668908341643,181.23335665352843,181.11969230769245,185.47376254383815,176.76562207154674,167.88750475000035,173.49368920000018,178.8738797999999,180.8298000000001,183.80666666666673,56857458,107321128.2,67.75966970568696,1.009994523358238,1.5,2.75,NaN,NaN,1.2520868629582063,0.5297881130548905,592.278301389611,0.2793361805397041,1.3936010710353912,1.114264890495687,10.384617306883733,2.5689670565128027,53.09400638416188,17.076094842096694,29.82989877374143,8777382207
1388500200,184.07,184.69,183.93,184.69,NaN,NaN,179.40816326530611,185.1729958,168.03610475000033,173.64258920000017,179.0799197999999,181.0378000000001,178.74917186445893,181.5625607817638,181.57892307692325,186.08055460758172,177.07729154626477,168.03610475000033,173.64258920000017,179.0799197999999,181.0378000000001,184.43666666666664,86247638,106647221.05,70.57175484794789,1.1344181573516026,1.5,2.75,NaN,NaN,1.2247949441754777,0.8087190378787653,595.4881878029466,0.3079804245123592,1.499240421136136,1.191259996623777,10.261335509104228,3.380912398544636,53.3836647168071,16.87862682552138,29.73770845767152,8863629845
1388673000,183.98,184.07,182.48,182.92,NaN,NaN,179.66918367346938,185.3359956,168.17765475000033,173.77868920000014,179.25031999999993,181.1963000000001,178.9127337521272,181.69184070731012,181.94738461538478,186.0235335171991,177.87123571357046,168.17765475000033,173.77868920000014,179.25031999999993,181.1963000000001,183.15666666666664,119636836,106800897.75,59.24907440169019,0.4004567207790051,1.5,2.75,NaN,NaN,1.29516673387723,1.1201856774654313,591.6979111398126,0.18597148398176344,1.4237243516009812,1.2377528676192178,12.172404486022332,0.6714364336818927,21.74502575160671,46.688847739694715,31.56612650869856,8743993009
1388759400,183.21,183.6,182.63,182.885,NaN,NaN,179.93020408163264,185.4989954,168.31362975000033,173.91642930000012,179.39981999999992,181.3540500000001,179.0685088991026,181.80547492566154,182.31469230769244,185.75197319947074,178.87741141591414,168.31362975000033,173.91642930000012,179.39981999999992,181.3540500000001,183.03833333333333,81390502,104718791,59.04733158904082,0.3308215887827953,1.5,2.75,NaN,NaN,1.2719405386002849,0.7772291985303764,594.8164484131629,0.08623173640802695,1.3455425381292514,1.2593108017212244,7.899636265257575,0.768637390489824,6.274673327987165,72.5832128788359,21.14211379317694,8662602507
1389018600,183.47,183.56,182.08,182.36,NaN,NaN,180.1912244897959,185.6619952,168.45363480000032,174.04392930000012,179.55561979999996,181.52505000000008,179.19758698149073,181.8582868375033,182.55653846153862,185.49373855323617,179.61933836984107,168.45363480000032,174.04392930000012,179.55561979999996,181.52505000000008,182.66666666666666,108028139,104773494.6,55.968834771333675,0.10706812582008723,1.5,2.75,NaN,NaN,1.2868019287002639,1.0310636236046669,593.1646096109272,-0.02578878490716985,1.2270748205872621,1.252863605494432,8.101869914680512,0.4406256884776445,4.56694813978058,76.73049585891447,18.702556001304952,8554574368
1389105000,183.09,183.79,182.95,183.48,NaN,NaN,180.45224489795916,185.824995,168.59303475000033,174.1913292000001,179.72221999999994,181.6520500000001,179.36552474692246,182.01273571012203,182.92807692307707,184.83639288812304,181.0197609580311,168.59303475000033,174.1913292000001,179.72221999999994,181.6520500000001,183.40666666666667,86144169,102694327.15,60.67871184400478,0.4889156541200386,1.5,2.75,NaN,NaN,1.2970303623645292,0.8388405804945185,596.5869835937293,-0.034595521615545355,1.2096192034750004,1.2442147250905458,8.721556809989913,0.5204623897441454,17.395566505867386,52.43140205038003,30.17303144375258,8640718537
1389191400,183.45,183.83,182.89,183.52,NaN,NaN,180.71326530612245,185.9879948,168.73588475000034,174.3627292000001,179.87361999999993,181.75805000000008,179.52844534508236,182.1562846901104,183.0680769230771,184.85889340407053,181.27726044208364,168.73588475000034,174.3627292000001,179.87361999999993,181.75805000000008,183.41333333333336,96582234,104017258.45,60.83982118153618,0.36433011767802714,1.5,2.75,NaN,NaN,1.2715281936242075,0.9285212419478067,594.8038719372458,-0.047092420756293496,1.185349199145179,1.2324416199014725,8.28801257140024,0.32252774285245905,18.721285261587283,50.54522812480315,30.733486613609546,8737300771
1389277800,184.1,184.13,182.795,183.64,NaN,NaN,180.9742857142857,186.1509946,168.8731347500003,174.54082920000008,180.02181999999993,181.90255000000008,179.6896827825301,182.29759091009987,183.23346153846165,184.7929505307789,181.6739725461444,168.8731347500003,174.54082920000008,180.02181999999993,181.90255000000008,183.52166666666665,90683302,104502613.2,61.35142339759093,0.35343828441070063,1.5,2.75,NaN,NaN,1.2760618940796218,0.867761094418259,595.4880393921741,-0.05603438785809134,1.1623986350788584,1.2184330229369498,8.223035393518082,-0.11693997987544719,47.08288791922461,21.287335654578207,31.62977642619717,8827984073
1389364200,183.95,184.22,183.01,184.14,NaN,NaN,181.23530612244897,186.3139944,169.0128847500003,174.73452920000008,180.16121999999993,182.17355000000006,179.86420502635244,182.4730584424713,183.4319230769232,184.72251947132557,182.14132668252083,169.0128847500003,174.73452920000008,180.16121999999993,182.17355000000006,183.78999999999996,102026318,103074388.6,63.4916203928041,0.3998762116518997,1.5,2.75,NaN,NaN,1.2713431873596495,0.9898319008801766,598.8952509953903,-0.037901013781766135,1.171056755709742,1.2089577694915081,7.841633591776773,0.1604612581250442,73.74163241835676,5.726898284621067,20.531469297022184,8930010391
1389623400,183.71,184.18,181.34,181.685,NaN,NaN,181.49632653061224,186.4769942,169.1379597500003,174.89557920000007,180.2691199999999,182.35130000000007,179.9356087508092,182.39800525747404,183.36692307692317,184.89579163022802,181.83805452361833,169.1379597500003,174.89557920000007,180.2691199999999,182.35130000000007,182.40166666666664,149891938,104790743.5,49.11131819194022,0.4428947947117657,1.5,2.75,NaN,NaN,1.383390102548246,1.430392923970427,594.233348665511,-0.19224273432875205,0.9686543515805681,1.1608970859093202,11.055922025018639,-1.1614623000761566,66.50003260923657,9.084224413292633,24.41574297747081,8780118453
1389709800,182.28,183.77,181.95,183.67,NaN,NaN,181.7573469387755,186.639994,169.2760597500003,175.08667920000005,180.42671999999988,182.62930000000006,180.08205546646374,182.5191476139051,183.42384615384628,184.93844259080046,181.9092497168921,169.2760597500003,175.08667920000005,180.42671999999988,182.62930000000006,183.12999999999997,105016055,104651165.75,57.494202438496714,0.3104909108464542,1.5,2.75,NaN,NaN,1.4335050952233719,1.0034867194014032,598.0162503067893,-0.16280906733046074,0.9573857517462443,1.120194819076705,13.053664194808423,-0.5522767881314691,67.87510063083546,8.40213808246157,23.722761286702962,8885134508
1389796200,184.1,184.94,183.7102,184.66,NaN,NaN,182.01836734693876,184.94,169.4152597000003,175.27267920000003,180.5957199999999,182.90150000000006,180.261582703073,182.7230383173427,183.48576923076934,185.1263922182421,181.84514624329657,169.4152597000003,175.27267920000003,180.5957199999999,182.90150000000006,184.43673333333334,98525721,104767712.3,60.94930104552435,0.7856537869518654,1.5,2.75,NaN,NaN,1.4218261598502746,0.9404206585887244,599.0747258003036,-0.08285900990178185,1.0166210566994778,1.0994800666012596,13.146538914966545,0.9512355127924826,68.05223769294237,8.31605790358819,23.63170440346943,8983660229
1389882600,184.28,184.6618,183.83,184.42,NaN,NaN,182.27938775510202,185.04290322580644,169.56120970000026,175.45067920000002,180.7475199999999,183.19000000000005,180.4246578911878,182.88465371569103,183.53000000000014,185.2366521433672,181.8233478566331,169.56120970000026,175.45067920000002,180.7475199999999,183.19000000000005,184.30393333333333,72290520,103887927.1,59.68275246855642,0.4971382026109233,1.5,2.75,NaN,NaN,1.3796814341466828,0.6958510196320974,600.8542388423087,-0.05374424578961934,1.0322997593642356,1.086044005153855,11.711851137984414,0.8393252590425659,47.04316837420185,21.421880328404427,31.534951297393732,8911369709
1389969000,184.1,184.45,183.32,183.635,NaN,NaN,182.54040816326528,185.1458064516129,169.70008470000028,175.6270292,180.8948199999999,183.28675000000007,180.55055366016083,182.9561152665776,183.51576923076934,185.2155830040883,181.81595545745037,169.70008470000028,175.6270292,180.8948199999999,183.28675000000007,183.80166666666665,107848616,97535033.8,55.612086995255126,0.20646548908720258,1.5,2.75,NaN,NaN,1.361847045993348,1.105742334812212,598.5016054835105,-0.09267643550269011,0.9701984607754923,1.0628748962781824,12.067259358873025,0.6991664838780309,20.961660756679542,47.645049764126895,31.39328947919356,8803521093
1390314600,184.7,184.77,183.05,184.18,NaN,NaN,182.80142857142857,185.24870967741936,169.84519470000023,175.8355292,181.0350199999999,183.42125000000004,180.69288488917414,183.07267571737972,183.47653846153855,185.08734993702203,181.86572698605508,169.84519470000023,175.8355292,181.0350199999999,183.42125000000004,184,88621138,95151147.1,57.76582142377599,0.27430907224395873,1.5,2.75,NaN,NaN,1.387429399850966,0.9313722503719559,601.9257842171633,-0.08712952664716989,0.95396298796922,1.0410925146163899,11.950706127078382,0.3815129714410383,52.5518564281419,17.410210072553085,30.037933499304998,8892142231
1390401000,184.49,184.57,183.91,184.3,NaN,NaN,183.06244897959184,185.3516129032258,169.98564465000024,176.03942919999997,181.2224199999999,183.55825000000007,180.83434038371632,183.18956374429595,183.5826923076924,185.2145558737624,181.95082874162242,169.98564465000024,176.03942919999997,181.2224199999999,183.55825000000007,184.26,61270816,88360342.5,58.246210090620345,0.4009277890049558,1.5,2.75,NaN,NaN,1.3354701570044683,0.6934198563116706,604.9930571533895,-0.08091867994700874,0.939944164682629,1.0208628446296377,11.496269205858969,0.42502179598953854,46.98343449349275,21.473754796204926,31.542810710302327,8953413047
1390487400,183.36,183.4,181.82,182.79,NaN,NaN,183.3234693877551,185.45451612903224,170.11584465000024,176.22562920000001,181.33241999999987,183.57125000000005,180.91103291768823,183.151510054363,183.57538461538473,185.22047737192952,181.93029185883995,170.11584465000024,176.22562920000001,181.33241999999987,183.57125000000005,182.67,132496880,90705309.45,50.467293721405206,0.6075082214076143,1.5,2.75,NaN,NaN,1.4172222886470076,1.4607400691691261,601.3345580916682,-0.17845563469847237,0.7977933012565472,0.9762489359550196,12.529835169765013,-0.4628621215421446,14.934971771854496,56.275428702820044,28.789599525325453,8820916167
1390573800,181.6,181.66,178.83,178.89,NaN,NaN,183.58448979591836,185.55741935483871,170.21694465000027,176.37802929999998,181.36381999999986,183.36925000000005,180.8317767248377,182.7456519539475,183.30846153846161,186.2616876352558,180.35523544166742,170.21694465000027,176.37802929999998,181.36381999999986,183.36925000000005,179.79333333333332,208677093,98870722.05,36.797956104983825,1.8594293906024437,1.5,2.75,NaN,NaN,1.598849268029363,2.110605532894457,595.0308415605048,-0.4880241331654982,0.3662187694981469,0.8542429026636451,17.3817703136423,-2.8510915607689804,8.837733341174802,66.99791698740513,24.16434967142007,8612239074
1390833000,179.06,179.52,177.12,178.01,NaN,NaN,183.84551020408162,185.66032258064516,170.31104465000027,176.51422929999998,181.38481999999988,183.07700000000006,180.72111881405976,182.29463748214297,182.88769230769242,186.96719758575742,178.80818702962742,170.31104465000027,176.51422929999998,181.38481999999988,183.07700000000006,178.21666666666667,180843004,104744610.9,34.52557523131651,2.218189251849103,1.5,2.75,NaN,NaN,1.6560743203129802,1.7265136835789228,590.2898582155727,-0.7204201528265364,-0.046282288369525304,0.6741378644570111,17.07430188188265,-2.0227316509343156,6.509440748321433,71.87514551188838,21.615413739790192,8431396070
1390919400,178.14,179.3,178.12,179.07,NaN,NaN,184.10653061224488,185.7632258064516,170.41239465000024,176.64742929999997,181.3986199999999,182.83825000000007,180.65636905664564,181.9875291505103,182.54538461538473,187.0769617929359,178.01380743783358,170.41239465000024,176.64742929999997,181.3986199999999,182.83825000000007,178.83,110463152,107177076.45,39.38148489180821,1.6156165684049737,1.5,2.75,NaN,NaN,1.6299261545763402,1.030660246191106,594.3168291423813,-0.766815123423932,-0.28438103982290386,0.4824340836010281,16.51698557759586,-2.504491751510859,7.891644587290131,68.81978820878007,23.288567203929805,8541859222
1391005800,177.56,178.55,176.88,177.35,NaN,NaN,184.36755102040814,185.86612903225807,170.52355465000022,176.76132919999998,181.3602199999999,182.51475000000008,180.52670752501248,181.54585970760456,182.0615384615386,187.30895010864748,176.8141268144297,170.52355465000022,176.76132919999998,181.3602199999999,182.51475000000008,177.59333333333333,216597269,115164067,34.8632017662739,2.036438941942155,1.5,2.75,NaN,NaN,1.6699314292494587,1.8807712739078588,589.8880078735417,-0.8698615175206499,-0.6048928132997844,0.26496870422086555,15.05436399032556,-3.9586266652225723,1.987889709656507,85.02057418012852,12.99153611021497,8325261953
1391092200,178.86,179.81,178.26,179.23,NaN,NaN,184.6285714285714,185.96903225806452,170.63265465000023,176.89322929999994,181.3438199999999,182.24175000000008,180.4758562495218,181.32530164021364,181.68384615384628,186.98502041251524,176.3826718951773,170.63265465000023,176.89322929999994,181.3438199999999,182.24175000000008,179.1,118938051,116798587.65,42.61329188617735,0.966049155919161,1.5,2.75,NaN,NaN,1.7263648985887836,1.0183175446984953,593.98477552068,-0.7712878839947189,-0.6991411507725331,0.07214673322218582,16.39843496344955,-2.8142283917145634,9.825053446192616,64.9339879781601,25.240958575647284,8444200004
1391178600,177.02,179.29,176.92,178.18,NaN,NaN,184.8895918367347,186.07193548387096,170.7480046500002,176.99868929999997,181.3190199999999,182.00475000000006,180.38582267110917,181.02574910305043,181.4142307692309,187.03465758871764,175.79380394974416,170.7480046500002,176.99868929999997,181.3190199999999,182.00475000000006,178.13,194677861,120550638.9,39.767367718713516,1.30355334195946,1.5,2.75,NaN,NaN,1.7723388344038706,1.6149052611947625,591.0622463983977,-0.7367379498212376,-0.8487757040543613,-0.11203775423312362,16.436545828165187,-2.9705666131184056,10.208754297829055,64.2066417488651,25.58460395330584,8249522143
1391437800,177.95,178.37,173.83,174.17,NaN,NaN,185.15061224489796,186.1748387096774,170.84815465000023,177.05168929999996,181.2218199999999,181.56900000000005,180.14206491930096,180.37282061704562,180.68346153846167,187.31933071765926,174.0475923592641,170.84815465000023,177.05168929999996,181.2218199999999,181.56900000000005,175.45666666666668,254837004,129222964,31.198062378124277,2.959833065285916,1.5,2.75,NaN,NaN,1.9700289176607364,1.9720721156032297,585.6670533427131,-0.9313491047830136,-1.2762241352118906,-0.344875030428877,19.8411098463886,-5.434900640677609,8.84779528615409,66.88181639619955,24.270388317646365,7994685139
1391524200,174.95,175.84,174.1055,175.385,NaN,NaN,185.41163265306122,186.27774193548387,170.9476796500002,177.11153939999994,181.16011999999992,181.22025000000005,179.95551335383817,179.8977900820889,179.9700000000001,186.73544273382515,173.20455726617507,170.9476796500002,177.11153939999994,181.16011999999992,181.22025000000005,175.1101666666667,165012351,132072174.6,35.717925132727146,2.194740105210566,1.5,2.75,NaN,NaN,1.9532054235421121,1.249410418960422,587.2068859106728,-0.923822126054259,-1.4996526879967007,-0.5758305619424418,20.565252635061334,-4.837221920781346,12.051205393008148,60.916247019610495,27.032547587381362,8159697490
1391610600,174.79,175.56,173.71,175.17,NaN,NaN,173.71,186.38064516129032,171.0426796500002,177.1737393999999,181.06531999999993,180.80475000000007,179.76784616349158,179.4475243599852,179.25846153846166,185.94742418612452,172.5694988907988,171.0426796500002,177.1737393999999,181.06531999999993,180.80475000000007,174.8133333333333,164230470,135976489.65,35.276299306790506,2.0578488054712767,1.5,2.75,NaN,NaN,1.945833607574818,1.2077857754875494,584.9771554083009,-0.8791471396213616,-1.6747644864691438,-0.7956173468477822,20.408022976437273,-4.168718201214511,13.665173857670732,58.19843481359079,28.136391328738487,7995467020
1391697000,175.58,177.48,175.2209,177.48,NaN,NaN,173.59718750000002,186.48354838709676,171.14117965000023,177.25523939999988,180.99871999999993,180.50275000000005,179.67812670609976,179.26014108760566,178.78500000000014,185.02400633114655,172.54599366885373,171.14117965000023,177.25523939999988,180.99871999999993,180.50275000000005,176.72696666666664,132877526,137791254.25,43.37694668554044,0.877333127965938,1.5,2.75,NaN,NaN,1.9718454927480453,0.9643393314274878,588.9875585468062,-0.650387082942787,-1.608601200526266,-0.958214117583479,22.73614461033614,-0.7881938621499227,14.557047428174162,56.76320811723078,28.679744454595056,8128344546
1391783400,178.31,179.87,177.73,179.68,NaN,NaN,173.484375,186.58645161290323,171.25017965000023,177.34893939999986,180.97971999999993,180.30475000000007,179.67820016860566,179.30012765069083,178.4388461538463,183.89198096696194,172.98571134073066,171.25017965000023,177.34893939999986,180.97971999999993,180.30475000000007,179.09333333333333,170787197,141796449,49.81856315358653,0.5409682221981371,1.5,2.75,NaN,NaN,2.001713671837472,1.2044532723100845,591.0144776581698,-0.3237756300319701,-1.3629336551234417,-1.0391580250914716,20.822321998026883,0.9381495421605618,39.08564473533434,27.94235448002445,32.97200078464121,8299131743
1392042600,179.7,180.07,179.21,180.01,NaN,NaN,173.3715625,186.68935483870968,171.35762965000026,177.43833929999985,180.96631999999994,180.09825000000006,179.69121192669954,179.3677345411012,178.1088461538463,182.5236432201003,173.69404908759228,171.35762965000026,177.43833929999985,180.96631999999994,180.09825000000006,179.76333333333332,92218729,141306069.55,50.72411220340443,0.646994251246116,1.5,2.75,NaN,NaN,1.9201626952776516,0.6526168995689824,593.2742083896339,-0.07155541090587225,-1.1286022887238119,-1.0570468778179396,20.544446184266857,0.5249343832020985,74.1404085011747,5.5847681783996315,20.27482332042566,8391350472
1392129000,180.16,182.439,180.0389,181.98,NaN,NaN,173.25875000000002,186.79225806451612,171.47632960000027,177.52762939999985,180.9835199999999,180.11300000000008,179.78096832173094,179.616521727663,178.0465384615386,182.2110799629871,173.8819969600901,171.47632960000027,177.52762939999985,180.9835199999999,180.11300000000008,181.48596666666666,117814009,139702173.1,55.846484545546964,1.5690266747298682,1.5,2.75,NaN,NaN,1.956508217043534,0.8433226655369759,597.5947021885726,0.22564008133750857,-0.7749967761460539,-1.0006368574835625,21.154705161061077,2.610656893149138,72.26726645535392,6.364291463663263,21.368442080982824,8509164481
1392215400,182.22,182.83,181.705,182.07,NaN,NaN,173.1459375,186.8951612903226,171.59017960000025,177.62072949999987,181.0049199999999,180.03300000000007,179.87073426989835,179.85018632502843,178.291153846154,182.96728004345684,173.61502764885117,171.59017960000025,177.62072949999987,181.0049199999999,180.03300000000007,182.20166666666668,94717638,139187252.25,56.07115575856758,1.4376145802380103,1.5,2.75,NaN,NaN,1.8971147729689959,0.6805051214738669,598.8121640724668,0.4149542372944375,-0.48194406086551567,-0.8968982981599531,19.947753592820188,1.5845561568933793,100.00000000000001,0,0,8603882119
1392301800,180.84,183.2,180.83,183.01,NaN,NaN,173.033125,186.99806451612903,171.7068296500003,177.74362949999986,181.0545199999999,179.9505000000001,179.99384272990233,180.15112096074,178.67576923076936,183.97686903850908,173.37466942302964,171.7068296500003,177.74362949999986,181.0545199999999,179.9505000000001,182.34666666666666,100542155,139288073.95,58.449260236101836,1.599309635576611,1.5,2.75,NaN,NaN,1.9308922891854945,0.7218288841878269,602.3464572224722,0.5800255503953616,-0.17186636016575108,-0.7518919105611127,19.398184896120554,2.710741946346382,100.00000000000001,0,0,8704424274
1392388200,182.84,184.36,182.67,184.02,NaN,NaN,172.92031250000002,187.10096774193548,171.83552965000027,177.88452959999984,181.1399199999999,179.9305000000001,180.15173125029833,180.51958563114573,179.05653846153857,185.07831865401056,173.03475826906657,171.83552965000027,177.88452959999984,181.1399199999999,179.9305000000001,183.6833333333333,96498305,140498463.2,60.89861396435114,1.8551448735262284,1.5,2.75,NaN,NaN,1.9136856971008183,0.6868281887370851,605.5316779476278,0.7243938491666536,0.15360040089720428,-0.5707934482694493,18.779806470876135,5.6553941551358005,100.00000000000001,0,0,8800922579
1392733800,184.19,184.49,183.65,184.24,NaN,NaN,172.8075,187.20387096774192,171.95797965000028,178.03162959999986,181.2301199999999,179.9607500000001,180.31205551499252,180.87391080913184,179.58653846153857,186.10645514884874,173.0666217742284,171.95797965000028,178.03162959999986,181.2301199999999,179.9607500000001,184.12666666666667,80460878,139129076.3,61.43193242710968,1.7261670382861776,1.5,2.75,NaN,NaN,1.8369938615936172,0.5783182073781942,608.5784826456556,0.7961508803332614,0.4243951521471274,-0.371755728186134,9.313129260155266,5.048892436639404,100,0,0,8881383457
1392820200,183.76,184.95,182.87,183.02,NaN,NaN,172.69468750000001,187.3067741935484,172.06623965000026,178.17142969999986,181.31171999999992,179.9027500000001,180.41824941636537,181.0783002558812,179.87807692307703,186.64250598928297,173.1136478568711,172.06623965000026,178.17142969999986,181.31171999999992,179.9027500000001,183.61333333333334,126524261,141024232.45,56.8049043725662,1.1990204514873588,1.5,2.75,NaN,NaN,1.8543514429083578,0.897180993662625,605.3851253427223,0.7249229287341593,0.5343979327315651,-0.19052499600259418,11.58638263891595,4.481360963635339,70.0272500221064,7.3535521364565914,22.619197841437007,8754859196
1392906600,183.27,184.52,182.6,184.1,NaN,NaN,172.58187500000003,187.40967741935484,172.17783965000024,178.31552969999987,181.37491999999992,179.8927500000001,180.56263179219417,181.3660811838925,180.33346153846165,187.3708817220406,173.2960413548827,172.17783965000024,178.31552969999987,181.37491999999992,179.8927500000001,183.74,104998099,143210596.6,59.69874826377938,1.339797236379003,1.5,2.75,NaN,NaN,1.859040625557762,0.7331726945686086,608.4568746105429,0.7129370277276053,0.7006462886569125,-0.012290739070692835,11.061980361033433,3.7299977462249294,70.8063621522624,7.000953959368728,22.192683888368897,8859857295
1392993000,184.49,184.89,183.8,183.89,NaN,NaN,172.4690625,187.51258064516128,172.28429015000023,178.46533969999984,181.4247199999999,179.9477500000001,180.69311681995126,181.60645440447416,181.08115384615394,187.36545192684008,174.7968557654678,172.28429015000023,178.46533969999984,181.4247199999999,179.9477500000001,184.1933333333333,118116359,142491570.55,58.87283239122132,1.1425546974671261,1.5,2.75,NaN,NaN,1.8041091523036346,0.8289357647198731,609.6658156601968,0.6547615030364341,0.8061611397248498,0.1513996366884157,10.221914543809493,2.3430543187889468,39.93646124274561,27.207076311861233,32.85646244539317,8741740936
1393252200,184.28,186.15,184.2,184.91,NaN,NaN,172.35625000000002,187.61548387096775,172.39214015000027,178.63433979999988,181.5079199999999,180.2487500000001,180.8584847877963,181.92107779452425,181.8138461538462,187.45941099422234,176.1682813134701,172.39214015000027,178.63433979999988,181.5079199999999,180.2487500000001,185.08666666666664,114063868,137760909.3,61.64820824966721,1.6362686204992,1.5,2.75,NaN,NaN,1.8366727842819477,0.82798428508921,612.4200594013821,0.6476882667819109,0.9610099701658044,0.3133217033838934,8.726874081060673,2.722070996055778,43.21874620004522,24.514643166667803,32.26661063328699,8855804804
1393338600,185.03,185.59,184.23,184.84,NaN,NaN,172.24343750000003,187.7183870967742,172.50193515000024,178.78933979999988,181.63031999999993,180.5902500000001,181.01462263925526,182.19907038552194,182.55769230769238,186.90454725455066,178.2108373608341,172.50193515000024,178.78933979999988,181.63031999999993,180.5902500000001,184.88666666666666,117084901,134573004.15,61.342268862793524,1.1096126535387478,1.5,2.75,NaN,NaN,1.8026247282618095,0.8700474641220974,611.1054661792004,0.6019782795009733,1.06579455276011,0.46381627325913677,8.912865023148845,1.5716012748653774,20.659494271297486,48.09354851903058,31.246957209671912,8738719903
1393425000,185.11,185.6,184.33,184.85,NaN,NaN,172.130625,187.82129032258064,172.6091351500002,178.94603989999985,181.76471999999995,180.8792500000001,181.16502959457858,182.4515398726151,183.12461538461545,186.48514295661556,179.76408781261534,172.6091351500002,178.94603989999985,181.76471999999995,180.8792500000001,184.92666666666668,98677144,133983703.75,61.37176101633376,0.9755179751515011,1.5,2.75,NaN,NaN,1.7645801048145362,0.7364861639003617,613.6626551996435,0.5381811010991021,1.1365426496330144,0.5983615485339123,7.2698968610604,1.526885263909486,46.531620573705226,21.855716022618882,31.61266340367588,8837397047
1393511400,184.59,185.87,184.37,185.82,NaN,NaN,172.01781250000002,187.92419354838708,172.72053520000023,179.12803989999986,181.91891999999993,181.30275000000012,181.34757745361472,182.7723455990327,183.59692307692316,186.59448500536138,180.59936114848495,172.72053520000023,179.12803989999986,181.91891999999993,181.30275000000012,185.35333333333335,93880780,127847879.3,64.22298080531986,1.102527834973003,1.5,2.75,NaN,NaN,1.745681525899212,0.7343162867778598,616.9555471284656,0.5264299088941498,1.2563989346515996,0.7299690257574498,7.518433115894165,1.5354352221190113,45.38556264063425,22.7565681728452,31.857869186520567,8931277827
1393597800,185.79,187.15,185.05,186.29,NaN,NaN,171.90500000000003,188.02709677419355,172.82583520000023,179.30203989999987,182.06039999999993,181.6557500000001,181.54139794562983,183.1073603038867,184.08000000000007,186.59490327082034,181.5650967291798,172.82583520000023,179.30203989999987,182.06039999999993,181.6557500000001,186.16333333333333,150842000,129443076.75,65.54984882280456,1.2212618451832857,1.5,2.75,NaN,NaN,1.7709899883349822,1.1653153168734456,619.218779821368,0.5148074772953736,1.3734783723766668,0.8586708950812932,7.268432384216308,1.2335615693946211,77.505150853906,4.3315946811203965,18.163254464973587,9082119827
1393857000,184.69,185.45,183.75,184.98,NaN,NaN,171.7921875,188.13,172.92016015000024,179.47753999999986,182.18699999999993,181.9957500000001,181.6762450850169,183.28570694161178,184.3107692307693,186.5477378050647,182.07380065647388,172.92016015000024,179.47753999999986,182.18699999999993,181.9957500000001,184.72666666666666,167748455,128096606.45,58.98365941241434,0.3735218474044684,1.5,2.75,NaN,NaN,1.825919274882483,1.3095464403694201,616.0297360775476,0.3891062254485941,1.3450536768920358,0.9559474514434417,8.395269443403075,0.4016500217108015,41.613961087155666,25.760301954861458,32.625736957982866,8914371372
1393943400,186.75,187.98,186.75,187.58,NaN,NaN,171.67937500000002,188.23290322580644,173.03136015000027,179.6985399999999,182.3045999999999,182.6662500000001,181.90776488560445,183.69468723288685,184.73461538461544,187.190034701907,182.27919606732388,173.03136015000027,179.6985399999999,182.3045999999999,182.6662500000001,187.4366666666667,167545852,123732048.85,66.2168319012955,1.6412239280250591,1.5,2.75,NaN,NaN,1.9097821838194486,1.354102300553637,620.917897045341,0.44713226020879304,1.5148627767044331,1.06773051649564,11.413787791006403,2.491530980220742,71.1319453469831,6.858480797449048,22.00957385556787,9081917224
1394029800,187.72,188.07,187.45,187.75,NaN,NaN,171.5665625,188.3358064516129,173.13541015000024,179.9200398999999,182.42979999999991,183.28450000000012,182.1368721449925,184.08090749642145,185.09923076923084,187.81581755911978,182.3826439793419,173.13541015000024,179.9200398999999,182.42979999999991,183.28450000000012,187.75666666666666,88376859,119900274.25,66.63118722500099,1.4588195761861469,1.5,2.75,NaN,NaN,1.8176548849752028,0.7370863790997543,620.1984918329265,0.46117715025613104,1.644201954315804,1.183024804059673,10.123279427485212,1.982618142313963,70.68572336079488,7.057612235222085,22.256664403983027,9170294083
1394116200,188.21,188.61,187.7796,188.18,NaN,NaN,171.45375,188.43870967741935,173.24166020000027,180.11013989999992,182.56219999999993,183.93500000000012,182.37385755107124,184.47129725866702,185.41923076923084,188.50665898990417,182.3318025485575,173.24166020000027,180.11013989999992,182.56219999999993,183.93500000000012,188.1898666666667,82516500,115814575.75,67.70999694945979,1.4684842270414191,1.5,2.75,NaN,NaN,1.7492509646198322,0.7124880393131345,622.3417953578618,0.4624607310900706,1.761100717922261,1.2986399868321905,9.898573168224061,2.332916417423471,70.14987946083676,7.300176425564988,22.549944113598265,9252810583
1394202600,188.87,188.96,187.43,188.26,NaN,NaN,171.34093750000002,188.5416129032258,173.3471102000003,180.29013999999992,182.67679999999993,184.4740000000001,182.6046866667155,184.83212609117493,185.72846153846163,189.07583567492838,182.38108740199488,173.3471102000003,180.29013999999992,182.67679999999993,184.4740000000001,188.21666666666664,114513432,114896371.05,67.91781071367002,1.2474962093358353,1.5,2.75,NaN,NaN,1.7335901814327015,0.9966670918628635,619.6754140945958,0.4322882592198385,1.8390003108569886,1.40671205163715,9.745575572042744,1.81169217457141,68.17364932609681,8.22712738625323,23.599223287649963,9367324015
1394458200,187.94,188.23,187.08,188.16,NaN,NaN,171.228125,188.64451612903224,173.4582602500003,180.46233999999993,182.78139999999993,184.89800000000008,182.8225420915502,185.14906646344397,186.12384615384624,189.30843924184205,182.93925306585044,173.4582602500003,180.46233999999993,182.78139999999993,184.89800000000008,187.82333333333335,74939176,110103970,67.33444859092921,0.9041517539919117,1.5,2.75,NaN,NaN,1.6940480256160784,0.6806219248951695,618.459133352754,0.37150898187983916,1.871098278986949,1.4995892971071099,9.64179995245727,1.7961480199091069,84.58163260714704,2.1089765234584354,13.309390869394514,9292384839
1394544600,188.44,188.71,186.8,187.23,NaN,NaN,171.11531250000002,188.7474193548387,173.56716025000034,180.63763999999992,182.84889999999993,185.2590000000001,182.99538357815607,185.34725060978263,186.36461538461546,189.36893653291864,183.36029423631228,173.56716025000034,180.63763999999992,182.84889999999993,185.2590000000001,187.58,99009013,110443484.2,62.000855687311436,0.6605136876617422,1.5,2.75,NaN,NaN,1.7094731666435012,0.8964676704757563,614.9702347023051,0.24091669688803918,1.8007351682171588,1.5598184713291197,10.340653979736022,1.2875304300784396,52.266154766342716,17.551549065462872,30.18229616819441,9193375826
1394631000,186.32,187.35,185.9,187.28,NaN,NaN,171.00250000000003,188.85032258064516,173.67702025000034,180.78973989999992,182.91759999999994,185.52400000000011,183.16340775156172,185.53132198027953,186.62538461538472,189.2951309632813,183.95563826748813,173.67702025000034,180.78973989999992,182.91759999999994,185.52400000000011,186.84333333333333,104824323,109793999.9,62.17433228603898,0.29071303610215854,1.5,2.75,NaN,NaN,1.6909393690261074,0.9547363525827789,617.5131988520066,0.13540504723221436,1.7290747803693876,1.5936697331371732,10.332121876721528,0.7857065977828048,54.13230542197461,16.282548175822964,29.585146402202422,9298200149
1394717400,187.84,187.99,184.66,185.18,NaN,NaN,170.8896875,188.9532258064516,173.77142025000035,180.9093398999999,182.94479999999996,185.6795000000001,183.24248980052008,185.49786274406245,186.64615384615396,189.2659311527339,184.02637653957402,173.77142025000035,180.9093398999999,182.94479999999996,185.6795000000001,185.9433333333333,155014237,112808829.85,51.53319341368678,0.561130114080103,1.5,2.75,NaN,NaN,1.8080151283813863,1.374132124286014,615.9155278744419,-0.08637204376320584,1.4857046784331658,1.5720767221963716,12.204872676767762,-0.5958451876107066,22.57751900089054,45.48740445300729,31.93507654610216,9143185912
1394803800,184.8,185.8,184.44,184.66,NaN,NaN,170.77687500000002,189.05612903225807,173.86862025000036,181.0120598999999,182.94419999999994,185.76200000000009,183.2980784357938,185.41806629224698,186.6323076923078,189.2917252554536,183.97289012916198,173.86862025000036,181.0120598999999,182.94419999999994,185.76200000000009,184.96666666666667,153919598,115477702,49.28387687132144,0.6830880258334204,1.5,2.75,NaN,NaN,1.7760140477827169,1.332894535777998,617.9360646366265,-0.26836737118422915,1.236617508216085,1.5049848794003142,12.129772628951958,-0.17299167477564775,4.1092932719225645,78.04475535048844,17.845951377589,8989266314
1395063000,185.59,186.77,185.51,186.33,NaN,NaN,170.66406250000003,189.1590322580645,173.97112025000035,181.13135999999992,183.01239999999996,185.87750000000008,183.41697732066464,185.5049171215568,186.74615384615393,189.2101660646789,184.28214162762896,173.97112025000035,181.13135999999992,183.01239999999996,185.87750000000008,186.20333333333335,98359454,115570759.45,55.935800005815764,0.15758220577974164,1.5,2.75,NaN,NaN,1.7998701872268097,0.8510756048337104,621.6683561579308,-0.275515416816452,1.1605906083797493,1.4361060251962012,12.62649157152096,-0.6663823435334257,15.608495045568702,55.19184812880653,29.199656825624757,9087625768
1395149400,186.71,187.91,186.51,187.66,NaN,NaN,170.55125,189.26193548387096,174.09219520000036,181.25385999999992,183.10789999999994,186.04850000000005,183.5833703669131,185.71016310997996,186.88769230769236,189.33396613155716,184.44141848382756,174.09219520000036,181.25385999999992,183.10789999999994,186.04850000000005,187.36,101804519,116637941.5,60.39143988750573,0.7355714070138878,1.5,2.75,NaN,NaN,1.784165173853465,0.8728250661042402,626.4343068201058,-0.19376791154665374,1.1938961357628841,1.3876640473095379,10.426301972440575,-0.04793608521970887,35.31722173361586,31.50022213732498,33.18255612905915,9189430287
1395235800,187.7,187.94,185.47,186.66,NaN,NaN,170.43843750000002,189.36483870967743,174.20374515000037,181.37475989999993,183.19389999999993,186.23050000000006,183.7040225093871,185.80062376617235,186.91615384615392,189.34247792194407,184.48982977036377,174.20374515000037,181.37475989999993,183.19389999999993,186.23050000000006,186.68999999999997,176267253,119125091.1,55.82103067665426,0.2731894780411142,1.5,2.75,NaN,NaN,1.8331533757210745,1.4796819995884143,621.7576169039976,-0.20884125690157251,1.1266124761825722,1.3354537330841447,10.84423846785759,-0.8077372728238974,11.897438635923827,61.247270031467174,26.855291332609013,9013163034
1395322200,186.25,187.89,185.92,187.747,NaN,NaN,170.32562500000003,189.46774193548387,174.32468015000038,181.5007299999999,183.27923999999993,186.41285000000005,183.8625706462739,185.9859929312988,187.12900000000005,189.31184049243905,184.94615950756105,174.32468015000038,181.5007299999999,183.27923999999993,186.41285000000005,187.18566666666666,117240972,119737234.75,59.41640752564264,0.5617496269800815,1.5,2.75,NaN,NaN,1.8429281345981405,0.9791521596835607,621.280746640914,-0.1501464101692882,1.1477707203725345,1.2979171305418227,11.359458756187875,-0.2724954849675857,34.30170996359212,32.48767266387551,33.210617372532376,9130404006
1395408600,187.72,189.0239,186.03,186.2,NaN,NaN,170.2128125,189.57064516129032,174.44932015000037,181.60322999999988,183.33283999999992,186.52835000000005,183.95423454249845,186.0063745568894,187.0228461538462,189.2415584409822,184.80413386671017,174.44932015000037,181.60322999999988,183.33283999999992,186.52835000000005,187.0846333333333,163127905,121987812.05,52.82721757048774,0.3066195207225583,1.5,2.75,NaN,NaN,1.925140410698273,1.3372475680860447,623.780746640914,-0.21604548307385874,1.0278602766994993,1.243905759773358,12.236572164848553,-1.041666666666671,33.25175026375103,33.52963941904782,33.21861031720115,8967276101
1395667800,186.82,187.07,184.62,185.43,NaN,NaN,170.10000000000002,189.67354838709676,174.56282015000036,181.6952299999999,183.36863999999994,186.55435000000006,184.0121076976946,185.95148174194756,186.84438461538463,189.17102624110848,184.51774298966077,174.56282015000036,181.6952299999999,183.36863999999994,186.55435000000006,185.70666666666668,121411145,122355175.9,49.86313490147196,0.4774820808241744,1.5,2.75,NaN,NaN,1.9626303813626813,0.9922845037567388,620.5005027475427,-0.30650433658304577,0.860775339044551,1.1672796756275967,12.34991843110272,-0.9613843935266694,13.85387550233885,57.853787889090555,28.29233660857059,8845864956
1395754200,186.37,186.94,185.27,186.31,NaN,NaN,169.98718750000003,189.77645161290323,174.67037015000034,181.78662999999995,183.41203999999993,186.62785000000002,184.10222112131441,185.98562633795257,186.70053846153849,188.90722795774454,184.49384896533243,174.67037015000034,181.78662999999995,183.41203999999993,186.62785000000002,186.17333333333332,103851737,121693517.7,53.10179538787787,0.09584801010377361,1.5,2.75,NaN,NaN,1.941728211265346,0.853387583519578,622.6898835800504,-0.30161705151439233,0.7902583612346064,1.0918754127489987,12.595717271048708,-0.5179410508329767,13.97228102918924,57.6618957979479,28.36582317286286,8949716693
1395840600,187.03,187.34,184.92,184.97,NaN,NaN,169.87437500000001,189.87935483870967,174.77122015000035,181.87342999999993,183.47773999999993,186.63385000000002,184.1362516655766,185.88890002005232,186.44746153846154,188.63526164401924,184.25966143290384,174.77122015000035,181.87342999999993,183.47773999999993,186.63385000000002,185.74333333333334,119842897,122751805.35,48.01555364595745,0.2884949835567219,1.5,2.75,NaN,NaN,1.975890481889251,0.9763025208329452,621.1132687616137,-0.37821262090992125,0.6191096366115971,0.9973222575215184,13.149421019408729,-0.11340317528891239,16.849662939138177,53.223296591758746,29.92704046910308,8829873796
1395927000,184.77,185.34,183.9,184.58,NaN,NaN,169.76156250000003,189.98225806451612,174.87863010000035,181.96132999999995,183.49593999999993,186.57185,184.15365356104417,185.76424287528542,186.17207692307693,188.32933821556665,184.0148156305872,174.87863010000035,181.96132999999995,183.49593999999993,186.57185,184.60666666666668,142382757,125176904.2,46.616069642487716,0.7340958134566758,1.5,2.75,NaN,NaN,1.937612590325733,1.1374522952933037,622.6362880093141,-0.4403759948881095,0.44685226391138144,0.887228258799491,11.548076706746969,-0.04332286364127807,3.082839894433123,81.11410839060964,15.803051714957224,8687491039
1396013400,185.105,186.42,185,185.49,NaN,NaN,169.64875000000004,190.0851612903226,174.99733010000034,182.05412999999996,183.51253999999994,186.53185000000002,184.2060593037483,185.73812450621062,186.03823076923075,188.13128950323875,183.94517203522275,174.99733010000034,182.05412999999996,183.51253999999994,186.53185000000002,185.63666666666666,101641547,122716881.55,50.25908683225657,0.2456975832883174,1.5,2.75,NaN,NaN,1.9306402624453216,0.8282605108294492,624.8029304861989,-0.40626817265853843,0.37939304297631793,0.7856612156348564,11.787718788009997,-0.4508130735791356,16.31910759402151,54.01150287620893,29.66938952976955,8789132586
1396272600,186.65,187.3,185.5216,187.01,NaN,NaN,169.53593750000002,190.18806451612903,175.11133005000033,182.15592999999993,183.56433999999993,186.63335000000004,184.31601776242485,185.85925550561913,186.0174615384615,188.06569869654217,183.96922438038084,175.11133005000033,182.15592999999993,183.56433999999993,186.63335000000004,186.61053333333336,99744911,119316704.35,55.69742850433318,0.5282667562351638,1.5,2.75,NaN,NaN,1.9220231008420845,0.8359677007790235,628.4953095791872,-0.27375267585684604,0.4434703708137988,0.7172230466706448,11.572629994023135,-0.3463710966641829,39.15091403542567,27.83996497448586,33.009120990088476,8888877497
1396359000,187.62,188.36,187.0015,188.25,NaN,NaN,169.42312500000003,190.29096774193548,175.2367050500003,182.27572999999992,183.65663999999992,186.66685000000004,184.47029157566308,186.08694545746494,186.25361538461536,188.5536179984876,183.95361277074312,175.2367050500003,182.27572999999992,183.65663999999992,186.66685000000004,187.8705,89193125,115399068,59.57993771186464,0.8975011978863443,1.5,2.75,NaN,NaN,1.881771450781937,0.7729102716843432,630.3323288413214,-0.10374884456684152,0.5875369909620929,0.6912858355289344,11.468547063183497,0.8518161362905836,37.55842524198253,29.28327883119712,33.15829592682035,8978070622
1396445400,188.5,189.13,188.14,188.88,NaN,NaN,169.31031250000004,190.39387096774192,175.3589050500003,182.39282999999995,183.75063999999992,186.72335000000004,184.64322131779394,186.35295065199207,186.57823076923074,189.07012213048242,184.08633940797907,175.3589050500003,182.39282999999995,183.75063999999992,186.72335000000004,188.71666666666667,78773818,114918915.95,61.42939195994932,1.0970949909833385,1.5,2.75,NaN,NaN,1.8180734900117994,0.6854730341719691,632.2812170211857,0.04214775643069635,0.7439705310673048,0.7018227746366085,10.974484497961196,0.6034716932893635,65.90897619243212,9.315960660640844,24.775063146927035,9056844440
1396531800,189.17,189.22,188.05,188.63,NaN,NaN,169.19750000000002,190.4967741935484,175.47338005000026,182.52982999999998,183.83723999999992,186.74585000000008,184.79956557984124,186.5698124946595,186.75515384615386,189.4682085362703,184.0420991560374,175.47338005000026,182.52982999999998,183.83723999999992,186.74585000000008,188.63333333333333,77435320,114664856.95,60.25125214475387,0.8746575469355616,1.5,2.75,NaN,NaN,1.771782526439527,0.6753186814140093,630.0894738068112,0.10903066418652729,0.8381111048697676,0.7290804406832403,10.633528858068875,1.305048335123527,79.83518504981063,3.4857245211529073,16.679090429036453,8979409120
1396618200,189.64,189.7,186.1,186.4,NaN,NaN,169.08468750000003,189.7,175.5881300500003,182.62092999999996,183.90943999999988,186.6528500000001,184.86232771396513,186.55363987612049,186.65823076923078,189.32468495800924,183.99177658045232,175.5881300500003,182.62092999999996,183.90943999999988,186.6528500000001,187.39999999999998,169380705,117408220.6,50.87781983578646,0.38215109825901455,1.5,2.75,NaN,NaN,1.9023694888367033,1.4426647821966907,628.9299398419529,-0.003724270072524072,0.7244251030925852,0.7281493731651093,11.85195844152527,0.5231084506282688,36.594851203629275,30.17845356695147,33.22669522941926,8810028415
1396877400,185.9,186.26,183.96,184.34,NaN,NaN,168.97187500000004,189.78654545454543,175.71283010000028,182.69113,184.0184399999999,186.46185000000008,184.8418442742018,186.34281703077568,186.47976923076928,189.41850722823727,183.54103123330128,175.71283010000028,182.69113,184.0184399999999,186.46185000000008,184.85333333333335,140802699,120701396.75,44.058931591840796,1.0480517042847117,1.5,2.75,NaN,NaN,1.94077166820551,1.1665374452263744,625.0890170137717,-0.21230443235683627,0.462768832719064,0.6750732650759003,13.343604612525517,-1.0573774891310175,12.0599770618551,60.85669539413983,27.083327544005076,8669225716
1396963800,184.21,185.4,183.59,185.1,NaN,NaN,168.85906250000002,189.8730909090909,175.84298005000025,182.77252999999996,184.1602399999999,186.3553500000001,184.8519680281547,186.22445350403513,186.2761538461539,189.20224379126896,183.35006390103885,175.84298005000025,182.77252999999996,184.1602399999999,186.3553500000001,184.69666666666672,112659755,121383933.85,46.88716728946301,0.8821205505240296,1.5,2.75,NaN,NaN,1.9314308347622595,0.9281274006098625,628.2700963989877,-0.28956217764294234,0.31312054302222236,0.6026827206651647,13.257746234645861,0.07028166729739713,14.379600452537025,56.999486755605716,28.620912791857265,8781885471
1397050200,185.6,187.15,185.06,187.09,NaN,NaN,168.74625000000003,189.95963636363635,175.99313005000025,182.85962999999995,184.3206399999999,186.3458500000001,184.9397339878349,186.30688650365082,186.34461538461545,189.30185542205925,183.38737534717166,175.99313005000025,182.85962999999995,184.3206399999999,186.3458500000001,186.43333333333337,100253612,121155398.3,53.51433630048965,0.13964850271385698,1.5,2.75,NaN,NaN,1.9427572037078125,0.8274795296513008,630.4604831496888,-0.20130390015132782,0.3510528454760049,0.5523567456273327,13.974898473952058,1.359843970094263,16.607628976564456,53.572843159839294,29.81952786359627,8882139083
1397136600,187.09,187.17,182.93,183.155,NaN,NaN,168.63343750000004,190.0461818181818,176.11603005000026,182.89847999999995,184.43673999999993,186.2446000000001,184.8697444196845,186.00670683663645,186.1696153846155,189.56015076674473,182.77908000248627,176.11603005000026,182.89847999999995,184.43673999999993,186.2446000000001,184.41833333333332,172959331,122052653,42.28015361284868,1.2061543581203078,1.5,2.75,NaN,NaN,2.106845974871539,1.4170878448664284,627.7758280001603,-0.39159087671845105,0.06286814972926891,0.45445902644771996,19.003907951223383,-1.2588279691627624,12.264206700734286,60.503481453721825,27.23231184554388,8709179752
1397223000,182.17,183.42,181.31,181.51,NaN,NaN,181.31,190.13272727272727,176.22288005000027,182.91307999999992,184.48233999999994,186.0871000000001,184.73798973655963,185.57844904267108,185.8003846153847,189.99859387013905,181.60217536063035,176.22288005000027,182.91307999999992,184.48233999999994,186.0871000000001,182.08,167250792,122719212.7,38.62930302416696,1.9154535537758577,1.5,2.75,NaN,NaN,2.1070712623807135,1.3628737368847217,623.8364729109968,-0.5994544995041661,-0.29485909793248766,0.3045954015716784,19.15856818631393,-2.941019196834394,12.515466897482437,60.07277075339224,27.41176234912533,8541928960
1397482200,182.93,183.37,181.44,182.9401,NaN,NaN,181.47521739130434,190.2192727272727,176.33218055000026,182.94828099999995,184.5775419999999,185.9176050000001,184.66748425669454,185.32717770527384,185.64423846153855,190.09761579601872,181.19086112705838,176.33218055000026,182.94828099999995,184.5775419999999,185.9176050000001,182.58336666666665,132381601,124420320.05,43.21960347065131,1.3698874245972719,1.5,2.75,NaN,NaN,2.094423315067806,1.0639869833705673,626.8184004573822,-0.6098262929714369,-0.45768746464261767,0.1521388283288192,19.097694027232833,-2.8206640106241694,33.163059335263014,33.543013615449674,33.2939270492873,8674310561
1397568600,183.32,184.33,181.51,184.2,NaN,NaN,181.6404347826087,190.30581818181818,176.45108055000026,182.99998099999996,184.77814199999995,185.7446050000001,184.64915154074572,185.21982744762872,185.61500769230776,190.10081316870023,181.12920221591529,176.45108055000026,182.99998099999996,184.77814199999995,185.7446050000001,183.34666666666666,157092533,127184720.75,46.981944871998955,0.8310517912904002,1.5,2.75,NaN,NaN,2.146250221134393,1.2351525566407315,629.5829722402913,-0.5053421762272162,-0.47953889195520105,0.025803284272015142,19.141062321635456,-2.4777636594663317,37.203085596884435,29.645328710784163,33.151585692331395,8831403094
1397655000,185.47,186.14,184.65,186.125,NaN,NaN,181.80565217391305,190.39236363636363,176.57490555000027,183.07653099999996,184.99294199999994,185.7178550000001,184.70702795091256,185.30603435737837,185.66385384615393,190.15697381518586,181.170733877122,176.57490555000027,183.07653099999996,184.99294199999994,185.7178550000001,185.63833333333332,105196633,123631189.75,52.194135575595745,0.3689716247016456,1.5,2.75,NaN,NaN,2.1315180624819363,0.8508907275965125,633.6968280379353,-0.2907489248977637,-0.33763287185018953,-0.0468839469524258,20.27662137305383,-1.3279966071144544,37.59503382313226,29.283311546560338,33.1216546303074,8936599727
1397741400,185.88,186.91,185.56,186.39,NaN,NaN,181.97086956521738,190.47890909090907,176.70080550000023,183.14133099999995,185.21734199999992,185.6500050000001,184.77302685479833,185.40926918048518,185.61616153846165,190.06404858983703,181.16827448708628,176.70080550000023,183.14133099999995,185.21734199999992,185.6500050000001,186.2866666666667,105254649,123031873.6,52.88087743958215,0.7255458953367526,1.5,2.75,NaN,NaN,2.075695343733226,0.8555071618449287,635.0436274339623,-0.12366538033695154,-0.20146567237361523,-0.07780029203666369,20.344807465093204,-0.005364806866963158,68.71722327403774,7.950291102907889,23.332485623054364,9041854376
1398087000,186.44,187.1,186.21,187.04,NaN,NaN,182.13608695652175,190.56545454545454,176.82960550000024,183.20363099999994,185.40854199999995,185.6920050000001,184.8619277624533,185.56457687758183,185.5230846153847,189.7937217617628,181.2524474690066,176.82960550000024,183.20363099999994,185.40854199999995,185.6920050000001,186.78333333333333,68329343,118291945.5,54.60348759374926,0.7662849450947565,1.5,2.75,NaN,NaN,1.9910028191808515,0.577633098442869,637.702068272557,0.02973286392545489,-0.04063421212984508,-0.07036707605529997,19.27412968876517,1.464684821525436,100,0,0,9110183719
1398173400,187.23,188.4,187.13,187.89,NaN,NaN,182.3013043478261,190.652,176.95395550000026,183.27623099999994,185.57274199999992,185.8150050000001,184.98067569333747,185.78604574638356,185.44693076923085,189.50544984540105,181.38841169306065,176.95395550000026,183.27623099999994,185.57274199999992,185.8150050000001,187.80666666666664,85790307,116510903.6,56.82628305187834,1.1992928688525861,1.5,2.75,NaN,NaN,1.9459311892393631,0.7363285696807522,639.8924728791138,0.17920780319861512,0.15364267794296893,-0.025565125255646193,17.91834732423432,1.5072933549432697,100,0,0,9195974026
1398259800,187.81,187.92,187.3,187.45,NaN,NaN,182.46652173913043,190.73854545454543,177.07148045000022,183.34393099999994,185.72154199999994,185.87200500000012,185.0775119406576,185.94451758006133,185.3561615384616,189.1713487793981,181.5409742975251,177.07148045000022,183.34393099999994,185.72154199999994,185.87200500000012,187.5566666666667,73869384,115011785.95,55.31637954682047,0.7914504525206619,1.5,2.75,NaN,NaN,1.851221818579407,0.6422766448658908,639.1716345871667,0.23565473044093896,0.2690032877955275,0.033348557354588554,18.010162370293365,0.19242076006199435,81.10728988617969,3.092995752979212,15.799714360841094,9122104642
1398346200,188.37,188.39,186.93,187.83,NaN,NaN,182.6317391304348,190.8250909090909,177.18498045000027,183.41103099999998,185.83854199999993,186.01500500000012,185.18545264886708,186.1240873343412,185.4661615384616,189.47303457482917,181.459288502094,177.18498045000027,183.41103099999998,185.83854199999993,186.01500500000012,187.71666666666667,88169916,113428136.9,56.39399024473672,0.7806582053710294,1.5,2.75,NaN,NaN,1.8232774029665908,0.7773196175983386,639.7592042385597,0.2826278403260267,0.38663335776212193,0.10400551743609524,17.01072975231278,2.5524828697005333,80.28318989213192,3.3521864546449973,16.364623653223088,9210274558
1398432600,187.21,187.33,185.87,186.29,NaN,NaN,182.79695652173913,190.91163636363635,177.29047045000024,183.46393099999997,185.92294199999998,186.1005050000001,185.22876823126444,186.13988854059443,185.61616153846157,189.58902419445687,181.64329888246627,177.29047045000024,183.46393099999997,185.92294199999998,186.1005050000001,186.49666666666667,100380205,111328009.3,51.0235932925375,0.10538403640648084,1.5,2.75,NaN,NaN,1.833043302754692,0.9016617258420698,636.4971030218857,0.19802645644262887,0.3515385879893813,0.15351213154675244,11.79957765872754,2.6334637210071077,46.32588202893261,21.900422717296305,31.77369525377108,9109894353
1398691800,187.05,187.69,184.96,186.875,NaN,NaN,182.96217391304347,190.9981818181818,177.38764545000024,183.527381,186.00024199999996,186.16975500000012,185.2933263398423,186.2098991557759,185.75270000000003,189.76700972092286,181.7383902790772,177.38764545000024,183.527381,186.00024199999996,186.16975500000012,186.50833333333333,135121094,113001986.65,52.860057384057335,0.07914135199357542,1.5,2.75,NaN,NaN,1.897111638272213,1.1957408715167928,637.5344990292958,0.17055286648865914,0.3667032146575764,0.19615034816891724,9.625542681959342,2.150922624400008,51.964048346795224,17.742499556468186,30.293452096736583,9245015447
1398778200,187.48,188.04,187.08,187.75,NaN,NaN,183.12739130434784,191.08472727272726,177.48884550000025,183.60738099999998,186.07484199999996,186.2067550000001,185.3896664833779,186.3565754266544,185.80346923076925,189.89999858914427,181.70693987239423,177.48884550000025,183.60738099999998,186.07484199999996,186.2067550000001,187.62333333333333,84097551,112219618.65,55.54510493942575,0.657071229652102,1.5,2.75,NaN,NaN,1.8448179498241972,0.7494015040479733,640.0256598737499,0.1984444800288172,0.44420594820493875,0.24576146817612154,9.19356619331515,1.927252985884914,51.76876024659131,17.8788251249039,30.352414628504786,9329112998
1398864600,187.44,188.5,187.18,188.31,NaN,NaN,183.29260869565218,191.1712727272727,177.58962050000025,183.693181,186.15624199999993,186.20975500000011,185.5041893663827,186.5426158622111,186.2000076923077,190.1909280800699,182.2090873045455,177.58962050000025,183.693181,186.15624199999993,186.20975500000011,187.99666666666667,101507717,112835348.25,57.2243876817669,0.7076432544263285,1.5,2.75,NaN,NaN,1.8073309534081827,0.899609196712875,643.1140998583476,0.23902094683261782,0.5445376517168938,0.305516704884276,8.796317232720625,1.1739422431161866,75.91845064898314,4.87944601404451,19.20210333697235,9430620715
1398951000,188.22,188.84,187.73,188.325,NaN,NaN,183.45782608695652,191.25781818181818,177.69362055000022,183.787031,186.26234199999996,186.1820050000001,185.61480939123044,186.7123667324767,186.72423846153848,189.79824789405419,183.65022902902277,177.69362055000022,183.787031,186.26234199999996,186.1820050000001,188.29833333333332,93019095,113547612.1,57.27094794307089,0.663024292113661,1.5,2.75,NaN,NaN,1.7575215995933136,0.8192078484052947,645.0776858898453,0.2500955446089337,0.6181361356454431,0.36804059103650943,7.11767110901344,1.0381458232737821,76.18971296706151,4.776972640357409,19.033314392581087,9523639810
1399037400,188.31,189.14,187.78,188.06,NaN,NaN,183.62304347826088,191.34436363636362,177.79417005000022,183.85823100000005,186.34154199999995,186.15350500000008,185.71069921902532,186.84071275795512,187.11807692307696,189.34788387736498,184.88826996878893,177.79417005000022,183.85823100000005,186.34154199999995,186.15350500000008,188.32666666666668,98121662,114581929.2,56.10898865196547,0.6022781221346603,1.5,2.75,NaN,NaN,1.7291271996223616,0.8563449985968642,646.8766755052583,0.22365942950543294,0.6476148779183006,0.4239554484128677,7.265119524786699,0.5453378956373023,76.4779360649541,4.669173247451039,18.852890687594865,9425518148
1399296600,187.14,188.55,186.62,188.42,NaN,NaN,183.78826086956522,191.43090909090907,177.89192005000018,183.92843100000002,186.43214199999994,186.25450500000008,185.8169463084753,186.9911210667213,187.44269230769234,189.0085865736684,185.87679804171628,177.89192005000018,183.92843100000002,186.43214199999994,186.25450500000008,187.86333333333334,75882739,109907030.9,57.37422069891104,0.5110617320220263,1.5,2.75,NaN,NaN,1.7434752567921934,0.6904266121886475,646.2527670624829,0.21447442591400073,0.6920484808053686,0.4775740548913679,7.115136208938524,0.2820799403906547,74.18451199013064,5.542476002795673,20.27301200707368,9501400887
1399383000,188,188.13,186.74,186.78,NaN,NaN,183.95347826086956,191.51745454545454,177.9799700500002,183.988731,186.46954199999996,186.3765050000001,185.85471311990764,186.9710142984621,187.49307692307698,188.92232383864516,186.0638300075088,177.9799700500002,183.988731,186.46954199999996,186.3765050000001,187.21666666666667,85454226,107139607.25,50.26551173177747,0.11458104619009732,1.5,2.75,NaN,NaN,1.7389413098784636,0.7975969689771286,642.8350410547653,0.08845941963881693,0.588148329439889,0.4996889098010721,8.467981463867428,-0.35742864763936383,47.312381783496534,21.099105747323577,31.588512469179875,9415946661
1399469400,187.43,187.97,186.01,187.88,NaN,NaN,184.11869565217393,191.60399999999998,178.07187005000017,184.080331,186.53034199999993,186.5155050000001,185.93413613481323,187.05758436527523,187.6076923076924,188.89682806703422,186.31855654835056,178.07187005000017,184.080331,186.53034199999993,186.5155050000001,187.28666666666666,106500480,106831643.5,54.35095471892143,0.12196373710215876,1.5,2.75,NaN,NaN,1.7547312163157167,0.9969001366154214,645.7069078775164,0.07048232786317543,0.5877918196300413,0.5173094917668659,9.131021163276388,0.026619815790865645,47.91958171321557,20.638652698505926,31.441765588278507,9522447141
1399555800,187.67,189.05,187.08,187.675,NaN,NaN,184.28391304347826,191.69054545454543,178.16454505000019,184.175781,186.58684199999993,186.5447550000001,186.00240530599703,187.11638585429665,187.65653846153856,188.90335832157265,186.40971860150447,178.16454505000019,184.175781,186.58684199999993,186.5447550000001,187.93500000000003,93617513,106499838.55,53.469433156429645,0.27783746259679915,1.5,2.75,NaN,NaN,1.7701075580074512,0.8790390133413024,643.6092901811761,0.03772100194585204,0.5644607441991809,0.5267397422533289,9.081870292260964,0.7434644908476136,21.098158412541977,47.31362370079191,31.58821788666612,9428829628
1399642200,187.69,188.04,186.83,187.96,NaN,NaN,184.4491304347826,191.7770909090909,178.2617450500002,184.27428099999997,186.6296419999999,186.7850050000001,186.07917372536969,187.19673005864936,187.6619230769232,188.91332560372135,186.41052055012503,178.2617450500002,184.27428099999997,186.6296419999999,186.7850050000001,187.61,83678568,102035800.4,54.57254575476607,0.13153423228076563,1.5,2.75,NaN,NaN,1.730099875292632,0.8200902788233531,645.3758375638331,0.028595288803908603,0.5624838532582146,0.533888564454306,7.463230617375644,0.5806020066889674,47.60071475962783,20.87977796245961,31.519507277912567,9512508196
1399901400,188.76,189.88,187.9992,189.785,NaN,NaN,184.61434782608697,191.86363636363635,178.36602010000024,184.37997099999995,186.6995419999999,187.19875500000006,186.22450024594343,187.44323195782562,187.84153846153856,189.51785945437635,186.16521746870077,178.36602010000024,184.37997099999995,186.6995419999999,187.19875500000006,189.2214,86940045,98020263.05,60.9557820553685,0.9854061229056058,1.5,2.75,NaN,NaN,1.743664169914586,0.8869599233339336,649.8834069552215,0.13297633264583808,0.7001089802616036,0.5671326476157655,8.96566577119128,1.0838881491344856,49.22951106846755,19.666322591339604,31.10416634019284,9599448241
1399987800,190.03,190.42,189.77,189.96,NaN,NaN,184.7795652173913,191.9501818181818,178.47027010000022,184.49307099999996,186.79914199999988,187.54975000000007,186.37099043237703,187.6829241523184,188.00538461538474,190.02615545665594,185.98461377411354,178.47027010000022,184.49307099999996,186.79914199999988,187.54975000000007,190.04999999999998,66453965,94723881.25,61.514229833589596,1.0133316311375522,1.5,2.75,NaN,NaN,1.6655453006349712,0.7015544984333082,648.0169888660688,0.197427160714698,0.8139165985091381,0.6164894377944401,8.743270777725328,0.8762147522701957,74.751038521645,5.318019844875424,19.930941633479563,9665902206
1400074200,189.79,189.88,188.79,189.06,NaN,NaN,184.94478260869565,192.03672727272726,178.57262010000025,184.56667099999996,186.82874199999986,187.7927500000001,186.4764417879701,187.81407423304998,188.21846153846167,190.0456804618811,186.39124261504224,178.57262010000025,184.56667099999996,186.82874199999986,187.7927500000001,189.24333333333334,72366848,90487597,56.99897728375748,0.5208385797696066,1.5,2.75,NaN,NaN,1.6301492077324744,0.7997432841541808,645.1670375994289,0.16441791916787607,0.8220118367542852,0.6575939175864092,9.266128301771968,0.390282755874161,46.37046353472628,21.826991155567477,31.802545309706236,9593535358
1400160600,188.67,188.72,186.48,187.4,NaN,NaN,185.11,192.1232727272727,178.66668010000024,184.62577099999996,186.82174199999986,187.8565000000001,186.51265975706931,187.77463859180713,188.25884615384626,189.98597428969418,186.53171801799834,178.66668010000024,184.62577099999996,186.82174199999986,187.8565000000001,187.53333333333333,154956399,92975585.3,49.7460209035515,0.485083838593078,1.5,2.75,NaN,NaN,1.6979956928944413,1.6666353699200644,641.8845423938308,0.02317682689074574,0.6865649511998413,0.6633881243090956,10.674209228677944,-0.350951823885992,35.496972196526045,31.22332420538526,33.27970359808871,9438578959
1400247000,187.51,188.13,186.72,188.05,NaN,NaN,185.27521739130435,192.20981818181818,178.76338005000022,184.69067099999992,186.81914199999986,187.93950000000012,186.57294760973326,187.8008634878255,188.28192307692322,189.989140959732,186.57470519411444,178.76338005000022,184.69067099999992,186.81914199999986,187.93950000000012,187.63333333333335,97457678,92585736.75,52.305246455608795,0.2607595633577458,1.5,2.75,NaN,NaN,1.6774245719734096,1.0526208617117259,645.2991542997559,-0.031131822435589873,0.6244733462646082,0.655605168700198,10.884658930176824,-0.19636981212184276,37.42390855993481,29.41136656751382,33.16472487255137,9536036637
1400506200,187.69,188.89,187.52,188.74,NaN,NaN,185.4404347826087,192.29636363636362,178.8537800500002,184.75277099999997,186.82874199999983,188.02450000000013,186.65793005641038,187.89030506041354,188.3150000000001,190.03968503254367,186.59031496745655,178.8537800500002,184.75277099999997,186.82874199999983,188.02450000000013,188.38333333333333,63839398,92361239.5,54.9291865877863,0.2676667613954803,1.5,2.75,NaN,NaN,1.655465673975307,0.6911925212956892,648.3896268215822,-0.025482289269831204,0.623752307112909,0.6492345963827402,11.042280498528905,1.0493628868187215,34.64768590318112,32.070108812772716,33.28220528404617,9599876035
1400592600,188.645,188.67,187.07,187.55,NaN,NaN,185.60565217391303,192.38290909090907,178.93678005000024,184.79897099999994,186.81654199999983,188.00750000000014,186.6929131914531,187.85789505465988,188.25538461538477,190.02749097411458,186.48327825665496,178.93678005000024,184.79897099999994,186.81654199999983,188.00750000000014,187.76333333333332,111644478,93653948.05,49.83685691565787,0.31748630725007543,1.5,2.75,NaN,NaN,1.6565038401199292,1.1920957986778646,644.3236131063486,-0.1024674154504508,0.5211503270696767,0.6236177425201275,10.398384538601286,-0.17564402810303603,13.996101516906007,57.643964037700904,28.35993444539309,9488231557
1400679000,188.1,189.22,188.06,189.13,NaN,NaN,185.7708695652174,192.46945454545454,179.02893005000024,184.85172099999997,186.8545419999998,188.09150000000017,186.78848522316082,187.97904790659703,188.33769230769246,190.1644069516455,186.51097766373942,179.02893005000024,184.85172099999997,186.8545419999998,188.09150000000017,188.8033333333333,89093285,94415143.1,55.7081286697069,0.3689515506608344,1.5,2.75,NaN,NaN,1.6574678515399335,0.9436334265324013,647.2169989112369,-0.050202184941931405,0.5608650113427132,0.6110671962846446,10.96547402966214,0.7752764086852186,32.53735334125036,34.17051335472919,33.29213330402044,9577324842
1400765400,189.18,189.98,188.86,189.59,NaN,NaN,185.93608695652173,192.55599999999998,179.1282300500002,184.90917099999996,186.9007419999998,188.17950000000016,186.89834854774276,188.13247191549254,188.42769230769247,190.37318657108293,186.482198044302,179.1282300500002,184.90917099999996,186.9007419999998,188.17950000000016,189.4766666666667,61549345,93084114.55,57.275980351465726,0.6916314261326164,1.5,2.75,NaN,NaN,1.619077290715651,0.6612228659804124,650.0371533446036,0.008973472854921227,0.6222840373532961,0.6133105644983748,10.945484646409167,0.8672057884656286,68.38648823372843,8.105855286355485,23.50765647991608,9638874187
1400851800,189.75,190.48,189.5858,190.35,NaN,NaN,186.10130434782607,192.64254545454543,179.2340801000002,184.97447099999994,187.0041419999998,188.38250000000016,187.03370742822344,188.34366506639802,188.70230769230784,190.64780195571328,186.7568134289024,179.2340801000002,184.97447099999994,187.0041419999998,188.38250000000016,190.1386,60156088,91072908.7,59.807418341133776,0.8483098572920093,1.5,2.75,NaN,NaN,1.5673003413788176,0.6605267017237586,653.1850241979091,0.08850321361952829,0.7239395815227851,0.6354363679032569,11.078793417137195,0.2977052981004809,64.88775090758674,9.858865058686124,25.25338403372715,9699030275
1401197400,191.05,191.58,190.95,191.52,NaN,NaN,186.26652173913044,192.7290909090909,179.34268010000017,185.04277099999996,187.1413419999998,188.61475000000016,187.2096404702539,188.64617315531248,188.98230769230784,191.3710686050333,186.5935467795824,179.34268010000017,185.04277099999996,187.1413419999998,188.61475000000016,191.35,72010355,87917371.75,63.40246080562864,1.1889854481262285,1.5,2.75,NaN,NaN,1.5432074598517604,0.8190685591098781,656.5490740909946,0.20258494427573326,0.8886675482479234,0.6860826039721901,10.255269919862535,0.8212255211623511,66.94582213888255,8.864403981069806,24.18977388004765,9771040630
1401283800,191.52,191.82,191.06,191.38,NaN,NaN,186.43173913043478,192.81563636363634,179.45303010000018,185.12737099999998,187.2423419999998,188.79625000000016,187.37318398122434,188.9065376167113,189.26730769230784,191.8410825775108,186.69353280710487,179.45303010000018,185.12737099999998,187.2423419999998,188.79625000000016,191.42,66722865,87048637.45,62.68000053306714,1.1297844787056286,1.5,2.75,NaN,NaN,1.4872640698623483,0.7665009695105802,657.6531789859424,0.24827996831271992,0.99643256436309,0.7481525960503701,10.298254628067955,1.227123664445146,78.76490743319728,3.878757858514653,17.35633470828805,9704317765
1401370200,191.82,192.4,191.33,192.37,NaN,NaN,186.59695652173912,192.9021818181818,179.5693251500002,185.222221,187.33654199999984,188.99925000000016,187.5691375505881,189.2363911770245,189.60653846153858,192.53914922962818,186.67392769344897,179.5693251500002,185.222221,187.33654199999984,188.99925000000016,192.03333333333333,64376573,85192080.25,65.6598977377008,1.191821299640331,1.5,2.75,NaN,NaN,1.4574594934436085,0.7556638224009091,660.8943131231002,0.3202642006882833,1.1484828469107242,0.8282186462224409,9.928146314796637,2.652081109925293,76.98868923987472,4.5093782184599585,18.50193254166533,9768694338
1401456600,192.19,192.8,192.03,192.68,NaN,NaN,186.76217391304348,192.98872727272726,179.68467515000017,185.32542099999998,187.45694199999983,189.21700000000016,187.7695635289964,189.56435392206978,189.8292307692309,193.19056257065532,186.46789896780646,179.68467515000017,185.32542099999998,187.45694199999983,189.21700000000016,192.50333333333333,76315640,84356907.5,66.56029319955236,1.1615538358160675,1.5,2.75,NaN,NaN,1.4083552439119227,0.9046756485235071,661.6366206120583,0.36082650884224965,1.279251782275253,0.9184252734330033,7.344546083664424,2.4621111406540788,78.22552865692408,4.065715565396764,17.708755777679148,9845009978
1401715800,192.95,192.99,191.97,192.895,NaN,NaN,186.92739130434782,193.0752727272727,179.80545010000017,185.419571,187.55990199999985,189.45875000000018,187.9705610376632,189.8815583104441,190.05500000000012,193.79416897389734,186.3158310261029,179.80545010000017,185.419571,187.55990199999985,189.45875000000018,192.61833333333334,64655648,82683606.8,67.2025855803931,1.1388633054807233,1.5,2.75,NaN,NaN,1.3806155836325005,0.781964533264652,660.5806640562344,0.3726827457544901,1.3842787056261159,1.0115959598716258,7.38784950912998,2.2014411359542234,77.75788013460293,4.198202107344414,18.04391775805263,9909665626
1401802200,192.4,192.9,192.25,192.8,NaN,NaN,187.09260869565216,193.16181818181818,179.93755010000018,185.51237099999997,187.69190199999983,189.67775000000017,188.1599508008921,190.15950513802085,190.34269230769243,194.30049009352538,186.38489452185948,179.93755010000018,185.51237099999997,187.69190199999983,189.67775000000017,192.65,65047193,82141829.5,66.59392559026922,0.9498530396969204,1.5,2.75,NaN,NaN,1.3284287562301795,0.7918887781772623,657.9143762043528,0.34529215466394714,1.4432111532015597,1.0979189985376125,7.5404643372755356,2.7992535323913623,49.84798942737718,19.23107737860142,30.92093319402141,9844618433
1401888600,192.47,193.3,192.265,193.19,NaN,NaN,187.25782608695653,193.24836363636362,180.0743501000002,185.607871,187.84710199999984,189.99825000000016,188.35720763222966,190.44812369630458,190.78807692307706,194.62223421381847,186.95391963233564,180.0743501000002,185.607871,187.84710199999984,189.99825000000016,192.91833333333335,55529372,80645586.8,67.88006804343144,0.9787068008619831,1.5,2.75,NaN,NaN,1.3074695593565973,0.6885605797340419,659.1138658917633,0.3249028484500933,1.5040475591002291,1.1791447106501358,5.314013551107663,2.146671601543913,76.89918773060285,4.5075147841715095,18.593297485225634,9900147805
1401975000,193.41,194.65,192.7,194.45,NaN,NaN,187.42304347826087,193.33490909090906,180.22275010000018,185.710971,188.00990199999987,190.32675000000015,188.59614066625986,190.829254772847,191.28038461538472,195.2238045710515,187.33696465971795,180.22275010000018,185.710971,188.00990199999987,190.32675000000015,193.9333333333333,92102592,79925692.4,71.67438494089112,1.3815306692326608,1.5,2.75,NaN,NaN,1.3533645908311271,1.1523527570966654,663.752022853316,0.3647515012916638,1.6350840872647154,1.2703325859730517,4.682986741420666,2.5634263410517355,79.02407157348654,3.7603599024561065,17.215568524057364,9992250397
1402061400,194.87,195.43,194.78,195.375,NaN,NaN,187.5882608695652,193.42145454545454,180.3717251000002,185.84787099999997,188.21800199999987,190.71175000000014,188.86197828719085,191.26218288971873,191.79076923076934,195.99572024330266,187.58581821823603,180.3717251000002,185.84787099999997,188.21800199999987,190.71175000000014,195.19500000000002,78696219,79179627.7,74.09384172304496,1.560385740010255,1.5,2.75,NaN,NaN,1.326695691486048,0.9938947843777244,667.5320309933154,0.4180569478052345,1.7929037707295947,1.3748468229243602,4.807291844787541,2.6398739164696643,79.2564715406012,3.6823756390361884,17.061152820362626,10070946616
1402320600,195.35,196.05,195.17,195.58,NaN,NaN,187.75347826086957,193.50799999999998,180.5268251000002,185.966971,188.43800199999987,191.09275000000014,189.12543011906573,191.67340356688837,192.40846153846164,196.28657841816485,188.53034465875842,180.5268251000002,185.966971,188.43800199999987,191.09275000000014,195.60000000000002,65118828,78251640.7,74.61141731652724,1.4716293354638361,1.5,2.75,NaN,NaN,1.2947888563799033,0.8321720467133924,669.8199066455308,0.4301009380047114,1.9124729954302495,1.4823720574255381,4.881449417024707,2.1198830409356737,79.17825800523714,3.7052581786635765,17.116483816099283,10136065444
1402407000,195.33,195.64,194.92,195.6,NaN,NaN,187.9186956521739,193.59454545454543,180.6745251000002,186.076371,188.64020199999987,191.38350000000014,189.37933482027884,192.0473651319466,192.90615384615393,196.6311983040192,189.18110938828866,180.6745251000002,186.076371,188.64020199999987,191.38350000000014,195.38666666666666,57129440,76761110.45,74.66459866931572,1.1727415803448846,1.5,2.75,NaN,NaN,1.2537325094956242,0.7442497856673463,667.7998459629546,0.40286512604126146,1.985953464977115,1.5830883389358534,4.5523720707331305,2.2050370989654087,100,0,0,10193194884
1402493400,194.9,195.12,194.48,194.92,NaN,NaN,188.08391304347825,193.6810909090909,180.8160251000002,186.181371,188.79840199999987,191.63150000000013,189.59661580771888,192.32094940509455,193.31615384615392,196.6429799007796,189.98932779152824,180.8160251000002,186.181371,188.79840199999987,191.63150000000013,194.84,68772479,76877036.15,69.34590083439083,0.7619830577345524,1.5,2.75,NaN,NaN,1.2441801873887943,0.8945776586107371,664.885355806244,0.30684666554065965,1.966646670861678,1.6598000053210185,5.377085820348685,1.3255705151530814,78.00921518567469,4.105986356267687,17.88479845805761,10124422405
1402579800,194.65,194.8,193.11,193.54,NaN,NaN,188.24913043478261,193.76763636363634,180.95372510000018,186.28042100000002,188.90420199999988,191.85550000000015,189.75125832506325,192.43704946175222,193.56153846153853,196.41377209265536,190.7093048304217,180.95372510000018,186.28042100000002,188.90420199999988,191.85550000000015,193.8166666666667,106350200,78576203.75,60.00417887700906,0.21015626905838575,1.5,2.75,NaN,NaN,1.2845958882895927,1.3534657431194619,662.5056408068667,0.12737828954891373,1.8190228672571607,1.691644577708247,6.967135994834476,0.44633589370977017,39.00954827377098,27.977122255688702,33.01332947054031,10018072205
1402666200,193.9,194.32,193.3,194.13,NaN,NaN,188.41434782608695,193.8541818181818,181.10772510000018,186.37992100000002,189.0092019999999,192.19200000000015,189.9229736848647,192.59828284634725,193.7623076923078,196.3682642283098,191.15635115630576,181.10772510000018,186.37992100000002,189.0092019999999,192.19200000000015,193.91666666666666,82017278,74929247.7,62.340022716685695,0.257209968406527,1.5,2.75,NaN,NaN,1.2656961819831918,1.094596309419506,664.5748322910117,0.030443628880674645,1.7296991138090902,1.6992554849284156,7.089903052128267,0.6402446927084606,39.4897026395891,27.54933719984507,32.960960160565826,10100089483
1402925400,193.89,194.7,193.66,194.29,NaN,NaN,188.5795652173913,193.94072727272726,181.25962510000016,186.47982100000004,189.12240199999994,192.50400000000013,190.0942296187916,192.75939876574276,193.98615384615394,196.20651124584086,191.76579644646702,181.25962510000016,186.47982100000004,189.12240199999994,192.50400000000013,194.21666666666667,87424332,74427580.4,62.97158611302319,0.31178040816339087,1.5,2.75,NaN,NaN,1.2495750261272491,1.1746227880867668,664.7891180052974,-0.0371900055073191,1.6527679780442668,1.6899579835515859,7.086386512315085,0.7728215767634754,44.68665645419503,23.275925947493185,32.037417598311784,10187513815
1403011800,194.02,194.97,193.81,194.83,NaN,NaN,188.74478260869566,194.0272727272727,181.41292510000017,186.60022100000006,189.29100199999993,192.80850000000015,190.27994610432918,192.95659888329106,194.1753846153847,196.22530567030998,192.12546356045942,181.41292510000017,186.60022100000006,189.29100199999993,192.80850000000015,194.53666666666666,84833876,75477304.3,65.09891338143375,0.512383331945338,1.5,2.75,NaN,NaN,1.2431768099753027,1.123965366632735,667.6100126875765,-0.05857738160814785,1.616736256541401,1.6753136381495488,7.129590786145911,0.8489052228376287,48.6983596732385,20.169061361758978,31.132578965002537,10272347691
1403098200,194.83,196.37,194.4,196.255,NaN,NaN,188.91,194.11381818181817,181.57595015000018,186.77387100000007,189.52930199999992,193.24375000000015,190.5142619433751,193.27073232297764,194.45038461538473,196.58165892376437,192.3191103070051,181.57595015000018,186.77387100000007,189.52930199999992,193.24375000000015,195.67499999999998,105266767,75158418.75,69.99741892086952,0.797341912265114,1.5,2.75,NaN,NaN,1.2950927521199238,1.4005984791956523,671.1056239711168,0.006754804822990623,1.683757144178287,1.6770023393552964,7.9803046802377615,0.9282591925945008,74.15103707923292,5.60224301501434,20.246719905752727,10377614458
1403184600,196.43,196.6,195.8,196.48,NaN,NaN,189.07521739130434,194.20036363636362,181.73640015000018,186.9585710000001,189.7569019999999,193.61125000000013,190.7482124553996,193.57637686364643,194.72615384615395,196.90818237959482,192.54412531271308,181.73640015000018,186.9585710000001,189.7569019999999,193.61125000000013,196.29333333333332,85928920,75000200.5,70.69676565372852,0.9256009601637485,1.5,2.75,NaN,NaN,1.2597289841113566,1.1457158704529062,672.9525918437612,0.04641971969525782,1.7350269889743686,1.6886072692791108,7.337956265757134,0.5655790147152858,100,0,0,10463543378
1403271000,196.03,196.1039,195.7,195.94,NaN,NaN,189.2404347826087,194.28690909090906,181.8873501500002,187.12727100000006,189.9339019999999,193.92875000000012,190.95181196695256,193.80148382901345,194.9676923076924,196.92720408120547,193.00818053417933,181.8873501500002,187.12727100000006,189.9339019999999,193.92875000000012,195.9146333333333,100587108,76952088.65,66.67957293393172,0.6254572498524065,1.5,2.75,NaN,NaN,1.2254626281034027,1.307139413167832,675.3294281127016,0.018991272879935295,1.7123463603790299,1.6933550874990946,7.212646704505855,0.18406790060332612,75.45311609923147,5.086318496459312,19.460565404309232,10362956270
1403530200,195.97,196.05,195.52,195.88,NaN,NaN,189.40565217391304,194.37345454545454,182.03695010000018,187.3125710000001,190.18840199999988,194.20525000000015,191.14507424275834,193.9994377500598,195.1746153846155,196.8927962721119,193.4564344971191,182.03695010000018,187.3125710000001,190.18840199999988,194.20525000000015,195.8166666666667,70611486,77474858.55,66.22925919977362,0.48878265693513695,1.5,2.75,NaN,NaN,1.175786726096017,0.9114116156072672,674.892190796604,-0.018462955041350426,1.6702763936974065,1.688739348738757,7.202339926985598,0.1431492842535793,51.15857555548039,18.30273304792368,30.53869139659593,10292344784
1403616600,195.53,196.5,194.48,194.7,NaN,NaN,189.57086956521738,194.45999999999998,182.18025015000018,187.4672710000001,190.4522019999999,194.36425000000014,191.2844830959835,194.06615796433982,195.19384615384627,196.88453174008055,193.50316056761199,182.18025015000018,187.4672710000001,190.4522019999999,194.36425000000014,195.2266666666667,96236917,78686186.65,57.94165971629295,0.20039852352292378,1.5,2.75,NaN,NaN,1.2360876742320168,1.2230471585574034,672.2215962051885,-0.13167143847691132,1.5241500506426178,1.655821489119529,8.031519124062115,-0.11286681715575562,24.13741208231141,43.51737976632398,32.3452081513646,10196107867
1403703000,194.25,195.781,194.25,195.58,NaN,NaN,189.73608695652175,194.54654545454542,182.3199801500002,187.64127100000013,190.7049999999999,194.57425000000012,191.45293473927825,194.21033339630745,195.2096153846155,196.91055838795168,193.5086723812793,182.3199801500002,187.64127100000013,190.7049999999999,194.57425000000012,195.20366666666666,82781912,79489139,61.78250186310893,0.27507213425050825,1.5,2.75,NaN,NaN,1.2571528403583017,1.041424187523279,675.5525477351928,-0.15466215258810267,1.4624937983844006,1.6171559509725033,8.237754527256087,1.0540456753126075,20.643677986008367,47.95522975721907,31.40109225677255,10278889779
1403789400,195.61,195.63,194.13,195.44,NaN,NaN,189.90130434782608,194.6330909090909,182.45283015000018,187.85397100000012,190.9297999999999,194.72775000000013,191.6092902396987,194.327444501421,195.19884615384626,196.89202774639202,193.5056645613005,182.45283015000018,187.85397100000012,190.9297999999999,194.72775000000013,195.0666666666667,84311822,80485901.45,60.83074177797446,0.14887341711831564,1.5,2.75,NaN,NaN,1.2744990660469944,1.0475352885545646,676.7395990858474,-0.1846424162347038,1.3863529306791236,1.5709953469138274,6.823175842146993,0.6748055426775884,4.575680625543472,76.72485683955789,18.69946253489864,10194577957
1403875800,194.98,195.88,194.885,195.82,NaN,NaN,190.06652173913042,194.71963636363634,182.5849302000002,188.05832100000015,191.12369999999987,194.88475000000014,191.7744161126517,194.4695926441428,195.21576923076935,196.9289302593994,193.5026082021393,182.5849302000002,188.05832100000015,191.12369999999987,194.88475000000014,195.52833333333334,71453616,80242800.25,62.518533362568654,0.20396599899702308,1.5,2.75,NaN,NaN,1.254534847043638,0.8904676279664107,680.3237522419157,-0.18382595655850342,1.3412129012156981,1.5250388577742016,6.729962793901221,0.7874826290596537,19.92425975768433,48.91839611351956,31.15734412879609,10266031573
1404135000,195.7,196.165,195.53,195.72,NaN,NaN,190.2317391304348,194.80618181818178,182.71878020000023,188.26382100000018,191.31029999999987,195.02600000000012,191.9291448925477,194.58867905898634,195.2773076923078,197.00099165130962,193.55362373330598,182.71878020000023,188.26382100000018,191.31029999999987,195.02600000000012,195.80499999999998,70504228,80535229.25,61.7642891193925,0.31464304964854023,1.5,2.75,NaN,NaN,1.2102823579690918,0.8754457975296569,682.6456704893625,-0.1939630095939231,1.2825850957817977,1.4765481053757208,6.776384428649642,0.4568084997176956,20.117668539939523,48.67659107522953,31.205740384830953,10195527345
1404221400,196.19,197.63,196.13,197.03,NaN,NaN,190.39695652173913,194.89272727272726,182.85728020000022,188.45932100000016,191.51009999999988,195.23750000000013,192.12917842617327,194.82118581527337,195.54576923076937,197.18873018892734,193.9028082726114,182.85728020000022,188.45932100000016,191.51009999999988,195.23750000000013,196.92999999999998,90470121,81806375.65,67.32548674392885,0.9213071771790939,1.5,2.75,NaN,NaN,1.2602621895427277,1.10590550285551,685.8351966176575,-0.12000912420495036,1.326536700119533,1.4465458243244833,7.530702079609349,0.39489439759496864,50.83015604431091,18.54940925280971,30.62043470287939,10285997466
1404307800,197.05,197.48,196.96,197.23,NaN,NaN,190.56217391304347,194.9792727272727,182.99188020000022,188.63482100000016,191.69689999999989,195.43950000000012,192.3292106447547,195.05059669000923,195.78423076923087,197.43587724915807,194.13258428930368,182.99188020000022,188.63482100000016,191.69689999999989,195.43950000000012,197.2233333333333,52474832,81653648.65,68.08859897534424,0.7602452519705388,1.5,2.75,NaN,NaN,1.207386318861103,0.6426514046534282,683.1145421404566,-0.06778953436705315,1.3618089063656669,1.42959844073272,6.434961060528819,0.3817182410423453,46.32030557612466,21.910871554509825,31.76882286936551,10338472298
1404394200,197.79,198.29,197.64,198.2,NaN,NaN,190.72739130434783,195.06581818181817,183.1275301500002,188.81672100000017,191.9118999999999,195.62700000000012,192.55943767829373,195.3505398623893,196.0850000000001,197.94907329007142,194.22092670992876,183.1275301500002,188.81672100000017,191.9118999999999,195.62700000000012,198.0433333333333,52938832,79695460.65,71.55808073920807,1.0115326835485055,1.5,2.75,NaN,NaN,1.1968587246567386,0.6642640818966142,685.1485664524944,0.017364090095496554,1.4513035533520906,1.433939463256594,6.916533626790759,1.1534143105032106,76.14384670370607,4.797231415909943,19.058921880383963,10391411130
1404739800,197.82,197.98,197.22,197.51,NaN,NaN,190.89260869565217,195.15236363636362,183.2498252000002,188.97202100000015,192.1054999999999,195.73375000000016,192.75357737718417,195.55620273263793,196.29115384615397,198.1472131698217,194.43509452248625,183.2498252000002,188.97202100000015,192.1054999999999,195.73375000000016,197.57000000000002,61696447,78845472.05,66.05639656327826,0.6519901506058191,1.5,2.75,NaN,NaN,1.1813688157526852,0.7824982893231344,681.3366293861814,0.012719337507381967,1.4498386351408215,1.4371192976334395,7.068310313968602,0.832142127833365,46.90047019691099,21.411599485444018,31.687930317645,10329714683
1404826200,197.15,197.22,195.76,196.24,NaN,NaN,191.0578260869565,195.23890909090906,183.3672252500002,189.1137210000002,192.30449999999985,195.76675000000014,192.89029983298087,195.6213262819105,196.2900000000001,198.14616643816834,194.43383356183188,183.3672252500002,189.1137210000002,192.30449999999985,195.76675000000014,196.40666666666667,108142552,80996658.25,57.32087051372548,0.06894560404545419,1.5,2.75,NaN,NaN,1.2219853289132077,1.3351483176776617,678.8481945985473,-0.0850090474839098,1.3308579882785523,1.415867035762462,8.20470757584156,0.7909604519774117,38.12052160586584,28.766238466420862,33.1132399277133,10221572131
1404912600,196.73,197.295,196.31,197.12,NaN,NaN,191.22304347826088,195.32545454545453,183.4992252500002,189.2548210000002,192.50939999999989,195.84275000000014,193.05617042776595,195.76405711220474,196.33923076923085,198.2461971323672,194.4322644060945,183.4992252500002,189.2548210000002,192.50939999999989,195.84275000000014,196.90833333333333,72992322,81789802.35,61.154246105468694,0.3258530185546903,1.5,2.75,NaN,NaN,1.2100578054194056,0.8924379311695452,680.9482556477209,-0.09855563648338994,1.2926724901582247,1.3912281266416147,7.473401635932677,0.7874015748031454,34.93538587456503,31.75751806185341,33.30709606358156,10294564453
1404999000,195.22,196.86,195.06,196.34,NaN,NaN,191.38826086956522,195.41199999999998,183.6312753000002,189.3780210000002,192.68119999999988,195.9137500000001,193.18494805804963,195.8189088158043,196.3700000000001,198.26306426401766,194.47693573598252,183.6312753000002,189.3780210000002,192.68119999999988,195.9137500000001,196.0866666666667,99040407,83303198.75,56.32516082580395,0.15380627598407934,1.5,2.75,NaN,NaN,1.2707679621751624,1.1889148134302585,677.2473599164846,-0.1643412657536205,1.185801544449589,1.3501428102032096,7.6933249196570905,0.4604993860008216,12.991058996793754,59.26324042687809,27.745700576328154,10195524046
1405085400,196.22,196.75,195.78,196.61,NaN,NaN,191.55347826086955,195.49854545454542,183.7666753000002,189.50172100000017,192.8471999999999,196.06725000000012,193.31926382047905,195.89425083334675,196.42615384615394,198.30096728856074,194.55134040374713,183.7666753000002,189.50172100000017,192.8471999999999,196.06725000000012,196.38,64243410,81197859.25,57.57404937957353,0.07467611518191336,1.5,2.75,NaN,NaN,1.2492845363055078,0.7911958590213695,678.3431321765269,-0.19203760803916348,1.1100958001542551,1.3021334081934186,7.67711541182512,0.4034317230109389,14.630467467942465,56.59549777465418,28.774034757403346,10259767456
1405344600,197.61,197.86,197.44,197.6,NaN,NaN,191.71869565217392,195.5850909090909,183.9094753500002,189.64752100000015,193.0326999999999,196.2407500000001,193.4871358275191,196.05670313493277,196.64923076923088,198.32942236159948,194.96903917686228,183.9094753500002,189.64752100000015,193.0326999999999,196.2407500000001,197.63333333333333,58657919,80029891.3,61.878506549610606,0.5286079547603277,1.5,2.75,NaN,NaN,1.2493356408551146,0.7329501270983233,681.3690617857544,-0.14802202462356506,1.1171058774139624,1.2651279020375275,8.067254646986902,0.9605558961782115,32.52200409062656,34.17605488509727,33.301941024276154,10318425375
1405431000,197.72,198.1,196.36,197.23,NaN,NaN,191.88391304347826,195.67163636363634,184.0471753500002,189.77882100000016,193.2160999999999,196.3877500000001,193.63391481467522,196.1684456935106,196.77615384615396,198.36064674658354,195.19166094572438,184.0471753500002,189.77882100000016,193.2160999999999,196.3877500000001,197.23000000000002,111346230,81225986.2,59.45080249916775,0.27865768838691807,1.5,2.75,NaN,NaN,1.284383095079748,1.3708202905143674,679.4940617857544,-0.1478208157404144,1.0803518823620095,1.228172698102424,8.191476666133402,0.1015073846622284,31.928666395332105,34.7829074154403,33.28842618922759,10207079145
1405517400,198.11,198.26,197.42,197.96,NaN,NaN,192.0491304347826,195.75818181818178,184.19243035000022,189.91952100000017,193.40689999999987,196.5442500000001,193.80356521409973,196.33906991317625,196.9700000000001,198.46740287986975,195.47259712013047,184.19243035000022,189.91952100000017,193.40689999999987,196.5442500000001,197.88,80073242,80987954.5,62.57091961446663,0.5593488072219677,1.5,2.75,NaN,NaN,1.266212874002623,0.9887055734936484,681.1505042546897,-0.10455581195125019,1.0974779331633613,1.2020337451146115,7.562120824097081,0.37012624854232024,33.15845080781262,33.5331262308459,33.308422961341485,10287152387
1405603800,197.35,198.1,195.43,195.71,NaN,NaN,192.21434782608696,195.84472727272725,184.33093040000023,190.02752100000015,193.58549999999985,196.5170000000001,193.8783273625664,196.27915849287373,196.96153846153857,198.48584099874267,195.43723592433446,184.33093040000023,190.02752100000015,193.58549999999985,196.5170000000001,196.41333333333333,145398459,82994539.1,49.84113869634244,0.20598419743674515,1.5,2.75,NaN,NaN,1.366483383002435,1.7519039273753858,676.4627880149517,-0.2265056131217702,0.9189017287123988,1.145407341834169,10.155221491306909,-1.256306760847619,26.864140097330182,40.27794195515197,32.85791794751786,10141753928
1405690200,196.35,197.91,196.24,197.7099,NaN,NaN,192.3795652173913,195.9312727272727,184.47277990000023,190.1562200000002,193.78209799999985,196.5784950000001,194.028585113054,196.4154195887905,197.1146076923078,198.50306605260965,195.72614933200595,184.47277990000023,190.1562200000002,193.78209799999985,196.5784950000001,197.2866333333333,124330419,84914614.05,58.01698094491181,0.37835697527963447,1.5,2.75,NaN,NaN,1.4260202842165461,1.4641816416522946,681.6289460834963,-0.1738811016401176,0.9280559647840221,1.1019370664241397,11.57722705290356,0.10121006531315566,35.31373670262992,31.415450217328036,33.27081308004205,10266084347
1405949400,197.09,197.5,196.43,197.34,NaN,NaN,192.54478260869564,196.01781818181817,184.61357995000023,190.2811200000002,193.97539799999987,196.64849500000008,194.15844452038522,196.50347486604855,197.13845384615394,198.5309231450904,195.74598454721746,184.61357995000023,190.2811200000002,193.97539799999987,196.64849500000008,197.09,67591618,83264839.55,56.19256269597386,0.21082295064702014,1.5,2.75,NaN,NaN,1.4155831210582213,0.8117666276101051,678.696741096297,-0.1654342464162235,0.8951442584038602,1.0605785048200838,11.448569725878714,0.5605381165919253,20.101646558866662,48.63859320675254,31.259760234380803,10198492729
1406035800,198.01,198.56,197.87,198.2,NaN,NaN,192.70999999999998,196.10436363636362,184.76647995000022,190.4049200000002,194.1801979999999,196.76449500000007,194.3169368921348,196.66504868832965,197.21306923076932,198.71668308749884,195.7094553740398,184.76647995000022,190.4049200000002,194.1801979999999,196.76449500000007,198.21,67677602,83118145.35,59.38999343074644,0.5986742525353425,1.5,2.75,NaN,NaN,1.401612898125491,0.8142337839110604,682.0632427424177,-0.106253485539058,0.9277616478962614,1.0340151334353194,10.918101587877745,0.5478896103896023,42.52135431407578,24.92949737827547,32.549148307648736,10266170331
1406122200,198.495,198.85,198.1,198.64,NaN,NaN,192.87521739130435,196.19090909090906,184.91522995000022,190.52842000000018,194.3572979999999,196.9614950000001,194.48646877871775,196.85313928944112,197.24691538461548,198.85410924274015,195.6397215264908,184.91522995000022,190.52842000000018,194.3572979999999,196.9614950000001,198.52999999999997,65611830,81586891,60.96000189459681,0.6855504117188979,1.5,2.75,NaN,NaN,1.3550691196879558,0.804195737768706,684.2403968481254,-0.04493729437123295,0.9778435154712781,1.022780809842511,10.73052433022042,1.1714373026382718,40.64080579951517,26.531453220302815,32.827740980182014,10331782161
1406208600,198.83,199.06,198.45,198.65,NaN,NaN,193.04043478260868,199.06,185.07133000000024,190.6651200000002,194.5310979999999,197.11499500000008,194.6497445128857,197.0242688809229,197.33460769230777,199.1056958419052,195.56351954271034,185.07133000000024,190.6651200000002,194.5310979999999,197.11499500000008,198.71999999999997,56888093,80292200.05,60.996908149464694,0.6099701334597218,1.5,2.75,NaN,NaN,1.3018498968531027,0.7085133171662296,683.4245972341032,-0.01283612718645677,1.00673565085944,1.0195717780458968,10.323148258610898,1.0375871013681868,79.64201961393458,3.5494357059533796,16.80854468011203,10388670254
1406295000,198.09,198.26,197.33,197.72,NaN,NaN,193.20565217391305,199.18315789473684,185.23253000000022,190.7665200000002,194.7042979999999,197.2289950000001,194.77014668885096,197.09052898750167,197.44845384615388,199.110363492182,195.78654420012577,185.23253000000022,190.7665200000002,194.7042979999999,197.2289950000001,197.77,76837257,79918471.8,55.72122753396358,0.11706554873462294,1.5,2.75,NaN,NaN,1.3031463327921664,0.9614455240371601,680.4030695361283,-0.06068851513193452,0.9437111341309787,1.0043996492629133,10.851373191615973,0.060728744939273556,43.4527634126556,24.15720522203074,32.39003136531364,10311832997
1406554200,197.76,198.09,196.62,197.8,NaN,NaN,193.3708695652174,199.3063157894737,185.39352995000024,190.8670200000002,194.9122979999999,197.32799500000007,194.88896446575876,197.15809765535866,197.5007615384616,199.16083108946253,195.84069198746067,185.39352995000024,190.8670200000002,194.9122979999999,197.32799500000007,197.50333333333333,69258785,79808730.25,56.07318655062283,0.14980646447743168,1.5,2.75,NaN,NaN,1.3150644518784402,0.8678096341471364,678.5039019271908,-0.09155157936904046,0.8899601750516126,0.9815117544206531,10.474895849027664,0.28900268721797984,72.6239195541662,6.185605400901846,21.190475044931947,10381091782
1406640600,198.17,198.45,196.92,196.95,NaN,NaN,193.53608695652173,199.42947368421054,185.53242995000022,190.9547200000002,195.09029799999993,197.3894950000001,194.9697893886702,197.13827883103878,197.54768461538467,199.10517750383616,195.99019172693318,185.53242995000022,190.9547200000002,195.09029799999993,197.3894950000001,197.43999999999997,80466351,80306836.4,51.39842013550634,0.025750970304091573,1.5,2.75,NaN,NaN,1.3304169910299801,1.0019863140817236,676.2177665212405,-0.16928993459959096,0.7698993361711644,0.9391892707707553,10.73193128850334,-0.5102040816326628,40.70026706474718,26.478491959098008,32.821240976154805,10300625431
1406727000,197.65,197.91,196.16,196.98,NaN,NaN,193.70130434782607,199.55263157894737,185.66603000000023,191.0419200000002,195.25509799999992,197.3869950000001,195.0486211773498,197.12320465665414,197.5761461538462,199.0765338917068,196.0757584159856,185.66603000000023,191.0419200000002,195.25509799999992,197.3869950000001,197.01666666666665,104222452,80994452.95,51.55194123456424,0.2278073697356719,1.5,2.75,NaN,NaN,1.3603872059564102,1.2867850600131745,673.5974651299034,-0.215788250897459,0.6694539571489315,0.8852422080463905,10.458283816421634,0.6489193194011454,47.00110908347028,21.337266674338792,31.661624242190932,10404847883
1406813400,195.61,195.78,192.97,193.09,NaN,NaN,193.86652173913043,199.6757894736842,185.77678000000023,191.09122000000022,195.36589799999993,197.17999500000008,194.97181250372822,196.739089927449,197.22922307692312,200.05092993425768,194.40751621958856,185.77678000000023,191.09122000000022,195.36589799999993,197.17999500000008,193.9466666666667,183479441,87544683.4,35.772792814344896,1.6521539686145479,1.5,2.75,NaN,NaN,1.5496452626738086,2.095837621134169,666.3331115225043,-0.48994181452927554,0.2728149398847961,0.7627567544140716,14.18310565449419,-2.3367064572891905,15.147274909348603,55.78899946396336,29.06372562668803,10221368442
1406899800,192.56,193.76,191.57,192.5,NaN,NaN,194.03173913043477,199.79894736842107,185.89078000000023,191.1439200000002,195.43329799999995,196.89499500000005,194.8748786800526,196.33536707721575,196.86537692307698,200.64878825163058,193.08196559452338,185.89078000000023,191.1439200000002,195.43329799999995,196.89499500000005,192.61,189260864,94360785,34.069492242244365,1.8559070228158738,1.5,2.75,NaN,NaN,1.5953848867685365,2.0057152343529148,663.1899414551536,-0.680698726853451,-0.08811665415274206,0.592582072700709,12.142948589748586,-2.4526198439241935,10.055262578058748,64.48588688599817,25.45885053594308,10032107578
1407159000,192.87,194.3,192.05,193.89,NaN,NaN,194.1969565217391,199.9221052631579,185.9998799500002,191.2100200000002,195.51929799999994,196.71399500000007,194.83625598671722,196.10247497462376,196.55230000000003,200.58682787211754,192.51777212788252,185.9998799500002,191.2100200000002,195.51929799999994,196.71399500000007,193.41333333333333,91340487,95842987,41.17576984883047,1.2593586039352302,1.5,2.75,NaN,NaN,1.6421431091422125,0.9530221235696671,665.829242326769,-0.6812740167960565,-0.2590104482943616,0.42226356850169483,13.406758632320422,-2.1745711402623624,10.769062600239348,63.25153385958344,25.97940354017721,10123448065
1407245400,193.1,193.6,191.31,192.01,NaN,NaN,194.36217391304348,200.04526315789474,186.0938299500002,191.2783200000002,195.55249799999993,196.5024950000001,194.72542241861066,195.71271545323103,196.26768461538464,200.96699855278436,191.56837067798492,186.0938299500002,191.2783200000002,195.55249799999993,196.5024950000001,192.30666666666664,152690379,98070378.35,35.58857207962063,1.730851988299465,1.5,2.75,NaN,NaN,1.7091328870606246,1.556946975926498,662.518006044912,-0.7697479920026951,-0.5399214215016741,0.229826570501021,13.494408201002932,-3.337696335078532,8.621454097579116,67.38583779054485,23.992708111876045,9970757686
1407331800,191.11,192.89,191.08,192.07,NaN,NaN,194.52739130434782,200.16842105263157,186.18223995000022,191.3524200000002,195.56349799999992,196.24999500000007,194.62128820611613,195.36579017197093,195.8338461538462,200.94387573956396,190.72381656812843,186.18223995000022,191.3524200000002,195.56349799999992,196.24999500000007,192.01333333333332,94818317,99161678.1,35.88757306402162,1.473531662720631,1.5,2.75,NaN,NaN,1.7163376808420066,0.9561991972784092,663.6750898686718,-0.7831165290916284,-0.7490690908635145,0.0340474382281139,13.258761291941278,-3.312358419330487,7.800424314450515,69.09093759122088,23.108638094328622,10065576003
1407418200,192.935,193.13,190.55,191.03,NaN,NaN,190.55,200.29157894736844,186.26539000000022,191.39942000000016,195.55649799999995,195.98449500000007,194.48045337450372,194.95285777464036,195.34846153846158,200.96741214486758,189.72951093205558,186.26539000000022,191.39942000000016,195.55649799999995,195.98449500000007,191.57000000000002,135733421,100996328.8,33.0258326344037,1.6566154211301716,1.5,2.75,NaN,NaN,1.7780278464961479,1.3439441077981045,662.2190678908156,-0.8171241810193006,-0.9873577880460118,-0.17023360702671125,13.114992392988528,-3.3835727291118745,9.126862917339416,66.37334919177948,24.4997878908811,9929842582
1407504600,191.46,193.37,190.95,193.24,NaN,NaN,190.66407407407408,200.41473684210527,186.35454000000018,191.4552200000002,195.57389799999993,195.81599500000004,194.43180814413103,194.78972846276986,194.96692307692314,200.4310121888011,189.50283396504517,186.35454000000018,191.4552200000002,195.57389799999993,195.81599500000004,192.51999999999998,117014384,103634877.5,43.36156010353142,0.8422184269656215,1.5,2.75,NaN,NaN,1.8238830003178528,1.1291023526322015,664.3440678908156,-0.6530154942695658,-0.9865029748636687,-0.33348748059410277,15.777398673708008,-2.3053589484327612,33.47474357638091,33.294022982269695,33.2312334413494,10046856966
1407763800,193.965,194.66,193.71,193.795,NaN,NaN,190.77814814814815,200.5378947368421,186.45066495000017,191.52657000000016,195.59619799999993,195.62574500000002,194.40683527573373,194.69499241869653,194.59423076923082,199.65111008382928,189.53735145463236,186.45066495000017,191.52657000000016,195.59619799999993,195.62574500000002,194.05499999999998,74543691,104429166.1,45.63075812561292,0.07995973238079719,1.5,2.75,NaN,NaN,1.7950342145808624,0.7138206095471255,668.5767576562723,-0.4774640523396544,-0.9303175460186708,-0.4528534936790164,15.992773235426561,-1.6019294237116026,32.64729308237953,34.039337996698606,33.31336892092186,10121400657
1407850200,193.61,194.15,192.94,193.53,NaN,NaN,190.89222222222224,200.66105263157894,186.54256500000017,191.58440000000016,195.60889799999993,195.44074500000005,194.37244957864613,194.58404075977305,194.20038461538468,198.69913394849385,189.7016352822755,186.54256500000017,191.58440000000016,195.60889799999993,195.44074500000005,193.54,73631640,102543436.6,44.70967214221429,0.31044424893931166,1.5,2.75,NaN,NaN,1.7532460563965155,0.7180531727956542,666.4603948337301,-0.3551854569909201,-0.8968353149176664,-0.5416498579267464,15.929695367074283,-1.751446847395669,43.60041762064039,24.04382739405758,32.355754985302035,10047769017
1407936600,194.29,195.06,193.96,194.84,NaN,NaN,191.0062962962963,200.7842105263158,186.63701500000016,191.67080000000016,195.64969799999994,195.28474500000002,194.39078488928746,194.60841783027084,193.97884615384626,198.02318912386758,189.93450318382494,186.63701500000016,191.67080000000016,195.64969799999994,195.28474500000002,194.62,69046544,101992101.7,50.07471445731971,0.33098440480131486,1.5,2.75,NaN,NaN,1.7372999095110502,0.6769793233900974,670.5087141008938,-0.17138493582077374,-0.7558810277027135,-0.5844960918819397,16.649420243094223,0.9063131182350199,40.44861924907053,26.706637604775334,32.84474314615414,10116815561
1408023000,195.16,195.76,194.98,195.76,NaN,NaN,191.12037037037038,200.90736842105264,186.73466500000018,191.77410000000015,195.70109799999994,195.28724500000004,194.44447959951148,194.718092322626,193.82192307692318,197.39147279741863,190.25237335642774,186.73466500000018,191.77410000000015,195.70109799999994,195.28724500000004,195.5,57370793,97590718.4,53.488128831654706,0.6199749772319483,1.5,2.75,NaN,NaN,1.6789213445459743,0.5878714076563248,673.7166587841621,0.01684294158820432,-0.5634424148966843,-0.5802853564848887,11.728794606517075,1.6935064935064887,77.44808657329158,4.304906719391053,18.247006707317382,10174186354
1408109400,196.47,196.65,194.31,195.72,NaN,NaN,191.23444444444445,201.03052631578947,186.82741500000017,191.86820000000014,195.7264979999999,195.18775000000005,194.49450000737377,194.81351210142353,193.7273076923078,197.0142015156476,190.44041386896797,186.82741500000017,191.86820000000014,195.7264979999999,195.18775000000005,195.56000000000003,139950669,98371730.9,53.317444118991986,0.511167993113738,1.5,2.75,NaN,NaN,1.7261412485069765,1.4226716122568501,673.1136360950065,0.13667523801415982,-0.4094413089671889,-0.5461165469813487,11.445559611646045,0.9438341327556927,30.599456756454636,36.15961358739609,33.24092965614927,10034235685
1408368600,196.8,197.45,196.69,197.36,NaN,NaN,191.34851851851852,201.1536842105263,186.9327650000002,191.99210000000014,195.76619799999992,195.18875000000003,194.6068725561042,195.0560347584308,193.75653846153858,197.1631957101347,190.34988121294248,186.9327650000002,191.99210000000014,195.76619799999992,195.18875000000003,197.16666666666666,75424360,98763368,59.08263182763941,1.1617701966921068,1.5,2.75,NaN,NaN,1.7264168736136203,0.7636876053072633,678.0885732805397,0.314258867030091,-0.15329296319373498,-0.46755183022382596,11.665360912608891,2.7863132128535093,31.526242235556307,35.17416213815183,33.29959562629186,10109660045
1408455000,197.84,198.54,197.4426,198.39,NaN,NaN,191.4625925925926,201.27684210526317,187.0457650000002,192.13020000000012,195.8223979999999,195.19825000000006,194.75523049508053,195.37355525762786,194.16423076923087,198.33671176177182,189.99174977668991,187.0457650000002,192.13020000000012,195.8223979999999,195.19825000000006,198.12419999999997,59134709,98336223.35,62.236939623237326,1.4909665678300588,1.5,2.75,NaN,NaN,1.6873870969269316,0.6013522482913211,680.7574589693005,0.47908565075334764,0.13130523321785859,-0.34778041753548905,9.154487465405163,3.290467017233297,54.85126185896859,15.753645938165203,29.39509220286619,10168794754
1408541400,198.12,199.16,198.08,198.92,NaN,NaN,191.57666666666668,201.4,187.15931500000016,192.26450000000008,195.88879799999992,195.21225000000007,194.9185547893911,195.71131189975853,194.658076923077,199.4058173386046,189.9103365075494,187.15931500000016,192.26450000000008,195.88879799999992,195.21225000000007,198.72,72762541,98693758.9,63.78404415292766,1.481082920625825,1.5,2.75,NaN,NaN,1.6440023042892926,0.7372557475870949,681.0556013663005,0.5942754336062535,0.3950638744723278,-0.19921155913392566,8.97462413860911,4.130241323352346,55.50753296359922,15.326085255210792,29.166381781189987,10241557295
1408627800,199.09,199.76,198.93,199.5,NaN,NaN,191.69074074074075,201.52315789473684,187.27266500000016,192.3894000000001,195.98039799999992,195.25475000000003,195.0982193074542,196.07213933787676,195.08961538461548,200.45880736154942,189.72042340768155,187.27266500000016,192.3894000000001,195.98039799999992,195.25475000000003,199.39666666666668,67790690,99238888.75,65.45210127886197,1.566915822868159,1.5,2.75,NaN,NaN,1.5865735682686293,0.6831060973564156,683.3723925453932,0.6741516764510015,0.6434780364298263,-0.030673640021175258,7.000132722355056,3.2394949285862094,56.92192051337465,14.424425580223845,28.6536539064015,10309347985
1408714200,199.34,199.69,198.74,199.19,NaN,NaN,191.80481481481482,201.6463157894737,187.38726500000018,192.49880000000007,196.0933979999999,195.32825000000005,195.25868129539717,196.36907844855517,195.64192307692318,201.1066428437655,190.17720331008084,187.38726500000018,192.49880000000007,196.0933979999999,195.32825000000005,199.20666666666668,76107359,99202393.85,63.76170217473105,1.2300621457601062,1.5,2.75,NaN,NaN,1.5411040276780121,0.7671927666894705,680.841877030339,0.6693725830812564,0.8060420888303952,0.13666950574913883,6.05994048202355,2.7838695528780466,73.73410336556424,5.723416895090202,20.542479739345566,10233240626
1408973400,200.14,200.5949,199.1502,200.2,NaN,NaN,191.91888888888892,201.76947368421054,187.50241500000018,192.61200000000008,196.21479799999994,195.44825000000006,195.45245849949924,196.73392812012133,196.26730769230775,201.8139859988864,190.7206293857291,187.50241500000018,192.61200000000008,196.21479799999994,195.44825000000006,199.98169999999996,63855022,98932205.7,66.7726658898899,1.4049786983881782,1.5,2.75,NaN,NaN,1.53421802570101,0.6454422151835234,683.402845315687,0.6944973737125004,1.0047912228897644,0.310293849177264,6.167239533265815,3.4464940836046027,73.29531442950032,5.906604125664541,20.798081444835123,10297095648
1409059800,200.33,200.82,200.28,200.33,NaN,NaN,192.03296296296298,201.89263157894737,187.6294150000002,192.7290000000001,196.33559799999992,195.61725000000007,195.6437346367738,197.07641115630025,196.98269230769236,202.01829878004227,191.94708583534245,187.6294150000002,192.7290000000001,196.33559799999992,195.61725000000007,200.4766666666667,47298324,97273804.35,67.15099229084157,1.3595507315697752,1.5,2.75,NaN,NaN,1.4689167381509383,0.48623906832939656,686.1805146902656,0.6793058123027829,1.1594261145557425,0.4801203022529597,5.706818905290624,2.8176965715458886,72.22914216065217,6.355096112255682,21.415761727092132,10344393972
1409146200,200.43,200.57,199.94,200.25,NaN,NaN,192.14703703703705,202.0157894736842,187.7442150000002,192.86750000000006,196.4439979999999,195.78075000000007,195.8243724941552,197.37865771284308,197.52192307692314,202.33532989612647,192.70851625771982,187.7442150000002,192.86750000000006,196.4439979999999,195.78075000000007,200.25333333333333,47873708,94456367.15,66.64808245757848,1.0704377539971912,1.5,2.75,NaN,NaN,1.4089941139972997,0.5068341017601797,687.9750449862067,0.6246911244859207,1.2609842078603606,0.6362930833744399,5.671377775570824,2.2936248467511287,46.68013298010908,21.588300794607722,31.731566225283203,10296520264
1409232600,199.59,200.27,199.39,200.14,NaN,NaN,192.26111111111112,202.13894736842107,187.85831500000018,193.02550000000008,196.52169799999993,196.13325000000003,195.99361278850205,197.6416426925723,198.01000000000005,202.4878566301352,193.53214336986488,187.85831500000018,193.02550000000008,196.52169799999993,196.13325000000003,199.9333333333333,58330373,88198913.75,65.91707301151803,0.8636536969873423,1.5,2.75,NaN,NaN,1.3712088201403514,0.661350242536292,686.1895704097741,0.5448914496225485,1.3174073954026255,0.772515945780077,5.803610625991466,2.2583282239934537,19.241381712758336,49.812643966505036,30.94597432073663,10238189891
1409319000,200.45,200.73,199.82,200.71,NaN,NaN,192.3751851851852,202.2621052631579,187.97706500000018,193.18160000000006,196.60629799999992,196.54375000000005,196.17856914973726,197.9338671980416,198.5623076923077,202.42217738997167,194.70243799464376,187.97706500000018,193.18160000000006,196.60629799999992,196.54375000000005,200.42,65906598,82031200.45,67.88287105877376,0.8730863283785942,1.5,2.75,NaN,NaN,1.338265332987469,0.8034332990186053,689.5197490971857,0.49564363717383464,1.3920704922473703,0.8964268550735357,5.599610699976723,1.6974057559789189,51.65335776661509,17.928317846484802,30.41832438690011,10304096489
1409664600,200.97,200.995,199.86,200.61,NaN,NaN,192.48925925925928,202.38526315789474,188.0882150000002,193.3168000000001,196.69969799999993,196.87975000000003,196.35235075170834,198.1887369887043,199.00615384615386,202.34344467244634,195.6688630198614,188.0882150000002,193.3168000000001,196.69969799999993,196.87975000000003,200.48833333333334,72425793,81085465.75,67.15111709337233,0.7426844907976593,1.5,2.75,NaN,NaN,1.3237463806312206,0.8932031447325072,688.2424163498687,0.4242392850400676,1.42672596137362,1.0024866763335525,4.4078599803648935,1.1190080145168746,19.985883117998675,48.790803454407765,31.22331342759355,10231670696
1409751000,201.38,201.41,200.22,200.5,NaN,NaN,192.60333333333335,202.50842105263158,188.1943650000002,193.4902500000001,196.79209799999992,197.30425000000005,196.51500366340605,198.40885727549437,199.37076923076927,202.20803185020642,196.53350661133211,188.1943650000002,193.4902500000001,196.79209799999992,197.30425000000005,200.71,57461742,76324033.9,66.30442642488205,0.7466616417481386,1.5,2.75,NaN,NaN,1.3141930677289904,0.7528656317522022,686.5160351182565,0.3410856734206118,1.4288437681093171,1.0877580946887053,3.911683482779915,0.7942891614719548,5.844346034239487,73.44066971924842,20.7149842465121,10174208954
1409837400,200.84,201.58,199.66,200.2101,NaN,NaN,192.71740740740742,202.63157894736844,188.2951655000002,193.6772510000001,196.9022999999999,197.71125500000005,196.65990940209602,198.58040420163778,199.71616153846162,201.6367549139912,197.79556816293203,188.2951655000002,193.6772510000001,196.9022999999999,197.71125500000005,200.48336666666668,85236442,75844940.15,64.01364169345607,0.5633943126243657,1.5,2.75,NaN,NaN,1.357464991462635,1.12382502816175,683.5917020083097,0.24266870233733795,1.3910939726103777,1.1484252702730398,4.003409562724962,0.35593984962406583,4.55426552224974,76.75175877884008,18.693975698910172,10088972512
1409923800,200.17,201.19,199.41,201.11,NaN,NaN,192.8314814814815,202.75473684210527,188.4036155000002,193.8589500000001,197.01289999999995,198.21525500000004,196.83442275887657,198.8213180871961,200.00462307692317,201.50311094688158,198.50613520696476,188.4036155000002,193.8589500000001,197.01289999999995,198.21525500000004,200.57000000000002,102176784,74167108.3,67.73963256588891,0.6356535093884441,1.5,2.75,NaN,NaN,1.3876460635010184,1.3776562999692952,686.1351301179036,0.2152212988439013,1.4174518938279164,1.202230594984015,4.409260960578971,0.9639038104322586,25.86878657162178,41.40678247165985,32.72443095671837,10191149296
1410183000,200.92,201.21,200,200.59,NaN,NaN,192.94555555555556,202.8778947368421,188.5114155000002,194.02285000000012,197.11589999999993,198.58275500000005,196.98170029774417,198.9897639836536,200.17385384615395,201.37143023619194,198.97627745611595,188.5114155000002,194.02285000000012,197.11589999999993,198.58275500000005,200.60000000000002,64145745,71523676.35,63.63926475495805,0.4254368327839403,1.5,2.75,NaN,NaN,1.3749570589652318,0.8968463070341043,684.7016455352239,0.14258984992299095,1.3804679073877537,1.2378780574647628,4.644684638023139,0.1948051948052022,8.891364129820637,66.7483009630494,24.360334907129957,10127003551
1410269400,200.41,200.55,198.91,199.32,NaN,NaN,193.05962962962965,203.00105263157894,188.61566550000018,194.1548000000001,197.18589999999992,198.85900500000002,197.07339832528362,199.02121503282945,200.20462307692318,201.2867469377786,199.12249921606778,188.61566550000018,194.1548000000001,197.18589999999992,198.85900500000002,199.5933333333333,88590876,72226035.6,54.898915188303434,0.07861752678040017,1.5,2.75,NaN,NaN,1.3967458404677158,1.2265781343812259,680.5438388632105,-0.0027428617153821833,1.234449480320535,1.2371923420359172,5.29554212324631,-0.5041681225977234,8.154946428895245,68.25371180775555,23.591341763349195,10038412675
1410355800,199.43,200.2,198.77,200.07,NaN,NaN,193.17370370370372,203.1242105263158,188.71646550000017,194.2916000000001,197.27289999999994,199.186005,197.19091211644897,199.12109931541713,200.24846923076936,201.2564926657336,199.24044579580513,188.71646550000017,194.2916000000001,197.27289999999994,199.186005,199.67999999999998,67251103,71907008.75,58.52188631058316,0.15054495378792696,1.5,2.75,NaN,NaN,1.399121137577163,0.9352510161257404,681.8617319185314,-0.05710680302418547,1.1658088382556855,1.222915641279871,5.803813982111296,-0.08988764044944161,22.786190377310405,45.14299486271167,32.07081475997793,10105663778
1410442200,199.27,200.33,199.12,200.3,NaN,NaN,193.2877777777778,203.24736842105264,188.81391550000018,194.4242000000001,197.33829999999992,199.459005,197.3128371314902,199.2333755710917,200.33385384615397,201.135752157814,199.53195553449393,188.81391550000018,194.4242000000001,197.33829999999992,199.459005,199.91666666666666,66823558,71795859.45,59.593841674055234,0.11252532253345324,1.5,2.75,NaN,NaN,1.3856124848930804,0.9307438968195261,683.9159422825838,-0.08465846104239927,1.117092564976872,1.2017510260192712,5.845265896243217,0.0799440391725917,48.36883491841302,20.298646649348935,31.33251843223803,10172487336
1410528600,200.1,200.12,198.56,199.13,NaN,NaN,193.40185185185186,203.37052631578948,188.90641550000018,194.5366000000001,197.3762999999999,199.62750499999999,197.38409842045138,199.22353027860677,200.2515461538463,201.27933855015985,199.22375375753276,188.90641550000018,194.5366000000001,197.3762999999999,199.62750499999999,199.27,117478516,74801245.6,52.20297054553681,0.3455737873803348,1.5,2.75,NaN,NaN,1.4109258788292895,1.5705422424142093,679.110517716205,-0.18311217148138126,0.9728608116675446,1.1559729831489258,6.756620389825047,-0.7872054207563213,14.080325184601957,57.47374996348122,28.445924851916807,10055008820
1410787800,199.16,199.32,198.38,198.981,NaN,NaN,193.51592592592593,203.4936842105263,188.9979205000002,194.6519100000001,197.39191999999989,199.79055499999998,197.44672201180623,199.2004321568347,200.1477769230771,201.37582211930751,198.91973172684666,188.9979205000002,194.6519100000001,197.39191999999989,199.79055499999998,198.8936666666667,76401421,71623783.2,51.32989917312688,0.36302391961774727,1.5,2.75,NaN,NaN,1.3772883160557687,1.0667046278002248,675.91431899358,-0.2552696241520136,0.8368859529589088,1.0921555771109224,6.411427881210157,-0.8120233288470261,13.936834422891293,57.733902863891416,28.329262713217307,9978607399
1410874200,198.61,200.84,198.5,200.48,NaN,NaN,193.63000000000002,203.61684210526317,189.0947205000002,194.77841000000006,197.45131999999987,199.94655499999996,197.5656740897746,199.32229576094568,200.16546923076942,201.40546453442752,198.9254739271113,189.0947205000002,194.77841000000006,197.45131999999987,199.94655499999996,199.94000000000003,116200722,73662601.3,58.796001559386106,0.411765573429948,1.5,2.75,NaN,NaN,1.4460534363375,1.5774724208660278,678.9177184280984,-0.2014091579124111,0.8403941297204085,1.0418032876328196,8.018228272808939,-0.009975062344144754,43.37507405889211,24.240837903403037,32.38408803770484,10094808121
1410960600,200.77,201.68,199.75,200.75,NaN,NaN,193.7440740740741,203.74,189.1934705000002,194.92301000000006,197.54151999999988,200.06455499999998,197.6905496156658,199.45826759323657,200.21239230769248,201.49056005991042,198.93422455547454,189.1934705000002,194.92301000000006,197.54151999999988,200.06455499999998,200.7266666666667,151265896,78269160.65,59.986649668469724,0.5146574774052376,1.5,2.75,NaN,NaN,1.480621048027679,1.9326372576859874,680.0297252355348,-0.14935941273328335,0.8551040217162154,1.0044634344494987,8.049967942629031,0.26966671511576523,53.4537435010935,16.70380446470294,29.842452034203564,10246074017
1411047000,201.36,201.85,201.1,201.82,NaN,NaN,193.85814814814816,203.86315789473684,189.29992050000018,195.07246000000006,197.63551999999984,200.209555,197.852488846424,199.6831944891188,200.29777692307712,201.82210060794722,198.77345323820703,189.29992050000018,195.07246000000006,197.63551999999984,200.209555,201.59,94990300,79380548.6,64.3795213047242,0.7466614929288182,1.5,2.75,NaN,NaN,1.4534338303114158,1.1966445391887857,682.7138081469346,-0.04977857471772662,0.9422402160523404,0.992018790770067,8.489263304997932,0.353040624533827,56.21940903851681,14.887575512437635,28.89301544904557,10341064317
1411133400,201.52,201.899,200.29,200.7,NaN,NaN,193.97222222222223,201.899,189.40467050000018,195.20196000000007,197.72271999999987,200.269555,197.9641559504858,199.78003310920272,200.30470000000017,201.83543696075782,198.77396303924252,189.40467050000018,195.20196000000007,197.72271999999987,200.269555,200.96299999999997,121649147,82073471.45,57.28964503356946,0.3614893025097042,1.5,2.75,NaN,NaN,1.4645456995748867,1.4821981433319766,680.1876562712611,-0.06527358894061808,0.9104268045942945,0.9757003935349126,8.844165578904583,0.054838227229665096,55.35414046494706,15.444615655010155,29.20124388004278,10219415170
1411392600,200.35,200.38,198.73,199.15,NaN,NaN,194.08629629629633,201.969975,189.50177050000016,195.31036000000006,197.77351999999985,200.26755499999996,198.01065963870204,199.7200299559453,200.20085384615402,201.84357705727322,198.55813063503481,189.50177050000016,195.31036000000006,197.77351999999985,200.26755499999996,199.42,125552758,84545741.4,49.21239106552086,0.5012008836627095,1.5,2.75,NaN,NaN,1.5006495781766804,1.4850275829504995,677.538471147835,-0.17937646743587665,0.7514798092400667,0.9308562766759434,9.796405442182955,-0.08528998595223133,48.1267442016611,20.518618052920612,31.354637745418298,10093862412
1411479000,198.43,199.26,197.95,198.01,NaN,NaN,194.2003703703704,202.04095,189.59712050000016,195.40721000000005,197.78171999999984,200.15805499999996,198.01063377051764,199.55716996014098,200.03161538461552,202.04676318041854,198.0164675888125,189.59712050000016,195.40721000000005,197.78171999999984,200.15805499999996,198.40666666666667,111393319,86922656.25,44.26879329816745,0.7483578984586675,1.5,2.75,NaN,NaN,1.4870317511640605,1.2815222613494397,673.856528585691,-0.32272930604984007,0.5274446441136433,0.8501739501634834,9.673769405338637,-1.0296396261308554,23.183966812389304,44.69672310655972,32.119310081050955,9982469093
1411565400,198.04,199.69,197.52,199.56,NaN,NaN,194.31444444444446,202.111925,189.69022050000015,195.52221000000006,197.82831999999985,200.119555,198.07139323049734,199.5574394877466,199.91238461538475,201.8397077551605,197.985061475609,189.69022050000015,195.52221000000006,197.82831999999985,200.119555,198.92333333333332,107275635,89921521.8,51.415097894666296,0.4161556534537446,1.5,2.75,NaN,NaN,1.5358151975094838,1.1929917649592092,675.8604008061603,-0.3044955792813906,0.46955447606174516,0.7740500553431358,10.581797275716196,-0.36944583125312486,17.97133841034438,51.63425539830754,30.39440619134807,10089744728
1411651800,199.04,199.05,196.27,196.34,NaN,NaN,194.42851851851853,202.1829,189.76492050000013,195.60141000000007,197.79591999999985,199.924055,198.00349545675235,199.25101667938978,199.58546153846166,202.24488387194492,196.9260392049784,189.76492050000013,195.60141000000007,197.79591999999985,199.924055,197.22000000000003,150300028,95042837.8,39.95346727543228,1.3238336811283062,1.5,2.75,NaN,NaN,1.6611141119730917,1.5813924697437853,670.685536481444,-0.4896546152621998,0.16198178626538606,0.6516364015275858,13.91984864173871,-1.401094762215634,3.826117150369341,78.84391651447221,17.329966335158435,9939444700
1411738200,196.7,198.39,196.42,197.9,NaN,NaN,194.5425925925926,202.253875,189.85067050000012,195.7126100000001,197.83971999999986,199.812055,197.9994368113895,199.1223484242098,199.47623076923088,202.28286665898628,196.66959487947548,189.85067050000012,195.7126100000001,197.83971999999986,199.812055,197.56999999999996,103546740,97303656.15,46.20970286368115,0.7584462158084878,1.5,2.75,NaN,NaN,1.6888916754035839,1.0641608352349665,674.520680981112,-0.48642549697115356,0.04360453031364386,0.5300300272847974,14.739346211963989,-0.5432679502062955,17.101542843411877,52.89025539764131,30.008201758946814,10042991440
1411997400,196.2,197.89,196.05,197.54,NaN,NaN,194.6566666666667,202.32485,189.94477050000012,195.8092100000001,197.83632199999988,199.653555,197.9814196815311,198.97164857428507,199.2816153846155,202.2431621258475,196.32006864338348,189.94477050000012,195.8092100000001,197.83632199999988,199.653555,197.16,95111605,98763906.5,45.04338018860158,0.8566648611138258,1.5,2.75,NaN,NaN,1.700399412874756,0.9630198760920823,672.2098369794537,-0.4867088614127645,-0.07835604948115815,0.40835281193160633,14.75557211611655,-1.4664804469273733,17.47648159688093,52.324631239541475,30.19888716357758,9947879835
1412083800,197.69,198.3,196.61,197.02,NaN,NaN,194.77074074074076,202.395825,190.0392205000001,195.9026600000001,197.8299219999999,199.47405500000002,197.94371694892203,198.78577728149602,199.02930769230778,202.15514024695753,195.90347513765803,190.0392205000001,195.9026600000001,197.8299219999999,199.47405500000002,197.31000000000003,131302082,101707720.95,43.341703512475895,0.727347151564303,1.5,2.75,NaN,NaN,1.699656597669416,1.2909745766946124,668.9472096881277,-0.49828044581546405,-0.2144977453377237,0.28378270047774035,13.804676276112103,-1.8580323785803188,16.26320347277029,54.11171542151552,29.625081105714177,9816577753
1412170200,196.7,196.77,193.91,194.35,NaN,NaN,194.88481481481483,202.4668,190.1204205000001,195.9665600000001,197.7529219999999,199.16655500000002,197.80278687249373,198.36332230230593,198.66161538461546,202.65712852492612,194.6661022443048,190.1204205000001,195.9665600000001,197.7529219999999,199.16655500000002,195.00999999999996,177797862,107724526.95,35.8521792407293,1.7720910125244755,1.5,2.75,NaN,NaN,1.8003954121216015,1.6504863565799115,664.3151602116064,-0.6523929615052653,-0.5317085014038412,0.12068446010142403,15.185806501901606,-3.7013180061440885,2.750871204281805,82.22948088386735,15.019647911850834,9638779891
1412256600,194.18,195.055,192.35,194.38,NaN,NaN,194.9988888888889,202.537775,190.1962405000001,196.0125100000001,197.66772199999988,198.87505000000002,197.6685599363175,197.9839582735149,198.30769230769238,202.89815837316348,193.71722624222127,190.1962405000001,196.0125100000001,197.66772199999988,198.87505000000002,193.9283333333333,157285182,111326963.95,35.98602903280856,1.8219083239943714,1.5,2.75,NaN,NaN,1.865010025541488,1.412821983276586,665.780672842984,-0.7139739108852678,-0.7717829285051607,-0.05780901761989293,14.391762472310058,-3.1489785749875403,19.41171205622772,49.60075980445992,30.987528139312364,9796065073
1412343000,195.68,196.94,195.08,196.52,NaN,NaN,195.11296296296297,202.60875,190.28559050000007,196.07811000000012,197.6251219999999,198.64555000000001,197.6235183701874,197.8445336760373,198.003076923077,202.50114067482681,193.5050131713272,190.28559050000007,196.07811000000012,197.6251219999999,198.64555000000001,196.17999999999998,121568769,112296563.2,44.82945018314232,0.5872577419296864,1.5,2.75,NaN,NaN,1.914652166574239,1.0825689187253773,668.7254775903315,-0.578047130392175,-0.7803679306101117,-0.2023208002179367,16.580240459116826,-1.3206126035651495,21.083929529346026,47.359479122907665,31.556591347746313,9917633842
1412602200,197.34,197.6,195.582,196.29,NaN,NaN,195.22703703703706,202.679725,190.3585405000001,196.1504100000001,197.59652199999994,198.43055000000004,197.57122353214083,197.696482849748,197.66000000000005,201.94287466365745,193.37712533634266,190.3585405000001,196.1504100000001,197.59652199999994,198.43055000000004,196.49066666666667,104778335,114328192.7,44.12391556127334,0.4127730319155915,1.5,2.75,NaN,NaN,1.9220341546760793,0.9164697921442783,668.3172292998676,-0.4753822145278007,-0.7965485683776876,-0.3211663538498869,16.186317026251068,-0.8686429978283919,21.827641744995304,46.37536921459366,31.796989040411038,9812855507
1412688600,195.28,195.72,193.22,193.26,NaN,NaN,195.34111111111113,202.7507,190.41739050000012,196.2090100000001,197.50572199999996,198.12755000000004,197.40215594264512,197.27396067358154,197.00153846153853,201.15374896571947,192.8493279573576,190.41739050000012,196.2090100000001,197.50572199999996,198.12755000000004,194.0666666666667,147913498,117294323.8,36.07009908578694,1.3233750266974507,1.5,2.75,NaN,NaN,2.004031715056359,1.261045660250441,664.0969773742369,-0.576553022021269,-1.0418576313764731,-0.4653046093552041,18.011660453600083,-3.156945279615159,20.94184526654575,47.52827044220666,31.52988429124759,9664942009
1412775000,193.37,196.92,192.36,196.64,NaN,NaN,195.4551851851852,202.821675,190.49279050000013,196.2949100000001,197.49952199999993,197.95605000000003,197.37226747430608,197.21358346657377,196.68923076923085,200.2504272971013,193.12803424136038,190.49279050000013,196.2949100000001,197.49952199999993,197.95605000000003,195.30666666666664,186461453,123254841.3,47.56722489036616,0.6711801691929135,1.5,2.75,NaN,NaN,2.186600878266617,1.5128124058523291,669.3164049522787,-0.38979526502250517,-0.9525486906333356,-0.5627534256108304,20.628641043958282,0.15279616990933226,55.31340496017292,15.460670540271988,29.2259244995551,9851403462
1412861400,196.33,196.6,192.58,192.74,NaN,NaN,195.56925925925927,202.89265,190.5438405000001,196.3349100000001,197.41472199999993,197.57805000000002,197.1906099262941,196.78752789832865,196.1961538461539,200.02307499034447,192.3692327019633,190.5438405000001,196.3349100000001,197.41472199999993,197.57805000000002,193.97333333333336,210704601,130448893.45,38.878969350063045,1.53101019478805,1.5,2.75,NaN,NaN,2.3204151012475713,1.6152272006873047,662.2763410321144,-0.496063782463823,-1.1828331536906092,-0.6867693712267862,21.699331710390126,-2.607377463365334,21.9146457600279,46.26350618164327,31.821848058328843,9640698861
1412947800,192.69,193.65,190.49,190.54,NaN,NaN,195.68333333333334,202.963625,190.58189050000013,196.36481000000012,197.36372199999994,197.14855000000003,196.9298016938904,196.19252524134495,195.62153846153853,200.32855349578875,190.91452342728832,190.58189050000013,196.36481000000012,197.36372199999994,197.14855000000003,191.56,221908954,135670415.35,34.99582315613033,1.9529148376283283,1.5,2.75,NaN,NaN,2.380385451158459,1.635647340118503,656.5673487749299,-0.6708040623835714,-1.5252744492062504,-0.8544703868226791,21.358267370115126,-3.5435861091424523,5.886194376447984,73.34793499905837,20.765870624493665,9418789907
1413207000,190.46,191.15,187.3,187.4099,NaN,NaN,195.79740740740743,203.0346,190.5996650000001,196.3476090000001,197.26191999999995,196.569995,196.55647221569862,195.35608474216923,194.68691538461547,200.57224871462395,188.801582054607,190.5996650000001,196.3476090000001,197.26191999999995,196.569995,188.61996666666667,230938833,143397285.95,30.35106461431282,2.9543062653448295,1.5,2.75,NaN,NaN,2.4853579189328547,1.6104825936560903,653.3569078872839,-0.9371288532572555,-2.0258814533942484,-1.088752600136993,22.503004062557167,-4.877728149426463,4.01768470502228,78.29968692342302,17.682628371554703,9187851074
1413293400,188.42,189.82,187.04,187.7,NaN,NaN,195.9114814814815,203.105575,190.61894000000007,196.3287090000001,197.13812,195.930995,196.20915957978886,194.6269338143436,194.02230000000006,200.8816059357424,187.1629940642577,190.61894000000007,196.3287090000001,197.13812,195.930995,188.1866666666666,215846527,148379576.2,31.261649080549233,2.7265352417334285,1.5,2.75,NaN,NaN,2.506403781866222,1.4546916262185685,656.398289152433,-1.0264907756841404,-2.3718660697421683,-1.345375294058028,22.80695973830589,-3.421661950090047,17.7674749379153,51.94500941995999,30.28751564212473,9403697601
1413379800,185.16,187.694,181.92,186.43,NaN,NaN,181.92,203.17655,190.6319900000001,196.2895090000001,197.02651999999998,195.214995,195.82566312567948,193.8462734510728,193.13999230769235,200.6928653425007,185.587119272884,190.6319900000001,196.2895090000001,197.02651999999998,195.214995,185.34799999999996,380714600,159852011.4,29.44662671325993,3.8556879043430325,1.5,2.75,NaN,NaN,2.740232083161492,2.3816691242460024,654.1943964923556,-1.0974736580782651,-2.7172173666558592,-1.619743708577594,22.171236696597685,-4.089926947216786,3.127131457116046,81.00535708589062,15.867511456993341,9022983001
1413466200,183.06,187.58,182.89,186.27,NaN,NaN,181.74020833333333,203.247525,190.63989000000004,196.2370090000001,196.91052,194.43749499999998,195.45093123839794,193.12472359858967,192.27306923076927,200.18538970238674,184.3607487591518,190.63989000000004,196.2370090000001,196.91052,194.43749499999998,185.58,270391490,168622070.9,29.216483072363488,3.1278178157893883,1.5,2.75,NaN,NaN,2.8795012200785304,1.6035355784495942,658.2911981453263,-1.0798769029518158,-2.969589837267364,-1.889712934315548,22.10679052395444,-5.215754121717891,2.8689445971777325,81.85334808099554,15.277707321826739,8752591511
1413552600,188.42,189.75,187.62,188.47,NaN,NaN,181.56041666666664,203.3185,190.66764000000006,196.20790900000011,196.85931999999997,193.82599499999998,195.177169229049,192.68141658920018,191.61537692307695,199.2568098165674,183.9739440295865,190.66764000000006,196.20790900000011,196.85931999999997,193.82599499999998,188.61333333333334,214624921,173270859.6,36.55863442021114,1.2888809101540541,1.5,2.75,NaN,NaN,2.92239399007292,1.2386671451591276,660.0811739490529,-0.8546116535730839,-2.9579775012819027,-2.103365847708819,22.30953524319942,-3.983901370421312,13.084478461476419,59.17439970038846,27.741121838135125,8967216432
1413811800,188.13,190.45,188.07,190.3,NaN,NaN,181.38062499999998,203.389475,190.70471500000008,196.1872090000001,196.80051999999995,193.38349499999998,194.98590769065493,192.45461500927635,191.3038384615385,198.80281657594765,183.80486034712936,190.70471500000008,196.1872090000001,196.80051999999995,193.38349499999998,189.60666666666665,130010813,173493762.35,41.95236009879742,0.6736521085963754,1.5,2.75,NaN,NaN,2.8836515622105687,0.7493688028836503,664.7953950508909,-0.5326572945937729,-2.7691874659510347,-2.236530171357262,23.666228305041994,-1.5316154403394286,27.26486566028781,39.891982875674,32.84315146403819,9097227245
1413898200,191.68,194.2,191.48,194.07,NaN,NaN,181.20083333333332,203.46045,190.76326500000008,196.20110900000012,196.80601999999996,193.186495,194.9499897420018,192.6084611988691,191.27999230769234,198.741569249902,183.81841536548268,190.76326500000008,196.20110900000012,196.80601999999996,193.186495,193.25,154948579,175671525.35,51.163900225853844,1.2275431194298967,1.5,2.75,NaN,NaN,2.9562478791955265,0.8820358261891759,669.8540256550904,-0.04195715287207591,-2.2889766124473567,-2.247019459575281,25.42908582327059,-1.3069568755085401,24.1652693466254,43.534103598880556,32.300627054494036,9252175824
1413984600,194.41,194.91,192.61,192.69,NaN,NaN,181.02104166666666,203.531425,190.80931500000005,196.1990590000001,196.78921999999994,192.84299500000003,194.86136269329586,192.6162267989768,190.98537692307698,197.87675923754202,184.09399460861195,190.80931500000005,196.1990590000001,196.78921999999994,192.84299500000003,193.40333333333334,151822409,177898864.05,48.15171378115901,0.969335060519259,1.5,2.75,NaN,NaN,2.9093730306815595,0.8534197776402271,666.3464095434674,0.20022092422836701,-1.9967433042898222,-2.196964228518189,23.261803510179323,-0.025941683096405193,37.69733282354475,29.23968675554497,33.06298042091027,9100353415
1414071000,194.62,196.2,194.26,194.93,NaN,NaN,180.84124999999997,203.6024,190.8663650000001,196.2203590000001,196.79101999999995,192.772495,194.86405435238228,192.8365861514552,190.88076153846157,197.48204314995306,184.27947992697008,190.8663650000001,196.2203590000001,196.79101999999995,192.772495,195.13,154944169,178131071.1,52.98970219691293,1.6844886513544648,1.5,2.75,NaN,NaN,2.9522749570614475,0.8698323545869029,671.1848967971563,0.5044984099478986,-1.5663412160833161,-2.0708396260312147,21.301747660775394,2.3039781673139577,76.62563720007296,4.625617085513538,18.748745714413495,9255297584
1414157400,195.25,196.49,194.49,196.43,NaN,NaN,180.66145833333331,203.673375,190.9303150000001,196.2527590000001,196.80441999999996,192.698995,194.9254639856222,193.1788160417928,191.12460769230773,198.2711026053022,183.97811277931328,190.9303150000001,196.2527590000001,196.80441999999996,192.698995,195.80333333333337,117927286,178850098.4,55.9536353989415,1.7654648422658736,1.5,2.75,NaN,NaN,2.884255317271344,0.659363830688281,674.0614790182523,0.7833729481774063,-1.0916234408094567,-1.874996388986863,19.94840637560873,4.813032822705745,73.26133878403796,5.948785201093942,20.78987601486809,9373224870
1414416600,195.73,196.45,195.03,196.16,NaN,NaN,180.48166666666665,203.74435,190.9904150000001,196.2698590000001,196.81321999999997,192.62999499999998,194.97387716265663,193.46273832352682,191.08768461538466,198.12392413370762,184.0514450970617,190.9904150000001,196.2698590000001,196.81321999999997,192.62999499999998,195.88,82953689,178242202.6,55.278042227717364,1.4537927127440529,1.5,2.75,NaN,NaN,2.7796656517519613,0.4653986978951303,671.9827532264675,0.9169636165785089,-0.7287918682637269,-1.6457554848422358,16.009724240586245,4.507192328183276,55.17391088055775,15.559065010590361,29.26702410885189,9290271181
1414503000,196.82,198.42,196.73,198.41,NaN,NaN,180.301875,203.815325,191.07404000000014,196.3002090000001,196.83421999999996,192.69949499999998,195.10862707784656,193.93390610223855,191.52383846153847,199.54911258523063,183.49856433784632,191.07404000000014,196.3002090000001,196.83421999999996,192.69949499999998,197.85333333333332,106735936,177013895.3,59.65025396197977,1.9977119617702048,1.5,2.75,NaN,NaN,2.7425466766268203,0.6029805503071147,677.1147764471536,1.1112206936574087,-0.25672961777047476,-1.3679503114278835,16.325686719911957,6.426004398433723,51.360150979288754,18.145569361461845,30.494279659249408,9397007117
1414589400,198.55,199.12,196.8,198.11,NaN,NaN,180.1220833333333,203.8863,191.14624000000015,196.3255090000001,196.82861999999997,192.887495,195.22632797675453,194.3316293305968,192.10614615384617,200.82955139814376,183.38274090954857,191.14624000000015,196.3255090000001,196.82861999999997,192.887495,198.01,142557417,175251873.05,58.824478668133814,1.7697521820934865,1.5,2.75,NaN,NaN,2.7123647711534753,0.8134430435406977,674.9743015809006,1.1680512839441068,0.09211379350225002,-1.0759374904418568,15.104711124038381,6.356364417243788,52.12983079645449,17.607323539304144,30.262845664241357,9254449700
1414675800,197.58,199.95,197.4,199.38,NaN,NaN,179.94229166666665,203.957275,191.21984000000012,196.36330900000013,196.83781999999997,193.137495,195.38921707570535,194.81242653720662,193.0269230769231,202.093349341292,183.96049681255423,191.21984000000012,196.36330900000013,196.83781999999997,193.137495,198.91,113329976,173054112.75,61.268902669743035,1.9868122100043173,1.5,2.75,NaN,NaN,2.7007672874996547,0.6548817257161662,676.3227013058271,1.2332979682971295,0.4656849699295549,-0.7676129983675745,14.446958283812961,5.788719690136359,48.416744697432854,20.28153783140443,31.301717471162718,9367779676
1414762200,201.78,201.82,200.77,201.66,NaN,NaN,179.7625,204.02825,191.30604000000014,196.43070900000012,196.88101999999995,193.39449499999998,195.63513013156003,195.464576390806,194.10076923076926,203.6814114496186,184.52012701191993,191.30604000000014,196.43070900000012,196.88101999999995,193.39449499999998,201.41666666666666,146902554,174320802,65.2566277662055,2.624893834163189,1.5,2.75,NaN,NaN,2.6821410526782508,0.8427138489186161,680.9727955654498,1.3620442632708483,0.9349423307209861,-0.4271019325498623,14.402143270469942,5.9695218076720895,51.59934191385115,17.977410107027744,30.423247979121108,9514682230
1415025000,201.92,202.45,201.305,201.77,NaN,NaN,179.5827083333333,204.099225,191.3967150000001,196.51300900000012,196.93261999999996,193.66849499999998,195.8757132636557,196.06509292501497,195.28076923076927,204.56580255257708,185.99573590896145,191.3967150000001,196.51300900000012,196.93261999999996,193.66849499999998,201.84166666666667,93734143,173768592.4,65.44149624281708,2.4343015811856223,1.5,2.75,NaN,NaN,2.5723452632012314,0.5394193605725496,679.8761175348945,1.3822530855905049,1.3007144244382687,-0.08153866115223607,14.677812034857425,3.967640542072457,73.1286863923532,6.02021714960157,20.85109645804523,9608416373
1415111400,201.23,201.6,200.06,201.07,NaN,NaN,179.40291666666664,204.1702,191.48116500000012,196.58240900000013,196.95001999999994,194.058995,196.07941078272805,196.5417507416802,196.41923076923084,204.5652159494481,188.27324558901358,191.48116500000012,196.58240900000013,196.95001999999994,194.058995,200.91,93342777,171040056.35,63.13910383325279,1.7635575801667736,1.5,2.75,NaN,NaN,2.510749172972573,0.5457363555177523,677.1869341426594,1.2785306008359263,1.5166245898926718,0.23809398905674556,12.592857831420428,4.348954278893557,49.99883930356392,19.206201434377267,30.794959262058804,9515073596
1415197800,202.54,202.59,201.45,202.34,NaN,NaN,179.22312499999998,204.241175,191.57136500000007,196.6629090000001,196.99021999999994,194.343995,196.32492408536615,197.09396495675827,197.48615384615394,204.77634763259348,190.1959600597144,191.57136500000007,196.6629090000001,196.99021999999994,194.343995,202.12666666666667,91708574,166302412.4,65.50998543497113,1.9578042916461453,1.5,2.75,NaN,NaN,2.439981374903104,0.5514566666622811,679.3278062391037,1.2253744456610813,1.7698120461330973,0.544437600472016,10.636272837766825,3.801364592417789,81.0678294246621,3.122174196018062,15.80999637931983,9606782170
1415284200,202.39,203.26,201.64,203.15,NaN,NaN,179.04333333333332,204.31215,191.67316500000007,196.7461090000001,197.04821999999993,194.86449500000003,196.59257412123415,197.67073019897177,198.47461538461545,205.048786828801,191.90044394042988,191.67316500000007,196.7461090000001,197.04821999999993,194.86449500000003,202.6833333333333,107089076,161121636.15,66.96923183940143,2.008990326810463,1.5,2.75,NaN,NaN,2.3814112766957396,0.6646473965811946,681.3514757020442,1.174549818139297,2.0126248731461374,0.8380750550068403,9.75134378659288,3.4210660286107,80.89880530794522,3.1748972301199125,15.926297461934873,9713871246
1415370600,203.17,203.5999,202.61,203.34,NaN,NaN,178.86354166666663,204.383125,191.79541500000008,196.8169590000001,197.11221999999995,195.50449500000005,196.85717905765634,198.21066065621255,199.18769230769237,205.70690015880305,192.6684844565817,191.79541500000008,196.8169590000001,197.11221999999995,195.50449500000005,203.18329999999997,89539712,154503174.05,67.31852506904964,1.7879942915133502,1.5,2.75,NaN,NaN,2.2820176140746136,0.5795331555520233,683.9950539110494,1.0856068697501993,2.1950836421945894,1.1094767724443901,9.622928865278038,3.6602773246329563,78.27375653147661,4.044572128017103,17.681671340506295,9803410958
1415629800,203.38,204.04,203.13,203.98,NaN,NaN,178.68374999999997,204.4541,191.92526500000008,196.8919590000001,197.17761999999996,196.33300000000003,197.13650536912078,198.76012154609708,200.0561538461539,205.8491604441005,194.2631472482073,191.92526500000008,196.8919590000001,197.17761999999996,196.33300000000003,203.71666666666667,66318964,146272180.6,68.52588317698178,1.792592266347891,1.5,2.75,NaN,NaN,2.1840163559264267,0.4533942389315826,686.0051295415677,1.003678263707961,2.3640746020793415,1.3603963383713804,9.13054914015385,2.8073181795272384,75.45206487929617,5.0430341217389545,19.504900998964885,9869729922
1415716200,204.055,204.31,203.65,204.175,NaN,NaN,178.50395833333332,204.525075,192.0507900000001,196.9743090000001,197.2489199999999,197.15675000000002,197.41252476641017,199.2758242559926,200.76730769230778,206.12179770664298,195.41281767797258,192.0507900000001,196.9743090000001,197.2489199999999,197.15675000000002,204.045,54499375,138204823,68.90284248275525,1.6131287268582322,1.5,2.75,NaN,NaN,2.0751580447888247,0.39433772148458235,686.7184120450855,0.89975449828259,2.485089461224618,1.585334962942028,7.877647319796798,3.061430518398868,100,0,0,9924229297
1415802600,203.35,204.24,203.31,203.96,NaN,NaN,178.32416666666666,204.59605,192.1838400000001,197.05510900000007,197.3181199999999,198.03325,197.66928850106075,199.72193623161235,201.3465384615386,206.3140875935237,196.37898932955346,192.1838400000001,197.05510900000007,197.3181199999999,198.03325,203.83666666666664,90120295,123675107.75,67.93671597540714,1.375567807511836,1.5,2.75,NaN,NaN,1.9933610415896232,0.728685801367333,688.0737557364565,0.7592764839139363,2.5344305678344483,1.775154083920512,7.78833128840528,2.2971210753335405,73.42304680199426,5.851362186352915,20.72559101165282,9834109002
1415889000,204.16,204.83,203.21,204.19,NaN,NaN,178.14437499999997,204.667025,192.30864000000008,197.15000900000007,197.3977179999999,198.92925000000002,197.92500267748974,200.14746611431593,201.9642307692309,206.1309041262241,197.79755741223772,192.30864000000008,197.15000900000007,197.3977179999999,198.92925000000002,204.07666666666668,85357918,114423429.15,68.44642172858494,1.1955298484197747,1.5,2.75,NaN,NaN,1.9666923957617932,0.7459828693658758,685.2605217052594,0.6299193798294254,2.562553308707294,1.9326339288778684,7.509150091996283,1.2545869284935045,71.73241583478021,6.566396312430885,21.701187852788898,9919466920
1415975400,204.1,204.49,203.72,204.24,NaN,NaN,177.9645833333333,204.738,192.4389400000001,197.23660900000007,197.4603179999999,199.71775000000005,198.17264963131367,200.53723124628584,202.41269230769242,206.18937505109716,198.6360095642877,192.4389400000001,197.23660900000007,197.4603179999999,199.71775000000005,204.15,80417514,107713058.8,68.56341845206236,1.0489700062202667,1.5,2.75,NaN,NaN,1.8812143674930943,0.7465901989592371,686.3767796261861,0.5013908668383644,2.559372512425824,2.0579816455874598,4.905249425273821,1.2241661297516968,70.97486737076153,6.898959137935101,22.12617349130339,9999884434
1416234600,203.85,204.58,203.65,204.37,NaN,NaN,177.78479166666665,204.808975,192.5899400000001,197.32590900000005,197.53591799999992,200.42125000000004,198.4156829791053,200.90225684187766,202.8942307692309,205.86378356164838,199.9246779768134,192.5899400000001,197.32590900000005,197.53591799999992,200.42125000000004,204.20000000000002,80440954,105234565.85,68.8864409759932,0.9936392332249931,1.5,2.75,NaN,NaN,1.8132704841007308,0.7643966918118853,684.2554592826265,0.38408201762542893,2.538084167619246,2.154002149993817,4.900609902392894,1.6412194758044518,72.49879936493436,6.241524447614595,21.259676187451053,10080325388
1416321000,204.44,205.92,204.44,205.55,NaN,NaN,177.60499999999996,204.87995,192.7407650000001,197.42320900000007,197.6605179999999,200.99525000000006,198.6954601171796,201.34489904741312,203.36884615384628,205.8763246723355,200.86136763535706,192.7407650000001,197.42320900000007,197.6605179999999,200.99525000000006,205.30333333333337,76068107,101290542.25,71.72633978017058,1.4000105714965965,1.5,2.75,NaN,NaN,1.794465449522106,0.7509892366086134,687.2173382931073,0.3460881064256096,2.586612283025829,2.2405241766002195,4.4682340236906075,1.5864386675892101,74.18898597349978,5.543381824383637,20.267632202116587,10156393495
1416407400,205.31,205.55,204.3,205.22,NaN,NaN,177.4252083333333,204.950925,192.89101500000012,197.51820900000007,197.7635179999999,201.62175000000005,198.9513244263098,201.71395628099282,203.6426923076924,206.12127321491778,201.16411140046705,192.89101500000012,197.51820900000007,197.7635179999999,201.62175000000005,205.02333333333334,82373009,97818072.25,69.80735740262928,0.931100124422359,1.5,2.75,NaN,NaN,1.755575060270527,0.8421041951171758,684.2840132847941,0.2626454882281437,2.568831036885399,2.3061855486572553,4.107414811374571,1.018951513659854,76.07769542392427,4.8080250149161285,19.11427956115961,10074020486
1416493800,204.26,205.71,204.18,205.58,NaN,NaN,177.24541666666664,205.0219,193.0315150000001,197.6037090000001,197.8691179999999,202.15425000000008,199.21127248802316,202.08215092089827,203.93576923076932,206.35971974484974,201.5118187166889,193.0315150000001,197.6037090000001,197.8691179999999,202.15425000000008,205.15666666666667,72840326,93712880.1,70.72743887026797,0.9613214210268932,1.5,2.75,NaN,NaN,1.7394625559654895,0.7772712344586239,687.0467677979567,0.19852626673941698,2.5543433820815267,2.3558171153421097,3.781038713527188,1.101603226123738,75.23635364342351,5.12972865440757,19.633917702168926,10146860812
1416580200,207.64,207.8445,205.98,206.68,NaN,NaN,177.06562499999998,205.092875,193.16651500000012,197.6982090000001,198.02011799999994,202.66675000000006,199.50416376300265,202.52004130938414,204.36730769230778,206.58560438949817,202.14901099511738,193.16651500000012,197.6982090000001,198.02011799999994,202.66675000000006,206.83483333333334,142327285,94932880.05,73.39527304176893,1.3955425441255607,1.5,2.75,NaN,NaN,1.776965230539383,1.4992411999408208,690.3714878524665,0.19665240119919325,2.6016326168411013,2.404980215641908,4.454638491699862,1.3236591822727803,79.13855940937567,3.7180396916136806,17.14340089901064,10289188097
1416839400,207.17,207.39,206.91,207.26,NaN,NaN,176.8858333333333,205.16385,193.3027650000001,197.78880900000007,198.18569799999995,203.22175000000007,199.80831420366923,202.97146594658565,204.74576923076927,207.12441734765733,202.3671211138812,193.3027650000001,197.78880900000007,198.18569799999995,203.22175000000007,207.18666666666664,65880759,94079233.55,74.70434646360695,1.3332812235741724,1.5,2.75,NaN,NaN,1.700753428357997,0.7002688745862982,692.6689344502279,0.20025755421635694,2.655302158412354,2.4550446041959972,4.416565268672463,1.510958736378097,79.01947340621386,3.773745776228191,17.20678081755793,10355068856
1416925800,207.54,207.79,206.8,207.11,NaN,NaN,176.70604166666664,205.234825,193.4284150000001,197.8848090000001,198.31829799999997,203.65675000000005,200.09465482313317,203.36561204691083,205.05038461538467,207.545007946115,202.55576128465435,193.4284150000001,197.8848090000001,198.31829799999997,203.65675000000005,207.23333333333335,79108301,92697851.8,73.69442458585759,1.203527846365366,1.5,2.75,NaN,NaN,1.6499853263324245,0.8533995067186659,694.0918153883019,0.16006453977981305,2.6551252789207638,2.4950607391409507,4.606186439349395,1.544420474602866,54.26781200069559,16.193622432789148,29.538565566515263,10275960555
1417012200,207.29,207.76,207.03,207.64,NaN,NaN,176.52624999999998,205.3058,193.55626500000008,197.99880900000008,198.45609799999994,204.13325000000006,200.39055071242205,203.7726966138717,205.38115384615386,208.0172119576202,202.74509573468754,193.55626500000008,197.99880900000008,198.45609799999994,204.13325000000006,207.47666666666666,62167832,88678372.55,74.98141115164874,1.099800776652779,1.5,2.75,NaN,NaN,1.5842720887372506,0.7010484091253206,696.4346175149253,0.13755785865945658,2.6670080624652712,2.5294502038058146,4.354295376060881,1.6896028209020955,78.89308549887552,3.8165860762288966,17.29032842489559,10338128387
1417185000,207.49,207.87,206.91,207.2,NaN,NaN,176.34645833333332,205.376775,193.67721500000007,198.0996090000001,198.56369799999996,204.52425000000008,200.6575879393859,204.09910646016962,205.62884615384615,208.29666045327957,202.96103185441274,193.67721500000007,198.0996090000001,198.56369799999996,204.52425000000008,207.3266666666667,57890088,85906378.15,71.8391042016862,0.8836016216305247,1.5,2.75,NaN,NaN,1.5396812252560188,0.6738741551752871,693.4926500756437,0.06509980994724796,2.610824966239875,2.545725156292627,4.89835760856247,1.4492753623188306,58.331839392526824,13.601444760247226,28.06671584722595,10280238299
1417444200,206.4,206.54,205.38,205.76,NaN,NaN,176.16666666666663,205.44774999999998,193.7859150000001,198.19380900000007,198.66489799999997,204.7292500000001,200.85768252999821,204.25728679729633,205.75076923076924,208.28310122433524,203.21843723720323,193.7859150000001,198.19380900000007,198.66489799999997,204.7292500000001,205.89333333333332,103968354,83759668.15,62.59380727551707,0.20391151188270587,1.5,2.75,NaN,NaN,1.5597039948805882,1.2412698891524918,688.3128074881929,-0.0988344570608839,2.422182084966522,2.521016542027406,6.894509620371839,0.6801389636443638,15.21111210076311,55.700440634030535,29.08844726520635,10176269945
1417530600,205.81,207.34,205.782,207.085,NaN,NaN,175.98687499999997,205.518725,193.9001400000001,198.29855900000007,198.82359799999995,204.99500000000006,201.10189105823358,204.52659281660144,205.99115384615385,208.38752338828138,203.59478430402632,193.9001400000001,198.29855900000007,198.82359799999995,204.99500000000006,206.73566666666667,74507192,82798320.6,66.82453471784788,0.6278090742334879,1.5,2.75,NaN,NaN,1.5611537095319756,0.8998635655902423,691.7328409987718,-0.13482943616729326,2.3524797468182896,2.487309182985583,7.620685283333064,0.7467769399172933,16.638844708303413,53.53532478340747,29.825830508289126,10250777137
1417617000,207.3,208.15,207.1,207.89,NaN,NaN,175.8070833333333,205.5897,194.02449000000013,198.40145900000007,199.02119799999994,205.3360000000001,201.36809140889108,204.84691731025845,206.27576923076924,208.62731813493644,203.92422032660204,194.02449000000013,198.40145900000007,199.02119799999994,205.3360000000001,207.71333333333334,68951968,81578780.15,69.11038960456638,0.8523131414284815,1.5,2.75,NaN,NaN,1.52571415885112,0.8452194047669882,693.854784801667,-0.1216255135561477,2.3352772910403985,2.456902804596546,7.290466870996914,1.301042783354443,41.033490765100964,26.199979488866102,32.76652974603294,10319729105
1417703400,207.54,208.265,206.7,207.66,NaN,NaN,175.62729166666665,205.660675,194.14229000000014,198.50575900000007,199.18319799999995,205.6020000000001,201.6148329222679,205.11482994737668,206.53884615384615,208.67597634265815,204.40171596503416,194.14229000000014,198.50575900000007,199.18319799999995,205.6020000000001,207.54166666666666,91316591,81559181,67.67562534234514,0.6265846744396641,1.5,2.75,NaN,NaN,1.5285202903617543,1.119635948771972,690.6721111198854,-0.14405091683485782,2.276839158552974,2.420890075387832,7.227294186202843,1.011771573110217,16.606516897206465,53.58329457277789,29.810188530015644,10228412514
1417789800,207.87,208.47,207.55,208,NaN,NaN,175.44749999999996,205.73165,194.26284000000015,198.60615900000008,199.41639799999993,205.8445000000001,201.86523163119858,205.38960804762652,206.81807692307694,208.67953019516546,204.95662365098843,194.26284000000015,198.60615900000008,199.41639799999993,205.8445000000001,208.00666666666666,91025470,80756000.7,68.7097710058054,0.7083999710906197,1.5,2.75,NaN,NaN,1.4850545553359138,1.1271666403856475,692.063177234441,-0.15092812507643938,2.2322299190422825,2.383158044118722,7.224238783088621,0.6386684730017385,39.031093256093385,27.957441043926107,33.01146569998052,10319437984
1418049000,207.52,208.12,205.93,206.61,NaN,NaN,175.2677083333333,205.802625,194.37134000000012,198.71515900000009,199.59059799999994,206.0080000000001,202.0513009789947,205.50583585261447,206.8996153846154,208.6191970043426,205.1800337648882,194.37134000000012,198.71515900000009,199.59059799999994,206.0080000000001,206.88666666666668,108588152,81708422.7,60.22656105485842,0.16577114272422586,1.5,2.75,NaN,NaN,1.5354078013833483,1.3289713399399643,688.0835415727253,-0.2577600739451378,2.0609579516873,2.3187180256324376,7.94983541276359,-0.31361574833541317,38.554800668109,28.374200308452764,33.070999023438226,10210849832
1418135400,204.37,206.6,203.91,206.47,NaN,NaN,175.08791666666664,205.8736,194.47949000000014,198.8027600000001,199.76919799999993,206.1325000000001,202.22458329354393,205.59766100950833,206.99576923076924,208.44791801612664,205.54362044541185,194.47949000000014,198.8027600000001,199.76919799999993,206.1325000000001,205.66,125180054,84651477.2,59.430676083606905,0.42309857897756886,1.5,2.75,NaN,NaN,1.6185929584273961,1.4787698707755095,690.8371010059387,-0.3412818433825935,1.8921157214041955,2.233397564786789,7.744227986107036,-0.30901453333977824,13.888828110217942,57.785065880034416,28.326106009747644,10085669778
1418221800,205.91,205.98,202.93,203.1601,NaN,NaN,174.90812499999996,205.944575,194.57104050000015,198.8609610000001,199.8919999999999,206.0817550000001,202.26127022320887,205.3655123419361,206.8096230769231,209.2345508737075,204.3846952801387,194.57104050000015,198.8609610000001,199.8919999999999,206.0817550000001,204.02336666666665,159856394,89919328.15,44.468719688948724,1.1565139941127078,1.5,2.75,NaN,NaN,1.7558363185397245,1.777775671692449,685.2232231127173,-0.6073326569590258,1.4742317435880068,2.0815644005470326,11.920902380781216,-2.1575322673858537,2.89323269419846,81.73117607757041,15.375591228231139,9925813384
1418308200,203.88,206.19,203.71,204.19,NaN,NaN,174.7283333333333,206.01555,194.66289050000017,198.9208610000001,200.0887999999999,206.09325500000008,202.3369066850438,205.25355878556124,206.61808461538465,209.41806183053131,203.81810740023798,194.66289050000017,198.9208610000001,200.0887999999999,206.09325500000008,204.69666666666663,159012805,93363953.65,48.78894415902896,0.5333419177404255,1.5,2.75,NaN,NaN,1.8468408672154584,1.7031498644123666,687.7753120403875,-0.6955021845388576,1.2121866698734607,1.9076888544123183,12.342754042359642,-1.4527027027026984,19.612379683887102,49.29742056456301,31.090199751549886,10084826189
1418394600,202.64,203.819,200.85,200.89,NaN,NaN,174.54854166666664,206.086525,194.73589050000018,198.94336100000007,200.2189999999999,205.92825500000012,202.28016524641464,204.83798175836492,206.12808461538464,210.23276049755222,202.02340873321705,194.73589050000018,198.94336100000007,200.2189999999999,205.92825500000012,201.85299999999998,202330191,99212567.3,38.46327040509707,1.6094938360726836,1.5,2.75,NaN,NaN,1.953495090985783,2.039360501459375,682.4360296440409,-0.9422960882601197,0.7298187440871686,1.6721148323472883,14.931003390714888,-2.366835147744948,5.2604550800462535,74.89325708895585,19.8462878309979,9882495998
1418653800,201.98,202.53,198.78,199.51,NaN,NaN,174.36874999999998,206.1575,194.80854050000016,198.95196100000004,200.2787999999999,205.69175500000014,202.1715313151827,204.33055492423492,205.54346923076926,210.89708749100186,200.18985097053667,194.80854050000016,198.95196100000004,200.2787999999999,205.69175500000014,200.2733333333333,189965750,104689979.1,35.11627405287621,2.1761546058173042,1.5,2.75,NaN,NaN,2.081816870201084,1.8145552385538686,678.2185066743347,-1.1508977357193984,0.23349266269804048,1.3843903984174388,14.923394136913352,-3.6579182461308237,4.132534777143132,77.94410742455597,17.92335779830089,9692530248
1418740200,198.58,202.395,197.86,197.91,NaN,NaN,197.86,206.228475,194.86019050000016,198.95386100000005,200.31119999999987,205.36875500000014,202.0044124400775,203.7190735028792,204.7950076923077,211.35223208188694,198.23778330272847,194.86019050000016,198.95386100000005,200.31119999999987,205.36875500000014,199.38833333333332,259543848,113645123.8,31.674771463504612,2.0160566149834973,1.5,2.75,NaN,NaN,2.257044236615292,2.283809804781083,676.199843750516,-1.3360427311003957,-0.2856630154580557,1.05037971564234,13.824076888186875,-4.800615710231368,3.0584488637571594,81.20328506373221,15.73826607251063,9432986400
1418826600,198.44,202.34,198.29,201.79,NaN,NaN,198.23069767441862,206.29945,194.9303905000002,198.99376100000006,200.4817999999999,205.18075500000015,201.99600410909406,203.53535221689071,204.37885384615387,210.95937437577572,197.79833331653202,194.9303905000002,198.99376100000006,200.4817999999999,205.18075500000015,200.80666666666664,253910092,122537223.05,45.598281090561564,1.1619717254583213,1.5,2.75,NaN,NaN,2.4122553625713428,2.0721058114430644,682.9550382748229,-1.1440140354355353,-0.3796378286520792,0.7643762067834561,19.125410195973632,-2.8267360107868655,19.403922539458808,49.61096506963793,30.985112390903247,9686896492
1418913000,204.74,212.97,203.92,206.78,NaN,NaN,198.60139534883723,212.97,195.02339050000018,199.09206100000003,200.68459999999993,205.25875500000012,202.18361179109036,203.84436629147254,204.45731538461544,211.12557478884912,197.78905598038176,195.02339050000018,199.09206100000003,200.68459999999993,205.25875500000012,207.88999999999996,257633887,131300266.95,57.57295970514633,2.0409229637562207,1.5,2.75,NaN,NaN,3.03852283667339,1.9621733678432556,688.4741249257387,-0.652201592596273,-0.05087578396188519,0.6013258086343878,24.79621498904562,-0.586538461538461,25.51609284919967,41.849717977078036,32.6341891737223,9944530379
1418999400,206.43,207.33,205.6109,206.52,NaN,NaN,198.97209302325584,213.14573015873015,195.11469050000014,199.18746100000004,200.96019999999993,205.30575500000015,202.35366623065545,204.09918854942754,204.4138538461539,211.02011793488035,197.80758975742745,195.11469050000014,199.18746100000004,200.96019999999993,205.30575500000015,206.4869666666667,245084590,139912480.15,56.870540965829896,1.2868858449323484,1.5,2.75,NaN,NaN,2.9442783483395787,1.7516992746983335,691.864356611933,-0.33182836142596184,0.18654035685193548,0.5183687182778973,24.76389058512662,-0.04356033105851769,23.372119545368694,44.442004073970836,32.18587638066047,9699445789
1419258600,206.75,207.47,206.46,207.47,NaN,NaN,199.34279069767445,213.32146031746032,195.21124050000014,199.33126100000004,201.29879999999991,205.34525500000012,202.55430677062975,204.4202182113868,204.38154615384622,210.9232872754653,197.83980503222713,195.21124050000014,199.33126100000004,201.29879999999991,205.34525500000012,207.13333333333333,148318934,140212062.6,58.84624523835339,1.256573946829753,1.5,2.75,NaN,NaN,2.8061156091724655,1.0578186444851572,694.4076525896712,-0.057728723792876524,0.4462078135368017,0.5039365373296782,24.61219069534077,0.4843318641933453,43.3596225078479,24.230468409899217,32.409909082252874,9847764723
1419345000,208.17,208.23,207.3991,207.75,NaN,NaN,199.71348837209305,213.49719047619047,195.3138405000001,199.48376100000004,201.70560199999989,205.3697550000001,202.75805944629133,204.73734028649284,204.3884692307693,210.94424938261338,197.8326890789252,195.3138405000001,199.48376100000004,201.70560199999989,205.3697550000001,207.79303333333334,122167931,143026421.2,59.43604866390265,1.4298456974503204,1.5,2.75,NaN,NaN,2.66502877994586,0.8541633774725254,698.1597353446222,0.13037250662766886,0.6669021706142644,0.5365296639865955,24.606741985168103,2.259252678060308,70.92331991044628,6.922019537052814,22.154660552500896,9969932654
1419431400,208.02,208.34,207.72,207.77,NaN,NaN,200.08418604651163,213.67292063492064,195.41629050000012,199.62256100000005,202.10700199999988,205.40275500000016,202.95460613467205,205.02616502111258,204.370776923077,210.88860691031093,197.85294693584305,195.41629050000012,199.62256100000005,202.10700199999988,205.40275500000016,207.94333333333336,42963399,141219176.1,59.48071869005183,1.2190976776929592,1.5,2.75,NaN,NaN,2.5189552956640133,0.30423204685443567,697.9930686779555,0.23782128624538057,0.8338062717933212,0.5959849855479407,22.2078028127892,1.7532690141534906,62.34803011644494,11.213505402991691,26.43846448056338,10012896053
1419604200,208.31,208.85,208.25,208.44,NaN,NaN,200.45488372093024,213.8486507936508,195.5325905000001,199.78686100000007,202.54720199999988,205.44275500000012,203.16971961958686,205.351292161959,204.5115461538462,211.2905567222742,197.73253558541822,195.5325905000001,199.78686100000007,202.54720199999988,205.44275500000012,208.51333333333332,57326703,140977119.65,61.02899013467048,1.3536366960810091,1.5,2.75,NaN,NaN,2.416172774545154,0.40663834771432,701.2636908965815,0.33002546828306767,1.0085168209017752,0.6784913526187075,22.14775217359512,3.7582756732540257,48.16636052027161,20.45125006661924,31.382389413109145,10070222756
1419863400,208.22,208.97,208.14,208.72,NaN,NaN,200.82558139534885,214.02438095238094,195.6528905000001,199.9533610000001,202.99620199999987,205.51875500000014,203.3873776737207,205.67212147986768,204.68462307692315,211.76308049607957,197.60616565776672,195.6528905000001,199.9533610000001,202.99620199999987,205.51875500000014,208.61,79643948,142064812.65,61.68784515817679,1.2131491473123146,1.5,2.75,NaN,NaN,2.3028747192205006,0.5606169924442581,703.6588614761567,0.3822000526235223,1.1562414183981105,0.7740413657745882,18.878781040693866,4.616309959400535,99.99999999999999,0,0,10149866704
1419949800,208.21,208.37,207.51,207.6,NaN,NaN,201.19627906976746,214.2001111111111,195.7592405000001,200.11906100000007,203.3788019999999,205.61075500000015,203.55257854926106,205.85572895797551,205.0261538461539,212.20515544145582,197.847152250852,195.7592405000001,200.11906100000007,203.3788019999999,205.61075500000015,207.82666666666668,73540761,140543433,57.500268691556776,0.6648483341117372,1.5,2.75,NaN,NaN,2.2248122392761798,0.5232600302285202,701.129546174057,0.31633394212822574,1.1694587934348704,0.8531248513066446,18.582955913772864,4.896164923450052,78.57125697540295,3.958519616613773,17.470223407983276,10076325943
1420036200,207.99,208.19,205.39,205.54,NaN,NaN,201.56697674418606,214.37584126984126,195.84864050000007,200.24206100000006,203.68360199999992,205.53350500000016,203.63051664536846,205.82565953340642,205.13000000000005,212.29666213476526,197.96333786523485,195.84864050000007,200.24206100000006,203.68360199999992,205.53350500000016,206.37333333333333,130333829,143334764.85,50.68508991444941,0.031919794693706115,1.5,2.75,NaN,NaN,2.2658970793278823,0.9092967022787145,697.7623473131322,0.11922542825842686,1.0021566366296781,0.8829312083712513,19.06303238262935,1.8583676098914714,32.23716736415885,34.65340868961412,33.10942394622704,9945992114
1420209000,206.38,206.88,204.18,205.43,NaN,NaN,201.93767441860467,214.55157142857144,195.94249050000005,200.35841100000007,203.91080199999993,205.41050500000014,203.7010846200599,205.787977673082,205.4792307692308,212.214905992258,198.74355554620362,195.94249050000005,200.35841100000007,203.91080199999993,205.41050500000014,205.49666666666667,121465865,145960459.7,50.34196858088445,0.5043584543283576,1.5,2.75,NaN,NaN,2.296904430804461,0.8321833546540962,699.8889380259168,-0.025637821878607747,0.8508839310229916,0.8765217529015994,16.324283495040085,-0.6528677821839609,12.74186962443739,59.89262566260405,27.36550471295858,9824526249
1420468200,204.17,204.37,201.35,201.72,NaN,NaN,202.30837209302328,214.72730158730158,196.01235550000004,200.44031100000012,204.0914019999999,205.11350500000017,203.62339502711637,205.40055122802656,205.6492307692308,211.86520751178506,199.43325402667654,196.01235550000004,200.44031100000012,204.0914019999999,205.11350500000017,202.48000000000002,169632646,149876262.45,40.406568178640555,1.8513140358803766,1.5,2.75,NaN,NaN,2.424268400032715,1.1318179625448754,694.8008255184255,-0.35984593788109875,0.4267143305502259,0.7865602684313246,12.616386737537344,-2.3242300987797844,2.073313578597888,84.72042618833385,13.206260233068251,9654893603
1420554600,202.09,202.72,198.855,199.82,NaN,NaN,202.6790697674419,214.90303174603176,196.08045550000006,200.4901110000001,204.1892019999999,204.70450500000015,203.47424228095494,204.8690701586907,205.7961538461539,211.3258862834785,200.26642140882933,196.08045550000006,200.4901110000001,204.1892019999999,204.70450500000015,200.465,209151408,155782559.35,36.44014002807371,2.1830312990873124,1.5,2.75,NaN,NaN,2.527177800030379,1.342585517099479,691.8413288230979,-0.6788818727030572,-0.06204207244749682,0.6168398002555604,13.190425816316163,-3.687280088687524,0,99.99999999999999,0,9445742195
1420641000,201.42,202.72,200.88,202.31,NaN,NaN,203.0497674418605,215.0787619047619,196.16485550000004,200.55561100000014,204.3068019999999,204.48950500000018,203.42858572091748,204.62534919119636,205.8361538461539,211.25581911235543,200.4164885799524,196.16485550000004,200.55561100000014,204.3068019999999,204.48950500000018,201.97000000000003,125346709,156620487.2,44.17428563393316,1.1945591604565808,1.5,2.75,NaN,NaN,2.5538079571710663,0.800321281340006,696.6882822730992,-0.6899769341387229,-0.2456313674178432,0.44434556672087966,15.454041250742524,-2.618531889290011,2.9208695798867557,81.68741748362159,15.39171293649166,9571088904
1420727400,204.01,206.16,203.99,205.9,NaN,NaN,203.4204651162791,215.25449206349205,196.26280550000007,200.65741100000014,204.50160199999988,204.46100500000017,203.52550392794032,204.7467445063205,205.7684615384616,211.16119651550667,200.3757265614165,196.26280550000007,200.65741100000014,204.50160199999988,204.46100500000017,205.35,147217784,157722373.7,53.04555744600313,0.5977084900183744,1.5,2.75,NaN,NaN,2.6463931030874184,0.9333982271914033,702.1059272589747,-0.435706973287446,-0.10028814988842782,0.3354188233990182,19.26972527504687,-0.9000336911007385,15.33407949461659,55.57688907472143,29.089031430661972,9718306688
1420813800,206.4,206.42,203.51,204.25,NaN,NaN,203.79116279069768,215.43022222222223,196.35920550000006,200.72631100000012,204.6184019999999,204.5155000000002,203.55391553860932,204.69943550571855,205.59384615384621,211.02480322185832,200.1628890858341,196.35920550000006,200.72631100000012,204.6184019999999,204.5155000000002,204.72666666666666,158567288,157657918.4,49.17750571706394,0.1120228713675036,1.5,2.75,NaN,NaN,2.6652221671526024,1.0057679919234555,699.0388477451397,-0.36185210302849746,-0.11689630538660367,0.2449557976418938,19.6776852591776,-2.010170792554211,13.860890926950951,57.90851193251037,28.23059714053866,9559739400
1421073000,204.41,204.6,201.92,202.65,NaN,NaN,204.1618604651163,215.60595238095237,196.44955550000006,200.76891100000014,204.70920199999986,204.43850000000018,203.51846787042857,204.5042511718406,205.223076923077,210.74837195656704,199.69778188958696,196.44955550000006,200.76891100000014,204.70920199999986,204.43850000000018,203.05666666666664,144396067,156927081.5,45.69767526185791,0.8571319582071633,1.5,2.75,NaN,NaN,2.666277726641703,0.920147533617389,696.1874560178233,-0.40093389334119883,-0.25621156903460474,0.1447223243065941,19.689921031375576,-2.908202376389418,15.890625341893793,54.64254958698864,29.46682507111757,9415343333
1421159400,204.12,205.48,200.51,202.08,NaN,NaN,204.5325581395349,215.78168253968255,196.53250550000007,200.8005110000002,204.76320199999986,204.49800000000022,203.46205736570587,204.27337010785578,204.78692307692316,210.34056296228695,199.23328319155937,196.53250550000007,200.8005110000002,204.76320199999986,204.49800000000022,202.69000000000003,214553306,157538237.25,44.48988255498642,1.033733570716839,1.5,2.75,NaN,NaN,2.830829317595867,1.3619125727522383,695.0086966343142,-0.44210745935003665,-0.4079119998809517,0.034195459469084935,19.51272883210812,-2.6589595375722457,15.562144327525964,55.143750155887524,29.29410551658652,9200790027
1421245800,199.65,201.1,198.57,200.86,NaN,NaN,204.9032558139535,215.9574126984127,196.60175550000008,200.8141110000002,204.7472019999999,204.5655000000002,203.36001590038407,203.94828724044095,204.25538461538468,209.88739540746778,198.6233738233016,196.60175550000008,200.8141110000002,204.7472019999999,204.5655000000002,200.17666666666665,192991092,157689504.35,41.93514604871644,1.6657811762454895,1.5,2.75,NaN,NaN,2.8793415091961636,1.2238677063227132,692.4172126050977,-0.5229075526269721,-0.6194389813146302,-0.09653142868765809,19.54365569868362,-2.2769290649021983,3.553749180419745,79.62474792110177,16.82150289847849,9007798935
1421332200,201.63,202.01,198.88,199.0199,NaN,NaN,205.27395348837211,216.13314285714284,196.65560500000007,200.8124100000002,204.69219999999987,204.62099500000022,203.1898152768396,203.47891702706562,203.5307615384616,209.24610645626964,197.81541662065356,196.65560500000007,200.8124100000002,204.69219999999987,204.62099500000022,199.96996666666664,176613906,153543007.25,38.35746944843748,1.6577412148436,1.5,2.75,NaN,NaN,2.897245687110723,1.1502569160472138,690.4757619183093,-0.6626906323443083,-0.9248947191180434,-0.2622040867737352,19.452572674414345,-3.120332960132405,0,100,0,8831185029
1421418600,198.77,201.82,198.55,201.63,NaN,NaN,205.64465116279072,216.30887301587302,196.71935500000006,200.8267100000002,204.70339999999985,204.61299500000024,203.12864605029688,203.3028296911546,202.985376923077,207.9150271263951,198.05572671975892,196.71935500000006,200.8267100000002,204.70339999999985,204.61299500000024,200.66666666666666,211879605,151441482.9,45.46470909347665,1.0088665526487144,1.5,2.75,NaN,NaN,2.923870995174241,1.3990856464335373,695.7841613454071,-0.5466036717317936,-0.9454586764384771,-0.39885500470668356,21.574712516364492,-0.04461629982153649,6.19555664480392,72.59663523836714,21.20780811682893,9043064634
1421764200,202.4,202.72,200.17,202.055,NaN,NaN,206.01534883720933,216.48460317460317,196.7864800000001,200.84396000000018,204.69769999999986,204.37674500000023,203.08654228361857,203.1839887681875,202.55883846153853,206.71670091054023,198.40097601253683,196.7864800000001,200.84396000000018,204.69769999999986,204.37674500000023,201.6483333333333,130991069,145109342,46.5454501339901,0.47524064857167375,1.5,2.75,NaN,NaN,2.8971659240903676,0.9027059677522348,692.8987077074796,-0.4144299540403883,-0.9168924472571689,-0.5024624932167806,18.933528748296943,1.1185066559903982,18.23922405133888,51.206096662962075,30.554679285699038,9174055703
1421850600,201.5,203.66,200.94,203.08,NaN,NaN,206.38604651162794,216.66033333333334,196.86988000000008,200.8722600000002,204.69629999999987,204.20474500000026,203.08628572347666,203.17408507597918,202.36960769230777,206.17665350881447,198.56256187580107,196.86988000000008,200.8722600000002,204.69629999999987,204.20474500000026,202.56,122942707,139002247.85,49.162132188576805,0.1505553229382992,1.5,2.75,NaN,NaN,2.8845112152267696,0.8844656032661418,695.7966309610655,-0.23986696536589003,-0.8022961999241431,-0.5624292345582531,18.046494682329126,0.3806040235282538,42.05018039799458,25.32389179799191,32.625927804013514,9296998410
1421937000,203.99,206.26,202.33,206.1,NaN,NaN,206.75674418604655,216.8360634920635,196.97868000000008,200.9318600000002,204.75149999999988,204.13624500000026,203.2044705970658,203.45274364017163,202.42114615384622,206.40648420271546,198.43580810497699,196.97868000000008,200.9318600000002,204.75149999999988,204.13624500000026,204.89666666666668,174356029,140304102.6,55.996812114558196,1.2021884781880767,1.5,2.75,NaN,NaN,2.959188985567713,1.242700860266933,700.719320948494,0.07997686147658778,-0.4624581577125184,-0.5424350191891062,18.606875998288576,0.09713453132588083,74.7164524769051,5.330554826373485,19.952992696721402,9471354439
1422023400,205.79,206.1,204.81,204.97,NaN,NaN,207.12744186046515,217.01179365079366,197.0780300000001,200.97446000000022,204.77129999999985,203.99724500000025,203.2737070442397,203.59724424586958,202.67114615384622,206.85213013564592,198.49016217204652,197.0780300000001,200.97446000000022,204.77129999999985,203.99724500000025,205.29333333333332,117516753,140071543.7,53.11916033911016,0.9550976476581396,1.5,2.75,NaN,NaN,2.839961200884304,0.838976639335774,699.4321516769031,0.20908757291697927,-0.2810755530428821,-0.4901631259598614,16.004606585179612,0.35250917992656006,82.20251994793976,2.754093452800336,15.04338659925991,9353837686
1422282600,204.71,205.56,203.85,205.45,NaN,NaN,207.49813953488376,217.1875238095238,197.1698300000001,201.0228600000002,204.7967999999999,203.88124500000023,203.3590518660342,203.77369717483438,203.10422307692312,207.17916749988333,199.0292786539629,197.1698300000001,201.0228600000002,204.7967999999999,203.88124500000023,204.9533333333333,92009711,142523859.3,54.195938895142575,0.7384516580383025,1.5,2.75,NaN,NaN,2.759249686535426,0.6455740916075515,702.7708728128366,0.31415215177250483,-0.09747293624423037,-0.4116250880167352,15.297425236804676,1.3816925734024095,77.06877431277623,4.471481398110917,18.459744289112862,9445847397
1422369000,202.97,204.12,201.74,202.74,NaN,NaN,207.86883720930234,217.36325396825396,197.2677550000001,201.04526000000024,204.77239999999992,203.59624500000024,203.33477532226817,203.67524982485017,203.13730000000007,207.19285475632014,199.08174524368,197.2677550000001,201.04526000000024,204.77239999999992,203.59624500000024,202.86666666666667,134044598,146359754.05,47.554859715549746,0.34867873983132375,1.5,2.75,NaN,NaN,2.8271604232114655,0.9158569503622365,701.9927947927092,0.19434305786153422,-0.16869626568981744,-0.36303932355135166,16.644411451799805,0.32660332541567527,46.623788069893614,21.72693674545508,31.649275184651305,9311802799
1422455400,204.17,204.29,199.91,200.14,NaN,NaN,208.23953488372095,217.53898412698413,197.3609050000001,201.04455900000022,204.69139999999987,203.16724500000026,203.20949001551256,203.33855936534061,202.69422307692315,206.70396610198395,198.68448005186235,197.3609050000001,201.04455900000022,204.69139999999987,203.16724500000026,201.44666666666663,168514312,150803272.25,42.21065871716333,0.8176277317404841,1.5,2.75,NaN,NaN,2.9380775358392177,1.117444664732731,697.1108552874169,-0.05355491105497945,-0.42998296237007594,-0.3764280513150965,18.208767052326397,-0.35845862790004346,18.689676410333043,50.700125031003196,30.61019855866375,9143288487
1422541800,200.38,202.3,198.68,201.9902,NaN,NaN,208.61023255813956,217.71471428571428,197.4561555000001,201.05336100000022,204.6464039999999,202.88675500000025,203.16167472078658,203.21014418768914,202.5203923076924,206.44020435377863,198.60058026160615,197.4561555000001,201.05336100000022,204.6464039999999,202.88675500000025,200.99006666666665,173585424,155805505.4,46.79299254081911,0.9588961803355942,1.5,2.75,NaN,NaN,2.9867862832792738,1.1141161126133095,700.113856788918,-0.08461785417184042,-0.48220036902989705,-0.3975825148580566,18.743792253773517,1.4924638189447288,18.296868418832762,51.251940765428635,30.451190815738606,9316873911
1422628200,200.57,202.17,199.13,199.45,NaN,NaN,208.98093023255817,217.89044444444446,197.5324055000001,201.04196100000024,204.54800399999988,202.58225500000026,203.0161188493832,202.85203521743304,202.27423846153852,206.5190118816339,198.02946504144313,197.5324055000001,201.04196100000024,204.54800399999988,202.58225500000026,200.25,197729724,159175300.15,41.8826979470817,1.093124512030455,1.5,2.75,NaN,NaN,2.990587263045039,1.2422136086042743,696.1013762593702,-0.25813664312171475,-0.7202533187602,-0.4621166756384853,19.489813051723402,-1.0811883152308719,14.557791477578071,56.83810807762519,28.60410044479675,9119144187
1422887400,200.05,202.03,197.86,201.92,NaN,NaN,209.35162790697677,218.0661746031746,197.61138050000008,201.06796100000022,204.4754039999999,202.40675500000026,202.97313379646621,202.7632699586299,202.26193076923084,206.509812289654,198.01404924880768,197.61138050000008,201.06796100000022,204.4754039999999,202.40675500000026,200.60333333333332,163106969,161257355.35,47.63666954797852,0.9084184427657864,1.5,2.75,NaN,NaN,3.074831029970393,1.0114699490512264,700.4234770860002,-0.19152024988376182,-0.7015169879931875,-0.5099967381094257,19.32032127638072,-0.06681349137612003,20.610516519777303,47.992027621068964,31.39745585915373,9282251156
1422973800,203,204.85,202.55,204.84,NaN,NaN,209.72232558139538,218.24190476190475,197.70363050000006,201.11566100000022,204.46780399999992,202.56275500000027,203.04634423582047,202.96105377209372,202.5680846153847,206.9395710852174,198.19659814555197,197.70363050000006,201.11566100000022,204.46780399999992,202.56275500000027,204.08000000000004,124212881,158986367.1,53.49809918674946,0.7529692435222888,1.5,2.75,NaN,NaN,3.0644859564010796,0.7812800761833372,705.7367406057938,0.05127054405399212,-0.4459085580419355,-0.49717910209592764,20.979357631776068,0.8666535355524871,40.58599707417643,26.60770196418111,32.80630096164247,9406464037
1423060200,203.92,205.38,203.51,204.06,NaN,NaN,210.093023255814,218.41763492063492,197.78873050000004,201.15326100000024,204.4374039999999,202.77475500000025,203.08609544225888,203.0657153176086,202.95578461538466,206.8698344966275,199.0417347341418,197.78873050000004,201.15326100000024,204.4374039999999,202.77475500000025,204.3166666666667,134306728,155244133.1,51.82913621817482,0.7793658938418776,1.5,2.75,NaN,NaN,2.97916553094386,0.865132390629453,702.6362723789276,0.15551433260790215,-0.3027861863360499,-0.4583005189439521,21.026045689636362,-0.9898107714701563,43.74997942071255,23.940922346251064,32.30909823303639,9272157309
1423146600,204.86,206.3,204.77,206.12,NaN,NaN,210.4637209302326,218.59336507936507,197.87988050000007,201.22316100000023,204.42620399999993,202.96525500000027,203.20507209158205,203.35659957307445,203.30116923076926,207.47040023412802,199.1319382274105,197.87988050000007,201.22316100000023,204.42620399999993,202.96525500000027,205.73000000000002,97953181,153874456.7,55.75495535450509,1.2438926552762075,1.5,2.75,NaN,NaN,2.926367993019299,0.6365785660642401,704.7711476229857,0.3483426272588942,-0.022872234870334296,-0.3712148621292285,20.005780034220408,0.5610577157632852,37.7033368925895,29.182362374551104,33.11430073285939,9370110490
1423233000,206.56,207.24,204.92,205.55,NaN,NaN,210.8344186046512,218.76909523809525,197.9703805000001,201.28885100000022,204.3920039999999,202.94775500000026,203.29703004877493,203.56549485182927,203.57001538461543,207.83283381077962,199.30719695845124,197.9703805000001,201.28885100000022,204.3920039999999,202.94775500000026,205.90333333333336,125672026,152797168.8,54.433048573501424,1.0834886047762997,1.5,2.75,NaN,NaN,2.883055993517922,0.8224761426338679,701.6599602002342,0.41795119717476714,0.15122413433923043,-0.2667270628355367,19.79157629594018,0.04867364322220625,45.65152207048903,22.41430207652719,31.934175852983785,9244438464
1423492200,204.77,205.64,204.135,204.63,NaN,NaN,211.2051162790698,218.9448253968254,198.0543805000001,201.33035100000023,204.34240399999987,202.96675500000023,203.34930338019552,203.6668762945122,203.68924615384623,207.97720470173118,199.40128760596127,198.0543805000001,201.33035100000023,204.34240399999987,202.96675500000023,204.80166666666665,87219016,149229755.2,52.27858651701445,0.48340430668401424,1.5,2.75,NaN,NaN,2.784623422552356,0.5844612951559677,699.2367200092388,0.3833902568743223,0.2125107582573662,-0.17087949861695612,19.9188846946557,0.9322284699615203,19.95447533141941,48.831017936961246,31.21450673161935,9157219448
1423578600,205.88,207.12,204.6801,206.81,NaN,NaN,211.57581395348842,219.12055555555554,198.15698050000006,201.39095100000023,204.3258039999999,203.17475500000026,203.48501697312904,203.96622140932058,203.7438615384616,208.16913879846607,199.31858427845714,198.15698050000006,201.39095100000023,204.3258039999999,203.17475500000026,206.2033666666667,96164183,146818161,56.656374975567886,1.1591012458947556,1.5,2.75,NaN,NaN,2.7635788923700457,0.6549883362181603,701.3017545891167,0.4823105611563514,0.43200870282848314,-0.05030185832786825,18.962063467656574,3.3326671330069035,16.796013929651824,53.28784230146348,29.91614376888469,9253383631
1423665000,206.61,207.45,205.83,206.93,NaN,NaN,211.946511627907,219.29628571428572,198.25725550000007,201.44205100000025,204.32040399999988,203.41725500000024,203.6201143467318,204.24848603700434,203.89463076923084,208.60133829941603,199.18792323904566,198.25725550000007,201.44205100000025,204.32040399999988,203.41725500000024,206.73666666666668,91087785,140644884.95,56.89080907455984,1.0337437942918792,1.5,2.75,NaN,NaN,2.6818946857721833,0.6476437805212909,699.3945314768407,0.5271450869780535,0.6086295003946987,0.08148441341664513,16.512588388399713,2.445564190737976,43.507221775801646,24.10760875620026,32.3851694679981,9344471416
1423751400,207.89,208.99,206.9727,208.92,NaN,NaN,212.3172093023256,219.47201587301586,198.36310550000005,201.52425100000022,204.38360399999988,203.82025500000026,203.82795299980114,204.69339212871822,204.16155384615394,209.53689642993427,198.7862112623736,198.36310550000005,201.52425100000022,204.38360399999988,203.82025500000026,208.29423333333332,97545949,135872627.8,60.68811775898504,1.6851190876300473,1.5,2.75,NaN,NaN,2.637473636788456,0.7179220022415729,703.4547221761616,0.6538669558026992,0.8988181081700191,0.2449511523673199,16.561682292155986,4.7480571571822505,43.61962990446365,24.015439119940446,32.36493097559591,9442017365
1423837800,209.07,209.84,208.76,209.78,NaN,NaN,212.68790697674422,219.64774603174604,198.47045550000007,201.6305510000002,204.4375039999999,204.35826000000026,204.06136660765208,205.1778309736022,204.70309230769243,210.77041187120415,198.6357727441807,198.47045550000007,201.6305510000002,204.4375039999999,204.35826000000026,209.45999999999998,93670430,131725454,62.236260777381204,1.711321088487127,1.5,2.75,NaN,NaN,2.5262255198749957,0.7111034895351357,706.0502649142537,0.7516669998684173,1.1845349022028415,0.43286790233442424,13.055736604042742,3.8926307448494524,78.16657741549855,4.047294922516514,17.786127661984935,9535687795
1424183400,209.4,210.32,209.1,210.11,NaN,NaN,213.05860465116282,219.82347619047619,198.57938050000007,201.7515510000002,204.48190399999993,204.78226000000024,204.2985679171559,205.64756135706867,205.47001538461552,211.55674263549608,199.38328813373496,198.57938050000007,201.7515510000002,204.48190399999993,204.78226000000024,209.84333333333333,76968199,124979883.7,62.840977109210385,1.6869802045889841,1.5,2.75,NaN,NaN,2.4329236970267814,0.6158447001339304,703.4791971184947,0.7906760016046388,1.4212129043402228,0.630536902735584,12.305678234928157,2.57273969927749,100,0,0,9612655994
1424269800,209.66,210.22,209.3401,210.13,NaN,NaN,213.42930232558143,219.99920634920636,198.68973050000008,201.85725100000022,204.53130399999992,205.1860100000002,204.52725152824783,206.07446027544307,206.09615384615398,212.2958190403838,199.89648865192416,198.68973050000008,201.85725100000022,204.53130399999992,205.1860100000002,209.8967,80652941,122462977.3,62.87977320903082,1.3959010910148573,1.5,2.75,NaN,NaN,2.321993432953439,0.6585903983244086,705.1230891320956,0.7692054143216988,1.5920436706377075,0.8228382563160087,10.495851431881796,2.974615309222774,100,0,0,9693308935
1424356200,209.41,210.42,209.24,209.98,NaN,NaN,213.80000000000004,220.1749365079365,198.7975305000001,201.9936510000002,204.5709039999999,205.5310100000002,204.7410848016499,206.4464164396866,206.906153846154,212.08896887251646,201.72333881979156,198.7975305000001,201.9936510000002,204.5709039999999,205.5310100000002,209.87999999999997,91462491,120888966.5,62.3539572656793,1.225010354994505,1.5,2.75,NaN,NaN,2.2404224734567633,0.7565826199697059,704.0050551433458,0.6983507384072216,1.6957766793250357,0.9974259409178141,9.94552625753097,1.8726955171744544,75.28281885797168,5.108409026060976,19.60877211596735,9601846444
1424442600,209.48,211.33,208.73,211.239,NaN,NaN,214.17069767441865,220.35066666666665,198.91982550000012,202.12704100000022,204.66348399999987,205.78796000000017,204.99590500550676,206.90285296924026,207.62300000000016,212.41182172756058,202.83417827243974,198.91982550000012,202.12704100000022,204.66348399999987,205.78796000000017,210.433,140896392,119215984.65,64.99950795920526,1.407822254975262,1.5,2.75,NaN,NaN,2.2661065824955675,1.181858224915479,707.2842027442879,0.688584797384971,1.858156937649028,1.1695721402640569,9.11140346094384,2.7676964242276783,77.87205223671883,4.150858093155597,17.977089670125586,9742742836
1424701800,210.94,211.21,210.48,211.209,NaN,NaN,214.54139534883726,220.52639682539683,199.03647050000015,202.26373100000018,204.7582639999999,206.09991000000014,205.23955578960454,207.312962210265,208.1129230769232,212.96538100834877,203.26046514549765,199.03647050000015,202.26373100000018,204.7582639999999,206.09991000000014,210.96633333333332,74411054,117060699.7,64.88250292177705,1.1962772287869452,1.5,2.75,NaN,NaN,2.158456112317314,0.635662132472287,706.6718303085921,0.6337896459729293,1.9618091977302186,1.3280195517572893,8.675788828320636,3.215071103943707,55.59124231360634,15.3414628498716,29.06729483652206,9668331782
1424788200,211.12,212.05,210.76,211.81,NaN,NaN,214.91209302325586,220.70212698412698,199.15714550000013,202.4116310000002,204.93126199999992,206.41791000000018,205.49722026844358,207.74125152357308,208.70907692307705,213.32168942903598,204.0964644171181,199.15714550000013,202.4116310000002,204.93126199999992,206.41791000000018,211.54,72472263,116083827.3,66.19533455781885,1.3425090958190027,1.5,2.75,NaN,NaN,2.0964235328660785,0.624309731042095,709.4065557800527,0.5924679212943749,2.068604453375258,1.476136532080883,7.374599086485663,2.4176780619892653,55.153574690385014,15.62626948982522,29.22015581978976,9740804045
1424874600,211.66,212.24,211.22,211.63,NaN,NaN,215.28279069767447,212.24,199.27549550000012,202.58443100000022,205.08006199999988,206.86241000000018,205.73772143438697,208.11160852132804,209.13292307692322,213.72859699327464,204.5372491605718,199.27549550000012,202.58443100000022,205.08006199999988,206.86241000000018,211.6966666666667,73061687,113034681.75,65.4066737508287,1.1286341377858977,1.5,2.75,NaN,NaN,2.019536137661359,0.6463652205576277,711.357986231819,0.5105652828791134,2.114343135679775,1.6037778528006614,6.139663540686917,2.2712994732518186,31.569495411430676,35.234494780207655,33.196009808361666,9667742358
1424961000,211.52,211.71,210.65,211.38,NaN,NaN,215.65348837209308,212.2237777777778,199.38347050000007,202.7544310000002,205.28986199999989,207.42441000000017,205.95898726048944,208.4228839002492,209.58138461538476,213.81452118940254,205.348248041367,199.38347050000007,202.7544310000002,205.28986199999989,207.42441000000017,211.24666666666667,72697868,108243859.55,64.26151414971926,0.7770594069883854,1.5,2.75,NaN,NaN,1.9509978421141194,0.6716119353303307,709.7417421605355,0.40188986753638556,2.1061401872211434,1.7042503196847578,6.3978762527664,1.1774842044801876,34.200579798701,32.57654144062533,33.222878760673666,9595044490
1425047400,211.26,211.58,210.6,210.66,NaN,NaN,216.02418604651166,212.20755555555556,199.4869705000001,202.89583100000021,205.51286199999987,207.85790000000014,206.14334070125454,208.63594257641594,210.0452307692309,213.1874204177016,206.9030411207602,199.4869705000001,202.89583100000021,205.51286199999987,207.85790000000014,210.9466666666667,108075972,104968386.95,60.95167585087009,0.5710820639652752,1.5,2.75,NaN,NaN,1.8816408533916835,1.0296049614583507,710.7553482281347,0.25122044884389183,2.0182758807396226,1.7670554318957308,5.075494928624861,0.4194870817046408,4.256205634293424,77.64923799192871,18.094556373777863,9486968518
1425306600,210.78,212.06,210.72,211.99,NaN,NaN,216.39488372093027,212.19133333333335,199.6016205000001,203.05283100000023,205.79446199999987,208.48490000000015,206.3726214580681,208.9553766167573,210.4436923076924,213.1235192119233,207.7638654034615,199.6016205000001,203.05283100000023,205.79446199999987,208.48490000000015,211.59,87491428,99456472.15,64.58077402429241,0.7902460453387464,1.5,2.75,NaN,NaN,1.8472379352922779,0.8796956709669497,712.6005106268022,0.21238197091472277,2.032532895539134,1.8201509246244114,5.706230159281737,0.8947694065013542,19.561458582093703,49.36472718660324,31.073814231303068,9574459946
1425393000,211.47,212.054,210.08,211.12,NaN,NaN,216.76558139534887,212.1751111111111,199.7202205000001,203.23143100000024,205.98106199999987,208.94490000000013,206.55879316559484,209.16153122468518,210.7660000000001,212.5289236206538,209.0030763793464,199.7202205000001,203.23143100000024,205.98106199999987,208.94490000000013,211.0846666666667,110325809,96817414.15,60.6124214884218,0.40783608117107556,1.5,2.75,NaN,NaN,1.8562923684856858,1.1395244333738488,710.2779622916258,0.1047900154502055,1.9511384439371682,1.8463484284869627,6.403229569933002,0.4711369152429492,4.441931862004472,77.05773141650573,18.50033672148981,9464134137
1425479400,210.4,210.49,209.06,210.2301,NaN,NaN,217.13627906976748,212.1588888888889,199.83112100000008,203.36733200000023,206.05006399999988,209.2144050000001,206.70276598263032,209.26329967947706,210.866776923077,212.31836692270417,209.41518692344982,199.83112100000008,203.36733200000023,206.05006399999988,209.2144050000001,209.92669999999998,114497192,96331629.7,56.76977186270792,0.1416854873772054,1.5,2.75,NaN,NaN,1.8708429135938511,1.188573185739429,707.5337661898689,-0.041763948816549545,1.7941434924662758,1.8359074412828253,6.952818312187811,0.11910658157919961,3.692601432283206,79.206028218458,17.10137034925879,9349636945
1425565800,210.62,210.8,209.85,210.46,NaN,NaN,217.5069767441861,212.14266666666668,199.9397210000001,203.54453200000023,206.12886399999985,209.5344050000001,206.8501084931154,209.37727113857449,210.9190846153847,212.2546263512428,209.5835428795266,199.9397210000001,203.54453200000023,206.12886399999985,209.5344050000001,210.37,76872957,93459941.15,57.51905467913143,0.08443882926728594,1.5,2.75,NaN,NaN,1.80506841976572,0.8225230623312884,709.0953668082179,-0.1334977359748657,1.6690352713142431,1.8025330072891088,6.957697841727647,-0.368776599018172,13.993790046319415,57.6130521706315,28.393157783049073,9426509902
1425652200,209.42,209.94,207.1,207.5,NaN,NaN,217.8776744186047,212.12644444444445,200.03947100000008,203.7141320000002,206.12946399999987,209.60340500000012,206.87559443456186,209.1984834110912,210.71831538461544,212.95840103660802,208.47822973262285,200.03947100000008,203.7141320000002,206.12946399999987,209.60340500000012,208.17999999999998,188127982,97968681.2,46.37424780699268,1.0866899552296896,1.5,2.75,NaN,NaN,1.9161349612110268,1.9202869702404446,702.1192169627325,-0.3893301589270397,1.3158703086303092,1.7052004675573489,9.856160156539822,-1.7560804700557282,10.257988388423374,64.10031483854753,25.641696773029082,9238381920
1425907800,207.74,208.79,207.5459,208.36,NaN,NaN,218.2483720930233,212.11022222222223,200.1356210000001,203.92363300000022,206.14166399999988,209.7439050000001,206.93380641752023,209.11862784813013,210.5821615384616,213.14118727078235,208.02313580614086,200.1356210000001,203.92363300000022,206.14166399999988,209.7439050000001,208.23196666666664,89818893,96176024.55,49.43948255847778,0.6802276928777106,1.5,2.75,NaN,NaN,1.8714110354102387,0.9339010779480176,703.5846071568626,-0.48993443135268677,1.0927824283664904,1.5827168597191772,10.406233677482675,-1.6288182805344358,9.48414484247902,65.69529345744816,24.820561700072826,9328200813
1425994200,206.71,206.81,204.93,204.98,NaN,NaN,218.6190697674419,212.09400000000002,200.21257100000014,204.09643300000022,206.08586399999984,209.76140500000005,206.85718655800963,208.7244728149749,210.19754615384622,214.13480524468088,206.26028706301156,200.21257100000014,204.09643300000022,206.08586399999984,209.76140500000005,205.57333333333335,157121263,99671136.9,39.80852690513685,1.7352877142586491,1.5,2.75,NaN,NaN,1.982738818595222,1.5763968174421414,698.2129997003682,-0.7574410990104128,0.6359154859561613,1.393356584966574,13.057285190164757,-3.142276614846669,8.118779744738983,68.44158740401198,23.439632851249023,9171079550
1426080600,205.29,205.5,204.4,204.5,NaN,NaN,218.98976744186052,212.07777777777778,200.28332100000014,204.27713300000022,206.00706399999984,209.64590500000003,206.76474786946022,208.32214207069157,209.6791615384616,214.5864729399287,204.77185013699452,200.28332100000014,204.27713300000022,206.00706399999984,209.64590500000003,204.79999999999998,110145718,100370213.65,38.65684873538498,1.731993484872818,1.5,2.75,NaN,NaN,1.91968604583842,1.097394475856035,700.5489770383269,-0.9287382264600001,0.23243380189157392,1.161172028351574,12.983766338578372,-3.2548017787870167,8.333994209678428,67.9952895580414,23.670716232280157,9060933832
1426167000,205.26,207.175,205.2,207.1,NaN,NaN,219.3604651162791,212.06155555555557,200.36122100000014,204.4854330000002,205.97466399999988,209.65440500000005,206.77789501183432,208.20574758776857,209.36308461538468,214.3639599331272,204.36220929764215,200.36122100000014,204.4854330000002,205.97466399999988,209.65440500000005,206.49166666666667,93993523,100515500.55,47.51437056932287,0.8077459745273243,1.5,2.75,NaN,NaN,1.9736370425642478,0.9351147085343744,704.3515003681001,-0.8320782126787108,0.12107426250318554,0.9531524751818964,15.935009195168636,-1.6899268964207739,9.606116399406567,65.45916163922723,24.93472196136619,9154927355
1426253400,206.77,207.9338,204.58,205.8272,NaN,NaN,219.73116279069774,212.04533333333333,200.43345700000017,204.65900500000018,205.93920799999987,209.49976500000002,206.74061285450748,207.97921924607633,208.9028692307693,214.01816029933815,203.78757816220048,200.43345700000017,204.65900500000018,205.93920799999987,209.49976500000002,206.11366666666666,162410893,103758747.75,44.153277070910725,1.2176871435150352,1.5,2.75,NaN,NaN,2.072220110952514,1.5652742204572336,700.5674970226099,-0.8177915054861399,-0.06908690667577844,0.7487045988103614,16.098438556960872,-2.9071182602952987,10.566267602196346,63.64705695489048,25.786675442913186,8992516462
1426512600,206.71,208.69,205.8641,208.58,NaN,NaN,220.10186046511632,212.02911111111112,200.51450700000015,204.8418050000002,206.00000799999984,209.43976500000002,206.81274568374246,208.03643646073573,208.66825384615393,213.53546230882856,203.8010453834793,200.51450700000015,204.8418050000002,206.00000799999984,209.43976500000002,207.71136666666666,136099192,105880185.85,52.053068234178674,0.3143100364119184,1.5,2.75,NaN,NaN,2.128690103027334,1.285407566178729,703.7820472762743,-0.5971154240983524,0.0023103186874209314,0.5994257427857733,17.865877386742966,-1.2031072375899925,15.04894384383588,56.01123529931235,28.93982085685178,9128615654
1426599000,207.69,208.42,206.98,207.96,NaN,NaN,220.47255813953493,212.0128888888889,200.59090700000016,204.9807050000002,206.0506079999998,209.33226500000006,206.8577360490859,208.02915679780853,208.405176923077,213.02086646879968,203.7894873773543,200.59090700000016,204.9807050000002,206.0506079999998,209.33226500000006,207.78666666666666,94510422,106757297,50.326374646444016,0.12808031843396572,1.5,2.75,NaN,NaN,2.090926524239669,0.8852830172348781,702.0598657844131,-0.4725299559165513,0.008763297890084232,0.4812932538066355,17.819890308742636,-1.0798168292742025,18.56401894092166,50.81943637310184,30.6165446859765,9034105232
1426685400,207.39,211.27,206.62,210.46,NaN,NaN,220.84325581395353,211.99666666666667,200.67873200000017,205.15840500000022,206.22540799999982,209.34876500000004,206.99900130206294,208.2606656742077,208.3897923076924,212.9765596053434,203.8030250100414,200.67873200000017,205.15840500000022,206.22540799999982,209.34876500000004,209.45000000000002,228808524,114165076.15,56.58075403686944,0.7359771847043758,1.5,2.75,NaN,NaN,2.273717486793979,2.0041901754558586,707.5930987152291,-0.21451509615395303,0.21314938361419422,0.42766447976814725,19.2721402101425,0,52.2912457577269,17.529649116396456,30.179105125876635,9262913756
1426771800,209.96,210.4697,209.03,209.5,NaN,NaN,221.21395348837214,211.98044444444446,200.76223200000015,205.3041050000002,206.41900799999982,209.32476500000007,207.0970796823742,208.37869751475935,208.1982538461539,212.3555105678262,204.0409971244816,200.76223200000015,205.3041050000002,206.41900799999982,209.32476500000007,209.66656666666665,117917302,115487816.7,53.78048972925129,0.5701720217231098,1.5,2.75,NaN,NaN,2.2141448091658367,1.0210367237810982,704.4532427229623,-0.106715037516466,0.29427068287256475,0.40098572038903074,19.439374519059996,0.963855421686747,31.315033393886356,35.46591255851063,33.219054047603,9144996454
1426858200,209.71,211.02,209.4903,210.41,NaN,NaN,221.58465116279075,211.96422222222225,200.84833200000014,205.4439050000002,206.58100799999983,209.28331500000007,207.22699812620266,208.57215489430607,208.14363846153853,212.16226776289952,204.12500916017754,200.84833200000014,205.4439050000002,206.58100799999983,209.28331500000007,210.30676666666668,177715081,117328751.15,56.00331386107858,0.9189226324921095,1.5,2.75,NaN,NaN,2.1652558942254214,1.5146763198118298,709.5871635304098,0.02086449321088807,0.42706633690264084,0.4062018436917528,17.470005624450096,0.9838740641197844,63.58849875180351,10.56961736013192,25.841883888064558,9322711535
1427117400,210.42,211.11,210,210,NaN,NaN,221.95534883720936,211.948,200.92608200000018,205.5823050000002,206.66300799999982,209.2228650000001,207.33574329772412,208.70814014246739,208.12593846153854,212.10952684739263,204.14235007568445,200.92608200000018,205.5823050000002,206.66300799999982,209.2228650000001,210.37,71784536,117197425.25,54.72627877451534,0.7928577245990758,1.5,2.75,NaN,NaN,2.089880473209321,0.612509497088973,711.8945017205782,0.06986661339642058,0.4935351104372785,0.4236684970408579,17.469442845795633,2.449019416528447,47.84838771877939,20.765073531560475,31.38653874966014,9250926999
1427203800,209.85,210.4,208.74,208.82,NaN,NaN,222.32604651162796,211.9317777777778,200.99330700000016,205.6864050000002,206.7544079999998,209.07336500000005,207.3939494429114,208.71879346223238,207.9997846153847,211.77831339854495,204.22125583222444,200.99330700000016,205.6864050000002,206.7544079999998,209.07336500000005,209.32000000000002,77805321,117464078.15,51.11376268690958,0.19526050344550097,1.5,2.75,NaN,NaN,2.059174725122941,0.662375444692493,710.0803181201886,0.017750321555382365,0.4458563989850859,0.4281060774297035,14.450233713340449,2.1124694376528086,49.900195671666374,19.243804375189768,30.85599995314387,9173121678
1427290200,209.07,209.35,205.71,205.76,NaN,NaN,222.69674418604657,211.91555555555556,201.04420700000017,205.76290500000016,206.81660799999983,208.77986500000006,207.3298729941698,208.43700360868644,207.86593846153852,211.8247695784851,203.90710734459194,201.04420700000017,205.76290500000016,206.81660799999983,208.77986500000006,206.93999999999997,159521708,121787079.2,43.15772986205058,0.981341261245147,1.5,2.75,NaN,NaN,2.172090816185587,1.3098409868097074,707.2308450363807,-0.2150306743689046,0.15931773446857278,0.3743484088374774,17.24938277015978,-0.6470304200869162,12.019389067870131,61.01539285655966,26.965218075570213,9013599970
1427376600,204.96,206.37,204.12,205.27,NaN,NaN,204.12,211.89933333333335,201.09255700000017,205.82180500000015,206.88040799999985,208.4743650000001,207.2490936610651,208.13538421738298,207.62824615384622,211.80493780937002,203.45155449832242,201.09255700000017,205.82180500000015,206.88040799999985,208.4743650000001,205.25333333333333,153067241,125805547.85,42.02956404618245,1.3409707201769288,1.5,2.75,NaN,NaN,2.1776557578866163,1.2166970663527856,704.6700458822704,-0.3843445478823926,-0.10608227601551334,0.27826227186687924,15.487391180776344,-0.27071252001678814,10.768917445282808,63.2449333530073,25.986149201709882,8860532729
1427463000,205.13,205.95,204.9,205.74,NaN,NaN,204.21205882352942,211.88311111111113,201.14665700000015,205.86260500000017,206.97800799999982,208.22836500000008,207.18991351749392,207.90725238715603,207.68670769230772,211.7327231274336,203.64069225718185,201.14665700000015,205.86260500000017,206.97800799999982,208.22836500000008,205.53,118938966,126348697.55,43.55374297757444,1.0460958757824055,1.5,2.75,NaN,NaN,2.097108918037571,0.9413549035828586,707.185305433936,-0.44286178936931736,-0.2753149648447675,0.1675468245245499,15.190969221668373,-1.3615878799501406,5.434514809467344,74.52637549444367,20.039109696088968,8979471695
1427722200,206.98,208.61,206.96,208.25,NaN,NaN,204.30411764705883,211.8668888888889,201.22020700000016,205.9274050000002,207.16260999999983,208.0413650000001,207.23148553641573,207.9398950169507,207.97516923076927,211.58216006984406,204.36817839169447,201.22020700000016,205.9274050000002,207.16260999999983,208.0413650000001,207.94000000000003,96180365,126783144.4,50.968028261900024,0.29710712914201826,1.5,2.75,NaN,NaN,2.15231542389203,0.7586210726605074,710.0640823134179,-0.29766887210778364,-0.20453926561017965,0.09312960649760398,14.829857252054122,0.13944989421042125,16.02877218815974,54.445443220862316,29.525784590977953,9075652060
1427808600,207.26,208.1,206.36,206.43,NaN,NaN,204.39617647058824,211.85066666666668,201.28170700000018,205.98100500000018,207.25860999999986,207.8068650000001,207.2000547310661,207.7960954915268,207.9236307692308,211.59769121292544,204.24957032553618,201.28170700000018,205.98100500000018,207.25860999999986,207.8068650000001,206.96333333333337,126768703,127605289.1,46.22660731281945,0.2952744987500319,1.5,2.75,NaN,NaN,2.133578607899741,0.9934439543540833,707.3442311481065,-0.3080576632658268,-0.29194247258467954,0.016115190681147265,15.585734127999055,-1.9148531787513072,13.596499099280793,58.27089599127679,28.132604909442417,8948883357
1427895000,206.39,206.42,204.51,205.7,NaN,NaN,204.48823529411766,211.83444444444447,201.33875700000016,206.0146050000002,207.33150999999987,207.5803600000001,207.14122905533802,207.59646734947663,207.91384615384615,211.61079323914623,204.21689906854607,201.33875700000016,206.0146050000002,207.33150999999987,207.5803600000001,205.5433333333333,137303584,128745608.7,44.4408232913973,0.9023525827432377,1.5,2.75,NaN,NaN,2.118322993049761,1.0664719782399847,708.2939473079741,-0.3451540782540397,-0.41532740713640237,-0.07017332888236266,13.35148732558769,-1.8138424821002441,14.648081968011388,56.5787540708866,28.773163961102018,8811579773
1427981400,205.62,206.98,205.4,206.435,NaN,NaN,204.58029411764707,211.81822222222223,201.39678200000014,206.04745500000018,207.39860999999985,207.37911000000014,207.11353379826593,207.48585141143124,207.74884615384616,211.5031629591565,203.99452934853582,201.39678200000014,206.04745500000018,207.39860999999985,207.37911000000014,206.27166666666668,86900906,129247006.15,46.67450343081281,0.44048651626807656,1.5,2.75,NaN,NaN,2.079871350689063,0.6723630093152452,711.3752628540527,-0.302766105619002,-0.4486309609061152,-0.14586485528711318,13.65468690398971,-1.8891687657430705,37.37050696187938,29.464271701802502,33.165221336318105,8898480679
1428327000,205.37,208.45,205.21,207.83,NaN,NaN,204.67235294117648,211.80200000000002,201.45465700000014,206.0923550000002,207.43320999999986,207.39561000000012,207.14163051205944,207.5186274674854,207.73884615384617,211.4915521597707,203.98614014792165,201.45465700000014,206.0923550000002,207.43320999999986,207.39561000000012,207.16333333333333,114368155,125559014.8,50.72375137882736,0.4412711455344465,1.5,2.75,NaN,NaN,2.1627376827827,0.9108717138484588,715.2468114962486,-0.16997118294088015,-0.35832883396321336,-0.1883576510223332,14.089774580288635,-1.0333333333333274,36.66428864551364,30.135586202147373,33.20012515233898,9012848834
1428413400,207.855,208.76,207.24,207.28,NaN,NaN,204.7644117647059,211.78577777777778,201.50865700000014,206.1253550000002,207.4794099999999,207.34161000000012,207.14705676648848,207.49590104201062,207.4942307692308,210.90449095817053,204.08397058029107,201.50865700000014,206.1253550000002,207.4794099999999,207.34161000000012,207.76,81236337,125129887,49.13943190973664,0.33688150720132526,1.5,2.75,NaN,NaN,2.1168278482982203,0.6492160981492775,714.4852830000269,-0.11121022214724374,-0.3273704287063879,-0.21616020655914414,14.108451041032213,-0.7374772531366689,17.113932049185635,52.8482449667258,30.037822984088567,8931612497
1428499800,207.55,208.51,207.08,207.975,NaN,NaN,204.8564705882353,211.76955555555557,201.5688320000001,206.1633550000002,207.52990999999986,207.49136000000016,207.17952512858696,207.54152951420008,207.37692307692308,210.60307710650054,204.15076904734562,201.5688320000001,206.1633550000002,207.52990999999986,207.49136000000016,207.85500000000002,89351939,121741420.8,51.21310994263146,0.24143382338913055,1.5,2.75,NaN,NaN,2.0677687162769174,0.7339485477731503,716.9267547515992,-0.02222619900451922,-0.24394295531479315,-0.22171675631027393,14.041088960912564,1.076496889580095,42.37524004899344,25.070135322880237,32.55462462812633,9020964436
1428586200,207.78,209.18,207.19,208.9,NaN,NaN,204.9485294117647,211.75333333333336,201.63393200000013,206.21275500000021,207.65310999999986,207.71136000000016,207.24699473138747,207.67090765570484,207.26076923076926,210.13082912335113,204.39070933818738,201.63393200000013,206.21275500000021,207.65310999999986,207.71136000000016,208.42333333333332,85548854,120511577.6,53.90674707575329,0.4944443304681142,1.5,2.75,NaN,NaN,2.062213807971424,0.7098807907398932,716.3494044824096,0.09576508524982202,-0.10201039974799642,-0.19777548499781844,10.817883155732575,1.7684025917084791,78.71223208281003,3.8655304287992367,17.422237488390728,9106513290
1428672600,209.2,210.09,208.96,210.04,NaN,NaN,205.0405882352941,211.73711111111112,201.71063200000015,206.27125500000022,207.8511099999999,207.85836000000012,207.35652434976444,207.89653549801866,207.26384615384617,210.14570760849972,204.38198469919263,201.71063200000015,206.27125500000022,207.8511099999999,207.85836000000012,209.6966666666667,72722915,119448047.2,57.05383006770849,0.9411132059135061,1.5,2.75,NaN,NaN,1.9999128216877506,0.6088246455652395,719.666029272765,0.23925479043317535,0.10129300304365074,-0.1379617873895246,10.71791387185649,2.0900165257120555,78.01587042909026,4.106555387761799,17.877574183147953,9179236205
1428931800,209.87,210.63,209.03,209.09,NaN,NaN,205.13264705882352,211.7208888888889,201.77818200000013,206.3197550000002,207.9931059999999,208.02150000000015,207.42450378702858,208.01019878392165,207.2846153846154,210.2145286454615,204.35470212376927,201.77818200000013,206.3197550000002,207.9931059999999,208.02150000000015,209.58333333333334,74436594,115049332.25,53.75976883972686,0.7064726864910308,1.5,2.75,NaN,NaN,1.971347620138625,0.6469971841144693,717.0701211968234,0.25728021697451287,0.18363848382861647,-0.0736417331458964,11.410722657411783,0.40336134453781675,50.94780589001446,18.458914173786344,30.593279936199202,9104799611
1429018200,208.85,209.71,208.1,209.49,NaN,NaN,205.22470588235294,211.7046666666667,201.84843200000012,206.37095500000024,208.19390599999988,208.06700000000015,207.50550363851767,208.15113223307196,207.5715384615385,210.577599990735,204.565476932342,201.84843200000012,206.37095500000024,208.19390599999988,208.06700000000015,209.1,75099866,111999365.95,54.93944940993496,0.5170422444937088,1.5,2.75,NaN,NaN,1.94553707584301,0.6705383138823028,718.8549612480433,0.2812895941620511,0.27797025955666754,-0.0033193346053835976,9.27918700568845,1.4823426827496013,78.72068630148915,3.869031737788357,17.41028196072249,9179899477
1429104600,210.05,211.04,209.95,210.43,NaN,NaN,205.31676470588235,211.68844444444446,201.9214820000001,206.41975500000026,208.36410599999988,208.19050000000016,207.62018977034052,208.36816725849368,207.96846153846155,211.01648330454384,204.92043977237927,201.9214820000001,206.41975500000026,208.36410599999988,208.19050000000016,210.47333333333336,99529320,112250310.85,57.6723340320633,0.995677210688245,1.5,2.75,NaN,NaN,1.917284427568508,0.8866730011376178,720.8645169641769,0.3416114070378888,0.4236949241919774,0.08208351715408861,7.289596894374755,2.2994652406417204,79.39230144165724,3.6426143991612845,16.965084159181497,9279428797
1429191000,210.03,210.98,209.7928,210.37,NaN,NaN,205.40882352941176,211.67222222222225,201.9947320000001,206.47125500000024,208.47470599999988,208.18600000000015,207.72802546562127,208.55881799578,208.3246153846154,211.32954840971553,205.3196823595153,201.9947320000001,206.47125500000024,208.47470599999988,208.18600000000015,210.38093333333333,68934864,104256627.85,57.4328957450494,0.7999804334199979,1.5,2.75,NaN,NaN,1.8651355398850422,0.6612036608279769,719.0180273732169,0.3569347166911603,0.528251913018039,0.1713171963268787,6.605779605012245,1.9061690120376884,53.6463430604018,16.59118543709065,29.762471502507566,9210493933
1429277400,208.94,209.23,207.01,207.95,NaN,NaN,205.50088235294118,211.656,202.0493320000001,206.49495500000023,208.5525059999999,208.10850000000013,207.7367303493224,208.50083532951524,208.30153846153846,211.31300982342742,205.2900670996495,202.0493320000001,206.49495500000023,208.5525059999999,208.10850000000013,208.06333333333333,191113230,107916424.25,48.65821984934589,0.48173800999047056,1.5,2.75,NaN,NaN,1.9719115727503973,1.770937383518802,714.374406114888,0.19182735004827958,0.41110138388722817,0.21927403383894858,10.212658441042263,0.05773949862867542,16.208125951062986,54.218526919862356,29.573347129074666,9019380703
1429536600,209.06,210.25,208.96,209.85,NaN,NaN,205.5929411764706,211.6397777777778,202.11243200000007,206.5266550000002,208.6271059999999,208.08050000000017,207.8196036689568,208.62932720289473,208.5646153846154,211.47187277987203,205.65735798935876,202.11243200000007,206.5266550000002,208.6271059999999,208.08050000000017,209.6866666666667,92189481,103640144.25,54.53177785287641,0.4983110917329561,1.5,2.75,NaN,NaN,1.9953464604110842,0.8895151745217684,717.6369308728952,0.1975398263713326,0.46619881680311437,0.26865899043178176,10.79230804004434,1.2398687765341534,33.458685227684505,33.23606773075933,33.30524704155617,9111570184
1429623000,210.67,210.86,209.24,209.6,NaN,NaN,205.685,211.62355555555558,202.16943200000009,206.5500550000002,208.70810599999993,208.0605000000002,207.8894231329193,208.72177223119047,208.8646153846154,211.29300345887341,206.4362273103574,202.16943200000009,206.5500550000002,208.70810599999993,208.0605000000002,209.9,72559831,103678909,53.66188186230251,0.433669136170729,1.5,2.75,NaN,NaN,1.9685359989531501,0.6998514133670137,718.5745453347722,0.172361203056408,0.4841104942522918,0.3117492911958838,10.645307421461009,0.7813439115278279,16.88987235225798,53.17826886800636,29.931858779735663,9039010353
1429709400,210.01,210.85,208.9,210.63,NaN,NaN,205.77705882352942,211.60733333333334,202.23503200000007,206.58525500000022,208.82810599999993,208.1510000000002,207.9968967355499,208.90350820917234,209.1873076923077,211.33746552334813,207.0371498612673,202.23503200000007,206.58525500000022,208.82810599999993,208.1510000000002,210.12666666666667,78264616,103701873.75,56.72482150989642,0.6523723929048378,1.5,2.75,NaN,NaN,1.9672119990279242,0.7547078289894449,720.3153883349147,0.21043430562807286,0.5747921732309749,0.364357867602902,10.800577703662643,0.8281474389660075,14.339649322795875,57.085415454756856,28.57493522244726,9117274969
1429795800,210.15,211.94,210.01,211.16,NaN,NaN,205.86911764705883,211.59111111111113,202.30963200000008,206.62045500000022,208.91510599999995,208.4210000000002,208.12094000082246,209.11841218925116,209.44346153846158,211.67757256326246,207.2093505136607,202.30963200000008,206.62045500000022,208.91510599999995,208.4210000000002,211.03666666666666,102585942,100855085.45,58.25393228476736,0.9483713329978741,1.5,2.75,NaN,NaN,1.9645539990973586,1.017161817297335,723.1036559135781,0.25376805538840264,0.6815679368384053,0.4277998814500027,10.649717535199136,0.5332317653780254,33.89232046525261,32.80525935677919,33.30242017796819,9219860911
1429882200,211.66,211.97,211.11,211.6499,NaN,NaN,205.96117647058824,211.57488888888892,202.38228150000006,206.66495400000022,209.00950399999994,208.7399950000002,208.2593305890255,209.35950626646533,209.7796076923077,211.92368353838697,207.63553184622845,202.38228150000006,206.66495400000022,209.00950399999994,208.7399950000002,211.57663333333335,61327387,96268092.75,59.67239765005025,0.8663600421968523,1.5,2.75,NaN,NaN,1.8856572848761177,0.6370479070283648,723.8564285662871,0.2949899730735498,0.79653734779194,0.5015473747183902,10.327825031967533,1.2243053230666214,78.66530000456886,3.8818744167604264,17.4528255786707,9281188298
1430141400,212.33,212.48,210.54,210.77,NaN,NaN,206.05323529411766,212.48,202.45443150000006,206.71505400000024,209.04650399999994,208.9914950000002,208.35778821298527,209.49383900299244,209.9946076923077,211.92124621651914,208.06796916809628,202.45443150000006,206.71505400000024,209.04650399999994,208.9914950000002,211.26333333333332,79358126,94289050.75,55.99243763835077,0.6250871837540984,1.5,2.75,NaN,NaN,1.8895389073849664,0.8416473107827952,721.2756243391681,0.2446375365695146,0.8073442954302834,0.5627067588607688,10.261014530889495,0.6110076853310425,52.04675294150495,17.75851850787648,30.194728550618557,9201830172
1430227800,210.74,211.5,209.3301,211.44,NaN,NaN,206.14529411764707,212.48571428571427,202.5285815000001,206.75860400000022,209.07970399999994,209.1509950000002,208.47865926345642,209.67918766937413,210.1899923076923,212.1478960540268,208.2320885613578,202.5285815000001,206.75860400000022,209.07970399999994,209.1509950000002,210.7567,86863531,93823209.05,58.110788831125966,0.5158932487335722,1.5,2.75,NaN,NaN,1.9095646997146127,0.9258213599761753,723.9358730262128,0.23788104559480527,0.8600580658542754,0.6221770202594701,10.336149625329313,0.47996958608562984,78.47963785622635,3.9760624535306244,17.54429969024305,9288693703
1430314200,210.37,211.29,209.6,210.57,NaN,NaN,206.23735294117648,212.49142857142857,202.59343150000007,206.78540400000023,209.08890399999993,209.35799500000016,208.56067262567382,209.76402693895756,210.23076153846156,212.19653079257634,208.2649922843468,202.59343150000007,206.78540400000023,209.08890399999993,209.35799500000016,210.48666666666668,125684903,93769019.05,54.44586712839416,0.19191767529017126,1.5,2.75,NaN,NaN,1.9045957925921406,1.3403670452495793,720.4984187422953,0.15998245380503795,0.8221550875157675,0.6621726337107295,10.432747158997678,0.095070589913005,42.78225672613994,24.840360693337256,32.37738258052279,9163008800
1430400600,209.88,210.35,207.62,208.46,NaN,NaN,206.3294117647059,212.49714285714285,202.64958150000007,206.79340400000024,209.05550399999993,209.49599500000016,208.55672467956896,209.63983389715207,210.1823,212.28449937871207,208.08010062128793,202.64958150000007,206.79340400000024,209.05550399999993,209.49599500000016,208.81000000000003,161304890,94969084.35,46.745740611714005,0.6987521478446432,1.5,2.75,NaN,NaN,1.9792675216927011,1.6984989494636527,716.1166382822539,-0.037921591128410204,0.6147706448002168,0.652692235928627,11.950406141412643,0.24525126232268302,11.725892333889002,61.58463058443579,26.689477081675218,9001703910
1430487000,209.4,210.77,209.28,210.72,NaN,NaN,206.4214705882353,212.50285714285712,202.71338150000008,206.82060400000023,209.07030399999994,209.71024500000016,208.64155900586036,209.74270685932805,210.2769153846154,212.35656049618132,208.19727027304947,202.71338150000008,206.82060400000023,209.07030399999994,209.71024500000016,210.25666666666666,103399711,95794024.6,54.21484158062321,0.16037334630221242,1.5,2.75,NaN,NaN,2.0028912701432224,1.079396250776168,718.4396527885359,-0.021698650283872967,0.6255689230737858,0.6472675733576587,11.534079276061323,0.41458184417441246,16.729744954635294,53.54449236033492,29.725762685029785,9105103621
1430746200,211.23,212.02,211.1,211.32,NaN,NaN,206.5135294117647,212.50857142857143,202.79143150000007,206.86770400000023,209.07192399999994,209.88474500000015,208.7465959075913,209.89292525367776,210.34537692307697,212.49798980147082,208.19276404468312,202.79143150000007,206.86770400000023,209.07192399999994,209.88474500000015,211.48000000000002,70927235,93621978.6,55.98003057973333,0.5904741314353132,1.5,2.75,NaN,NaN,1.9526847508472789,0.7575917114830129,720.7021319334538,0.021996637226897597,0.6747633698912807,0.6527667326643831,10.507323463691732,0.8206106870229003,30.785638668197084,35.95007837696585,33.26428295483706,9176030856
1430832600,211.03,211.46,208.73,208.9,NaN,NaN,206.6055882352941,212.5142857142857,202.84738200000007,206.89200400000024,209.02574399999992,209.96574500000014,208.75261175435244,209.7983609438037,210.23230000000007,212.51817281701003,207.9464271829901,202.84738200000007,206.89200400000024,209.02574399999992,209.96574500000014,209.6966666666667,113326156,95226469.55,47.95021060057877,0.4392755798406276,1.5,2.75,NaN,NaN,2.008207268643903,1.1900699095065843,716.1014073528397,-0.11215899928915363,0.5125679835529411,0.6247269828420947,12.636336101053212,-0.8213454873474765,11.961951072477103,61.023193981940814,27.01485494558209,9062704700
1430919000,209.56,209.93,206.76,208.04,NaN,NaN,206.76,212.51999999999998,202.90088200000008,206.94080300000024,208.95034399999994,209.96899500000012,208.72466619535822,209.63089799677476,210.23922307692314,212.49778696124267,207.9806591926036,202.90088200000008,206.94080300000024,208.95034399999994,209.96899500000012,208.24333333333334,135060151,97511880.15,45.45491883841882,1.0606634380313813,1.5,2.75,NaN,NaN,2.0911924637407684,1.3850635511513105,714.3630752887269,-0.25094430069001705,0.3110466069795734,0.5619909076695905,12.326330262856889,-1.4775525667740124,11.621652730605117,61.620522928355356,26.757824341039537,8927644549
1431005400,207.92,209.38,207.52,208.87,NaN,NaN,206.8542857142857,212.52571428571426,202.95423200000013,206.98760300000023,208.89514399999996,209.96749500000016,208.73036556024613,209.55843152089145,210.16383846153852,212.53209068767077,207.79558623540626,202.95423200000013,206.98760300000023,208.89514399999996,209.96749500000016,208.58999999999997,88244940,97646684.45,48.25373361580244,0.5036820333525812,1.5,2.75,NaN,NaN,2.0746787163307125,0.9037167057647086,716.8950624340556,-0.27693222684398056,0.2158256241146148,0.49275785095859537,12.51669018164796,-1.3134426238802843,35.78371469373267,30.943877049409295,33.27240825685803,9015889489
1431091800,210.88,211.86,210.78,211.62,NaN,NaN,206.94857142857143,212.53142857142856,203.01913200000013,207.09490300000024,208.899944,210.04649500000014,208.84368455788353,209.75477137604463,210.31922307692315,212.78228097397232,207.85616517987398,203.01913200000013,207.09490300000024,208.899944,210.04649500000014,211.42,155877260,101804401.7,56.26166116816664,0.7637493412465622,1.5,2.75,NaN,NaN,2.1400588080213767,1.531144600793818,721.7735868011158,-0.10769751431695207,0.3581359580624053,0.46583347237935735,14.88269582467413,0.40328319969634874,42.18144301565459,25.211380619334463,32.60717636501097,9171766749
1431351000,211.57,211.89,210.52,210.605,NaN,NaN,207.04285714285714,212.53714285714284,203.07890700000016,207.20585300000025,208.898844,210.1222450000001,208.91275575169203,209.83574553070704,210.31730000000005,212.77942317634972,207.85517682365037,203.07890700000016,207.20585300000025,208.898844,210.1222450000001,211.005,75708065,101867975.25,53.00144174272553,0.46684295951763416,1.5,2.75,NaN,NaN,2.0850546074484195,0.7431978972213841,718.3814390055935,-0.06500063708683579,0.38458267602081264,0.44958331310764843,14.952437852389124,-0.3949110858872531,25.84415340514078,41.485744613257836,32.670101981601384,9096058684
1431437400,209.61,210.63,208.62,209.98,NaN,NaN,207.13714285714283,212.54285714285712,203.14020700000015,207.32655300000025,208.858644,210.1467450000001,208.95460846731194,209.8494840515921,210.22653076923083,212.64429735133518,207.80876418712649,203.14020700000015,207.32655300000025,208.858644,210.1467450000001,209.74333333333334,119727592,104099361.55,51.04013834277908,0.2106507157190783,1.5,2.75,NaN,NaN,2.0796935640592458,1.1501280144018329,716.6731160422933,-0.07881642594416832,0.351062780677438,0.42987920662160634,14.879276634451875,-0.28019186018901243,25.207913573716738,42.23613317646648,32.55595324981677,8976331092
1431523800,210.47,211.22,209.74,210.02,NaN,NaN,207.23142857142855,212.54857142857142,203.20130700000013,207.40885300000025,208.83664399999998,210.1262450000001,208.99638852741737,209.8657236657262,210.10115384615392,212.3754589939836,207.82684869832423,203.20130700000013,207.40885300000025,208.83664399999998,210.1262450000001,210.32666666666668,94667943,103856292.7,51.16469177176703,0.1477184175149897,1.5,2.75,NaN,NaN,2.0368583094835846,0.9115282332815255,719.0362951266234,-0.08471062757502046,0.32399092215283076,0.4087015497278512,14.720861623379102,0.7483450062362095,53.75180904305951,16.518091335050553,29.730099621889934,9070999035
1431610200,211.24,212.32,210.91,212.21,NaN,NaN,207.32571428571427,212.5542857142857,203.27760700000013,207.46315300000023,208.87624199999993,210.2182450000001,209.12241250673432,210.08898807851418,210.21192307692314,212.73266026601812,207.69118588782817,203.27760700000013,207.46315300000023,208.87624199999993,210.2182450000001,211.81333333333333,95934006,105206249.8,57.534425997198014,0.8368241423780735,1.5,2.75,NaN,NaN,2.0556541445204703,0.9118660363084248,723.0350449312498,0.0520703018536553,0.47378942704492033,0.42171912519126503,14.408646218496965,0.7070994684889944,54.64792781824225,15.921499134111082,29.430573047646654,9166933041
1431696600,212.44,212.61,211.86,212.44,NaN,NaN,207.42,212.55999999999997,203.35490700000014,207.5223530000002,208.91584199999997,210.44274500000012,209.25251397705847,210.31289397579854,210.28884615384624,213.0080150140107,207.56967729368176,203.35490700000014,207.5223530000002,208.91584199999997,210.44274500000012,212.30333333333337,76510099,99476093.25,58.15177790592754,0.7870833087092454,1.5,2.75,NaN,NaN,1.9623931341975795,0.7691305166932659,725.0849279040119,0.145905657180124,0.60410119666642,0.45819553948629604,13.220728627548382,0.5300018928639052,45.713146453978176,22.376289367273664,31.91056417874815,9243443140
1431955800,212.24,213.4,212.16,213.1,NaN,NaN,207.5142857142857,212.56571428571428,203.45495700000015,207.5786530000002,209.027842,210.6052450000001,209.4033957818797,210.57833264477011,210.4834615384616,213.58984549765157,207.37707757927163,203.45495700000015,207.5786530000002,209.027842,210.6052450000001,212.88666666666666,74549685,98594103.45,59.95101379866026,1.0240581737581458,1.5,2.75,NaN,NaN,1.9107936246120387,0.7561272164496771,726.7320597986278,0.23501360120676607,0.7519625409947537,0.5169489397879876,13.236047121263368,2.010531354715169,69.41028912213781,7.638005192844511,22.951705685017675,9317992825
1432042200,213.24,213.57,212.69,213.03,NaN,NaN,207.60857142857142,212.57142857142856,203.55760700000013,207.6314530000002,209.121242,210.77674500000006,209.54561555513934,210.81182477383962,210.83500000000006,213.9799691205717,207.69003087942843,203.55760700000013,207.6314530000002,209.121242,210.77674500000006,213.09666666666666,72114610,98571842.4,59.65804665852682,0.8545461047783355,1.5,2.75,NaN,NaN,1.8371655085683212,0.7315944213293917,724.2291203502286,0.26936477162367356,0.8536549043175796,0.5842901326939061,10.741941743467809,2.398577196692948,80.44071471220316,3.3053367398734443,16.253948547923397,9245878215
1432128600,213.15,213.78,212.504,212.88,NaN,NaN,207.70285714285714,213.78,203.65255700000012,207.68255300000018,209.27924199999998,210.88924500000007,209.67637572944759,211.00879384299776,211.00115384615395,214.3272792285236,207.67502846378432,203.65255700000012,207.68255300000018,209.27924199999998,210.88924500000007,213.05466666666666,76857530,98501488.1,58.99277486999205,0.7430096533998001,1.5,2.75,NaN,NaN,1.797082257956299,0.7802677044023257,724.7972324190596,0.26187536213430085,0.9116343353617822,0.6497589732274813,10.200129902396359,1.919854454924111,52.40109199638359,17.453375874928714,30.14553212868769,9169020685
1432215000,212.71,213.75,212.51,213.5,NaN,NaN,207.79714285714283,213.85647058823528,203.76000700000012,207.73315300000021,209.459242,211.0062450000001,209.82632177927317,211.24605157223607,211.16884615384623,214.75223121839417,207.5854610892983,203.76000700000012,207.73315300000021,209.459242,211.0062450000001,213.2533333333333,64764585,96610420.25,60.93203462896347,0.7733317023362642,1.5,2.75,NaN,NaN,1.7572906681022784,0.6703685258009215,726.445923359831,0.2770964291848228,0.9961295097085099,0.7190330805236871,10.153976281555831,0.8883848407522896,47.81352091544474,20.772093827221553,31.414385257333723,9233785270
1432301400,213.04,213.54,212.91,212.99,NaN,NaN,207.89142857142855,213.9329411764706,203.8646070000001,207.7758530000002,209.57704199999998,211.07325000000006,209.9503875918507,211.41214189868978,211.48346153846163,214.93038967951279,208.03653339741047,203.8646070000001,207.7758530000002,209.57704199999998,211.07325000000006,213.14666666666668,57433495,96415725.65,58.482060822421055,0.6025267701632077,1.5,2.75,NaN,NaN,1.6767699060949723,0.5956859694080412,724.0769699414398,0.23300855054220604,1.0102937687014446,0.7772852181592386,7.6660529630276715,1.132451746159882,22.70408755819118,45.320702323232055,31.975210118576776,9176351775
1432647000,212.4,212.9089,210.2,210.7,NaN,NaN,207.98571428571427,214.00941176470587,203.9629570000001,207.80685300000022,209.67449799999997,211.06975000000003,209.97978415687615,211.3443188607193,211.688076923077,214.5611014309114,208.8150524152426,203.9629570000001,207.80685300000022,209.67449799999997,211.06975000000003,211.26963333333333,124308584,98663248.55,48.96227203189721,0.5545389358810299,1.5,2.75,NaN,NaN,1.7562863413739043,1.2599279450747418,719.2548164228381,0.03993161797962774,0.8271997406337732,0.7872681226541455,9.720868993831264,0.3428897990284784,3.320531636212666,80.36680559968241,16.31266276410492,9052043191
1432733400,211.25,212.98,210.7612,212.7,NaN,NaN,208.07999999999998,214.08588235294118,204.0602570000001,207.87845300000023,209.756898,211.13275000000004,210.08645928797904,211.47343135017462,211.9826923076924,214.3865629537562,209.57882166162858,204.0602570000001,207.87845300000023,209.756898,211.13275000000004,212.14706666666666,93213981,98980771.05,55.73879716927918,0.35022620300233587,1.5,2.75,NaN,NaN,1.7936944598471969,0.9417382791745792,723.336371384993,0.03727941021016512,0.8338673854168519,0.7965879752066868,10.854030129300556,1.276068945814674,19.72952658973417,49.16868717243099,31.10178623783483,9145257172
1432819800,212.33,212.59,211.63,212.46,NaN,NaN,208.1742857142857,214.16235294117647,204.15358200000009,207.9487530000002,209.846898,211.22725000000005,210.17953931590142,211.56739026920562,212.04730769230778,214.45386480983097,209.6407505747846,204.15358200000009,207.9487530000002,209.846898,211.22725000000005,212.2266666666667,74974560,96445253.9,54.79853151894449,0.17082077271363638,1.5,2.75,NaN,NaN,1.7420019984295396,0.7773794662590442,721.0198931466813,0.01108422964659106,0.8104432622649256,0.7993590326183345,10.928774186476904,0.11780783186466236,19.932517098721092,48.893661278097554,31.17382162318135,9070282612
1432906200,212.38,212.43,210.82,211.14,NaN,NaN,208.26857142857142,214.23882352941177,204.2416320000001,208.0429530000002,209.860498,211.36125000000007,210.21720444076803,211.52668643404317,212.08846153846162,214.41181251570876,209.76511056121447,204.2416320000001,208.0429530000002,209.860498,211.36125000000007,211.46333333333334,124919611,94625989.95,49.820595967644024,0.22111080443597228,1.5,2.75,NaN,NaN,1.7347161413988592,1.3201405984339718,717.6528863611405,-0.09744237563507518,0.6775560630744906,0.7749984387095658,9.913353264838474,-0.6119374882319767,4.870059701397671,75.92777621628214,19.202164082320184,8945363001
1433165400,211.94,212.34,210.62,211.57,NaN,NaN,208.36285714285714,214.31529411764706,204.32528200000013,208.1604530000002,209.901898,211.40375000000003,210.27025524701241,211.53081153556286,212.21076923076933,214.22396357791737,210.1975748836213,204.32528200000013,208.1604530000002,209.901898,211.40375000000003,211.51,93338750,94122941.9,51.370342826341755,0.1847423077736641,1.5,2.75,NaN,NaN,1.7336649884417976,0.9916684297773739,719.073130712333,-0.1399805763591353,0.6000227182606466,0.7400032946197819,9.983739765124486,-0.7179727827311128,17.21109057128937,52.682340753795,30.106568674915632,9038701751
1433251800,211.02,212.19,210.27,211.36,NaN,NaN,208.45714285714283,214.39176470588237,204.4032820000001,208.25095300000018,209.92089800000002,211.40575000000004,210.31299033536487,211.51454377027116,212.31384615384624,213.97408781304534,210.65360449464714,204.4032820000001,208.25095300000018,209.92089800000002,211.40575000000004,211.27333333333334,91531012,95153130.75,50.54926256377943,0.23020515437208786,1.5,2.75,NaN,NaN,1.7469746321245254,0.9619337932293941,720.863186877728,-0.17945286153596895,0.5156872176998206,0.6951400792357896,9.730578456915875,-0.7839271464112977,19.785895146348828,49.062674363547956,31.15143049010323,8947170739
1433338200,212,212.67,211.3301,211.92,NaN,NaN,208.55142857142854,214.46823529411765,204.4842820000001,208.31115300000016,209.95929800000002,211.55675000000005,210.37601032221332,211.55315864929295,212.29153846153855,213.96450627411807,210.61857064895904,204.4842820000001,208.31115300000016,209.95929800000002,211.55675000000005,211.9733666666666,87820909,93877868.4,52.71950656495803,0.08993939633427929,1.5,2.75,NaN,NaN,1.7178978726870593,0.9354804332135858,721.4817405905551,-0.16538567732000453,0.4884079825857839,0.6537936599057884,9.932652133348713,-0.4509582863585156,18.998206428028396,50.14261699607651,30.85917657589509,9034991648
1433424600,211.07,211.859,209.75,210.1292,NaN,NaN,208.64571428571426,214.54470588235296,204.5481280000001,208.36994500000014,209.98548200000002,211.66121000000007,210.3663314860481,211.4175435398365,212.1137846153847,214.1396999782887,210.08786925248071,204.5481280000001,208.36994500000014,209.98548200000002,211.66121000000007,210.5794,151882820,94719001.85,45.79764816830881,0.6996328079292883,1.5,2.75,NaN,NaN,1.75019088178084,1.6035095074220318,717.0711297063245,-0.26814403265192466,0.3186136190908826,0.5867576517428073,10.935469461851564,-1.5788290398126477,13.82925391776873,57.88294344563478,28.287802636596496,8883108828
1433511000,209.95,210.58,208.98,209.77,NaN,NaN,208.73999999999998,214.62117647058824,204.6050280000001,208.44114500000015,210.065682,211.7062100000001,210.34294593757562,211.26063463128062,211.85763076923087,214.14517534925716,209.57008618920457,204.6050280000001,208.44114500000015,210.065682,211.7062100000001,209.77666666666667,121704676,96391988.65,44.53459167992232,0.7227366499529978,1.5,2.75,NaN,NaN,1.7394629616536388,1.2626015678741782,715.2994387375354,-0.34676708808725,0.1532987916337447,0.5000658797209947,10.601958624621805,-1.5118080661063893,14.048697091104902,57.527598359013375,28.423704549881716,8761404152
1433770200,209.64,209.82,208.39,208.48,NaN,NaN,208.8342857142857,214.69764705882355,204.6528280000001,208.5051450000001,210.129882,211.54921000000007,210.2698892341413,210.99581228544437,211.50763076923084,214.30588493199954,208.70937660646214,204.6528280000001,208.5051450000001,210.129882,211.54921000000007,208.89666666666662,89063330,93051292.15,40.24219969446831,1.0047282952215397,1.5,2.75,NaN,NaN,1.7173584643926652,0.9571423237887836,711.98281394718,-0.4647521837854717,-0.08087435001084486,0.3838778337746268,10.90056311050092,-1.053630754627432,3.0628581956167604,81.17020444237878,15.766937362004462,8672340822
1433856600,208.45,209.1,207.69,208.45,NaN,NaN,207.69,214.77411764705883,204.6975780000001,208.58104500000013,210.18408200000002,211.4414600000001,210.19852102888083,210.75335397254491,211.1668615384616,214.27537771138782,208.0583453655354,204.6975780000001,208.58104500000013,210.18408200000002,211.4414600000001,208.41333333333333,105034690,94517623.4,40.14529322695733,1.021296300767049,1.5,2.75,NaN,NaN,1.6954042883646174,1.1112709590199026,710.2117842510036,-0.5197541494266095,-0.26581485300863505,0.2539392964179744,9.4175297127841,-1.998119417019276,2.922074698700566,81.6337049967515,15.444220304547917,8567306132
1433943000,209.37,211.41,209.2987,210.95,NaN,NaN,207.73043478260868,214.85058823529414,204.75637800000007,208.70034600000014,210.23808200000002,211.4899600000001,210.22799079245414,210.77208216563588,210.97070769230774,213.77222585929394,208.16918952532154,204.75637800000007,208.70034600000014,210.23808200000002,211.4899600000001,210.5529,134551285,95258808.05,50.78182404487307,0.27615026079693,1.5,2.75,NaN,NaN,1.785732553481431,1.4124812996754688,712.0454684714089,-0.369752901107909,-0.20825182996691183,0.16150107114099715,10.474093114844274,-0.7107220182622702,6.069176135782244,72.89754840891025,21.033275455307518,8701857417
1434029400,211.48,212.09,211.2,211.63,NaN,NaN,207.7708695652174,214.92705882352942,204.81352800000008,208.80034600000013,210.342082,211.57046000000008,210.28297154569123,210.8537886260515,210.86609230769233,213.45140503270554,208.28077958267912,204.81352800000008,208.80034600000013,210.342082,211.57046000000008,211.64,73876447,94219233.25,53.21706930703332,0.42170136171270883,1.5,2.75,NaN,NaN,1.7396087996613299,0.7840909382480036,714.6554265530873,-0.21442832964677955,-0.10653434091747727,0.10789398872930227,10.72165839315539,0.23207350573079905,20.941890254759787,47.514761332837736,31.543348412402473,8775733864
1434115800,210.64,211.482,209.68,210.01,NaN,NaN,207.81130434782608,215.00352941176473,204.8619280000001,208.87989600000012,210.428282,211.4604600000001,210.27226677919353,210.77342780452278,210.81301538461545,213.43781840651948,208.18821236271143,204.8619280000001,208.87989600000012,210.428282,211.4604600000001,210.39066666666668,135382369,96191651.4,47.22251264853786,0.31309338643473134,1.5,2.75,NaN,NaN,1.7546367425426628,1.4074232745732858,711.9378568326964,-0.2102014743105887,-0.1548578541589336,0.05534362015165509,11.038009881860757,-0.7373446140757207,19.82059471462183,49.0123004699641,31.167104815414067,8640351495
1434375000,208.64,209.45,207.79,209.11,NaN,NaN,207.8517391304348,215.08,204.90622800000008,208.9401960000001,210.481782,211.2939600000001,210.2266876898134,210.61500610885395,210.53686153846164,213.06299135978975,208.01073171713352,204.90622800000008,208.9401960000001,210.481782,211.2939600000001,208.78333333333333,124384184,98585355.65,44.240957727468924,0.7842624510889353,1.5,2.75,NaN,NaN,1.7878769752181867,1.261690270120763,710.5152057264119,-0.25447350930546264,-0.26274826648017324,-0.008274757174710573,11.095837537493713,-1.0645344436033308,17.232692068134295,52.64896392886508,30.118344003000622,8515967311
1434461400,208.93,210.35,208.72,210.25,NaN,NaN,207.89217391304348,215.1564705882353,204.9567780000001,208.9816960000001,210.53018200000002,211.1514600000001,210.227601898056,210.58024362229642,210.36686153846162,212.63689756604163,208.09682551088162,204.9567780000001,208.9816960000001,210.53018200000002,211.1514600000001,209.7733333333333,85308227,99123282.75,48.66251576301996,0.29736666794627276,1.5,2.75,NaN,NaN,1.7766000484168871,0.8606275401023278,713.2868916737468,-0.19605486515930012,-0.25334333862383573,-0.05728847346453561,11.727212722215432,-0.7880332200830443,37.452542932977146,29.379317239807822,33.16813982721503,8601275538
1434547800,210.59,211.32,209.36,210.59,NaN,NaN,207.93260869565216,215.2329411764706,205.00617800000006,209.0378960000001,210.596382,211.0294600000001,210.2418135883283,210.58117280112535,210.32455384615395,212.55554086831845,208.09356682398945,205.00617800000006,209.0378960000001,210.596382,211.0294600000001,210.42333333333332,126708635,101852984,49.93757584234601,0.10388419617344978,1.5,2.75,NaN,NaN,1.7897000449585365,1.244034588127531,714.3288678182503,-0.12694137699355906,-0.21596519470648445,-0.08902381771292539,11.64002875038873,0.21929365361882408,36.497395510828724,30.268400373270833,33.23420411590045,8727984173
1434634200,211.31,213.34,210.6315,212.78,NaN,NaN,207.97304347826088,213.34,205.06702800000005,209.1111960000001,210.692482,211.0244600000001,210.34135031035464,210.7905849153039,210.41763076923087,212.9316953096109,207.90356622885085,205.06702800000005,209.1111960000001,210.692482,211.0244600000001,212.25049999999996,165867949,106303504.95,57.294983808528706,0.9539138326596679,1.5,2.75,NaN,NaN,1.8582928988900698,1.560324366332194,716.0203249387037,0.06360439209426931,-0.00951832759508875,-0.07312271968935806,11.999232306504414,1.4349048958382946,46.337808524143554,21.847478199365334,31.81471327649112,8893852122
1434720600,211.46,211.55,210.36,210.81,NaN,NaN,208.01347826086956,213.318,205.11857800000004,209.1918960000001,210.730682,210.88996000000012,210.35972872955642,210.79243397098924,210.37532307692317,212.84260537397103,207.9080407798753,205.11857800000004,209.1918960000001,210.730682,210.88996000000012,210.90666666666664,130478689,109589210.15,50.15447087070082,0.065291086851245,1.5,2.75,NaN,NaN,1.8984148346836354,1.190616200458125,713.5514713393102,0.05464638949537711,-0.004814732820136669,-0.05946112231551378,13.391630190317805,1.1176132003069899,46.93731823279393,21.38416263307084,31.678519134135243,8763373433
1434979800,211.905,212.59,211.64,211.89,NaN,NaN,208.05391304347827,213.296,205.17697750000008,209.30939600000008,210.76768199999998,210.83496000000014,210.41973936761303,210.89696406899026,210.37301538461546,212.83456376769232,207.9114670015386,205.17697750000008,209.30939600000008,210.76768199999998,210.83496000000014,212.04,70696027,110252336.75,53.57070122040708,0.5242505101128456,1.5,2.75,NaN,NaN,1.8899566322062331,0.6412202143189496,716.2972546233107,0.1156322056006181,0.08507913468525885,-0.030553070915359252,12.894304217380427,1.650275845526504,73.07359006383751,5.996999875743297,20.929410060419176,8834069460
1435066200,212.14,212.44,211.57,212.04,NaN,NaN,208.09434782608696,213.274,205.23162750000006,209.4098940000001,210.826682,210.90196000000014,210.48327900025566,211.00582463384833,210.5200000000001,213.129509237701,207.9104907622992,205.23162750000006,209.4098940000001,210.826682,210.90196000000014,212.01666666666665,68476797,107460747.4,54.04182593642496,0.4380354853488086,1.5,2.75,NaN,NaN,1.8171025870486452,0.6372261375133521,718.4164311357581,0.15764649844116935,0.16650505213610245,0.008858553694933092,12.860920217062011,0.5167101208817272,72.1800700567423,6.374376654644625,21.445553288613084,8902546257
1435152600,211.72,212.17,210.47,210.5,NaN,NaN,208.13478260869564,213.252,205.2811775000001,209.5203940000001,210.846882,210.79196000000016,210.48393472573582,210.95765085919612,210.57615384615394,213.1498615991185,208.00244609318938,205.2811775000001,209.5203940000001,210.846882,210.79196000000016,211.04666666666668,92307318,107415414.25,48.59041955463305,0.13401117748011984,1.5,2.75,NaN,NaN,1.8087381165451697,0.8593488992665688,715.293611896673,0.07735618927246324,0.10555379028551215,0.028197601013048905,11.97476192151755,-0.5339507631243187,44.87610317327277,23.002046581700363,32.12185024502689,8810238939
1435239000,211.1,211.25,209.77,209.86,NaN,NaN,208.17521739130436,213.23000000000002,205.33387750000009,209.59979400000012,210.835482,210.66196000000014,210.4594666972756,210.85311268212982,210.6823076923078,213.00281365632236,208.36180172829324,205.33387750000009,209.59979400000012,210.835482,210.66196000000014,210.29333333333332,97107361,108522054.3,46.49149886592007,0.329933926127107,1.5,2.75,NaN,NaN,1.7852568225062284,0.8948168335585959,712.498829112482,-0.01812373728870486,0.005542929402167829,0.02366666669087269,11.857083589664974,-0.07142517022997823,11.989240343979796,60.9779091616211,27.032850494399103,8713131578
1435325400,210.29,210.58,209.16,209.82,NaN,NaN,208.21565217391304,213.208,205.3826275000001,209.6495940000001,210.824482,210.5959600000001,210.43438957189224,210.75472099811745,210.78769230769242,212.79662855658697,208.77875605879788,205.3826275000001,209.6495940000001,210.824482,210.5959600000001,209.85333333333332,104174840,107484815.75,46.35671969615839,0.42757772559076757,1.5,2.75,NaN,NaN,1.7591670494700704,0.9692051781742018,710.0047683708298,-0.07978710028230651,-0.07606720866201044,0.0037198916202960605,11.02704485477028,0.33953421644109777,13.635267343113101,58.20013405801256,28.16459859887433,8608956738
1435584600,208.045,209.828,205.33,205.42,NaN,NaN,208.25608695652173,213.186,205.40822750000007,209.6631940000001,210.773882,210.28846000000013,210.23774684358273,210.24665233163006,210.36230769230784,213.85074268500026,206.87387269961542,205.40822750000007,209.6631940000001,210.773882,210.28846000000013,206.85933333333332,202621332,112948944.85,34.50647752744119,1.843724010100702,1.5,2.75,NaN,NaN,1.954797974507922,1.7939196534247217,702.087513364878,-0.3950855642896755,-0.49013706374179833,-0.09505149945212282,16.348289995872864,-2.297265160523193,1.7689003013824853,85.91135919899395,12.319740499623556,8406335406
1435671000,207.26,207.32,205.28,205.85,NaN,NaN,208.29652173913044,213.16400000000002,205.44182750000007,209.66049400000009,210.69388199999997,210.01296000000016,210.0656783399128,209.82792353814148,209.91769230769245,214.0588118430259,205.776572772359,205.44182750000007,209.66049400000009,210.69388199999997,210.01296000000016,206.15,182925106,117518649.55,36.22234421796849,1.5577883526760439,1.5,2.75,NaN,NaN,1.9608838334716412,1.5565623558512038,705.221283110809,-0.5436893332368095,-0.7746631659981347,-0.23097383276132522,15.915914594511268,-2.250819127214022,9.168456568846668,66.2090810234382,24.62246240771512,8589260512
1435757400,207.73,208.03,206.56,207.5,NaN,NaN,208.33695652173913,213.142,205.48442250000008,209.67999400000008,210.65188199999997,209.79196000000016,209.96506350305347,209.60621653450895,209.72461538461553,214.06001255662167,205.3892182126094,205.48442250000008,209.67999400000008,210.65188199999997,209.79196000000016,207.36333333333334,135979873,119926597.75,42.45266726669025,0.9333253812818351,1.5,2.75,NaN,NaN,1.9765349882236674,1.133859173454289,708.4085290356422,-0.5009253137837477,-0.8571304749910098,-0.35620516120726214,16.851674694998945,-2.4814362252091366,26.30266793039416,40.913603029284005,32.78372904032185,8725240385
1435843800,208.07,208.27,206.81,207.31,NaN,NaN,208.37739130434784,213.12,205.51857250000003,209.7067940000001,210.58548199999998,209.65100000000015,209.86094336567882,209.3875292455081,209.586153846154,214.10242554515185,205.06988214715614,205.51857250000003,209.7067940000001,210.58548199999998,209.65100000000015,207.46333333333337,104373652,117551139.35,41.94454082147572,0.7780867755326317,1.5,2.75,NaN,NaN,1.9396396319219775,0.8878999606225425,707.9777541404716,-0.45674022384312823,-0.9271304410111725,-0.47039021716804424,15.114132651631444,-1.6602627958825482,25.855482422631358,41.434436088163444,32.7100814892052,8620866733
1436189400,205.77,207.65,205.53,206.72,NaN,NaN,208.41782608695652,213.098,205.54842250000004,209.7058940000001,210.49668199999996,209.49850000000015,209.73776911604435,209.133478841174,209.3146153846155,214.0573806629355,204.57185010629553,205.54842250000004,209.7058940000001,210.49668199999996,209.49850000000015,206.63333333333333,117975369,117364674,40.330253405720946,1.0955823059176684,1.5,2.75,NaN,NaN,1.9525225153561223,1.005203397063072,704.5198439540811,-0.43846675204658914,-1.0184736572262807,-0.5800069051796916,14.510991451973132,-2.439945254613237,23.70023241695208,44.0257322317618,32.27403535128611,8502891364
1436275800,206.96,208.17,204.11,208.02,NaN,NaN,204.11,213.076,205.57942250000005,209.71679400000008,210.42408399999997,209.47550000000018,209.6704056212975,209.02743323725267,209.11692307692317,213.84478735074995,204.3890588030964,205.57942250000005,209.71679400000008,210.42408399999997,209.47550000000018,206.76666666666662,173820249,121602519.95,45.32349086303141,0.814523373893111,1.5,2.75,NaN,NaN,2.1030566214021116,1.4294132150507297,706.6452242445963,-0.3157773670623517,-0.9747286140076312,-0.6589512469452795,14.730619079158073,-1.8958687040181013,59.69540090855066,12.745270310371632,27.559328781077706,8676711613
1436362200,206.42,206.7645,204.25,204.53,NaN,NaN,203.92157894736843,213.054,205.59857250000005,209.6728940000001,210.29928399999997,209.27950000000018,209.468821087129,208.59910626227622,208.48230769230778,213.2871908100489,203.67742457456666,205.59857250000005,209.6728940000001,210.29928399999997,209.27950000000018,205.1815,164020059,124551788.4,36.49431772915466,1.480971120781497,1.5,2.75,NaN,NaN,2.2221240055876756,1.3168824077679802,700.9939847401595,-0.4390405800517889,-1.2077519720100156,-0.7687113919582267,16.91853565456928,-2.8361045130641327,25.852083766910113,41.44386381669928,32.70405241639062,8512691554
1436448600,207.04,207.35,204.77,204.9,NaN,NaN,203.73315789473685,213.032,205.62732250000005,209.62409400000013,210.16848399999995,208.97700000000017,209.28965163273176,208.24681042777374,208.02769230769243,212.98164739489093,203.07373722049394,205.62732250000005,209.62409400000013,210.16848399999995,208.97700000000017,205.67333333333332,144113107,125029879.5,37.87602765976737,1.0053254315816587,1.5,2.75,NaN,NaN,2.264829433759984,1.1526293360940174,703.7673145122369,-0.4626636106228892,-1.3470409052368382,-0.884377294613949,16.998856658547975,-2.363480415515109,26.45902629836859,40.73814867683535,32.80282502479604,8656804661
1436535000,207.29,207.98,206.49,207.48,NaN,NaN,203.54473684210527,213.01,205.67467250000004,209.5977940000001,210.10668399999994,208.76950000000016,209.2186849020364,208.17378086322387,207.68846153846167,212.1138070436491,203.26311603327423,205.67467250000004,209.5977940000001,210.10668399999994,208.76950000000016,207.3166666666667,129456890,127808901.65,46.60058596699741,0.14326647053384103,1.5,2.75,NaN,NaN,2.323055902777127,1.0128941593951957,708.2638010077795,-0.2805042059146722,-1.2350075520072892,-0.954503346092617,19.092257733753268,-1.115241635687734,48.73691609619905,20.038959028389343,31.224124875411594,8786261551
1436794200,208.99,209.9,208.94,209.77,NaN,NaN,203.3563157894737,212.988,205.72572250000005,209.5941940000001,210.132884,208.75750000000016,209.24030510195652,208.32580173339304,207.5138461538463,211.38275606561206,203.64493624208052,205.72572250000005,209.5941940000001,210.132884,208.75750000000016,209.53666666666666,106069400,126343253.2,52.9205688011432,0.8667736151235497,1.5,2.75,NaN,NaN,2.3299804811501903,0.8395335509692258,712.4527888387023,0.0032187488777213336,-0.9504799099954653,-0.9536986588731866,20.327953432059296,2.1176126959400365,72.64375719574622,6.175667108525388,21.180575695728404,8892330951
1436880600,209.72,211.05,209.65,210.68,NaN,NaN,203.16789473684213,212.966,205.79742250000007,209.6011940000001,210.132084,208.83600000000018,209.29676372540922,208.5500110921175,207.52769230769243,211.44029249641378,203.6150921189711,205.79742250000007,209.6011940000001,210.132084,208.83600000000018,210.46000000000004,81709575,124209522.75,55.190138886300986,1.2266732891696377,1.5,2.75,NaN,NaN,2.263553303925177,0.6578366391799054,714.8552484284846,0.24765083088162232,-0.6441351202711587,-0.891785951152781,15.257488696279859,2.346368715083805,67.97513474330275,8.2886019133192,23.73626334337805,8974040526
1436967000,210.73,211.28,210.04,210.61,NaN,NaN,202.97947368421055,212.94400000000002,205.86097250000006,209.5949040000001,210.117884,208.85400000000018,209.34826318715787,208.74620051191584,207.58538461538473,211.6528965397069,203.51787269106256,205.86097250000006,209.5949040000001,210.117884,208.85400000000018,210.64333333333337,97914141,124839818.45,54.970613723421536,0.9918236389349291,1.5,2.75,NaN,NaN,2.1904423536448077,0.7843181944326193,712.3970878984359,0.39153686448940805,-0.402364870541021,-0.793901735030429,15.345806992528912,1.498795180722898,79.31933827283252,3.654694969434036,17.025966757733457,8876126385
1437053400,211.87,212.3,211.58,212.3,NaN,NaN,202.79105263157896,212.922,205.93477250000007,209.6058140000001,210.18588400000002,208.93950000000018,209.4640175719752,209.0846576060191,207.77615384615396,212.43468143435388,203.11762625795404,205.93477250000007,209.6058140000001,210.18588400000002,208.93950000000018,212.06000000000003,106683266,123838550,59.19099929246142,1.4250907678976885,1.5,2.75,NaN,NaN,2.154696471241607,0.8614705679289688,716.506882413847,0.576286535826169,-0.07354356524771788,-0.6498301010738868,15.346986112471278,2.4070232984419513,77.8376219953916,4.162512930041348,17.999865074567047,8982809651
1437139800,212.29,212.55,211.8,212.48,NaN,NaN,202.60263157894738,212.9,206.0120725000001,209.6125140000001,210.27468399999998,208.92450000000017,209.58229139268207,209.408023548303,208.31923076923087,213.38105446940753,203.2574070690542,206.0120725000001,209.6125140000001,210.27468399999998,208.92450000000017,212.27666666666667,89029973,119996651.2,59.62504813551957,1.2826571592708291,1.5,2.75,NaN,NaN,2.0543610090100635,0.7419371466593061,713.3019270115934,0.6792857146248011,0.19927704220711462,-0.4800086724176865,15.245593549400882,2.786377708978324,75.85007824572828,4.890379366233576,19.259542388038135,9071839624
1437399000,212.75,213.18,212.21,212.59,NaN,NaN,202.4142105263158,213.18,206.1032725000001,209.62211400000007,210.34908399999998,209.01350000000016,209.70024074983178,209.71106892465508,208.83769230769244,214.1558652377153,203.51951937766958,206.1032725000001,209.62211400000007,210.34908399999998,209.01350000000016,212.66,70446821,116995057.8,59.90570141818586,1.3294257302237678,1.5,2.75,NaN,NaN,1.9769066512236304,0.6021350159972313,710.0288747225017,0.7196304153038489,0.4195293467121246,-0.30010106859172425,14.936251851047771,2.1969041438323202,75.03115388872011,5.2386645940655265,19.73018151721436,9142286445
1437485400,212.43,212.74,211.39,211.75,NaN,NaN,202.22578947368424,213.17238095238096,206.19012250000011,209.62581400000008,210.35168399999995,209.00650000000013,209.78062346552466,209.9052528365927,209.1646153846155,214.63403591578526,203.69519485344574,206.19012250000011,209.62581400000008,210.35168399999995,209.00650000000013,211.96,77965048,117358508.85,56.66637421373203,0.8056301170626426,1.5,2.75,NaN,NaN,1.9321276047076583,0.6643322990721521,707.5489553689742,0.656322603130896,0.5203021853218956,-0.13602041780900026,15.216967484437937,3.530044492250525,49.92999568028133,19.231736119236086,30.83826820048258,9064321397
1437571800,210.93,211.77,210.89,211.37,NaN,NaN,202.03736842105266,213.16476190476192,206.26437250000015,209.63291400000006,210.36698399999997,208.97300000000013,209.8429519570727,210.04475256644102,209.4769230769232,214.95073420666756,204.00311194717887,206.26437250000015,209.63291400000006,210.36698399999997,208.97300000000013,211.34333333333333,88667920,118368065,55.21189242529733,0.43990997307457286,1.5,2.75,NaN,NaN,1.8569756329428273,0.7490865040329924,705.7791883019007,0.5592263374936524,0.5630125040580651,0.0037861665644128295,10.013782286901412,3.157637872132747,51.719220627137275,17.954746704037227,30.326032668825505,8975653477
1437658200,211.53,211.65,209.75,210.18,NaN,NaN,201.84894736842108,213.15714285714287,206.33382250000014,209.61481400000005,210.370984,208.95700000000016,209.85616952738357,210.05763327439902,209.74307692307704,214.98642514646843,204.49972869968565,206.33382250000014,209.61481400000005,210.370984,208.95700000000016,210.52666666666667,90509128,118278155.5,50.81335043555165,0.14641286467289744,1.5,2.75,NaN,NaN,1.86004880201834,0.7652226872949502,702.3895922047045,0.39307517286948507,0.49513013265126915,0.1020549597817841,11.251154224134027,1.301330248698678,20.849186114861524,47.750527386362876,31.40028649877558,8885144349
1437744600,210.3,210.37,207.6,208,NaN,NaN,201.6605263157895,213.14952380952383,206.4075225000001,209.58361400000004,210.330584,208.86400000000017,209.7833785655254,209.86166820064673,209.7415384615386,214.98691941070194,204.49615751237525,206.4075225000001,209.58361400000004,210.330584,208.86400000000017,208.65666666666667,117754979,119310536.4,43.91173273093804,0.9474531350258202,1.5,2.75,NaN,NaN,1.925045316159888,0.9869621120905462,697.9490618468357,0.12827626896800948,0.26240029599179593,0.13412402702378645,11.511529694406619,-0.8437812842637222,3.2622862067959106,80.60045553727615,16.137258255927954,8767389370
1438003800,206.94,207.55,206.26,206.79,NaN,NaN,201.4721052631579,213.14190476190478,206.45827250000013,209.54921300000007,210.22218400000003,208.71250000000018,209.66599117079892,209.56912837201372,209.91538461538474,214.57549762415957,205.2552716066099,206.45827250000013,209.54921300000007,210.22218400000003,208.71250000000018,206.86666666666667,132361082,120719848.5,40.614372642697504,1.3908425466974044,1.5,2.75,NaN,NaN,1.9118277935770394,1.0964318100515178,693.7064211597163,-0.12286116434769294,-0.019452428410829725,0.10340873593686321,9.680788129041037,-1.8464021264477002,0,100,0,8635028288
1438090200,207.79,209.5,206.8,209.33,NaN,NaN,201.28368421052633,213.1342857142857,206.54122250000015,209.5379130000001,210.159984,208.9080000000002,209.65281504645387,209.54635424134574,210.25615384615395,213.94639493449827,206.56591275780963,206.54122250000015,209.5379130000001,210.159984,208.9080000000002,208.54333333333332,123544845,116766024.15,49.232359229607965,0.4764565574056417,1.5,2.75,NaN,NaN,1.9688400940358228,1.0580547372349665,698.0083587076901,-0.1126745485655276,-0.037434449770046285,0.07524009879548131,12.134313724861213,-0.6077584160296288,5.293261616429243,74.99036043583918,19.716377947731583,8758573133
1438176600,209.48,211.04,209.31,210.77,NaN,NaN,201.09526315789478,213.12666666666667,206.64237250000014,209.5706130000001,210.113384,209.15400000000017,209.69662622110275,209.66289193264615,210.50923076923087,213.83662255481386,207.18183898364788,206.64237250000014,209.5706130000001,210.113384,209.15400000000017,210.37333333333336,105791255,112909331.6,53.36432041893016,0.43583622247701903,1.5,2.75,NaN,NaN,1.9517800873189777,0.9369575880121498,701.9791825341102,-0.009171702840346713,0.06377547024504793,0.07294717308539464,12.878003841686846,-0.7206782854451254,19.46486396825162,49.74220996998165,30.792926061766728,8864364388
1438263000,210.16,211.02,209.42,210.82,NaN,NaN,200.9068421052632,213.11904761904762,206.75942300000014,209.5952130000001,210.06918399999998,209.32000000000016,209.740680094785,209.77309270096555,210.59000000000012,213.89257708232518,207.28742291767506,206.75942300000014,209.5952130000001,210.06918399999998,209.32000000000016,210.42,91304374,110675556.65,53.50582158713599,0.4395407534660428,1.5,2.75,NaN,NaN,1.9266529382247666,0.8249732530258749,702.2601582775848,0.05870850923354383,0.14633280962732442,0.0876243003937806,11.865213818702607,-0.7812499999999984,39.60135071128487,27.651330360421206,32.74731892829392,8955668762
1438349400,211.42,211.45,210.16,210.5,NaN,NaN,200.7184210526316,213.11142857142858,206.87342300000014,209.65041300000007,210.021584,209.47950000000014,209.7704573459699,209.84232196754027,210.57615384615397,213.87861482560078,207.27369286670717,206.87342300000014,209.65041300000007,210.021584,209.47950000000014,210.70333333333335,103266857,110620216.9,52.409800575258544,0.3515053936885173,1.5,2.75,NaN,NaN,1.8811777283515685,0.9335260759193105,705.1920083216442,0.07695640759565402,0.18381980988834812,0.1068634022926941,11.830063127381006,-0.9831130344795161,41.510745520322764,25.986650611463784,32.50260386821344,8852401905
1438608600,210.46,210.53,208.65,209.79,NaN,NaN,200.53000000000003,213.10380952380953,206.99022300000016,209.7033130000001,209.94738400000003,209.63300000000012,209.77122372455932,209.83733892301262,210.51307692307702,213.8417623611491,207.18439148500494,206.99022300000016,209.7033130000001,209.94738400000003,209.63300000000012,209.65666666666667,113965728,110419734.85,49.96428424524402,0.33078668440310477,1.5,2.75,NaN,NaN,1.8810936048978846,1.0321137625879746,702.415119575023,0.03807486016706453,0.15445697750152476,0.11638211733446023,11.866011784075207,-0.9256198347107476,46.66708106644063,21.591186950499853,31.741731983059513,8738436177
1438695000,209.7,210.2483,208.8,209.38,NaN,NaN,200.34157894736845,213.0961904761905,207.10577300000014,209.7261130000001,209.87518400000002,209.7010000000001,209.75588161771387,209.79378283510667,210.28846153846163,213.49640213023014,207.08052094669313,207.10577300000014,209.7261130000001,209.87518400000002,209.7010000000001,209.4761,81820823,105819763.55,48.55530392166565,0.2432966314979724,1.5,2.75,NaN,NaN,1.8501797759766063,0.7732092782586831,701.1205439974974,-0.01551756329972144,0.09698516320980843,0.11250272650952987,11.758824536817622,-0.941477030799077,20.74070507658465,47.78017027741036,31.479124646004987,8656615354
1438781400,210.45,211.31,209.73,210.07,NaN,NaN,200.15315789473686,213.08857142857144,207.21377300000015,209.7685410000001,209.862584,209.97800000000012,209.76819998564665,209.82008923176318,210.10307692307703,213.05100850161247,207.15514534454158,207.21377300000015,209.7685410000001,209.862584,209.97800000000012,210.36999999999998,85786817,101908101.45,51.05673265272101,0.2289705630571895,1.5,2.75,NaN,NaN,1.8558812205497064,0.8418056639205498,700.6774022342246,-0.005286277609693635,0.10589487949741283,0.11118115710710647,12.011581768496876,-0.05233609287278221,18.003203786253046,51.537296937196366,30.459499276550584,8742402171
1438867800,210.29,210.415,207.65,208.35,NaN,NaN,199.96473684210528,213.0809523809524,207.30402300000011,209.7662410000001,209.77558399999998,210.15050000000014,209.712584299935,209.6800807335,209.77692307692317,212.48014491097152,207.07370124287482,207.30402300000011,209.7662410000001,209.77558399999998,210.15050000000014,208.80499999999998,116030803,100503986.25,45.16175242112461,0.605031880096874,1.5,2.75,NaN,NaN,1.9208182762247266,1.154489561353095,698.0793260228713,-0.10937638969779351,-0.02553933001513542,0.08383705968265809,12.486496575544134,0.16826923076922803,3.4087734313596054,80.07073318481567,16.520493383824725,8626371368
1438954200,208.16,208.34,206.87,207.95,NaN,NaN,199.77631578947373,213.07333333333335,207.37342300000012,209.7661410000001,209.685384,210.17400000000015,209.64346334699638,209.51531113983333,209.48461538461547,212.09128865954267,206.87794210968826,207.37342300000012,209.7661410000001,209.685384,210.17400000000015,207.72000000000003,117857956,99924039.55,43.89253442767436,0.913771974245056,1.5,2.75,NaN,NaN,1.8893312564943883,1.1794754948935608,696.9752526094654,-0.1951757563072592,-0.1601326357014159,0.03504312060584329,10.971414508602264,0.5609555587794365,3.224618804106805,80.64937788705204,16.126003308841153,8508513412
1439213400,209.28,210.67,209.28,210.57,NaN,NaN,199.58789473684214,213.0657142857143,207.4628230000001,209.7672410000001,209.67398400000002,210.2140000000001,209.6797981177024,209.61575769794445,209.42307692307702,211.88241247581743,206.9637413703366,207.4628230000001,209.7672410000001,209.67398400000002,210.2140000000001,210.17333333333332,80270676,98634103.35,53.175104475911525,0.4019952320415632,1.5,2.75,NaN,NaN,1.9486647381733604,0.8138227375085678,701.2610216293677,-0.07183890366899973,-0.054755508980406375,0.017083394688593354,12.37704723308549,0.5923661204796162,14.724773032671965,56.497250116017575,28.77797685131046,8588784088
1439299800,208.97,209.47,207.76,208.67,NaN,NaN,199.39947368421056,213.05809523809523,207.53152300000008,209.75894100000008,209.61598400000003,210.1135000000001,209.64019819151798,209.52568553623544,209.3069230769232,211.75489724240043,206.85894891144596,207.53152300000008,209.75894100000008,209.61598400000003,210.1135000000001,208.63333333333333,126081377,100852693.45,47.09067958275284,0.5129275392344886,1.5,2.75,NaN,NaN,2.0101886854466917,1.2501537905133657,698.4162398266359,-0.11217714713074758,-0.12313803922484112,-0.010960892094093542,11.848721263354369,-0.9963467286615849,12.182482262812396,60.6880238866692,27.129493850518422,8462702711
1439386200,207.11,209.14,205.36,208.92,NaN,NaN,199.21105263157898,213.0504761904762,207.5939730000001,209.74404100000007,209.56718400000003,210.02900000000014,209.61195512518395,209.46800119945112,209.37769230769243,211.7214191734572,207.03396544192765,207.5939730000001,209.74404100000007,209.56718400000003,210.02900000000014,207.80666666666667,172123672,104563170,47.93484860140473,0.7529220076737158,1.5,2.75,NaN,NaN,2.1366037793433548,1.6461214020194683,697.3915447500399,-0.11552552091902443,-0.15536779324287409,-0.03984227232384965,11.01308973213442,-0.9012427663409571,21.526254440573524,46.803812283950414,31.669933275476062,8634826383
1439472600,208.73,209.55,208.01,208.66,NaN,NaN,199.0226315789474,213.04285714285714,207.6564730000001,209.73064100000008,209.50198400000002,209.84700000000012,209.57462355164733,209.3910487042653,209.52153846153857,211.39461649028792,207.64846043278922,207.6564730000001,209.73064100000008,209.50198400000002,209.84700000000012,208.74,89383253,103698169.35,47.09330919455456,0.25728991459733613,1.5,2.75,NaN,NaN,2.093989223675974,0.8619559396300953,695.1196974130517,-0.12779753623829265,-0.19958919262171548,-0.07179165638342283,10.990874388896417,-0.8741092636579588,23.648600574049045,44.12197800278358,32.22942142316737,8545443130
1439559000,208.43,209.5087,208.26,209.42,NaN,NaN,198.83421052631581,213.0352380952381,207.71152300000006,209.73664100000005,209.48780000000002,209.69400000000013,209.56855988295527,209.39380597052576,209.52846153846167,211.39932059499733,207.657602481926,207.71152300000006,209.73664100000005,209.48780000000002,209.69400000000013,209.06289999999998,72786528,102885997.1,49.86405830110791,0.11193274041181284,1.5,2.75,NaN,NaN,2.033611421984834,0.7074483413836693,698.2862455379073,-0.07963410433810805,-0.1713342868060579,-0.09170018246794984,11.299873572670624,-0.17636684303351188,46.394088590844675,21.843446230413196,31.762465178742126,8618229658
1439818200,208.71,210.59,208.16,210.59,NaN,NaN,198.64578947368426,213.02761904761905,207.77392300000002,209.78494100000006,209.50420000000003,209.59400000000014,209.6086163581335,209.50772921142806,209.51461538461552,211.35085929977672,207.67837146945433,207.77392300000002,209.78494100000006,209.50420000000003,209.59400000000014,209.78,79072643,103317288.2,53.869341344298036,0.4043654937903042,1.5,2.75,NaN,NaN,2.0619248918430606,0.765337964029141,701.1047238906217,0.03023103276091514,-0.05391139151680591,-0.08414242427772105,11.63129666025102,0.5778966472442487,46.888213260729806,21.431313467071625,31.68047327219857,8697302301
1439904600,210.26,210.68,209.699,209.98,NaN,NaN,198.45736842105268,213.02,207.82692300000005,209.83204100000006,209.53420000000003,209.50550000000013,209.62318042252042,209.55270738176824,209.45000000000013,211.1521795982274,207.74782040177286,207.82692300000005,209.83204100000006,209.53420000000003,209.50550000000013,210.1196666666667,71692678,103003669.7,51.55675341998467,0.26980726101934455,1.5,2.75,NaN,NaN,1.9847159709971274,0.6960206195449753,697.9229640779366,0.05934594705342325,-0.009959990460941981,-0.06930593751436523,11.712878498344608,-0.04284286190317676,56.709162524067125,14.566845438365059,28.723992037567804,8625609623
1439991000,209.09,210.01,207.35,208.32,NaN,NaN,198.2689473684211,213.01238095238097,207.86022300000005,209.85784100000004,209.5316,209.35300000000012,209.57207530791177,209.4353066787427,209.28230769230782,210.96712046612015,207.5974949184955,207.86022300000005,209.85784100000004,209.5316,209.35300000000012,208.56000000000003,172945975,107217572.45,45.79520127785984,0.3921681122359356,1.5,2.75,NaN,NaN,2.0329505444973326,1.6130375930741379,694.0319487862679,-0.030821874261055954,-0.10783328034068518,-0.07701140607962922,12.408801510708795,-0.014398848092153175,12.186228075380297,60.64512430181065,27.168647622809058,8452663648
1440077400,206.51,207.17,203.9,203.97,NaN,NaN,198.0805263157895,213.00476190476192,207.87122300000007,209.81504100000006,209.39199999999997,209.0425000000001,209.35238608015052,208.91480128076722,208.83461538461552,212.09664510088723,205.5725856683438,207.87122300000007,209.81504100000006,209.39199999999997,209.0425000000001,205.01333333333332,194327884,112408510.25,34.81546349259294,1.8615810898906242,1.5,2.75,NaN,NaN,2.2034540770332365,1.7287648734762944,688.5722583941227,-0.36262632355826974,-0.5302943105274665,-0.1676679869691967,16.671056859818776,-1.9139216157730174,8.11484429013781,68.34871917441507,23.536436535447127,8258335764
1440163800,201.73,203.9404,197.52,197.63,NaN,NaN,197.89210526315793,212.99714285714288,207.85402300000004,209.72704100000007,209.11199999999997,208.52400000000011,208.89268466524265,207.84005830164654,207.93076923076936,214.70648360826976,201.15505485326895,207.85402300000004,209.72704100000007,209.11199999999997,208.52400000000011,199.69680000000002,346588470,123850184.8,25.296062738829463,4.0690067030784665,1.5,2.75,NaN,NaN,2.5067787858165755,2.7984493568555417,685.7109211200469,-0.9546608447366759,-1.3609940428900416,-0.40633319815336566,23.715242712829845,-6.145224865840337,0.9440391382289282,89.85160614776055,9.204354714010519,7911747294
1440423000,187.49,195.84,182.4,189.55,NaN,NaN,182.4,212.98952380952383,207.7900730000001,209.56554100000005,208.70279999999994,207.66200000000012,208.13414801170373,206.09814798720402,206.35230769230782,218.1205155915501,194.58409979306555,207.7900730000001,209.56554100000005,208.70279999999994,207.66200000000012,189.26333333333332,507244330,142594347.2,18.393520462818728,8.058722819399964,1.5,2.75,NaN,NaN,3.4155803011153907,3.5572541265506774,680.6083371044365,-1.787633975454625,-2.640875667471647,-0.8532416920170219,28.846317117019822,-9.162792926630555,0,100,0,7404502964
1440509400,195.43,195.45,186.92,187.27,NaN,NaN,181.7614705882353,212.9819047619048,207.71067300000007,209.37389100000004,208.26599999999996,206.55900000000014,207.31594612889182,204.30499103604174,204.73076923076937,220.18349109514327,189.27804736639547,207.71067300000007,209.37389100000004,208.26599999999996,206.55900000000014,189.87999999999997,369833070,154908758.45,16.985099709577355,6.5102224156898005,1.5,2.75,NaN,NaN,3.780895993892863,2.3874251766040153,678.8542210658225,-2.353740101366691,-3.7954168187253856,-1.4416767173586946,28.843025328870176,-10.362818303656892,0,100,0,7034669894
1440595800,192.08,194.79,188.37,194.46,NaN,NaN,181.1229411764706,212.9742857142857,207.66627300000007,209.240191,207.95019999999994,205.74350000000013,206.8117913787392,203.367372842133,203.6930769230771,219.9334186864661,187.45273515968807,207.66627300000007,209.240191,207.95019999999994,205.74350000000013,192.54,339256990,166582045.2,34.11744178497882,4.342439951453373,1.5,2.75,NaN,NaN,4.047974851471943,2.03657596827248,684.1126918655432,-2.113185014016126,-4.083157984878852,-1.969972970862726,39.86281056731818,-6.805329243745801,3.6625677262242777,79.62536209565022,16.71207017812551,7373926884
1440682200,197.02,199.42,195.21,199.27,NaN,NaN,180.4844117647059,212.96666666666667,207.64272300000005,209.16009100000002,207.72379999999993,205.16600000000017,206.51603485408276,202.97714685716795,202.8238461538463,218.70448272016475,186.94320958752783,207.64272300000005,209.16009100000002,207.72379999999993,205.16600000000017,197.96666666666667,274143910,175724022,42.64513926815189,1.4270380290534868,1.5,2.75,NaN,NaN,4.113119504938231,1.5600821497245265,691.2672358761703,-1.526710264780287,-3.8783608018380846,-2.3516505370577976,43.78104563068439,-4.846719511030455,12.67239505879351,60.280057605408224,27.04754733579826,7648070794
1440768600,198.5,199.835,197.92,199.28,NaN,NaN,179.84588235294117,212.95904761904762,207.61824800000002,209.07314100000002,207.45379999999994,204.60500000000016,206.23226878137362,202.62503763267577,202.1015384615386,217.7046088618535,186.49846806122372,207.61824800000002,209.07314100000002,207.45379999999994,204.60500000000016,199.01166666666666,160414352,178581396.75,42.661755989098,0.8949495529843593,1.5,2.75,NaN,NaN,3.956110968871216,0.8982702281389788,694.2703788838421,-1.0570088533203679,-3.6729116037082576,-2.6159027503878898,43.582508665453176,-5.37062538582079,27.178037800619222,40.396156253152306,32.42580594622847,7808485146
1441027800,198.11,199.125,197.01,197.67,NaN,NaN,179.20735294117648,212.95142857142858,207.58679800000002,208.960841,207.19099999999995,203.99900000000017,205.89649353504524,202.15312928670664,201.236153846154,216.4741923600661,185.9981153322419,207.58679800000002,208.960841,207.19099999999995,203.99900000000017,197.93499999999997,163298816,181048051.15,40.62124523087245,1.1810500351403364,1.5,2.75,NaN,NaN,3.8356744710947015,0.9019639535622805,692.0213480848347,-0.7860967102334477,-3.5985236381796994,-2.8124269279462517,43.078007573039486,-5.862463091723023,46.06821532717566,22.10030432333009,31.83148034949426,7645186330
1441114200,193.12,194.77,190.73,191.77,NaN,NaN,178.56882352941176,212.94380952380953,207.524698,208.778141,206.78859999999997,203.11850000000018,205.34251339641602,201.16425983082982,199.93692307692325,215.30115203124743,184.57269412259907,207.524698,208.778141,206.78859999999997,203.11850000000018,192.42333333333332,256000392,189757029.6,34.17109442068434,3.4897456109168563,1.5,2.75,NaN,NaN,4.057412008873651,1.3490956964263106,686.1130748762151,-0.9259695959404413,-3.969888922871803,-3.043919326931362,45.09703575551923,-7.944508448540698,53.710275942964934,16.54827689482166,29.74144716221342,7389185938
1441200600,194.62,195.46,192.42,195.41,NaN,NaN,177.93029411764707,212.9361904761905,207.48054800000003,208.64134099999998,206.45599999999996,202.38550000000015,204.9530030671448,200.6162350850365,198.85923076923092,213.3522985265325,184.36616301192933,207.48054800000003,208.64134099999998,206.45599999999996,202.38550000000015,194.42999999999998,160269331,193481155.3,40.453250881853705,2.1494779094582332,1.5,2.75,NaN,NaN,4.031168293954105,0.8283459479632329,688.0941171023898,-0.7050512268351645,-3.9252333604753176,-3.220182133640153,47.86208623204672,-4.1966955924890925,44.79713647831242,23.106788048238883,32.096075473448714,7549455269
1441287000,196.26,198.05,194.96,195.55,NaN,NaN,177.29176470588234,212.92857142857144,207.436448,208.50194099999996,206.15699999999993,201.74550000000016,204.58425784882542,200.1337365055092,197.70230769230784,210.57564604087327,184.82896934374241,207.436448,208.50194099999996,206.15699999999993,201.74550000000016,196.18666666666664,152087836,195284006.95,40.687699790769464,1.1354982841270027,1.5,2.75,NaN,NaN,3.963941987243097,0.7788033355897914,690.6991621196562,-0.4913316638591576,-3.8343467134641003,-3.3430150496049427,47.04199121218299,-1.0524717907200243,36.53791977695916,30.279839548470573,33.18224067457027,7701543105
1441373400,192.85,193.86,191.61,192.59,NaN,NaN,176.65323529411765,212.9209523809524,207.371648,208.32354099999998,205.8115999999999,200.97750000000013,204.1138947959303,199.41528540974642,196.36461538461555,207.3293241299382,185.3999066392929,207.371648,208.32354099999998,205.8115999999999,200.97750000000013,192.6866666666667,207080961,199745157.2,37.34023820342837,2.4199375998353387,1.5,2.75,NaN,NaN,3.9622318452971617,1.0367258155483332,686.4034097557399,-0.4900426193336336,-3.9555683237719848,-3.465525704438351,44.43470976115504,1.6037984700606658,13.636859459835279,58.24724651725483,28.1158940229099,7494462144
1441719000,195.94,197.61,195.17,197.43,NaN,NaN,176.01470588235296,212.91333333333336,207.332698,208.19414099999997,205.56379999999993,200.32050000000015,203.85178127452127,199.22621060881818,195.5269230769232,204.1169365437889,186.93690961005748,207.332698,208.19414099999997,205.56379999999993,200.32050000000015,196.73666666666668,116025739,201532910.35,45.26929996425943,0.26884703572375224,1.5,2.75,NaN,NaN,4.037786713490222,0.575716089240707,691.5626390643502,-0.12307379812119557,-3.6193679520898456,-3.49629415396865,39.07787662593647,5.4253217279863275,28.7873679243893,38.355218175550554,32.857413900060145,7610487883
1441805400,199.32,199.47,194.35,194.79,NaN,NaN,175.37617647058823,212.9057142857143,207.27874799999998,208.06254099999998,205.35119999999995,199.62650000000016,203.49641730297142,198.8037143603593,194.82076923076937,201.8937316676196,187.74780679391915,207.27874799999998,208.06254099999998,205.35119999999995,199.62650000000016,196.20333333333335,149347735,202696228.25,42.13715724725789,0.4991707581807293,1.5,2.75,NaN,NaN,4.115087662526635,0.7368056933738233,687.3305879764903,-0.0232167045460967,-3.525315034651271,-3.5020983301051745,39.290634904920566,0.16970070965750492,37.23761199336054,29.814633601851583,32.94775440478787,7461140148
1441891800,194.56,197.22,194.25,195.85,NaN,NaN,174.73764705882354,212.89809523809524,207.22459799999996,207.922541,205.15119999999996,198.97300000000018,203.1965578008941,198.52240823080126,194.68384615384628,201.60118018215076,187.7665121255418,207.22459799999996,207.922541,205.15119999999996,198.97300000000018,195.77333333333334,158611063,202020597.8,43.81797931357481,0.5046022931056708,1.5,2.75,NaN,NaN,4.033295686631876,0.7851232237072412,688.6816034162416,0.14016353080006994,-3.326893916605087,-3.467057447405157,33.03247497580574,-1.7162643649320097,37.13309922981759,29.911829364759175,32.95507140542323,7619751211
1441978200,195.375,196.82,194.53,196.74,NaN,NaN,174.09911764705882,212.8904761904762,207.17199799999995,207.79394100000002,204.93599999999995,198.37700000000018,202.943359455761,198.35265506596303,195.2369230769232,201.54700480071526,188.92684135313115,207.17199799999995,207.79394100000002,204.93599999999995,198.37700000000018,196.03,119691212,203535995.75,45.25587802335985,0.3702915774470136,1.5,2.75,NaN,NaN,3.9087745661581694,0.5880591860862527,689.7417419945934,0.32362571496285275,-3.062525303701591,-3.3861510186644437,29.607838976457217,-1.274588518667198,34.50945915735058,32.417253925082086,33.07328691756735,7739442423
1442237400,196.95,197.01,195.43,196.01,NaN,NaN,173.46058823529413,212.88285714285715,207.11649799999995,207.647741,204.70999999999995,197.70650000000018,202.67146300651547,198.12954505968085,195.90923076923093,200.22932664807203,191.58913489038983,207.11649799999995,207.647741,204.70999999999995,197.70650000000018,196.15,79451983,203869268.5,44.25538379647381,0.42815507955385756,1.5,2.75,NaN,NaN,3.742433525718299,0.38972025349666667,686.3631485569301,0.4059352608894029,-2.8787319425526903,-3.284667203442093,29.624900992123003,-0.8397834775130251,51.17479011891783,18.29227728233596,30.532932598746196,7659990440
1442323800,196.61,198.99,195.9612,198.46,NaN,NaN,172.8220588235294,212.8752380952381,207.07059799999996,207.520741,204.54479999999995,197.1000000000002,202.50630759449524,198.16101695875886,196.21692307692322,200.64865748034148,191.78518867350496,207.07059799999996,207.520741,204.54479999999995,197.1000000000002,197.80373333333333,113806176,205605945.15,48.380017202632786,0.8217366673297082,1.5,2.75,NaN,NaN,3.691459702452707,0.5535159789128306,689.7696071866568,0.6225444527825368,-2.5064866374639223,-3.129031090246459,30.320758436481402,3.488553996975542,51.03221141935443,18.39332245368749,30.574466126958068,7773796616
1442410200,198.82,200.41,198.41,200.18,NaN,NaN,172.1835294117647,212.86761904761906,207.03549799999996,207.40604199999999,204.38799999999995,196.61000000000018,202.4150798456915,198.35330105792468,196.28692307692322,200.93290982888703,191.6409363249594,207.03549799999996,207.40604199999999,204.38799999999995,196.61000000000018,199.66666666666663,99581557,207000389.1,51.11470475322279,1.2920177471666527,1.5,2.75,NaN,NaN,3.570641152277514,0.4810694194004295,694.3165842044126,0.8639692498597031,-2.04906952792183,-2.913038777781533,23.339209056657744,2.441021442096111,83.77290135428683,2.3186717693706176,13.908426876342526,7873378173
1442496600,200.02,202.89,199.28,199.73,NaN,NaN,171.54500000000002,202.89,207.00534799999997,207.29564199999996,204.29199999999994,196.1805000000002,202.30978259684085,198.48441524288424,196.32153846153858,201.06195613969334,191.58112078338382,207.00534799999997,207.29564199999996,204.29199999999994,196.1805000000002,200.63333333333333,276046620,212155421.35,50.36296093835282,1.462034603779067,1.5,2.75,NaN,NaN,3.5734524985434044,1.301152797526661,697.3942817565159,0.9678386095418969,-1.7032405158541621,-2.671079125396059,21.617217919560108,2.137560726156982,29.92684588061252,36.90719351895525,33.165960600432214,7597331553
1442583000,195.71,197.56,194.96,195.45,NaN,NaN,170.9064705882353,202.64499999999998,206.94717299999996,207.135742,204.10299999999995,195.7545000000002,202.0407715146118,198.1954233149905,196.15076923076933,200.8442898810658,191.45724858047285,206.94717299999996,207.135742,204.10299999999995,195.7545000000002,195.99,223657456,213621899.95,43.76952515624237,0.848481700057318,1.5,2.75,NaN,NaN,3.6589201772188744,1.0469781237426918,693.391118450367,0.7334183300996959,-1.7543062127714393,-2.487724542871135,25.609195548170447,1.4850199906537127,8.63295510541614,67.3107587863527,24.056286108231163,7373674097
1442842200,196.44,197.68,195.21,196.46,NaN,NaN,170.2679411764706,202.39999999999998,206.89002299999996,206.994642,203.88259999999994,195.6960000000002,201.82191772972507,198.03014490403902,196.51153846153858,200.4653941933501,192.55768272972705,206.89002299999996,206.994642,203.88259999999994,195.6960000000002,196.45000000000002,105726209,201578786.9,45.58011642567824,0.479164687967671,1.5,2.75,NaN,NaN,3.573997307417526,0.5244907493785498,696.2195455751132,0.6351771898890664,-1.6937530555098022,-2.3289302453988685,23.794458460940923,-0.4913133768930754,19.10724010735223,50.032324793023065,30.8604350996247,7479400306
1442928600,193.88,194.46,192.56,193.91,NaN,NaN,169.62941176470588,202.15499999999997,206.82127299999996,206.849142,203.56539999999993,195.91400000000016,201.51164644620644,197.6377501512734,196.39615384615396,200.55413810973357,192.23816958257436,206.82127299999996,206.849142,203.56539999999993,195.91400000000016,193.64333333333332,153890876,183911114.2,41.91085479471167,1.6696131362636017,1.5,2.75,NaN,NaN,3.5972832140305604,0.8367676780678218,691.3351681473193,0.3988018783362941,-1.8304278974785007,-2.2292297758147948,20.155655968585435,-0.451768571281891,6.667090090266515,71.53542152871826,21.79748838101524,7325509430
1443015000,194.11,194.67,192.91,193.6,NaN,NaN,168.99088235294118,201.91,206.74927299999996,206.67794199999997,203.22379999999993,196.23050000000018,201.20138580125717,197.25320251781878,196.24615384615393,200.6489050032818,191.84340268902605,206.74927299999996,206.67794199999997,203.22379999999993,196.23050000000018,193.72666666666666,92790620,170058991.7,41.47375280743502,1.3852044078082986,1.5,2.75,NaN,NaN,3.466048698742662,0.545637834685574,689.1186295218357,0.23028054551464905,-1.9413790939214834,-2.1716596394361325,18.747783292349485,-1.1488383967321931,1.6177042962483605,86.57059348500498,11.81170221874668,7232718810
1443101400,192.15,193.45,190.56,192.9,NaN,NaN,168.35235294117646,201.665,206.68072299999997,206.493742,202.8695999999999,196.1525000000002,200.8758412600314,196.83861180183604,196.2700000000001,200.59597165609802,191.94402834390218,206.68072299999997,206.493742,202.8695999999999,196.1525000000002,192.3033333333333,159378840,161065084.2,40.44792713892414,1.831097561876064,1.5,2.75,NaN,NaN,3.4356166488324713,0.9895306657654857,686.2409744215146,0.08770919391342025,-2.062023147044357,-2.1497323409577773,18.397861836996658,-1.951814577615128,2.258281786439667,83.99516164027418,13.746556573286151,7073339970
1443187800,194.64,195,191.81,192.85,NaN,NaN,167.71382352941177,201.42,206.61262299999996,206.33324199999996,202.48059999999995,195.8315000000002,200.561102387089,196.458744011185,195.9176923076924,200.54396612876644,191.29141848661834,206.61262299999996,206.33324199999996,202.48059999999995,195.8315000000002,193.22,155054777,155110627.55,40.37111539537806,1.2051565190320697,1.5,2.75,NaN,NaN,3.4180726024872947,0.9996399308617199,685.150103210051,0.010158188132193047,-2.137034605792536,-2.147192793924729,18.023687776570064,-1.6121626447630206,2.8038604228763453,82.05659970057918,15.139539876544461,6918285193
1443447000,191.78,191.91,187.64,188.01,NaN,NaN,167.07529411764705,201.17499999999998,206.53687249999996,206.13294199999993,201.99119999999996,195.2680000000002,200.06890229347766,195.65410172440548,195.39615384615396,201.65423680877234,189.1380708835356,206.53687249999996,206.13294199999993,201.99119999999996,195.2680000000002,189.18666666666664,178515871,156015703.5,33.69970710528541,3.222829980545487,1.5,2.75,NaN,NaN,3.5460674165953456,1.144217325533516,678.7431397851618,-0.3282837349246064,-2.5575474625804873,-2.229263727655881,22.51210753265723,-5.265544694144925,0,100,0,6739769322
1443533400,188.27,189.74,186.93,188.12,NaN,NaN,186.93,200.92999999999998,206.45652249999995,205.92544199999992,201.50179999999997,194.79050000000018,199.60031788981186,194.93656822684306,194.80153846153857,202.14836968283697,187.45470724024017,206.45652249999995,205.92544199999992,201.50179999999997,194.79050000000018,188.26333333333332,159045572,155803041.3,33.96678700716872,2.963179998169667,1.5,2.75,NaN,NaN,3.4934911725528215,1.0208117291738643,676.4247351612879,-0.49585968484309095,-2.8490883337097443,-2.3532286488666534,20.235549474849286,-6.024577879908084,4.770682625311139,76.27358429211716,18.955733082571697,6898814894
1443619800,190.37,191.825,189.44,191.63,NaN,NaN,187.1112,200.68499999999997,206.41022249999995,205.72554199999996,201.09939999999995,194.78350000000017,199.2877564039369,194.62165696714374,194.40846153846164,201.8446344422963,186.97228863462698,206.41022249999995,205.72554199999996,201.09939999999995,194.78350000000017,190.965,163452044,151175623.9,41.99615981652274,1.1663371591154594,1.5,2.75,NaN,NaN,3.5085989459419045,1.081206346521319,681.3284964727711,-0.32944532331769727,-2.765035303013775,-2.435589979696078,23.280678438477768,-4.055474891102986,18.790143453358205,50.5760618828823,30.633794663759506,7062266938
1443706200,192.08,192.49,189.82,192.13,NaN,NaN,187.29240000000001,200.43999999999997,206.37332249999992,205.54079199999995,200.7145999999999,194.6195000000002,199.00706007437074,194.38435630360624,194.1100000000001,201.57649129831717,186.64350870168303,206.37332249999992,205.54079199999995,200.7145999999999,194.6195000000002,191.48000000000002,131078964,149716105.55,43.05833686418056,0.8316755971219429,1.5,2.75,NaN,NaN,3.448699021231769,0.8755167890486181,680.7373198528694,-0.15375631642406073,-2.6277853752261535,-2.474029058802093,23.605794021744856,-1.698644154515218,41.81319462202072,25.64593395485511,32.54087142312417,7193345902
1443792600,189.77,195.03,189.12,195,NaN,NaN,187.4736,200.195,206.3587724999999,205.39099199999998,200.41099999999992,194.59200000000018,198.8499204636111,194.44298903659612,193.84384615384624,200.90688772339465,186.78080458429784,206.3587724999999,205.39099199999998,200.41099999999992,194.59200000000018,193.04999999999998,211003342,152661880.85,48.848551677979536,0.35488948301888695,1.5,2.75,NaN,NaN,3.624506234000928,1.3821612888899502,682.2542347904434,0.17013425544763905,-2.261361239492544,-2.431495494940183,22.824235453618353,-0.7431538226611055,73.66200620539064,5.79930028721941,20.538693507389958,7404349244
1444051800,196.46,198.74,196.33,198.47,NaN,NaN,187.6548,199.95,206.34217249999992,205.27549199999999,200.2203999999999,194.88600000000017,198.83502162190086,194.82651389025364,193.71230769230777,200.34928640183097,187.07532898278458,206.34217249999992,205.27549199999999,200.2203999999999,194.88600000000017,197.8466666666667,126320842,148623874.9,54.829276693137366,2.1554287676743837,1.5,2.75,NaN,NaN,3.6327557887151483,0.8499364054731693,689.111347885617,0.6078386460326812,-1.6716971873993316,-2.279535833432013,24.924230674814375,2.3516064153473275,99.99999999999999,0,0,7530670086
1444138200,198.31,198.98,197,197.79,NaN,NaN,187.836,199.70499999999998,206.29722249999992,205.131292,200.0403999999999,194.90400000000017,198.7940403818263,195.10875066261042,193.563076923077,199.7221546992867,187.4039991468673,206.29722249999992,205.131292,200.0403999999999,194.90400000000017,197.92333333333332,110274530,148336314.45,53.50893502761698,1.6834134793610358,1.5,2.75,NaN,NaN,3.5147018038069224,0.7434088571559492,690.2530579825878,0.8277054537497337,-1.2449040162448455,-2.072609469994579,23.508967250124236,2.1642561983471063,82.33144493311029,2.718653998894209,14.949901067995485,7420395556
1444224600,198.9,199.825,197.48,199.41,NaN,NaN,188.0172,199.45999999999998,206.26167249999995,205.000992,199.8419999999999,195.13500000000016,198.81819566097036,195.51839345664752,193.86769230769238,200.72236013378466,187.0130244816001,206.26167249999995,205.000992,199.8419999999999,195.13500000000016,198.905,124307295,147084292.45,56.214130050165906,1.816984470256496,1.5,2.75,NaN,NaN,3.4311516749635707,0.8451432367753149,694.5671176844361,1.0444042219911616,-0.7671041925056272,-1.8115084144967888,23.631288962325517,3.3748055987558274,81.391271185931,2.9983987047801484,15.61033010928884,7544702851
1444311000,198.95,201.55,198.59,201.21,NaN,NaN,188.19840000000002,199.21499999999997,206.23037249999993,204.882092,199.65079999999986,195.4030000000002,198.91199190955976,196.06045122268108,194.23307692307702,202.04155115448808,186.42460269166597,206.23037249999993,204.882092,199.65079999999986,195.4030000000002,200.45000000000002,153055231,146806500.85,59.06431670872296,2.246007105509628,1.5,2.75,NaN,NaN,3.3974979838947448,1.0425643967659488,699.0463242145305,1.2568643879594474,-0.24042792954747938,-1.4972923175069268,23.45431169525879,4.334975369458135,82.20443285095286,2.7557179487621886,15.039849200284946,7697758082
1444397400,201.38,201.9,200.58,201.33,NaN,NaN,188.3796,198.96999999999997,206.19827249999994,204.76509200000004,199.46099999999987,195.63250000000022,199.0068157562437,196.56231301099717,194.80384615384625,203.4718546677891,186.1358376399034,206.19827249999994,204.76509200000004,199.46099999999987,195.63250000000022,201.26999999999998,107069240,146175402.25,59.2547355356562,2.184624840291494,1.5,2.75,NaN,NaN,3.2491052707594053,0.7324709790562591,701.0301296160172,1.3454520437730775,0.18452273720942003,-1.1609293065636574,23.39977286272797,7.084729535663009,79.01234197551264,3.7612823274222955,17.226375697065063,7804827322
1444656600,201.42,201.76,200.91,201.52,NaN,NaN,188.5608,198.72499999999997,206.16702249999994,204.65149200000005,199.28139999999988,195.90800000000021,199.1053720010969,197.0344736766165,195.41307692307703,204.74489308605257,186.0812607601015,206.16702249999994,204.65149200000005,199.28139999999988,195.90800000000021,201.39666666666665,56395585,145022582.35,59.57537053567395,1.957488687417464,1.5,2.75,NaN,NaN,3.0777406085623045,0.38887450551593356,702.2711896004892,1.3531555778317041,0.5305151657259728,-0.8226404121057314,14.279094196397093,7.1231129066553285,77.2130305539752,4.394872265238766,18.392097180786024,7861222907
1444743000,200.65,202.16,200.05,200.25,NaN,NaN,188.74200000000002,198.48,206.12607249999994,204.51899200000003,199.09059999999988,195.99750000000023,199.1502593736029,197.3407142788435,195.97846153846163,205.52097804627633,186.43594503064693,206.12607249999994,204.51899200000003,199.09059999999988,195.99750000000023,200.82000000000002,88038718,143734209.45,56.381584159331204,1.4464469094705112,1.5,2.75,NaN,NaN,3.008616279379282,0.6125105382836891,698.2624781564139,1.2135007749243902,0.6942355565497564,-0.5192652183746338,15.86201479098677,4.4982518394823385,81.31927318418022,3.024005134334882,15.656721681484902,7773184189
1444829400,200.18,200.87,198.94,199.29,NaN,NaN,188.9232,198.23499999999999,206.07892249999995,204.38199200000003,198.8887999999999,195.95300000000023,199.1557393981675,197.52636053800126,196.47384615384624,205.9838814638626,186.9638108438299,206.07892249999995,204.38199200000003,198.8887999999999,195.95300000000023,199.70000000000002,99106161,143710439.65,54.02394361886164,0.7934639124096391,1.5,2.75,NaN,NaN,2.931572259423619,0.689623949668294,695.5272484619492,1.0058232188006904,0.7380138051262293,-0.26780941367446115,14.890935012636803,3.7266434185187096,52.92093952489155,17.07033244002787,30.008728035080576,7674078028
1444915800,200.08,202.36,199.64,202.35,NaN,NaN,189.1044,197.98999999999998,206.05267249999994,204.298492,198.7343999999999,196.08400000000023,199.281004519808,197.98575477247732,197.57692307692315,206.18830868728324,188.96553746656306,206.05267249999994,204.298492,198.7343999999999,196.08400000000023,201.45000000000002,134142195,136615218.4,59.79499933375028,1.5312618806797347,1.5,2.75,NaN,NaN,2.9414599551790763,0.9818978922775707,697.8970926796483,1.0206516534178303,1.0080051530978267,-0.012646500320003584,16.187780613837198,3.7692307692307665,50.90309835864001,18.477120599560696,30.6197810417993,7808220223
1445002200,202.83,203.29,201.92,203.27,NaN,NaN,189.28560000000002,197.74499999999998,206.04132249999992,204.204192,198.63279999999992,196.47500000000022,199.43743571510964,198.48901622271757,198.74230769230778,205.896199172736,191.58841621187955,206.04132249999992,204.204192,198.63279999999992,196.47500000000022,202.82666666666668,114580052,131161348.2,61.36519355760108,1.6991902695434615,1.5,2.75,NaN,NaN,2.829212815523428,0.873580925878284,700.4704078992652,1.0352691291839515,1.2814399111599357,0.2461707819759843,14.979286384619506,2.4185015367561906,51.87944744445223,17.789315815860895,30.331236739686858,7922800275
1445261400,202.5,203.37,202.13,203.37,NaN,NaN,189.4668,197.49999999999997,206.03102249999992,204.113292,198.54119999999992,196.8205000000002,199.59165392236025,198.95387182055399,199.64538461538467,205.88563912393604,193.4051301068333,206.03102249999992,204.113292,198.54119999999992,196.8205000000002,202.95666666666668,76523897,129701232.6,61.541013443403436,1.4820472099532551,1.5,2.75,NaN,NaN,2.715697614414612,0.5900013089004368,698.8806052299151,0.9942980357059975,1.4890433266084813,0.49474529090248376,12.335718066204198,2.8211739723949707,54.18874755047846,16.218941219860834,29.592311229660705,7999324172
1445347800,202.85,203.84,202.5471,203.09,NaN,NaN,189.648,197.25499999999997,206.0378724999999,204.032792,198.39159999999993,197.27950000000024,199.72884396462064,199.34778879002502,200.4884615384616,205.21813120431347,195.75879187260972,206.0378724999999,204.032792,198.39159999999993,197.27950000000024,203.15903333333335,78448484,125929113,60.707951025227196,1.3618634899553983,1.5,2.75,NaN,NaN,2.614069213384997,0.6229574887897448,701.5381416830987,0.8941159577771391,1.6123902381239077,0.7182742803467685,12.031282385118327,1.8454440599769355,55.74037291241576,15.202402586128446,29.057224501455785,7920875688
1445434200,203.61,203.79,201.65,201.85,NaN,NaN,189.82920000000001,197.00999999999996,206.0480224999999,203.93559199999999,198.25519999999995,197.69200000000026,199.81202655424335,199.58609461954646,201.01538461538468,204.5595205338428,197.47124869692655,206.0480224999999,203.93559199999999,198.25519999999995,197.69200000000026,202.42999999999998,102038033,126391483.65,57.026349291427024,0.9059521830568797,1.5,2.75,NaN,NaN,2.5802071267146394,0.8073173132658293,699.76681035359,0.6987704635761307,1.591737359816932,0.8929668962408013,12.420926780684143,0.31807564236369285,54.96130092615978,15.708712056043147,29.329987017797066,7818837655
1445520600,202.98,205.51,201.85,205.26,NaN,NaN,190.0104,196.765,206.0627724999999,203.87459199999998,198.18199999999993,198.31000000000023,200.025672571724,200.12646656054204,201.5376923076924,205.41322624686393,197.66215836852086,206.0627724999999,203.87459199999998,198.18199999999993,198.31000000000023,204.20666666666668,174911723,127168127.8,63.56933161692798,1.8176664634642898,1.5,2.75,NaN,NaN,2.657335189092165,1.3754368018619207,704.3357270742143,0.7491782147955113,1.8294396647351903,1.080261449939679,14.769766635315714,1.9520190731634521,59.035829977694206,13.151005784154352,27.813164238151447,7993749378
1445607000,207.25,207.95,206.3,207.51,NaN,NaN,190.1916,196.51999999999998,206.07082249999993,203.83049199999996,198.15899999999993,199.04300000000023,200.31917560812695,200.8296602214428,202.2853846153847,206.69411452413945,197.87665470662992,206.07082249999993,203.83049199999996,198.15899999999993,199.04300000000023,207.25333333333333,144442340,126637505.95,67.12596672012512,2.5550028904190563,1.5,2.75,NaN,NaN,2.6596683898712956,1.1405968470117362,706.5998413805675,0.8752408628759252,2.1743125285345855,1.2990716656586603,15.573343342200832,2.9724096863834757,61.721940795095556,11.585498794605478,26.692560410298967,8138191718
1445866200,207.3,207.37,206.56,207,NaN,NaN,190.3728,196.27499999999998,206.08457249999992,203.79919999999998,198.11059999999995,199.9925000000002,200.58116872153374,201.41731162892444,202.86923076923085,207.5987873367673,198.13967420169442,206.08457249999992,203.79919999999998,198.11059999999995,199.9925000000002,206.9766666666667,69032965,121163360.65,65.56351452486851,2.0256191853610597,1.5,2.75,NaN,NaN,2.5375492191662024,0.5697511576904251,703.6834021170943,0.8639825192025896,2.3790498146618972,1.5150672954593076,15.858892334577712,3.3707865168539324,44.69186740310511,23.274176755271483,32.03395584162342,8069158753
1445952600,206.2,207,205.79,206.6,NaN,NaN,190.554,196.02999999999997,206.1043224999999,203.76749999999996,198.03079999999994,200.9165000000002,200.8172013206893,201.9109009975983,203.28384615384624,208.29549743069896,198.27219487699352,206.1043224999999,203.76749999999996,198.03079999999994,200.9165000000002,206.46333333333334,77905770,117106370.55,64.29936807706176,1.4895077400707528,1.5,2.75,NaN,NaN,2.4427242749400455,0.665256464136912,701.0967399327265,0.772294971319601,2.480436009608809,1.708141038289208,15.132247398543393,3.6680214762406558,44.57923877514499,23.364900182850043,32.05586104200497,7991252983
1446039000,207,208.98,206.21,208.95,NaN,NaN,190.73520000000002,195.78499999999997,206.13867249999987,203.77219999999997,198.01019999999997,201.7825000000002,201.1361346022309,202.5812913787794,203.87000000000006,209.56616335116686,198.17383664883326,206.13867249999987,203.77219999999997,198.01019999999997,201.7825000000002,208.04666666666665,135906725,115729104.6,68.1809991466557,1.8520536429383176,1.5,2.75,NaN,NaN,2.466101112444327,1.1743521689702938,704.6752829531823,0.8087407282168597,2.7190669485602825,1.9103262203434228,14.86748253352699,3.261675315048181,71.92269790902871,6.538318997007925,21.53898309396337,8127159708
1446125400,208.35,209.27,208.21,208.83,NaN,NaN,190.9164,195.53999999999996,206.1785224999999,203.77599999999998,198.02039999999997,202.6175000000002,201.4378548139081,203.17640648556232,204.43230769230775,210.5193438732056,198.3452715114099,206.1785224999999,203.77599999999998,198.02039999999997,202.6175000000002,208.76999999999998,90525498,113701431.3,67.77576053504805,1.9066560708472724,1.5,2.75,NaN,NaN,2.3656653186983037,0.7961684999474584,702.4207970324196,0.7641144980547541,2.865469342911865,2.101354844857111,13.487923793651449,2.7352782014069965,41.51830642296319,25.906668599146865,32.575024977889946,8036634210
1446211800,209.06,209.44,207.74,207.93,NaN,NaN,191.0976,195.29499999999996,206.22307299999989,203.74579999999997,198.09959999999998,203.2640000000002,201.69244874277445,203.62912967741354,205.02307692307699,210.8573015943595,199.18885225179446,206.22307299999989,203.74579999999997,198.09959999999998,203.2640000000002,208.37,131076942,109705111.3,64.67117141045591,1.5721222618778925,1.5,2.75,NaN,NaN,2.3181177959341386,1.1948116222366023,703.9308877024708,0.6194939484723947,2.8757222804476044,2.2562283319752097,14.097394461195698,2.2422186163150917,10.139521002970259,64.46629642471771,25.39418257231203,7905557268
1446474600,208.32,210.62,208.17,210.39,NaN,NaN,191.27880000000002,195.04999999999998,206.26687299999992,203.73339999999996,198.35479999999998,203.86000000000024,202.03352918423428,204.27302208908844,205.8769230769231,211.3423972818028,200.41144887204342,206.26687299999992,203.73339999999996,198.35479999999998,203.86000000000024,209.72666666666666,86270811,107702609.75,68.86879033857355,1.964007874409225,1.5,2.75,NaN,NaN,2.344680810510271,0.8010094760029712,710.0513452017105,0.6327955432805643,3.047222761075915,2.4144272177953505,15.028525216953433,3.5944655079028918,24.870399572972143,42.60205027941977,32.52755014760809,7991828079
1446561000,209.97,211.66,209.7,211,NaN,NaN,191.46,211.66,206.3115979999999,203.74329999999998,198.7838,204.52050000000023,202.3851554907349,204.9136866520324,206.54230769230773,212.22989825340412,200.85471713121134,206.3115979999999,203.74329999999998,198.7838,204.52050000000023,210.78666666666663,95246052,106951185.85,69.82616877205163,2.098680314614452,1.5,2.75,NaN,NaN,2.317203609759538,0.8905562967163678,712.0971907166427,0.6248774400454971,3.1955240178522217,2.5706465778067247,14.729946675639646,4.53306911072579,46.80079176368529,21.50033029949196,31.69887793682275,8087074131
1446647400,211.35,211.5,209.7201,210.36,NaN,NaN,191.6412,211.9257575757576,206.3479979999999,203.7558,199.24560000000002,205.0680000000002,202.69789449109822,205.43238316136265,207.08769230769238,212.7752828687862,201.40010174659855,206.3479979999999,203.7558,199.24560000000002,205.0680000000002,210.5267,96224477,105547044.95,67.48136593489932,1.5595347986814105,1.5,2.75,NaN,NaN,2.2788247804909996,0.9116738137537028,709.5391683827156,0.522878019368763,3.2242441020176784,2.7013660826489154,14.060302977312293,2.4846536100555503,17.907840806915807,51.689179193582845,30.40297999950137,7990849654
1446733800,210.43,210.98,209.09,210.15,NaN,NaN,191.82240000000002,212.19151515151515,206.3682479999999,203.7548,199.5594,205.51500000000019,202.99013392281987,205.88168000313763,207.60923076923083,213.07672048454472,202.14174105391695,206.3682479999999,203.7548,199.5594,205.51500000000019,210.07333333333335,78408744,101814720.6,66.69000812713439,1.147952669750911,1.5,2.75,NaN,NaN,2.2510515818844987,0.770112057843235,708.7461576769988,0.3935070804236389,3.193249933178464,2.799742852754825,11.731588035664606,1.272227844441239,18.814794583699577,50.40989943919689,30.775305977103535,7912440910
1446820200,209.74,210.32,208.46,210.04,NaN,NaN,192.0036,212.45727272727274,206.3935979999999,203.7493,199.77480000000003,205.9505000000002,203.26659925917988,206.27771047902928,208.14384615384623,213.0717356285288,203.21595667916364,206.3935979999999,203.7493,199.77480000000003,205.9505000000002,209.60666666666665,110471473,101984832.25,66.25173548718675,0.7705413788143788,1.5,2.75,NaN,NaN,2.223119326035605,1.083214734610695,705.4428616403284,0.25924692664430626,3.1238015110602078,2.8645545844159015,10.45087098343055,1.4685990338164212,20.48015272451418,48.14198701506297,31.377860260422842,7801969437
1447079400,209.31,209.49,206.95,208.08,NaN,NaN,192.1848,212.7230303030303,206.40674799999994,203.70230000000004,199.95080000000002,206.27850000000018,203.45536007254537,206.4493571000741,208.62307692307698,211.9664642852259,205.27968956092806,206.40674799999994,203.70230000000004,199.95080000000002,206.27850000000018,208.17333333333332,131008660,105715486,58.832654634961834,0.16100862010433675,1.5,2.75,NaN,NaN,2.285039374175919,1.2392570375167173,699.5267818572288,0.010306892593494155,2.877438200157769,2.867131307564275,11.977687851230959,0.7163601161665142,4.0970910646767935,78.02444311996975,17.878465815353458,7670960777
1447165800,207.51,208.6,207.19,208.56,NaN,NaN,192.366,212.9887878787879,206.43584799999994,203.67980000000003,200.1686,206.6940000000002,203.65554203048478,206.65037070959087,208.8769230769231,211.60485703300404,206.14898912084217,206.43584799999994,203.67980000000003,200.1686,206.6940000000002,208.11666666666665,75874602,105107280.2,60.01361371922428,0.07717622085278399,1.5,2.75,NaN,NaN,2.2225365617347816,0.721877703006152,701.8019676932068,-0.14177081253216972,2.689917791899063,2.831688604431233,11.906784029160496,-0.1866475233309339,2.684025011436578,82.44144731125397,14.87452767730946,7746835379
1447252200,208.88,208.94,207.66,207.74,NaN,NaN,192.5472,213.25454545454545,206.47384799999992,203.63830000000004,200.488,207.11650000000017,203.81571685281872,206.75414492772506,208.8946153846154,211.5896434608143,206.1995873084165,206.47384799999992,203.63830000000004,200.488,207.11650000000017,208.11333333333334,67845971,103544270.7,57.005093404542656,0.06792715445638102,1.5,2.75,NaN,NaN,2.155212521610869,0.6552363596878373,699.5085553317375,-0.3078047604274139,2.4469326538969653,2.7547374143243792,10.137366959162199,-0.5219556577120161,3.059246869047041,81.18225189237141,15.75850123858154,7678989408
1447338600,206.5,207.06,204.82,204.84,NaN,NaN,192.72840000000002,213.52030303030304,206.4880969999999,203.56630000000004,200.6766,207.24100000000016,203.85588481937486,206.57184541079886,208.72846153846154,212.06113287313607,205.39579020378702,206.4880969999999,203.56630000000004,200.6766,207.24100000000016,205.57333333333335,121315200,102902920.95,47.866070340744706,0.9832167475469241,1.5,2.75,NaN,NaN,2.2098401986386653,1.1789286337065827,694.2527786616537,-0.6059216284357474,1.9973353787796952,2.6032570072154426,12.744736954738482,-1.4860770451594303,2.564969382359688,82.85749554840818,14.57753506923213,7557674208
1447425000,204.35,204.67,202.435,202.54,NaN,NaN,192.9096,213.7860606060606,206.5035469999999,203.48670000000004,200.81640000000004,207.20450000000014,203.80428149312488,206.18786013357993,208.41615384615386,213.01031427644241,203.8219934158653,206.5035469999999,203.48670000000004,200.81640000000004,207.20450000000014,203.215,153577050,104852770.85,42.10113503879016,1.9668149321566952,1.5,2.75,NaN,NaN,2.2237801844501894,1.4646923372173337,691.4465356215733,-0.9315261168166749,1.438849361194599,2.370375478011274,13.804514251513087,-3.7311659299396336,2.2001452465735625,84.19059316061796,13.609261592808481,7404097158
1447684200,202.32,205.69,202.18,205.62,NaN,NaN,202.18,214.0518181818182,206.52204699999996,203.44430000000003,201.07700000000006,207.31700000000015,203.87548614045332,206.13377821609612,208.16000000000003,212.97267557122595,203.3473244287741,206.52204699999996,203.44430000000003,201.07700000000006,207.31700000000015,204.49666666666667,117645231,106908837.55,50.66936195450889,1.0643366592509538,1.5,2.75,NaN,NaN,2.3156530284180326,1.1004256869314355,695.5841677946887,-0.9118284200189843,1.2305899529875433,2.1424183730065276,15.139178997139785,-2.549763033175353,16.474039701116073,53.800258103330805,29.7257021955531,7521742389
1447770600,205.99,207.04,204.88,205.47,NaN,NaN,202.6285294117647,214.31757575757575,206.52519699999996,203.40080000000006,201.23780000000002,207.43600000000015,203.93801609572967,206.0705612431346,207.90153846153848,212.8998387643667,202.90323815871025,206.52519699999996,203.40080000000006,201.23780000000002,207.43600000000015,205.79666666666665,121123744,109042600.55,50.27912013791585,0.4710782574174765,1.5,2.75,NaN,NaN,2.304534954959602,1.1107928771788633,692.415216308609,-0.8807874016992794,1.0414341208824283,1.9222215225817076,14.825027729754671,-2.324586423274394,4.660128055919087,76.4887348027939,18.851137141287026,7400618645
1447857000,206.04,208.9,205.99,208.73,NaN,NaN,203.07705882352943,214.58333333333334,206.54854699999999,203.43390000000008,201.5166,207.78000000000011,204.12593703315204,206.32384112474082,207.96307692307695,212.98092435992422,202.9452294862297,206.54854699999999,203.43390000000008,201.5166,207.78000000000011,207.87333333333333,121342544,110007826.1,57.87294376284575,0.5581091373982684,1.5,2.75,NaN,NaN,2.384925315319631,1.103035559394624,696.709915884184,-0.624638104407722,1.141423892072055,1.766061996479777,18.176756194500587,-0.6757078277420966,18.105942447017505,51.42615900887509,30.467898544107396,7521961189
1447943400,208.59,209.05,208.2,208.55,NaN,NaN,203.52558823529412,214.8490909090909,206.560697,203.46090000000007,201.77059999999997,207.94450000000012,204.29942969851862,206.5358562557179,207.82153846153852,212.6581033337723,202.98497358930476,206.560697,203.46090000000007,201.77059999999997,207.94450000000012,208.6,88220465,105673263.2,57.352096261178986,0.7315210154098831,1.5,2.75,NaN,NaN,2.2752877927968016,0.8348418732279671,697.9439042442293,-0.4589321553008401,1.192396802353727,1.651328957654567,18.176319921462316,-0.7093886878689681,20.18777225926409,48.552244385247036,31.25998335548888,7433740724
1448029800,209.45,210.12,208.86,209.3108,NaN,NaN,203.97411764705882,215.1148484848485,206.579501,203.47900800000008,202.02201599999998,208.0345400000001,204.49595402406692,206.8001366123162,207.69160000000008,212.2631158018016,203.12008419819855,206.579501,203.47900800000008,202.02201599999998,208.0345400000001,209.43026666666665,94011519,103151722.15,59.030432875290415,0.9728928827705349,1.5,2.75,NaN,NaN,2.224910093311315,0.911390687818972,700.8161855674983,-0.29751526699159037,1.2794348739150792,1.5769501409066695,18.35235553711112,0.5915032679738503,48.50192484172549,20.225282145425684,31.272793012848823,7527752243
1448289000,209.38,209.98,208.52,209.07,NaN,NaN,204.42264705882354,215.38060606060606,206.601701,203.49660800000004,202.28321599999995,208.1380400000001,204.6753283760643,207.0163140778099,207.5923692307693,211.98020485169297,203.2045336098456,206.601701,203.49660800000004,202.28321599999995,208.1380400000001,209.18999999999997,64931172,102946632.5,58.24909083355645,0.7445639708108949,1.5,2.75,NaN,NaN,2.170273658074791,0.630726527164451,702.0360216220565,-0.21049009351643955,1.3138375240111202,1.5243276175275597,17.459356846934686,0.24453394706558826,26.45837240314577,40.730174111366445,32.811453485487796,7462821071
1448375400,207.87,209.83,207.41,209.35,NaN,NaN,204.87117647058824,215.64636363636365,206.614401,203.52290800000003,202.501016,208.2755400000001,204.85864883190493,207.23856987992326,207.53083076923082,211.79413175349416,203.26752978496748,206.614401,203.52290800000003,202.501016,208.2755400000001,208.86333333333334,98874365,103995062.25,58.929825712314525,0.7148002237613176,1.5,2.75,NaN,NaN,2.188111253926593,0.9507601886165513,704.833445686325,-0.14093822027099234,1.3481548421888192,1.4890930624598115,17.43117069602138,0.7750072205641596,58.615940359960696,13.386279898605318,27.99777974143398,7561695436
1448461800,209.5,209.74,209.01,209.32,NaN,NaN,205.31970588235293,215.9121212121212,206.626351,203.535908,202.68381599999998,208.29404000000008,205.03360377967337,207.43680131993057,207.47544615384624,211.62408667453374,203.32680563315873,206.626351,203.535908,202.68381599999998,208.29404000000008,209.35666666666665,51980062,99798729.1,58.819168721693565,0.6833552507217137,1.5,2.75,NaN,NaN,2.0839604500746947,0.5208489373438324,707.2953290233695,-0.10544654629059913,1.3572848795965626,1.4627314258871618,17.222511569016156,2.1870728373364527,31.968016721319106,34.72865686692099,33.3033264117599,7509715374
1448634600,209.43,209.8,208.86,209.56,NaN,NaN,205.76823529411766,216.1778787878788,206.629551,203.58620800000006,202.88041599999997,208.3305400000001,205.21110951380382,207.6390107180324,207.58929230769238,211.8769434892988,203.30164112608594,206.629551,203.58620800000006,202.88041599999997,208.3305400000001,209.40666666666667,37317779,97138343.15,59.474776039552395,0.5741485897786178,1.5,2.75,NaN,NaN,2.0022489893550732,0.384171458868454,709.760176219062,-0.07569257431172649,1.3681157079975037,1.4438082823092302,14.42609099299637,3.4659820282413403,57.262520033822014,14.218044109477274,28.519435856700724,7547033153
1448893800,209.75,209.89,208.56,208.69,NaN,NaN,206.21676470588235,216.44363636363636,206.624101,203.624108,203.14521599999998,208.36854000000008,205.34753659169385,207.73910493536266,207.5992923076924,211.89654832408797,203.30203629129682,206.624101,203.624108,203.14521599999998,208.36854000000008,209.04666666666665,112822700,96225631.05,55.99470327016367,0.3330284337134576,1.5,2.75,NaN,NaN,1.9542312044011383,1.1724807493481229,707.6058722384164,-0.12175972331654861,1.2916086281635444,1.413368351480093,12.416676219664698,1.493045423596923,17.726940191432274,51.94186983092149,30.331189977646222,7434210453
1448980200,209.44,210.82,209.11,210.68,NaN,NaN,206.66529411764708,216.70939393939395,206.62695100000002,203.65610800000002,203.42961599999998,208.38304000000008,205.5566528037843,208.01919017961384,207.82544615384626,212.42718158074518,203.22371072694733,206.62695100000002,203.65610800000002,203.42961599999998,208.38304000000008,210.20333333333335,97858418,96805011.4,61.538421198062736,0.7341614669816473,1.5,2.75,NaN,NaN,1.9667861183724853,1.0108817362320974,711.5252402720581,-0.030139132424180426,1.3756944359498675,1.405833568374048,10.723629700116868,2.535649973232106,45.04563186898438,22.870881296999155,32.083486834016455,7532068871
1449066600,210.615,211,208.23,208.529,NaN,NaN,207.11382352941177,211,206.61894600000002,203.643698,203.721996,208.25949000000008,205.67321543893001,208.06774349584109,208.10921538461545,212.38282577098636,203.83560499824455,206.61894600000002,203.643698,203.721996,208.25949000000008,209.25300000000001,108441259,97464771.75,53.66822719796362,0.2833638406423309,1.5,2.75,NaN,NaN,2.024158538488737,1.1126200477661303,706.6390352006351,-0.12122168907908293,1.2543064570251943,1.3755281461042772,12.91673083946715,-0.09629665117615743,13.887834084526093,57.79361849102173,28.318547424452188,7423627612
1449153000,208.83,209.15,204.7511,205.61,NaN,NaN,207.56235294117647,210.967,206.59709600000002,203.592998,203.962196,208.0219900000001,205.67073640210924,207.83367268671336,208.34536923076934,211.57323343855663,205.11750502298204,206.59709600000002,203.592998,203.962196,208.0219900000001,206.5037,166224154,100964755.6,45.21700945057564,1.268286449731663,1.5,2.75,NaN,NaN,2.193782928596684,1.6463582070018898,700.9776884123146,-0.3707800180037375,0.9120531235996054,1.282833141603343,12.19112312879562,-1.40973387676816,8.24603428051778,68.07186785404936,23.682097865432862,7257403458
1449239400,206.08,209.97,205.93,209.62,NaN,NaN,208.0108823529412,210.934,206.58900100000002,203.58309799999998,204.29659600000002,207.9954900000001,205.82560948437947,208.00379909750257,208.65306153846163,211.52619308064743,205.77992999627583,206.58900100000002,203.58309799999998,204.29659600000002,207.9954900000001,208.50666666666666,192913879,106690012.35,55.56821173547453,0.5056976801540903,1.5,2.75,NaN,NaN,2.348512719411206,1.808171868676328,703.6036210824453,-0.26354795556865906,0.9533981971425192,1.2169461527111782,17.083550587123334,0.14772290775249253,24.222312540224237,43.37715737120572,32.400530088570015,7450317337
1449498600,209.23,209.7295,207.2,208.35,NaN,NaN,208.4594117647059,210.901,206.574706,203.54359799999997,204.60659600000002,207.91099000000014,205.9246051908744,208.03677061202612,208.8746000000001,211.10379858383195,206.64540141616826,206.574706,203.54359799999997,204.60659600000002,207.91099000000014,208.4265,102027111,106267794.25,52.203930494980284,0.23521368802818876,1.5,2.75,NaN,NaN,2.3614403823104064,0.9600943702659002,699.3818288786811,-0.27466445576948595,0.8736155829993208,1.1482800387688068,17.339855793072477,-0.3443822643133873,26.510956953930332,40.69240911000582,32.796633936063834,7348290226
1449585000,206.49,208.289,205.78,206.949,NaN,NaN,208.9079411764706,210.868,206.55040100000002,203.48828799999998,204.98537600000003,207.85444000000012,205.9647775363303,207.93317341088078,208.7376000000001,211.19294517453412,206.28225482546608,206.55040100000002,203.48828799999998,204.98537600000003,207.85444000000012,207.006,103372367,104885979.6,48.701065240761196,0.5794279718897183,1.5,2.75,NaN,NaN,2.3763374978596628,0.9855689711268141,695.6539023910159,-0.3671108950346964,0.6893914199754363,1.0565023150101327,17.713835097643305,-1.1468832099355062,11.037779151403548,62.694847626690276,26.267373221906173,7244917859
1449671400,206.19,208.68,204.18,205.34,NaN,NaN,209.3564705882353,210.835,206.51895100000002,203.415788,205.329776,207.6934400000001,205.9402764564742,207.68620451460643,208.49067692307702,211.54451227620046,205.43684156995357,206.51895100000002,203.415788,205.329776,207.6934400000001,206.0666666666667,162401537,109212326.35,44.969104549719404,1.2806356990298706,1.5,2.75,NaN,NaN,2.528027676583972,1.4870257087972012,692.9546961584886,-0.5181245234612994,0.4088466606835084,0.9269711841448078,18.041753317897815,-1.9013949933116712,9.42581513582276,65.72151209788784,24.852672766289402,7082516322
1449757800,205.42,207.43,205.14,205.87,NaN,NaN,209.805,210.802,206.49140100000005,203.35698799999997,205.61457600000006,207.59994000000012,205.93752051700463,207.5132326560725,208.22600000000008,211.5353738194675,204.91662618053266,206.49140100000005,203.35698799999997,205.61457600000006,207.59994000000012,206.14666666666668,116128884,111626472,46.425440981028494,0.6674280034159704,1.5,2.75,NaN,NaN,2.5110256996851184,1.0403346260016173,693.4608565551094,-0.5602436539781849,0.22666661667207677,0.7869102706502616,18.206982517680892,-1.7608322198892907,28.957805003443006,37.943472816989946,33.098722179567055,7198645206
1449844200,203.35,204.14,201.51,201.88,NaN,NaN,210.2535294117647,210.769,206.44750100000002,203.262088,205.80957600000005,207.4519400000001,205.7784020653574,206.97673430787512,207.67292307692315,212.3527196183017,202.9931265355446,206.44750100000002,203.262088,205.80957600000005,207.4519400000001,202.51,211173305,116119377.25,38.22426724096159,2.247389198671003,1.5,2.75,NaN,NaN,2.643095292564754,1.818587991092589,690.1486905946308,-0.8190808002647896,-0.23694072968072533,0.5821400705840643,20.73703023451113,-3.2632133786956743,3.456651036201301,79.94436287780213,16.598986085996568,6987471901
1450103400,202.07,203.05,199.95,202.9008,NaN,NaN,210.70205882352943,210.736,206.40205500000005,203.18929599999998,205.96759200000005,207.46998000000013,205.66555492553945,206.58855008807748,207.17683076923083,212.37854007609587,201.9751214623658,206.40205500000005,203.18929599999998,205.96759200000005,207.46998000000013,201.96693333333334,182385177,117559783.6,41.091420916727664,2.071496763688785,1.5,2.75,NaN,NaN,2.6757313430958445,1.5514249126263278,685.2887474242791,-0.8785395287093852,-0.5160343403026673,0.36250518840671797,21.330414216266448,-3.6924245300930334,18.970316897934854,50.1878628985051,30.84182020356004,7169857078
1450189800,204.7,206.11,204.58,205.0308,NaN,NaN,211.15058823529412,210.703,206.37160900000003,203.159604,206.09880800000008,207.44052000000016,205.6406625755183,206.440192936832,206.84689230769237,212.00694256771533,201.68684204766942,206.37160900000003,203.159604,206.09880800000008,207.44052000000016,205.24026666666668,154069569,119381000.5,46.654955277911625,0.37409253120751607,1.5,2.75,NaN,NaN,2.7138362471604274,1.2905702612200842,691.0856236162385,-0.7371258806537097,-0.5589021624104191,0.17822371824329053,21.53694406598376,-1.677560435239222,39.46512401997359,27.566340721839985,32.968535258186414,7323926647
1450276200,206.365,208.39,204.8,208.03,NaN,NaN,211.59911764705882,210.67000000000002,206.3606085,203.172004,206.30360800000005,207.56852000000012,205.73436208236072,206.59160313332418,206.72920000000008,211.70277964138808,201.75562035861208,206.3606085,203.172004,206.30360800000005,207.56852000000012,207.07333333333335,197017008,123175663.7,53.33761930214411,0.45755570124221434,1.5,2.75,NaN,NaN,2.7764193723632524,1.5994799790959031,697.1302110328483,-0.4200720832807767,-0.34686638585768037,0.07320569742309635,23.0028432936277,1.1769855551772712,69.9098111992886,7.382474961179536,22.70771383953188,7520943655
1450362600,208.4,208.48,204.84,204.86,NaN,NaN,212.04764705882354,210.637,206.33260850000002,203.12730399999998,206.41260800000006,207.37502000000012,205.70007337324853,206.42668854919808,206.4345846153847,211.36219605226322,201.50697317850617,206.33260850000002,203.12730399999998,206.41260800000006,207.37502000000012,206.06000000000003,173092476,125763160.3,46.681261676268015,0.11137949995782337,1.5,2.75,NaN,NaN,2.8381037029087333,1.3763368826538624,693.6902497927565,-0.40229742937007523,-0.4296660892894977,-0.02736865991942246,23.289101758145254,-2.2707756893426154,44.43264488288739,23.3628183912689,32.20453672584371,7347851179
1450449000,202.77,202.93,199.83,200.0208,NaN,NaN,212.49617647058824,210.604,206.29521250000002,203.01981199999994,206.38882400000008,206.94856000000013,205.47735677037605,205.81660392546493,205.61464615384622,210.9722459405525,200.25704636713994,206.29521250000002,203.01981199999994,206.38882400000008,206.94856000000013,200.92693333333332,251393535,133921813.8,38.73435153507702,2.1482484875702252,1.5,2.75,NaN,NaN,2.9946677241295383,1.877166444112184,691.7569164594232,-0.6786444485367232,-0.8756742205903265,-0.19702977205360328,23.131867859872404,-3.9976961843052488,41.15703901821753,26.089449110483795,32.75351187129868,7096457644
1450708200,201.41,201.88,200.09,201.67,NaN,NaN,212.94470588235293,210.571,206.2617625,202.92831199999992,206.3956240000001,206.56652000000014,205.32804866173385,205.42168926589684,205.08703076923086,210.54273931964005,199.63132221882168,206.2617625,202.92831199999992,206.3956240000001,206.56652000000014,201.21333333333334,99094290,134175952.35,42.33712102932886,1.90959173788331,1.5,2.75,NaN,NaN,2.9135628866917136,0.7385398669763942,695.2057014117012,-0.7092333690296588,-1.0835714833406769,-0.37433811431101804,24.241608273293238,-2.5508700211163253,36.18235489880503,30.565295122961587,33.25234997823339,7195551934
1450794600,202.715,203.85,201.55,203.5,NaN,NaN,213.39323529411766,210.538,206.25436249999998,202.85831199999993,206.4352240000001,206.28802000000013,205.25636047892075,205.23867124057332,204.92472307692316,210.43382483040193,199.41562132344438,206.25436249999998,202.85831199999993,206.4352240000001,206.28802000000013,202.96666666666667,111026246,136480706.05,46.12315124040593,0.7743359627244064,1.5,2.75,NaN,NaN,2.8697369662137326,0.8134940770259884,699.6584713915931,-0.5710276327119894,-1.0881226552010048,-0.5170950224890154,25.085330762041288,-0.8960748027661456,32.74007188347201,33.93221311742222,33.32771499910577,7306578180
1450881000,204.69,206.07,204.58,206.02,NaN,NaN,213.84176470588235,210.505,206.26196249999998,202.82061199999993,206.55062400000008,206.12152000000015,205.2863071268062,205.31308350337588,204.64780000000007,209.50879831469135,199.7868016853088,206.26196249999998,202.82061199999993,206.55062400000008,206.12152000000015,205.55666666666664,110987228,137086349.2,50.90362877628504,0.4944120908222765,1.5,2.75,NaN,NaN,2.8483271829127514,0.8096154624270935,705.8242599991065,-0.2889339731571574,-0.8782624889354622,-0.5893285157783048,25.927474118505216,0.0728615145480185,25.065317549295713,42.3549061057405,32.579776344963776,7417565408
1450967400,205.72,206.33,205.42,205.68,NaN,NaN,214.29029411764708,210.472,206.25486249999997,202.78361199999992,206.6784240000001,205.9395200000002,205.3017460630099,205.3480279316258,204.44241538461546,208.86633689862464,200.01849387060628,206.25486249999997,202.78361199999992,206.6784240000001,205.9395200000002,205.81000000000003,48542150,136914453.6,50.25571441489356,0.44930253624424316,1.5,2.75,NaN,NaN,2.7098752412761278,0.3545436491447241,707.487000472648,-0.11330194620943579,-0.7309559485400996,-0.6176540023306638,25.90699003910497,1.8823063205864927,36.38421062115548,30.374855311016045,33.240934067828476,7369023258
1451313000,204.86,205.26,203.94,205.21,NaN,NaN,214.73882352941177,210.439,206.25177649999998,202.73501199999993,206.73562400000006,205.72202000000016,205.29814817818598,205.33488241432812,204.30864615384624,208.52143291988176,200.09585938781072,206.25177649999998,202.73501199999993,206.73562400000006,205.72202000000016,204.8033333333333,65899939,138343561.6,49.32115751532875,0.08441876108225686,1.5,2.75,NaN,NaN,2.640598438327834,0.47634988023902375,704.1334386629308,-0.02164298738834114,-0.6447077365660903,-0.6230647491777491,22.880861055924452,1.1380930977108046,67.81995771793973,8.370894339176003,23.80914794288425,7303123319
1451399400,206.51,207.79,206.47,207.4,NaN,NaN,215.18735294117647,210.406,206.24587649999998,202.72551199999995,206.81822400000004,205.65752000000015,205.38057373982573,205.5315602796302,204.46710769230776,208.9682513818195,199.96596400279603,206.24587649999998,202.72551199999995,206.81822400000004,205.65752000000015,207.22,92640672,137334460.2,53.6466208667422,1.0529257035582344,1.5,2.75,NaN,NaN,2.6362699784472734,0.6745624649857546,707.693293487454,0.18238267958019394,-0.3950863997025067,-0.5774690792827006,23.40068545235354,1.1555337051799077,67.49301511465289,8.53026332186022,23.97672156348689,7395763991
1451485800,207.11,207.21,205.76,205.93,NaN,NaN,215.6358823529412,210.373,206.23572649999997,202.70531199999994,206.86942400000004,205.42002000000016,205.4021198676757,205.56950691966543,204.47172307692315,208.97873052082264,199.96471563302367,206.23572649999997,202.70531199999994,206.86942400000004,205.42002000000016,206.30000000000004,63317679,135607423.25,50.5291267280536,0.538856058867113,1.5,2.75,NaN,NaN,2.565107837129612,0.4669189745112276,703.2351548624222,0.21215392312009873,-0.3122766753825772,-0.5244305985026759,23.304754250061034,-1.0094697880113417,38.90389888102997,28.07289042940302,33.023210689567,7332446312
1451572200,205.13,205.89,203.87,203.87,NaN,NaN,216.0844117647059,210.34,206.2027765,202.63831199999993,206.88502400000004,205.18707000000012,205.34203673560998,205.40764911779254,204.62480000000005,208.89844180494086,200.35115819505924,206.2027765,202.63831199999993,206.88502400000004,205.18707000000012,204.5433333333333,114877859,135929253.25,46.455036450416024,0.30328186553571046,1.5,2.75,NaN,NaN,2.5290287059060685,0.845129773417629,700.3157838218165,0.09300924878557482,-0.40816903752070743,-0.5011782863062823,22.109630919789513,-0.48325685834228693,7.480184137804316,69.70272873360476,22.817087128590934,7217568453
1451917800,200.49,201.03,198.59,201.0192,NaN,NaN,216.5329411764706,210.30700000000002,206.16037250000002,202.56180399999994,206.86840800000004,204.95753000000013,205.17251372637037,204.9897015827647,204.4800615384616,209.09154826254039,199.8685748143828,206.16037250000002,202.56180399999994,206.86840800000004,204.95753000000013,200.2130666666667,222353534,138735722.25,41.47165188043723,2.3137545363695406,1.5,2.75,NaN,NaN,2.7255266554842064,1.602712916283535,697.0819093769387,-0.1639062726248901,-0.7060611270873949,-0.5421548544625048,21.839694813232388,0.49914808859878756,3.282679642706374,80.46540917467387,16.25191118261978,6995214919
1452004200,201.4,201.9,200.05,201.36,NaN,NaN,216.9814705882353,210.274,206.11512249999998,202.48620399999996,206.79040800000007,204.54453000000012,205.02300338415978,204.64401571773948,204.1976923076924,209.0812229362168,199.314161679168,206.11512249999998,202.48620399999996,206.79040800000007,204.54453000000012,201.10333333333335,110845849,134632320.75,42.26894607763406,1.493828631431777,1.5,2.75,NaN,NaN,2.662989037235334,0.8233227235667332,699.659809611675,-0.2896519243619803,-0.9042197599149802,-0.6145678355529999,16.759535008371678,-0.15371646749639206,14.668463653310715,56.535193624686364,28.796342722002926,7106060768
1452090600,198.34,200.06,197.6,198.82,NaN,NaN,217.43,210.241,206.0592225,202.38780399999996,206.61660800000004,204.0680300000001,204.77974834948685,204.08934755414523,203.48923076923086,208.60983450729745,198.36862703116427,206.0592225,202.38780399999996,206.61660800000004,204.0680300000001,198.82666666666668,152112604,137136595.4,38.102855794221426,2.3684595782545337,1.5,2.75,NaN,NaN,2.7413469631470972,1.1092050488516065,695.0175338079682,-0.5097767987213305,-1.251788833954663,-0.7420120352333325,17.587563240006407,-2.2997542997543032,3.209205112162764,80.69853154753626,16.09226334030096,6953948164
1452177000,195.33,197.44,193.59,194.05,NaN,NaN,217.8785294117647,210.208,205.9853725,202.23410399999997,206.35760800000003,203.42308000000008,204.35897390440894,203.1332192156552,202.6576923076924,209.74935658125375,195.56602803413105,205.9853725,202.23410399999997,206.35760800000003,203.42308000000008,195.02666666666664,213436073,142639780.7,31.770070278006017,3.877943598769129,1.5,2.75,NaN,NaN,2.9191078943508755,1.496329228442231,687.0751738890851,-0.9186689376097527,-1.8903482072455233,-0.9716792696357707,20.485377553747472,-5.81011552276478,2.1330561184304333,84.44619469721853,13.420749184351026,6740512091
1452263400,195.19,195.85,191.58,191.923,NaN,NaN,218.32705882352943,210.175,205.9161875,202.04743399999995,206.06406800000005,202.7522300000001,203.87128865325565,202.06557929035472,202.03478461538467,211.0932998280147,192.97626940275464,205.9161875,202.04743399999995,206.06406800000005,202.7522300000001,193.11766666666668,209817228,145010565.25,29.421839037325356,3.9414924338293216,1.5,2.75,NaN,NaN,3.015600187611526,1.4469099381708672,683.8157982722278,-1.25367802148611,-2.5387767964934085,-1.2850987750072984,17.545957984271503,-6.688545313107743,1.7313385704737885,86.06238324086893,12.206278188657294,6530694863
1452522600,193.01,193.41,189.82,192.11,NaN,NaN,218.77558823529412,210.142,205.85038750000004,201.86873399999996,205.72726800000004,202.0642300000001,203.4100616472456,201.1174288817495,201.29940000000005,211.79514672771018,190.80365327228992,205.85038750000004,201.86873399999996,205.72726800000004,202.0642300000001,191.78,187941323,148601187.2,29.912321138357427,4.100091746203242,1.5,2.75,NaN,NaN,3.0566287456392742,1.2647363492934465,680.546946293562,-1.3742854482024316,-3.002955585260338,-1.6286701370579064,17.903758236991166,-6.383704497831487,13.802180585368474,58.08471036302337,28.11310905160816,6718636186
1452609000,193.82,194.55,191.14,193.6608,NaN,NaN,219.22411764705882,210.109,205.78999150000004,201.722142,205.42388400000004,201.65327000000008,203.02773766107913,200.4072737501543,200.54253846153853,211.69299109823487,189.39208582484218,205.78999150000004,201.722142,205.42388400000004,201.65327000000008,193.11693333333332,172330490,146659046.45,34.00815174258139,2.9393835457678357,1.5,2.75,NaN,NaN,3.081869549522185,1.1750416641277706,679.3129579335167,-1.2640208248180353,-3.2086961680804507,-1.9446753432624153,19.74319325753972,-6.624493731919002,17.57889698361414,52.311851109194805,30.10925190719103,6890966676
1452695400,194.45,194.86,188.38,188.83,NaN,NaN,219.67264705882354,210.076,205.69289150000003,201.570742,205.04188400000004,200.94973000000007,202.47096363515445,199.3046762501396,199.22023076923082,211.480628975682,186.95983256277964,205.69289150000003,201.570742,205.04188400000004,200.94973000000007,190.69000000000003,221168886,148598231.9,28.433920267171388,3.96139131839912,1.5,2.75,NaN,NaN,3.3245931531277444,1.4883682206181081,672.6855091843315,-1.4192081712007867,-3.7186855572633988,-2.299477386062612,19.567577017314743,-8.303792550866797,15.363274408063532,55.61400662437433,29.022718967562117,6669797790
1452781800,189.55,193.26,187.66,191.93,NaN,NaN,220.12117647058824,210.043,205.62039150000004,201.51374199999998,204.67268400000003,200.29469000000006,202.0575925122072,198.60232613107868,198.16253846153853,210.38366783790792,185.94140908516914,205.62039150000004,201.51374199999998,204.67268400000003,200.29469000000006,190.94999999999996,240795609,152934533.9,35.7156498542943,2.849376383706138,1.5,2.75,NaN,NaN,3.4871222136186195,1.5745012121163564,676.4727056596754,-1.2232807017384237,-3.8285782632356415,-2.605297561497218,24.524149762969333,-5.856673370284985,42.91262353667543,24.737413483282022,32.349962980042555,6910593399
1452868200,186.77,188.76,185.52,187.81,NaN,NaN,220.56970588235293,210.01,205.53094150000004,201.496342,204.20888400000004,199.28369000000004,201.49886339408144,197.57448554716643,196.82407692307697,209.46863936892788,184.17951447722606,205.53094150000004,201.496342,204.20888400000004,199.28369000000004,187.36333333333332,324846450,159326006,31.175584274437355,4.1667882606395334,1.5,2.75,NaN,NaN,3.6958991983601464,2.03887901388804,669.8835731927518,-1.2755275382327276,-4.199706984288127,-2.9241794460554,25.915373422372987,-6.571113605068575,35.096718935141396,31.755881884419058,33.14739918043953,6585746949
1453213800,189.96,190.11,186.2,188.06,NaN,NaN,221.01823529411766,209.977,205.43906650000005,201.504242,203.762884,198.44369000000003,200.97184914333315,196.6683440664839,195.33638461538465,207.17911096932772,183.49365826144157,205.43906650000005,201.504242,203.762884,198.44369000000003,188.12333333333336,195244373,160433600.85,31.74258146238529,3.441162405261291,1.5,2.75,NaN,NaN,3.7111921127629945,1.2169793108523874,665.7839369230494,-1.1987959801070511,-4.422674421189214,-3.223878441082163,26.144161297899174,-6.605085419149787,34.292989984812905,32.7254503462072,32.981559668979905,6780991322
1453300200,185.03,187.495,181.02,185.65,NaN,NaN,181.02,209.94400000000002,205.32816650000004,201.41614200000004,203.272884,197.72515000000004,200.3709923141828,195.61897796491402,193.77638461538467,204.95022225042752,182.60254698034183,205.32816650000004,201.41614200000004,203.272884,197.72515000000004,184.72166666666666,286547840,162191316.1,29.241649079209495,4.4339695003917745,1.5,2.75,NaN,NaN,3.9489641047084945,1.7667273864608588,664.0291636835522,-1.212268345254973,-4.739213872650879,-3.526945527395906,25.776608716115188,-6.624082084297347,13.569060611996253,58.65580918621711,27.775130201786624,6494443482
1453386600,186.21,188.87,184.64,186.69,NaN,NaN,180.5279069767442,209.911,205.22521650000007,201.290342,202.805884,196.97615000000002,199.83448281166585,194.76859911111268,192.45484615384623,202.5529701071344,182.35672220055807,205.22521650000007,201.290342,202.805884,196.97615000000002,186.73333333333335,195772941,167025248.65,31.740963200450665,2.8524485152261914,1.5,2.75,NaN,NaN,3.9690380972293178,1.1721158482466356,667.8065512353421,-1.0586385933808429,-4.85024376912196,-3.791605175741117,26.705980982507167,-3.7928368977067834,31.675587833659055,35.37041415556078,32.95399801078017,6690216423
1453473000,189.78,190.76,188.88,190.52,NaN,NaN,180.03581395348837,209.87800000000001,205.13794150000004,201.20274200000003,202.45468400000001,196.32715000000002,199.46920897591426,194.36397062434006,191.64721538461544,200.4759332954848,182.81849747374608,205.13794150000004,201.20274200000003,202.45468400000001,196.32715000000002,190.0533333333333,168319598,169889916.25,40.12814356756463,0.9371407175190817,1.5,2.75,NaN,NaN,3.9762496617129375,0.9907568484071225,676.6418497588783,-0.6278618637714839,-4.576432505455472,-3.948570641683988,27.94331748522353,-0.7310223370830966,27.64846312086345,39.723819348109,32.62771753102755,6858536021
1453732200,189.92,190.15,187.41,187.64,NaN,NaN,179.54372093023258,209.845,205.03164150000003,201.10244200000005,202.03628400000002,195.40815000000003,199.0053184278392,193.723592469641,190.5918307692308,197.6206737217738,183.56298781668778,205.03164150000003,201.10244200000005,202.03628400000002,195.40815000000003,188.4,130371686,170859139.15,36.49663518800175,1.512976441978864,1.5,2.75,NaN,NaN,3.9143746858763,0.7630360696453269,670.3026711697245,-0.4727423057633917,-4.539498523888227,-4.066756218124835,28.546191721373773,-2.3267919421165097,43.02116311118941,24.524538147168276,32.454298741642326,6728164335
1453818600,188.42,190.53,188.02,190.2,NaN,NaN,179.05162790697676,209.812,204.9324415,201.08674200000004,201.68548400000003,194.63415000000006,198.6600118228259,193.3880122344371,189.92875384615385,195.11156856856329,184.74593912374442,204.9324415,201.08674200000004,201.68548400000003,194.63415000000006,189.58333333333334,141036757,175483869.5,41.55936841785036,0.7924260658736203,1.5,2.75,NaN,NaN,3.8412050654565655,0.8037021146265526,676.546129284485,-0.15028537959293686,-4.254612942616006,-4.10432756302307,29.941783157111818,-1.7870420859564797,39.5738153154543,27.478200807012644,32.94798387753306,6869201092
1453905000,189.58,191.56,187.06,188.13,NaN,NaN,178.55953488372094,209.779,204.82764150000003,201.01394200000007,201.35128400000002,193.78015000000008,198.24707018271508,192.8872491644907,189.47336923076924,194.14258316782553,184.80415529371294,204.82764150000003,201.01394200000007,201.35128400000002,193.78015000000008,188.91666666666666,185681707,181472957.9,38.861487422352084,1.0700062707916582,1.5,2.75,NaN,NaN,3.888261846495382,1.0231921557277928,673.6655704762641,-0.03498161052262372,-4.148054576176349,-4.113072965653726,29.826573664566713,-0.3707038076576905,48.94999323902756,19.880871074881984,31.169135686090435,6683519385
1453991400,189.96,190.2,187.16,189.11,NaN,NaN,178.06744186046512,209.746,204.72574150000003,200.94954200000006,201.082684,192.86565000000007,197.88875370496154,192.5275111488249,189.25698461538462,193.70766208971477,184.80630714105448,204.72574150000003,200.94954200000006,201.082684,192.86565000000007,188.82333333333335,143798780,184030863.3,40.82018709779961,0.8575687430505902,1.5,2.75,NaN,NaN,3.8276717146028543,0.7813840429884024,678.2723287966259,0.13916176360608912,-3.939120761146114,-4.078282524752203,26.403165978675897,-1.4692856770697613,45.348084005540066,22.638413032494974,32.01350296196495,6827318165
1454077800,190.02,193.88,189.88,193.7208,NaN,NaN,177.5753488372093,209.713,204.64219550000004,200.96085000000005,200.8447,192.25519000000008,197.7253045400611,192.6411577060797,189.3808923076923,194.21551369701768,184.54627091836693,204.64219550000004,200.96085000000005,200.8447,192.25519000000008,192.49360000000001,210529336,191391446.15,49.085009765230645,1.0548927522889922,1.5,2.75,NaN,NaN,3.894980877845506,1.0999934439860022,686.5651828633165,0.5724477748230976,-3.3627228062233314,-3.935170581046429,28.4443537354321,3.1472232575475187,48.71649497971127,20.05383186870348,31.229673151585256,7037847501
1454337000,192.53,194.58,191.84,193.65,NaN,NaN,177.08325581395349,209.68,204.55859550000005,200.92305000000007,200.60829999999999,191.7441900000001,197.56548867574497,192.7372379245483,189.38006153846152,194.2117436660119,184.54837941091114,204.55859550000005,200.92305000000007,200.60829999999999,191.7441900000001,193.35666666666668,136061564,192450631.4,48.97191339122712,1.2630754892311473,1.5,2.75,NaN,NaN,3.812482243713685,0.7069946355083769,685.530084524303,0.8453723026588427,-2.8784552027228756,-3.7238275053817183,24.62071190034611,2.9724555992768282,49.32331409483449,19.60740466355641,31.06928124160912,6901785937
1454423400,191.96,191.97,189.54,190.16,NaN,NaN,176.5911627906977,209.64700000000002,204.46964550000007,200.87675000000007,200.2369,191.20123000000007,197.27507735512754,192.49178669363894,189.48236923076922,194.3194507306159,184.64528773092255,204.46964550000007,200.87675000000007,200.2369,191.20123000000007,190.55666666666664,182564890,190461199.2,43.63476482925387,0.48766512396401474,1.5,2.75,NaN,NaN,3.8337335120198515,0.9585411137115218,679.9758068935034,0.7833460740895002,-2.744644912769843,-3.527990986859343,27.49513298139017,2.4293024508483656,23.399935762065283,44.39798098112581,32.2020832568089,6719221047
1454509800,191.41,191.78,187.1,191.3,NaN,NaN,176.09906976744188,209.614,204.3768955000001,200.83125000000007,199.8919,190.69823000000008,197.04076059610293,192.37828319900666,189.4339076923077,194.18376651219694,184.6840488724185,204.3768955000001,200.83125000000007,199.8919,190.69823000000008,190.06000000000003,205054934,195171653.45,45.715893907434605,0.5767762587112275,1.5,2.75,NaN,NaN,3.894181118304148,1.0506389138755334,682.7698096875076,0.8083210971933505,-2.5175896153676547,-3.3259107125610052,26.07676762435637,2.4693341903690684,53.65477238217338,16.562583777755258,29.78264384007137,6924275981
1454596200,190.71,192.75,189.96,191.6,NaN,NaN,175.60697674418606,209.58100000000002,204.2868955000001,200.77985000000004,199.537684,190.33723000000006,196.82739743547145,192.30416098957744,189.72544615384615,194.5059744494654,184.9449178582269,204.2868955000001,200.77985000000004,199.537684,190.33723000000006,191.4366666666667,139531794,194542612.95,46.27802902676274,0.14871413364492456,1.5,2.75,NaN,NaN,3.8153110384252793,0.7172299779681766,686.0247961250924,0.8310684224773417,-2.287075184464328,-3.1181436069416697,26.03286873208121,0.5668696199873945,53.50970760173742,16.660315204815202,29.829977193447398,7063807775
1454682600,190.99,191.6696,187.2,187.95,NaN,NaN,175.11488372093024,209.548,204.1734955000001,200.69925000000006,199.11528400000003,190.03223000000006,196.47926420270787,191.88947899057007,189.7169846153846,194.50964831786837,184.92432091290084,204.1734955000001,200.69925000000006,199.11528400000003,190.03223000000006,188.9398666666667,180788308,192910224.7,40.74908512151985,1.52672887183005,1.5,2.75,NaN,NaN,3.8620459642520464,0.9371629123399181,681.2875842372212,0.5972530724235279,-2.3715772664122596,-2.9688303388357875,26.078324418074022,0.16520997655084327,22.83385909541295,45.10401662506137,32.062124279525676,6883019467
1454941800,185.77,186.12,182.8,185.42,NaN,NaN,174.62279069767442,209.51500000000001,204.04479550000008,200.56885000000005,198.63668400000003,189.70708000000005,196.04556756730756,191.2733381343253,189.6992923076923,194.55318610162323,184.84539851376138,204.04479550000008,200.56885000000005,198.63668400000003,189.70708000000005,184.78,191526694,191995698,37.41254097688193,3.0623460746782882,1.5,2.75,NaN,NaN,3.954042681091184,0.9975572160997066,674.2407484411463,0.2850007178361813,-2.6125794415405608,-2.897580159376742,25.768117281035877,-2.5131440588853846,19.99087238218257,48.78574586277438,31.223381755043057,6691492773
1455028200,183.36,186.94,183.2,185.43,NaN,NaN,174.13069767441863,209.482,203.9136960000001,200.42135000000005,198.15888400000003,189.37308000000002,195.62927079996217,190.71682974058,189.6023692307692,194.73506441923195,184.46967404230645,203.9136960000001,200.42135000000005,198.15888400000003,189.37308000000002,185.18999999999997,184513136,191824288.65,37.434347134933354,2.239694745521852,1.5,2.75,NaN,NaN,3.9387539181561,0.9618861995972792,668.9988716086298,0.1014016445957493,-2.7708281036320557,-2.872229748227805,24.054049059646264,-1.435177802583314,46.37495260293615,21.820395799702116,31.804651597361733,6876005909
1455114600,186.41,188.34,185.12,185.27,NaN,NaN,173.6386046511628,209.449,203.7861960000001,200.27675000000008,197.67308400000005,188.95354000000003,195.22302488623816,190.19808405100096,189.19852307692307,194.78496282063352,183.6120833332126,203.7861960000001,200.27675000000008,197.67308400000005,188.95354000000003,186.24333333333334,148214057,190618467,37.21095528686849,1.4550009746816417,1.5,2.75,NaN,NaN,3.8874143525735216,0.7775430121363844,670.7282961056544,-0.003015595230832613,-2.875999242266346,-2.8729836470355132,23.45509977727501,-2.030564221881446,19.814845897280424,49.02379427706102,31.16135982565856,6727791852
1455201000,182.34,184.1,181.09,182.86,NaN,NaN,181.09,209.416,203.64329600000008,200.15085000000008,197.15648400000006,188.65504000000004,194.73820038089548,189.4992189032866,188.83083076923077,195.3333111401807,182.32835039828083,203.64329600000008,200.15085000000008,197.15648400000006,188.65504000000004,182.6833333333333,219058885,190512966.95,33.92681368189682,2.862757071485816,1.5,2.75,NaN,NaN,3.908313327389699,1.1498371397338631,664.3840073354296,-0.19591234206581998,-3.117874074617788,-2.921961732551968,23.878899880976473,-5.606419135167718,4.84548343058618,75.97171192901371,19.182804640400104,6508732967
1455287400,184.96,186.65,183.96,186.63,NaN,NaN,181.094375,209.383,203.52359600000008,200.05255000000008,196.67548400000004,188.39004000000006,194.42023173850743,189.22595996011643,188.5562153846154,195.10557754819328,182.00685322103752,203.52359600000008,200.05255000000008,196.67548400000004,188.39004000000006,185.74666666666667,127632393,184854806.15,42.4791597766598,1.0649305209579598,1.5,2.75,NaN,NaN,3.8998623754332913,0.6904467114392091,670.9254672393363,-0.03931467729524574,-2.971105079171025,-2.931790401875779,22.380261002125174,-3.625096824167317,17.132631579560947,52.797242354544174,30.070126065894875,6636365360
1455633000,188.77,189.81,187.63,189.78,NaN,NaN,181.09875,209.35000000000002,203.43019600000008,200.01125000000008,196.30050400000005,188.48854000000006,194.2382618664091,189.27872567820057,188.68313846153848,195.2584427619633,182.10783416111366,203.43019600000008,200.01125000000008,196.30050400000005,188.48854000000006,189.07333333333335,120250668,174625017.05,48.479723954348245,0.7541850240763904,1.5,2.75,NaN,NaN,3.8484436343309136,0.6886222262504855,677.6602384200924,0.28865286002032287,-2.5709743268503757,-2.8596271868706986,25.277653757629206,-0.19983172065628704,40.458737070270715,26.706930066999764,32.83433286272952,6756616028
1455719400,191.16,193.32,191.01,192.88,NaN,NaN,181.103125,209.317,203.34099600000005,200.0040500000001,196.045904,188.72954000000007,194.18499669517735,189.62170418503862,188.9731384615385,195.92020585810212,182.02607106497487,203.34099600000005,200.0040500000001,196.045904,188.72954000000007,192.40333333333334,136009496,171663273.2,53.60879101986914,2.1433774687010096,1.5,2.75,NaN,NaN,3.8264119461644195,0.7923039882942183,682.1445344508077,0.7029903317668547,-1.9808892721621305,-2.683879603928985,24.931305987005242,0.8259278619968552,36.859201768171715,29.951783602137713,33.18901462969058,6892625524
1455805800,193.2,193.27,191.72,192.09,NaN,NaN,181.10750000000002,209.28400000000002,203.24484600000002,199.99595000000008,195.695304,189.05154000000007,194.10283996203313,189.85677997693972,188.84769230769234,195.49994769778274,182.19543691760194,203.24484600000002,199.99595000000008,195.695304,189.05154000000007,192.36,102342997,162453031.05,52.18305290274946,1.644416188607852,1.5,2.75,NaN,NaN,3.6638110928669616,0.6299851491752144,683.2488497115561,0.8998895808047442,-1.5590176279230548,-2.458907208727799,24.928318759397968,0.25574112734864773,41.11715174988516,26.137315874185663,32.74553237592917,6790282527
1455892200,191.17,192.18,190.45,192,NaN,NaN,181.111875,209.251,203.16034600000003,199.9874500000001,195.368304,189.31704000000008,194.02037564979653,190.06089616961214,188.72076923076926,195.05713781725086,182.38440064428767,203.16034600000003,199.9874500000001,195.368304,189.31704000000008,191.54333333333332,114792988,158404033.4,52.01333854716407,1.1567326315455282,1.5,2.75,NaN,NaN,3.5256817290907514,0.7246847541446504,682.497380562254,0.9928023146208753,-1.2179043154517046,-2.21070663007258,24.92119889182424,2.1548284118116583,53.58823264426522,16.610449824988528,29.80131753074625,6675489539
1456151400,193.87,194.95,193.79,194.78,NaN,NaN,181.11625,209.21800000000002,203.09404600000002,200.0551500000001,195.124924,189.53004000000007,194.0501648400006,190.51033462964907,189.0761538461539,196.16866577378408,181.9836419185237,203.09404600000002,200.0551500000001,195.124924,189.53004000000007,194.50666666666666,103640292,155170068.1,56.69805655821092,2.1521976442925994,1.5,2.75,NaN,NaN,3.4845616055842683,0.6679142006511758,686.8140150537686,1.1965615740703135,-0.715004662484688,-1.9115662365550015,22.696212335248692,5.047999137094172,50.64003474198801,18.639470152143996,30.720495105867993,6779129831
1456237800,194,194.32,192.18,192.32,NaN,NaN,181.120625,209.185,203.01129600000002,200.0971500000001,194.864524,189.76404000000008,193.98231523843197,190.68268371253964,189.15461538461543,196.36537919940588,181.94385156982497,203.01129600000002,200.0971500000001,194.864524,189.76404000000008,192.93999999999997,111455289,154224248.25,51.87221858854198,1.2044308384326912,1.5,2.75,NaN,NaN,3.42137863375682,0.722683302170027,682.9964858250967,1.1219841269847488,-0.5090860778240653,-1.6310702048088142,22.468249090863363,3.7156878606482158,23.54434184094172,44.199296074805794,32.25636208425249,6667674542
1456324200,190.63,193.53,189.32,193.2,NaN,NaN,181.125,209.15200000000002,202.91919599999997,200.1128500000001,194.611124,189.91404000000009,193.95163620947386,190.9224281208692,189.27769230769235,196.70264878554715,181.85273582983754,202.91919599999997,200.1128500000001,194.611124,189.91404000000009,192.01666666666665,150812152,154713018,53.40020951670308,0.8601014647049883,1.5,2.75,NaN,NaN,3.477708731345619,0.974786439755186,686.0576598673317,1.087453865902233,-0.27175287243102275,-1.3592067383332558,22.35291536193109,4.280239650240178,25.302637676273076,42.07261898387894,32.62474333984799,6818486694
1456410600,193.73,195.55,192.83,195.54,NaN,NaN,181.129375,209.119,202.84387099999995,200.14695000000012,194.48432400000002,190.28454000000008,194.0139249855729,191.3621968712626,189.86153846153852,197.941804436409,181.78127248666803,202.84387099999995,200.14695000000012,194.48432400000002,190.28454000000008,194.64,110728317,150965348.5,57.28381627445451,1.6041441069200664,1.5,2.75,NaN,NaN,3.423586679106646,0.73346842901502,690.2703591733632,1.1705298003521416,0.10395551210692133,-1.0665742882452203,22.528762304017654,6.934266652083548,50.05462365738441,19.06019318925414,30.88518315336147,6929215011
1456497000,196.57,196.68,194.9,195.0892,NaN,NaN,181.13375,209.086,202.76941699999995,200.14784200000008,194.32809200000003,190.58350000000007,194.0560926331975,191.71714955018996,190.60532307692313,198.6933797662614,182.51726638758487,202.76941699999995,200.14784200000008,194.32809200000003,190.58350000000007,195.55640000000002,129833663,150267092.65,56.3101928102617,1.7542823154821414,1.5,2.75,NaN,NaN,3.306187630599028,0.8640192653650839,693.4305557028947,1.1421938316196016,0.3611680012792817,-0.7810258303403199,20.00480947063444,4.532604618764405,47.52202177101986,20.937250443333426,31.540727785646705,6799381348
1456756200,195.11,196.23,193.33,193.56,NaN,NaN,181.138125,209.053,202.68711699999997,200.0987420000001,194.098676,190.57546000000008,194.03663802013094,191.89265911683853,191.23070769230773,198.86596836748987,183.5954470171256,202.68711699999997,200.0987420000001,194.098676,190.57546000000008,194.37333333333333,125918102,146036530.95,53.018269548765424,1.0762331500974844,1.5,2.75,NaN,NaN,3.2771742284133816,0.8622370113893754,694.8588413886033,0.974088199238208,0.43658441870744014,-0.5375037805307679,19.370935523980155,1.9917799557382239,23.00753202965584,44.864650261047466,32.1278177092967,6673463246
1456842600,195.01,198.21,194.4542,198.11,NaN,NaN,181.14249999999998,209.02,202.61661699999996,200.1019420000001,193.90027600000002,190.79846000000006,194.196377705616,192.48478681999677,192.21840000000006,199.8357602405033,184.6010397594968,202.61661699999996,200.1019420000001,193.90027600000002,190.79846000000006,196.92473333333336,141799687,146323437.1,60.430588091373316,2.302840100347385,1.5,2.75,NaN,NaN,3.3752332120981405,0.9690838994103974,700.0956970801655,1.1129302223373867,0.8536589973909656,-0.25927122494642113,21.241373737825242,2.7115304852758286,49.43630026410234,19.508712661908177,31.05498707398947,6815262933
1456929000,197.74,199.06,197.25,199,NaN,NaN,181.146875,208.98700000000002,202.54941699999995,200.0978420000001,193.783076,191.24046000000007,194.3847550504938,193.1052833133304,193.4599384615385,199.70987612498115,187.21000079809588,202.54941699999995,200.0978420000001,193.783076,191.24046000000007,198.43666666666664,102414960,142315940.6,61.703355603986815,2.2451862479152394,1.5,2.75,NaN,NaN,3.2634308398054164,0.7196309813800297,703.5634052570454,1.200773518379086,1.2416956730274364,0.04092215464835042,19.86066549667967,3.597272112030817,45.33193280235138,22.635522271153718,32.03254492649489,6917677893
1457015400,198.79,199.795,198.11,199.775,NaN,NaN,181.15125,208.954,202.48279199999996,200.08349200000012,193.77815999999999,191.66421000000008,194.59613720537638,193.74049442634654,194.47109230769235,200.20603025594588,188.7361543594388,202.48279199999996,200.08349200000012,193.77815999999999,191.66421000000008,199.22666666666666,95172197,136821803.75,62.82470333316364,2.2768700392062873,1.5,2.75,NaN,NaN,3.1506857798193133,0.6955923280612356,707.8867555811217,1.2419710724991027,1.5933859952722287,0.3514149227731261,19.319922792483688,4.04947916666667,43.987115315444946,23.715252540204204,32.29763214435085,7012850090
1457101800,200.01,201.35,199.03,200.43,NaN,NaN,181.155625,208.92100000000002,202.41979199999997,200.0744920000001,193.75336,192.10571000000007,194.82491613849888,194.37759019526592,195.2903230769231,201.15201997700547,189.42862617684074,202.41979199999997,200.0744920000001,193.75336,192.10571000000007,200.26999999999998,129293601,136309894.1,63.78972202483436,2.4043100503264485,1.5,2.75,NaN,NaN,3.0913510812607905,0.9485268978724855,711.4232852718668,1.2412835124408312,1.9030193133241653,0.661735800883334,19.127557070584643,2.9007084916315873,75.30997016443416,5.097370235799362,19.592659599766474,7142143691
1457361000,199.34,201.07,199.25,200.59,NaN,NaN,181.16,208.888,202.35834199999996,200.0651920000001,193.69516,192.73771000000008,195.05099785855774,194.96924827190728,195.88340000000002,202.19267618326822,189.57412381673183,202.35834199999996,200.0651920000001,193.69516,192.73771000000008,200.3033333333333,100218998,132281428.6,64.03531779092557,1.9795523968761715,1.5,2.75,NaN,NaN,3.0005402897421622,0.7576195620252018,713.8278264301376,1.179960337499086,2.1366862227571914,0.9567258852581054,18.070117791168087,4.3001247920133165,100,0,0,7242362689
1457447400,199.32,199.92,198.21,198.4,NaN,NaN,181.164375,208.85500000000002,202.282842,200.04669200000012,193.54276,193.38671000000008,195.1823312758692,195.29598653172562,196.36878461538464,202.4008337489413,190.336735481828,202.282842,200.04669200000012,193.54276,193.38671000000008,198.84333333333333,123974866,128903837.2,58.215170127122434,1.1495499922545371,1.5,2.75,NaN,NaN,2.9562159833320076,0.9617624167979384,709.2617214085144,0.9311857177555027,2.120708032452484,1.189522314696981,17.54211577410846,2.69151138716357,74.04733472915034,5.617840906308833,20.334824364540832,7118387823
1457533800,199.36,199.79,198.43,199.38,NaN,NaN,181.16875,208.822,202.214792,200.04759200000012,193.41675999999995,194.0842100000001,195.34694573563903,195.68494019537079,196.93647692307695,202.5945501010137,191.2784037451402,202.214792,200.04759200000012,193.41675999999995,194.0842100000001,199.20000000000002,94801213,124418241.05,59.968574687524324,1.0998812068030728,1.5,2.75,NaN,NaN,2.844343413094006,0.7619559013207895,713.0176690728387,0.7781409742873553,2.1621985325561752,1.38405755826882,17.554284577651515,1.9637925744093299,73.63636646787548,5.785301576188314,20.57833195593622,7213189036
1457620200,199.96,201.07,197.38,199.54,NaN,NaN,181.173125,208.78900000000002,202.158992,200.01949200000013,193.30336,194.7977100000001,195.5113792362022,196.0520887481926,197.30263076923077,202.97116393092753,191.63409760753402,202.158992,200.01949200000013,193.30336,194.7977100000001,199.33,156838697,124849473.05,60.26176569776443,0.9767938226216059,1.5,2.75,NaN,NaN,2.9047474550158623,1.256222338537135,710.8711657219179,0.6390166960071739,2.1828284282777872,1.5438117322706133,16.63444292411865,2.2814179360005507,76.71238080095743,4.586403308176286,18.70121589086629,7370027733
1457706600,201.26,202.81,201.12,202.76,NaN,NaN,181.1775,208.756,202.109292,200.01439200000013,193.21056000000002,195.7927100000001,195.7956388739982,196.69093743884093,198.10570769230767,203.6804313661421,192.53098401847325,202.109292,200.01439200000013,193.21056000000002,195.7927100000001,202.23000000000002,137964528,120794755.2,65.70547538334378,2.1013858595337966,1.5,2.75,NaN,NaN,2.9308369225147297,1.1421400521204086,711.674803285334,0.7097362231540831,2.430982011213217,1.721245788059134,18.137695071302183,4.753048150444301,77.16153753852265,4.421936914969254,18.416525546508108,7507992261
1457962200,202.16,203.04,201.77,202.5,NaN,NaN,181.181875,208.723,202.05949200000003,200.00569200000012,193.14196,196.58621000000008,196.0585549965865,197.24418149228467,198.8210923076923,204.07152168584744,193.57066292953718,202.05949200000003,200.00569200000012,193.14196,196.58621000000008,202.43666666666664,73611974,118093734.25,64.93199853344231,1.9471263544347004,1.5,2.75,NaN,NaN,2.8122057137636767,0.6233351368512593,709.8278558163271,0.6845714452181837,2.576960094581864,1.8923886493636801,16.936588428719965,2.215940639038911,56.68143582012541,14.575792653071709,28.742771526802905,7434380287
1458048600,201.36,202.2,201.05,202.17,NaN,NaN,181.18625,208.69,202.014642,199.9964920000001,193.10796,197.20571000000007,196.2982195065243,197.71330706444803,199.3310923076923,204.4949040819151,194.1672805334695,202.014642,199.9964920000001,193.10796,197.20571000000007,201.80666666666667,93169090,116739655.35,63.90375168065095,1.315795802337767,1.5,2.75,NaN,NaN,2.714905305637699,0.7980928992866005,705.4987980965986,0.5945999084208107,2.6356385348896936,2.041038626468883,12.25408155365873,1.5929648241205967,61.699190880523474,11.576099634977146,26.72470948449938,7341211197
1458135000,201.6,203.82,201.55,203.34,NaN,NaN,181.19062499999998,208.657,201.973492,200.01139200000011,193.15437599999998,197.72871000000004,196.5743677611704,198.24918258211966,199.96576923076924,204.91169816450852,195.01984029702996,201.973492,200.01139200000011,193.15437599999998,197.72871000000004,202.90333333333334,129303179,116404339.5,65.96182789672005,1.6160090461505252,1.5,2.75,NaN,NaN,2.6831263552350046,1.1108106412132512,711.1256104223434,0.5630964895744737,2.744909238436975,2.181812748862501,12.369920776082342,1.7845075710173934,64.41903511964004,10.088481646858488,25.49248323350147,7470514376
1458221400,203.24,205.23,202.77,204.63,NaN,NaN,181.195,208.62400000000002,201.939842,200.00509200000016,193.21977599999994,198.35571000000004,196.89027490779117,198.85687947906064,200.81730769230774,204.77076112982706,196.8638542547884,201.939842,200.00509200000016,193.21977599999994,198.35571000000004,204.21,134278505,118001114.9,68.12009382456553,2.085513316546029,1.5,2.75,NaN,NaN,2.667188758432503,1.1379426805737747,715.9746124343887,0.5762659244726906,2.9021451544533647,2.325879229980674,12.571511383894226,2.0954946864241824,63.05996887570085,10.819756193980849,26.120274930318324,7604792881
1458307800,204.17,204.78,203.8,204.38,NaN,NaN,181.199375,208.591,201.902142,199.97379200000017,193.33097599999994,198.97471000000004,197.18398961728954,199.38289095724534,201.2996153846154,205.34307251458986,197.25615825464095,201.902142,199.97379200000017,193.33097599999994,198.97471000000004,204.32000000000002,138372404,119180085.7,67.2304023743506,1.6188897737233316,1.5,2.75,NaN,NaN,2.5466752756873237,1.1610362854437852,719.6388762442546,0.5171524462144794,2.9723197877487735,2.455167341534294,12.72085859989042,1.8894261927314382,28.59348955641901,38.31002233113786,33.096488112443105,7466420477
1458567000,204.07,204.94,203.8,204.67,NaN,NaN,181.20374999999999,208.55800000000002,201.87484599999996,199.95049200000017,193.54337599999997,199.46921000000003,197.47755865190564,199.8864251517934,201.73576923076928,205.9138914555487,197.55764700598985,201.87484599999996,199.95049200000017,193.54337599999997,199.46921000000003,204.47,72926659,117644404.05,67.75647936605213,1.5063180474001598,1.5,2.75,NaN,NaN,2.4461984702810855,0.6198905896875934,719.3554028894977,0.449115107980695,3.016561226510163,2.567446118529468,12.705290470744366,3.1602822580645067,48.734410255860624,20.137777494230587,31.127812249908786,7539347136
1458653400,203.76,205.23,203.57,204.56,NaN,NaN,181.208125,208.525,201.84879599999996,199.93009200000017,193.79611599999993,200.08121000000003,197.75530144987013,200.33152751828925,202.10384615384618,206.36835830707918,197.83933400061318,201.84879599999996,199.93009200000017,193.79611599999993,200.08121000000003,204.4533333333333,97471939,116945236.55,67.31504139487974,1.3223312475198872,1.5,2.75,NaN,NaN,2.390041436689579,0.8334836191324972,717.8399150813306,0.3525004071898987,3.0080716275168413,2.6555712203269426,9.91049874813302,2.5980539672986294,47.92807597729555,20.742577756245293,31.329346266459165,7441875197
1458739800,204.11,204.33,203.01,203.2092,NaN,NaN,181.21249999999998,208.49200000000002,201.82244199999994,199.8726840000002,194.0180999999999,200.58167000000003,197.96917982438504,200.60559156416647,202.31763076923082,206.50297529752874,198.1322862409329,201.82244199999994,199.8726840000002,194.0180999999999,200.58167000000003,203.5164,81052455,113457251.7,61.975296393846364,0.6557181966946198,1.5,2.75,NaN,NaN,2.3300384769260383,0.7143876110653224,713.2933523272588,0.1630502944510952,2.8593840883908115,2.6963337939397163,11.238005042049009,1.8388293074070452,22.395867166882386,45.78596875063024,31.818164082487378,7360822742
1458826200,202,203.16,201.74,203.12,NaN,NaN,181.216875,208.459,201.79579199999998,199.81558400000017,194.20728399999993,200.96067000000002,198.17117277244836,200.84505903424585,202.5122461538462,206.59211474341623,198.43237756427618,201.79579199999998,199.81558400000017,194.20728399999993,200.96067000000002,202.67333333333332,84360853,112138878.5,61.62764620700954,0.2557363470396788,1.5,2.75,NaN,NaN,2.268550014288464,0.752289073409986,712.7720662921162,0.005484772054955123,2.70318975900841,2.697704986953455,11.304676565327746,0.17754981258631566,3.0765363950017846,81.21696504996403,15.706498555034175,7276461889
1459171800,203.61,203.86,202.705,203.24,NaN,NaN,181.22125,208.42600000000002,201.75724199999996,199.76868400000018,194.49548399999992,201.36821000000003,198.3699503107837,201.07314865003195,202.8845538461539,206.20879594840213,199.56031174390566,201.75724199999996,199.76868400000018,194.49548399999992,201.36821000000003,203.26833333333335,62408185,108767604.6,61.93698056948916,0.47454834077343133,1.5,2.75,NaN,NaN,2.189010727553574,0.5737754842492873,714.8774622899494,-0.11049810740717092,2.559582352694491,2.670080460101662,6.7619230627460505,0.3654320987654366,14.665163799218748,56.544964439028455,28.789871761752803,7338870074
1459258200,202.76,205.25,202.4,205.1208,NaN,NaN,181.22562499999998,208.393,201.72469599999997,199.7159920000002,194.75929999999994,201.94625000000002,198.6346895142824,201.45863925479082,203.3261538461539,206.15991541103398,200.4923922812738,201.72469599999997,199.7159920000002,194.75929999999994,201.94625000000002,204.25693333333334,92922863,107117842.65,66.49582440849223,0.9871522274104662,1.5,2.75,NaN,NaN,2.2362242470140328,0.8674825846112202,718.6623273142313,-0.08171578768553056,2.567935725494749,2.6496515131802796,8.382255453932633,1.4595637334916236,17.780234146881757,51.86076355730226,30.359002295815998,7431792937
1459344600,206.3,206.87,205.59,206.02,NaN,NaN,181.23,208.36,201.70474599999994,199.6661920000002,195.12349999999995,202.34175000000002,198.92430953333016,201.89305456385836,203.82461538461544,206.0288058242469,201.620424944984,201.70474599999994,199.6661920000002,195.12349999999995,202.34175000000002,206.15999999999997,86365310,104346123.8,68.44190416654268,1.4004678676962665,1.5,2.75,NaN,NaN,2.201436800798745,0.8276810566105571,721.2142671047073,-0.02616343443766489,2.6169472201331985,2.6431106545708634,8.325959515699555,1.3179895741123275,46.32776221136953,21.857845109664623,31.814392678965845,7518158247
1459431000,205.91,206.41,205.33,205.52,NaN,NaN,181.234375,208.32700000000003,201.68679599999993,199.61779200000018,195.47269999999997,202.66775,199.18296406143486,202.23847793872898,204.0369230769231,206.3203034456879,201.7535427081583,201.68679599999993,199.61779200000018,195.47269999999997,202.66775,205.7533333333333,94584110,103954581.3,66.14134651594237,1.0449945835454195,1.5,2.75,NaN,NaN,2.121334172170262,0.9098599486158481,723.1134094303465,-0.0459783324047649,2.5856377390649072,2.631616071469672,8.255957670319319,0.4349313394907955,43.36104792656991,24.231748159825017,32.40720391360507,7423574137
1459517400,204.35,207.14,203.98,206.92,NaN,NaN,181.23874999999998,208.294,201.6701459999999,199.58549200000016,195.89809999999997,203.02500000000003,199.48637723549624,202.68433718265956,204.3769230769231,206.94250198609723,201.81134416774898,201.6701459999999,199.58549200000016,195.89809999999997,203.02500000000003,206.01333333333332,114423478,104917145.35,69.25733122457666,1.238788848656342,1.5,2.75,NaN,NaN,2.1955245884438144,1.090607999467458,721.5999043347426,0.009365121540480636,2.6433224733952727,2.633957351854792,8.367559842345782,1.2427830511791722,74.56913752885302,5.389082662979209,20.04177980816778,7537997615
1459776600,206.83,207.07,205.89,206.25,NaN,NaN,181.243125,208.26100000000002,201.64844599999992,199.54759200000015,196.28929999999997,203.316,199.75161734390815,203.02392411764436,204.69076923076926,207.09266268815256,202.28887577338597,201.64844599999992,199.54759200000015,196.28929999999997,203.316,206.40333333333334,63496969,101627313.75,66.12117527976798,0.9765200404207959,1.5,2.75,NaN,NaN,2.1229871178406854,0.6248021979228985,717.2690371864212,-0.023208730010300993,2.6049464393419157,2.6281551693522167,8.648841281924822,0.7719743978111168,55.2643701077032,15.488722810397741,29.246907081899057,7474500646
1459863000,204.67,206.2642,203.89,204.1892,NaN,NaN,181.2475,208.228,201.60549199999994,199.50868400000013,196.56268399999996,203.49596000000003,199.92564019316666,203.1349027731068,204.7560923076923,207.05130950262586,202.46087511275877,201.60549199999994,199.50868400000013,196.56268399999996,203.49596000000003,204.7811333333333,99662158,101599471.75,57.496909613026276,0.20591328557325994,1.5,2.75,NaN,NaN,2.1409308951377795,0.9809318521382961,713.9261705600729,-0.19788457972798978,2.3807994446922294,2.578684024420219,10.663111090569249,-0.1812671098944088,26.087355847922456,41.15698535252693,32.75565879955062,7374838488
1459949400,204.29,206.49,203.98,206.42,NaN,NaN,181.25187499999998,208.19500000000002,201.58354199999994,199.4872840000001,196.93828399999998,203.89696,200.1803209699052,203.44776917566807,204.89378461538462,207.35125621888125,202.436313011888,201.58354199999994,199.4872840000001,196.93828399999998,203.89696,205.63,91839761,99992716.5,63.10660923685742,0.6135085959928515,1.5,2.75,NaN,NaN,2.167292974056511,0.9184645063623209,718.111579388231,-0.17813950721815086,2.356009640397531,2.5341491476156817,12.4057526031484,1.5800465726945323,26.925410829831705,40.19014609860685,32.88444307156144,7466678249
1460035800,205.14,205.56,203.09,203.95,NaN,NaN,181.25625,208.162,201.54384199999993,199.4493840000001,197.213284,204.12546000000003,200.328151520105,203.4956006827473,204.86070769230767,207.35623127903773,202.3651841055776,201.54384199999993,199.4493840000001,197.213284,204.12546000000003,204.19999999999996,113859037,100945607.7,54.52556272880601,0.3865911216134643,1.5,2.75,NaN,NaN,2.250343475909616,1.1279246278686774,713.3472714492973,-0.3371582946466014,2.11270127930743,2.4498595739540314,13.90259370625092,0.408625443087822,24.86029050797702,42.60576004134867,32.53394945067433,7352819212
1460122200,205.34,205.85,203.87,204.4992,NaN,NaN,181.26062499999998,208.12900000000002,201.5061379999999,199.4459760000001,197.540668,204.37342000000004,200.49172204872832,203.5911815701047,204.84756923076924,207.34876265344715,202.34637580809132,201.5061379999999,199.4459760000001,197.540668,204.37342000000004,204.73973333333333,95040598,97855702.75,55.95951840708408,0.16371005713197667,1.5,2.75,NaN,NaN,2.231033227630357,0.9712320828435316,717.8650426265767,-0.40644003609791257,1.9418095288316408,2.3482495649295534,13.95217487605957,0.619563078134222,21.898411749169803,46.27832813643666,31.82326011439353,7447859810
1460381400,205.25,206.07,203.91,204.0201,NaN,NaN,181.265,208.096,201.47373849999994,199.4607770000001,197.83887,204.436425,200.63008981152328,203.63203094438046,204.80603846153846,207.3426312429242,202.26944568015273,201.47373849999994,199.4607770000001,197.83887,204.436425,204.6667,83757486,95145350.65,54.34945163694872,0.0958504278003365,1.5,2.75,NaN,NaN,2.2259594256567596,0.8803108657206887,720.4299885067896,-0.48054181690379805,1.7475722937998057,2.2281141107036038,14.059862600095741,-0.536610621643436,19.81594039690377,49.018554963467395,31.165504639628836,7364102324
1460467800,204.22,206.25,203.7,205.92,NaN,NaN,181.269375,208.06300000000002,201.4540384999999,199.46377700000008,198.082854,204.607425,200.8375372698949,203.84993275920138,205.01456153846155,207.43481183895602,202.59431123796708,201.4540384999999,199.46377700000008,198.082854,204.607425,205.29,115350567,97232280.3,59.344897268076856,0.5586778584875088,1.5,2.75,NaN,NaN,2.2491051809669917,1.1863402426035667,724.1790624665236,-0.40086269297363764,1.7270357444865567,2.1278984374601944,14.073119100677308,-0.04853897679838012,48.482913616046865,20.213191827223127,31.30389455673,7479452891
1460554200,207,208.1,206.84,208.0008,NaN,NaN,181.27374999999998,208.03000000000003,201.4449424999999,199.48908500000007,198.36987000000002,204.898965,201.1184495338206,204.24525344880124,205.39000769230768,208.0231115389792,202.75690384563615,201.4449424999999,199.48908500000007,198.36987000000002,204.898965,207.64693333333332,96336433,97390647.45,63.992277161845394,1.25378677283132,1.5,2.75,NaN,NaN,2.244169096612207,0.9891754036182865,729.2970257711104,-0.2165153259779955,1.8572542799876999,2.0737696059656954,15.005852218062508,1.207084468664844,49.081663946172895,19.769410686113034,31.148925367714085,7575789324
1460640600,208.07,208.6,207.6,208.01,NaN,NaN,181.278125,207.997,201.45789249999996,199.48188500000006,198.72687000000002,205.132465,201.38870641484726,204.6038007393916,205.7569307692308,208.41860289300112,203.09525864546046,201.45789249999996,199.48188500000006,198.72687000000002,205.132465,208.07000000000002,65212883,94186132.65,64.01186536592125,1.227133934448288,1.5,2.75,NaN,NaN,2.1552998754256207,0.692383062826606,727.559432386791,-0.1079389157274262,1.9388459613064128,2.046784877033839,14.86840835205549,0.5267736323216718,78.7040709248087,3.8620489810470446,17.43388009414425,7641002207
1460727000,208.01,208.1721,207.4,207.78,NaN,NaN,181.28249999999997,207.96400000000003,201.46754249999995,199.47418500000006,199.05647000000005,205.289965,201.6393453789709,204.9062959070686,205.96148461538465,208.79907933227142,203.12388989849788,201.46754249999995,199.47418500000006,199.05647000000005,205.289965,207.78403333333333,75761615,91260288.15,63.08787057315298,0.9173467397339782,1.5,2.75,NaN,NaN,2.0564998843237903,0.8301706748446201,729.0728135617251,-0.06756519863908661,1.9623283787349806,2.029893577374067,14.469259798897006,0.7418181818181824,52.785863493356445,17.13787441067405,30.0762620959695,7565240592
1460986200,207.14,209.28,207,209.2392,NaN,NaN,181.28687499999998,207.931,201.47623849999997,199.47346900000008,199.40925400000003,205.53292499999998,201.93737889352104,205.31895343972874,206.20911538461542,209.5424730540978,202.87575771513303,201.47623849999997,199.47346900000008,199.40925400000003,205.53292499999998,208.50639999999996,82530960,88468215.95,66.40147679978804,1.2906541225391641,1.5,2.75,NaN,NaN,2.0724641783006623,0.9328882595150829,733.2078789097092,0.0358987271922282,2.0747669863643523,2.038868259172124,14.71282155098469,2.473196427626932,80.85391208811238,3.1859752992043626,15.960112612683247,7647771552
1461072600,209.74,210.2,208.94,209.9,NaN,NaN,181.29125,207.89800000000002,201.48918849999998,199.4817690000001,199.84825400000003,205.79442499999996,202.2496385447555,205.755243588326,206.5460384615385,210.3804440237299,202.7116328993471,201.48918849999998,199.4817690000001,199.84825400000003,205.79442499999996,209.67999999999998,88316060,89237686,67.81071070169953,1.3526346450490718,1.5,2.75,NaN,NaN,2.014431022707757,0.9896722333207968,737.0413006124728,0.1224487803922516,2.191929234662439,2.0694804542701872,12.77002084184989,1.6858831508574839,79.50547410492004,3.6213364335247666,16.87318946155518,7736087612
1461159000,209.95,210.92,209.39,210.1,NaN,NaN,181.29562499999997,210.92,201.50608849999998,199.4892690000001,200.341854,206.07142499999995,202.55749585672586,206.16902991324733,206.79065384615387,211.06927990210127,202.51202779020647,201.50608849999998,199.4892690000001,200.341854,206.07142499999995,210.13666666666666,81100314,88419104.75,68.24484270941709,1.4755775834957077,1.5,2.75,NaN,NaN,1.9798288068000602,0.9172261382798043,739.3386420711545,0.16417418407064943,2.274698184358499,2.1105240002878496,11.691230075195273,3.015444962000493,78.64324568813265,3.9128767599925753,17.443877551874785,7817187926
1461245400,210.12,210.25,208.65,208.97,NaN,NaN,181.29999999999998,210.91915789473683,201.51083849999998,199.48576900000012,200.812654,206.35946499999994,202.8089666074425,206.43578896912854,206.99988461538462,211.4161036176336,202.58366561313562,201.51083849999998,199.48576900000012,200.812654,206.35946499999994,209.29,85695041,88651234.05,63.06923762164293,0.8272986780985574,1.5,2.75,NaN,NaN,1.9526981777429129,0.9666536728825154,736.549775316041,0.0903653721658686,2.2234807154951852,2.1331153433293166,9.177287728670358,2.1862188213939207,51.15387896903591,18.366225577396367,30.47989545356772,7731492885
1461331800,208.55,209.29,207.91,208.97,NaN,NaN,181.304375,210.91831578947367,201.5330385,199.47986900000012,201.28665399999997,206.65196499999996,203.05057576009182,206.6771424006401,207.36763846153846,211.5778081065802,203.15746881649673,201.5330385,199.47986900000012,201.28665399999997,206.65196499999996,208.72333333333333,99251724,89395777.6,63.06923762164292,0.5109690629497207,1.5,2.75,NaN,NaN,1.9117911650469903,1.1102506926456894,740.2240099302157,0.019919131238355092,2.1580142573772605,2.1380951261389054,9.27860577322564,2.426182518291083,70.48273369245553,7.167168910672867,22.35009739687161,7731492885
1461591000,208.26,208.66,207.54,208.61,NaN,NaN,181.30874999999997,210.9174736842105,201.5515885,199.47906900000012,201.80165399999998,206.92046499999998,203.26859239695096,206.86122407676962,207.5361,211.75636175634799,203.31583824365202,201.5515885,199.47906900000012,201.80165399999998,206.92046499999998,208.26999999999998,66166494,89583693.05,61.35014101405147,0.185259455095017,1.5,2.75,NaN,NaN,1.8773775104007773,0.7385997579165442,737.3806641220849,-0.06774636569178805,2.0534121690241705,2.1211585347159585,9.174669876420234,1.3063325563325692,37.71395016951269,29.142986956852422,33.14306287363489,7665326391
1461677400,209.04,209.52,208.36,208.9192,NaN,NaN,181.31312499999999,210.91663157894735,201.55878449999997,199.46146100000013,202.247438,207.110385,203.4901848519725,207.05722178374393,207.91834615384616,211.64095380116743,204.1957385065249,201.55878449999997,199.46146100000013,202.247438,207.110385,208.93306666666663,75864174,88730758.6,62.30061158539148,0.43154654747651,1.5,2.75,NaN,NaN,1.8261362596578645,0.854992960693565,741.8950574185803,-0.11874780018463182,1.9727237844851686,2.0914715846698004,8.003110954950136,0.44153676332013686,35.02820971252636,31.673014425860263,33.29877586161336,7741190565
1461763800,208.47,209.81,208.05,209.35,NaN,NaN,181.3175,210.91578947368419,201.55668449999996,199.46967100000012,202.638838,207.276885,203.71998152444417,207.27558161386355,208.2914846153846,211.50620686807332,205.0767623626959,201.55668449999996,199.46967100000012,202.638838,207.276885,209.07000000000002,77329437,88278964.95,63.642170061826604,0.5247226587450895,1.5,2.75,NaN,NaN,1.8214122411108735,0.8759667384387474,744.6574066449468,-0.13606445299368186,1.9213910184276983,2.05745547142138,5.899814449957493,0.6441997980866321,34.14483587382916,32.534726681817766,33.320437444353075,7818520002
1461850200,208.46,209.76,206.96,207.4475,NaN,NaN,181.32187499999998,210.91494736842105,201.54052199999998,199.4880460000001,202.93018800000002,207.37326,203.866158719564,207.2919547934956,208.55513076923074,210.71425380681393,206.39600773164756,201.54052199999998,199.4880460000001,202.93018800000002,207.37326,208.05583333333337,97216169,88410567.9,54.43026586608725,0.02937493050428406,1.5,2.75,NaN,NaN,1.89131136674581,1.0995989654761622,741.5471151725156,-0.27995600624569983,1.7075104636142555,1.9874664698599553,8.15384606002218,-0.16002502647031006,31.858657426335867,34.83659309508682,33.304749478577314,7721303833
1461936600,206.72,207.13,205.03,206.3308,NaN,NaN,181.32625,210.9141052631579,201.519126,199.4551540000001,203.21500400000002,207.34379999999996,203.96281131879678,207.2004162417341,208.58673076923074,210.59759677992488,206.5758647585366,201.519126,199.4551540000001,203.21500400000002,207.34379999999996,206.1636,142424137,89810600.85,49.86759260214571,0.9760473418700856,1.5,2.75,NaN,NaN,1.9288962691211087,1.5858276823899013,739.2829515782475,-0.44485322534562965,1.4313999381779183,1.876253163523548,8.669022151658872,-1.3899881093026547,14.807496562685952,56.321994942234284,28.87050849507978,7578879696
1462195800,206.92,208.18,206.41,207.97,NaN,NaN,181.33062499999997,210.91326315789473,201.49747599999998,199.45135400000015,203.534404,207.42979999999997,204.1199559729616,207.27370993299752,208.5843615384615,210.59805396551943,206.5706691114036,201.49747599999998,199.45135400000015,203.534404,207.42979999999997,207.52,62188015,89745153.15,55.733488183466555,0.16914809108949425,1.5,2.75,NaN,NaN,1.9232036784696007,0.6929400955621412,742.3407285485317,-0.43738319394648584,1.3295241710904406,1.7669073650369265,8.975975297819126,-0.9194854692710847,28.980283285107195,37.933976489710396,33.08574022518242,7641067711
1462282200,206.52,206.8,205.28,206.1592,NaN,NaN,181.33499999999998,210.91242105263157,201.465872,199.4434560000001,203.76198799999997,207.5283,204.19992632696312,207.1675661298549,208.4419923076923,210.8256953873421,206.05828922804247,201.465872,199.4434560000001,203.76198799999997,207.5283,206.07973333333334,106422142,90083152.35,48.92336025992945,0.7505801603046597,1.5,2.75,NaN,NaN,1.9779748442932006,1.181376752741935,739.5737963161678,-0.5414423560310508,1.090104419998113,1.6315467760291638,9.716052051935915,-1.8756782484531156,9.959215565873626,64.70878127455053,25.332003159575844,7534645569
1462368600,204.99,205.85,204.42,205.01,NaN,NaN,181.339375,210.9115789473684,201.427972,199.4401560000001,204.015788,207.4578,204.23169392198417,206.96208364129728,208.2289153846154,211.2272095415166,205.23062122771418,201.427972,199.4401560000001,204.015788,207.4578,205.09333333333333,92243810,90103354.8,45.15257835216493,1.120014519808523,1.5,2.75,NaN,NaN,1.9609194982722584,1.0237555549929425,736.7882095429931,-0.6664950796519484,0.7984279264642282,1.4649230061161767,9.763469733257498,-1.8950088529454028,1.64152875909534,86.46983804900901,11.888633191895648,7442401759
1462455000,205.56,205.98,204.47,204.97,NaN,NaN,181.34374999999997,210.91073684210525,201.39407200000002,199.43115600000013,204.25118799999996,207.5088,204.2606471015142,206.77236138974516,207.90051538461537,211.2934761845317,204.50755458469905,201.39407200000002,199.43115600000013,204.25118799999996,207.5088,205.14,67619222,87791364.05,45.0225033527561,1.0130869056054932,1.5,2.75,NaN,NaN,1.928710962681382,0.7702263512102248,735.6226665081643,-0.7258450607077038,0.557616680231547,1.2834617409392508,9.645896342111918,-1.9141503565105038,1.8754797329566577,85.48917516430792,12.635345102735412,7374782537
1462541400,204.06,205.77,203.88,205.72,NaN,NaN,181.34812499999998,210.9098947368421,201.365822,199.46955600000013,204.45478799999992,207.56984000000003,204.317876626945,206.67213649548373,207.57897692307688,210.94520158594491,204.21275226020884,201.365822,199.46955600000013,204.45478799999992,207.56984000000003,205.12333333333333,89315004,87505084.35,48.04472874216973,0.7929702041960104,1.5,2.75,NaN,NaN,1.9259458939184273,1.0206835941413501,738.5047009369974,-0.6888323093864688,0.4224213542061648,1.1112536635926336,10.12810824356975,-1.3853602415991633,16.38537794540356,53.94675888605634,29.66786316854009,7464097541
1462800600,205.57,206.4,205.36,205.8892,NaN,NaN,181.35249999999996,210.90905263157893,201.344368,199.49944000000013,204.67078799999993,207.663295,204.37949715137853,206.59757111496145,207.2550692307692,210.39112018931945,204.11901827221897,201.344368,199.49944000000013,204.67078799999993,207.663295,205.88306666666665,74374922,87035956.15,48.72948085759133,0.36326911740917245,1.5,2.75,NaN,NaN,1.8626640443528246,0.8545309925913877,736.7563250672778,-0.6288568448283959,0.3251826075571387,0.9540394523855346,10.218472240722186,-1.4503214639918214,18.01125722090137,51.58517940847333,30.403563370625303,7538472463
1462887000,206.72,208.5,206.64,208.45,NaN,NaN,181.35687499999997,210.90821052631577,201.34661799999998,199.53363200000015,204.96858799999995,207.789795,204.53912471406957,206.77399291353655,207.2150692307692,210.2749446806052,204.1551937809332,201.34661799999998,199.53363200000015,204.96858799999995,207.789795,207.86333333333332,77472207,85142038.15,57.795601035307435,0.5899761557069462,1.5,2.75,NaN,NaN,1.9161023268990522,0.9099172240099821,741.2636290811739,-0.4035731926916962,0.4495729615209143,0.8531461542126105,12.86441550903685,-0.4299020778600457,46.44742496818498,21.807609837581634,31.74496519423339,7615944670
1462973400,207.91,208.54,206.5,206.5,NaN,NaN,181.36124999999998,210.9073684210526,201.34516799999997,199.51833200000016,205.13638799999993,207.71475500000003,204.61602178410607,206.74789835034258,207.02506923076922,209.9281956488297,204.12194281270874,201.34516799999997,199.51833200000016,205.13638799999993,207.71475500000003,207.17999999999998,81726989,84411565.95,50.47607489133995,0.1670608522161353,1.5,2.75,NaN,NaN,1.9249521606919764,0.9681965744884987,738.4388491882797,-0.37343620544917333,0.3863508974011438,0.7597871028503171,13.766417553721256,-0.4567420672700278,48.68397801585741,20.107950479427778,31.208071504714805,7534217681
1463059800,207.29,207.4899,205.37,206.56,NaN,NaN,181.36562499999997,210.90652631578945,201.33131799999995,199.53533200000015,205.28758799999991,207.64225500000003,204.69225622394504,206.73000326935758,206.8673769230769,209.6282284841933,204.1065253619605,201.33131799999995,199.53533200000015,205.28758799999991,207.64225500000003,206.4733,89586308,85630237.2,50.68303462155074,0.1560954991314828,1.5,2.75,NaN,NaN,1.9388770063568352,1.046199460953963,737.3161663895041,-0.33806855688933923,0.3372014067386431,0.6752699636279823,12.857370795223344,0.11108375482477247,75.59231744193302,5.00546995127859,19.40221260678841,7623803989
1463146200,206.21,206.86,204.38,204.76,NaN,NaN,181.36999999999998,210.9056842105263,201.301268,199.58272400000016,205.38728799999993,207.49125500000005,204.69491284261386,206.54238391037114,206.54743846153846,209.24631862079747,203.84855830227946,201.301268,199.58272400000016,205.38728799999993,207.49125500000005,205.33333333333334,96474630,86665887.95,44.654130628892524,0.7652912944083952,1.5,2.75,NaN,NaN,1.9775286487599197,1.1131788098179867,734.0474953252464,-0.4192067898058208,0.1512614763707063,0.5704682661765271,13.460228346307387,-1.5434918497860306,42.634565772602556,24.87966357684874,32.48577065054871,7527329359
1463405400,204.96,207.34,204.89,206.78,NaN,NaN,181.374375,210.90484210526316,201.28106799999998,199.63382400000017,205.51428799999994,207.36829500000005,204.77668096643293,206.56501401414533,206.34974615384618,208.5240375738475,204.17545473384487,201.28106799999998,199.63382400000017,205.51428799999994,207.36829500000005,206.33666666666667,77486827,86413681.3,51.61060931863382,0.2948466772562188,1.5,2.75,NaN,NaN,2.020562316705641,0.896696285059204,738.7827392694659,-0.3243763190393289,0.164997867377366,0.4893741864166949,13.943723197042099,0.30112650805785174,43.349149982256606,24.2720493593219,32.37880065842149,7604816186
1463491800,206.46,206.8,204.23,204.8508,NaN,NaN,181.37874999999997,210.904,201.25282199999998,199.64733200000018,205.59950399999994,207.11583500000006,204.77958759520027,206.40175553660768,206.15000000000006,208.36099424623063,203.9390057537695,201.25282199999998,199.64733200000018,205.59950399999994,207.11583500000006,205.29359999999997,114924940,87744125.3,45.7024247405835,0.671932794212852,1.5,2.75,NaN,NaN,2.0598078655123824,1.3097736128437991,735.6602402702666,-0.3755126425652049,0.019983383210188777,0.39549602577539367,14.08209325898222,-0.07765474854885053,16.51350468504637,53.74805190276457,29.738443412189056,7489891246
1463578200,204.44,206.3,203.63,204.91,NaN,NaN,181.38312499999998,210.90315789473684,201.228422,199.63623200000018,205.72970399999994,206.85633500000003,204.7847018071532,206.25968358074027,206.04070769230773,208.3436983505731,203.73771703404236,201.228422,199.63623200000018,205.72970399999994,206.85633500000003,204.9466666666667,123493379,89863778.55,45.90706203027951,0.6682475825689368,1.5,2.75,NaN,NaN,2.1033930179757845,1.3742286491023585,732.2315236647456,-0.3877065623229724,-0.08913717712832181,0.2985693851946506,13.725940195907084,-0.02927257647460715,43.3105359204771,24.30387585383645,32.385588225686455,7613384625
1463664600,204.06,204.54,202.78,204.2,NaN,NaN,202.78,210.90231578947368,201.202522,199.62143200000017,205.826104,206.617835,204.76177232451974,206.0635232397174,205.7507076923077,207.95629328760702,203.5451220970084,201.202522,199.62143200000017,205.826104,206.617835,203.84,115430507,91350551.85,43.776160727694375,0.9752604244854197,1.5,2.75,NaN,NaN,2.1052935166917996,1.263599449180558,728.3448950031751,-0.423057797743454,-0.23025286198466688,0.1928049357587871,13.86638102428906,-0.7388683647676503,18.257018751122747,51.21864575730087,30.524335491576394,7497954118
1463751000,204.92,206.1,204.86,205.49,NaN,NaN,203.0989705882353,210.90147368421052,201.179622,199.6242320000002,205.94510399999996,206.44383499999998,204.7903302725778,206.00890197879193,205.69923076923078,207.89549540142934,203.50296613703222,201.179622,199.6242320000002,205.94510399999996,206.44383499999998,205.48333333333335,104990408,91637486.05,48.45745299100254,0.19125293149513176,1.5,2.75,NaN,NaN,2.0906296940709574,1.1457146253740993,733.1848330193071,-0.34247085788150605,-0.23528363659309548,0.10718722128841057,14.225118396163206,-0.19389069460660352,42.102621435222595,25.311439879553113,32.585938685224306,7602944526
1464010200,205.51,205.84,204.985,205.21,NaN,NaN,203.41794117647058,210.90063157894735,201.16392199999999,199.60233200000016,205.99410399999994,206.27383500000002,204.80678790894729,205.93281607604985,205.71461538461537,207.8940902936349,203.53514047559585,201.16392199999999,199.60233200000016,205.99410399999994,206.27383500000002,205.34500000000003,58682576,91263290.15,47.53235530032887,0.17342457875179595,1.5,2.75,NaN,NaN,2.0023704302087455,0.6430030727968445,733.1848330193071,-0.2928537882332742,-0.25888001400318217,0.03397377423009203,14.227896697363764,-1.5543295754377457,25.790997463463466,41.496043467532765,32.71295906900377,7544261950
1464096600,206.17,208.24,206.14,207.87,NaN,NaN,203.7369117647059,210.8997894736842,201.163522,199.62173200000015,206.10150399999995,206.221375,204.92691387330228,206.1173097830927,205.93769230769232,208.34806527909504,203.5273193362896,201.163522,199.62173200000015,206.10150399999995,206.221375,207.41666666666663,93537808,92146971.85,56.10558678271676,0.8854075387627964,1.5,2.75,NaN,NaN,2.075772542336692,1.0150936717949242,737.2828586943108,-0.07695763738266873,-0.06222327249824389,0.014734364884424842,14.398621285296025,0.6634382566585978,54.612567114548554,15.910911080667242,29.476521804784216,7637799758
1464183000,208.67,209.77,207.8691,209.28,NaN,NaN,204.05588235294118,210.89894736842103,201.157072,199.67583200000016,206.24370399999995,206.21787499999996,205.0976231331728,206.4185183751791,206.2115384615385,209.20028177916717,203.22279514390985,201.157072,199.67583200000016,206.24370399999995,206.21787499999996,208.97303333333332,79221525,92241576.25,59.85060666696453,1.4021007570492596,1.5,2.75,NaN,NaN,2.0632816464555,0.8588483438887462,740.404629753414,0.1522447094758667,0.20504025172925822,0.05279554225339152,13.620347550534463,1.3168086754453907,49.805664077940435,19.239888373117488,30.95444754894206,7717021283
1464269400,209.44,209.71,208.97,209.34,NaN,NaN,204.37485294117647,210.89810526315787,201.160422,199.75904000000017,206.36370399999996,206.31249999999994,205.26399085344053,206.69675472040015,206.47698461538465,209.88729813296607,203.06667109780324,201.160422,199.75904000000017,206.36370399999996,206.31249999999994,209.34,55280699,90144802.75,60.00697397768709,1.19811014998002,1.5,2.75,NaN,NaN,1.9687615288515363,0.6132433297714438,742.0270304154103,0.29127111380439646,0.4168844345088871,0.12561332070449066,13.620455965447377,2.2367649931627334,82.94474392776377,2.540268548598501,14.514987523637725,7772301982
1464355800,209.53,210.25,209.47,210.24,NaN,NaN,204.69382352941176,210.8972631578947,201.167022,199.8478400000002,206.47590399999999,206.50795999999997,205.4591284670311,207.0342066517906,206.61467692307696,210.45051201550166,202.77884183065225,201.167022,199.8478400000002,206.47590399999999,206.50795999999997,209.98666666666668,64211214,86234156.6,62.374143276069155,1.246642589446436,1.5,2.75,NaN,NaN,1.8931357053621407,0.7446146229254129,745.3743130558918,0.41943196232867686,0.6499032736153367,0.23047131128665987,12.0555713914474,1.6732759454492736,80.81587002517634,3.172541722767271,16.0115882520564,7836513196
1464701400,210.56,210.69,209.18,209.84,NaN,NaN,205.01279411764705,210.89642105263155,201.17292199999997,199.95804000000018,206.585104,206.60145999999995,205.63092735067693,207.3014250659058,206.87160000000006,211.0723594683261,202.670840531674,201.17292199999997,199.95804000000018,206.585104,206.60145999999995,209.9033333333333,109879380,88618724.85,60.65576296124444,1.0408598124861235,1.5,2.75,NaN,NaN,1.8657688692648442,1.2399115444956665,746.2844135054482,0.4501451542727667,0.7931527541276182,0.3430075998548515,11.360868196068093,2.4355286872201676,66.79458614742954,8.885777446500953,24.31963640606952,7726633816
1464787800,209.12,210.48,208.89,210.27,NaN,NaN,205.33176470588236,210.8955789473684,201.17717199999996,200.1202400000002,206.697104,206.80699999999996,205.81285176829743,207.58414648820047,207.15698461538466,211.72254082673496,202.59142840403436,201.17717199999996,200.1202400000002,206.697104,206.80699999999996,209.88,69936215,86794428.5,61.87181992519083,1.016800544518267,1.5,2.75,NaN,NaN,1.8460710928887842,0.8057684831694006,749.1916326366668,0.47011269578142006,0.9306484695816266,0.46053577380020655,9.028909987479572,2.6157825386755227,64.47253348533759,10.07969403855592,25.447772476106504,7796570031
1464874200,209.8,210.93,209.2399,210.91,NaN,NaN,205.65073529411765,210.89473684210526,201.17877199999998,200.3101100000002,206.824104,207.10199999999995,206.01273993424655,207.9008944417052,207.63006153846158,212.37507195721057,202.88505111971259,201.17877199999998,200.3101100000002,206.824104,207.10199999999995,210.35996666666665,63044749,85334475.45,63.67158351226922,0.9834789613921474,1.5,2.75,NaN,NaN,1.8349303005395856,0.73879576416849,751.9801559141321,0.4946285677283496,1.0788214834606435,0.5841929157322939,8.90751885535856,3.285994123408427,62.68024736508756,11.049191997500584,26.270560637411847,7859614780
1464960600,210.25,210.69,208.86,210.28,NaN,NaN,205.96970588235294,210.8938947368421,201.18027199999997,200.49181000000019,206.96552000000003,207.36749999999992,206.18008346623688,208.12747592344755,207.89929230769232,212.81493184285932,202.98365277252532,201.18027199999997,200.49181000000019,206.96552000000003,207.36749999999992,209.94333333333333,101757126,87041370.65,60.637311034606824,0.7512590453691999,1.5,2.75,NaN,NaN,1.850292421929614,1.169066218053633,753.4915164026708,0.4385342909527774,1.1323607794232657,0.6938264884704883,8.786043535110096,2.331013674631365,32.20553217308679,34.51336947885669,33.28109834805651,7757857654
1465219800,210.7,211.77,210.51,211.35,NaN,NaN,206.28867647058823,210.89305263157894,201.19542199999995,200.66870200000017,207.13012000000003,207.64899999999994,206.38282529109034,208.4343829783573,208.39923076923077,213.2949523647508,203.50350917371074,201.19542199999995,200.66870200000017,207.13012000000003,207.64899999999994,211.21,64887045,85819972.7,63.79323520336294,1.1104645942143578,1.5,2.75,NaN,NaN,1.8245572489346422,0.7560832631213363,756.9440517029972,0.44234620945061653,1.246759250283759,0.8044130408331425,8.64203911844685,2.992056917304218,32.651541638611484,34.079807923322434,33.268650438066096,7822744699
1465306200,211.525,212.34,211.5,211.68,NaN,NaN,206.60764705882352,210.89221052631578,201.23397199999997,200.89720200000014,207.29892000000004,207.93853999999996,206.59055763261622,208.74348936137088,208.92000000000002,213.65804243900456,204.18195756099547,201.23397199999997,200.89720200000014,207.29892000000004,207.93853999999996,211.84,60974761,85149964.65,64.73238051073932,1.1551567776981224,1.5,2.75,NaN,NaN,1.7649460168678828,0.7160867447289069,759.6599746812427,0.43527307578953933,1.3485043855700667,0.9132313097805274,8.28139061643891,1.832876316928851,65.98116730988485,9.305908050022456,24.712924640092673,7883719460
1465392600,211.84,212.52,211.6899,212.37,NaN,NaN,206.92661764705883,212.52,201.307672,201.10160200000013,207.44390400000003,208.13453999999996,206.81720243133717,209.0888713269546,209.54846153846154,213.75281712726536,205.34410594965772,201.307672,201.10160200000013,207.44390400000003,208.13453999999996,212.1933,66170920,84584900.3,66.67857598908344,1.1340739907625372,1.5,2.75,NaN,NaN,1.6988784442344629,0.7823018028668174,762.7031423672596,0.44373047125603815,1.467894398850575,1.024163927594537,5.507590302810594,1.476490825688075,65.63633290655577,9.482559437938205,24.881107655506028,7949890380
1465479000,211.51,212.22,211.19,212.08,NaN,NaN,207.24558823529412,212.56705882352944,201.42032199999997,201.34430200000014,207.56510400000002,208.41353999999995,207.0235866497161,209.3737407243875,210.05538461538464,213.736769098968,206.37400013180127,201.42032199999997,201.34430200000014,207.56510400000002,208.41353999999995,211.83,73786869,84187894.3,65.05371575161266,0.830967002174325,1.5,2.75,NaN,NaN,1.661815698217716,0.8764546211010292,760.0890778436999,0.3979260888150571,1.5215715386133581,1.123645449798301,4.962827163468821,1.308875513518682,37.974586237486136,28.954832769489634,33.07058099302423,7876103511
1465565400,210.46,210.86,209.43,210.07,NaN,NaN,207.5645588235294,212.61411764705883,201.534322,201.56440200000011,207.65610400000003,208.58903999999993,207.1430538399233,209.4400511315887,210.4292307692308,212.8312486585753,208.0272128798863,201.534322,201.56440200000011,207.65610400000003,208.58903999999993,210.12,113829158,85400036.8,55.042036419699386,0.14272173403415564,1.5,2.75,NaN,NaN,1.7324002912021652,1.3328935474182373,755.7814618492598,0.20983928080774095,1.3859445508079773,1.1761052700002363,7.981469079673748,-0.08085996955860726,35.720980369681236,31.059483262195947,33.21953636812282,7762274353
1465824600,209.36,210.37,208.35,208.4492,NaN,NaN,207.8835294117647,212.66117647058826,201.60426800000002,201.7923940000001,207.686688,208.77349999999993,207.19427525796553,209.34568435715167,210.47378461538466,212.6992696229717,208.2482996077976,201.60426800000002,201.7923940000001,207.686688,208.77349999999993,209.05640000000002,117751153,86463862.95,48.55314847339812,0.4907428537958341,1.5,2.75,NaN,NaN,1.7529431275448686,1.3618539466377149,751.6092949369485,-0.03320800521070266,1.1345952634868581,1.1678032686975608,8.755266291800197,-0.6627906976744248,10.739760336005473,63.21925476480263,26.040984899191912,7644523200
1465911000,208,208.74,206.9199,208.04,NaN,NaN,208.2025,212.70823529411766,201.64811800000004,202.00589400000013,207.722488,208.83649999999994,207.22744093412373,209.22133346599438,210.37840000000003,212.8884692825255,207.86833071747455,201.64811800000004,202.00589400000013,207.722488,208.83649999999994,207.89996666666664,125059286,88842485.9,47.04521521063272,0.9427376579663695,1.5,2.75,NaN,NaN,1.7577400470059492,1.40765180907663,748.4245096784331,-0.22056534449280285,0.8920965880815572,1.11266193257436,8.757984726990472,-1.0605412089218709,1.9857145343538727,85.02828145237937,12.986004013266758,7519463914
1465997400,208.54,209.36,207.53,207.75,NaN,NaN,208.5214705882353,212.75529411764708,201.69046800000004,202.1781940000001,207.793704,208.9814599999999,207.24793344651104,209.081206469233,210.2560923076923,213.09061563644744,207.4215689789372,201.69046800000004,202.1781940000001,207.793704,208.9814599999999,208.21333333333334,109124496,88552463.7,45.95590125482443,0.568199154751571,1.5,2.75,NaN,NaN,1.7629014722198109,1.232314623901311,751.1521460178302,-0.35508594417265593,0.6688045023585403,1.0238904465311962,8.560717540238347,-1.498269404011188,0,100.00000000000001,0,7410339418
1466083800,206.73,208.57,205.59,208.37,NaN,NaN,208.8404411764706,212.80235294117648,201.74396800000005,202.3854940000001,207.832704,209.15445999999991,207.2919360564518,209.01347251978223,210.11224615384617,213.11994351240176,207.10454879529058,201.74396800000005,202.3854940000001,207.832704,209.15445999999991,207.51,149533065,89854448,48.691218383342516,0.8338602666944379,1.5,2.75,NaN,NaN,1.8498370813469667,1.6641698694760219,749.6843090192008,-0.3905543202002708,0.5356975462808578,0.9262518664811286,8.550069111433423,-0.9083127258892888,6.993233163016848,70.77321305581388,22.233553781169263,7559872483
1466170200,207.17,207.2,205.75,206.52,NaN,NaN,209.15941176470588,212.8494117647059,201.81771800000007,202.5486940000001,207.884104,209.27045999999996,207.261664054238,208.77599894646963,209.85686153846154,213.42520649378588,206.2885165831372,201.81771800000007,202.5486940000001,207.884104,209.27045999999996,206.49,117055748,89935710.05,41.87991910957507,1.146557083801431,1.5,2.75,NaN,NaN,1.9048487183936123,1.3015491614501353,752.6405110479503,-0.518818847855895,0.2777283066612597,0.7965471545171547,9.609502317159519,-2.2853087295954504,6.9624125816408595,70.84226220138457,22.19532521697459,7442816735
1466429400,208.82,209.61,207.75,207.85,NaN,NaN,209.47838235294117,212.8964705882353,201.87991800000003,202.74589400000008,207.95112,209.38845999999998,207.28473605211101,208.68780857061537,209.6707076923077,213.38300932665095,205.95840605796445,201.87991800000003,202.74589400000008,207.95112,209.38845999999998,208.40333333333336,82789603,88825669.8,47.55943452708836,0.15571311048660308,1.5,2.75,NaN,NaN,1.9895023813654973,0.9320459185549537,757.5438626713664,-0.4943997030642988,0.17854752568678123,0.67294722875108,9.984237041165501,-1.8093348450491367,20.342270633566784,48.32795278945327,31.329776576979953,7525606338
1466515800,208.3,208.92,207.78,208.44,NaN,NaN,209.79735294117648,212.94352941176473,201.94436800000003,202.93919400000007,208.03951800000002,209.54995999999997,207.33004052065567,208.6642077543663,209.4807076923077,213.17262577328484,205.78878961133057,201.94436800000003,202.93919400000007,208.03951800000002,209.54995999999997,208.38,72461663,89514624.15,49.89838925210632,0.1414130706707808,1.5,2.75,NaN,NaN,1.9288236398393894,0.8094952493860188,759.2320569729798,-0.4216597165727386,0.14587258303515682,0.5675322996078954,10.15989364738255,-1.8505438621274224,43.01441742566956,24.528885810340654,32.45669676398978,7598068001
1466602200,208.65,209.5,207.93,208.1,NaN,NaN,210.11632352941177,212.99058823529413,202.02191800000003,203.08298600000006,208.08311800000004,209.56145999999998,207.36023501004172,208.61047368252187,209.31301538461537,213.04232789857554,205.5837028706552,202.02191800000003,203.08298600000006,208.08311800000004,209.56145999999998,208.51,95560471,89615757.3,48.55440351091985,0.12551440054203905,1.5,2.75,NaN,NaN,1.9031933798508611,1.0663355851594194,757.3717157233115,-0.3808356924863273,0.0914876839999863,0.4723233764863136,9.693111237412419,-1.8766503206337315,45.16356264981494,22.783722393638673,32.05271495654638,7502507530
1466688600,209.81,210.87,209.27,210.81,NaN,NaN,210.43529411764706,213.03764705882355,202.08881800000003,203.25458600000005,208.13930200000001,209.63796000000002,207.4955199116087,208.81995237942456,209.27147692307693,212.92026952772852,205.62268431842534,202.08881800000003,203.25458600000005,208.13930200000001,209.63796000000002,210.3166666666667,102731356,90791248.85,58.21499377999585,0.6675442932406026,1.5,2.75,NaN,NaN,1.9651081384329434,1.1315116522929072,762.2804057823025,-0.16664416189939724,0.26401817411206707,0.4306623360114643,12.966073902560366,0.35226353120388876,39.48845091111474,27.552534880125805,32.959014208759456,7605238886
1466775000,203.63,206.905,202.72,203.13,NaN,NaN,210.75426470588235,213.08470588235295,202.13051800000002,203.38428600000006,208.04170200000002,209.32746000000003,207.32432305232993,208.2780521528127,208.61378461538465,213.24022935228655,203.98733987848274,202.13051800000002,203.38428600000006,208.04170200000002,209.32746000000003,204.25166666666667,333444400,104699433.9,37.00649209640618,2.1316710895770785,1.5,2.75,NaN,NaN,2.4026004142591617,3.1847774871302335,754.9005996560186,-0.5177032222047263,-0.21646669174444355,0.30123653046028276,24.450616284940637,-2.551796792695772,18.4535729037847,50.91747999379852,30.62894710241677,7271794486
1467034200,201.59,201.6,198.65,199.6,NaN,NaN,198.65,213.13176470588238,202.149268,203.46728600000006,207.878102,208.79546000000005,207.0214084228268,207.45157099540197,207.63147692307695,213.81229241029445,201.45066143585944,202.149268,203.46728600000006,207.878102,208.79546000000005,199.95000000000002,248988660,113938306.2,31.35260719936609,3.7095530228050038,1.5,2.75,NaN,NaN,2.5509860989549353,2.185293676061335,748.1768133472799,-0.9386240509114796,-0.8720435331790668,0.06658051773241286,25.702490550557492,-4.056912132282252,4.928488835720932,75.81117550019513,19.26033566408393,7022805826
1467120600,201.48,203.23,201.12,203.1997,NaN,NaN,198.49115384615385,213.17882352941177,202.1815665,203.58328300000008,207.75731199999998,208.46344500000004,206.87153750428456,207.04663090060177,206.94837692307695,212.97251341358378,200.92424043257012,202.1815665,203.58328300000008,207.75731199999998,208.46344500000004,202.51656666666668,159382399,116413457.15,41.215574775167894,1.8954295557156269,1.5,2.75,NaN,NaN,2.628058520458154,1.369106312121923,754.7222802714116,-0.9241274054284825,-1.0885787390531902,-0.16445133362470776,28.710208301681753,-2.190276774969912,9.280443099518898,66.0500112084087,24.66954569207239,7182188225
1467207000,204.84,206.93,204.72,206.66,NaN,NaN,198.3323076923077,213.2258823529412,202.23481650000002,203.77038300000007,207.692512,208.282945,206.86324191588125,207.00980891006827,206.68606923076925,212.43430984100226,200.93782862053624,202.23481650000002,203.77038300000007,207.692512,208.282945,206.10333333333332,137328614,119783077.1,48.82685626475262,0.22424480744201547,1.5,2.75,NaN,NaN,2.706790054711143,1.1464775937034264,760.950399865977,-0.6442693697198054,-0.9697880457744645,-0.3255186760546591,30.77100440200475,-0.8206555646206306,21.149615497457535,47.326279360229435,31.52410514231302,7319516839
1467293400,207.21,209.54,206.56,209.475,NaN,NaN,198.17346153846154,213.2729411764706,202.2898915,204.01093300000008,207.68001199999998,208.21119500000003,206.96566380153297,207.2445890138713,206.76497692307692,212.6347414074904,200.89521243866344,202.2898915,204.01093300000008,207.68001199999998,208.21119500000003,208.52500000000003,165021948,124881937.05,54.040271232911365,1.0415350675153165,1.5,2.75,NaN,NaN,2.726305050803204,1.3214236734166673,765.950399865977,-0.25247169444307715,-0.6411082941085056,-0.3886365996654284,31.787018647530754,1.4308541545612938,25.244249903118376,42.22433299254936,32.53141710433227,7484538787
1467379800,209.36,210.49,209.29,209.9208,NaN,NaN,198.01461538461538,213.32000000000002,202.3385955,204.25584100000006,207.699028,208.19323500000004,207.0815514955905,207.49946625064547,206.90965384615384,212.9870360298645,200.8322716624432,202.3385955,204.25584100000006,207.699028,208.19323500000004,209.90026666666665,106055333,125096847.4,54.82518674289101,1.2512854287826556,1.5,2.75,NaN,NaN,2.6172832614601194,0.8477858171827918,768.8868005504191,0.03832752167533898,-0.3407271975712547,-0.3790547192465937,31.214081814723055,0.9962954053403992,61.01211314976757,12.012576075652618,26.97531077457982,7590594120
1467725400,208.95,209.08,207.71,208.41,NaN,NaN,197.85576923076923,213.36705882352945,202.38199550000002,204.48724100000007,207.687828,208.04623500000002,207.13364751537128,207.58618375058398,206.96042307692306,213.07594470140015,200.84490145244598,202.38199550000002,204.48724100000007,207.687828,208.04623500000002,208.4,109803713,127342680.8,51.60843364888417,0.4625943568860821,1.5,2.75,NaN,NaN,2.588248742784397,0.8622695258980287,763.6418216256218,0.12562568762636828,-0.2220226097136333,-0.3476482973400016,31.42917951635914,-0.014392630972942399,81.60890944622228,2.9337116211114314,15.457378932666273,7480790407
1467811800,207.83,209.8,207.06,209.66,NaN,NaN,197.69692307692307,213.41411764705884,202.45304550000003,204.75524100000007,207.70882799999998,207.945235,207.2327201618273,207.78369006005218,207.05965384615382,213.30395010316656,200.8153575891411,202.45304550000003,204.75524100000007,207.70882799999998,207.945235,208.83999999999997,96021491,129095017.3,54.012598263806254,0.7800067253586211,1.5,2.75,NaN,NaN,2.599088118299798,0.7438047804498803,766.5457826602642,0.2566985036046735,-0.026775167834159674,-0.2834736714388332,31.574257992189015,0.7496395963479108,79.6025946779282,3.5660892917274296,16.831316030344368,7576811898
1467898200,209.87,210.6495,208.63,209.526,NaN,NaN,197.53807692307694,213.46117647058827,202.51837550000005,204.98420100000007,207.72096399999998,207.803035,207.32265270450074,207.94962434004722,207.29088461538458,213.65951140994056,200.9222578208286,202.51837550000005,204.98420100000007,207.72096399999998,207.803035,209.6018333333333,85593827,130066162.65,53.70457376194348,0.7612437724258666,1.5,2.75,NaN,NaN,2.557688966992669,0.6580791287763882,768.7415578243983,0.31942865402493714,0.11581214609233825,-0.2036165079325989,31.553939630092575,-0.6090792656894796,56.07747991320913,14.974164453353769,28.9483556334371,7491218071
1467984600,211.05,212.94,210.7785,212.65,NaN,NaN,197.3792307692308,213.50823529411767,202.61207550000003,205.2129010000001,207.78696399999998,207.83153499999997,207.5315682847164,208.39727916480464,207.66011538461538,214.64258295719657,200.6776478120342,202.61207550000003,205.2129010000001,207.78696399999998,207.83153499999997,212.12283333333335,133970972,133075367.8,59.502927822129465,1.8291345504290928,1.5,2.75,NaN,NaN,2.618854040778906,1.0067300524116982,774.5476016519574,0.5432244337508149,0.47541403425591966,-0.06781039949489517,31.83458985939602,4.686653866981741,53.325287495360705,16.786314549609045,29.888397955030236,7625189043
1468243800,213.19,214.07,212.95,213.4,NaN,NaN,197.22038461538463,213.5552941176471,202.71107550000005,205.4181010000001,207.90601399999997,207.998035,207.76170286178635,208.87372876815658,208.04165384615382,215.6654808312834,200.41782686102425,202.71107550000005,205.4181010000001,207.90601399999997,207.998035,213.47333333333333,73633937,131065606.75,60.77316504068962,2.043756454074516,1.5,2.75,NaN,NaN,2.533221609294697,0.5618097594470565,778.1824007806415,0.7035000327167776,0.8115646414010769,0.10806460868429926,20.718093527281145,6.9138276553106275,51.84770319673336,17.930043756704453,30.222253046562173,7698822980
1468330200,214.53,215.3,213.4308,214.95,NaN,NaN,197.06153846153848,213.6023529411765,202.82132550000003,205.6467010000001,208.078398,208.32307499999996,208.0435968672065,209.4524212664274,208.5685769230769,217.0359135745982,200.1012402715556,202.82132550000003,205.6467010000001,208.078398,208.32307499999996,214.56026666666673,101275629,130241830.55,63.332888368777716,2.273533559348,1.5,2.75,NaN,NaN,2.4879914943450765,0.7775967872404878,781.9895326241115,0.8650112134083335,1.1893286254447162,0.32431741203638265,14.987100773351562,5.782636490112919,81.3917476410754,3.0333749545026887,15.574877404421917,7800098609
1468416600,215.44,215.45,214.35,214.92,NaN,NaN,196.90269230769232,213.64941176470592,202.9316755,205.87590100000008,208.217398,208.66707499999998,208.3132597351592,209.97314305057716,208.88473076923077,217.9490907795251,199.82037075893643,202.9316755,205.87590100000008,208.217398,208.66707499999998,214.90666666666667,87324129,128355072.7,63.24686370327076,1.9218561056723884,1.5,2.75,NaN,NaN,2.3888492447489993,0.6803325117044634,780.2689146200822,0.9160267054508238,1.4693507938499124,0.5533240883990886,13.913849594328802,3.996903125907283,56.27486353621171,14.962431904114919,28.76270455967338,7712774480
1468503000,216.4,216.67,215.66,216.12,NaN,NaN,196.74384615384616,213.69647058823531,203.07222550000003,206.0893010000001,208.416614,209.08557499999998,208.61940641221176,210.55855799814125,209.8839615384615,219.05382370856876,200.71409936835425,203.07222550000003,206.0893010000001,208.416614,209.08557499999998,216.15,91230870,127460391.4,65.2784597302713,2.12122883840798,1.5,2.75,NaN,NaN,2.3432171558383565,0.7157585897700295,782.7469874742217,0.9715192404541698,1.7677231389668009,0.7962038985126311,11.937112860110648,3.172216254923027,80.48735101120492,3.3168959826597146,16.195753006135376,7804005350
1468589400,216.78,217.0125,215.308,215.83,NaN,NaN,196.585,213.74352941176474,203.2107755,206.3244010000001,208.633014,209.45857499999997,208.90217478820347,211.06060009355636,211.13242307692306,218.6283437604203,203.63650239342581,203.2107755,206.3244010000001,208.633014,209.45857499999997,216.05016666666668,107155401,125341508.2,64.35267294920166,1.7881318411632567,1.5,2.75,NaN,NaN,2.2975945018499027,0.8549075445064733,784.3299426619755,0.9296062809132755,1.9582117496542253,1.0286054687409498,10.810228469221721,2.8149664063780238,46.86550873001119,21.598358209395542,31.53613306059327,7696849949
1468848600,215.97,216.6,215.67,216.4092,NaN,NaN,196.42615384615385,213.79058823529414,203.33467150000004,206.55649300000007,208.86179800000002,209.95303499999994,209.19656793376413,211.56999056083671,212.14853846153844,218.5722347497625,205.72484217331439,203.33467150000004,206.55649300000007,208.86179800000002,209.95303499999994,216.2264,58725918,122425016.7,65.407870120685,1.6937561296761747,1.5,2.75,NaN,NaN,2.199909180289196,0.47968887064893495,787.4422965923554,0.8821901436831461,2.1313431483448824,1.2491530046617363,10.798746507953677,3.838203541096877,43.90567266949882,23.847595735938178,32.246731594563,7755575867
1468935000,215.92,216.23,215.63,216.19,NaN,NaN,196.2673076923077,213.83764705882356,203.45497150000006,206.76299300000005,209.07119800000004,210.37003499999992,209.47082017165573,212.00999145980464,212.88161538461537,218.7867819453332,206.97644882389756,203.45497150000006,206.76299300000005,209.07119800000004,210.37003499999992,216.01666666666665,54345728,121002822.95,64.62817428402639,1.2664706778791626,1.5,2.75,NaN,NaN,2.0984299531256823,0.449127769708781,785.2514063623348,0.7808476409785265,2.2252125558848945,1.444364914906368,9.09608251212747,3.114566440904322,19.765250804161678,49.16801578880529,31.066733407033034,7701230139
1469021400,216.75,217.37,216.24,217.085,NaN,NaN,196.10846153846154,213.88470588235296,203.56539650000005,206.98295100000007,209.29511400000004,210.80228499999993,209.7694154590418,212.49332560648992,213.46699999999998,219.41392839345525,207.52007160654472,203.56539650000005,206.98295100000007,209.29511400000004,210.80228499999993,216.89833333333334,58159457,120287712.65,66.3898764396771,1.5333631269081285,1.5,2.75,NaN,NaN,2.0328278136167053,0.4835028925126044,788.4901347705419,0.7203436098767537,2.3447944272523102,1.6244508173755565,8.985405085962915,3.6076668289376963,43.855564528618316,23.88848952669396,32.25594594468771,7759389596
1469107800,216.96,217.22,215.75,216.265,NaN,NaN,195.94961538461538,213.9317647058824,203.65437150000005,207.21000100000003,209.451414,211.21053499999994,210.02414426456957,212.8525326915861,213.95501538461536,219.69546735386774,208.214563415363,203.65437150000005,207.21000100000003,209.451414,211.21053499999994,216.41166666666666,67777310,118898554.6,63.280178504552936,1.0358989200505353,1.5,2.75,NaN,NaN,1.9926258269297976,0.5700431786409622,786.3990706826652,0.5775189606467879,2.3463495181840415,1.7688305575372536,9.666706060599909,1.699976487185507,15.792271299979488,54.87179228000203,29.335936420018484,7691612286
1469194200,216.41,217.3,216.1,217.24,NaN,NaN,195.79076923076923,213.97882352941178,203.75162150000003,207.40130100000005,209.666214,211.5320349999999,210.30711899929233,213.27038672095887,214.63424615384616,219.63094919768932,209.637543110003,203.75162150000003,207.40130100000005,209.666214,211.5320349999999,216.88,62787477,116901360.65,65.35793913059024,1.169205144195117,1.5,2.75,NaN,NaN,1.9360096964348135,0.5370979144373201,789.1199825416819,0.5038208709299421,2.3986066461996813,1.8947857752697392,6.388751664227689,1.799437675726337,48.520916584554605,20.24509307315617,31.23399034228922,7754399763
1469453400,217,217.06,215.97,216.65,NaN,NaN,195.63192307692307,214.0258823529412,203.83782150000002,207.57780100000008,209.86801400000002,212.20803499999988,210.55585943069264,213.5922546522961,215.1719384615385,219.34896551584973,210.99491140722728,203.83782150000002,207.57780100000008,209.86801400000002,212.20803499999988,216.55999999999997,55873147,103022798,63.03360181795841,0.7656506523745292,1.5,2.75,NaN,NaN,1.8884375752608988,0.5423376969435445,786.4018306852612,0.3762903916032083,2.3651487647737497,1.9888583731705414,6.877368113537337,0.7908816003721876,23.250860798418287,44.673934861209304,32.075204340372416,7698526616
1469539800,216.53,217.17,215.76,216.75,NaN,NaN,195.47307692307695,214.0729411764706,203.91552150000004,207.74755100000004,210.107814,213.06553499999987,210.7987669039988,213.89299230445837,215.7276307692308,218.40539617903957,213.04986535942206,203.91552150000004,207.74755100000004,210.107814,213.06553499999987,216.55999999999997,70080493,94077389.65,63.27201517147037,0.6434465533179368,1.5,2.75,NaN,NaN,1.854263462742263,0.7449238681124482,788.9446675690341,0.26488071795214596,2.319959270610724,2.055078552658578,5.836027739311608,0.8514796203238473,50.50830840397629,18.813139447467186,30.678552148556523,7768607109
1469626200,217.19,217.27,215.62,216.52,NaN,NaN,195.3142307692308,214.12000000000003,203.99147150000002,207.90845100000007,210.302614,213.73154999999988,211.02312898619493,214.14318351355757,216.02532307692312,218.04886591695492,214.0017802368913,203.99147150000002,207.90845100000007,210.302614,213.73154999999988,216.47,84083893,90312464.35,62.27714896015326,0.5575562091655349,1.5,2.75,NaN,NaN,1.8396732154035305,0.9310330927759697,787.4505714435043,0.14775198637931375,2.23976853563272,2.0920165492534064,5.915559655768262,0.1850823616509373,21.542902537780034,46.842102942361116,31.614994519858836,7684523216
1469712600,216.29,217.11,215.75,216.77,NaN,NaN,195.15538461538463,214.16705882352946,204.0677215,208.07025100000007,210.540998,214.2370499999999,211.2484964769324,214.39335651226637,216.28455384615387,217.6541661497641,214.91494154254363,204.0677215,208.07025100000007,210.540998,214.2370499999999,216.54333333333332,65035718,86697819.55,62.95891223407479,0.5453146462536579,1.5,2.75,NaN,NaN,1.8054108428747078,0.7501424872916542,788.3770740498935,0.06347446372116838,2.1713596289048667,2.1078851651836983,5.083596578228083,0.43552796182180314,47.39563908399652,21.11816922606673,31.486191689936767,7749558934
1469799000,216.46,217.54,216.13,217.12,NaN,NaN,194.99653846153848,214.21411764705886,204.15207150000003,208.25745100000003,210.785198,214.6192999999999,211.4787515170527,214.65303684443148,216.45147692307697,217.64777715333085,215.25517669282308,204.15207150000003,208.25745100000003,210.785198,214.6192999999999,216.93,79519436,82422693.95,63.941451803978715,0.6444570159946387,1.5,2.75,NaN,NaN,1.7771672112407997,0.964775988130633,791.6490585169931,0.010442504616177128,2.12093829595392,2.1104957913377427,5.016761330831996,0.3284518403099342,50.214192279282365,19.024974590560912,30.76083313015672,7829078370
1470058200,217.19,217.65,216.405,216.94,NaN,NaN,194.83769230769232,214.26117647058828,204.24032150000002,208.433051,211.03999800000003,214.97025999999988,211.6929181242271,214.87084285924755,216.60686153846157,217.4353063448077,215.77841673211543,204.24032150000002,208.433051,211.03999800000003,214.97025999999988,216.99833333333333,73311422,80785498.4,63.01567970662684,0.48393206552979456,1.5,2.75,NaN,NaN,1.739155267580743,0.9074824498452311,789.216462008487,-0.0540724800570862,2.042905191266385,2.0969776713234713,4.886154547072279,0.3469170636939729,42.53601885416506,24.971098557590338,32.49288258824462,7755766948
1470144600,216.65,216.83,214.57,215.5492,NaN,NaN,194.67884615384617,214.30823529411768,204.30631750000003,208.59314300000003,211.241182,215.3272199999999,211.84414486445348,214.93544830122397,216.5629538461539,217.53756917101413,215.58833852129368,204.30631750000003,208.59314300000003,211.241182,215.3272199999999,215.64973333333336,92295506,79910088.05,56.24012673134033,0.24370427189790667,1.5,2.75,NaN,NaN,1.7842156056106901,1.1549919196966771,784.4088975464815,-0.19955000582148097,1.8475401640466202,2.047090169868101,6.20448233269749,-0.7074648179284587,16.563666707531503,53.70166414317015,29.73466914929835,7663471442
1470231000,215.48,216.245,215.13,216.18,NaN,NaN,194.52,214.3552941176471,204.37086750000006,208.72734300000005,211.46058200000004,215.65321999999992,212.0141783991808,215.05397703444075,216.58987692307696,217.4991628784398,215.68059096771412,204.37086750000006,208.72734300000005,211.46058200000004,215.65321999999992,215.8516666666667,53993626,77808694.8,58.423632524653996,0.03747078971189594,1.5,2.75,NaN,NaN,1.736414490924213,0.6939279233353751,787.6748838701924,-0.2586785075440634,1.723742035438022,1.9824205429820854,5.92176300404937,-0.03930363211799392,38.11166478808464,28.836710364175637,33.05162484773973,7717465068
1470317400,216.31,216.78,214.25,216.4097,NaN,NaN,214.25,214.4023529411765,204.43606600000004,208.86644000000004,211.63137600000002,215.99740499999993,212.18655179529134,215.18309350735115,216.58991538461544,217.49917080897035,215.68065996026053,204.43606600000004,208.86644000000004,211.63137600000002,215.99740499999993,215.8132333333333,46585528,75858279.85,59.22155905376118,0.24386157581543022,1.5,2.75,NaN,NaN,1.7930991701439123,0.6141126333488829,789.717997162843,-0.28559318440361636,1.625429062477565,1.9110222468811813,5.556255890833175,-0.38220401399375,34.75952014588807,31.993169541304272,33.24731031280765,7764050596
1470403800,217.21,218.23,217.07,218.18,NaN,NaN,214.82777777777778,214.44941176470593,204.51151600000006,209.02654000000007,211.80937600000001,216.27390499999996,212.4215889797897,215.46851317331772,216.74299230769233,217.9520270567636,215.53395755862107,204.51151600000006,209.02654000000007,211.80937600000001,216.27390499999996,217.82666666666668,71892161,72754339.3,64.8246241296613,0.812002050245292,1.5,2.75,NaN,NaN,1.7950420865622045,0.9881494587361335,793.1999232855242,-0.19193753057482477,1.6711003336626504,1.8630378642374752,6.859230667399935,0.7062081698592204,33.371295366775314,33.36231761694008,33.26638701628459,7835942757
1470663000,218.4,218.52,217.74,218.05,NaN,NaN,215.40555555555557,214.49647058823533,204.59251600000007,209.17364000000006,211.983576,216.506405,212.64231098058227,215.71436906157317,216.8172230769231,218.2062352863256,215.42821086752062,204.59251600000007,209.17364000000006,211.983576,216.506405,218.10333333333332,39906479,71067966.4,64.12780099171351,0.7076067061975906,1.5,2.75,NaN,NaN,1.72253908037919,0.5615255511236916,794.9172687261153,-0.14845555553395573,1.6774684198200305,1.8259239753539862,6.606450411499159,0.5997693194925081,43.38247641852041,24.223601933183684,32.393921648295915,7796036278
1470749400,218.13,218.76,217.8,218.18,NaN,NaN,215.98333333333332,214.54352941176475,204.65711600000006,209.30914000000004,212.142376,216.66790500000002,212.85947525585354,215.94919105570906,216.9645307692308,218.48773789872595,215.44132363973566,204.65711600000006,209.30914000000004,212.142376,216.66790500000002,218.2466666666667,51251728,68566771.35,64.53831371542125,0.6668337548190902,1.5,2.75,NaN,NaN,1.6680720032092464,0.7474717999828937,796.3096036323889,-0.1217699144807276,1.6737115822530768,1.7954814967338044,6.605542621137201,0.7666728246813211,82.94492569580311,2.542778051744015,14.512296252452872,7847288006
1470835800,218.31,218.4038,217.23,217.64,NaN,NaN,216.5611111111111,214.59058823529415,204.70776600000005,209.44174000000004,212.298376,216.80390500000004,213.04694681444752,216.11022047897487,216.99530000000001,218.55523960043158,215.43536039956845,204.70776600000005,209.44174000000004,212.298376,216.80390500000004,217.7579333333333,57941092,67097619.5,61.39535120218404,0.38825062691461765,1.5,2.75,NaN,NaN,1.6327668601228715,0.8635342420754585,794.4507207569623,-0.1494910920630257,1.6086176316550223,1.758108723718048,6.787480784706027,0.4013470498685132,53.126012808021095,16.916848192278366,29.957138999700533,7789346914
1470922200,218.26,218.94,217.95,218.65,NaN,NaN,217.13888888888889,214.63764705882357,204.76601600000006,209.58154000000005,212.46597599999998,216.930405,213.26667439035154,216.35210424288204,217.14914615384617,218.92242605733244,215.3758662503599,204.76601600000006,209.58154000000005,212.46597599999998,216.930405,218.51333333333332,72504270,66161289.5,64.84388698425713,0.716687572572558,1.5,2.75,NaN,NaN,1.6089977986855242,1.095871476326047,797.4729957843982,-0.11060212023979465,1.6198560734183047,1.7304581936580994,7.1873481894764355,0.704679439941047,57.94046014451199,13.801529622105727,28.25801023338228,7861851184
1471008600,218.29,218.71,217.99,218.46,NaN,NaN,217.71666666666667,214.68470588235297,204.82531600000004,209.72054000000003,212.61697599999997,217.06190500000002,213.47033421818088,216.55285621975042,217.28068461538462,219.1661582051028,215.39521102566644,204.82531600000004,209.72054000000003,212.61697599999997,217.06190500000002,218.38666666666668,61313544,63869196.65,63.69125192083747,0.47606584295709214,1.5,2.75,NaN,NaN,1.5454979559222723,0.9599861469370775,796.6748123630009,-0.10833093336281463,1.595044526954581,1.7033754603173956,7.233524079212526,0.7006545588642068,26.093162681776544,41.15899238461406,32.74784493360939,7800537640
1471267800,218.89,219.5,218.88,219.09,NaN,NaN,218.29444444444445,214.7317647058824,204.87601600000005,209.87934800000002,212.79317599999996,217.19594500000002,213.6907132684483,216.79448896072657,217.47837692307695,219.53456431973524,215.42218952641866,204.87601600000005,209.87934800000002,212.79317599999996,217.19594500000002,219.15666666666667,49813482,63423574.85,65.85835167590518,0.7661690379461011,1.5,2.75,NaN,NaN,1.5093909590706809,0.7854095597388105,800.0083540231576,-0.07655273161409992,1.6076845457997706,1.6842372774138705,7.275404790656145,1.6426876091398113,48.88449316925459,20.037521471922442,31.07798535882297,7850351122
1471354200,218.6,218.68,217.96,217.96,NaN,NaN,218.87222222222223,214.7788235294118,204.92166600000004,210.02774800000003,212.92537599999991,217.28444500000006,213.85813627752876,216.90549001208595,217.5699153846154,219.59756492472576,215.54226584450504,204.92166600000004,210.02774800000003,212.92537599999991,217.28444500000006,218.20000000000002,53213621,63366969.5,59.050447997363676,0.2818417489969673,1.5,2.75,NaN,NaN,1.4822916048513461,0.8397690692782775,796.634928464471,-0.14009057959506177,1.5091240529200434,1.6492146325151051,6.828430825569893,0.8233879174761778,24.83801495516088,42.78969966901184,32.37228537582728,7797137501
1471440600,218,218.53,217.02,218.37,NaN,NaN,219.45,214.82588235294122,204.97386600000004,210.179048,213.05917599999992,217.34869500000005,214.03507210978253,217.04496715379204,217.66606923076927,219.71766882190875,215.6144696396298,204.97386600000004,210.179048,213.05917599999992,217.34869500000005,217.97333333333336,75134339,64215713.6,60.640256804260474,0.19176378868612673,1.5,2.75,NaN,NaN,1.4842707759333922,1.1700304300597228,797.6241173360502,-0.16144142493782931,1.4474128513428184,1.6088542762806477,6.753280948895015,0.9058281583496571,54.657305463105985,15.988390740911925,29.354303795982098,7872271840
1471527000,218.34,218.9,218.21,218.86,NaN,NaN,220.02777777777777,214.87294117647062,205.01621600000007,210.31644,213.18897599999994,217.47844500000002,214.22428496822243,217.21782742485948,217.81376153846156,219.91095180462858,215.71657127229454,205.01621600000007,210.31644,213.18897599999994,217.47844500000002,218.6566666666667,52989266,63476311.4,62.51339064799014,0.35968527689040736,1.5,2.75,NaN,NaN,1.4275371490810067,0.8347880466160799,801.1846065346482,-0.1497576569624659,1.4216572050775653,1.5714148620400312,6.790453951611281,0.31166926391053573,51.13034276865012,18.406678608092996,30.46297862325688,7925261106
1471613400,218.31,218.75,217.74,218.54,NaN,NaN,220.60555555555555,214.92000000000004,205.05391600000007,210.44164,213.31817599999994,217.54344500000002,214.3935286949588,217.34374862249192,218.0438230769231,219.70841247725122,216.379233676595,205.05391600000007,210.44164,213.31817599999994,217.54344500000002,218.34333333333333,75443004,64109087.75,60.48883212264195,0.24902582455234465,1.5,2.75,NaN,NaN,1.405570209860935,1.1767911016640538,799.0027074167502,-0.16933189546912364,1.3597499927036267,1.5290818881727504,5.214664199886042,0.22471910112358662,47.078327628324416,21.401945759304787,31.5197266123708,7849818102
1471872600,218.26,218.8,217.83,218.53,NaN,NaN,221.18333333333334,214.96705882352947,205.09476600000005,210.57173999999998,213.48737599999995,217.637445,214.5557432559408,217.45672494415936,218.22459230769238,219.50677937298383,216.94240524240092,205.09476600000005,210.57173999999998,213.48737599999995,217.637445,218.38666666666666,61368766,64383868.7,60.42297631206316,0.17564882255670924,1.5,2.75,NaN,NaN,1.3744580520137253,0.95316990480878,798.6709066585846,-0.18730251551753208,1.2949537437758352,1.4822562592933672,5.194858068104129,0.16041800348335974,22.743591559006013,45.28108469037985,31.975323750614145,7788449336
1471959000,219.25,219.6,218.9,218.97,NaN,NaN,221.76111111111112,219.6,205.13886600000006,210.69224000000003,213.69779199999996,217.74844500000003,214.72885136355097,217.60084637804894,218.4215384615385,219.22548435149977,217.6175925715772,205.13886600000006,210.69224000000003,213.69779199999996,217.74844500000003,219.15666666666667,53399159,63549802,62.364547854194704,0.43549248411364483,1.5,2.75,NaN,NaN,1.3527110482984586,0.8402726258690782,801.8346616734984,-0.17418111994734486,1.264529859359186,1.438710979306531,5.294647980763694,0.611100900569754,44.864586742394664,23.07584548711413,32.0595677704912,7841848495
1472045400,218.8,218.91,217.36,217.85,NaN,NaN,222.33888888888887,219.73358490566036,205.17791600000004,210.80824,213.89399199999997,217.81494500000002,214.85124934929408,217.62457529442523,218.39615384615388,219.2483921104198,217.54391558188797,205.17791600000004,210.80824,213.89399199999997,217.81494500000002,218.04,71728949,62932054.8,54.97188461861298,0.0824573982704092,1.5,2.75,NaN,NaN,1.3710888305628532,1.139783997645664,798.2841148172066,-0.24141825812771134,1.1369381566468917,1.378356414774603,5.986053269302839,-0.3658815458495364,15.8253709900062,54.82549738612383,29.34913162386998,7770119546
1472131800,217.4,218.19,217.22,217.7,NaN,NaN,222.91666666666666,219.86716981132074,205.22601600000002,210.94334800000001,214.09299199999998,217.861445,214.96296506108646,217.63175859971807,218.3692307692308,219.28337472483682,217.45508681362477,205.22601600000002,210.94334800000001,214.09299199999998,217.861445,217.7033333333333,69224776,63141507.7,54.04782647633974,0.2527323106531621,1.5,2.75,NaN,NaN,1.3424396283797921,1.0963434121482025,800.1536704048365,-0.2930445116245912,1.012050775243864,1.3050952868684553,5.246292694420299,-0.3478897738716558,3.303875212487701,80.45162835681975,16.244496430692557,7700894770
1472218200,217.92,219.12,216.25,217.29,NaN,NaN,223.49444444444444,220.00075471698113,205.26966600000003,211.05204800000004,214.271392,217.869945,215.05422133320073,217.5992101616497,218.30076923076925,219.37978478031192,217.22175368122657,205.26966600000003,211.05204800000004,214.271392,217.869945,217.5533333333333,122506348,65290853.3,51.49959002026425,0.44109597477229345,1.5,2.75,NaN,NaN,1.4515510834955216,1.87631715329412,797.8073406842101,-0.3481045163921106,0.8699646413783171,1.2180691577704277,5.308885792927934,-0.8215801725318415,2.5053945635670374,83.11628546049792,14.378319975935048,7578388422
1472477400,217.44,218.665,217.4,218.3608,NaN,NaN,224.07222222222222,220.1343396226415,205.32277000000005,211.196156,214.50820799999997,217.94098500000004,215.18389108483993,217.67174252720687,218.3562153846154,219.36554333110865,217.34688743812217,205.32277000000005,211.196156,214.50820799999997,217.94098500000004,218.14193333333333,70502167,65150390.55,57.17812562611492,0.17487819914421945,1.5,2.75,NaN,NaN,1.4460831489601274,1.0821449634425868,801.5670503361202,-0.30713579631264887,0.8341494123796167,1.1412852086922656,5.884293482854347,0.18388695173426492,13.01967067823848,59.216416514895215,27.76391280686629,7648890589
1472563800,218.26,218.59,217.35,218,NaN,NaN,224.65,220.26792452830188,205.38857000000007,211.33116400000003,214.71120799999997,218.06352500000003,215.2943267285717,217.70300514366338,218.3062153846154,219.31677416937578,217.29565659985502,205.38857000000007,211.33116400000003,214.71120799999997,218.06352500000003,217.98000000000002,58114543,63441342.4,54.847921496757586,0.11119216091031536,1.5,2.75,NaN,NaN,1.4313629240344046,0.916035834071506,800.6841417570164,-0.2987871228031953,0.7678013051882715,1.0665884279914668,5.1251850123608005,-0.16943719375372282,3.762894973991703,78.99749922521963,17.239605800788663,7590776046
1472650200,217.61,217.75,216.465,217.38,NaN,NaN,225.22777777777776,220.40150943396225,205.46277000000006,211.46476300000003,214.89000799999994,218.12352500000003,215.37611783725515,217.67224274902875,218.2231384615385,219.34130957691153,217.10496734616547,205.46277000000006,211.46476300000003,214.89000799999994,218.12352500000003,217.19833333333335,85269453,65005133.75,51.00150022123938,0.33792137837076086,1.5,2.75,NaN,NaN,1.4387655723176611,1.3117341366903963,798.1039977964703,-0.32718225595965955,0.6576106080418924,0.984792864001552,5.214092440052021,-0.6762313807913818,3.5029025726102607,79.78140120957607,16.715696217813658,7505506593
1472736600,217.37,217.73,216.03,217.39,NaN,NaN,225.80555555555554,220.53509433962265,205.52162000000004,211.57946300000003,215.07580799999994,218.17254000000003,215.4550936083432,217.6453624872165,218.09236923076924,219.1713801264938,217.01335833504467,205.52162000000004,211.57946300000003,215.07580799999994,218.17254000000003,217.04999999999998,97844207,67568067.7,51.06111360179931,0.3704626283121376,1.5,2.75,NaN,NaN,1.4574251742949702,1.4480835449435236,796.8611319762167,-0.3361683327390468,0.5645824480777435,0.9007507808167903,4.944664450211718,-0.5262194563924251,19.546230354945145,49.38692691587104,31.06684272918382,7603350800
1472823000,218.39,218.87,217.7,218.37,NaN,NaN,226.38333333333333,220.66867924528302,205.58612000000005,211.683155,215.22700799999996,218.18204,215.56940366291798,217.71437558367205,218.12390769230768,219.2095462678551,217.03826911676026,205.58612000000005,211.683155,215.22700799999996,218.18204,218.3133333333334,79293856,67938152.45,56.629918067916684,0.17606036198112562,1.5,2.75,NaN,NaN,1.4590376618453307,1.1671476650525252,801.2605454268573,-0.26984879447033805,0.5634397877288677,0.8332885821992058,5.717364569588293,-0.07321649201482477,52.02742155138997,17.661944478153863,30.31063397045617,7682644656
1473168600,218.7,219.12,217.86,219.0308,NaN,NaN,226.9611111111111,220.8022641509434,205.63762400000005,211.79336300000003,215.54502399999998,218.23107999999996,215.70514469574474,217.83974933760805,218.17473846153845,219.35909669614986,216.99038022692704,205.63762400000005,211.79336300000003,215.54502399999998,218.23107999999996,218.67026666666666,56702089,68777932.95,59.9400614567815,0.3054995667312374,1.5,2.75,NaN,NaN,1.444820685999235,0.82442269733842,803.4966134043572,-0.17956129368876927,0.6088369650882441,0.7883982587770134,5.987534673832743,0.027766360688679003,50.89739885472316,18.460893063373046,30.6417080819038,7739346745
1473255000,218.84,219.22,218.3,219.01,NaN,NaN,227.5388888888889,220.93584905660376,205.68992400000002,211.90566300000003,215.93322399999997,218.27257999999998,215.83474686453906,217.95120178164538,218.18627692307695,219.39968117214173,216.97287267401217,205.68992400000002,211.90566300000003,215.93322399999997,218.27257999999998,218.84333333333333,76554855,70043089.3,59.78538309460474,0.3096264993187814,1.5,2.75,NaN,NaN,1.4073334941421458,1.0929679967728094,806.1333502043394,-0.12207302147298149,0.6358069819357866,0.757880003408768,5.879384563083858,0.5324764746385112,46.6137757418627,21.63862899093135,31.747595267205945,7662791890
1473341400,218.62,218.94,218.15,218.51,NaN,NaN,228.11666666666667,221.06943396226413,205.73592000000005,211.99837100000002,216.23943,218.31607999999997,215.9396587522042,218.00442065958393,218.18396923076924,219.39478516255622,216.97315329898225,205.73592000000005,211.99837100000002,216.23943,218.31607999999997,218.53333333333333,74102880,70851178.7,56.041571064611375,0.14639030334823322,1.5,2.75,NaN,NaN,1.368238244560563,1.0458948088043594,804.3334659488015,-0.118459495912688,0.6098056335179081,0.7282651294305961,5.151992979072423,0.37207165824529276,49.00801805046848,19.829651279572893,31.162330669958642,7588689010
1473427800,216.97,217.03,213.25,213.28,NaN,NaN,228.69444444444443,221.20301886792453,205.75697000000002,212.03217099999998,216.37183000000002,218.04757999999998,215.8353584089805,217.55447583486165,217.78012307692308,220.6395866674325,214.92065948641365,205.75697000000002,212.03217099999998,216.37183000000002,218.04757999999998,214.51999999999998,221589073,78305418.85,32.86124939423539,1.55322355024728,1.5,2.75,NaN,NaN,1.6462212270919507,2.8298050920903797,794.2046657931763,-0.4503906015141521,0.16527687753790588,0.615667479052058,15.018769178234823,-1.8454599843527042,9.339175906144343,65.86779145246018,24.793032641395477,7367099937
1473687000,212.39,216.81,212.31,216.34,NaN,NaN,212.31,221.3366037735849,205.79192000000003,212.094571,216.50913,217.94158,215.855148275295,217.43881146963673,217.5778153846154,220.44405426223526,214.71157650699556,205.79192000000003,212.094571,216.50913,217.94158,215.15333333333336,168110913,83645287.3,46.74163185656829,1.0273324552114975,1.5,2.75,NaN,NaN,1.8500625680139542,2.009807347508507,798.2602013214454,-0.44515923996838835,0.05921842909157249,0.5043776690599608,17.691599948153403,-0.925440830039095,17.779944916288038,51.90800100141167,30.312054082300286,7535210850
1473773400,214.84,215.1499,212.5,213.23,NaN,NaN,212.23538461538462,221.47018867924527,205.81147000000004,212.13717099999997,216.575314,217.64857999999995,215.75220128410695,217.0379722820523,217.2224307692308,220.89718222988463,213.547679308577,205.81147000000004,212.13717099999997,216.575314,217.64857999999995,213.62663333333333,182828839,90296055.15,38.11651464281695,1.6475943408153035,1.5,2.75,NaN,NaN,1.9922009560129577,2.0247710566788806,790.1461494459742,-0.6216155903544275,-0.2726418188830735,0.348973771471354,18.99382310433646,-2.1880733944954174,6.25016512711767,72.50886646530522,21.240968407577107,7352382011
1473859800,213.29,214.7,212.5,213.15,NaN,NaN,212.16076923076923,221.60377358490564,205.82942000000006,212.178971,216.67011399999998,217.40807999999993,215.65015417492629,216.66768920757113,216.87243076923082,221.12056029307706,212.62430124538457,205.82942000000006,212.178971,216.67011399999998,217.40807999999993,213.45000000000002,134185491,94344648.65,37.922660887255766,1.4676448699194569,1.5,2.75,NaN,NaN,2.0070437448691743,1.4222904310959028,789.1661514665865,-0.707915836198075,-0.5359210237762397,0.17199481242183523,19.025717696279198,-1.9459011868617122,5.331900072741583,74.74871695862005,19.919382968638377,7218196520
1473946200,212.96,215.73,212.75,215.28,NaN,NaN,212.08615384615385,221.73735849056604,205.86237000000006,212.24567099999996,216.78251400000002,217.2535799999999,215.63563832492918,216.5355283306596,216.71781538461545,221.03957283468864,212.39605793454226,205.86237000000006,212.24567099999996,216.78251400000002,217.2535799999999,214.58666666666667,145736123,97874737.85,45.823072335895766,0.7140474140016468,1.5,2.75,NaN,NaN,2.076540620235661,1.489006522023599,793.0195246445287,-0.5905334604126146,-0.566172013093933,0.02436144731868159,20.251955321362438,-0.9706058236349351,17.06010047066641,52.95098086468248,29.98891866465112,7363932643
1474032600,213.48,213.69,212.57,213.37,NaN,NaN,212.01153846153846,221.8709433962264,205.87582000000006,212.29017899999997,216.85939400000004,216.97907999999993,215.54678976316725,216.23404944202534,216.33390769230775,220.88429642054047,211.78351896407503,205.87582000000006,212.29017899999997,216.85939400000004,216.97907999999993,213.21,155236354,102987092.25,40.807761690175994,1.1812617677660173,1.5,2.75,NaN,NaN,2.1217877187902574,1.5073379644816605,789.6313097753092,-0.6081175580964548,-0.7357855003018869,-0.12766794220543212,20.732880433428196,-2.2896918074827126,20.291737866895772,48.42960527164292,31.278656861461318,7208696289
1474291800,214.13,214.88,213.03,213.41,NaN,NaN,211.93692307692308,222.00452830188678,205.90022500000006,212.33077899999998,216.87459400000003,216.72257999999994,215.46299408618032,215.96509235230863,215.98083076923083,220.66951999616543,211.29214154229624,205.90022500000006,212.33077899999998,216.87459400000003,216.72257999999994,213.7733333333333,80250490,103227466.55,40.953515189174595,0.8024343266986909,1.5,2.75,NaN,NaN,2.1023743103052386,0.7774141193432205,793.2572892668021,-0.5835437717899271,-0.857097656942841,-0.2735538851529139,20.394347226529504,-2.566214431942906,13.644706781949525,58.1810251998183,28.17426801823218,7288946779
1474378200,214.41,214.59,213.38,213.42,NaN,NaN,211.8623076923077,222.13811320754715,205.93927500000007,212.39050399999996,216.87499400000004,216.46707999999995,215.382876671036,215.7227026044697,215.67621538461543,220.47497402013067,210.8774567491002,205.93927500000007,212.39050399999996,216.87499400000004,216.46707999999995,213.79666666666665,69665279,103642292.2,40.99263395528376,0.6183058580770961,1.5,2.75,NaN,NaN,2.0386332881405793,0.6721703806547034,791.8165844906246,-0.5344189546364819,-0.9415775784485163,-0.4071586238120344,20.181325149771116,-2.5523948678142565,34.40081514342435,32.27814712611496,33.3210377304607,7358612058
1474464600,214.24,216.03,213.44,215.82,NaN,NaN,211.7876923076923,222.27169811320755,205.97027500000004,212.48539599999995,216.89239400000002,216.30957999999993,215.40001876236792,215.73196902309164,215.55544615384622,220.2535728853373,210.85731942235515,205.97027500000004,212.48539599999995,216.89239400000002,216.30957999999993,215.09666666666666,110284425,106486555.5,49.619439683747885,0.07649650097784376,1.5,2.75,NaN,NaN,2.0794451961305387,1.0356652488397937,797.4232575334099,-0.31873896564710796,-0.8055823308709193,-0.4868433652238114,21.671373188598395,-1.231064939819687,65.7616719560076,9.389953190742883,24.84837485324952,7468896483
1474551000,217,217.53,216.71,217.18,NaN,NaN,211.71307692307693,222.40528301886792,206.01442500000005,212.57749599999997,216.93759400000002,216.27607999999992,215.4698219481574,215.86987673517814,215.46390769230777,219.98203576379927,210.94577962081627,206.01442500000005,212.57749599999997,216.93759400000002,216.27607999999992,217.14000000000001,76678713,106734043.7,53.746150374348396,0.781467359052267,1.5,2.75,NaN,NaN,2.0530562535497863,0.7184091442794273,802.9322034260907,-0.07561562287138002,-0.5813628938130364,-0.5057472709416564,22.105254355174488,1.8285821455363866,60.19233342810572,12.442314789692107,27.36535178220217,7545575196
1474637400,216.72,216.88,215.88,215.99,NaN,NaN,211.63846153846154,222.5388679245283,206.05963000000003,212.675804,216.93499400000002,216.1905799999999,215.49022108744535,215.88131704611357,215.23000000000008,219.27538103176903,211.18461896823112,206.05963000000003,212.675804,216.93499400000002,216.1905799999999,216.25,73630921,106954350.95,49.89499739477716,0.3159212690867223,1.5,2.75,NaN,NaN,1.9992665211533738,0.6884331525177658,799.6724085512155,0.009401055585898765,-0.4939959514592829,-0.5033970070451816,16.762631279361287,-0.1617823795876834,78.99268754785476,3.7642726061479683,17.243039845997288,7471944275
1474896600,215.02,215.23,214.01,214.24,NaN,NaN,211.56384615384616,222.67245283018866,206.10413000000005,212.76810400000002,216.903194,216.0380799999999,215.4411928095063,215.7250011369599,214.86307692307702,218.28823618599003,211.437917660164,206.10413000000005,212.76810400000002,216.903194,216.0380799999999,214.4933333333333,89827305,105320398.8,44.80996438014002,0.4977436097465642,1.5,2.75,NaN,NaN,1.9978903410709914,0.8528956025943191,795.5286116653174,-0.044896493529857806,-0.5595176239575039,-0.5146211304276461,15.278036552442298,0.4736669324204002,48.940956527484495,19.87292476991047,31.186118702605036,7382116970
1474983000,214.05,215.68,213.62,215.57,NaN,NaN,211.48923076923077,222.80603773584903,206.15263000000002,212.87410400000002,216.88640999999998,215.89853999999985,215.4462440718786,215.7102391239161,214.6369230769232,217.39166036289936,211.88218579094706,206.15263000000002,212.87410400000002,216.88640999999998,215.89853999999985,214.95666666666668,78494829,105720031.9,49.05910965561432,0.21306815063676507,1.5,2.75,NaN,NaN,2.0023267452802065,0.7424782946929852,797.7911429068802,0.012993598472545331,-0.4983791323369644,-0.5113727308095097,13.038220992882982,1.1353506920009324,50.202453728384675,18.952323568072046,30.845222703543257,7460611799
1475069400,215.83,216.82,214.71,216.64,NaN,NaN,211.4146153846154,222.93962264150943,206.22643000000005,212.98330399999998,216.89540999999997,215.83053999999987,215.49305802984415,215.79878777878122,214.8953846153847,217.72193582065634,212.06883341011306,206.22643000000005,212.98330399999998,216.89540999999997,215.83053999999987,216.05666666666664,87411015,107184855.5,52.24462695042961,0.3030064348550328,1.5,2.75,NaN,NaN,2.010017692045905,0.815516470048327,802.7862224530066,0.12154382857859025,-0.35944294508627195,-0.4809867736648622,13.176208112576148,0.6317354143441031,47.12430231306554,21.239310567921006,31.636387119013463,7548022814
1475155800,216.4,216.87,214.04,214.68,NaN,NaN,211.34,223.0732075471698,206.28532600000003,213.07121199999997,216.84731,215.69553999999988,215.46117340122282,215.69223656175444,214.76769230769239,217.4688618987733,212.06652271661147,206.28532600000003,213.07121199999997,216.84731,215.69553999999988,215.19666666666663,128070615,109324913.6,46.507512373568865,0.1526597077718906,1.5,2.75,NaN,NaN,2.0685878568997698,1.1714677906683477,797.3322548410873,0.0625119250265091,-0.4028468673817258,-0.4653587924082349,13.304764961116375,0.6139569761447262,17.175363251805987,52.73070341079325,30.093933337400752,7419952199
1475242200,215.65,217.12,215.36,216.3,NaN,NaN,211.26538461538462,223.20679245283017,206.34167200000005,213.14971199999997,216.84801,215.6410399999999,215.49406856195918,215.7501187939683,215.00384615384624,217.66244657757184,212.34524573012064,206.34167200000005,213.14971199999997,216.84801,215.6410399999999,216.26,117202914,110292848.95,51.27058011945058,0.5459817299972095,1.5,2.75,NaN,NaN,2.095117295692643,1.0626519771298373,801.2841257841493,0.12986209577795454,-0.3030311726857917,-0.43289326846374626,12.733904765172626,1.3542008340752612,42.50919921224734,24.934456987660923,32.55634380009173,7537155113
1475501400,215.82,216.04,215.04,215.78,NaN,NaN,211.19076923076923,223.34037735849054,206.38042200000004,213.24251199999995,216.81881,215.51153999999988,215.5052815595294,215.7529646231142,215.20615384615394,217.66223626097977,212.7500714313281,206.38042200000004,213.24251199999995,216.81881,215.51153999999988,215.62,83512057,110503759,49.73960098025968,0.023976456868632503,1.5,2.75,NaN,NaN,2.035466060286027,0.7557395128974753,798.7155848369572,0.13602971247905982,-0.2628561278649215,-0.39888584034398133,12.907032276063735,1.1058007684378286,43.55287787728642,24.069634957795394,32.37748716491819,7453643056
1475587800,215.91,216.17,213.99,214.68,NaN,NaN,211.11615384615385,223.47396226415094,206.42952200000002,213.32371199999994,216.77941,215.29399999999987,215.47291757680276,215.65077751615095,215.16000000000005,217.63129987597878,212.68870012402132,206.42952200000002,213.32371199999994,216.77941,215.29399999999987,214.9466666666666,119948052,113666057.15,46.571525429678005,0.4167511493991377,1.5,2.75,NaN,NaN,2.045789913122738,1.0552671132219351,794.708923716606,0.06620168870051824,-0.3161337294683335,-0.38233541816885175,13.39074136837385,-0.5282179594106137,19.242795639637922,49.80070800021916,30.956496360142914,7333695004
1475674200,215.41,216.13,215.33,215.63,NaN,NaN,211.04153846153847,223.6075471698113,206.50756800000002,213.43241199999997,216.75701,215.12499999999986,215.4790776718301,215.64879870508895,215.33384615384622,217.5851847431779,213.08250756451454,206.50756800000002,213.43241199999997,216.75701,215.12499999999986,215.6966666666667,72815963,113479112.55,49.55957354274364,0.14253151687082766,1.5,2.75,NaN,NaN,2.0032334907568274,0.6416684212957392,797.5331883267719,0.08307689392777451,-0.2784893007591336,-0.3615661946869081,11.91723139557408,-0.7136937102864036,17.398727532698814,52.40544639839299,30.195826068908197,7406510967
1475760600,215.37,216.04,214.735,215.78,NaN,NaN,210.96692307692308,223.74113207547168,206.57811800000002,213.52241199999997,216.74221,214.98849999999985,215.49087854744462,215.66129406650904,215.51615384615394,217.48033366654906,213.55197402575882,206.57811800000002,213.52241199999997,216.74221,214.98849999999985,215.51833333333332,62927376,112920337.35,50.03472864677562,0.12799707884771,1.5,2.75,NaN,NaN,1.9533596699884812,0.5572722990098293,795.7475009954389,0.1021678971321136,-0.2338563232717661,-0.3360242204038797,11.238126842540122,-0.0972267234594231,40.93957576180171,26.267460343794887,32.79296389440341,7469438343
1475847000,216.1,216.3,214.19,215.04,NaN,NaN,210.8923076923077,223.87471698113205,206.63581800000003,213.62430399999997,216.70761000000002,215.07649999999984,215.47319703578012,215.602123203032,215.64076923076934,217.2262312898443,214.05530717169438,206.63581800000003,213.62430399999997,216.70761000000002,215.07649999999984,215.17666666666662,89788255,106330296.45,47.64997003947803,0.1337378664424616,1.5,2.75,NaN,NaN,1.9645482649893051,0.844427768921169,792.6679988711771,0.06461635554525846,-0.2552537759723066,-0.31987013151756505,10.97276578909592,0.37341299477221007,12.832541331562409,59.52865038832222,27.638808280115377,7379650088
1476106200,216.155,216.7,215.985,216.16,NaN,NaN,210.8176923076923,224.00830188679242,206.68651800000006,213.73680399999998,216.68841,215.06749999999982,215.50013048535737,215.65525432655275,215.66692307692315,217.27441294273652,214.0594332111098,206.68651800000006,213.73680399999998,216.68841,215.06749999999982,216.28166666666664,51855023,100517501.95,51.42367963831712,0.3321697696600056,1.5,2.75,NaN,NaN,1.9427948174900689,0.5158805381553754,796.539547513373,0.11208445904873399,-0.17976455770664757,-0.29184901675538155,10.19307967873657,0.27369299995361296,28.719851033721312,38.21525537599143,33.06489359028725,7431505111
1476192600,215.66,215.74,212.58,213.43,NaN,NaN,210.74307692307693,224.14188679245282,206.72526800000006,213.82910399999997,216.61821,215.07749999999987,215.4189488976963,215.44332534307154,215.3784615384616,217.13527414445642,213.6216489324668,206.72526800000006,213.82910399999997,216.61821,215.07749999999987,213.91666666666666,130367373,97894428.65,43.24130053671972,0.9099563877931076,1.5,2.75,NaN,NaN,2.059738044812206,1.331713916693869,791.2349042165689,-0.03560059628493695,-0.33634976211155276,-0.3007491658266158,12.171876852983727,-1.4817208271787203,27.320863283855626,39.77717289951279,32.901963816631586,7301137738
1476279000,213.59,214.32,213.01,213.71,NaN,NaN,210.66846153846154,224.2754716981132,206.76776800000007,213.91130399999994,216.581426,215.1054999999999,215.35193129386508,215.27824673896947,215.20307692307702,217.12786877381512,213.27828507233892,206.76776800000007,213.91130399999994,216.581426,215.1054999999999,213.67999999999998,73866117,94878459.95,44.22160843562898,0.6352433130582891,1.5,2.75,NaN,NaN,2.00618532732562,0.7785341060439503,791.0497401966144,-0.10568966714282652,-0.43286124975514895,-0.32717158261232243,11.69183173165993,-0.45183528973355636,27.385045939967267,39.70447947034727,32.91047458968545,7375003855
1476365400,212.16,213.59,211.21,213.01,NaN,NaN,210.59384615384616,224.40905660377356,206.79581800000008,213.98930399999995,216.518026,214.9919999999999,215.2600908509684,215.06222324002,215.10846153846165,217.3137955777443,212.90312749917902,206.79581800000008,213.98930399999995,216.518026,214.9919999999999,212.60333333333332,101356960,92659501.8,42.25666532918821,1.0068030054046926,1.5,2.75,NaN,NaN,2.0414578039452183,1.0938647200885339,787.351091794833,-0.18576931571531097,-0.5593832272564612,-0.3736139115411502,10.724773590848429,-1.521035598705511,9.436846451151233,65.70974350280173,24.853410046047056,7273646895
1476451800,214.15,214.69,213.03,213.12,NaN,NaN,210.51923076923077,224.54264150943393,206.8317680000001,214.04180399999993,216.452232,214.97949999999992,215.17616571955787,214.87724959811334,214.9200000000001,217.34332257607406,212.49667742392614,206.8317680000001,214.04180399999993,216.452232,214.97949999999992,213.61333333333332,93346237,89564995.95,42.68763145021614,0.5190356995198829,1.5,2.75,NaN,NaN,2.015639389377703,1.0422178442581618,788.2755080725701,-0.2157972438060871,-0.6433604662987591,-0.427563222492672,9.418522105963582,-1.2327370469923054,30.45517679213921,36.3410755008558,33.20374770700497,7366993132
1476711000,213.09,213.39,212.17,212.38,NaN,NaN,210.4446153846154,224.67622641509433,206.87431800000005,214.07280399999996,216.336232,214.92799999999994,215.06651216192816,214.63941630305493,214.59230769230783,217.14530477079916,212.0393106138165,206.87431800000005,214.07280399999996,216.336232,214.92799999999994,212.64666666666665,58275674,88466255.15,40.497868258309104,0.8178321410795344,1.5,2.75,NaN,NaN,1.9588080044221527,0.6587333656340487,785.8541122158922,-0.2666327782276259,-0.7608541952772043,-0.49422141704957845,9.476795304155235,-1.0713620272032847,17.920922273554527,51.66772448112503,30.41135324532047,7308717458
1476797400,214.24,214.31,213.27,213.71,NaN,NaN,210.37,224.8098113207547,206.93777200000005,214.11650399999996,216.24943199999998,214.94249999999994,215.01331560655842,214.55090046466876,214.51769230769244,217.1124343739659,211.922950241419,206.93777200000005,214.11650399999996,216.24943199999998,214.94249999999994,213.76333333333335,76869656,88826474,45.872150499205326,0.17570790576827575,1.5,2.75,NaN,NaN,1.9567502898205709,0.8653912796313405,790.0875767807872,-0.1951349603324346,-0.7381401174651216,-0.543005157132687,10.146882170615237,-0.8904141353243925,48.847012203940466,19.9524121740999,31.200575621959636,7385587114
1476883800,214.02,214.64,213.6,214.28,NaN,NaN,210.29538461538462,224.94339622641508,207.00237200000004,214.1569039999999,216.17143199999998,214.86549999999994,214.98455813179143,214.5251004204146,214.36230769230784,216.7447583226136,211.97985706200208,207.00237200000004,214.1569039999999,216.17143199999998,214.86549999999994,214.17333333333332,66519224,86638213.95,48.038255794657175,0.12095740102794794,1.5,2.75,NaN,NaN,1.891268126261958,0.7677815708249605,793.9526801934069,-0.09876567340968112,-0.6664622488947884,-0.5676965754851073,9.886437826252632,-0.6951524701084438,47.80839612139519,20.729308882848276,31.462294995756547,7452106338
1476970200,213.87,214.53,213.11,213.88,NaN,NaN,210.22076923076924,225.07698113207545,207.077672,214.19730399999992,216.096232,214.70049999999992,214.94124212662314,214.46366228513702,214.216153846154,216.46199154779305,211.97031614451492,207.077672,214.19730399999992,216.096232,214.70049999999992,213.84,73639830,86486269.8,46.628070900092354,0.13051561580426216,1.5,2.75,NaN,NaN,1.8576061172432456,0.8514626676614975,792.1202871587179,-0.05353729575927635,-0.6346181951842027,-0.5810808994249264,9.870361704407548,-0.5394345238095223,54.28126469802355,16.13847021778053,29.580265084195908,7378466508
1477056600,212.96,214.08,212.76,213.98,NaN,NaN,210.14615384615385,225.21056603773582,207.17732200000003,214.23440399999993,216.00283199999998,214.5999999999999,214.90354635695164,214.41759921036206,214.16230769230785,216.39460425166072,211.93001113295497,207.17732200000003,214.23440399999993,216.00283199999998,214.5999999999999,213.6066666666667,89089092,87259178.35,47.04658251334081,0.23020937389514898,1.5,2.75,NaN,NaN,1.8192056802973011,1.0209710162827816,792.7808654177937,-0.010703141334129862,-0.5944598260925886,-0.5837566847584588,9.755002932285853,-1.0085122131754287,53.72391930185318,16.51066230084771,29.765418397299126,7467555600
1477315800,215,215.32,214.48,214.89,NaN,NaN,210.07153846153847,225.34415094339622,207.292157,214.2742039999999,215.93143199999997,214.63249999999994,214.90301512726725,214.46258976175613,214.10538461538474,216.21969651119502,211.99107271957445,207.292157,214.2742039999999,215.93143199999997,214.63249999999994,214.89666666666662,60146592,85775142.7,50.82544531759455,0.31850545176608674,1.5,2.75,NaN,NaN,1.7849767031332084,0.7012123804954042,795.1058181926701,0.08010162551858269,-0.4836296528602304,-0.5637312783788131,9.565948583208455,0.6840650330318978,76.39906054067818,4.685999392627337,18.914940066694495,7527702192
1477402200,214.68,214.98,213.98,214.17,NaN,NaN,209.99692307692308,225.4777358490566,207.402457,214.31310399999992,215.83303199999997,214.56249999999994,214.87426943600187,214.4347240701603,213.98153846153858,215.86498613743566,212.0980907856415,207.402457,214.31310399999992,215.83303199999997,214.56249999999994,214.37666666666667,66542329,85177517.7,47.91212427931837,0.07959530536274864,1.5,2.75,NaN,NaN,1.7289069386236935,0.7812193968174304,792.8939620281992,0.09200794713929317,-0.4487213444546967,-0.5407292915939899,6.122545289308055,0.21524495812080835,48.83023457705812,19.96024135344547,31.209524069496403,7461159863
1477488600,213.21,214.42,212.93,213.74,NaN,NaN,209.9223076923077,225.61132075471696,207.502853,214.33700399999995,215.748632,214.41749999999993,214.82978828164886,214.3685598730022,213.8815384615386,215.66496379415952,212.0981131289177,207.502853,214.33700399999995,215.748632,214.41749999999993,213.6966666666667,75705478,84592240.85,46.208591381666,0.20722892568814294,1.5,2.75,NaN,NaN,1.7118421572934284,0.8949458867538678,790.112260376751,0.07213552053614136,-0.4505598909238131,-0.5226954114599545,6.226477691752658,0.34270691516831053,22.489963606229452,45.52323678450257,31.986799609267983,7385454385
1477575000,214.58,214.62,213.08,213.17,NaN,NaN,209.8476923076923,225.74490566037733,207.624553,214.35190399999993,215.64463199999997,214.34199999999993,214.76469854511362,214.25441131366864,213.65153846153862,214.8874335566879,212.41564336638933,207.624553,214.35190399999993,215.64463199999997,214.34199999999993,213.62333333333333,77220213,82049720.75,43.97647616512346,0.2821436232721869,1.5,2.75,NaN,NaN,1.6995677174867543,0.9411392542734522,786.5773999699969,0.02428765126578991,-0.4923358473777171,-0.516623498643507,6.1174397367828135,0.02346096096095296,22.069585298782204,46.05829971812897,31.872114983088814,7308234172
1477661400,213.14,213.93,211.71,212.54,NaN,NaN,209.77307692307693,225.87849056603773,207.727603,214.35360399999993,215.51823199999998,214.1539999999999,214.6774554649131,214.0911340457002,213.5830769230771,214.9519256164386,212.21422822971562,207.727603,214.35360399999993,215.51823199999998,214.1539999999999,212.72666666666666,140623183,83220734.2,41.58544306394764,0.5352765549738512,1.5,2.75,NaN,NaN,1.736741451951986,1.689761384008554,784.1720487927851,-0.042470835421105635,-0.569712042919889,-0.5272412074987833,6.3460824033898735,0.07533666070251276,2.4317203455828986,83.33725242443698,14.231027229980132,7167610989
1477920600,212.93,213.19,212.36,212.55,NaN,NaN,209.69846153846154,226.0120754716981,207.851303,214.35830399999992,215.39843199999996,213.99249999999992,214.59402583883806,213.9443593746811,213.49384615384633,214.9653506368774,212.02234167081528,207.851303,214.35830399999992,215.39843199999996,213.99249999999992,212.70000000000002,61272507,82108756.7,41.63968396944085,0.46785123583026905,1.5,2.75,NaN,NaN,1.671974205383986,0.746235961456228,784.9670805353577,-0.07664243609169097,-0.623044252613397,-0.546401816521706,6.008775716605913,-0.542791633522061,2.2959194010820942,83.84250591268405,13.86157468623386,7228883496
1478007000,212.93,212.99,209.6,211.01,NaN,NaN,209.62384615384616,226.14566037735847,207.96605300000002,214.3677039999999,215.24803199999994,213.8089999999999,214.45347580594245,213.66489657709243,213.34000000000015,215.31406258173948,211.3659374182608,207.96605300000002,214.3677039999999,215.24803199999994,213.8089999999999,211.20000000000002,122781818,82250445,36.083020078108895,1.202506751345821,1.5,2.75,NaN,NaN,1.794690333570845,1.4927799843514524,780.38599972731,-0.18734057144944427,-0.7805775308335114,-0.5932369593840672,5.94168642631954,-1.5260406944185225,1.7729871280709675,85.89751959519936,12.329493276729664,7106101678
1478093400,210.65,211.1,209.23,209.74,NaN,NaN,209.54923076923077,226.27924528301884,208.08650300000002,214.38061199999993,215.06343199999995,213.5144999999999,214.2686336174741,213.29109690308363,213.08000000000013,215.83668697473823,210.32331302526202,208.08650300000002,214.38061199999993,215.06343199999995,213.5144999999999,210.02333333333334,103330806,83776187.15,32.25974680051456,1.2963792973708428,1.5,2.75,NaN,NaN,1.8000695954586423,1.2334150015085759,775.9731805634452,-0.32254332072013003,-0.9964161102842297,-0.6738727895640997,5.931070007942026,-1.9356648587993204,1.5863697245381623,86.69690799381391,11.716722281647934,7002770872
1478179800,209.99,210.24,208.46,208.78,NaN,NaN,209.4746153846154,226.41283018867924,208.196953,214.38801199999992,214.88203199999995,213.16449999999992,214.05339308345552,212.86146862659947,212.80307692307707,216.38512090005173,209.2210329461024,208.196953,214.38801199999992,214.88203199999995,213.16449999999992,209.16,88939346,85076785.65,29.69813218345145,1.5238814538400547,1.5,2.75,NaN,NaN,1.7986360529258822,1.0454008731111482,773.6423031126294,-0.4454989184742437,-1.2307464376569044,-0.7852475191826607,6.088060115668742,-2.430133657351149,1.5224655864926573,86.98047551131909,11.497058902188247,6913831526
1478266200,208.91,209.89,208.38,208.55,NaN,NaN,208.38,226.5464150943396,208.28710300000003,214.3960119999999,214.69903199999993,212.83999999999992,213.83757374684942,212.45085256692334,212.406153846154,216.59106842818852,208.2212392641195,208.28710300000003,214.3960119999999,214.69903199999993,212.83999999999992,208.93999999999997,109122059,86043475.85,29.101899927258273,1.3034111506466295,1.5,2.75,NaN,NaN,1.7780191920026043,1.2682200239124812,774.8401272268865,-0.5067304265784974,-1.4186605524057825,-0.911930125827285,5.879863196838809,-2.950346689003665,1.7558225905839409,85.9693798480529,12.274797561363165,6804709467
1478529000,211.45,213.19,211.3,213.15,NaN,NaN,208.27923076923076,226.67999999999998,208.41465300000004,214.44381199999992,214.6162319999999,212.6894999999999,213.81061007050238,212.51743803674017,212.31923076923093,216.39024244870382,208.24821908975804,208.41465300000004,214.44381199999992,214.6162319999999,212.6894999999999,212.54666666666668,109794861,88940467.75,50.504506545517735,0.4088151751580761,1.5,2.75,NaN,NaN,1.982446392573846,1.2344758665832405,780.0814465809641,-0.21667035686694858,-1.1827680719109708,-0.9660977150440222,14.947913400836137,-0.4762571788765849,4.5893076799872725,76.79369246519157,18.616999854821174,6914504328
1478615400,212.69,214.77,212.38,214.11,NaN,NaN,208.17846153846153,226.81358490566035,208.53420300000005,214.5197119999999,214.53121599999992,212.7234999999999,213.8223508520513,212.66911060466967,212.33692307692323,216.43680963904313,208.23703651480332,208.53420300000005,214.5197119999999,214.53121599999992,212.7234999999999,213.75333333333333,106772138,87760706,53.64926153307855,0.9267095923521367,1.5,2.75,NaN,NaN,2.011557364532858,1.216628065868112,782.1940653101097,0.04656457928984459,-0.9078919909317165,-0.954456570221561,15.136356541868247,0.1731075138018174,21.72025468689776,46.69697817243381,31.582767140668427,7021276466
1478701800,212.37,217.1,212.34,216.3792,NaN,NaN,208.0776923076923,226.94716981132072,208.67544900000007,214.60500399999992,214.4987999999999,212.8569599999999,213.9226194460885,213.02245245184398,212.52147692307705,217.08982947185893,207.95312437429516,208.67544900000007,214.60500399999992,214.4987999999999,212.8569599999999,215.27306666666667,258428972,96988848.75,60.1021847359072,1.6543819367458843,1.5,2.75,NaN,NaN,2.207874695637653,2.6645225232658514,784.5940653101097,0.3626307864700905,-0.5011680871339479,-0.8637988736040384,16.208289190700803,1.5054651217338322,61.67113156598309,11.695569079567527,26.633299354449395,7279705438
1478788200,217.3,218.31,215.22,216.92,NaN,NaN,207.97692307692307,227.08075471698112,208.81449900000007,214.68980399999992,214.4895999999999,213.05245999999988,214.04016378153602,213.39364745643027,212.67763076923092,217.67754177357324,207.6777197648886,208.81449900000007,214.68980399999992,214.4895999999999,213.05245999999988,216.81666666666663,172113313,100526666.4,61.478603098140276,1.7406071872935254,1.5,2.75,NaN,NaN,2.2708836459492496,1.7121159903498002,782.1819745534876,0.5841129389035461,-0.13365769997460575,-0.7177706388781518,16.024274991632126,2.060788557448008,82.98585803454642,2.559973501908266,14.454168463545317,7451818751
1478874600,216.08,216.7,215.32,216.42,NaN,NaN,207.87615384615384,227.2143396226415,208.92799500000004,214.77300399999993,214.47019999999992,213.2174599999999,214.13349069206402,213.6818715081988,212.85070769230785,218.18955937316872,207.51185601144698,208.92799500000004,214.77300399999993,214.47019999999992,213.2174599999999,216.14666666666665,100552732,100886991.15,59.43697767465752,1.10292658275682,1.5,2.75,NaN,NaN,2.2229633855243027,0.996686796323393,784.223216005807,0.6669484417637832,0.11591491332657711,-0.5510335284372061,15.958633367604461,1.8207480592801581,83.69862911769503,2.3609498857642475,13.940420996540727,7351266019
1479133800,217.03,217.27,215.72,216.59,NaN,NaN,207.7753846153846,227.34792452830186,209.042695,214.83080399999992,214.43459999999993,213.4279599999999,214.22982439041445,213.9588361264656,213.0699384615386,218.75940253228015,207.38047439079708,209.042695,214.83080399999992,214.43459999999993,213.4279599999999,216.52666666666667,94579982,102702206.55,59.924278364198884,1.0740904176528043,1.5,2.75,NaN,NaN,2.1748945722725677,0.9209147999556783,785.9938472873378,0.6997782611136392,0.3236892979548429,-0.37608896315879625,15.93447513873558,2.644424434860913,84.22590540236686,2.1914225793843967,13.582672018248733,7445846001
1479220200,217.04,218.28,216.8,218.28,NaN,NaN,207.67461538461538,227.48150943396223,209.183295,214.98230399999989,214.41958399999993,213.65645999999987,214.38865480647664,214.3703755429927,213.46301538461555,219.79555917865056,207.13047159058053,209.183295,214.98230399999989,214.41958399999993,213.65645999999987,217.78666666666666,91652580,103441352.75,64.49121511487255,1.422302756731868,1.5,2.75,NaN,NaN,2.14025924568167,0.8860342364383861,790.4590977325493,0.7949524062264144,0.6176015446242218,-0.17735086160219263,15.090320611295148,4.071707828740341,83.90328853465832,2.2772260895942322,13.819485375747453,7537498581
1479306600,217.56,218.14,217.42,217.87,NaN,NaN,207.57384615384615,227.61509433962263,209.316145,215.1650039999999,214.39678399999994,213.8359599999999,214.52517814739912,214.70367311032672,213.87301538461554,220.5918263241973,207.15420444503377,209.316145,215.1650039999999,214.39678399999994,213.8359599999999,217.80999999999997,65617697,103396276.4,62.62662036619238,1.1983080571763105,1.5,2.75,NaN,NaN,2.048812156704409,0.6346234050649042,791.6489424018564,0.7883846296092427,0.8081299254093608,0.01974529580011805,14.310721422872145,4.353865312769424,59.20445611179979,13.028683747373769,27.76686014082645,7471880884
1479393000,218.05,219.06,217.92,218.99,NaN,NaN,207.47307692307692,227.748679245283,209.453095,215.3229069999999,214.40638399999992,214.09145999999987,214.70026920044228,215.11189471886703,214.36840000000015,221.55718937832552,207.17961062167478,209.453095,215.3229069999999,214.40638399999992,214.09145999999987,218.65666666666667,69797191,103204144.45,65.55625282686457,1.3906464610006246,1.5,2.75,NaN,NaN,1.9874684312255224,0.6763022102645802,793.2807054368617,0.8142354188196486,1.0375395693246787,0.2233041505050302,13.277626194304354,5.005993766482857,48.01091016615142,20.57029454855331,31.418795285295285,7541678075
1479479400,219.07,219.27,218.29,218.5,NaN,NaN,207.3723076923077,227.88226415094337,209.60584500000002,215.4413069999999,214.51078399999992,214.3174599999999,214.84927825140534,215.43457141230826,214.94455384615398,222.16485912526386,207.7242485670441,209.60584500000002,215.4413069999999,214.51078399999992,214.3174599999999,218.68666666666664,86265751,103062977.4,63.22130612711845,1.156960145750874,1.5,2.75,NaN,NaN,1.9155064004237006,0.8370197832068453,792.1305242917082,0.7544481499831471,1.166364337983964,0.411916188000817,13.475973193893248,2.509969505043394,50.927396838997446,18.437241382429878,30.63536177857267,7455412324
1479738600,219.17,220.18,219,220.15,NaN,NaN,207.27153846153846,228.01584905660374,209.77949500000003,215.54805699999994,214.58698399999992,214.58045999999985,215.0571496925267,215.8836598492313,215.7453230769232,222.7859722664439,208.7046738874025,209.77949500000003,215.54805699999994,214.58698399999992,214.58045999999985,219.77666666666667,72402638,103675779.7,67.42833383493053,1.4448684638139446,1.5,2.75,NaN,NaN,1.898684514679151,0.6983563394411588,796.0263019205435,0.77896901350075,1.3856274548767544,0.6066584413760044,8.348483880742634,2.820979870160194,48.917818368343944,19.89523179482041,31.186949836835648,7527814962
1479825000,220.51,220.79,219.73,220.58,NaN,NaN,207.17076923076922,228.14943396226414,209.95524500000002,215.65464899999995,214.7339839999999,214.90095999999986,215.27373205752565,216.3309303397807,216.6530153846155,222.8610130659186,210.44501770331237,209.95524500000002,215.65464899999995,214.7339839999999,214.90095999999986,220.36666666666667,67428957,103720111.1,68.44146369904779,1.4106050528475487,1.5,2.75,NaN,NaN,1.8387784779163545,0.650104943823185,800.5476538147029,0.7754141790650189,1.575926165207278,0.8005119861422592,8.33531724791472,1.9414065677292527,45.23182244993058,22.720531022928125,32.047646527141275,7595243919
1479911400,219.98,220.76,219.75,220.7,NaN,NaN,207.07,228.2830188679245,210.13239500000003,215.77754899999996,214.88498399999992,215.24895999999984,215.48652687879914,216.74703221218255,217.58763076923086,222.04654280165897,213.12871873680274,210.13239500000003,215.77754899999996,214.88498399999992,215.24895999999984,220.40333333333334,56620237,102765849.05,68.73374329974042,1.255706992055611,1.5,2.75,NaN,NaN,1.7795800152080428,0.5509635498895341,800.2375669782299,0.7328975898162714,1.7166339734125984,0.983736383596327,6.862811421682524,1.7425779089065099,70.54476603567001,7.093058925800979,22.362175038529006,7651864156
1480084200,221.1,221.56,221.01,221.52,NaN,NaN,206.96923076923076,228.41660377358488,210.32569500000002,215.89614899999998,215.00978399999994,215.66645999999986,215.72313366786585,217.20160057292708,218.231476923077,222.34517382984444,214.11778001630955,210.32569500000002,215.89614899999998,215.00978399999994,215.66645999999986,221.36333333333334,37872255,100798451.15,70.72873216633718,1.5087800016044006,1.5,2.75,NaN,NaN,1.7138957284074692,0.37572258866995495,803.1004110691052,0.7111912601443207,1.8727254587767277,1.161534198632407,6.931115295762236,2.3565289714444244,67.18490817782018,8.677404776623451,24.137687045556373,7689736411
1480343400,221.16,221.48,220.36,220.48,NaN,NaN,206.86846153846153,228.55018867924525,210.49494500000003,216.00568899999996,215.1519839999999,216.06345999999985,215.9096774455966,217.51382908979116,218.72147692307698,222.22734524665285,215.2156085995011,210.49494500000003,216.00568899999996,215.1519839999999,216.06345999999985,220.77333333333334,76572511,97595917.55,65.05883671279128,0.9866983622980676,1.5,2.75,NaN,NaN,1.6743317478069353,0.7845872339974738,799.1700470663658,0.583344476240861,1.8907147939334834,1.3073703176926224,7.592332311825097,1.7960201301999106,71.49763071835325,6.718392391146557,21.78397689050019,7613163900
1480429800,220.52,221.44,220.17,220.91,NaN,NaN,206.7676923076923,228.68377358490562,210.65059500000007,216.08828899999992,215.3019839999999,216.48145999999983,216.10576852616143,217.83727393838248,219.07000000000005,222.47453995533326,215.66546004466684,210.65059500000007,216.08828899999992,215.3019839999999,216.48145999999983,220.84,69886690,98026626.7,66.26305369472135,0.9331884291567853,1.5,2.75,NaN,NaN,1.6454509086778693,0.7129357844158071,798.6027384374346,0.48815525732860054,1.9175643893533731,1.4294091320247726,7.561515615109569,1.2048744731537453,71.25171105581107,6.82689977304326,21.921389171145663,7683050590
1480516200,221.63,221.82,220.31,220.38,NaN,NaN,206.66692307692307,228.81735849056602,210.78809500000006,216.15808899999993,215.44118399999988,216.94995999999983,216.2733854467041,218.0794383252032,219.3361538461539,222.56311277137527,216.10919492093254,210.78809500000006,216.15808899999993,215.44118399999988,216.94995999999983,220.83666666666667,113291793,97552125.45,63.36434588255579,0.7662849771934349,1.5,2.75,NaN,NaN,1.6357758437723064,1.1613462287714817,795.7552644501772,0.35604758177867124,1.8744686092481118,1.5184210274694405,6.9370292206582045,1.1520631569284394,30.820987141208008,36.048637352968264,33.130375505823736,7569758797
1480602600,220.73,220.73,219.15,219.57,NaN,NaN,206.56615384615384,228.9509433962264,210.92549500000007,216.2042889999999,215.5161839999999,217.44145999999984,216.40266444879416,218.22139657994575,219.5784615384616,222.33139391797476,216.82552915894843,210.92549500000007,216.2042889999999,215.5161839999999,217.44145999999984,219.8166666666667,79040487,96337609.5,59.10858342840874,0.2771065304979371,1.5,2.75,NaN,NaN,1.6317918549314263,0.8204530651136823,792.7920756602284,0.18904498515868484,1.7547272589177965,1.5656822737591116,7.274769494479342,0.26485227635964387,11.418198599621023,62.11227483172575,26.46952656865323,7490718310
1480689000,219.67,220.25,219.26,219.68,NaN,NaN,206.4653846153846,229.08452830188676,211.0638950000001,216.25188899999995,215.56618399999988,217.98645999999985,216.53118741158653,218.36031119137948,219.8161538461539,221.9627438210993,217.66956387120848,211.0638950000001,216.25188899999995,215.56618399999988,217.98645999999985,219.73000000000002,74840347,95632659.55,59.506334958105526,0.20683701319359768,1.5,2.75,NaN,NaN,1.5859495795791823,0.7825814669607817,794.7156140663956,0.06720685906368296,1.6496908475887153,1.5824839885250324,6.727652211829509,0.5400457665903922,17.32581669595074,52.65357709173009,30.020606212319155,7565558657
1480948200,220.65,221.4,220.42,221,NaN,NaN,206.36461538461538,229.21811320754713,211.1949950000001,216.30068899999995,215.66638399999988,218.60895999999985,216.70643496407334,218.61171012553382,220.02538461538464,222.05956357102502,217.99120565974425,211.1949950000001,216.30068899999995,215.66638399999988,218.60895999999985,220.93999999999997,67837821,93568447.65,64.02810941262271,0.641646884518544,1.5,2.75,NaN,NaN,1.5955246096092406,0.7250074432542966,798.5409680805142,0.057130099203420937,1.6538966125293086,1.5967665133258877,7.222632308033423,0.3861003861003835,37.483646275154655,29.361411337078835,33.15494238776651,7633396478
1481034600,221.22,221.7441,220.662,221.7,NaN,NaN,206.26384615384615,229.35169811320753,211.34189500000008,216.35938899999994,215.81558399999992,219.03645999999986,216.9022610439136,218.90583297072106,220.32000000000002,222.11558432739812,218.52441567260192,211.34189500000008,216.35938899999994,215.81558399999992,219.03645999999986,221.36869999999996,59877377,91072573.45,66.18458863020513,0.7340520049045429,1.5,2.75,NaN,NaN,1.5588514232085804,0.6574688156020257,801.9300654984725,0.07793427630529193,1.6941843587075027,1.6162500824022108,6.1714019348018,0.5077522894187941,35.86414782102903,30.87802293577138,33.257829243199595,7693273855
1481121000,221.52,224.67,221.38,224.6,NaN,NaN,206.16307692307691,229.4852830188679,211.4988950000001,216.44129699999993,215.99618399999991,219.56095999999988,217.20413315983856,219.44813459255715,220.7515384615385,223.5031516516177,217.9999252714593,211.4988950000001,216.44129699999993,215.99618399999991,219.56095999999988,223.55,110738050,91270869.05,73.32043380088388,1.560000927490212,1.5,2.75,NaN,NaN,1.6825048929793955,1.213290189439694,806.2353778315924,0.2572246695095881,1.937780919289196,1.6805562497796078,9.393278428754268,1.7671046669687385,76.68064357465268,4.583403038277818,18.735953387069504,7804011905
1481207400,224.57,225.7,224.26,225.15,NaN,NaN,206.06230769230768,229.61886792452827,211.64694500000007,216.53089699999998,216.16638399999994,219.99949999999984,217.51573578102136,219.991169393266,221.26307692307697,224.56725967656874,217.9588941695852,211.64694500000007,216.53089699999998,216.16638399999994,219.99949999999984,225.03666666666666,99714387,83335139.8,74.42281759221027,1.7448607767226634,1.5,2.75,NaN,NaN,1.6651831149094387,1.1965467057391317,809.2919225725416,0.37589467687901523,2.150424595878377,1.7745299189993617,9.36320153802565,1.6386782231852632,100,0,0,7903726292
1481293800,225.41,226.53,225.37,226.51,NaN,NaN,205.96153846153845,229.75245283018864,211.80404900000008,216.62514699999997,216.40298399999992,220.47899999999987,217.86845202490287,220.61201040343116,221.7523076923077,226.00081985790302,217.5037955267124,211.80404900000008,216.62514699999997,216.40298399999992,220.47899999999987,226.13666666666666,88005766,79129762.45,76.95813629866352,1.8772582506568758,1.5,2.75,NaN,NaN,1.644812892415907,1.1121702286874489,808.4623612167572,0.5011836906280347,2.401009532284405,1.8998258416563705,9.608335871092507,2.734941944847606,100,0,0,7991732058
1481553000,226.4,226.96,225.76,226.25,NaN,NaN,205.86076923076922,229.88603773584902,211.9674990000001,216.72499699999997,216.60198399999993,220.97049999999984,218.19714018078903,221.14896179358058,222.18846153846155,226.99371408863308,217.38320898829002,211.9674990000001,216.72499699999997,216.60198399999993,220.97049999999984,226.32333333333332,102016125,79202932.1,75.41899071936828,1.6658849230581574,1.5,2.75,NaN,NaN,1.613040542957629,1.288034701432474,805.2794455124144,0.5195265978187269,2.5492340889297793,2.0297074911110524,8.858426491299337,2.4172740029876434,74.32458912490416,5.5128964849238,20.16251439017204,7889715933
1481639400,227.02,228.34,227,227.76,NaN,NaN,205.76,228.34,212.1157490000001,216.83019699999994,216.84158399999993,221.52899999999985,218.57215429134632,221.77858447990624,222.7315384615385,228.27954903305547,217.1835278900215,212.1157490000001,216.83019699999994,216.84158399999993,221.52899999999985,227.7,110477485,79997807.25,78.1519106249886,1.991000817096196,1.5,2.75,NaN,NaN,1.647109075603513,1.3810064150227068,807.900856367621,0.5816493505552685,2.756769179305138,2.1751198287498696,9.14105119402679,3.348761230601686,77.35733297120473,4.356697927488891,18.285969101306375,8000193418
1481725800,227.41,228.23,225.365,225.88,NaN,NaN,205.65923076923076,228.4520512820513,212.25014900000008,216.92249699999994,217.06558399999992,221.90899999999988,218.85873647599942,222.16919548181994,223.0669230769231,228.8052979989153,217.3285481549309,212.25014900000008,216.92249699999994,217.06558399999992,221.90899999999988,226.49166666666667,142501812,82540268.85,68.01313377882374,1.2773779372924348,1.5,2.75,NaN,NaN,1.734101284488975,1.7264519971332757,803.3422943350413,0.4502883081046103,2.7379802138806326,2.2876919057760223,10.880527255706848,2.8737987885412406,42.03465011770574,25.411270373027396,32.55407950926685,7857691606
1481812200,226.16,227.81,225.8904,226.81,NaN,NaN,205.55846153846153,228.56410256410257,212.38532400000008,217.02309699999995,217.28918399999992,222.3559999999999,219.17055073184258,222.61117686450376,223.55384615384617,229.4046924487621,217.70299985893024,212.38532400000008,217.02309699999995,217.28918399999992,222.3559999999999,226.8368,124972554,85508011.7,70.08091262977659,1.199666308462199,1.5,2.75,NaN,NaN,1.74809404988262,1.4615303468692395,805.4415743888183,0.38284287133324657,2.7662454949425808,2.383402623609334,10.16677985365507,3.245630007283319,44.97032189201995,22.997267213023278,32.03241089495677,7982664160
1481898600,226.01,226.08,224.67,225.04,NaN,NaN,205.4576923076923,228.67615384615385,212.5083740000001,217.10829699999994,217.47438399999993,222.65849999999992,219.40072521294678,222.84249335359863,223.87153846153848,229.5599063288549,218.18317059422205,212.5083740000001,217.10829699999994,217.47438399999993,222.65849999999992,225.26333333333332,156420152,89839159.75,61.881741956170394,0.45124119259254875,1.5,2.75,NaN,NaN,1.7760873320338626,1.741113256571837,808.1568510363677,0.1858138305418331,2.6156699117866253,2.4298560812447922,11.95321884052902,1.8280542986425303,19.298698032067094,49.81680926487568,30.88449270305723,7826244008
1482157800,225.25,226.02,225.08,225.53,NaN,NaN,205.35692307692307,228.78820512820513,212.63307400000008,217.19589699999995,217.6841839999999,223.0099999999999,219.6410889300861,223.0984463675416,224.26769230769236,229.63658936585588,218.89879524952883,212.63307400000008,217.19589699999995,217.6841839999999,223.0099999999999,225.54333333333332,90341147,90042929.55,63.16649805034521,0.4931983969313527,1.5,2.75,NaN,NaN,1.7192239511743022,1.003311947439853,811.2293868279373,0.06169729801745305,2.5069777037666086,2.4452804057491555,11.734134891122903,1.7275597654488104,37.25979942745027,29.573119395113594,33.16708117743614,7916585155
1482244200,226.15,226.57,225.88,226.4,NaN,NaN,205.25615384615384,228.90025641025642,212.7730740000001,217.28869699999996,217.8889839999999,223.3224999999999,219.90614426616116,223.41288004682337,224.79307692307697,229.51850655507155,220.06764729108238,212.7730740000001,217.28869699999996,217.8889839999999,223.3224999999999,226.28333333333333,89838810,90914738.15,65.39654959988654,0.6939169233296982,1.5,2.75,NaN,NaN,1.6707079546618515,0.9881655255034136,813.815711562044,0.013897398481040657,2.462652153850456,2.4487547553694156,11.764961066990026,0.8014247551202188,34.95583784100593,31.754925526528027,33.28923663246604,8006423965
1482330600,226.25,226.45,225.77,225.77,NaN,NaN,205.1553846153846,229.0123076923077,212.90502400000008,217.37699699999996,218.13578399999992,223.58199999999994,220.13609939297837,223.63736766141162,225.2615384615385,228.96307116820154,221.56000575487545,212.90502400000008,217.37699699999996,218.13578399999992,223.58199999999994,225.99666666666667,67909039,90938742.25,62.44807800984521,0.5172314405594322,1.5,2.75,NaN,NaN,1.599943100757432,0.7467558635604508,812.8599597435988,-0.07932113498689652,2.349603336635795,2.4289244716226914,9.730363385438226,0.27537197423939797,44.945488985277244,22.95840524070054,32.096105774022206,7938514926
1482417000,225.6,225.74,224.92,225.38,NaN,NaN,205.05461538461537,229.12435897435898,213.03422400000008,217.47530499999996,218.3691839999999,223.81599999999995,220.34174255403803,223.80333264603908,225.59846153846158,228.36679729123182,222.83012578569134,213.03422400000008,217.47530499999996,218.3691839999999,223.81599999999995,225.34666666666666,56219071,90918683.95,60.62582565692139,0.1816765841791994,1.5,2.75,NaN,NaN,1.5463757364176172,0.6183445311517842,810.8699051060781,-0.18062349050934312,2.2031451084860123,2.3837685989953554,9.72290535399884,-0.4988742218886564,20.772688306332096,47.75687705342612,31.470434640241784,7882295855
1482503400,225.43,225.72,225.21,225.71,NaN,NaN,204.95384615384614,229.23641025641027,213.14897400000007,217.57060499999997,218.6231839999999,224.0254999999999,220.55226245387968,223.98492001308298,225.90692307692314,227.52266076719948,224.2911853866468,213.14897400000007,217.57060499999997,218.6231839999999,224.0254999999999,225.54666666666665,36697822,90859962.3,61.645679078390714,0.22110817162382812,1.5,2.75,NaN,NaN,1.4723488981020725,0.4038943124236802,812.8754943112,-0.23532179679524123,2.089616353001304,2.3249381497965453,9.036579411326331,-0.23867403314916774,53.49432588689105,16.66912141380521,29.83655269930374,7918993677
1482849000,226.02,226.73,226,226.27,NaN,NaN,204.8530769230769,229.34846153846155,213.26782400000005,217.66920799999997,218.88618399999987,224.31499999999997,220.7764874556883,224.20254667850367,226.0353846153847,227.4705177452207,224.60025148554868,213.26782400000005,217.66920799999997,218.88618399999987,224.31499999999997,226.33333333333334,42672487,89164961.1,63.37913828970919,0.4968978155170934,1.5,2.75,NaN,NaN,1.4400382625233517,0.47857910185304847,815.3902654884791,-0.2427278036363143,2.0215283952511527,2.264256198887467,9.158394262918359,-0.6541974007727348,45.42165578005942,22.601597459612478,31.976746760328126,7961666164
1482935400,226.57,226.59,224.27,224.4,NaN,NaN,204.75230769230768,229.46051282051283,213.37897400000006,217.731408,219.1265839999999,224.48949999999996,220.9185859868378,224.2213517567414,225.9776923076924,227.59880595799922,224.35657865738557,213.37897400000006,217.731408,219.1265839999999,224.48949999999996,225.08666666666667,64095014,88875377.3,54.51821072894423,0.24536426825502192,1.5,2.75,NaN,NaN,1.5028926723431117,0.7211785305129726,811.6019856902346,-0.3746273755866474,1.7959719794041575,2.170599354990805,9.208770011072408,-0.6552151584912298,11.813797001637647,61.323919245427334,26.862283752935014,7897571150
1483021800,224.48,224.89,223.84,224.35,NaN,NaN,204.65153846153845,229.57256410256412,213.48402400000006,217.79440799999998,219.3393839999999,224.68799999999996,221.05315124225592,224.23360397038508,225.81153846153853,227.61309071789225,224.00998620518482,213.48402400000006,217.79440799999998,219.3393839999999,224.68799999999996,224.36,48696080,85645591.65,54.29961449101633,0.32704287751136457,1.5,2.75,NaN,NaN,1.470543195747174,0.568576608110804,813.8557926956588,-0.46064070907453303,1.5947984686476389,2.055439177722172,8.131440642540966,-1.0846082624222952,13.879288604331837,57.84310574278746,28.27760565288073,7848875070
1483108200,224.73,224.83,222.73,223.53,NaN,NaN,222.73,229.6846153846154,213.57852400000007,217.84790799999996,219.5243839999999,224.88599999999997,221.15028256608903,224.16659406844363,225.6023076923078,227.75009587613602,223.45451950847956,213.57852400000007,217.84790799999996,219.5243839999999,224.88599999999997,223.69666666666672,108998328,87143483.7,50.708645685081336,0.678208759245513,1.5,2.75,NaN,NaN,1.5155043960509489,1.2507914920550738,812.16093310867,-0.5614741839721951,1.353596447756928,1.915070631729123,7.667667265528123,-0.6709918236757869,9.264542828718387,66.04806218716963,24.68739498411198,7739876742
1483453800,225.04,225.83,223.8837,225.24,NaN,NaN,223.10763157894735,229.79666666666668,213.68282400000007,217.92390799999998,219.75158399999992,225.16399999999993,221.31066364192867,224.26882320478234,225.40846153846164,227.16076720465685,223.65615587226642,213.68282400000007,217.92390799999998,219.75158399999992,225.16399999999993,224.98456666666667,91366522,87969792.45,57.08268031669907,0.20105887698658154,1.5,2.75,NaN,NaN,1.5715397963330247,1.0386124538367034,817.1366807425567,-0.5035723763195625,1.28560516132967,1.7891775376492325,8.08111494502496,-0.12858599742827653,18.20872957135635,51.2602714730842,30.530998955559447,7831243264
1483540200,225.62,226.75,225.61,226.58,NaN,NaN,223.48526315789474,229.90871794871796,213.79237400000008,218.00320799999997,220.00358399999993,225.44299999999993,221.51730428342165,224.48893528051735,225.46230769230777,227.3097034284262,223.61491195618936,213.79237400000008,218.00320799999997,220.00358399999993,225.44299999999993,226.31333333333336,78744433,88515123.05,61.30535746678764,0.6221129610296178,1.5,2.75,NaN,NaN,1.5671440965949508,0.889615585299692,823.3474837561834,-0.3716784695179245,1.324579450751827,1.6962579202697514,8.698336598989385,0.0795053003533599,24.613736487729202,42.90931023587246,32.476953276398326,7909987697
1483626600,226.27,226.58,225.48,226.4,NaN,NaN,223.8628947368421,230.02076923076925,213.9015740000001,218.082608,220.23378399999993,225.67799999999994,221.70878254681688,224.67094144427762,225.43076923076933,227.19728621296204,223.66425224857662,213.9015740000001,218.082608,220.23378399999993,225.67799999999994,226.1533333333333,78379012,89440204.8,60.445021237553725,0.3962459833087054,1.5,2.75,NaN,NaN,1.5337766611238846,0.8763286284424966,821.5800813288323,-0.2964775635617174,1.3256609658176046,1.622138529379322,8.44206299539232,0.2790450458431126,22.74764244040708,45.20609243362874,32.04626512596418,7831608685
1483713000,226.53,227.75,225.9,227.21,NaN,NaN,224.24052631578945,230.13282051282053,214.02157800000012,218.163808,220.49458399999992,225.80849999999992,221.92451656458877,224.9127565448226,225.5976923076924,227.58167670348567,223.61370791189913,214.02157800000012,218.163808,220.49458399999992,225.80849999999992,226.95333333333335,71559922,87481298.4,62.963818341557584,0.8188080885500829,1.5,2.75,NaN,NaN,1.5563640424721783,0.8180025137807053,820.4001843575907,-0.19689766844521284,1.376016443822806,1.5729141122680188,8.462517183418232,0.8119620197000676,41.58820550393405,25.724945220597846,32.686849275468106,7903168607
1483972200,226.91,227.0701,226.4163,226.46,NaN,NaN,224.61815789473684,230.2448717948718,214.1382780000001,218.248808,220.74898399999992,225.87399999999994,222.1023786600951,225.0601130643633,225.66923076923086,227.70469271320016,223.63376882526157,214.1382780000001,218.248808,220.74898399999992,225.87399999999994,226.64880000000002,46939676,84842562.85,59.204511626071124,0.4259077058086604,1.5,2.75,NaN,NaN,1.5018880394384515,0.55325622450831,817.2795055270096,-0.18636442381341212,1.3399585825012537,1.5263230063146658,8.669180271994518,0.33228479021753576,56.157709191138295,14.909058031277675,28.93323277758403,7856228931
1484058600,226.48,227.45,226.01,226.46,NaN,NaN,224.9957894736842,230.3569230769231,214.25437800000012,218.32970799999998,221.01478399999988,225.8714999999999,222.2732657714639,225.19343562966202,225.67384615384623,227.71617572056078,223.63151658713167,214.25437800000012,218.32970799999998,221.01478399999988,225.8714999999999,226.64,63771939,83630871.5,59.204511626071124,0.3964790274885143,1.5,2.75,NaN,NaN,1.4974674651928477,0.7625406486407355,820.0297121308189,-0.18390805459132187,1.2964379380755133,1.4803459926668352,8.649033213011318,0.08397047774782239,39.860620540390556,27.20905906754659,32.93032039206286,7856228931
1484145000,226.36,227.1,225.59,227.1,NaN,NaN,225.37342105263156,230.46897435897438,214.3642740000001,218.41210799999996,221.30598399999988,225.91399999999993,222.4625494667006,225.37501318874183,225.77615384615393,227.95611204560976,223.5961956466981,214.3642740000001,218.41210799999996,221.30598399999988,225.91399999999993,226.59666666666666,74650016,82262566.05,61.48057611790514,0.31696822440629957,1.5,2.75,NaN,NaN,1.4983626462505006,0.9074603380914107,823.3920421500012,-0.14538041283402192,1.2986204766243077,1.4440008894583296,8.68238761989212,1.2032085561497274,38.94262704966926,28.024386154756883,33.032986795573855,7930878947
1484231400,226.5,226.75,224.955,226.53,NaN,NaN,225.75105263157894,230.58102564102563,214.46682400000012,218.49200799999994,221.5855839999999,225.8524999999999,222.62205733075157,225.48501193267117,225.86461538461546,228.06631564203997,223.66291512719096,214.46682400000012,218.49200799999994,221.5855839999999,225.8524999999999,226.07833333333335,72113181,80344350.85,58.35773137841791,0.15662286408960763,1.5,2.75,NaN,NaN,1.5445510286611779,0.8975513553483394,820.9553435637989,-0.16315170076427954,1.2400612635029802,1.4032129642672597,7.05571567704529,0.9716960106975738,40.715808195818205,26.462352176102,32.82183962807978,7858765766
1484317800,226.73,227.4,226.69,227.05,NaN,NaN,226.1286842105263,230.69307692307692,214.57447400000015,218.57720799999996,221.9063839999999,225.91099999999992,222.79570214131033,225.63405841527393,225.9676923076924,228.25460697555235,223.68077763983246,214.57447400000015,218.57720799999996,221.9063839999999,225.91099999999992,227.0466666666667,62717865,76355153.5,60.33702802379039,0.371340461004902,1.5,2.75,NaN,NaN,1.496368812328237,0.8213966199413115,823.3208431379469,-0.14534535756270506,1.2215312673138783,1.3668766248765833,7.051095216935701,1.5747326980718517,38.534381075683584,28.3916325325658,33.073986391750616,7921483631
1484663400,226.31,226.78,225.8,226.25,NaN,NaN,226.50631578947366,230.8051282051282,214.67112400000016,218.65000799999996,222.23658399999988,225.8829999999999,222.9311648024354,225.69271951858119,225.96615384615396,228.25227973889687,223.68002795341104,214.67112400000016,218.65000799999996,222.23658399999988,225.8829999999999,226.27666666666667,61240814,73168566.5,55.9323807149433,0.03529530677400222,1.5,2.75,NaN,NaN,1.4787710400190772,0.8369825586237226,821.6632627279715,-0.19008112712425707,1.129275215971262,1.319356343095519,7.018223967324427,0.4484105842656681,35.14713932887428,31.566411906962806,33.28644876416291,7860242817
1484749800,226.535,226.8,225.9,226.75,NaN,NaN,226.88394736842105,230.91717948717948,214.77362400000015,218.73900799999996,222.59598399999987,225.9684999999999,223.08092304547716,225.79341289776394,226.14692307692317,228.27530107420975,224.0185450796366,214.77362400000015,218.73900799999996,222.59598399999987,225.9684999999999,226.48333333333335,54793302,68087224,57.99624004513502,0.11012748472812085,1.5,2.75,NaN,NaN,1.4374302514462864,0.8047515933385682,823.2239175791018,-0.18827576205975305,1.0840116405208278,1.2722874025805808,5.791875857972398,0.0750286874393095,46.802718000503596,21.498209898808756,31.69907210068763,7915036119
1484836200,226.84,227,225.41,225.91,NaN,NaN,227.2615789473684,231.02923076923076,214.88222800000017,218.82110799999995,222.9431839999999,225.9874999999999,223.19186723977217,225.80451643131025,226.26692307692318,228.1367216611255,224.39712449272085,214.88222800000017,218.82110799999995,222.9431839999999,225.9874999999999,226.10666666666665,66608787,66900606,53.465894710978084,0.1362669563273661,1.5,2.75,NaN,NaN,1.4483280906286946,0.9956380215748718,819.2487197472703,-0.24248050665284504,0.9691867692645246,1.2116672759173697,5.20008296759979,-0.21643109540636443,18.451265106495647,50.91793552658206,30.630799366922304,7848427332
1484922600,226.7,227.31,225.9719,226.74,NaN,NaN,227.63921052631576,231.14128205128205,214.9838280000002,218.91560799999996,223.2149839999999,226.00449999999992,223.33100970095757,225.89361010451879,226.5138461538462,227.5219529387748,225.5057393689176,214.9838280000002,218.91560799999996,223.2149839999999,226.00449999999992,226.67396666666664,129168623,68867096.65,57.03705241125097,0.1623886985441758,1.5,2.75,NaN,NaN,1.4448760841552168,1.8756217305989766,821.9152098544197,-0.22182163990356019,0.9343902260379195,1.1562118659414797,5.653064617208045,-0.20685709255754536,56.77689150952171,14.524984506516654,28.698123983961636,7977595955
1485181800,226.35,226.805,225.27,226.15,NaN,NaN,228.01684210526315,231.25333333333333,215.0948280000002,218.99349999999998,223.45578399999988,226.02349999999987,223.4415583401357,225.9180281898027,226.58384615384622,227.3174164937937,225.85027581389875,215.0948280000002,218.99349999999998,223.45578399999988,226.02349999999987,226.07500000000002,75061645,69224726.95,53.872148290583574,0.11315135991947943,1.5,2.75,NaN,NaN,1.4513135067155585,1.084318397589577,823.2675518336649,-0.24543819008003465,0.8494141283414365,1.0948523184214711,5.391067503659573,-0.13688951691248002,30.15885450803312,36.61210560074904,33.22903989121785,7902534310
1485268200,226.4,228.08,226.27,227.6,NaN,NaN,228.3944736842105,231.3653846153846,215.2103320000002,219.08949999999996,223.6801999999999,226.1344999999999,223.6046344836598,226.07821598125005,226.66230769230776,227.57401459002523,225.7506007945903,215.2103320000002,219.08949999999996,223.6801999999999,226.1344999999999,227.31666666666672,95555295,71191538.15,59.77901131410274,0.5408068154281883,1.5,2.75,NaN,NaN,1.4855053990930192,1.342228268739829,827.3779470503332,-0.16482025777321296,0.8888269962049549,1.0536472539781678,6.313522281657166,0.5034001589684652,56.7856164029505,14.50991121293266,28.70447238411682,7998089605
1485354600,228.7,229.57,228.51,229.57,NaN,NaN,228.77210526315787,231.4774358974359,215.3380815000002,219.21139999999997,223.93319999999989,226.32749999999987,223.83857038626138,226.4107668401786,226.90615384615393,228.6876232216733,225.12468447063455,215.3380815000002,219.21139999999997,223.93319999999989,226.32749999999987,229.21666666666664,84437712,73578532.65,66.12569645202643,1.051530620766745,1.5,2.75,NaN,NaN,1.5201121563006605,1.1475862450486092,830.3940329565282,0.010464547462699425,1.066727938306542,1.0562633908438426,7.816697622636308,1.0876265962131215,60.13095829591027,12.477668561732076,27.391373142357647,8082527317
1485441000,229.4,229.71,229.01,229.33,NaN,NaN,229.14973684210526,231.58948717948718,215.45513150000022,219.33079999999998,224.19139999999987,226.48049999999984,224.0539205671923,226.6887890458759,227.06923076923084,229.27071923822228,224.8677423002394,215.45513150000022,219.33079999999998,224.19139999999987,226.48049999999984,229.35000000000002,59970719,74443444.25,64.78449205579031,0.9116440467467112,1.5,2.75,NaN,NaN,1.4615327165649004,0.8055876458187922,829.3294516616835,0.0948351076561007,1.1748072754139685,1.0799721677578678,7.867555895424012,1.2360393766830051,61.41809807644037,11.7351853654724,26.84671655808722,8022556598
1485527400,229.42,229.59,228.76,228.97,NaN,NaN,229.5273684210526,231.70153846153846,215.5599775000002,219.4368,224.43899999999988,226.7089999999999,224.24670799592985,226.90604723198294,227.26230769230776,229.6487070249878,224.87590835962772,215.5599775000002,219.4368,224.43899999999988,226.7089999999999,229.10666666666665,59711118,74224249.45,62.72921440275759,0.7000733983298991,1.5,2.75,NaN,NaN,1.4164232368102656,0.8044691383538133,827.2081313181238,0.10992526812575965,1.2173787529150673,1.1074534847893076,7.732384858305338,0.8456287161418135,30.763736612455798,35.97085070649147,33.26541268105274,7962845480
1485786600,228.17,228.2,226.41,227.55,NaN,NaN,229.90499999999997,231.81358974358974,215.6576775000002,219.52199199999998,224.62439999999984,226.86899999999986,224.37624885883457,226.96737606703218,227.34615384615392,229.69012205885716,225.0021856334507,215.6576775000002,219.52199199999998,224.62439999999984,226.86899999999986,227.38666666666668,79737252,75776308.05,55.27958386996177,0.12287904765191406,1.5,2.75,NaN,NaN,1.4981072913238183,1.0522715351529983,823.1639672317032,0.01290349951744596,1.123582859186115,1.110679359668669,8.718346527213155,0.574585635359121,29.967077966121074,36.817004075800476,33.215917958078435,7883108228
1485873000,226.98,227.6,226.32,227.53,NaN,NaN,230.28263157894736,231.92564102564103,215.7564275000002,219.607192,224.81759999999983,227.06899999999987,224.49992537417438,227.0209592987434,227.37923076923087,229.7205053929597,225.03795614550205,215.7564275000002,219.607192,224.81759999999983,227.06899999999987,227.15,75880805,74120431.9,55.180186616260514,0.1809708954834622,1.5,2.75,NaN,NaN,1.4825281990864028,1.0237501732636287,825.6782123612458,-0.05998649317737348,1.035696243196952,1.0956827363743256,8.395233084832148,0.3439911797133412,6.774619129426296,71.25445797790083,21.97092289267287,7807227423
1485959400,228.255,228.59,226.94,227.62,NaN,NaN,230.66026315789472,232.0376923076923,215.8483315000002,219.698292,224.99019999999985,227.18799999999987,224.6222812418538,227.07801079410117,227.46307692307698,229.75422892909322,225.17192491706075,215.8483315000002,219.698292,224.99019999999985,227.18799999999987,227.71666666666667,79117651,73507988.35,55.56736304127696,0.08271113159081145,1.5,2.75,NaN,NaN,1.4944904705802315,1.0763136466650431,824.6522340091606,-0.10677347800585468,0.9622158888670072,1.0689893668728618,8.329751055189858,0.7569386038688009,5.996320478438244,73.07142343719057,20.932256084371193,7886345074
1486045800,227.2,228.1,226.82,227.77,NaN,NaN,231.03789473684208,232.1497435897436,215.93768150000017,219.84319200000002,225.17559999999986,227.2474999999999,224.74572119315366,227.14391452799632,227.5184615384616,229.80179036550882,225.23513271141437,215.93768150000017,219.84319200000002,225.17559999999986,227.2474999999999,227.5633333333333,69657560,73053644.7,56.245773147085295,0.013338741751210206,1.5,2.75,NaN,NaN,1.4791697226816436,0.9535124535682474,826.226234478499,-0.13067453396299045,0.9056461994191238,1.0363207333821143,7.9118067464704165,0.45426479668342645,21.972796224226258,46.174647272146935,31.852556503626804,7956002634
1486132200,228.82,229.55,228.46,229.34,NaN,NaN,231.41552631578946,232.26179487179488,216.03388150000018,219.973192,225.35939999999988,227.39449999999994,224.92588898950058,227.35306552533,227.75615384615392,230.1042272096996,225.40808048260826,216.03388150000018,219.973192,225.35939999999988,227.39449999999994,229.11666666666667,80563168,73162852.5,62.67025769749461,0.6766159926923,1.5,2.75,NaN,NaN,1.500657599632955,1.1011485370940124,830.6042096573535,-0.048059283913052475,0.9762466284907987,1.0243059124038512,8.52174545364756,1.4105682069422938,46.84557482363696,21.45302715459029,31.701398021772743,8036565802
1486391400,228.87,229.326,228.54,228.93,NaN,NaN,231.79315789473682,232.37384615384616,216.13368150000016,220.13019200000002,225.52639999999988,227.48049999999995,225.08291295069662,227.50324976101285,227.9238461538462,230.27191951739186,225.57577279030053,216.13368150000016,220.13019200000002,225.52639999999988,227.48049999999995,228.93200000000002,57790108,72474361.8,60.18497801839868,0.4176760064651582,1.5,2.75,NaN,NaN,1.4506106282306017,0.797386918141858,828.0668694676873,-0.029261942274039443,0.9877284845613019,1.0169904268353414,8.40281702767413,0.5843585237258403,54.390119034656806,16.16055545851516,29.44932550682803,7978775694
1486477800,229.38,229.6556,228.72,228.94,NaN,NaN,232.1707894736842,232.48589743589744,216.23353150000017,220.288092,225.69119999999987,227.60449999999992,225.2341712663556,227.64008311710685,228.15692307692314,230.24641892501623,226.06742722883004,216.23353150000017,220.288092,225.69119999999987,227.60449999999992,229.10519999999997,57931151,73023935.55,60.22640749387648,0.4331461823811479,1.5,2.75,NaN,NaN,1.4138241547855583,0.7933172947154312,826.6159169674672,-0.024579704289561244,0.9862657964733899,1.010845500762951,7.738824764156472,-0.2744261009713793,81.76491446840207,2.910832573809889,15.32425295778805,8036706845
1486564200,228.61,229.39,228.31,229.24,NaN,NaN,232.54842105263157,232.59794871794873,216.33668150000017,220.42769200000004,225.84559999999988,227.7434999999999,225.3912625892436,227.79245615357286,228.34923076923084,230.33952199703725,226.35893954142443,216.33668150000017,220.42769200000004,225.84559999999988,227.7434999999999,228.98000000000002,51566218,72413649.5,61.52001724877081,0.4155835335331622,1.5,2.75,NaN,NaN,1.3899795723008743,0.7121063274127621,828.1902842939296,-0.010426845847754995,0.9978119434532573,1.0082387893010123,5.8810914238431575,-0.039244756464484984,79.97869326490373,3.471049352377998,16.55025738271828,8088273063
1486650600,229.56,230.95,229.52,230.6,NaN,NaN,232.92605263157893,232.71,216.44508550000018,220.59999200000001,226.0479999999999,227.9184999999999,225.59552680143014,228.059841281804,228.69153846153853,230.57916368758103,226.80391323549603,216.44508550000018,220.59999200000001,226.0479999999999,227.9184999999999,230.35666666666668,65955245,71978910.95,66.79283330611241,0.913546891018396,1.5,2.75,NaN,NaN,1.4128381742793816,0.9163134608387681,831.1296106860881,0.07659058633184257,1.1039770222158154,1.0273864358839728,6.7765080360869385,0.711883652880288,79.76897248288594,3.539739447493376,16.691288069620658,8154228308
1486737000,231,231.77,230.6216,231.51,NaN,NaN,233.3036842105263,232.8220512820513,216.5558855000002,220.780992,226.25999999999988,228.16749999999993,225.82746692686425,228.3884278263941,228.99230769230778,231.28989376796358,226.69472161665198,216.5558855000002,220.780992,226.25999999999988,228.16749999999993,231.30053333333333,66015892,71674046.5,69.77705886164652,1.0758557267547653,1.5,2.75,NaN,NaN,1.3954925904022841,0.9210571360722601,834.7563256217412,0.17582400996764957,1.2471664483435347,1.0713424383758852,6.881337561859215,1.7402768622280727,78.6851786457163,3.9043808384445966,17.410440515839102,8220244200
1486996200,232.08,233.07,232.05,232.77,NaN,NaN,233.68131578947367,232.93410256410257,216.68249800000015,220.97449200000003,226.50779999999992,228.45349999999993,226.09972312581075,228.80572041435656,229.2384615384616,232.29213369005132,226.18478938687187,216.68249800000015,220.97449200000003,226.50779999999992,228.45349999999993,232.63,55182050,71297255.75,73.34844067556419,1.3882020432036977,1.5,2.75,NaN,NaN,1.4072431196592639,0.7739715844533048,836.9607868082462,0.29944764419463565,1.4456519936191796,1.146204349424544,5.444824528509059,2.3029930119105213,100,0,0,8275426250
1487082600,232.56,233.71,232.16,233.7,NaN,NaN,234.05894736842103,233.04615384615386,216.81934400000011,221.15329200000005,226.79039999999995,228.82599999999994,226.39777319930838,229.27184227965594,229.57461538461544,233.44696005604254,225.70227071318834,216.81934400000011,221.15329200000005,226.79039999999995,228.82599999999994,233.18999999999997,71108983,71790664.2,75.63683253758441,1.4183576965826001,1.5,2.75,NaN,NaN,1.4174400396836029,0.9905045982288042,837.8256379397566,0.41013570390574006,1.658873979306719,1.248738275400979,5.300272677328302,2.671118530884801,100,0,0,8346535233
1487169000,233.45,235.14,233.39,234.92,NaN,NaN,234.43657894736842,233.15820512820514,216.9540940000001,221.33069200000003,227.09519999999992,229.23449999999994,226.73197817188452,229.80976206254584,230.03230769230777,234.81105006851104,225.2535653161045,216.9540940000001,221.33069200000003,227.09519999999992,229.23449999999994,234.48333333333332,86785826,73390290.4,78.27243764992247,1.678551350794499,1.5,2.75,NaN,NaN,1.4411943225633457,1.1825246299883831,839.831124918517,0.5244858853966112,1.9043456321467431,1.379859746750132,5.262015773622132,3.1391315801027253,100,0,0,8433321059
1487255400,234.96,235.155,233.85,234.72,NaN,NaN,234.81421052631578,233.27025641025642,217.09689800000012,221.51799200000002,227.3695999999999,229.67499999999995,227.04523392984984,230.2774037708748,230.5838461538462,235.7302058139779,225.4374864937145,217.09689800000012,221.51799200000002,227.3695999999999,229.67499999999995,234.57500000000002,84722437,74295972.9,76.80555931138363,1.3586089745769718,1.5,2.75,NaN,NaN,1.4314661566659643,1.1403368674374004,837.3680644915955,0.5433204963569975,2.059010367196379,1.5156898708393813,5.585044418935721,2.345862038894216,71.60556288705357,6.621045650074786,21.773391462871658,8348598622
1487341800,233.95,235.09,233.93,235.09,NaN,NaN,235.19184210526313,233.3823076923077,217.2472980000001,221.726492,227.6373999999999,230.09249999999997,227.36071495220867,230.73574626888671,231.16538461538465,236.50491277306992,225.8258564576994,217.2472980000001,221.726492,227.6373999999999,230.09249999999997,234.70333333333335,77204104,71697746.95,77.64040383630807,1.1859831945270647,1.5,2.75,NaN,NaN,1.4120757169041094,1.0767995827517423,835.9511750260493,0.5364381877861317,2.186237605572046,1.6497994177859143,5.046609616762835,2.6907788406936604,72.66967764206036,6.164862256435515,21.165460101504117,8425802726
1487687400,235.52,236.69,235.51,236.49,NaN,NaN,235.56947368421052,233.494358974359,217.40489800000006,221.93569200000002,227.8751999999999,230.60949999999997,227.71872613055342,231.28377043375465,231.84769230769234,237.46056297782872,226.23482163755597,217.40489800000006,221.93569200000002,227.8751999999999,230.60949999999997,236.23000000000005,88946051,72391967.25,80.50035948873844,1.6209637393506473,1.5,2.75,NaN,NaN,1.425498879982387,1.228672936775316,839.3608917627151,0.5783073368523217,2.3726835888513165,1.7943762519989948,4.5848049767016175,3.2978072857517304,75.61261375546803,4.983535363989486,19.403850880542482,8514748777
1487773800,236.02,236.54,235.83,236.28,NaN,NaN,235.94710526315788,233.60641025641027,217.55769800000004,222.132092,228.09779999999992,231.04349999999994,228.0544623607278,231.7596018210161,232.50230769230774,238.04476010059443,226.95985528402105,217.55769800000004,222.132092,228.09779999999992,231.04349999999994,236.21666666666667,62115185,70719961.75,78.87073635458731,1.3461803038389426,1.5,2.75,NaN,NaN,1.3743918171265006,0.8783260548072906,837.4932729579266,0.5444735869665145,2.474968235707138,1.9304946487406234,4.846308811108583,3.0710172744721653,52.73976089901765,17.175516477820775,30.084722623161568,8452633592
1487860200,236.88,236.9,235.56,236.44,NaN,NaN,236.32473684210524,233.71846153846155,217.7104520000001,222.349692,228.29639999999992,231.38699999999994,228.3833069740326,232.20535402853838,233.0484615384616,238.6359081613152,227.461014915608,217.7104520000001,222.349692,228.29639999999992,231.38699999999994,236.30000000000004,74615902,70228871.25,79.21596325915914,1.2105612412416233,1.5,2.75,NaN,NaN,1.3719352587603222,1.0624676243817601,839.1285580411371,0.487335917875245,2.53966454608468,2.052328628209435,4.946791522304186,2.532523850823939,51.12758197441825,18.298258130458002,30.574159895123753,8527249494
1487946600,235.46,236.7932,235.41,236.74,NaN,NaN,236.70236842105263,233.83051282051284,217.85190200000008,222.55409200000003,228.50619999999992,231.75749999999994,228.71102042603133,232.63722507343948,233.64923076923085,239.0111274574023,228.2873340810594,217.85190200000008,222.55409200000003,228.50619999999992,231.75749999999994,236.3144,82381612,71349415.9,79.87976631595116,0.9657046300633119,1.5,2.75,NaN,NaN,1.3727398831345863,1.1546220941102336,839.7913191869873,0.4264107905269632,2.585342116368139,2.1589313258411758,4.689293743602667,2.259081681136892,81.64470903885724,2.9203643129996975,15.43492664814306,8609631106
1488205800,236.64,237.31,236.35,237.11,NaN,NaN,237.07999999999998,233.94256410256412,218.0049520000001,222.76739200000003,228.69319999999993,232.16449999999992,229.0403921740301,233.0632036378738,234.27769230769238,239.17989999776879,229.37548461761597,218.0049520000001,222.76739200000003,228.69319999999993,232.16449999999992,236.92333333333332,56515440,71189632,80.69854141918537,1.1102266368004532,1.5,2.75,NaN,NaN,1.3432584629106878,0.7938717817785601,842.0433024399065,0.36980091358961253,2.6211824678281914,2.251381554238579,4.644472064320821,1.8645014391889003,81.07897087717849,3.1053654357661356,15.815663687055375,8666146546
1488292200,236.67,236.95,236.015,236.47,NaN,NaN,237.45763157894734,234.0546153846154,218.1545020000001,222.98529200000004,228.90499999999992,232.61049999999992,229.331749343676,233.3876604342668,234.83384615384622,238.89149639059568,230.77619591709677,218.1545020000001,222.98529200000004,228.90499999999992,232.61049999999992,236.47833333333332,96961938,72050866.3,75.01227896147489,0.7290346397390959,1.5,2.75,NaN,NaN,1.3255257155599265,1.3457428477858566,839.2381003298074,0.25356464376104526,2.5683373589398855,2.31477271517884,5.025691527805152,1.1852802738553745,45.20622598233201,22.79662198340012,31.997152034267874,8569184608
1488378600,238.39,240.32,238.37,239.78,NaN,NaN,237.83526315789473,240.32,218.32960200000008,223.22679200000002,229.16439999999994,233.2229999999999,229.74148466353185,233.99645467862234,235.5400000000001,239.59979158236527,231.48020841763494,218.32960200000008,223.22679200000002,229.16439999999994,233.2229999999999,239.49,149158170,75714734.55,82.05496384660559,1.8846451473942705,1.5,2.75,NaN,NaN,1.5058453073056455,1.970001887829375,842.9913597828347,0.3575508503249636,2.761711278085045,2.404160427760081,8.65919471832754,2.0687893751064252,75.92862277806837,4.881735983954982,19.189641237976655,8718342778
1488465000,239.56,239.57,238.21,238.27,NaN,NaN,238.2128947368421,240.55038461538462,218.48705200000006,223.45169200000004,229.42899999999995,233.75549999999993,230.07593624535414,234.40345899494403,236.06000000000012,239.62318785531173,232.4968121446885,218.48705200000006,223.45169200000004,229.42899999999995,233.75549999999993,238.6833333333333,70245978,75271150.9,72.07498126825382,1.1798951197244938,1.5,2.75,NaN,NaN,1.5104277853552417,0.9332390585248777,838.9796123272913,0.28570103958208604,2.761286727237689,2.475585687655603,9.818974129768543,1.5124403544648992,53.9505445053563,16.400714703136767,29.64874079150694,8648096800
1488551400,238.17,238.61,237.73,238.42,NaN,NaN,238.59052631578945,240.78076923076924,218.65489800000006,223.685492,229.68679999999992,234.28799999999993,230.40315443181083,234.78598670971127,236.4946153846155,239.70770989479294,233.2815208744381,218.65489800000006,223.685492,229.68679999999992,234.28799999999993,238.25333333333336,81974300,75886987.9,72.43365788251636,0.8835187011888134,1.5,2.75,NaN,NaN,1.4653972292584405,1.0802154923848282,839.7176607316351,0.21269325698311237,2.741452258884493,2.528759001901381,9.730421200526845,1.4164787953549636,53.97079555691999,16.387158101004434,29.64204634207558,8730071100
1488810600,237.5,238.12,237.01,237.71,NaN,NaN,238.96815789473683,241.01115384615383,218.81889800000005,223.900992,229.91299999999993,234.70649999999992,230.68969739526923,235.06446416592925,236.80307692307707,239.63059428602455,233.9755595601296,218.81889800000005,223.900992,229.91299999999993,234.70649999999992,237.61333333333334,55391533,74628406.15,67.98263953726045,0.5919873559068536,1.5,2.75,NaN,NaN,1.461440284311409,0.7422312207588262,836.0537948711705,0.08741890682257214,2.638032635429596,2.550613728607024,10.073107178768494,0.5158780498118308,35.35353699924255,31.359670060672666,33.28679294008478,8674679567
1488897000,237.36,237.77,236.76,237,NaN,NaN,239.3457894736842,241.24153846153845,218.98289800000006,224.136692,230.1375999999999,235.1099999999999,230.93716024251358,235.24880091203121,236.96307692307707,239.57330985833298,234.35284398782116,218.98289800000006,224.136692,230.1375999999999,235.1099999999999,237.17666666666665,65103737,74994087.6,63.763026981079065,0.2771822980520495,1.5,2.75,NaN,NaN,1.4291945497177383,0.8681182621655098,832.6932994771952,-0.06424727224406723,2.47030463830194,2.534551910546007,9.807130545810493,0.30472320975114225,40.63394773319522,26.537847532334347,32.82820473447044,8609575830
1488983400,237.34,237.64,236.4,236.56,NaN,NaN,239.72342105263155,241.47192307692308,219.13824800000006,224.36519200000004,230.3611999999999,235.49099999999993,231.157663762415,235.3736770156473,237.10461538461553,239.39263926000442,234.81659150922664,219.13824800000006,224.36519200000004,230.3611999999999,235.49099999999993,236.86666666666667,78168795,76005969.8,61.226760703238206,0.15000833633535526,1.5,2.75,NaN,NaN,1.415680653309327,1.0284559910976887,828.7038555747694,-0.20712754489113072,2.2756424794320935,2.4827700243232242,9.86257223814945,0.0507528336998835,6.8556865217326335,71.07654552205226,22.06776795621513,8531407035
1489069800,236.7,237.24,235.74,236.86,NaN,NaN,240.10105263157894,241.70230769230767,219.29649800000007,224.60369200000005,230.58419999999995,235.87199999999993,231.3812847913399,235.51523158558567,237.2407692307694,239.22331555829177,235.258222903247,219.29649800000007,224.60369200000005,230.58419999999995,235.87199999999993,236.61333333333334,90683918,77961854.8,62.32705473613571,0.015083572876671588,1.5,2.75,NaN,NaN,1.4217034637872321,1.1631831776275288,825.3972964367327,-0.28931380481760227,2.1211277683012213,2.4104415731188236,9.880565684076432,0.050688519050436996,29.306788136096785,37.536006332418204,33.15720553148501,8622090953
1489156200,237.97,238.02,236.59,237.69,NaN,NaN,240.4786842105263,241.9326923076923,219.44559800000007,224.84939200000005,230.81259999999995,236.2264999999999,231.62868538775794,235.72235238695845,237.33307692307704,239.27860251336858,235.3875513327855,219.44559800000007,224.84939200000005,230.81259999999995,236.2264999999999,237.4333333333333,81991652,78763675.15,65.26401338566477,0.29316066170385396,1.5,2.75,NaN,NaN,1.422296073516716,1.0409830654023258,828.3534322148624,-0.29466712735084544,2.042107663930267,2.3367747912811123,10.051594408024169,0.24461220530554767,29.26369378795548,37.58282910254454,33.15347710949999,8704082605
1489411800,237.62,237.86,237.24,237.81,NaN,NaN,240.85631578947365,242.16307692307691,219.58824800000005,225.10369200000005,231.08079999999995,236.5414999999999,231.87108988235568,235.92117596915287,237.45076923076934,239.31045425850203,235.59108420303664,219.58824800000005,225.10369200000005,231.08079999999995,236.5414999999999,237.63666666666668,57256824,78325721.75,65.68059096811035,0.31402909450463506,1.5,2.75,NaN,NaN,1.3649892111226654,0.7310092102662303,830.4533931824934,-0.296221358536477,1.9664980931105163,2.2627194516469933,10.025247401316202,0.5666680762887484,50.89187932237099,18.48240758591269,30.62571309171634,8761339429
1489498200,237.18,237.24,236.19,236.9,NaN,NaN,241.23394736842104,242.39346153846154,219.72604800000008,225.33559200000008,231.33179999999993,236.74799999999988,232.06830204383192,236.014397305424,237.48615384615397,239.28404215380542,235.68826553850252,219.72604800000008,225.33559200000008,231.33179999999993,236.74799999999988,236.7766666666667,59880778,78560658.15,59.82164568167088,0.04839762380053991,1.5,2.75,NaN,NaN,1.3832042674710467,0.7622234768663276,827.377313835184,-0.36036996283570977,1.812256998102356,2.1726269609380657,10.168628862740023,-1.201101009258485,52.171956190729965,17.58324245662481,30.244801352645226,8701458651
1489584600,237.56,239.44,237.29,238.95,NaN,NaN,241.6115789473684,242.62384615384616,219.86959800000008,225.58229200000008,231.64019999999994,237.01049999999987,232.33817255191695,236.29397851443125,237.65615384615396,239.554793658251,235.75751403405692,219.86959800000008,225.58229200000008,231.64019999999994,237.01049999999987,238.56000000000003,96081750,79809296.5,66.96975705828933,0.6571127928427597,1.5,2.75,NaN,NaN,1.465832534080257,1.2038917045209139,833.8186309394521,-0.27066709076921525,1.8342930974765466,2.104960188245762,7.723556504768607,0.28539052335584775,82.73878910345624,2.6039431334531873,14.657267763090571,8797540401
1489671000,239.11,239.2,238.1,238.48,NaN,NaN,241.98921052631576,242.85423076923075,220.01279800000012,225.82829200000006,231.90499999999992,237.18849999999983,232.57902853027315,236.50217103686637,237.76153846153858,239.6792108672714,235.84386605580576,220.01279800000012,225.82829200000006,231.90499999999992,237.18849999999983,238.59333333333333,78343951,79387202.75,64.15178556501144,0.5128209132766705,1.5,2.75,NaN,NaN,1.4397016387888095,0.9868586911509487,835.9435930373554,-0.2494390744660846,1.7931613451631563,2.042600419629241,6.849234349738461,0.025165674020636807,52.88300856240485,17.093681310696848,30.023310126898295,8719196450
1489757400,237.75,237.97,237.03,237.03,NaN,NaN,242.36684210526315,243.08461538461538,220.14659800000013,226.05879200000007,232.11399999999995,237.3039999999998,232.75357643104675,236.55244046192672,237.80461538461552,239.62710084529246,235.98212992393857,220.14659800000013,226.05879200000007,232.11399999999995,237.3039999999998,237.34333333333333,89002111,79601186.45,56.2832825106342,0.07592880420320547,1.5,2.75,NaN,NaN,1.4404372360181796,1.1181003069081767,838.5719092240064,-0.33421536730355905,1.6248312104997922,1.9590465778033512,7.689206706828667,-0.2860628496908026,22.341377852244197,45.7377325682686,31.92088957948722,8630194339
1490016600,237.03,237.36,236.32,236.77,NaN,NaN,242.7444736842105,243.315,220.2758980000001,226.27759200000008,232.32139999999995,237.38799999999983,232.91108323767236,236.5731604179337,237.57307692307705,239.06830800098246,236.07784584517165,220.2758980000001,226.27759200000008,232.32139999999995,237.38799999999983,236.8166666666667,52536979,78367830.2,54.98105616832302,0.19733734479232976,1.5,2.75,NaN,NaN,1.411834576302597,0.6703896084135809,836.4484472137291,-0.4042842297389615,1.4536912906296493,1.8579755203686108,7.549297061425816,-0.09704641350210538,8.2889463869534,67.97726385497927,23.733789758067335,8577657360
1490103000,237.47,237.61,233.58,233.73,NaN,NaN,243.1221052631579,243.5453846153846,220.3931480000001,226.4731920000001,232.45179999999996,237.24999999999983,232.94319762050873,236.30238323527334,237.2238461538463,239.70231389962015,234.74537840807244,220.3931480000001,226.4731920000001,232.45179999999996,237.24999999999983,234.97333333333336,131809275,80510991.4,42.576926776605866,1.067277353200596,1.5,2.75,NaN,NaN,1.598846392280983,1.637158761902912,831.8922386863921,-0.6379532940516914,1.0605339028039964,1.6984871968556878,10.402211753635273,-1.1963138315860722,5.746970878822664,73.67868427283774,20.57434484833959,8445848085
1490189400,233.77,234.61,233.05,234.28,NaN,NaN,243.49973684210525,243.7757692307692,220.50779800000012,226.67859200000007,232.6082,237.1499999999998,232.99562124323387,236.10977530810445,236.90538461538475,239.72733827999207,234.08343095077743,220.50779800000012,226.67859200000007,232.6082,237.1499999999998,233.98000000000002,97569204,82283692.35,44.99478518133299,1.0284656720772982,1.5,2.75,NaN,NaN,1.5960716499751988,1.1857659909691693,833.0815302462775,-0.7313550392602057,0.7842933977804307,1.5156484370406365,10.610559989138483,-1.0892510343662976,5.704886077568664,73.7818883004874,20.513225621943935,8543417289
1490275800,234,235.34,233.6,234.03,NaN,NaN,243.8773684210526,244.00615384615384,220.6195480000001,226.88719200000006,232.75960000000003,237.0294999999998,233.03618511604822,235.91170146923736,236.62230769230786,239.78263049806546,233.46198488655025,220.6195480000001,226.88719200000006,232.75960000000003,237.0294999999998,234.32333333333335,100410277,83573411.1,44.08611092582547,0.7388309756333324,1.5,2.75,NaN,NaN,1.6063522464055424,1.201461992257966,836.0216098024476,-0.7813308974425903,0.5389848152373986,1.320315712679989,10.514936729333998,-1.5398207749589787,5.186416250286634,75.08299420588445,19.730589543828913,8443007012
1490362200,234.38,235.04,232.96,233.86,NaN,NaN,244.255,244.23653846153846,220.7269980000001,227.10039200000006,232.89480000000003,236.8854999999998,233.06849158208553,235.71630132931,236.3807692307694,239.85325857538058,232.90827988615823,220.7269980000001,227.10039200000006,232.89480000000003,236.8854999999998,233.95333333333335,112504853,85079573.15,43.44362197512212,0.8008315512982269,1.5,2.75,NaN,NaN,1.6401842288051454,1.322348583033529,837.2707474360118,-0.7945822096014383,0.32708795067819096,1.1216701602796293,10.096132151076855,-1.6609898658592945,4.699993705696059,76.35856187264362,18.941444421660325,8330502159
1490621400,231.93,233.92,231.61,233.62,NaN,NaN,231.61,244.46692307692308,220.8346980000001,227.31109200000006,233.03660000000002,236.71099999999984,233.0901193631802,235.51665358366142,236.15461538461554,239.92143093733137,232.3877998318997,220.8346980000001,227.31109200000006,233.03660000000002,236.71099999999984,233.04999999999998,87454452,86626523.75,42.501907386242436,1.0215184676484113,1.5,2.75,NaN,NaN,1.6880282124619188,1.00955744515836,836.4939281031794,-0.786776854989405,0.13819909154287302,0.924975946532278,10.016083999120468,-1.38455044322499,3.682143074548399,79.29166985347071,17.026187071980893,8243047707
1490707800,233.27,235.81,233.14,235.32,NaN,NaN,231.76310344827587,244.69730769230767,220.9609480000001,227.55419200000009,233.20200000000006,236.6534999999998,233.17756566266334,235.49792467093175,236.036153846154,239.8036466950882,232.26866099721983,220.9609480000001,227.55419200000009,233.20200000000006,236.6534999999998,234.75666666666666,93483915,86452622.6,50.660421522358305,0.281814550281354,1.5,2.75,NaN,NaN,1.7581690544289257,1.081331163688723,839.8117587197119,-0.6405832677599219,0.12424686183237554,0.7648301295922975,11.137486800222952,-1.5191462649089749,18.72706888601627,50.59955707055122,30.67337404343252,8336531622
1490794200,234.99,235.81,234.725,235.54,NaN,NaN,231.91620689655173,244.9276923076923,221.0964020000001,227.81219200000007,233.38780000000006,236.44149999999982,233.27021014648045,235.50193184512872,235.87076923076938,239.5202535908678,232.22128487067096,221.0964020000001,227.81219200000007,233.38780000000006,236.44149999999982,235.35833333333332,60786374,82034032.8,51.61719065830908,0.10776571495960588,1.5,2.75,NaN,NaN,1.7100855505411459,0.7409897078715848,842.7518659914335,-0.5083044503736799,0.12944956662519758,0.6377540169988775,9.558171878364522,-1.23280778262328,13.995001164002074,57.69138832075324,28.313610515244676,8397317996
1490880600,235.47,236.52,235.27,236.29,NaN,NaN,232.0693103448276,245.15807692307692,221.23765200000008,228.08729200000008,233.57860000000008,236.3424999999998,233.38863327799103,235.57698595511647,235.7538461538463,239.24111123574193,232.26658107195067,221.23765200000008,228.08729200000008,233.57860000000008,236.3424999999998,236.02666666666667,56737890,81358628.4,54.83276457698613,0.30035474813608937,1.5,2.75,NaN,NaN,1.677222296931064,0.697380119549803,845.7115101712102,-0.35669952485386136,0.19187961093155081,0.5485791357854122,9.902879728013476,-0.31219676834156396,33.817314570456205,32.93040758204539,33.25227784749841,8454055886
1490967000,235.9,236.51,235.68,235.74,NaN,NaN,232.22241379310347,245.3884615384615,221.37760200000008,228.35919200000012,233.77520000000007,236.2084999999998,233.48084373767767,235.59251110224824,235.6646153846155,239.08879740155055,232.24043336768045,221.37760200000008,228.35919200000012,233.77520000000007,236.2084999999998,235.97666666666672,73733094,80946568.1,52.09827143185613,0.20514839784102926,1.5,2.75,NaN,NaN,1.6167064185788438,0.9108859798591017,846.4392883083847,-0.28307872246880006,0.1947307326994121,0.47780945516821216,9.407057533793159,-0.43502132871563165,41.10576539991278,26.196099943848616,32.698134656238594,8380322792
1491226200,235.8,236.03,233.91,235.33,NaN,NaN,232.37551724137933,245.61884615384614,221.51240200000007,228.58099200000012,233.9470000000001,236.08949999999976,233.55335966953345,235.56751004489126,235.38615384615397,238.23714599151586,232.5351617007921,221.51240200000007,228.58099200000012,233.9470000000001,236.08949999999976,235.09000000000003,85546486,82454315.75,50.092793895945654,0.19476635504333897,1.5,2.75,NaN,NaN,1.6526559601089268,1.0375016179792869,844.277183131669,-0.25261651517079076,0.16203881120472374,0.4146553263755145,9.428028727019983,0.68455054977967,41.566353283927405,25.786121091044272,32.64752562502832,8294776306
1491312600,235,235.58,234.555,235.48,NaN,NaN,232.52862068965518,245.84923076923076,221.6572020000001,228.7946920000001,234.1336000000001,236.01349999999974,233.62891419229683,235.55917575490162,235.15538461538475,237.38532929055353,232.92543994021597,221.6572020000001,228.7946920000001,234.1336000000001,236.01349999999974,235.205,56466195,82022438.65,50.838405288905676,0.1416597090405617,1.5,2.75,NaN,NaN,1.6078233915297182,0.6884237524435028,844.8701101929505,-0.2144885025203661,0.1465446982250569,0.361033200745423,5.235517511497436,0.5122076148198688,34.921962853622325,31.83060693070717,33.24743021567051,8351242501
1491399000,236.26,237.39,234.54,234.78,NaN,NaN,232.68172413793104,246.07961538461538,221.79185200000012,228.9787000000001,234.27720000000008,235.9244999999997,233.67405481220675,235.48496854014908,234.98230769230784,236.93548504600156,233.02913033861412,221.79185200000012,228.9787000000001,234.27720000000008,235.9244999999997,235.56999999999996,108800604,83554029.1,47.28789539310495,0.1607131484091292,1.5,2.75,NaN,NaN,1.696550292134738,1.3021586771092049,842.0321436579022,-0.22731059657426023,0.07689495502759769,0.3042055516018579,5.522166838947789,0.3204717343930265,10.486636529750427,63.73312082675127,25.7802426434983,8242441897
1491485400,234.94,236.04,234.425,235.44,NaN,NaN,232.83482758620693,246.31,221.9268520000001,229.1639000000001,234.3946000000001,235.8534999999997,233.74330756466924,235.48068582203965,234.88000000000014,236.56942411667782,233.19057588332245,221.9268520000001,229.1639000000001,234.3946000000001,235.8534999999997,235.30166666666665,69135757,82476621.05,50.77837672369783,0.055191699396420615,1.5,2.75,NaN,NaN,1.6907252712679697,0.8382467191288991,845.5242951367501,-0.1840849654631973,0.07409934477286129,0.2581843102360586,5.639460013579912,0.6756178910459181,12.232881731840388,60.613108631553324,27.15400963660629,8311577654
1491571800,235.15,236,234.64,235.2,NaN,NaN,232.98793103448278,246.5403846153846,222.0623520000001,229.35170000000014,234.5120000000001,235.72899999999973,233.80043275821163,235.45395383898824,234.99307692307704,236.5511503806939,233.43500346546017,222.0623520000001,229.35170000000014,234.5120000000001,235.72899999999973,235.27999999999997,74412311,82097654,49.494901708951986,0.06521796302470975,1.5,2.75,NaN,NaN,1.6671020376059729,0.9063877878897734,844.5711965339996,-0.16501199561646268,0.05191931571548025,0.21693131133194293,5.6670868810560915,0.6763119595924938,12.198428613289613,60.67253769672761,27.12903368998278,8237165343
1491831000,235.36,236.255,234.73,235.34,NaN,NaN,233.14103448275864,246.77076923076922,222.18500200000008,229.53920000000014,234.63940000000014,235.60549999999972,233.86080794416412,235.44310109241792,235.0746153846155,236.58510415693306,233.56412661229794,222.18500200000008,229.53920000000014,234.63940000000014,235.60549999999972,235.4416666666667,67615302,82615577.9,50.28431334717074,0.06564187392676614,1.5,2.75,NaN,NaN,1.6569518920626896,0.8184328394076391,847.4205907887575,-0.13745047456414655,0.04511821812675976,0.1825686926909063,5.575647271113094,0.008499065102843036,35.58051717998546,31.13987122896412,33.27961159105042,8304780645
1491917400,234.9,235.18,233.34,235.06,NaN,NaN,233.2941379310345,247.00115384615384,222.3446520000001,229.70700000000016,234.78960000000015,235.51349999999974,233.90783508360866,235.40661527409242,235.15384615384625,236.53976519821188,233.7679271094806,222.3446520000001,229.70700000000016,234.78960000000015,235.51349999999974,234.52666666666664,88045276,84023802.8,48.6466088037436,0.34728568047270897,1.5,2.75,NaN,NaN,1.681455328343926,1.0478611187067102,849.9721009458277,-0.1325034559120802,0.01693937280080604,0.14944282871288625,3.7864178198926486,-0.20378704254054078,14.729583551283925,56.44256266681057,28.827853781905496,8216735369
1492003800,234.74,234.96,233.77,234.03,NaN,NaN,233.44724137931036,247.23153846153843,222.5168020000001,229.86860000000016,234.91960000000014,235.26749999999976,233.91262586464362,235.27550905751218,235.16692307692318,236.5061854367983,233.82766071704808,222.5168020000001,229.86860000000016,234.91960000000014,235.26749999999976,234.25333333333336,81864436,83312937.1,43.087352283623204,0.4348097813274411,1.5,2.75,NaN,NaN,1.6534942334622165,0.9826137314273128,847.012255720029,-0.18955134582558403,-0.0874963535690938,0.10205499225649023,4.426303896258629,-0.9564518176816585,17.054041550620198,52.91243707227397,30.033521377105835,8134870933
1492090200,233.64,234.49,232.51,232.51,NaN,NaN,233.6003448275862,247.46192307692306,222.6633535000001,230.00380000000013,235.01740000000012,234.96899999999977,233.85762092877525,235.012127242511,235.08153846153857,236.87045899811508,233.29261792496206,222.6633535000001,230.00380000000013,235.01740000000012,234.96899999999977,233.17,92880394,84039759.25,36.46475314935632,0.7006892895417741,1.5,2.75,NaN,NaN,1.6768160739292024,1.105195860017888,843.8459264532531,-0.3133045281418213,-0.2895756679207864,0.023728860221034903,4.839225599963595,-1.370153559005692,3.3376274643784267,80.29507084606163,16.367301689559937,8041990539
1492435800,233.11,234.57,232.88,234.57,NaN,NaN,233.7534482758621,247.69230769230768,222.8029035000001,230.16450000000012,235.15340000000012,234.84599999999978,233.88555736294092,234.9700198860814,235.02384615384625,236.82660538021972,233.22108692747278,222.8029035000001,230.16450000000012,235.15340000000012,234.84599999999978,234.00666666666666,68405367,83009922.05,48.10610126489382,0.31598113459571686,1.5,2.75,NaN,NaN,1.7041863543628308,0.8240625374734948,847.4629098382494,-0.24319862826852787,-0.28026942511462494,-0.03707079684609707,7.6435821013077145,-0.32295075001063156,15.2463837704853,55.63189195842424,29.121724271090468,8110395906
1492522200,233.72,234.49,233.08,233.87,NaN,NaN,233.90655172413796,247.9226923076923,222.92487850000012,230.3017000000001,235.2440000000001,234.70099999999974,233.88494727027657,234.86525608740698,234.8953846153847,236.76931286918773,233.02145636158167,222.92487850000012,230.3017000000001,235.2440000000001,234.70099999999974,233.81333333333333,83225821,84544364.15,45.08323372413847,0.3459704934483535,1.5,2.75,NaN,NaN,1.6888873290511985,0.9844041271910139,846.3247294722904,-0.230843131738116,-0.32562471151874206,-0.09478157978062607,7.750383332257792,-0.6837098692033231,3.214883357205909,80.68089595478662,16.104220688007462,8027170085
1492608600,234.52,234.95,233.18,233.44,NaN,NaN,234.0596551724138,248.15307692307692,223.04247450000014,230.43030000000007,235.33420000000012,234.68649999999974,233.8674983577167,234.72951741241585,234.67615384615394,236.5126310500881,232.83967664221979,223.04247450000014,230.43030000000007,235.33420000000012,234.68649999999974,233.85666666666665,68699868,81388893.8,43.28394486789484,0.34696545039702203,1.5,2.75,NaN,NaN,1.694681091261826,0.8440938903632083,845.268611763233,-0.23757525733363166,-0.39175065144766563,-0.15417539411403397,7.733487117951278,-0.5707470823749908,3.5701142243816584,79.575866339255,16.854019436363338,7958470217
1492695000,234.15,235.845,233.78,235.34,NaN,NaN,234.21275862068967,248.38346153846152,223.1771245000001,230.57670000000005,235.4622000000001,234.73949999999977,233.92524352015917,234.78765861123338,234.6453846153847,236.42196067203525,232.86880855873414,223.1771245000001,230.57670000000005,235.4622000000001,234.73949999999977,234.98833333333334,92572186,81139042.9,52.335981693779445,0.3805984801647391,1.5,2.75,NaN,NaN,1.7454181561716955,1.1409080350391956,848.6693197505225,-0.10668158677784753,-0.2875273775863434,-0.18084579080849586,9.116589334014144,-0.04247366632687492,21.065015692768135,47.35371023399731,31.581274073234542,8051042403
1492781400,235.25,235.31,234.13,234.59,NaN,NaN,234.36586206896553,248.61384615384614,223.30177450000008,230.70740000000006,235.56920000000014,234.76749999999979,233.95131240172157,234.7688339815921,234.58846153846164,236.32050961295303,232.85641346397026,223.30177450000008,230.70740000000006,235.56920000000014,234.76749999999979,234.67666666666662,110389847,81638021.4,49.010735092239386,0.057579325604663584,1.5,2.75,NaN,NaN,1.7071740021594322,1.3521867030452062,847.2926916616383,-0.06526205615225097,-0.2624233609988096,-0.1971613048465586,9.147919273965972,-0.25935374149659235,19.18818896456179,49.87746568901469,30.93434534642351,7940652556
1493040600,237.18,237.41,236.61,237.17,NaN,NaN,234.5189655172414,248.84423076923076,223.43999450000007,230.87430000000003,235.70060000000012,234.93299999999982,234.0775354447913,234.99751645953572,234.71846153846167,236.8952459863068,232.54167709061653,223.43999450000007,230.87430000000003,235.70060000000012,234.93299999999982,237.0633333333333,119209877,81973272.6,58.72579216104007,0.9359527194278969,1.5,2.75,NaN,NaN,1.7866615734337579,1.4542529927004526,850.8507520622545,0.13056710266921423,-0.03395242651004082,-0.16451952917925505,11.176331998660876,0.7775983683181712,26.464456358941124,40.71604403412582,32.81949960693305,8059862433
1493127000,237.91,238.95,237.81,238.55,NaN,NaN,234.67206896551727,249.07461538461536,223.56949450000008,231.05070000000003,235.8414000000001,235.17949999999982,234.2529262116622,235.33584822529423,235.00846153846166,237.99475686262429,232.02216621429903,223.56949450000008,231.05070000000003,235.8414000000001,235.17949999999982,238.43666666666664,75050935,81353096.75,62.807704321292576,1.356992473124965,1.5,2.75,NaN,NaN,1.786185746759918,0.9225332285829673,854.1350187638167,0.3360327515153213,0.2555214102148966,-0.08051134130042471,11.52854508492315,1.4847273036671527,49.67147214926284,19.34006003116065,30.988467819576503,8134913368
1493213400,238.51,239.53,238.35,238.4,NaN,NaN,234.82517241379313,249.30499999999998,223.69449450000008,231.23090000000005,235.9540000000001,235.33349999999982,234.4155565563029,235.62767220383765,235.23615384615397,238.72793354189952,231.74437415040842,223.69449450000008,231.23090000000005,235.9540000000001,235.33349999999982,238.76,84702455,80914023.75,62.08892445954256,1.263655586952332,1.5,2.75,NaN,NaN,1.7428867648484958,1.046820453049092,856.433115802673,0.4383606045364579,0.4674394143701477,0.029078809833689767,11.487718247521762,1.8672819723967031,46.38104187094732,21.81566225151217,31.803295877540513,8050210913
1493299800,238.77,238.95,237.98,238.6,NaN,NaN,234.97827586206898,249.5353846153846,223.8127445000001,231.42120000000003,236.05200000000008,235.48649999999984,234.57965237762437,235.9107510415674,235.49769230769243,239.4220004100989,231.57338420528598,223.8127445000001,231.42120000000003,236.05200000000008,235.48649999999984,238.51,57410326,80745221.35,62.70183052460951,0.9747395337144441,1.5,2.75,NaN,NaN,1.6876805673593174,0.7110058656121326,856.6054612995595,0.4920165599487535,0.6440995097696316,0.1520829498208781,10.89954392275858,2.61924218313191,41.94048760642208,25.416405737015193,32.64310665656272,8107621239
1493386200,238.9,238.93,237.93,238.08,NaN,NaN,235.13137931034484,249.76576923076922,223.9285445000001,231.60520000000005,236.11520000000007,235.57599999999985,234.7169209118352,236.11734618046574,235.70846153846165,239.8637758089175,231.5531472680058,223.9285445000001,231.60520000000005,236.11520000000007,235.57599999999985,238.31333333333336,63532845,81084969.1,59.98640030976294,0.7487226505891749,1.5,2.75,NaN,NaN,1.6385605268336518,0.7835341827860425,854.1227941121103,0.4652830558126211,0.7336867695866545,0.2684037137740334,9.911363437240603,1.4963550326128743,51.22138757251165,18.228270286617523,30.550342140870825,8044088394
1493645400,238.68,239.17,238.195,238.68,NaN,NaN,235.28448275862073,249.99615384615385,224.0413445000001,231.78200000000004,236.1944000000001,235.72299999999987,234.87233577803772,236.36140844899282,235.98692307692318,240.4077853987424,231.56606075510396,224.0413445000001,231.78200000000004,236.1944000000001,235.72299999999987,238.6816666666667,66882521,80742440.45,62.02971328540448,0.8583193839662344,1.5,2.75,NaN,NaN,1.5993776320598179,0.8283440607844546,856.0894980878784,0.45997971957053885,0.8433783632372069,0.3833986436666681,9.032808268613698,2.056698165647583,43.94451347498119,23.752504289283316,32.3029822357355,8110970915
1493731800,238.84,238.98,238.3,238.77,NaN,NaN,235.43758620689658,250.22653846153844,224.15604450000006,231.95270000000005,236.26800000000011,235.8949999999999,235.0251853553696,236.59079812051732,236.35153846153855,240.847888065741,231.85518885733612,224.15604450000006,231.95270000000005,236.26800000000011,235.8949999999999,238.6833333333333,57375732,79333902.75,62.340368947297705,0.6573267353019961,1.5,2.75,NaN,NaN,1.5337078011984009,0.7232183216903444,856.0894980878784,0.4347910116699822,0.9268874082541458,0.49209639658416365,8.585002376370161,2.2832419465387304,40.70425241656194,26.47383399712631,32.82191358631175,8168346647
1493818200,238.29,238.8775,237.7,238.48,NaN,NaN,235.59068965517244,250.45692307692306,224.26639850000007,232.09150000000005,236.3078000000001,236.0449999999999,235.16066828261,236.77072210903947,236.8107692307693,240.8390191774534,232.7825192840852,224.26639850000007,232.09150000000005,236.3078000000001,236.0449999999999,238.35249999999996,73137731,80167479.55,60.619345405842886,0.45846771428568417,1.5,2.75,NaN,NaN,1.508264386827087,0.9123117180500158,853.1195225463998,0.3732172828326008,0.9586180001249147,0.5854007172923139,8.487922590805342,1.3342398232344634,43.54346370132229,24.08022611446436,32.376310184213345,8095208916
1493904600,238.83,238.9225,237.78,238.76,NaN,NaN,235.7437931034483,250.68730769230768,224.37924850000007,232.22760000000002,236.3574000000001,236.24399999999991,235.30181854603705,236.9601771462738,237.133076923077,241.06186914001455,233.20428470613945,224.37924850000007,232.22760000000002,236.3574000000001,236.24399999999991,238.48749999999998,61462732,77800585.95,61.718235126946695,0.44908042576860496,1.5,2.75,NaN,NaN,1.4821383591965815,0.7900034588364176,850.2503200034755,0.3275913550728564,0.9948899111333844,0.667298556060528,7.59072671857455,1.7775693763587481,44.32468149379751,23.444167923223553,32.231150582978934,8156671648
1493991000,239.19,239.72,238.68,239.7,NaN,NaN,235.89689655172415,250.91769230769228,224.49232350000005,232.35950000000005,236.4226000000001,236.45699999999994,235.47429625011404,237.22111265615248,237.5815384615385,241.2396998000388,233.92337712303822,224.49232350000005,232.35950000000005,236.4226000000001,236.45699999999994,239.36666666666665,62001269,77443861.55,65.22636583875104,0.6418110837974946,1.5,2.75,NaN,NaN,1.4505570478253966,0.8005962998109306,853.4624003756736,0.33572599775125267,1.0869560532495939,0.7512300554983412,7.084095079323151,1.066745372517604,72.63394473406143,6.180907034926136,21.185148231012445,8218672917
1494250200,239.75,239.92,239.17,239.66,NaN,NaN,236.05,251.1480769230769,224.60929850000008,232.49360000000004,236.4810000000001,236.67999999999992,235.63844149520762,237.4533876412808,238.06000000000006,240.9785665606675,235.14143343933262,224.60929850000008,232.49360000000004,236.4810000000001,236.67999999999992,239.58333333333337,48385730,76142532.5,64.95359131593665,0.6231363682186248,1.5,2.75,NaN,NaN,1.4005172586950112,0.6354625780275958,851.9904402312857,0.3138237950533369,1.1435097993150123,0.8296860042616754,4.415259655949236,0.465311255501985,47.05807514945624,21.289860902820465,31.652063947723303,8170287187
1494336600,239.96,240.19,239.04,239.44,NaN,NaN,236.2031034482759,251.37846153846152,224.7202985000001,232.61040000000006,236.5276000000001,236.8849999999999,235.78752222088576,237.64258881830168,238.37538461538466,240.91106981038666,235.83969942038266,224.7202985000001,232.61040000000006,236.5276000000001,236.8849999999999,239.55666666666673,51363200,75329927.4,63.38357302177912,0.5320222416056197,1.5,2.75,NaN,NaN,1.382623168788225,0.6818432165381324,850.2535848352707,0.262040781844893,1.1572369815677916,0.8951961997228987,3.3153532022382586,0.4362416107382517,22.903948374676123,44.994096202128105,32.10195542319576,8118923987
1494423000,239.39,239.87,239.15,239.87,NaN,NaN,236.35620689655175,251.60884615384614,224.83639850000012,232.75030000000004,236.59560000000013,237.12549999999987,235.94761938869416,237.85472321655865,238.78153846153847,240.212704659529,237.35037226354794,224.83639850000012,232.75030000000004,236.59560000000013,237.12549999999987,239.62999999999997,54293799,73642353.55,65.1563559899172,0.518097240333673,1.5,2.75,NaN,NaN,1.335292942446209,0.737263223983422,853.1528848532163,0.23512784414997823,1.1891060049103714,0.9539781607603932,3.3390309797077364,0.5322715842414125,53.23624170504746,16.830618458598593,29.933139836353945,8173217786
1494509400,239.35,239.57,238.13,239.38,NaN,NaN,236.5093103448276,251.83923076923077,224.9495485000001,232.87600000000003,236.5876000000001,237.3929999999999,236.08222254992185,237.9999876721245,238.9515384615385,240.06677134244163,237.83630558063535,224.9495485000001,232.87600000000003,236.5876000000001,237.3929999999999,239.02666666666664,62358346,72667049.05,61.50223587234306,0.2888000120815316,1.5,2.75,NaN,NaN,1.3642005894143376,0.8581378604915291,850.6877432595298,0.16596565400845376,1.1614352282709604,0.9954695742625066,3.661850189861527,0.5460349462365519,23.050362853393818,44.81087539207192,32.13876175453425,8110859440
1494595800,239.09,239.4273,238.67,238.98,NaN,NaN,236.66241379310347,252.06961538461536,225.0618485000001,233.0154,236.60180000000008,237.71649999999985,236.19586088129748,238.09332217954122,238.9846153846154,240.07548985057974,237.89374091865108,225.0618485000001,233.0154,236.60180000000008,237.71649999999985,239.02576666666667,53912730,70718665.85,58.61245736715465,0.14328969379772324,1.5,2.75,NaN,NaN,1.3208505473133145,0.76235502115316,848.822267448912,0.07931336767644082,1.0946112838580575,1.0152979161816167,3.5442551056330203,0.12569130216188326,4.810934279974673,76.06009169441488,19.12897402561044,8056946710
1494855000,239.47,240.44,239.45,240.3,NaN,NaN,236.81551724137933,252.29999999999998,225.17949850000016,233.16310000000001,236.63940000000005,238.00299999999987,236.35680751340345,238.30348197196585,239.13076923076926,240.36842113998185,237.89311732155667,225.17949850000016,233.16310000000001,236.63940000000005,238.00299999999987,240.06333333333336,61918937,70394344.35,64.53457983750502,0.5045232326783136,1.5,2.75,NaN,NaN,1.3307897939337927,0.8796010186860985,852.5174731880483,0.09582669448537295,1.1350812842883329,1.03925458980296,4.4914784512232755,0.6407840180927257,23.373458970085288,44.469537210724845,32.15700381918987,8118865647
1494941400,240.64,240.67,239.63,240.08,NaN,NaN,236.9686206896552,252.5303846153846,225.29429850000014,233.2999,236.68680000000006,238.3134999999999,236.50281506189742,238.47267416511195,239.2446153846154,240.5370933953076,237.9521373739232,225.29429850000014,233.2999,236.68680000000006,238.3134999999999,240.12666666666667,51241791,68795142.85,62.91865699447244,0.4356258818083387,1.5,2.75,NaN,NaN,1.3100190943670926,0.7448460585615312,850.897596649543,0.07763896238300694,1.1363032927817187,1.0586643303987118,4.583138388872525,0.6709158000671012,23.370830850061473,44.472795329410296,32.15637382052822,8067623856
1495027800,238.1,238.64,235.75,235.82,NaN,NaN,237.12172413793107,252.7607692307692,225.38869850000015,233.40040000000002,236.66320000000007,238.4324999999999,236.47603800064655,238.2200385303394,239.07076923076926,241.24812770852913,236.8934107530094,225.38869850000015,233.40040000000002,236.66320000000007,238.4324999999999,236.7366666666667,172174107,73968854.8,41.3352400916917,0.8807229857170066,1.5,2.75,NaN,NaN,1.5257320161980155,2.3276567883270785,845.5969576132052,-0.21934560692653693,0.7844823217405406,1.0038279286670775,11.57413732110814,-1.2313620371921585,3.0041924382927454,81.39832898563243,15.597478576074831,7895449749
1495114200,235.73,237.75,235.43,236.77,NaN,NaN,235.43,252.99115384615382,225.4948025000001,233.5143,236.6674000000001,238.5039999999999,236.48756592218982,238.08193962268803,238.9238461538462,241.42111282527134,236.42657948242106,225.4948025000001,233.5143,236.6674000000001,238.5039999999999,236.65,107047656,74692628.3,45.8003858458977,0.7185943629645145,1.5,2.75,NaN,NaN,1.5824654436124423,1.4331756484729297,846.3311663709846,-0.34251624924102,0.5756826171158025,0.9181988663568225,11.890884325080064,-1.2223612849394987,19.88801362058958,48.98103125508962,31.1309551243208,8002497405
1495200600,237.33,239.08,237.27,238.31,NaN,NaN,235.53324324324325,253.22153846153844,225.6054525000001,233.64030000000002,236.69640000000007,238.6899999999999,236.5590339252412,238.1036596586225,238.8884615384616,241.40639532082082,236.37052775610238,225.6054525000001,233.64030000000002,236.69640000000007,238.6899999999999,238.22,115011373,74923704.6,52.157422432780784,0.10778437567806531,1.5,2.75,NaN,NaN,1.6344321976401253,1.535046533190245,848.5755623772268,-0.31185379538203883,0.5283816221292739,0.8402354175113127,12.345909559756297,-0.5632980055078004,43.25240877191614,24.36681250235309,32.38077872573077,8117508778
1495459800,238.9,239.71,238.82,239.52,NaN,NaN,235.6364864864865,253.45192307692307,225.7210040000001,233.77280000000002,236.73300000000006,238.80749999999995,236.67515024189842,238.23854921494416,238.96846153846158,241.49547066938348,236.44145240753969,225.7210040000001,233.77280000000002,236.73300000000006,238.80749999999995,239.35,61010602,72013740.85,56.47686785430908,0.4094553925505472,1.5,2.75,NaN,NaN,1.617687040665831,0.8472077867344951,851.568491898389,-0.2067281647610374,0.581825211560016,0.7885533763210534,12.766974033410158,0.033411293017044985,41.675462729858864,25.637432398198058,32.687104871943085,8178519380
1495546200,239.95,240.24,239.51,240.05,NaN,NaN,235.73972972972973,253.6823076923077,225.8303540000001,233.9293,236.77780000000007,238.88249999999994,236.80749729123573,238.41106833733042,239.0676923076924,241.6547625704118,236.480622044973,225.8303540000001,233.9293,236.77780000000007,238.88249999999994,239.93333333333328,48341683,70678278.25,58.2547213427112,0.5331886276114433,1.5,2.75,NaN,NaN,1.554280823475416,0.6839680337006512,853.735517509682,-0.10336615289779061,0.6593456851988151,0.7627118380966057,12.815894147714936,0.07504064701713713,56.2694768025367,14.836731611394487,28.89379158606881,8226861063
1495632600,240.32,240.73,239.93,240.61,NaN,NaN,235.84297297297297,253.91269230769228,225.9431540000001,234.0919,236.8520000000001,238.99299999999994,236.95661504452062,238.6204904004418,239.13769230769242,241.8362520813297,236.43913253405515,225.9431540000001,234.0919,236.8520000000001,238.99299999999994,240.42333333333332,49181099,68902210.45,60.108888174993616,0.5911426536266741,1.5,2.75,NaN,NaN,1.5004036217985992,0.7137811498179591,855.4583796539797,-0.004377828278642637,0.7572395527483025,0.7616173810269451,12.843046561652162,0.5138273874175028,100,0,0,8276042162
1495719000,241.2,242.08,240.96,241.76,NaN,NaN,235.94621621621621,254.1430769230769,226.06105400000013,234.2742,236.90820000000008,239.15099999999993,237.1449830819904,238.91949131468544,239.29923076923086,242.3339880048517,236.26447353361002,226.06105400000013,234.2742,236.90820000000008,239.15099999999993,241.6,64071661,69235277.2,63.676844355914426,0.9937578398936466,1.5,2.75,NaN,NaN,1.4982319345272705,0.9254192889979502,856.7985723658143,0.1243424219699415,0.917045408489372,0.7927029865194305,12.980359855883743,1.1632772616955398,100,0,0,8340113823
1495805400,241.54,241.9,241.45,241.71,NaN,NaN,236.04945945945946,254.37346153846153,226.1814040000001,234.4389,236.97280000000006,239.33249999999992,237.3240033532849,239.18525404662017,239.47384615384624,242.77080548454325,236.17688682314923,226.1814040000001,234.4389,236.97280000000006,239.33249999999992,241.6866666666667,46629905,68390130.2,63.4112818543527,0.8266826318489869,1.5,2.75,NaN,NaN,1.4233582249181809,0.6818221410550845,857.8548817303871,0.18808574086904128,1.027810162605732,0.8397244217366908,12.897584385631285,0.5867665418227201,79.7162892495387,3.5237264512660142,16.75998429919528,8293483918
1496151000,241.34,241.79,241.16,241.5,NaN,NaN,236.1527027027027,254.60384615384612,226.2956540000001,234.58809999999997,237.06220000000005,239.47349999999992,237.48776792766589,239.40570604218016,239.59923076923087,243.06649714124148,236.13196439722026,226.2956540000001,234.58809999999997,237.06220000000005,239.47349999999992,241.48333333333335,35201897,66806099,62.23727731197227,0.6816647915051679,1.5,2.75,NaN,NaN,1.3666897802811675,0.5269263963459384,855.3682200649142,0.19712173624297935,1.086126592040415,0.8890048557974357,12.623491722258525,0.5914695101632736,57.430094384701476,14.119096948449934,28.45080866684861,8258282021
1496237400,241.84,241.88,240.64,241.44,NaN,NaN,236.25594594594594,254.83423076923074,226.41055400000013,234.73849999999996,237.15560000000005,239.60699999999989,237.6427574206986,239.59944832387728,239.7576923076924,243.35620613634737,236.15917847903742,226.41055400000013,234.73849999999996,237.15560000000005,239.60699999999989,241.32000000000002,91796016,68527113.2,61.884741319161655,0.4688727704581559,1.5,2.75,NaN,NaN,1.3576405102610847,1.3395576103153284,854.7215502742314,0.18051792854168036,1.1146522664745362,0.9341343379328558,12.601979484058134,2.383173606988383,21.089429335850426,47.340790553956474,31.569780110193097,8166486005
1496323800,241.97,243.38,241.64,243.36,NaN,NaN,236.35918918918918,255.06461538461537,226.53190400000014,234.89999999999998,237.34820000000008,239.85099999999989,237.86696301204375,239.95759610255564,240.09461538461548,244.13218217192073,236.05704859731023,226.53190400000014,234.89999999999998,237.34820000000008,239.85099999999989,242.79333333333332,68962024,68318327.85,68.10981598952056,0.9334994872935978,1.5,2.75,NaN,NaN,1.399237616671007,1.0094220126612774,859.5563201756848,0.2746615255193472,1.2774612448320397,1.0027997193126925,5.452093314854606,2.7832918021708846,25.79678608441012,41.50876091646677,32.694452999123115,8235448029
1496410200,243.42,244.35,243.08,244.17,NaN,NaN,236.46243243243245,255.295,226.66295400000013,235.07709999999994,237.54600000000005,240.12149999999988,238.11414093314008,240.35877742612178,240.39230769230778,244.97977660291443,235.80483878170114,226.66295400000013,235.07709999999994,237.54600000000005,240.12149999999988,243.8666666666667,88666128,69678497.65,70.31266806905583,1.2117006488991464,1.5,2.75,NaN,NaN,1.3900063583373625,1.2725034406650986,861.6183824541663,0.36182067128495277,1.4550755584188835,1.0932548871339307,5.425916749134364,2.4589819982375833,31.26096832212624,35.4693201540215,33.26971152385225,8324114157
1496669400,243.97,244.3,243.76,243.99,NaN,NaN,236.5656756756757,255.5253846153846,226.79105400000012,235.25239999999997,237.74520000000004,240.33599999999987,238.3445667788993,240.7046081474435,240.693076923077,245.65650244375468,235.72965140239933,226.79105400000012,235.25239999999997,237.74520000000004,240.33599999999987,244.01666666666665,44698825,68813375.45,69.1692279961839,1.0369315355960826,1.5,2.75,NaN,NaN,1.3292916184561236,0.6495659413260187,859.1068704976564,0.3760289222193194,1.56329103990808,1.1872621176887606,5.349449136373708,1.8662324649298592,32.38221475134972,34.37378930295587,33.24399594569441,8279415332
1496755800,243.34,243.98,243.12,243.21,NaN,NaN,236.66891891891893,255.7557692307692,226.9128040000001,235.4135,237.93220000000002,240.51349999999988,238.53536808168755,240.94321689530602,241.26153846153855,245.50246612604576,237.02061079703134,226.9128040000001,235.4135,237.93220000000002,240.51349999999988,243.43666666666672,50375430,68912860.45,64.29022006803905,0.7118248686926691,1.5,2.75,NaN,NaN,1.2964850742806866,0.7310018720896093,858.4353197608115,0.3046205013079999,1.5680377443237603,1.2634172430157604,5.892090622129506,1.3163924182461972,29.577765500335996,37.31775962171671,33.10447487794728,8229039902
1496842200,243.6,243.92,242.83,243.66,NaN,NaN,236.77216216216218,255.98615384615383,227.03840400000013,235.5848,238.13299999999998,240.7244999999999,238.73633403926843,241.2019581433721,241.79153846153852,245.31638517858985,238.2666917444872,227.03840400000013,235.5848,238.13299999999998,240.7244999999999,243.47,54144311,69051916,65.78949299995534,0.6431527709360513,1.5,2.75,NaN,NaN,1.281736140403493,0.7841101903674911,857.4353197608115,0.26109399133018085,1.5897847321784866,1.3286907408483057,5.880455043332857,1.2676114874693416,62.17688065100901,11.351307976021658,26.47181137296934,8283184213
1496928600,243.77,244.33,243.17,243.78,NaN,NaN,236.87540540540542,256.21653846153845,227.16465400000013,235.75209999999998,238.3022,240.9199999999999,238.9341248612579,241.44748593924143,242.21230769230777,245.24601731631307,239.17859806830248,227.16465400000013,235.75209999999998,238.3022,240.9199999999999,243.76,65950691,69634760.6,66.19706222911609,0.5980020493932301,1.5,2.75,NaN,NaN,1.2730407018032452,0.9470943883736136,859.2863274615509,0.21567013946035685,1.598278415173752,1.382608275713395,5.879259480909601,0.8355393778954378,61.755004667603814,11.588703161666793,26.656292170729397,8349134904
1497015000,244.09,245.01,241.95,243.41,NaN,NaN,236.97864864864866,245.01,227.28685400000012,235.9237,238.4596,241.12149999999988,239.1096493765027,241.63439204026605,242.51153846153855,245.16790783058502,239.85516909249208,227.28685400000012,235.9237,238.4596,241.12149999999988,243.4566666666667,132256362,73129661.4,63.678013628713344,0.40927553409190914,1.5,2.75,NaN,NaN,1.4006806516744421,1.8085187250709736,862.0888143186601,0.13967605268054473,1.557203341564076,1.4175272888835313,5.627957974322992,0.7033221629225057,16.558678834496323,53.722199220064056,29.719121945439625,8216878542
1497274200,243.13,243.42,242.38,243.36,NaN,NaN,237.0818918918919,245.077,227.41440400000013,236.0898,238.601,241.34049999999988,239.27632979311042,241.79873565547882,242.7661538461539,245.0364237516509,240.49588394065694,227.41440400000013,236.0898,238.601,241.34049999999988,243.05333333333334,86108102,74739430,63.32730873519615,0.1908189395212138,1.5,2.75,NaN,NaN,1.37491774798341,1.1521107666997192,862.998359659626,0.06860817295031629,1.5032875050714267,1.4346793321211104,5.62787736459202,0.7701863354037324,11.896083714666224,61.14286905847028,26.961047226863485,8130770440
1497360600,243.98,244.61,243.5799,244.55,NaN,NaN,237.18513513513514,245.14399999999998,227.54865400000017,236.2762,238.77719999999997,241.55299999999988,239.48314038945904,242.06076083114752,243.06923076923084,245.1513814552589,240.98708008320278,227.54865400000017,236.2762,238.77719999999997,241.55299999999988,244.24663333333334,60066953,74646830.8,67.86369383200002,0.6330297342081186,1.5,2.75,NaN,NaN,1.3659950516988808,0.8046818914648417,866.0946729453422,0.08333097128158595,1.5388430462230929,1.455512074941507,6.00186970425031,1.2881047051027228,26.800663477829065,40.33226965719755,32.86706686497337,8190837393
1497447000,244.86,244.87,243.29,244.24,NaN,NaN,237.28837837837838,245.21099999999998,227.68340400000017,236.4512,238.95539999999997,241.76099999999988,239.6696839035979,242.2683074186573,243.26000000000008,245.2809213435853,241.23907865641485,227.68340400000017,236.4512,238.95539999999997,241.76099999999988,244.1333333333333,78602311,76014856.8,65.58760949203803,0.43743277185712864,1.5,2.75,NaN,NaN,1.3812811194346761,1.0340387959528459,864.747522317233,0.055137487297226784,1.5244339340630404,1.4692964467658136,6.122389618719385,0.361604207758052,11.016068744383045,62.70907441190441,26.274856843712552,8112235082
1497533400,242.68,243.91,242.36,243.77,NaN,NaN,237.39162162162162,245.278,227.81045000000012,236.62739999999997,239.1212,242.15849999999992,239.83048061326073,242.41132575973754,243.4184615384616,245.24177797842836,241.59514509849484,227.81045000000012,236.62739999999997,239.1212,242.15849999999992,243.34666666666666,66464888,70729395.85,62.182434578928834,0.18981745300082356,1.5,2.75,NaN,NaN,1.4169038966179133,0.9397067117744935,862.310069451927,-0.008813637695610055,1.458279399646301,1.467093037341911,4.548311803358443,-0.16382028914280103,2.245930826238637,84.02139907954515,13.732670094216214,8045770194
1497619800,242.77,242.83,241.6337,242.64,NaN,NaN,237.49486486486487,245.345,227.9336500000001,236.77779999999998,239.27839999999998,242.4519999999999,239.94065784411325,242.43310425881015,243.50615384615392,245.03838275980652,241.97392493250132,227.9336500000001,236.77779999999998,239.27839999999998,242.4519999999999,242.3679,84553097,69604667.9,54.814012632453604,0.29783782414343474,1.5,2.75,NaN,NaN,1.468289332573777,1.214761876624082,864.1711895759228,-0.1339241057420737,1.299687905164319,1.4336120109063928,4.816417441958138,-0.5533013648100426,2.898319285763669,81.71691331208011,15.384767402156232,7961217097
1497879000,243.59,244.73,243.48,244.66,NaN,NaN,237.5981081081081,245.41199999999998,228.07005000000015,236.9287,239.46279999999996,242.76949999999988,240.12573008552056,242.6451895674949,243.7538461538462,244.8485758630522,242.65911644464023,228.07005000000015,236.9287,239.46279999999996,242.76949999999988,244.29,65123802,67110289.35,63.20720466597769,0.45897955932624945,1.5,2.75,NaN,NaN,1.512697237389936,0.9703996604806772,866.5224810143819,-0.08947868653829572,1.321763652733523,1.4112423392718187,7.0182029195103235,0.5961925907651776,15.745268633938682,54.880711487532764,29.37401987852855,8026340899
1497965400,244.25,244.26,242.99,243.01,NaN,NaN,237.70135135135135,245.47899999999998,228.19815000000017,237.06549999999996,239.61899999999994,242.94399999999987,240.2388387096178,242.67993341820966,243.7269230769231,244.87498859683723,242.57885755700897,228.19815000000017,237.06549999999996,239.61899999999994,242.94399999999987,243.42,56906368,66905077.65,54.329927725068565,0.06121648580802168,1.5,2.75,NaN,NaN,1.5239331490049395,0.8505537994843057,863.2398201928888,-0.17509571055121254,1.1923727010828031,1.3674684116340157,7.904202196901419,-0.26676516457358845,3.9210903561378188,78.54273304825091,17.536176595611263,7969434531
1498051800,243.42,243.59,242.41,242.95,NaN,NaN,237.8045945945946,245.546,228.32105000000013,237.20529999999997,239.77119999999996,243.08899999999986,240.345158760221,242.70565404504683,243.6330769230769,244.81973051438237,242.44642333177146,228.32105000000013,237.20529999999997,239.77119999999996,243.08899999999986,242.98333333333338,55977569,67286871.95,54.03274592236241,0.14567986855180387,1.5,2.75,NaN,NaN,1.4993664955045871,0.8319240793597331,860.4178286330792,-0.23587600435726674,1.0726234061874322,1.308499410544699,7.808028320887198,-0.34047091640003796,4.533578257154557,76.81844209132284,18.647979651522615,7913456962
1498138200,242.96,243.53,242.64,242.84,NaN,NaN,237.90783783783783,245.613,228.44009600000012,237.35819999999995,239.92679999999996,243.20049999999986,240.4429956715849,242.71844889789952,243.54461538461538,244.78202248474574,242.30720828448503,228.44009600000012,237.35819999999995,239.92679999999996,243.20049999999986,243.00333333333333,44148059,67035219.95,53.45544644455648,0.07668100839726186,1.5,2.75,NaN,NaN,1.4558403172542604,0.6585800573628161,862.3632648880674,-0.2805561874652547,0.9578041762131306,1.2383603636783853,7.792156806713109,-0.23417279487284548,5.28146435956939,74.85057755191994,19.86795808851066,7869308903
1498224600,242.91,243.51,242.47,243.13,NaN,NaN,238.01108108108107,245.67999999999998,228.5606960000001,237.5142,240.10879999999995,243.26899999999986,240.54836839034627,242.75764424095672,243.53846153846155,244.78323760495388,242.2936854719692,228.5606960000001,237.5142,240.10879999999995,243.26899999999986,243.03666666666666,66986801,67180976.95,54.82577538221417,0.05259481212683731,1.5,2.75,NaN,NaN,1.4261374374503841,0.9971096587335352,865.1916920128136,-0.28663641424065256,0.8800648458775697,1.1667012601182223,7.803330337961676,-0.09451019066404429,27.20846616933615,39.87678320083342,32.914750629830436,7936295704
1498483800,243.9,244.38,243.045,243.29,NaN,NaN,238.11432432432431,245.74699999999999,228.68459600000008,237.6709,240.32439999999994,243.34799999999987,240.65588335543072,242.80834478943703,243.51000000000002,244.75927055643172,242.26072944356832,228.68459600000008,237.6709,240.32439999999994,243.34799999999987,243.57166666666663,56700477,67684505.55,55.602419278780474,0.1599751070928034,1.5,2.75,NaN,NaN,1.4196276204896432,0.8377172373389673,867.9388739410828,-0.2758471945852239,0.8218922668866924,1.0977394614719163,7.815360609662803,-0.5152320588836717,26.071127265739236,41.17071923260107,32.75815350165968,7992996181
1498570200,243.04,243.38,241.31,241.33,NaN,NaN,238.21756756756756,245.814,228.8248460000001,237.80650000000003,240.45959999999997,243.33949999999987,240.68231930227657,242.66755004758588,243.32153846153844,245.01223419735715,241.63084272571973,228.8248460000001,237.80650000000003,240.45959999999997,243.33949999999987,242.0066666666667,82247666,70036794,45.32296012077772,0.38014415871755125,1.5,2.75,NaN,NaN,1.4660827904546683,1.174349385552971,865.126134275778,-0.3897148571839344,0.6105958899919983,1.0003107471759327,8.358667223088782,-1.1914510317720262,21.873956150955102,46.30453795814673,31.82150589089817,7910748515
1498656600,242.5,243.715,242.23,243.49,NaN,NaN,238.32081081081083,245.881,228.96059600000012,237.94800000000004,240.65199999999993,243.44199999999987,240.79242442767747,242.74587861448245,243.32769230769233,245.02021257408205,241.6351720413026,228.96059600000012,237.94800000000004,240.65199999999993,243.44199999999987,243.14499999999998,70042599,68949123.15,55.16111666312414,0.21221428902571068,1.5,2.75,NaN,NaN,1.53171973399362,1.0158591697768384,869.384459455157,-0.3119288936240894,0.610399630145821,0.9223285237699104,10.214090486342968,-0.11486237026705547,48.649443641640254,20.090911440847453,31.259644917512283,7980791114
1498743000,243.66,243.72,239.955,241.35,NaN,NaN,239.955,245.94799999999998,229.1011960000001,238.0722,240.81019999999992,243.3414999999999,240.814290136396,242.61293779405554,243.17307692307693,245.1661014451603,241.18005240099356,229.1011960000001,238.0722,240.81019999999992,243.3414999999999,241.67499999999998,106949719,70848507.9,46.276924763974584,0.54458070416482,1.5,2.75,NaN,NaN,1.6912397529940748,1.509554995158903,865.7117715615786,-0.3918008242514738,0.4325774934555682,0.824378317707042,11.319422658713895,-0.5316518298714112,34.70870334202218,31.97938629976215,33.311910358215655,7873841395
1498829400,242.28,242.71,241.575,241.8,NaN,NaN,240.11103448275864,246.015,229.2444460000001,238.20080000000002,240.93939999999992,243.2229999999999,240.8529454251648,242.53551514700263,242.96153846153845,244.90830455557816,241.01477236749875,229.2444460000001,238.20080000000002,240.93939999999992,243.2229999999999,242.02833333333334,86820694,70756236.2,48.16740128823178,0.24726118924099108,1.5,2.75,NaN,NaN,1.6675797706373563,1.2270394620001,868.2144973483232,-0.4001219074094917,0.32422593344517736,0.7243478408546691,11.167384444089283,-1.1689691817215668,37.96102405808701,28.913381281818268,33.12559466009471,7960662089
1499088600,242.88,243.38,242.21,242.21,NaN,NaN,240.26706896551727,246.082,229.3790960000001,238.3305,241.0917999999999,243.13399999999993,240.90616325162893,242.50451370443096,242.80538461538464,244.63929788209313,240.97147134867615,229.3790960000001,238.3305,241.0917999999999,243.13399999999993,242.60000000000002,39153806,70478985.25,49.89732658781084,0.28390452255333853,1.5,2.75,NaN,NaN,1.6613240727346867,0.5555387306033893,871.9046221804388,-0.36480084840426896,0.2683467803493329,0.6331476287536019,9.869743696463152,-0.3292045594831418,33.714789208619386,32.981611796207275,33.303598995173346,7999815895
1499261400,242.63,243.01,241.7,242.77,NaN,NaN,240.42310344827587,246.149,229.52609600000008,238.4522,241.2037999999999,243.11199999999994,240.97925488881995,242.52979811353276,242.72846153846154,244.47593173020036,240.98099134672273,229.52609600000008,238.4522,241.2037999999999,243.11199999999994,242.49333333333334,54427596,70681593.55,52.2418816043196,0.09904743410616396,1.5,2.75,NaN,NaN,1.6362294961107808,0.7700391752132476,869.2431689433269,-0.2935732239604566,0.2661810988030311,0.5597543227634877,9.290118069973804,-0.07408931878986558,61.412000058092715,11.754604296539416,26.83339564536787,8054243491
1499347800,241.89,242.03,240.34,240.55,NaN,NaN,240.5791379310345,246.21599999999998,229.66179600000007,238.54260000000002,241.2437999999999,242.95649999999995,240.9624213637682,242.34124591224392,242.56769230769234,244.66723297313166,240.46815164225302,229.66179600000007,238.54260000000002,241.2437999999999,242.95649999999995,240.97333333333336,66115317,71280143.85,43.54293177337683,0.5712704961612202,1.5,2.75,NaN,NaN,1.6929273892457257,0.9275418570861934,864.293421475021,-0.38031792234884765,0.0843569198274281,0.46467484217627575,10.654831538528063,-0.9430077417229419,33.91866092967225,32.77963727894071,33.30170179138705,7988128174
1499434200,241.21,242.28,240.5645,242.11,NaN,NaN,240.73517241379312,246.283,229.80524600000007,238.63600000000002,241.31799999999993,242.87299999999996,241.00742444754198,242.3192224920302,242.37153846153853,244.09537757864473,240.64769934443234,229.80524600000007,238.63600000000002,241.31799999999993,242.87299999999996,241.65150000000003,57972268,70881222.7,49.86094417801502,0.25789300787458164,1.5,2.75,NaN,NaN,1.6955754328710302,0.8178790629129483,867.197575142982,-0.3194317211214723,0.06538519077443539,0.38481691189590767,11.487776134208847,-0.4195286472257565,73.32670077198223,5.900058778470639,20.773240449547135,8046100442
1499693400,241.95,242.8,241.76,242.37,NaN,NaN,240.89120689655175,246.35,229.93799600000008,238.7227,241.39339999999993,242.82099999999997,241.06085878293248,242.32405844517018,242.32230769230773,244.00649941984523,240.63811596477024,229.93799600000008,238.7227,241.39339999999993,242.82099999999997,242.31,36663274,66101568.3,50.84821183058827,0.11108975830031731,1.5,2.75,NaN,NaN,1.6487486162373866,0.5546505921554663,868.2220685674897,-0.25144000083491613,0.07051691085226253,0.32195691168717866,11.482274707198716,-0.37814953347855956,68.57321162965248,8.007698787120193,23.41908958322733,8082763716
1499779800,242.16,242.55,240.85,242.19,NaN,NaN,241.04724137931035,246.417,230.0630460000001,238.7954,241.47559999999993,242.76249999999996,241.10513883066062,242.3112909742016,242.2638461538462,243.90913852366126,240.61855378403115,230.0630460000001,238.7954,241.47559999999993,242.76249999999996,241.86333333333332,50354614,64313893.9,50.11253184331774,0.17003447348906098,1.5,2.75,NaN,NaN,1.6524094293632887,0.7829507894249893,869.4351409954376,-0.21006560664400054,0.05937490338217799,0.2694405100261785,11.467098823818654,0.356358513239127,42.68517473258453,24.79901205271487,32.51581321470061,8032409102
1499866200,243.3,244.2,243.3,244.01,NaN,NaN,241.20327586206898,246.48399999999998,230.20314600000012,238.8883,241.58219999999994,242.73549999999994,241.21905495494843,242.4730727861824,242.35384615384618,244.22751041177085,240.4801818959215,230.20314600000012,238.8883,241.58219999999994,242.73549999999994,243.83666666666667,59610405,64291066.5,56.90224559943663,0.6177915229971359,1.5,2.75,NaN,NaN,1.6779516129801961,0.9271957714373894,873.4212279098047,-0.059429241253218024,0.195153958459656,0.254583199712874,11.152065924973995,0.21356113187399145,43.95467546907975,23.752939647643558,32.29238488327668,8092019507
1499952600,244.02,244.55,243.76,244.42,NaN,NaN,241.3593103448276,246.551,230.35404600000012,238.98159999999996,241.69519999999994,242.74449999999996,241.3445822116171,242.6584944255936,242.45307692307694,244.59770003308373,240.30845381307014,230.35404600000012,238.98159999999996,241.69519999999994,242.74449999999996,244.24333333333334,39471637,62334532.8,58.27978396339033,0.6542537836869177,1.5,2.75,NaN,NaN,1.6145264977673264,0.6332226332175221,874.4765176158269,0.06194634902016816,0.3320161359880842,0.27006978696791606,10.016899949082532,1.2720116014087397,75.87626290573574,4.88429001966124,19.239447074603017,8131491144
1500039000,244.43,245.97,244.31,245.56,NaN,NaN,241.51534482758623,246.618,230.50399600000011,239.07229999999996,241.83679999999993,242.83399999999997,241.50989271312233,242.93482828982278,242.62769230769234,245.31694331973966,239.93844129564502,230.50399600000011,239.07229999999996,241.83679999999993,242.83399999999997,245.27999999999997,60262692,62024423,61.92401487152818,0.9842980750524487,1.5,2.75,NaN,NaN,1.6177746050696598,0.9715961726882973,877.8755721062067,0.205064849646584,0.526400849026146,0.32133599937956203,8.331426532908507,1.5550041356492932,76.22745062325114,4.751857645364227,19.020691731384623,8191753836
1500298200,245.47,245.91,245.33,245.53,NaN,NaN,241.67137931034483,246.685,230.64844600000012,239.16479999999996,241.97219999999993,242.97849999999994,241.6675439792744,243.18198750031584,242.95076923076928,245.9320798515544,239.96945860998417,230.64844600000012,239.16479999999996,241.97219999999993,242.97849999999994,245.59,33531917,59473364,61.77110139214972,0.8416337996292159,1.5,2.75,NaN,NaN,1.5436478475646829,0.5638140294199602,879.5557735593299,0.2791748260178065,0.6703045319018202,0.39112970588401363,8.397236716598977,1.3707113661698498,57.12924177248432,14.337557518705422,28.53320070881024,8158221919
1500384600,245.06,245.72,244.67,245.66,NaN,NaN,241.82741379310346,246.75199999999998,230.80334600000012,239.25699999999998,242.0913999999999,243.02849999999995,241.82411088204796,243.41798869076194,243.11769230769235,246.42612585610078,239.80925875928392,230.80334600000012,239.25699999999998,242.0913999999999,243.02849999999995,245.35,42742498,58354298.8,62.2066224427164,0.6945156266470403,1.5,2.75,NaN,NaN,1.5083872870243493,0.7324652832603311,878.5743280467732,0.31572115919192223,0.7857811548739164,0.4700599956819942,8.41548623689627,1.1904271532726391,84.46769501553295,2.1371592820842005,13.395145702382854,8200964417
1500471000,246.02,247,246.01,246.99,NaN,NaN,241.9834482758621,246.819,230.9567960000001,239.35949999999997,242.23799999999991,243.2274999999999,242.02669476902648,243.75818024402272,243.5515384615385,247.27244692092327,239.83063000215375,230.9567960000001,239.35949999999997,242.23799999999991,243.2274999999999,246.66666666666666,51034260,58060693.4,66.4213850257471,1.035846975296261,1.5,2.75,NaN,NaN,1.4963596236654675,0.8789812351776013,882.5079165203645,0.40266911355940815,0.9733963876312544,0.5707272740718462,8.716417020443066,2.6771980877156505,83.8599929313457,2.298500312932599,13.841506755721689,8251998677
1500557400,247.28,247.42,246.47,247.1,NaN,NaN,242.13948275862072,246.886,231.1133960000001,239.45939999999996,242.3911999999999,243.43499999999995,242.22564791533915,244.07644879221104,243.9592307692308,247.97304124757713,239.94542029088447,231.1133960000001,239.45939999999996,242.3911999999999,243.43499999999995,246.99666666666667,47135183,57618574.1,66.7516430103476,1.0146286476222481,1.5,2.75,NaN,NaN,1.4573339362607904,0.8180553534385364,883.1880525611781,0.43787455798768327,1.1180704715564502,0.680195913568767,5.4536081527612685,2.0610466316963283,84.48542629916074,2.1325321930349945,13.382041507804274,8299133860
1500643800,246.44,246.91,246.18,246.88,NaN,NaN,242.29551724137932,246.953,231.27439600000008,239.56349999999995,242.53139999999988,243.63699999999994,242.40817152650231,244.34345366914332,244.31846153846158,248.47513066465888,240.16179241226428,231.27439600000008,239.56349999999995,242.53139999999988,243.63699999999994,246.65666666666667,88711019,59846722.1,65.3669189395656,0.6890675343545307,1.5,2.75,NaN,NaN,1.4189529408135901,1.4823037233646585,881.7776457716922,0.41674543828349875,1.2011277114231405,0.7843822731396417,5.21816715030926,1.8607913520650208,39.776568596622226,27.343808206205455,32.87962319717233,8210422841
1500903000,246.79,246.98,246.28,246.82,NaN,NaN,242.45155172413794,247.01999999999998,231.4303460000001,239.63389999999995,242.6801999999999,243.82149999999993,242.58118440781595,244.579315224463,244.63000000000005,248.8817471521672,240.3782528478329,231.4303460000001,239.63389999999995,242.6801999999999,243.82149999999993,246.6933333333333,46622256,58828494.85,64.971065408501,0.6320439240814895,1.5,2.75,NaN,NaN,1.3675991593269043,0.7925114541665007,880.071839676003,0.37067550759008994,1.247726657627254,0.8770511500371642,5.351817222910948,1.9117222015772721,37.19819860454153,29.779511454466352,33.02228994099211,8163800585
1500989400,247.68,247.8,247.16,247.42,NaN,NaN,242.60758620689657,247.087,231.5885460000001,239.72539999999992,242.8489999999999,244.02799999999993,242.77094188201926,244.849856631657,245.15846153846158,248.93118017586482,241.38574290105834,231.5885460000001,239.72539999999992,242.8489999999999,244.02799999999993,247.46,54915591,58739250.55,67.11568371230956,0.7824339438177018,1.5,2.75,NaN,NaN,1.3399135050892697,0.9349045227135606,882.3587937048717,0.35266303530425813,1.3178799441674869,0.9652169088632288,5.100365293129405,1.397483709684028,40.15131854053037,27.112776536009758,32.73590492345988,8218716176
1501075800,247.75,247.79,247.13,247.43,NaN,NaN,242.7636206896552,247.154,231.75049600000008,239.81549999999996,242.99159999999992,244.33299999999994,242.9536500435087,245.0955845714992,245.5676923076923,249.07365341892327,242.06173119646135,231.75049600000008,239.81549999999996,242.99159999999992,244.33299999999994,247.44999999999996,47575422,57005638.35,67.15178048271994,0.6536810404220104,1.5,2.75,NaN,NaN,1.2913482547257502,0.8345739715762696,883.2032549260645,0.31472446590014247,1.3586224912384068,1.0438980253382644,3.8917325378713166,1.2314867850421485,39.374806513197555,27.799440768122157,32.82575271868028,8266291598
1501162200,247.96,248,245.68,247.2,NaN,NaN,242.9196551724138,247.221,231.90569600000006,239.91039999999998,243.13399999999993,244.51849999999996,243.12017357121425,245.29600508849927,245.93923076923076,249.00732425427898,242.87113728418254,231.90569600000006,239.91039999999998,243.13399999999993,244.51849999999996,246.95999999999998,70766568,57041836.8,65.37432286748631,0.37704680940228946,1.5,2.75,NaN,NaN,1.3648233793881963,1.240608156573247,881.562987816574,0.25025184731738426,1.3567128344849948,1.1064609871676105,4.103021927208435,0.6678612151816201,15.763217757556834,55.01799081733529,29.21879142510787,8195525030
1501248600,246.65,247.06,246.13,246.91,NaN,NaN,243.07568965517243,247.28799999999998,232.07309600000008,240.00949999999997,243.35579999999993,244.79649999999992,243.26879421548037,245.44971888959458,246.3023076923077,248.50474206356296,244.09987332105243,232.07309600000008,240.00949999999997,243.35579999999993,244.79649999999992,246.70000000000002,50088359,54198768.8,63.1061898223585,0.2562881564295635,1.5,2.75,NaN,NaN,1.3437645665747533,0.9241604580508479,882.926976495515,0.1681285275516171,1.3166216466071319,1.1484931190555148,3.60637668613657,0.5620494440597872,20.782572775273955,47.90984741682794,31.307579807898108,8145436671
1501507800,247.37,247.48,246.53,246.77,NaN,NaN,243.23172413793105,247.355,232.23839600000008,240.11159999999995,243.55579999999995,245.04499999999993,243.4060964031086,245.57545994772843,246.51461538461535,248.28122213435105,244.74800863487965,232.23839600000008,240.11159999999995,243.55579999999995,245.04499999999993,246.92666666666665,65838659,53149667.05,61.98808059238448,0.2971658569190889,1.5,2.75,NaN,NaN,1.3156385261051273,1.2387407608416994,884.3232196510917,0.08843658100917162,1.2590388453169794,1.1706022643078078,3.645379067198757,0.45184401204917923,17.409401071092812,52.46574700118544,30.12485192772175,8079598012
1501594200,247.46,247.5,246.716,247.32,NaN,NaN,243.38775862068968,247.422,232.40994600000005,240.21619999999996,243.73599999999996,245.30049999999991,243.55958281867296,245.74160661937336,246.73769230769227,248.06865272082172,245.40673189456282,232.40994600000005,240.21619999999996,243.73599999999996,245.30049999999991,247.1786666666667,55050401,53944496.8,64.63877074230433,0.35192688411817596,1.5,2.75,NaN,NaN,1.2776643456690462,1.0205007788672154,886.4418800307918,0.058278778799236264,1.2434507378068531,1.1851719590076168,3.777097726480508,0.13360864812339937,17.435221988780064,52.428342687131774,30.136435324088183,8134648413
1501680600,247.47,247.6,246.37,247.44,NaN,NaN,243.54379310344828,247.48899999999998,232.58154600000006,240.31369999999995,243.89439999999996,245.53399999999988,243.7117560414701,245.90335836990923,246.88230769230768,248.07092431150747,245.69369107310789,232.58154600000006,240.31369999999995,243.89439999999996,245.53399999999988,247.13666666666668,47211216,53583677.8,65.20881893931822,0.2760669276493466,1.5,2.75,NaN,NaN,1.2742597495498278,0.8810745723019409,884.3518032253535,0.033174515879251576,1.2266401038566812,1.1934655879774296,2.2903895045399447,0.1375961149332268,17.35210112414429,52.548852897766466,30.09904597808923,8181859629
1501767000,247.31,247.34,246.64,246.96,NaN,NaN,243.6998275862069,247.55599999999998,232.75444600000006,240.40519999999992,244.03259999999995,245.85449999999986,243.83913815749088,246.00399090610836,246.99230769230766,247.88873320408408,246.09588218053125,232.75444600000006,240.40519999999992,244.03259999999995,245.85449999999986,246.98000000000005,40855997,52320711.8,60.974558548936045,0.17251248207524927,1.5,2.75,NaN,NaN,1.2403840531534125,0.7808761691961539,882.4694899017338,-0.02581248929483415,1.161199976358887,1.187012465653721,2.580489620784909,0.032404406999356976,21.78656363932756,46.490599593294306,31.722836767378137,8141003632
1501853400,247.52,247.79,246.97,247.41,NaN,NaN,243.85586206896554,247.623,232.92294600000008,240.51029999999992,244.16859999999994,246.11949999999987,243.97917195523632,246.13789653409805,247.12692307692305,247.61539854618184,246.63844760766426,232.92294600000008,240.51029999999992,244.16859999999994,246.11949999999987,247.39,60191838,52431690.3,63.375589873336295,0.27102015638785615,1.5,2.75,NaN,NaN,1.2110709064995961,1.1480049118309659,884.4954837721073,-0.043535085378503924,1.1325936089305912,1.1761286943090952,2.7244989330069123,0.2390405963860317,49.62423605473727,19.42693836283651,30.948825582426238,8201195470
1502112600,247.49,247.87,247.37,247.87,NaN,NaN,244.01189655172416,247.69,233.0908960000001,240.5994999999999,244.29079999999993,246.39449999999988,244.13175344718783,246.30285876894584,247.19461538461536,247.81462111089292,246.5746096583378,233.0908960000001,240.5994999999999,244.29079999999993,246.39449999999988,247.70333333333335,31995021,52198277.65,65.69880413082592,0.35127701760135815,1.5,2.75,NaN,NaN,1.160280127463911,0.6129516612508382,883.6902497524062,-0.033727499592836274,1.1339693198180498,1.167696819410886,2.8584680782373417,0.1818769703338522,79.75777925958529,3.510155581485408,16.732065158929284,8233190491
1502199000,247.51,248.91,246.83,247.26,NaN,NaN,244.16793103448276,248.91,233.25779600000013,240.68729999999988,244.40179999999998,246.6479999999999,244.25442978259224,246.39401507666528,247.2069230769231,247.82527744958117,246.58856870426501,233.25779600000013,240.68729999999988,244.40179999999998,246.6479999999999,247.66666666666666,61719353,52766514.6,60.24158143583017,0.29487081719943525,1.5,2.75,NaN,NaN,1.2259744040736305,1.1696689362158477,881.1590287731123,-0.0753866875038347,1.0734634600310926,1.1488501475349273,2.979539768601169,-0.06870630077194192,43.94852154735438,23.746397263326873,32.305081189318756,8171471138
1502285400,246.47,247.31,246.06,247.25,NaN,NaN,244.3239655172414,249.0051219512195,233.42414600000012,240.7894999999999,244.51679999999996,246.8099999999999,244.37190312445136,246.4755374503162,247.23538461538462,247.8242879187322,246.64648131203703,233.42414600000012,240.7894999999999,244.51679999999996,246.8099999999999,246.87333333333333,62632619,52917625.3,60.1533691618993,0.04980533807341304,1.5,2.75,NaN,NaN,1.2276905180683713,1.1835871062793137,877.7693686251966,-0.10865798882137878,1.013027661508204,1.1216856503295827,2.9788590058803868,0.02022653721683308,16.680691307867903,53.4577647794884,29.861543912643693,8108838519
1502371800,246.29,246.44,243.7,243.76,NaN,NaN,244.48000000000002,249.10024390243902,233.56849600000012,240.85939999999988,244.56319999999997,246.7769999999999,244.34790692349247,246.21691483600037,246.99999999999997,248.9464049701497,245.05359502985024,233.56849600000012,240.85939999999988,244.56319999999997,246.7769999999999,244.63333333333333,120479470,56968016.95,38.79974372293367,0.8472474025641216,1.5,2.75,NaN,NaN,1.3935697667777742,2.114861574095919,871.4986885527142,-0.3567656052789412,0.6757286437309062,1.0324942490098474,8.670190329596794,-1.2757684986432327,9.451659136719455,65.64032063168418,24.90802023159637,7988359049
1502458200,244.02,244.8,243.75,244.12,NaN,NaN,244.63603448275865,249.19536585365853,233.71824600000014,240.96329999999986,244.57839999999996,246.70499999999987,244.338969397081,246.0172086611432,246.7461538461538,249.2014719482394,244.29083574406818,233.71824600000014,240.96329999999986,244.57839999999996,246.70499999999987,244.22333333333336,74869947,57698379.7,41.12156958720324,0.8130538764901456,1.5,2.75,NaN,NaN,1.3690290691507911,1.2976091770563185,873.1519681217325,-0.480011104083397,0.43248036890560115,0.9124914729889981,8.827145042376591,-1.0738744579973276,11.680144563160578,61.51494976234589,26.804905674493522,8063228996
1502717400,245.59,246.79,245.55,246.54,NaN,NaN,244.79206896551727,249.29048780487804,233.88224600000015,241.0858999999999,244.62579999999997,246.7554999999999,244.42528432268566,246.06699831246289,246.67769230769227,249.10236235786667,244.25302225751787,233.88224600000015,241.0858999999999,244.62579999999997,246.7554999999999,246.29333333333332,73291919,59686379.8,53.80802927681914,0.11977538658812234,1.5,2.75,NaN,NaN,1.4619555642114481,1.227950484609556,877.6143105559255,-0.3859762839563542,0.43002111804355536,0.8159974019999096,10.862752420826917,-0.31538088306647305,18.723661887933417,50.52206630991413,30.754271802152477,8136520915
1502803800,246.98,247,246.16,246.51,NaN,NaN,244.94810344827587,249.38560975609755,234.04894600000017,241.2106999999999,244.6762,246.79799999999992,244.50703787865876,246.10918894937117,246.62461538461537,249.03137017877432,244.2178605904564,234.04894600000017,241.2106999999999,244.6762,246.79799999999992,246.55666666666664,55242746,60311392.2,53.65369073470697,0.15730087716264574,1.5,2.75,NaN,NaN,1.4175301667677735,0.9159587266168264,875.1332346391268,-0.316157388325747,0.42080066659272575,0.7369580549184728,10.762649249158498,-0.3758486905916613,19.415656278588507,49.56497342168063,31.019370299730877,8081278169
1502890200,247.11,247.57,246.45,246.94,NaN,NaN,245.1041379310345,249.48073170731706,234.2209460000002,241.34149999999988,244.75080000000003,246.7954999999999,244.60244815792706,246.18831381133583,246.62692307692308,249.03482525506885,244.2190208987773,234.2209460000002,241.34149999999988,244.75080000000003,246.7954999999999,246.98666666666668,56715544,60595456.4,55.618676639280075,0.25134982113596677,1.5,2.75,NaN,NaN,1.3962780119986473,0.9359702421516871,877.7831361508775,-0.23509987491209894,0.44308321127834915,0.6781830861904481,10.821315298756035,-0.008098477486236731,38.95986473358534,28.00883146570217,33.03130380071248,8137993713
1502976600,246.24,246.6,243.09,243.09,NaN,NaN,245.26017241379313,249.57585365853657,234.37364600000015,241.43619999999987,244.73940000000002,246.59499999999989,244.54313646545933,245.89323630549433,246.3438461538462,249.39676947887966,243.2909228288127,234.37364600000015,241.43619999999987,244.73940000000002,246.59499999999989,244.26,128490396,64663217.05,39.47919637537088,0.814268831789949,1.5,2.75,NaN,NaN,1.5715438682844578,1.9870708860749453,873.0378150564565,-0.42385114336346186,0.14836915698612074,0.5722203003495826,14.031880322058448,-1.7460894870862105,37.49033883766508,29.343991151401006,33.16567001093391,8009503317
1503063000,242.9,244.189,242.2,242.71,NaN,NaN,245.41620689655176,249.67097560975608,234.53214600000013,241.51009999999988,244.718,246.3864999999999,244.4712487609315,245.5900709430663,245.98923076923077,249.53707051533226,242.44139102312928,234.53214600000013,241.51009999999988,244.718,246.3864999999999,243.03300000000002,136747986,67065065.4,38.29791970064772,0.9927729579074877,1.5,2.75,NaN,NaN,1.6013621634069968,2.0390345582217235,874.2727967794448,-0.5494053398948817,-0.11453637451901955,0.43486896537586217,13.865649366461819,-2.0817363940775393,10.803605813896498,63.09063561217139,26.105758573932114,7872755331
1503322200,242.64,243.2,241.83,242.9,NaN,NaN,241.83,249.7660975609756,234.69794600000014,241.58369999999988,244.7078,246.19049999999987,244.4096311624636,245.33387371039333,245.64000000000001,249.43316794738243,241.8468320526176,234.69794600000014,241.58369999999988,244.7078,246.19049999999987,242.64333333333332,65469736,68007439.4,39.27627459111954,1.0028831467088484,1.5,2.75,NaN,NaN,1.5848362945922096,0.9626849147330195,874.8211156599981,-0.591138803348002,-0.30405453880914024,0.2870842645388617,13.772182385219285,-1.7633260535468678,9.214546108601851,66.12650655079182,24.65894734060634,7938225067
1503408600,243.57,245.62,243.55,245.44,NaN,NaN,241.88208333333336,249.8612195121951,234.88124600000017,241.67519999999985,244.74939999999998,246.09149999999985,244.45003778354345,245.34398097607016,245.52307692307693,249.23920712380794,241.8069467223459,234.88124600000017,241.67519999999985,244.74939999999998,246.09149999999985,244.87,63140101,68418664.9,50.56184823393484,0.1673750620829067,1.5,2.75,NaN,NaN,1.6659194164070517,0.922849066000994,878.220170150378,-0.4268284831901835,-0.24645133944886766,0.18037714374131583,15.489919089223317,-0.7320525783619827,21.848588048612253,46.35872688214934,31.792685069238395,8001365168
1503495000,244.33,245.05,244.16,244.56,NaN,NaN,241.93416666666667,249.95634146341465,235.06129600000014,241.76339999999985,244.7496,245.94799999999987,244.45435002732606,245.26931612120634,245.30384615384617,248.8825656365949,241.72512667109743,235.06129600000014,241.76339999999985,244.7496,245.94799999999987,244.59,50203837,68550085.65,47.28312299581271,0.1878101269819726,1.5,2.75,NaN,NaN,1.6383537438065479,0.7323672395732447,879.190113176377,-0.35927091149374496,-0.2687114956258654,0.09055941586787958,15.565034468035766,0.3281916639317408,10.210170619088318,64.21147537617198,25.57835400473969,7951161331
1503581400,245,245.18,243.75,243.99,NaN,NaN,241.98625,250.05146341463416,235.21549600000014,241.84999999999985,244.7446,245.78749999999985,244.43614022233288,245.14747649061528,245.00538461538466,248.31534734244144,241.69542188832787,235.21549600000014,241.84999999999985,244.7446,245.78749999999985,244.3066666666667,50741671,67548840.8,45.23690529786654,0.2845103218035374,1.5,2.75,NaN,NaN,1.6234713335346522,0.7511849263296314,880.1579043306608,-0.33529524079880846,-0.328559635130631,0.0067356056681774495,13.222339901877339,-0.053252498771094316,15.464147625347337,55.318122004274564,29.2177303703781,7900419660
1503667800,244.9,245.61,244.39,244.56,NaN,NaN,242.03833333333336,250.14658536585367,235.36774600000012,241.94079999999988,244.76039999999998,245.6699999999999,244.44099746851592,245.0915263486519,244.79769230769236,247.8440435056693,241.7513411097154,235.36774600000012,241.94079999999988,244.76039999999998,245.6699999999999,244.85333333333332,64445912,68266718.45,47.67547761484933,0.012536575083128977,1.5,2.75,NaN,NaN,1.6232233811393202,0.9440311979724286,882.8842270960163,-0.2663763631764778,-0.3262348483024198,-0.059858485125941996,13.264118473397627,-0.8031151131662164,54.814420725386164,15.793287342350082,29.39229193226376,7964865572
1503927000,245.17,245.2,244.09,244.57,NaN,NaN,242.09041666666667,250.24170731707318,235.5087000000001,242.0386999999999,244.79899999999998,245.55999999999986,244.44605639131922,245.04185717258983,244.59153846153853,247.28890864697425,241.89416827610282,235.5087000000001,242.0386999999999,244.79899999999998,245.55999999999986,244.61999999999998,40565606,67003065.8,47.719461899539795,0.1558989544522052,1.5,2.75,NaN,NaN,1.5865645682007963,0.605429102618764,881.2219521805054,-0.2080315617184406,-0.31989793727399274,-0.11186637555555215,11.755429034053535,-0.786986329155003,51.080257542543364,18.324935173163407,30.59480728429322,8005431178
1504013400,243.06,245.15,242.93,244.85,NaN,NaN,242.1425,250.3368292682927,235.6483500000001,242.1327999999999,244.8028,245.43649999999988,244.46189731714983,245.0235850609146,244.67538461538467,247.33160072553974,242.0191685052296,235.6483500000001,242.1327999999999,244.8028,245.43649999999988,244.31000000000003,51135715,66807331.5,49.01188273665272,0.2156164070315752,1.5,2.75,NaN,NaN,1.6318099561864536,0.7654207083544416,880.4716762930581,-0.14166800200858762,-0.2889513780662867,-0.14728337605769906,11.804467974098575,-0.8463594395399706,48.48598506898758,20.210358041216214,31.30365688979618,8056566893
1504099800,244.83,246.32,244.62,246.01,NaN,NaN,242.19458333333336,250.4319512195122,235.79630000000012,242.24089999999987,244.8628,245.36499999999992,244.52260722628122,245.1175293408275,244.82076923076932,247.5454875540133,242.09605090752532,235.79630000000012,242.24089999999987,244.8628,245.36499999999992,245.65,62030805,67548310.95,54.07688750846167,0.42797724232979567,1.5,2.75,NaN,NaN,1.636680673601706,0.9183176326335662,882.9912425822663,-0.017274893243610367,-0.168876992612212,-0.15160209936860164,12.146490031431698,1.2012012012011961,77.80396759727311,4.174350925104431,18.02168147762244,8118597698
1504186200,246.72,247.77,246.0473,247.49,NaN,NaN,242.24666666666667,250.5270731707317,235.95080000000013,242.36239999999987,244.95359999999997,245.3914999999999,244.63897557034863,245.34347892741536,244.89384615384623,247.84096509602074,241.9467272116717,235.95080000000013,242.36239999999987,244.95359999999997,245.3914999999999,247.10243333333335,103803880,70695705.1,59.592137136977435,0.8421365125293878,1.5,2.75,NaN,NaN,1.6454891969158714,1.4683194665527144,885.7584258741331,0.15743014573633815,0.045185582801821056,-0.1122445629345171,7.701786442478742,1.9694285361130572,99.99999999999999,0,0,8222401578
1504272600,247.92,248.33,247.67,247.84,NaN,NaN,242.29875,250.62219512195122,236.09860000000012,242.49019999999985,245.05359999999996,245.41299999999993,244.7645059401389,245.5812428390901,244.9961538461539,248.23817162681692,241.75413606549088,236.09860000000012,242.49019999999985,245.05359999999996,245.41299999999993,247.9466666666667,62006989,70786462.65,60.79137808586914,0.9722106806119241,1.5,2.75,NaN,NaN,1.5879542542790237,0.8759724201305318,888.6347744786948,0.28203862578028227,0.24030371929083572,-0.04173490648944653,7.411498502565258,2.0337587484561537,99.99999999999999,0,0,8284408567
1504618200,247.26,247.52,244.95,246.06,NaN,NaN,242.35083333333336,250.71731707317073,236.2395500000001,242.6104999999999,245.11219999999997,245.32249999999993,244.8153096287609,245.62683875917676,244.9284615384616,248.0394034799761,241.81751959694708,236.2395500000001,242.6104999999999,245.11219999999997,245.32249999999993,246.17666666666662,91398777,73756650.45,52.29157386646733,0.17267054366869247,1.5,2.75,NaN,NaN,1.680957521830523,1.2391937058199203,885.4245477646517,0.2321409237748252,0.24844124822908498,0.01630032445425978,9.140039306559274,0.25260756192959766,70.97130575931878,6.925586287539766,22.103107953141453,8193009790
1504704600,246.84,247.28,246.23,246.9,NaN,NaN,242.40291666666667,250.81243902439024,236.3791000000001,242.75439999999992,245.18439999999995,245.3044999999999,244.8970621923389,245.74809221068375,245.2215384615385,248.30218620718185,242.14089071589515,236.3791000000001,242.75439999999992,245.18439999999995,245.3044999999999,246.8033333333333,57916867,73566526.15,55.45671543230772,0.448103552148734,1.5,2.75,NaN,NaN,1.648031984556914,0.7872720112121264,887.7142305066104,0.24215503067820546,0.3189941128020166,0.07683908212381116,7.286629759061984,0.9568204121687943,71.61686519242919,6.640888287368447,21.742246520202382,8250926657
1504791000,247.25,247.27,246.4,246.87,NaN,NaN,242.455,250.90756097560975,236.5209500000001,242.8773999999999,245.29519999999997,245.2854999999999,244.97443230244326,245.854940571571,245.5415384615385,248.3657289776386,242.71734794543838,236.5209500000001,242.8773999999999,245.29519999999997,245.2854999999999,246.84666666666666,58034730,73336631.7,55.315568293135016,0.32184252719733686,1.5,2.75,NaN,NaN,1.5924582713742776,0.7913470888246426,888.4347053288392,0.23312245487044286,0.3682421507118647,0.13511969584142186,6.81537333071746,1.1803762449280688,49.058186611517066,19.839014686953934,31.102798701529,8192891927
1504877400,246.54,247.11,246.3,246.58,NaN,NaN,242.50708333333336,251.00268292682927,236.6531000000001,243.00449999999992,245.35699999999997,245.4264999999999,245.03739574156313,245.923993850469,245.8246153846154,248.2412960756293,243.40793469360153,236.6531000000001,243.00449999999992,245.35699999999997,245.4264999999999,246.66333333333333,63832825,70504299.45,53.88776130030695,0.2172884612751352,1.5,2.75,NaN,NaN,1.5365683948475437,0.9053749274577041,887.1772489354813,0.19550136406125165,0.3794964009179864,0.18399503685673477,6.642476052996655,0.8259731763166545,17.99195721442236,51.623829910505066,30.38421287507257,8129059102
1505136600,248.04,249.3,248.02,249.21,NaN,NaN,242.55916666666667,251.09780487804878,236.7962500000001,243.16219999999993,245.51419999999996,245.6809999999999,245.20102728110967,246.236946817091,246.1146153846154,249.11208729774924,243.11714347148157,236.7962500000001,243.16219999999993,245.51419999999996,245.6809999999999,248.84333333333333,71364848,70329044.5,63.171938480716754,1.0191006886595537,1.5,2.75,NaN,NaN,1.6210992237870048,1.0147279620726257,891.1038482043375,0.32783569683991315,0.5937896579066262,0.26595396106671304,8.622075793994469,1.8972073435008443,18.31291961080993,51.11091544842549,30.57616494076458,8200423950
1505223000,249.63,250.09,249.42,250.05,NaN,NaN,242.61125,251.1929268292683,236.94300000000013,243.30929999999992,245.67919999999995,245.85649999999993,245.39118307400733,246.6000947392728,246.5369230769231,250.04307928581247,243.03076686803374,236.94300000000013,243.30929999999992,245.67919999999995,245.85649999999993,249.85333333333332,56896027,69509249.9,65.5571891188956,1.1149751216660633,1.5,2.75,NaN,NaN,1.5681635649450756,0.8185389294497335,893.3962644871694,0.4447767900423066,0.8219249486195963,0.3771481585772897,8.573136455978382,2.1237492342250426,47.6149786115214,20.875672770094944,31.50934861838365,8257319977
1505309400,249.72,250.21,249.59,250.17,NaN,NaN,242.66333333333336,251.2880487804878,237.08625000000015,243.46509999999992,245.83839999999998,246.03949999999992,245.57858765934037,246.94008571648493,247.01230769230776,250.68034975101943,243.34426563359608,237.08625000000015,243.46509999999992,245.83839999999998,246.03949999999992,249.99000000000004,59228002,69708512.7,65.8969977593829,1.0078474600276301,1.5,2.75,NaN,NaN,1.5004375960204277,0.8496523552997853,894.2544523957806,0.49897699933089423,1.0008694077409075,0.5018924084100133,8.61182344696538,1.690988171212551,48.00230143072814,20.583005819852872,31.414692749418997,8316547979
1505395800,249.8,250.32,249.6,250.09,NaN,NaN,242.71541666666667,251.3831707317073,237.2343000000001,243.59429999999992,245.98479999999995,246.19699999999995,245.75550579034663,247.24007755301017,247.43769230769237,251.15183288617717,243.72355172920757,237.2343000000001,243.59429999999992,245.98479999999995,246.19699999999995,250.00333333333333,95446349,71645052.95,65.43351932176098,0.8789321665139513,1.5,2.75,NaN,NaN,1.4446920534475398,1.332211298198224,895.8457129312502,0.49711037126505875,1.1232803724913367,0.626170001226278,8.546102960121656,1.050547496868558,38.36794903211054,28.552782393873425,33.079268574016034,8221101630
1505482200,248.69,249.29,248.57,249.19,NaN,NaN,242.7675,251.47829268292682,237.3757000000001,243.70069999999993,246.15759999999997,246.5019999999999,245.89019183778402,247.4257844527235,247.793076923077,251.21420030687872,244.37195353927527,237.3757000000001,243.70069999999993,246.15759999999997,246.5019999999999,249.01666666666662,95432382,69992152.25,60.29560597347448,0.41291541907761425,1.5,2.75,NaN,NaN,1.450071192487002,1.3634726027445456,898.2634780636181,0.4067364880465958,1.1345906112845228,0.727854123237927,8.533095187716285,0.5447062621045813,32.111292799463925,34.58357167009827,33.3051355304378,8125669248
1505741400,249.61,250.12,249.28,249.72,NaN,NaN,242.81958333333336,251.57341463414633,237.52240000000012,243.81389999999993,246.30979999999997,246.8524999999999,246.04038039316504,247.64428117151172,248.16769230769236,251.26931623815793,245.0660683772268,237.52240000000012,243.81389999999993,246.30979999999997,246.8524999999999,249.70666666666668,46235238,65466514.85,62.178984957807536,0.5626974539253362,1.5,2.75,NaN,NaN,1.4129232501665023,0.7062425440843518,900.1830313149463,0.35595774479166253,1.1728013042275052,0.8168435594358426,8.564951939521404,1.48744208729578,27.554273401049368,39.48140964047289,32.964316958477745,8171904486
1505827800,250,250.07,249.6,249.97,NaN,NaN,242.87166666666667,251.66853658536584,237.67440000000013,243.92759999999996,246.46179999999993,247.20599999999996,246.19448312284484,247.86577820279632,248.4723076923077,251.44146353035802,245.5031518542574,237.67440000000013,243.92759999999996,246.46179999999993,247.20599999999996,249.88,47108148,64548435.45,63.06888332479072,0.5720496167222724,1.5,2.75,NaN,NaN,1.3455715894403235,0.7298108416042174,901.3319438442539,0.313978128237667,1.2093162197329264,0.8953380914952593,6.911775570625501,1.2434183880113379,25.666063989139126,41.65507716004475,32.67885885081612,8219012634
1505914200,250.07,250.19,248.92,250.06,NaN,NaN,242.92375,251.76365853658535,237.82630000000012,244.04739999999995,246.61919999999992,247.43699999999998,246.34607201998818,248.0747517072919,248.67000000000002,251.6929583065673,245.64704169343273,237.82630000000012,244.04739999999995,246.61919999999992,247.43699999999998,249.72333333333336,59574083,64370134.55,63.402726989779545,0.4023071000690756,1.5,2.75,NaN,NaN,1.3401736187660156,0.9254925970944705,902.9620183386078,0.2687878288238854,1.2313228775251162,0.9625350487012307,6.837359934289234,1.2921780694292533,25.72850369627433,41.58172997418808,32.68976632953758,8278586717
1506000600,249.88,249.98,249.185,249.39,NaN,NaN,242.97583333333336,251.8587804878049,237.96825000000013,244.15449999999993,246.72679999999988,247.67849999999999,246.46544174469452,248.2000134494546,248.78923076923076,251.79405214154232,245.7844093969192,237.96825000000013,244.15449999999993,246.72679999999988,247.67849999999999,249.51833333333332,48211398,64270512.6,59.11832881749343,0.30269704186943125,1.5,2.75,NaN,NaN,1.3069469317113003,0.750132464323927,901.3190794717291,0.17484003943006576,1.181085097988813,1.0062450585587472,7.1770441668943725,1.1395895855300404,34.87791946856413,31.82466729869652,33.297413232739345,8230375319
1506087000,249.05,249.63,249.02,249.44,NaN,NaN,243.02791666666667,251.9539024390244,238.10695000000015,244.26119999999992,246.8271999999999,247.95099999999996,246.58209108803982,248.31810740664937,249.04923076923075,251.61768389894868,246.4807776395128,238.10695000000015,244.26119999999992,246.8271999999999,247.95099999999996,249.36333333333332,51214032,64294130.65,59.33914873307621,0.1728822445711221,1.5,2.75,NaN,NaN,1.2571650080176349,0.7965584335963022,904.0187624694694,0.10080712040004292,1.1322539590588008,1.0314468386587579,7.066201991905606,0.09229164158741213,77.0369853338434,4.452688503548439,18.510326162608163,8281589351
1506346200,249.15,249.5532,248.08,248.93,NaN,NaN,243.08,252.04902439024391,238.22860000000014,244.36569999999992,246.8945999999999,248.16949999999997,246.67416594733237,248.3763828917304,249.2053846153846,251.45982454773377,246.9509446830354,238.22860000000014,244.36569999999992,246.8945999999999,248.16949999999997,248.85440000000003,57064357,63925052.9,56.0155899235288,0.06973682911712202,1.5,2.75,NaN,NaN,1.2725960788735176,0.8926759448954636,905.6247856152638,0.007169732691563624,1.0404090045232124,1.0332392718316488,3.896610997195399,-0.4479104179164185,47.638048085684275,20.848425935047032,31.513525979268692,8224524994
1506432600,249.42,249.7,248.805,249.08,NaN,NaN,243.13208333333336,252.14414634146343,238.34825000000015,244.46889999999996,246.9655999999999,248.39499999999998,246.76851238077032,248.44339404489892,249.37538461538458,251.1902059100755,247.56056332069366,238.34825000000015,244.46889999999996,246.9655999999999,248.39499999999998,249.19500000000002,54081959,64600870.55,56.782297054556594,0.12325281990650423,1.5,2.75,NaN,NaN,1.2456249303825508,0.8371707461456184,907.4561365247965,-0.051743412742202066,0.9685600059038961,1.0203034186460982,3.26769295409893,-0.43570372146939085,49.10173957853138,19.75474887624239,31.14351154522622,8278606953
1506519000,249.88,250.49,248.87,250.05,NaN,NaN,243.18416666666667,252.23926829268294,238.46595000000016,244.57239999999993,247.0533999999999,248.65499999999997,246.89719816975972,248.59640413586092,249.6423076923077,250.50501020275914,248.77960518185625,238.46595000000016,244.57239999999993,247.0533999999999,248.65499999999997,249.80333333333337,81001426,66094156.1,61.460720052538605,0.40131419343511904,1.5,2.75,NaN,NaN,1.2723660067837976,1.2255459601820984,909.4101533666333,-0.033355333370801654,0.9786092519325962,1.0119645853033978,4.080543983052539,-0.01599424207285059,53.300654610707696,16.787519659096503,29.911825730195808,8359608379
1506605400,249.73,250.44,249.63,250.35,NaN,NaN,243.23625,252.33439024390245,238.58645000000016,244.67929999999993,247.1205999999999,248.87199999999999,247.03260216310247,248.76341326577892,249.73,250.63005128071583,248.82994871928415,238.58645000000016,244.67929999999993,247.1205999999999,248.87199999999999,250.14,44778841,65231557.9,62.80191703697391,0.38493800091493285,1.5,2.75,NaN,NaN,1.239339863442098,0.6864597817615513,911.3655380888209,-0.010162088576619599,0.9992619745826232,1.0094240631592428,4.136091802606474,0.4655082467193694,76.63587094565088,4.596448093259697,18.767680961089432,8404387220
1506691800,250.34,251.32,250.13,251.23,NaN,NaN,243.28833333333336,252.42951219512196,238.70380000000014,244.79719999999995,247.2031999999999,249.05899999999997,247.19720599984353,248.99832628808568,249.8207692307692,251.0199089619798,248.6216294995586,238.70380000000014,244.79719999999995,247.2031999999999,249.05899999999997,250.89333333333335,85578002,64320264,66.48624409091494,0.5925407903792901,1.5,2.75,NaN,NaN,1.235815587481948,1.33049830143732,913.5945522065438,0.0518645190656013,1.0742547119912444,1.0223901929256431,3.8039894415396187,0.6046772385071243,79.49183773381804,3.597680875780106,16.91048139040184,8489965222
1506951000,251.49,252.32,251.2926,252.32,NaN,NaN,243.34041666666667,252.52463414634147,238.83600000000015,244.92169999999996,247.3119999999999,249.28299999999996,247.39809988220262,249.31467616541084,249.98615384615383,251.77860877579585,248.1936989165118,238.83600000000015,244.92169999999996,247.3119999999999,249.28299999999996,251.97753333333333,59022985,64171063.8,70.39732724640473,0.853117028537111,1.5,2.75,NaN,NaN,1.225400188376095,0.919775698030426,916.2642474564315,0.14826308861864712,1.207719053698952,1.0594559650803048,4.263117676816698,0.9401128135376222,100,0,0,8548988207
1507037400,252.46,252.89,252.23,252.86,NaN,NaN,243.3925,252.61975609756098,238.96625000000017,245.05649999999994,247.43279999999993,249.6229999999999,247.61229204368487,249.65232605441935,250.19923076923075,252.55914552052198,247.83931601793952,238.96625000000017,245.05649999999994,247.43279999999993,249.6229999999999,252.66,66810169,62941633.4,72.13242922712774,0.9216213518114345,1.5,2.75,NaN,NaN,1.1850144606349449,1.061462268947091,917.7066540956118,0.22571432902557165,1.3415988763622693,1.1158845473366976,4.309272438890668,1.1197312644965254,100,0,0,8615798376
1507123800,252.69,253.44,252.56,253.16,NaN,NaN,243.44458333333336,252.7148780487805,239.1068500000002,245.19829999999993,247.5475999999999,249.93599999999992,247.82984921844232,249.98639023971273,250.50461538461533,253.25780224171297,247.7514285275177,239.1068500000002,245.19829999999993,247.5475999999999,249.93599999999992,253.0533333333333,55953619,62843471,73.07656977727513,0.9316572459794676,1.5,2.75,NaN,NaN,1.1632277134467341,0.8903648717939211,917.1312187579634,0.27139894066082815,1.4551332231627327,1.1837342825019046,4.279941067557984,1.5116885199887768,100,0,0,8671751995
1507210200,253.54,254.68,253.196,254.66,NaN,NaN,243.49666666666667,252.81,239.25250000000023,245.34189999999995,247.6921999999999,250.32549999999992,248.09769826869947,250.43149593116866,250.88461538461536,254.3668570621642,247.40237370706652,239.25250000000023,245.34189999999995,247.6921999999999,250.32549999999992,254.17866666666666,63522757,63117872.35,77.23039098138344,1.259636597835282,1.5,2.75,NaN,NaN,1.1887114482005394,1.0064147385665163,919.3824810301525,0.3707406054687774,1.6471600393378765,1.276419433869099,4.2436876873423595,2.092687620269403,100,0,0,8735274752
1507296600,254.15,254.7008,253.85,254.37,NaN,NaN,243.54875,252.9051219512195,239.39235000000022,245.48479999999992,247.8355999999999,250.71499999999992,248.34367088561322,250.80659155677165,251.2230769230769,255.11514684591432,247.33100700023945,239.39235000000022,245.48479999999992,247.8355999999999,250.71499999999992,254.30693333333335,80645998,63958531,74.82677084470346,1.0007826567939753,1.5,2.75,NaN,NaN,1.1645749161862147,1.2609107297977185,916.9179173620615,0.38342720640537964,1.7557034418758235,1.3722762354704439,4.52194060957981,2.1853533121761126,69.0639454209194,7.773899697567315,23.16215488151329,8654628754
1507555800,254.63,254.7,253.65,253.95,NaN,NaN,243.60083333333336,253.00024390243902,239.53325000000024,245.66609999999994,247.97639999999993,250.9519999999999,248.56352692931466,251.10596378946008,251.52230769230766,255.60420132414237,247.44041406047296,239.53325000000024,245.66609999999994,247.97639999999993,250.9519999999999,254.09999999999997,35803138,62180445.5,71.36271457535864,0.7978255035873643,1.5,2.75,NaN,NaN,1.1563909936014838,0.5757941698889887,915.4179173620615,0.3319648350511959,1.7872322792844386,1.4552674442332427,4.398512171269029,1.9551951180343567,50.69919561672855,18.624356288343833,30.67644809492761,8618825616
1507642200,254.6,255.05,253.98,254.62,NaN,NaN,243.65291666666667,253.09536585365854,239.67945000000026,245.84459999999993,248.13339999999994,251.18049999999988,248.80103567718467,251.4406339047496,251.92461538461535,256.1160323683538,247.73319840087692,239.67945000000026,245.84459999999993,248.13339999999994,251.18049999999988,254.54999999999998,43057363,61488512.3,73.47248274480907,0.8296097937632955,1.5,2.75,NaN,NaN,1.1523630654870938,0.7002505246821528,917.9546046917685,0.31179751173378945,1.8450143339004796,1.5332168221666902,4.316871536223983,1.8276344731053762,46.033178635471025,22.11463394028411,31.85218742424487,8661882979
1507728600,254.51,255.02,254.32,255.02,NaN,NaN,243.705,253.19048780487805,239.82600000000025,246.0116999999999,248.28739999999993,251.42299999999992,249.04491663102056,251.78152591382107,252.35384615384612,256.58228131422936,248.12541099346285,239.82600000000025,246.0116999999999,248.28739999999993,251.42299999999992,254.7866666666667,47674325,60910828.45,74.67217711328436,0.7930057102126751,1.5,2.75,NaN,NaN,1.1200514179523027,0.7826904708599477,919.83866118619,0.2943611038230667,1.9011682019455236,1.606807098122457,4.188747033299812,1.8653884561613805,44.28656345363863,23.504543296335985,32.20889325002539,8709557304
1507815000,254.66,255.06,254.365,254.64,NaN,NaN,243.75708333333336,253.28560975609756,239.96785000000025,246.1628999999999,248.4313999999999,251.6504999999999,249.26433166509818,252.0537615410762,252.79307692307688,256.6801235347362,248.90603031141754,239.96785000000025,246.1628999999999,248.4313999999999,251.6504999999999,254.68833333333336,47080269,58492524.45,71.37001717352382,0.6467257719607257,1.5,2.75,NaN,NaN,1.0896906023842805,0.8048937781826238,921.1326544646313,0.22910173982109172,1.8931842728988215,1.6640825330777298,4.6296237005250465,1.3573219758786756,17.3521863111595,52.512681454767566,30.135132234072938,8662477035
1507901400,255.14,255.27,254.64,254.95,NaN,NaN,243.80916666666667,253.38073170731707,240.12060000000022,246.31189999999992,248.59119999999996,251.93849999999992,249.48729905078062,252.3295937752594,253.24461538461534,256.6332626335577,249.855968135673,240.12060000000022,246.31189999999992,248.59119999999996,251.93849999999992,254.9533333333333,54800435,56460927.1,72.44072234821337,0.6660201978350792,1.5,2.75,NaN,NaN,1.0568555593568336,0.9705904209284583,923.3097712273186,0.18080089594932525,1.8900836530143863,1.709282757065061,4.486760782616005,1.0423272035510445,54.034329318027545,16.320086468344577,29.645584213627863,8717277470
1508160600,255.21,255.51,254.82,255.29,NaN,NaN,243.86125,253.47585365853658,240.27530000000024,246.4586999999999,248.74879999999996,252.21699999999993,249.71485595075,252.6115372252347,253.64769230769224,256.6443792357256,250.65100537965887,240.27530000000024,246.4586999999999,248.74879999999996,252.21699999999993,255.2066666666667,38521675,56075248.95,73.60658221620388,0.6229932970339915,1.5,2.75,NaN,NaN,1.0306515908313454,0.6869639586325902,922.6692586120982,0.14716378210355874,1.8932374846945095,1.7460737025909507,4.101928695849673,0.9610060903266544,76.58482651840575,4.628841193720893,18.78633228787335,8755799145
1508247000,255.23,255.52,254.98,255.47,NaN,NaN,243.91333333333336,253.5709756097561,240.43500000000026,246.59579999999994,248.90079999999995,252.4919999999999,249.94054787425,252.88377177521235,254.04153846153838,256.4982385140833,251.58483840899342,240.43500000000026,246.59579999999994,248.90079999999995,252.4919999999999,255.32333333333335,31560964,55297889.75,74.22816941516962,0.5645600468224778,1.5,2.75,NaN,NaN,0.9956050486291079,0.5707444559401111,921.0473970943943,0.11393468100651272,1.8884920538490917,1.774557372842579,4.060559867579428,0.9124664243956401,75.18076253796505,5.162399450007389,19.656838012027556,8787360109
1508333400,255.9,255.95,255.5,255.72,NaN,NaN,243.96541666666667,253.6660975609756,240.58740000000026,246.73589999999996,249.06999999999994,252.77499999999992,250.16719305565195,253.15388874900165,254.38692307692298,256.38512818875694,252.38871796508903,240.58740000000026,246.73589999999996,249.06999999999994,252.77499999999992,255.72333333333333,40888330,54363602.1,75.10510738350915,0.6550505188972469,1.5,2.75,NaN,NaN,0.958776116584171,0.7521269456131201,921.9031327221246,0.08691079506642208,1.8831958666756066,1.7962850716091845,4.059339235476911,0.4162412628602852,74.2790414010871,5.518928371066617,20.202030227846283,8828248439
1508419800,254.83,255.83,254.35,255.79,NaN,NaN,244.0175,253.7612195121951,240.73345000000026,246.87879999999998,249.24079999999995,253.09499999999989,250.38769528876364,253.40494696338246,254.65384615384605,256.3856222713173,252.9220700363748,240.73345000000026,246.87879999999998,249.24079999999995,253.09499999999989,255.32333333333335,61903788,55048221.6,75.35794589658411,0.46313399109175835,1.5,2.75,NaN,NaN,0.9960063939710172,1.1245374727963964,922.435846326028,0.053507587758195196,1.8631695563069286,1.8096619685487334,2.597410675663992,0.5582419310453227,100.00000000000001,0,0,8890152227
1508506200,256.7,257.14,255.7744,257.11,NaN,NaN,244.06958333333336,253.85634146341465,240.88700000000026,247.03549999999998,249.50779999999995,253.47849999999988,250.65131508136113,253.75780915734603,254.9807692307691,256.8348534798592,253.12668498167903,240.88700000000026,247.03549999999998,249.50779999999995,253.47849999999988,256.6748,89176377,56946338.85,79.57135079469835,0.8477733124589308,1.5,2.75,NaN,NaN,1.0224059372587997,1.5659720853151913,924.8623356557572,0.0975071218837722,1.9315458709034488,1.8340387490196766,3.531074602683413,1.2443394368970369,100.00000000000001,0,0,8979328604
1508765400,257.48,257.51,256.02,256.11,NaN,NaN,244.12166666666667,253.95146341463416,241.03150000000028,247.16299999999998,249.74759999999995,253.83749999999986,250.86538115660187,253.9818273328369,255.2076923076922,256.8213675938977,253.5940170214867,241.03150000000028,247.16299999999998,249.74759999999995,253.83749999999986,256.5466666666667,63915306,57288886.3,69.83019880432633,0.6192728934434878,1.5,2.75,NaN,NaN,1.0558055131688862,1.115666757166477,922.1302511559136,0.039435448003740436,1.883333059024352,1.8438976110206116,4.311191729507916,0.5851857670253747,74.40014094778185,5.482934799430723,20.116924252787424,8915413298
1508851800,256.6,256.83,256.15,256.56,NaN,NaN,244.17375,254.04658536585367,241.18200000000027,247.28690000000003,249.94799999999992,254.2114999999999,251.0886995426175,254.22736758685244,255.35384615384606,257.0826881578591,253.62500414983307,241.18200000000027,247.28690000000003,249.94799999999992,254.2114999999999,256.5133333333333,66935910,57931583.85,71.51983530380646,0.5235256771909909,1.5,2.75,NaN,NaN,1.0318194050853922,1.155430346481024,923.57452865695,0.01287746267001677,1.8599944393581325,1.8471169766881157,4.206271982043848,0.6038742059446286,77.63108326867804,4.258688527411215,18.110228203910754,8982349208
1508938200,256.18,256.31,254,255.29,NaN,NaN,244.22583333333336,254.14170731707318,241.32615000000027,247.3999,250.12359999999993,254.4734999999999,251.25345642329916,254.32857067381886,255.42461538461532,257.059327599011,253.78990317021965,241.32615000000027,247.3999,250.12359999999993,254.4734999999999,255.20000000000002,103715291,59067277.1,61.11685609777999,0.013771568232620013,1.5,2.75,NaN,NaN,1.1409751618650072,1.7558840713854404,919.726345886044,-0.10233187183696568,1.7192021368919086,1.8215340087288743,5.2767054791051535,0.2552623311341524,44.36030930306451,23.488674757182142,32.15101593975335,8878633917
1509024600,255.99,256.3,255.48,255.62,NaN,NaN,244.27791666666667,254.2368292682927,241.46875000000028,247.524,250.29719999999995,254.73699999999985,251.42469342630704,254.45156394297896,255.55307692307684,256.9491237510283,254.15703009512538,241.46875000000028,247.524,250.29719999999995,254.73699999999985,255.79999999999998,69797972,60318233.65,62.63761618065221,0.21006523029695898,1.5,2.75,NaN,NaN,1.1316197931603653,1.1571620681899726,921.1754835606629,-0.16472519371067085,1.6156275165905356,1.7803527103012065,5.2099345577448535,0.26279662678957283,45.59743471743754,22.499827249867845,31.902738032694614,8948431889
1509111000,256.47,257.89,255.6254,257.71,NaN,NaN,244.33,254.3319512195122,241.6246500000003,247.6645,250.5895999999999,255.06099999999986,251.6711760370401,254.76189118650478,255.79076923076917,257.48975465727784,254.0917838042605,241.6246500000003,247.6645,250.5895999999999,255.06099999999986,257.0751333333333,85562544,60317460.75,70.50549229913224,0.788394470275316,1.5,2.75,NaN,NaN,1.212932665077481,1.4185369035118078,923.5995516691719,-0.07804917069329731,1.6827912469345847,1.760840417627882,6.863834647234093,0.9479415566610473,45.06196831522973,22.92495193217856,32.013079752591715,9033994433
1509370200,257.07,257.6,256.41,256.75,NaN,NaN,244.38208333333336,254.42707317073172,241.77315000000027,247.79420000000002,250.87039999999993,255.28249999999989,251.870345604215,254.95123488302815,255.9238461538461,257.6314857927363,254.2162065149559,241.77315000000027,247.79420000000002,250.87039999999993,255.28249999999989,256.92,54285687,60080595.85,63.853978066665725,0.4459263136193449,1.5,2.75,NaN,NaN,1.2191517604290862,0.9035477466890003,920.9107071111002,-0.09694905539938037,1.6396540983786565,1.7366031537780369,7.388677170013092,0.5010373037930094,46.36007620914063,21.855099972180867,31.784823818678497,8979708746
1509456600,257.18,257.44,256.805,257.15,NaN,NaN,244.43416666666667,254.52219512195123,241.92765000000028,247.93160000000003,251.15539999999993,255.4969999999999,252.07739087463796,255.1606410846445,256.11692307692306,257.7668812976966,254.4669648561495,241.92765000000028,247.93160000000003,251.15539999999993,255.4969999999999,257.13166666666666,60304781,59755326.45,65.32197572644225,0.49394449523740697,1.5,2.75,NaN,NaN,1.1813552061127228,1.009195072349906,923.9991470956979,-0.09401812123436648,1.6190805022350787,1.7130986234694452,7.410440664055186,0.5592053808853349,45.32234124521877,22.67002768283748,32.007631071943734,9040013527
1509543000,258.04,258.43,257.07,257.49,NaN,NaN,244.48625,254.61731707317074,242.08135000000027,248.07290000000003,251.39639999999991,255.7134999999999,252.2896500560247,255.38248479086883,256.3123076923076,257.9648144845308,254.65980090008443,242.08135000000027,248.07290000000003,251.39639999999991,255.7134999999999,257.66333333333336,54202736,59667782.3,66.56497290823677,0.5728005486337155,1.5,2.75,NaN,NaN,1.1941155485332438,0.9084087578029526,925.2493571620804,-0.08117247065910904,1.6116330351455588,1.6928055058046678,7.418501223782561,0.6646076859924224,81.13608573799029,3.0796020229596404,15.78431223905008,9094216263
1509629400,257.41,257.75,256.19,257.59,NaN,NaN,244.53833333333336,254.71243902439025,242.23975000000024,248.20330000000004,251.65699999999993,255.8599999999999,252.49750691657275,255.5927243345956,256.48923076923074,258.15845373981114,254.82000779865035,242.23975000000024,248.20330000000004,251.65699999999993,255.8599999999999,257.1766666666667,56449535,59314121.2,66.94030902267855,0.3792063279605538,1.5,2.75,NaN,NaN,1.2202501522094409,0.9517048193238679,925.6694411872888,-0.0779170889835743,1.5954091445752,1.6733262335587742,7.416445821142863,0.18669052156662957,80.24992140698473,3.358000380575711,16.392078212439547,9150665798
1509715800,257.77,258.5,257.3,258.45,NaN,NaN,244.59041666666667,254.80756097560976,242.39830000000023,248.34540000000004,251.94619999999995,256.0639999999999,252.73093801788363,255.86484582653887,256.7184615384615,258.57303337218974,254.86388970473328,242.39830000000023,248.34540000000004,251.94619999999995,256.0639999999999,258.0833333333333,59589730,58261307.8,70.0537734933171,0.6416024733051788,1.5,2.75,NaN,NaN,1.2188037127659084,1.0228011050586132,924.7635219551427,-0.0321643412385062,1.6331208070106413,1.6652851482491475,7.0849771447305985,0.9136699074616278,78.19451424288958,4.045461963043217,17.7600237940672,9210255528
1509978600,258.3,259,258.22,258.85,NaN,NaN,244.6425,254.90268292682927,242.56180000000023,248.49620000000002,252.23199999999997,256.3089999999999,252.97090123286858,256.14914622401136,256.95923076923077,259.0325849679025,254.88587657055905,242.56180000000023,248.49620000000002,252.23199999999997,256.3089999999999,258.69,49652598,58953780.8,71.4027833218792,0.7292007368661045,1.5,2.75,NaN,NaN,1.1874605904254842,0.8422292400286565,926.8814724469423,0.00854368129228611,1.6759647498645052,1.667421068572219,6.509964910449769,0.8925787340193406,99.99999999999999,0,0,9259908126
1510065000,258.97,259.35,258.09,258.67,NaN,NaN,244.69458333333336,254.99780487804878,242.71715000000023,248.65650000000002,252.51399999999998,256.51149999999996,253.19439530216786,256.38922753601025,257.1807692307692,259.3214155966844,255.04012286485403,242.71715000000023,248.65650000000002,252.51399999999998,256.51149999999996,258.7033333333334,57502161,59676020.7,69.87730392622416,0.568690812096349,1.5,2.75,NaN,NaN,1.1926419768236673,0.9635723080309206,924.8144148104146,0.0069220681913335635,1.676073653811386,1.6691515856200525,6.566296861591048,1.323984488229082,75.51993223943892,5.019079907817578,19.460987852743518,9202405965
1510151400,258.47,259.22,258.15,259.11,NaN,NaN,244.74666666666667,255.0929268292683,242.86485000000022,248.80100000000002,252.79919999999998,256.7159999999999,253.42637980012208,256.64834872305687,257.3346153846154,259.7076642561739,254.96156651305688,242.86485000000022,248.80100000000002,252.79919999999998,256.7159999999999,258.82666666666665,50469579,59815783.4,71.48123875161728,0.5925085989675746,1.5,2.75,NaN,NaN,1.1838818356219802,0.8437501965409351,925.4130243102836,0.01840524194940718,1.6921581380568114,1.6737528961074042,5.438665635027438,1.36530787888272,75.16994241113527,5.154338589468834,19.675718999395905,9252875544
1510237800,257.73,258.39,256.36,258.17,NaN,NaN,244.79875,255.1880487804878,243.0090500000002,248.95260000000002,253.0424,256.89249999999987,253.61240412168593,256.7932678922896,257.4930769230769,259.79181750958304,255.19433633657073,243.0090500000002,248.95260000000002,253.0424,256.89249999999987,257.64000000000004,95085497,62216044.8,63.68012445186169,0.10901151153426061,1.5,2.75,NaN,NaN,1.2957474187918387,1.528311503980401,923.0358845056458,-0.050610050052388944,1.610490333541918,1.661100383594307,6.184384815813136,0.17849520779171799,35.485834957243235,31.235106063255547,33.27905897950123,9157790047
1510324200,257.73,258.2926,257.37,258.09,NaN,NaN,244.85083333333336,255.28317073170732,243.15465000000017,249.104,253.25439999999998,257.0494999999999,253.78799611691392,256.916766188262,257.6107692307692,259.8625577375681,255.3589807239703,243.15465000000017,249.104,253.25439999999998,257.0494999999999,257.9175333333333,59984662,62475256.15,63.04946804155644,0.14800803775781277,1.5,2.75,NaN,NaN,1.2690940317352781,0.9601347108682483,921.3014691224946,-0.11146378380434863,1.5217706538388711,1.6332344376432197,4.194821119317204,0.5219084712755502,13.477940106356412,58.462936208430726,28.059123685212843,9097805385
1510583400,257.31,258.59,257.27,258.33,NaN,NaN,244.90291666666667,255.37829268292683,243.30855000000017,249.25890000000004,253.46419999999998,257.2014999999999,253.96611391625063,257.05135988461797,257.8446153846154,259.67594303055284,256.01328773867795,243.30855000000017,249.25890000000004,253.46419999999998,257.2014999999999,258.0633333333333,50228648,63060604.8,64.19508004710269,0.2225048045405572,1.5,2.75,NaN,NaN,1.2727301723256148,0.7965138957880722,919.6873115753029,-0.1433362567498837,1.4540641167058652,1.597400373455749,3.396094084464237,0.45887614232938245,12.480226316317486,60.183467324314215,27.33630635936829,9148034033
1510669800,257.41,257.85,256.52,257.73,NaN,NaN,244.955,255.47341463414634,243.4595500000002,249.40490000000003,253.6976,257.3144999999999,254.11371729208395,257.1159922765591,258.0069230769231,259.32209804895996,256.69174810488624,243.4595500000002,249.40490000000003,253.6976,257.3144999999999,257.3666666666667,61315152,64548314.2,59.2494053292539,0.15144360700879578,1.5,2.75,NaN,NaN,1.311106588588071,0.9499109738175006,917.4392538712259,-0.20865317446746912,1.3365839053714126,1.5452370798388817,3.7163187119873102,0.09320750320401146,12.173984042662116,60.70945899797933,27.116556959358544,9086718881
1510756200,256.62,257.22,255.63,256.44,NaN,NaN,245.00708333333336,255.56853658536585,243.6036500000002,249.5364,253.8884,257.3504999999999,254.2049440649434,257.05161205974395,257.90923076923076,259.46481547828273,256.3536460601788,243.6036500000002,249.5364,253.8884,257.3504999999999,256.43,80811525,66544473.95,50.280375648686764,0.44409684526944027,1.5,2.75,NaN,NaN,1.367456117974639,1.2143987352085754,914.8608822921086,-0.33506702672719735,1.126403296429885,1.4614703231570823,4.683986276720237,-0.44644590240303483,2.225708850401213,84.12567972572786,13.648611423870927,9005907356
1510842600,257.52,259.04,257.4748,258.62,NaN,NaN,245.05916666666667,255.66365853658536,243.75790000000023,249.70929999999996,254.1234,257.49199999999985,254.378083513377,257.20098233976836,258.0530769230769,259.49496424646634,256.61118959968746,243.75790000000023,249.70929999999996,254.1234,257.49199999999985,258.37826666666666,67777027,66838135.9,61.01933456105307,0.3846174231807132,1.5,2.75,NaN,NaN,1.4554949666907377,1.0140472364669884,918.6367454857563,-0.27093745191082985,1.122798508268545,1.3937359601793748,6.933101822958374,0.06577674598569004,16.86817063717901,53.24050936905286,29.891319993768136,9073684383
1510929000,258.22,258.5882,257.77,257.86,NaN,NaN,245.11125,255.75878048780487,243.90050000000025,249.85299999999995,254.34900000000002,257.52949999999987,254.51462925795045,257.2637459264571,258.10769230769233,259.4595947585973,256.7557898567874,243.90050000000025,249.85299999999995,254.34900000000002,257.52949999999987,258.0727333333333,75756833,66167158.7,56.442332803155914,0.12936637926455913,1.5,2.75,NaN,NaN,1.4122453262128296,1.1449310275431246,921.3504895377371,-0.27774713708978793,1.0465520388171399,1.3242991759069278,6.896734120670048,-0.38246088468225187,15.203181467558966,55.75630816093274,29.040510371508287,8997927550
1511188200,258.14,258.525,257.86,258.3,NaN,NaN,245.16333333333336,255.8539024390244,244.04735000000025,250.02249999999995,254.53080000000003,257.6389999999999,254.66307516940336,257.362436790604,258.17,259.4761746850064,256.8638253149936,244.04735000000025,250.02249999999995,254.53080000000003,257.6389999999999,258.2283333333333,48075514,65375169.1,58.388374155018624,0.19640955131053306,1.5,2.75,NaN,NaN,1.3588706600547678,0.7353788091387131,923.4035058633073,-0.2514489626733605,1.0099879725652272,1.2614369352385877,6.912195295140918,-0.1430393938222463,17.04188561262688,53.049995517420854,29.908118869952254,9046003064
1511274600,259.18,260.2,259.18,259.99,NaN,NaN,245.21541666666667,255.94902439024392,244.20260000000025,250.2044,254.72960000000003,257.8104999999999,254.87197418236792,257.6126809057846,258.3546153846154,259.9311474187153,256.7780833505155,244.20260000000025,250.2044,254.72960000000003,257.8104999999999,259.79,69176799,65487213.55,64.87882923190301,0.6994842411491885,1.5,2.75,NaN,NaN,1.39752275576514,1.0563405472609242,926.6039305924021,-0.12543283420596585,1.1046458924811304,1.2300787266870963,7.895858541837709,0.33962409787348824,41.42510555232394,25.957427266669363,32.61746718100671,9115179863
1511361000,260,260.15,259.57,259.76,NaN,NaN,245.2675,256.04414634146343,244.35520000000025,250.3799,254.92140000000003,258.0339999999999,255.06366146933388,257.81718748618607,258.4553846153846,260.20174109297716,256.7090281377921,244.35520000000025,250.3799,254.92140000000003,258.0339999999999,259.82666666666665,45033392,62553118.6,63.42881300479994,0.5764151824216122,1.5,2.75,NaN,NaN,1.3391282732104859,0.7199224116701354,928.5366214931017,-0.0657654254116431,1.1478719449225423,1.2136373703341854,7.89257380876021,0.6158732618042277,50.30166529863634,18.971039019180008,30.72729568218366,9070146471
1511533800,260.32,260.48,260.16,260.36,NaN,NaN,245.31958333333336,256.1392682926829,244.50400000000027,250.55579999999998,255.12680000000003,258.27099999999984,255.27136101955608,258.0593601065493,258.57153846153847,260.5874878833076,256.55558903976936,244.50400000000027,250.55579999999998,255.12680000000003,258.27099999999984,260.33333333333337,27746365,60450538.25,65.58939271403713,0.6474225362125062,1.5,2.75,NaN,NaN,1.2949048251240245,0.4589928527228622,930.991881537739,0.0023065807914104397,1.2165205963234484,1.214214015532038,7.552427102367657,0.8795381456081363,41.83845195670943,25.60502555638771,32.55652248690287,9097892836
1511793000,260.41,260.75,260,260.23,NaN,NaN,245.37166666666667,256.23439024390245,244.64760000000027,250.75259999999997,255.34760000000003,258.3969999999999,255.46581745016172,258.2660877154494,258.69153846153847,260.8937589654784,256.48931795759853,244.64760000000027,250.75259999999997,255.34760000000003,258.3969999999999,260.32666666666665,52274922,58786157.15,64.69753462911927,0.5626146323601513,1.5,2.75,NaN,NaN,1.2559830519008799,0.8892386326021312,928.5669399136289,0.02548582702615798,1.2460712993147354,1.2205854722885774,7.563774710939168,0.7354933612046739,48.35722281785789,20.341217068193597,31.301560113948522,9045617914
1511879400,260.76,262.9,260.655,262.87,NaN,NaN,245.42375,256.32951219512194,244.79810000000032,250.96019999999996,255.61060000000006,258.70299999999986,255.75617755015537,258.70455555207326,258.9807692307692,262.11660146274903,255.8449369987894,244.79810000000032,250.96019999999996,255.61060000000006,258.70299999999986,262.14166666666665,98971719,61020458.75,72.78935506888318,1.117744260057339,1.5,2.75,NaN,NaN,1.3569842624793857,1.6219432142502535,931.579733148639,0.19602890806045137,1.4656216073641417,1.2695926993036903,9.246262844139437,1.9943351569471874,58.74001561602355,13.331311223595673,27.928673160380793,9144589633
1511965800,263.02,263.63,262.2,262.71,NaN,NaN,245.47583333333336,256.4246341463415,244.94315000000032,251.16359999999997,255.86540000000005,258.9809999999999,256.0288764697571,259.0860264518758,259.33,262.9936677713075,255.66633222869245,244.94315000000032,251.16359999999997,255.86540000000005,258.9809999999999,262.84666666666664,77512102,61880824.8,71.7164513945446,1.1174096666221194,1.5,2.75,NaN,NaN,1.3621996723022873,1.2526029226423627,932.0105080438096,0.2708603874948121,1.6081681836722055,1.3373077961773934,9.020231945689458,2.4450163781001333,24.521090719338353,43.051574628967295,32.427334651694345,9067077531
1512052200,263.76,266.05,263.67,265.01,NaN,NaN,245.52791666666667,256.51975609756096,245.09360000000032,251.39179999999996,256.16440000000006,259.3569999999999,256.3810773925117,259.65021440884,259.8623076923077,264.5252295484781,255.1993858361373,245.09360000000032,251.39179999999996,256.16440000000006,259.3569999999999,264.91,127894389,65565407.45,76.97124691666038,1.6114368520378402,1.5,2.75,NaN,NaN,1.5034711242806975,1.9506382096005719,934.3646891487161,0.43815300686202785,1.8849990547549282,1.4468460478929004,8.592687847397011,2.470806588817565,57.96425388891747,13.804266704860506,28.23147940622204,9194971920
1512138600,264.76,265.31,260.76,264.46,NaN,NaN,245.58,256.6148780487805,245.2423000000003,251.59629999999999,256.46580000000006,259.7004999999999,256.69789788692304,260.1082892270457,260.33384615384614,265.4947795128603,255.172912794832,245.2423000000003,251.59629999999999,256.46580000000006,259.7004999999999,263.51,164390902,70962475.8,73.45667274255254,1.0947980670284962,1.5,2.75,NaN,NaN,1.72108032968922,2.316589157110553,935.2622166165719,0.47174974071181497,2.036533223782669,1.5647834830708542,8.396257209263744,2.559528426277812,26.324101182412065,40.91989719844259,32.75600161914535,9030581018
1512397800,266.31,266.8,264.08,264.14,NaN,NaN,245.63208333333336,256.71000000000004,245.38755000000035,251.7935,256.75980000000004,259.98499999999996,256.98974502861233,260.4922616816128,260.8269230769231,266.1216425631606,255.53220359068558,245.38755000000035,251.7935,256.75980000000004,259.98499999999996,265.00666666666666,94040560,72685017.3,71.41353935243008,1.2869145113502072,1.5,2.75,NaN,NaN,1.7924317347114207,1.293809418959855,936.1575673258261,0.4333901369284039,2.106521154231359,1.6731310173029552,8.058383720745338,2.2609368950832267,23.156728467202022,44.816112990764736,32.02715854203325,8936540458
1512484200,264.43,265.15,263.04,263.19,NaN,NaN,245.68416666666667,256.8051219512195,245.52105000000037,251.96979999999996,257.045,260.2019999999999,257.23289228239224,260.7491891405068,261.34615384615387,266.1160887817686,256.5762189105391,245.52105000000037,251.96979999999996,257.045,260.2019999999999,263.79333333333335,77994544,74102114.6,65.58168893950983,0.744647770758566,1.5,2.75,NaN,NaN,1.8151151822320304,1.052527912611012,933.2816616713699,0.3107476565660092,2.061565588010467,1.7508179314444576,8.769859689778112,1.2308165698680675,7.5867167976686485,69.57261455532317,22.840668647008176,8858545914
1512570600,262.87,263.73,262.71,263.24,NaN,NaN,245.73625,256.90024390243906,245.65585000000036,252.1469,257.32820000000004,260.4304999999999,257.46846513406314,260.9864092223633,261.70153846153846,266.2910840811088,257.1119928419681,245.65585000000036,252.1469,257.32820000000004,260.4304999999999,263.2266666666667,75898566,75021934.85,65.74026619041278,0.5117840887485512,1.5,2.75,NaN,NaN,1.758321240644031,1.011684997884322,931.3890530977037,0.2048168305228284,2.006838969597993,1.8020221390751647,8.282840480519384,1.3396981829381038,20.229925407203307,48.59781809664171,31.172256496154983,8934444480
1512657000,263.09,264.43,262.94,264.07,NaN,NaN,245.78833333333336,256.99536585365854,245.79400000000035,252.331,257.6086,260.6784999999999,257.72734885429594,261.2800845345192,262.17923076923074,266.34293815227403,258.01552338618745,245.79400000000035,252.331,257.6086,260.6784999999999,263.81333333333333,77218569,76359384.35,68.3473454728977,0.6243274591214085,1.5,2.75,NaN,NaN,1.7391554377408867,1.011251854075484,933.7207985891837,0.16422457338272656,2.007302855803573,1.8430782824208465,8.22712299193673,1.4249500691350359,13.634825426622813,58.32842666140871,28.036747911968458,9011663049
1512743400,264.99,265.52,264.72,265.51,NaN,NaN,245.84041666666667,257.0904878048781,245.93785000000037,252.51619999999994,257.9118,261.0454999999999,258.03255086000985,261.6829336264697,262.7338461538462,266.59251502327356,258.8751772844188,245.93785000000037,252.51619999999994,257.9118,261.0454999999999,265.25,76563873,75433303.15,72.28751420919286,0.930213857699958,1.5,2.75,NaN,NaN,1.7185014779022512,1.0149876752414229,936.0004587379121,0.20526765251432932,2.0996628480637582,1.894395195549429,8.509892444557488,2.0289743688275648,45.62415478351313,22.51333242425536,31.86251279223152,9088226922
1513002600,265.58,266.38,265.4793,266.31,NaN,NaN,245.8925,257.18560975609756,246.08385000000035,252.70829999999998,258.21340000000004,261.4564999999999,258.3571567086369,262.123606614425,263.21999999999997,267.1649285847114,259.27507141528855,246.08385000000035,252.70829999999998,258.21340000000004,261.4564999999999,266.05643333333336,83077533,76587946.7,74.20837366357054,1.0603903489476052,1.5,2.75,NaN,NaN,1.660087086623517,1.0847337809619069,937.6575349701188,0.25401548150846875,2.211914547435015,1.957899065926546,8.376506181089672,1.3086316430174603,76.72748633739639,4.564814516326302,18.7076991462773,9171304455
1513089000,266.57,267.32,266.345,266.78,NaN,NaN,245.94458333333336,257.2807317073171,246.23540000000034,252.90729999999996,258.50260000000003,261.8789999999999,258.68746428869036,262.5670726511464,263.75999999999993,267.5825726335153,259.93742736648454,246.23540000000034,252.90729999999996,258.50260000000003,261.8789999999999,266.815,85195750,78336301.8,75.2919299696611,1.2181222497803708,1.5,2.75,NaN,NaN,1.6136522947218364,1.0875641055600611,936.1967377318176,0.28339827497847603,2.312146909649641,2.028748634671165,6.754615783389355,1.5492368010353597,100,0,0,9256500205
1513175400,267.06,267.56,266.65,266.75,NaN,NaN,245.99666666666667,257.3758536585366,246.37025000000034,253.10659999999996,258.78040000000004,262.3299999999999,259.0036421597221,262.9654466843706,264.2515384615384,267.8347630183926,260.6683139046842,246.37025000000034,253.10659999999996,258.78040000000004,262.3299999999999,266.9866666666667,102905409,80415814.65,75.07512118357167,1.0959800821475463,1.5,2.75,NaN,NaN,1.5633914165274214,1.279666312501878,938.174555899871,0.2665483908555375,2.3619341232405873,2.0953857323850498,6.704485552614438,0.6565789970189839,70.65972019942087,7.042080886284508,22.298198914294613,9153594796
1513261800,267.09,267.22,265.6,265.66,NaN,NaN,246.04875,257.4709756097561,246.50720000000038,253.289,259.03040000000004,262.79099999999994,259.26467580051735,263.22207080966865,264.6692307692307,267.45773973435655,261.88072180410484,246.50720000000038,253.289,259.03040000000004,262.79099999999994,266.16,100666692,81408573,67.47278593512435,0.6568373516729257,1.5,2.75,NaN,NaN,1.567434886775463,1.2365613140031333,935.6973090133553,0.15334981751531496,2.2870730042791934,2.1337231867638784,5.622974810574423,0.4537548211449919,40.20224601130026,26.91558794728845,32.88216604141128,9052928104
1513348200,265.45,267.04,265.39,266.51,NaN,NaN,246.10083333333336,257.5660975609756,246.6476500000004,253.47979999999995,259.26740000000007,263.18549999999993,259.5488061612814,263.5352069230335,264.9492307692307,267.6894324635271,262.20902907493434,246.6476500000004,253.47979999999995,259.26740000000007,263.18549999999993,266.31333333333333,144610290,85250236.15,70.02213219487321,0.7594230382415166,1.5,2.75,NaN,NaN,1.5733323948629323,1.696303688186323,939.5128220240634,0.10915256117694572,2.2701638882350608,2.161011327058115,5.6400208430334855,0.8972514575603864,48.8205872116274,19.968456649015973,31.21095613935662,9197538394
1513607400,268.1,268.6,267.98,268.2,NaN,NaN,246.15291666666667,257.66121951219515,246.80010000000038,253.68979999999996,259.54400000000004,263.7025,259.88806866476057,263.97947293036367,265.37153846153836,268.28770925061696,262.4553676724598,246.80010000000038,253.68979999999996,259.54400000000004,263.7025,268.26,83676072,85646198.1,74.3299823502611,1.1363614413881915,1.5,2.75,NaN,NaN,1.6102372238012965,0.9769969228791722,943.1474507968254,0.16387894360802102,2.365860006568141,2.20198106296012,6.2883215378089465,1.9035677647326992,48.70246971244241,20.051402604264332,31.246127683293256,9281214466
1513693800,268.48,268.53,267.09,267.17,NaN,NaN,246.205,257.7563414634146,246.95095000000038,253.89239999999995,259.80840000000006,264.14599999999996,260.17363459947586,264.2833326512814,265.5376923076922,268.59524440898775,262.4801402063967,246.95095000000038,253.89239999999995,259.80840000000006,264.14599999999996,267.59666666666664,82382876,87361566.2,67.92356100979416,0.7877806523126132,1.5,2.75,NaN,NaN,1.5980774221012037,0.9430105203402362,940.6170158983952,0.10378234010652987,2.3317089880932826,2.2279266479867528,6.362306992602808,1.4929342045281897,26.508846733423493,40.66316128244014,32.82799198413637,9198831590
1513780200,268.27,268.33,266.69,267.03,NaN,NaN,246.25708333333336,257.85146341463417,247.1033000000004,254.0949999999999,260.05660000000006,264.49799999999993,260.4425116740062,264.54492001782603,265.73538461538453,268.8208604209741,262.64990880979497,247.1033000000004,254.0949999999999,260.05660000000006,264.49799999999993,267.34999999999997,76751500,87740301.25,67.07730345609818,0.6135362753624152,1.5,2.75,NaN,NaN,1.6010718919511169,0.8747576530574085,941.1728423905947,0.031428456625504975,2.267212218768634,2.235783762143129,6.428830170687501,1.120914908925656,29.48051466980627,37.34352421899625,33.17596111119748,9122080090
1513866600,267.74,268.385,267.3,267.58,NaN,NaN,246.30916666666667,257.94658536585365,247.2569000000004,254.29759999999996,260.30780000000004,264.88899999999995,260.7224131769863,264.83397525422356,265.9999999999999,269.0828358573196,262.9171641426802,247.2569000000004,254.29759999999996,260.30780000000004,264.88899999999995,267.75499999999994,67032339,88840248.6,68.72579861949887,0.7208656182563457,1.5,2.75,NaN,NaN,1.5834953282403241,0.7545266932087357,943.6025561128117,-0.0008525861283148473,2.2347180294827353,2.23557061561105,6.352355667184239,0.7796316522918132,54.98364897677717,15.66841218906288,29.347938834159958,9189112429
1513953000,267.6,267.635,266.9,267.51,NaN,NaN,246.36125,258.0417073170732,247.40600000000038,254.49829999999994,260.56520000000006,265.24649999999997,260.98859305239864,265.0888347538213,266.33230769230755,269.04047373480415,263.62414164981095,247.40600000000038,254.49829999999994,260.56520000000006,265.24649999999997,267.3483333333333,78720873,91388974,68.25735024416579,0.44758786404439416,1.5,2.75,NaN,NaN,1.522888519080302,0.8613826105543104,944.3043661394092,-0.04588953140192675,2.178208701358642,2.2240982327605687,5.821594577175183,0.4506026810859482,20.022308316624613,48.74167592126804,31.236015762107346,9110391556
1514298600,267.05,267.4377,266.885,267.19,NaN,NaN,246.41333333333336,258.1368292682927,247.55290000000042,254.70059999999995,260.81000000000006,265.5945,261.2317854817163,265.2889457296478,266.6361538461537,268.69745348790036,264.5748542044071,247.55290000000042,254.70059999999995,260.81000000000006,265.5945,267.1709,45244433,91037449.55,66.04122804586324,0.3112918934611952,1.5,2.75,NaN,NaN,1.4587536248602806,0.49698704460245946,946.1053929240495,-0.112410542590613,2.0835850545223025,2.1959955971129155,5.724375476156727,0.15368468400930543,4.44391366270135,77.05580184959611,18.500284487702533,9065147123
1514385000,267.38,267.73,267.01,267.32,NaN,NaN,246.46541666666667,258.2319512195122,247.7050000000004,254.89969999999994,261.05060000000003,265.81699999999995,261.47053899223727,265.48237946968135,266.8861538461537,268.34102446606886,265.4312832262386,247.7050000000004,254.89969999999994,261.05060000000003,265.81699999999995,267.3533333333333,57750986,88976412.9,66.51683569466157,0.32696918589634577,1.5,2.75,NaN,NaN,1.4059855087988338,0.6490594992282499,947.6541184402846,-0.15993605366928998,1.9960755300263031,2.156011583695593,5.654021339011303,0.21368322399249978,19.590862776243494,49.32965642696561,31.07948079679088,9122898109
1514471400,267.89,267.92,267.45,267.87,NaN,NaN,246.5175,258.3270731707317,247.84960000000044,255.09969999999993,261.2986,266.07499999999993,261.72149824744366,265.70977190114024,267.0676923076922,268.3715128202443,265.7638717951401,247.84960000000044,255.09969999999993,261.2986,266.07499999999993,267.74666666666667,45116139,87356614.75,68.52529285293988,0.39896702734778766,1.5,2.75,NaN,NaN,1.3484151153132042,0.5164593331496972,950.311563736782,-0.16589624203851816,1.9486412811474452,2.1145375231859633,5.74575850539589,0.8318903862079272,44.68440839059738,23.156341757339806,32.15924985206279,9168014248
1514557800,268.53,268.55,266.64,266.86,NaN,NaN,246.56958333333336,258.42219512195123,247.99150000000043,255.29569999999995,261.5214000000001,266.1674999999999,261.92300812009296,265.81931743436496,267.1099999999999,268.34669534832756,265.87330465167224,247.99150000000043,255.29569999999995,261.5214000000001,266.1674999999999,267.35,96007424,85762266.5,61.25845476737782,0.26946477871453234,1.5,2.75,NaN,NaN,1.3885283213622628,1.119459966697592,948.2216720987243,-0.24466909292719174,1.8087011570269738,2.0533702499541655,5.657059008479491,0.1313271547033968,13.242833178153392,58.84787716711206,27.909289654734536,9072006824
1514903400,267.84,268.81,267.4,268.77,NaN,NaN,246.62166666666667,258.5173170731707,248.1502000000004,255.51089999999996,261.78100000000006,266.3829999999999,262.1915176055795,266.1003348215683,267.26307692307677,268.76309506889487,265.76305877725866,248.1502000000004,255.51089999999996,261.78100000000006,266.3829999999999,268.32666666666665,86655749,81875508.85,68.13936233415916,0.536262789678045,1.5,2.75,NaN,NaN,1.4286334412649573,1.0583842496632008,951.2526235445027,-0.17804487835599803,1.830814152009168,2.008859030365166,6.706810992519246,0.21252796420581402,42.72298608031823,24.775344294147885,32.501669625533886,9158662573
1514989800,268.96,270.64,268.96,270.47,NaN,NaN,246.67375,258.61243902439026,248.31870000000043,255.778,262.0482,266.69949999999994,262.51616397398817,266.5164934099904,267.54923076923063,269.78662570412166,265.3118358343396,248.31870000000043,255.778,262.0482,266.69949999999994,270.0233333333333,90070416,81677001.65,72.77433811575199,1.047020946620105,1.5,2.75,NaN,NaN,1.4601596240317463,1.1027634974404081,953.8100108607022,-0.03677706049202856,1.9628877047501305,1.999664765242159,6.7020426499769865,1.2351686192312052,67.94955317539942,8.310676483284972,23.73977034131561,9248732989
1515076200,271.2,272.16,270.5447,271.61,NaN,NaN,246.72583333333336,258.7075609756098,248.5081000000004,256.0529,262.3582,267.12049999999994,262.8727849946161,267.0015892757056,268.006923076923,270.8606211862846,265.15322496756136,248.5081000000004,256.0529,262.3582,267.12049999999994,271.43823333333336,80636408,81809094.85,75.3627093568195,1.3623393597103022,1.5,2.75,NaN,NaN,1.4765767937437642,0.985665568698075,956.2314067173801,0.10821636000466661,2.1349352152479923,2.0267188552433257,6.216724002622145,1.715163090289496,70.15483849138207,7.275495645295307,22.56966586332263,9329369397
1515162600,272.51,273.56,271.95,273.42,NaN,NaN,246.77791666666667,258.8026829268293,248.7038000000004,256.32169999999996,262.69540000000006,267.62949999999995,263.28640126933703,267.61286648754316,268.5384615384615,272.4550679671262,264.6218551097968,248.7038000000004,256.32169999999996,262.69540000000006,267.62949999999995,272.9766666666667,83523995,82190366.3,78.80767661400729,1.5309755636932623,1.5,2.75,NaN,NaN,1.5103927370477803,1.016226095101367,958.4515719946213,0.29045530914543605,2.389787991675121,2.0993326825296847,6.644749676381847,2.1825248523806087,73.24684474155113,5.931038896346399,20.82211636210248,9412893392
1515421800,273.31,274.1,272.98,273.92,NaN,NaN,246.83,258.8978048780488,248.9032500000004,256.5958,263.06800000000004,268.12199999999996,263.70340514112775,268.2135458696819,268.9784615384615,273.82007504034476,264.1368480365782,248.9032500000004,256.5958,263.06800000000004,268.12199999999996,273.6666666666667,57319192,81195397.45,79.65402051095373,1.5852362002083449,1.5,2.75,NaN,NaN,1.4825075415443678,0.7059413932334905,960.5505384968214,0.402222621221239,2.6021109590562332,2.1998883378349943,6.649952567778026,2.3961721057156837,100.00000000000001,0,0,9470212584
1515508200,274.4,275.25,274.081,274.54,NaN,NaN,246.88208333333336,258.9929268292683,249.1066500000004,256.8718,263.44640000000004,268.57349999999997,264.12836964539724,268.8160653106646,269.54538461538453,275.08311319934916,264.0076560314199,249.1066500000004,256.8718,263.44640000000004,268.57349999999997,274.6236666666667,57253957,80229901.65,80.68414249529215,1.6550216627571588,1.5,2.75,NaN,NaN,1.4716141457197691,0.7136236717548063,958.4721767311835,0.4707020222045095,2.788265865590631,2.3175638433861216,6.443459301815401,2.7508514540214914,100.00000000000001,0,0,9527466541
1515594600,273.68,274.42,272.92,274.12,NaN,NaN,246.93416666666667,259.08804878048784,249.30915000000041,257.1821,263.7746000000001,268.96399999999994,264.52019828675424,269.32120194774416,270.0907692307692,275.91905812881845,264.2624803327199,249.30915000000041,257.1821,263.7746000000001,268.96399999999994,273.82,69574318,79554740.9,77.81013110652195,1.143518364050208,1.5,2.75,NaN,NaN,1.4822131353112145,0.8745464721889377,956.1597953962786,0.4410164002926451,2.868834343751928,2.427817943459283,6.517616827113169,2.5437677689660374,76.63750927889214,4.60005524456482,18.762435476543033,9457892223
1515681000,274.75,276.12,274.56,276.12,NaN,NaN,246.98625,259.1831707317073,249.51315000000042,257.51619999999997,264.1620000000001,269.4309999999999,264.9750924715874,269.96870652414947,270.74769230769226,277.18882528897984,264.3065593264047,249.51315000000042,257.51619999999997,264.1620000000001,269.4309999999999,275.6,62361455,78413026.15,81.23747024013205,1.4925335053039464,1.5,2.75,NaN,NaN,1.5191979113604133,0.7952945838451102,960.5410511864432,0.504792594010353,3.058808685972224,2.554016091961871,6.879197311185079,3.0798521670959795,75.24429999510825,5.127559554864621,19.62814045002711,9520253678
1515767400,276.42,278.11,276.0819,277.92,NaN,NaN,247.03833333333336,259.27829268292686,249.7250500000004,257.86639999999994,264.57740000000007,269.98949999999996,265.48273590407416,270.7259725694686,271.5484615384615,278.72663291970264,264.3702901572203,249.7250500000004,257.86639999999994,264.57740000000007,269.98949999999996,277.3706333333334,90816076,77808559.5,83.68053732071851,1.8936196732751427,1.5,2.75,NaN,NaN,1.5555480605489547,1.1671733365016224,962.067575090402,0.6098915324543435,3.3163805075298,2.7064889750754566,7.068807267887899,4.144495240950311,75.97852782365169,4.846325061458304,19.175147114890013,9611069754
1516113000,279.35,280.09,276.18,276.97,NaN,NaN,247.09041666666667,259.37341463414634,249.92845000000042,258.1817,264.9670000000001,270.55499999999995,265.9332168490124,271.3206418485668,272.30076923076916,279.5437879874688,265.0577504740695,249.92845000000042,258.1817,264.9670000000001,270.55499999999995,277.74666666666667,106555142,78102982,77.91424508853471,1.6669439125288499,1.5,2.75,NaN,NaN,1.72372319908117,1.3642903160854984,959.0145839805261,0.5584926650477331,3.404604806385123,2.84611214133739,6.934245835945266,3.0509357443167193,42.20984434520533,25.353846562316345,32.436309092478346,9504514612
1516199400,278.03,280.05,276.97,279.61,NaN,NaN,247.1425,259.4685365853659,250.14780000000042,258.5322,265.4074000000001,271.2099999999999,266.46956128630603,272.1101045296557,273.2461538461538,280.84164456695953,265.65066312534805,250.14780000000042,258.5322,265.4074000000001,271.2099999999999,278.87666666666667,113258799,76535407.45,81.69015670818692,1.9804251059894689,1.5,2.75,NaN,NaN,1.820600113432514,1.47982225186416,961.7595954047825,0.6395309137126075,3.645525783478149,3.0059948697655416,7.468109877161772,3.3793026953081617,50.68188829278649,18.751510594512645,30.566601112700873,9617773411
1516285800,279.48,279.96,278.58,279.14,NaN,NaN,247.19458333333336,259.56365853658536,250.36685000000043,258.8837,265.8212000000001,271.75699999999995,266.96644123586265,272.7796183839742,274.11307692307685,281.62842484834175,266.59772899781194,250.36685000000043,258.8837,265.8212000000001,271.75699999999995,279.22666666666663,100728006,77388004.15,79.09746573563771,1.648685192741443,1.5,2.75,NaN,NaN,1.7891286767587626,1.3015971545765725,958.081110662392,0.5993994673043992,3.7552442038960407,3.1558447365916416,7.938605078754653,2.7723574242479923,44.72326854745639,23.281953398063578,31.994778054480015,9517045405
1516372200,279.8,280.41,279.14,280.41,NaN,NaN,247.24666666666667,259.6587804878049,250.59150000000042,259.2421999999999,266.2524000000001,272.419,267.49363961877,273.50632139502426,275.15538461538455,282.0942899397513,268.2164792910178,250.59150000000042,259.2421999999999,266.2524000000001,272.419,279.9866666666667,140920098,80314865.25,80.86474740261666,1.5900862260147957,1.5,2.75,NaN,NaN,1.7520480569902825,1.7545954607699477,961.0733123648241,0.5951015426169688,3.8997216648628523,3.3046201222458835,7.956987774730548,2.556506473557168,53.831856403092495,16.56211326785557,29.606030329051947,9657965503
1516631400,280.17,282.69,280.11,282.69,NaN,NaN,247.29875,259.7539024390244,250.83105000000043,259.62339999999995,266.73280000000005,273.20199999999994,268.0895753199947,274.380957452641,276.2261538461538,283.1892324688047,269.26307522350294,250.83105000000043,259.62339999999995,266.73280000000005,273.20199999999994,281.83,91322408,81043410.65,83.55320886162717,1.9064519386995642,1.5,2.75,NaN,NaN,1.8111874814909754,1.1268332276191044,963.4872443583097,0.6765881631110311,4.150355326134672,3.4737671630236413,8.226860625336636,3.2016647196261614,52.451213953155,17.390982783002432,30.157803263842556,9749287911
1516717800,282.74,283.62,282.37,283.29,NaN,NaN,247.35083333333336,259.8490243902439,251.07030000000043,260.0078,267.2164000000001,273.98749999999995,268.6856704054851,275.2294376952466,277.21230769230766,284.26587483719504,270.1587405474203,251.07030000000043,260.0078,267.2164000000001,273.98749999999995,283.0933333333333,97084700,82546028.7,84.18299758907355,2.020781013330005,1.5,2.75,NaN,NaN,1.7711026613844771,1.1761280527842037,965.9128027132732,0.6988154548083885,4.347286481534127,3.6484710267257383,8.208951805362569,3.1871494135645078,78.96011759548722,3.782762703336287,17.257119701176478,9846372611
1516804200,284.02,284.7,281.84,283.18,NaN,NaN,247.40291666666667,259.9441463414634,251.31020000000044,260.37949999999995,267.7166000000001,274.77099999999996,269.2540754876229,275.9866341052231,278.1023076923076,285.02221944739716,271.182395937218,251.31020000000044,260.37949999999995,267.7166000000001,274.77099999999996,283.24,134816117,85350790.9,83.55132336305022,1.7357930804754735,1.5,2.75,NaN,NaN,1.8488810427141582,1.5795532247376045,964.186312275776,0.6358316728124622,4.443260617741316,3.807428944928854,8.47495671376211,3.305121844447688,46.08067290837469,22.073400192356246,31.845926899269077,9711556494
1516890600,284.16,284.27,282.405,283.3,NaN,NaN,247.455,260.03926829268295,251.55000000000047,260.73759999999993,268.22080000000005,275.5765,269.80489605673574,276.68314514282093,278.86230769230764,285.72827797544835,271.9963374091669,251.55000000000047,260.73759999999993,268.22080000000005,275.5765,283.325,84587313,87317934.9,83.69505794653105,1.5035361182279205,1.5,2.75,NaN,NaN,1.8500323968060048,0.9687278231771373,962.6051734456918,0.5359698282465652,4.47739123023706,3.941421401990495,8.153159425231356,2.60031870201362,70.58732929612384,7.084006952201006,22.32866375167515,9796143807
1516977000,284.25,286.6285,283.96,286.58,NaN,NaN,247.50708333333336,286.6285,251.8076000000005,261.12499999999994,268.78580000000005,276.5395,270.4627432701971,277.6257027482666,279.83615384615376,287.19544954180594,272.4768581505016,251.8076000000005,261.12499999999994,268.78580000000005,276.5395,285.7228333333333,107743119,89817541.55,87.03097302553876,1.9913378361267609,1.5,2.75,NaN,NaN,1.9556372256055732,1.1995776898438166,964.2381666075472,0.6186706854243429,4.714759758770924,4.096089073346581,9.202968135552982,3.1160046056418995,68.55796887175921,8.023256247775969,23.41877488046482,9903886926
1517236200,285.93,286.43,284.5,284.68,NaN,NaN,247.55916666666667,286.9481483050847,252.0608500000005,261.5112,269.3248000000001,277.38,271.0202827497972,278.297540581765,280.61615384615374,287.70942059259295,273.5228870997145,252.0608500000005,261.5112,269.3248000000001,277.38,285.2033333333334,90118337,92067651.45,77.18028539692999,1.564275402940861,1.5,2.75,NaN,NaN,1.9645202809194597,0.9788273685784346,958.6234160584298,0.4794774174260237,4.695435845129111,4.215958427703088,10.71521378642207,2.78369498501642,44.20343756977908,23.638153213338025,32.158409216882895,9813768589
1517322600,282.6,284.736,281.22,281.76,NaN,NaN,247.61125,287.26779661016946,252.3071000000005,261.85979999999995,269.8312000000001,278.12500000000006,271.4414481321581,278.62729862159694,281.20384615384603,287.233013916099,275.17467839159303,252.3071000000005,261.85979999999995,269.8312000000001,278.12500000000006,282.572,131796419,93857101.2,65.00324658284438,0.5839718124920126,1.5,2.75,NaN,NaN,2.0753402608537814,1.4042242655582888,952.7908764298874,0.1423151085686971,4.393852313413959,4.2515372048452615,12.636654036874736,0.768928149923099,17.408566798584854,52.51195133502127,30.079481866393866,9681972170
1517409000,282.73,283.3,280.68,281.9,NaN,NaN,247.66333333333336,287.5874449152542,252.5437500000005,262.21009999999995,270.2968,278.78150000000005,271.8515874210931,278.9389844671591,281.64846153846145,286.91693290429555,276.37999017262734,252.5437500000005,262.21009999999995,270.2968,278.78150000000005,281.96,118948131,95471720.3,65.28604002629497,0.31725504856153525,1.5,2.75,NaN,NaN,2.1142445279356545,1.245899106313684,954.2893032779076,-0.1062980680745671,4.118664619752053,4.22496268782662,11.628822849694087,0.9887511642903171,47.25755402625212,21.230488705184868,31.511957268563005,9800920301
1517495400,281.07,283.06,280.68,281.58,NaN,NaN,247.71541666666667,287.90709322033894,252.7823000000005,262.5600999999999,270.7712,279.33700000000005,272.2330937967365,279.1905097560011,281.9299999999999,286.7428801548272,277.11711984517257,252.7823000000005,262.5600999999999,270.7712,279.33700000000005,281.7733333333333,90102470,95473323,64.01278635743748,0.2252283149525166,1.5,2.75,NaN,NaN,2.133227061654536,0.943744987277755,952.1893893381908,-0.3154915011514179,3.830598311387348,4.146089812538766,11.590126408368937,0.417246175243379,25.30457988242454,42.18955108082452,32.50586903675093,9710817831
1517581800,280.08,280.23,275.41,275.45,NaN,NaN,247.7675,288.2267415254237,252.99235000000047,262.8225,271.11420000000004,279.52900000000005,272.3592469811782,278.83427073162005,281.81307692307684,287.1478244673438,276.47832937880986,252.99235000000047,262.8225,271.11420000000004,279.52900000000005,277.03000000000003,173174790,100100242.1,45.64722613479135,1.3517768626215914,1.5,2.75,NaN,NaN,2.4215679858220662,1.7300136979388985,944.6332502384099,-0.8590726950427245,3.07224894373536,3.9313216387780847,17.16908349138099,-2.5611093423891926,5.151486903504523,75.25973263108322,19.588780465412245,9537643041
1517841000,273.45,275.85,263.31,263.93,NaN,NaN,247.81958333333336,288.5463898305085,253.13530000000048,262.9613,271.19300000000004,279.0545000000001,272.02868827603396,277.4148163762277,280.60692307692295,291.5407362188516,269.67310993499433,253.13530000000048,262.9613,271.19300000000004,279.0545000000001,267.6966666666667,294681820,110658133.35,28.878776115056255,3.89777290453925,1.5,2.75,NaN,NaN,3.1443131296919202,2.6629928689285993,937.3665902197984,-1.9257654423686046,1.524114835817329,3.4498802781859337,27.866767745887667,-6.833986374386675,2.7595223113667107,82.19616229032803,15.04431539830527,9242961221
1517927400,259.94,269.7,258.7,269.13,NaN,NaN,247.87166666666667,288.8660381355932,253.3080000000005,263.1509,271.38040000000007,278.81500000000005,271.9150142259934,276.6257862451584,279.836923076923,292.36863149901814,267.3052146548278,253.3080000000005,263.1509,271.38040000000007,278.81500000000005,265.8433333333333,355026780,125543512.75,39.65476342287888,4.04111761328141,1.5,2.75,NaN,NaN,3.7054336204282117,2.82791816337798,941.3570852558698,-2.192996032574664,0.7086352374676039,2.9016312700422677,31.464146421510037,-4.961508581114489,29.147750494782887,37.727042200114546,33.12520730510255,9597988001
1518013800,268.5,272.36,267.58,267.67,NaN,NaN,247.92375,289.18568644067796,253.4605000000005,263.32669999999996,271.52660000000003,278.47150000000005,271.748543079876,275.77285422180995,278.856923076923,292.95124792415805,264.76259822968797,253.4605000000005,263.32669999999996,271.52660000000003,278.47150000000005,269.2033333333334,167376100,131049619.9,37.917629796256264,2.3249217139661273,1.5,2.75,NaN,NaN,3.7821883618261984,1.2771963789572196,942.2593930149162,-2.3651579212073854,-0.05481613146696418,2.3103417897404213,31.319299431990423,-5.5171196611366025,14.35753457608857,57.052850093805,28.589615330106426,9430611901
1518100200,268.01,268.17,257.59,257.63,NaN,NaN,247.97583333333336,289.5053347457627,253.55590000000046,263.41110000000003,271.4746,277.64700000000005,271.19487472380246,274.04496334354235,276.9292307692307,294.7591476533511,259.0993138851103,253.55590000000046,263.41110000000003,271.4746,277.64700000000005,261.13,246449505,139893379.25,28.629679370832775,4.562396111291346,1.5,2.75,NaN,NaN,4.267746335981473,1.7616952733665556,936.8026251263695,-3.0108724610254525,-1.453248786541394,1.5576236744840581,36.066956615329836,-10.101891269453553,11.046816591162479,62.66999210758596,26.283191301251563,9184162396
1518186600,260.8,263.61,252.92,261.5,NaN,NaN,252.92,289.82498305084744,253.67140000000046,263.5289,271.4472,276.91600000000005,270.81468355816315,272.85020492987167,275.25307692307683,294.4225452510282,256.08360859512544,253.67140000000046,263.5289,271.4472,276.91600000000005,259.3433333333333,283565310,150953572,35.21690218186711,4.640179969986781,1.5,2.75,NaN,NaN,4.726478740554226,1.878493541047177,939.4976497820521,-3.024985114117972,-2.2236077181634073,0.8013773959545649,36.83398341760154,-8.142475762259382,31.19483453990306,35.543126853957475,33.26203860613947,9467727706
1518445800,263.83,267.01,261.6644,265.34,NaN,NaN,253.0131932773109,290.1446313559322,253.80510000000046,263.6826,271.49980000000005,276.2870000000001,270.599990085294,272.1349473175029,273.8807692307692,293.1379252817418,254.62361317979662,253.80510000000046,263.6826,271.49980000000005,276.2870000000001,264.6714666666667,143735976,153599567,41.032597502174404,2.16361428454558,1.5,2.75,NaN,NaN,4.782444544800351,0.9357837317340875,943.5910710358417,-2.637502109125459,-2.495500240452259,0.1420018686732002,39.28919034285236,-5.827654741624083,53.64984404965961,16.658941586227144,29.69121436411325,9611463682
1518532200,263.97,266.62,263.31,266,NaN,NaN,253.10638655462185,290.4642796610169,253.94470000000044,263.842,271.5196,275.73850000000004,270.41959831724324,271.5506666205979,272.54999999999995,291.4064292239249,253.693570776075,253.94470000000044,263.842,271.5196,275.73850000000004,265.31,81223640,152332991.9,41.99640923547843,1.681224750573558,1.5,2.75,NaN,NaN,4.6772699344574695,0.5331979565747634,945.6484989710895,-2.215547995374739,-2.627433125545224,-0.41188513017048467,39.583191990921605,-5.6402979780063776,38.355165763382,28.695875346875976,32.948958889742045,9692687322
1518618600,264.31,270,264.3,269.59,NaN,NaN,253.19957983193277,290.78392796610166,254.09925000000044,264.044,271.6222,275.23750000000007,270.38706504990034,271.3639364662552,271.2430769230769,288.29775890529993,254.1883949408539,254.09925000000044,264.044,271.6222,275.23750000000007,267.9633333333333,120735685,152706836.2,47.06469216564585,0.664448855448254,1.5,2.75,NaN,NaN,4.750322081996221,0.7906370664498124,949.5094142339082,-1.6020721533331348,-2.4144753218369033,-0.8124031685037684,40.993860952601175,-4.258114922934871,63.62964505842081,10.589762687356506,25.78059225422269,9813423007
1518705000,271.57,273.04,268.77,273.03,NaN,NaN,253.29277310924368,291.1035762711864,254.27055000000044,264.2799,271.80000000000007,274.9320000000001,270.4907095577474,271.5226091837547,270.3469230769231,285.61382117426814,255.08002497957798,254.27055000000044,264.2799,271.80000000000007,274.9320000000001,271.6133333333333,111200286,153230450.2,51.443001869186624,0.7366526922487029,1.5,2.75,NaN,NaN,4.716013361853636,0.7257061886515296,952.7843936530921,-0.9066348228211911,-1.9456966970302574,-1.0390618742090663,42.15174249395447,-0.8785623525140737,100,0,0,9924623293
1518791400,272.32,275.32,272.27,273.11,NaN,NaN,253.3859663865546,291.42322457627114,254.44370000000043,264.5217,271.99840000000006,274.56700000000006,270.5934268299926,271.67378926149235,269.6815384615384,283.59472832119764,255.76834860187918,254.44370000000043,264.5217,271.99840000000006,274.56700000000006,273.56666666666666,160420135,154205452.05,51.54337798794993,1.1144084730235693,1.5,2.75,NaN,NaN,4.59701240743552,1.0403013179325522,954.9865647459285,-0.4086425394878248,-1.5498650485688472,-1.1412225090810224,40.39826328258508,3.478194975940593,100,0,0,10085043428
1519137000,272.03,273.67,270.5,271.4,NaN,NaN,253.47915966386554,291.7428728813559,254.60690000000042,264.7449,272.1616000000001,274.00250000000005,270.62505715038503,271.64771409373117,268.8738461538461,280.95442570810604,256.79326659958616,254.60690000000042,264.7449,272.1616000000001,274.00250000000005,271.8566666666667,86369662,153957814.75,49.202099831348015,0.4098589648272843,1.5,2.75,NaN,NaN,4.495082949761556,0.5609956346824545,954.2320219462626,-0.17381280419164913,-1.3584885143205838,-1.1846757101289347,30.894178247514734,0.8434585516293174,82.59555293728445,2.642033611337549,14.762413451378007,9998673766
1519223400,271.9,274.72,269.94,270.05,NaN,NaN,253.57235294117646,292.0625211864407,254.75865000000044,264.94489999999996,272.28120000000007,273.3405000000001,270.60250588958564,271.49555084670914,267.98692307692306,277.65872311498407,258.31512303886205,254.75865000000044,264.94489999999996,272.28120000000007,273.3405000000001,271.57,98883740,154047766.75,47.37261085041049,0.5888558335649243,1.5,2.75,NaN,NaN,4.515434167635733,0.6419031063298424,952.9344575087923,-0.09286790494744035,-1.3007605913132352,-1.2078926863657948,29.1991603311915,0.8891545559831118,59.83037257367923,12.662949148306483,27.506678278014267,9899790026
1519309800,271.1,273.05,269.64,270.4,NaN,NaN,253.66554621848738,292.3821694915254,254.91235000000043,265.1454,272.3790000000001,272.7015,270.59456448215093,271.3912126708321,267.59846153846155,276.4072118947911,258.789711182132,254.91235000000043,265.1454,272.3790000000001,272.7015,271.03000000000003,110511290,152832525.4,47.91335459903057,0.15528665242336787,1.5,2.75,NaN,NaN,4.436474584233182,0.723087508439483,954.6993774867901,-0.003916611838827189,-1.2127884511643288,-1.2088718393255016,28.96669836540715,4.956720878779638,59.02620900872082,13.141318792077824,27.83247219920134,10010301316
1519396200,271.79,274.71,271.25,274.71,NaN,NaN,253.7587394957983,292.70181779661016,255.08870000000042,265.3802,272.547,272.27200000000005,270.7559541103019,271.7072876545624,268.4276923076923,277.715534331937,259.13985028344763,255.08870000000042,265.3802,272.547,272.27200000000005,273.5566666666667,92766428,153241481.15,54.15963730665189,0.8945933044865588,1.5,2.75,NaN,NaN,4.427440685359384,0.6053610765429488,959.3872843318794,0.3381168355331552,-0.7862257949090576,-1.1243426304422128,15.818735099270341,5.051625239005729,57.4783653044519,14.08622866258001,28.43540603296809,10103067744
1519655400,275.93,278.01,275.26,277.9,NaN,NaN,253.85193277310924,293.0214661016949,255.27885000000043,265.636,272.7694,271.838,271.036112772643,272.2970697826993,269.1023076923077,279.6805586858662,258.52405669874923,255.27885000000043,265.636,272.7694,271.838,277.0566666666667,86491406,152178895.5,58.15903874413279,1.927373779570015,1.5,2.75,NaN,NaN,4.346909207833715,0.5683534876227302,962.5271228402403,0.7486008955486556,-0.18859151100639338,-0.937192406555049,15.267519009135532,4.733549408306326,49.20950561076133,19.674833848449087,31.115660540789566,10189559150
1519741800,278.11,278.92,274.36,274.43,NaN,NaN,253.94512605042016,293.34111440677964,255.45410000000044,265.8517,272.923,271.32550000000003,271.16920638940206,272.5002059938708,269.6223076923077,280.5273612952377,258.71725408937766,255.45410000000044,265.8517,272.923,271.32550000000003,275.90333333333336,99099165,152627936.9,52.766100708264524,1.247888070671947,1.5,2.75,NaN,NaN,4.362129978702735,0.6492858844375823,958.4187021121355,0.7537383668486373,0.0049805520057475405,-0.7487578148428897,17.51546319780893,3.1691729323308295,46.69403600424699,21.5698706659664,31.736093329786605,10090459985
1519828200,275.68,276.19,271.29,271.65,NaN,NaN,254.03831932773107,293.6607627118644,255.61745000000042,266.0366,273.0428,270.82,271.18806104079806,272.41923399445454,270.70076923076925,279.1436395466977,262.2578989148408,255.61745000000042,266.0366,273.0428,270.82,273.04333333333335,121907767,152133504.3,48.8573487552747,0.4596214103241697,1.5,2.75,NaN,NaN,4.400549265938253,0.8013209684541526,954.9812137077024,0.5468594003058345,-0.0651835644605967,-0.6120429647664312,19.17464607571553,0.7641232983419275,42.754742088400036,24.72927779639297,32.515980115207,9968552218
1519914600,271.41,273.17,266,267.7,NaN,NaN,254.131512605042,293.9804110169491,255.7544500000004,266.16700000000003,273.06660000000005,270.11,271.0512743333158,271.96978313783984,271.1776923076923,278.04030519355825,264.3150794218264,255.7544500000004,266.16700000000003,273.06660000000005,270.11,268.9566666666667,176855077,155028851.6,43.88320398644081,1.4186657449876454,1.5,2.75,NaN,NaN,4.598367175514093,1.1407881512037208,952.602181590552,0.14202450538332434,-0.43451233303727577,-0.5765368384206001,19.86699878701694,-1.9521664285975844,12.63457826831447,59.86363528579902,27.501786445886502,9791697141
1520001000,265.8,269.72,264.82,269.08,NaN,NaN,254.22470588235294,294.30005932203386,255.8994500000004,266.31410000000005,273.0842,269.485,270.9739694574995,271.6945656961408,271.4653846153846,277.59992548785533,265.3308437429139,255.8994500000004,266.31410000000005,273.0842,269.485,267.8733333333333,139083217,157477888.95,45.95345559303168,1.2813096352067987,1.5,2.75,NaN,NaN,4.6199123772630895,0.8831920336712135,954.718371768576,-0.025838770682339418,-0.6088353017735244,-0.582996531091185,18.43156525474238,-1.4755959137344035,17.153573808521752,52.762259425168516,30.08416676630973,9930780358
1520260200,267.73,272.89,267.61,272.19,NaN,NaN,254.31789915966385,294.6197076271186,256.0813000000004,266.4965,273.18460000000005,269.322,271.02165692975444,271.74174991555594,271.94153846153847,277.204271569281,266.67880535379595,256.0813000000004,266.4965,273.18460000000005,269.322,270.8966666666667,97307387,153684518.8,50.394884496634596,0.45548991801307726,1.5,2.75,NaN,NaN,4.6670614931728664,0.6331632343959943,958.8027753898134,0.0740902935501837,-0.49038366415345536,-0.5644739577036391,19.88034541931657,0.2910832719233679,17.247962620886227,52.67214315851912,30.07989422059465,10028087745
1520346600,273.3,273.39,271.18,272.88,NaN,NaN,254.41109243697477,294.93935593220334,256.26185000000044,266.67910000000006,273.3016,269.7695,271.0945331285876,271.850154685503,272.19461538461536,277.2945859147514,267.0946448544793,256.26185000000044,266.67910000000006,273.3016,269.7695,272.4833333333333,79213163,142911085.95,51.3501188909238,0.38658595560266457,1.5,2.75,NaN,NaN,4.491557100803375,0.5542828428839603,961.3007084196378,0.18202034880510953,-0.3369485216972521,-0.5189688705023616,19.55772712202258,1.0479540825772946,34.17033329481929,32.54807085272135,33.281595852459375,10107300908
1520433000,270.42,273.18,270.2,272.78,NaN,NaN,254.5042857142857,295.2590042372881,256.43420000000043,266.85670000000005,273.4056,269.95199999999994,271.160629868643,271.93871138212177,272.1753846153846,277.26448376725403,267.08628546351514,256.43420000000043,266.85670000000005,273.4056,269.95199999999994,272.05333333333334,87063502,129512922.05,51.1962477370014,0.16587814393971873,1.5,2.75,NaN,NaN,4.383588736460278,0.6722379560426264,962.3133404993259,0.23847658277568284,-0.2208731420327581,-0.45934972480844094,19.257834929580977,0.8801775147928979,38.39874309935995,28.555278566745155,33.045978333894915,10020237406
1520519400,273.55,274.24,272.42,274.1,NaN,NaN,254.59747899159663,295.5786525423729,256.6071000000004,267.0513,273.5374,270.27349999999996,271.275899285559,272.14454839334826,272.2515384615384,277.423259473443,267.0798174496338,256.6071000000004,267.0513,273.5374,270.27349999999996,273.5866666666667,66901150,124489174.55,53.1901841498352,0.528334722230321,1.5,2.75,NaN,NaN,4.200475255284544,0.5374053626898275,964.1758727939916,0.34978803995474594,-0.02211467486500851,-0.37190271481975445,19.38320912638047,-0.22205234611042804,77.33938857520377,4.351914262251247,18.308697162545005,10087138556
1520605800,275.7,278.87,275.34,278.87,NaN,NaN,254.69067226890755,295.8983008474576,256.80120000000045,267.2905,273.771,271.33549999999997,271.5737071567135,272.78506759398175,272.8261538461538,279.0455603895171,266.60674730279044,256.80120000000045,267.2905,273.771,271.33549999999997,277.6933333333333,113625335,117847966.05,59.611766804304416,1.8157207511805509,1.5,2.75,NaN,NaN,4.241155594192789,0.9641688253812676,968.0374900603824,0.7090202602728144,0.5143726105212636,-0.19464764975155083,19.788226901818785,0.34904641957539667,76.12563556281415,4.799221929580167,19.07514250760568,10200763891
1520861400,279.2,279.91,278.0801,278.52,NaN,NaN,254.78386554621846,296.21794915254236,256.9907500000004,267.5228,273.99500000000006,272.18649999999997,271.8461107976267,273.33125163265015,273.4776923076922,280.1550393343044,266.80034528108007,256.9907500000004,267.5228,273.99500000000006,272.18649999999997,278.8367,71924793,107265940.2,58.97248998295507,1.7816641390996497,1.5,2.75,NaN,NaN,4.068923051750447,0.6705277823127681,969.6385809583305,0.8764504259712614,0.900915382712526,0.02446495674126456,18.749953711873257,1.4903618409065973,52.2228421929741,17.590425988963595,30.186731818062313,10128839098
1520947800,279.84,280.41,276.03,276.72,NaN,NaN,254.87705882352938,280.41,257.1655500000004,267.73530000000005,274.172,272.7555,272.0372437075237,273.65398957239773,273.9638461538461,280.5942077333377,267.33348457435443,257.1655500000004,267.73530000000005,274.172,272.7555,277.72,91968937,104677588.25,55.666223406878906,1.2428006526102746,1.5,2.75,NaN,NaN,4.091142833768276,0.8785924335623008,967.2752979911472,0.820352593362217,1.0499056984440358,0.22955310508181884,17.51966200942224,1.8663721700718021,24.77472598939303,42.79510868905632,32.43016532155065,10036870161
1521034200,277.81,278.02,274.67,275.3,NaN,NaN,254.97025210084033,280.20940322580645,257.3335000000004,267.9311,274.3408,273.2205,272.1651949346797,273.8107524702646,274.0092307692307,280.6674193033902,267.35104223507125,257.3335000000004,267.9311,274.3408,273.2205,275.99666666666667,105895079,105911160.2,53.13533861218549,0.570345828555099,1.5,2.75,NaN,NaN,4.038204059927683,0.9998481633099889,965.3604437756345,0.649473445703746,1.0413949122115014,0.3919214665077554,16.576462907032873,2.8389988793425562,22.630983014773175,45.43276428936665,31.936252695860176,9930975082
1521120600,275.88,276.61,274.43,275,NaN,NaN,255.06344537815124,280.00880645161294,257.50100000000043,268.1232,274.4654,273.491,272.27636376077066,273.92401413976324,273.7861538461538,280.0930220850248,267.4792856072828,257.50100000000043,268.1232,274.4654,273.491,275.34666666666664,83433038,104046027.85,52.59132182839523,0.30481241884362215,1.5,2.75,NaN,NaN,3.905475198504277,0.8018858549822092,962.6401496738874,0.48560486285860915,0.9989275450810169,0.5133226822224077,13.303553650931677,2.2000891928051196,8.022206438070766,68.61135237399876,23.366441187930487,9847542044
1521207000,274.5,275.39,274.14,274.2,NaN,NaN,255.15663865546216,279.80820967741937,257.6648000000004,268.2941,274.54,273.54949999999997,272.35180047603455,273.95029850740485,273.7684615384615,280.0692934549958,267.46762962192724,257.6648000000004,268.2941,274.54,273.54949999999997,274.57666666666665,100343673,103503197.2,51.08917914561916,0.0409540261324624,1.5,2.75,NaN,NaN,3.7157983986111143,0.9694741391041783,965.5978220842393,0.30170500449497784,0.89045393784113,0.5887489333461522,13.56040555417911,0.7384547558690587,0,100,0,9747198371
1521466200,273.35,273.38,268.62,270.49,NaN,NaN,255.2498319327731,279.60761290322586,257.8004500000004,268.4379,274.51759999999996,273.4185,272.27878869266067,273.62074626860436,273.67923076923074,280.1286432006273,267.22981833783416,257.8004500000004,268.4379,274.51759999999996,273.4185,270.83,109208442,100942612.55,44.71121365909273,1.493255846377502,1.5,2.75,NaN,NaN,3.848955655853177,1.0818864228019232,961.1041853516654,-0.07150678328111937,0.499365454244753,0.5708722375258724,14.661317444942545,-0.875842861330983,0,100,0,9637989929
1521552600,270.94,271.67,270.18,270.95,NaN,NaN,255.34302521008402,279.4070161290323,257.9343500000004,268.5818,274.4682,273.396,272.22667933216417,273.36638948111823,273.92923076923074,279.64206361920736,268.2163979192541,257.9343500000004,268.5818,274.4682,273.396,270.93333333333334,59757271,99611993,45.617737267974505,0.9383010860432707,1.5,2.75,NaN,NaN,3.6804588232922364,0.5999003654108196,959.2713669479573,-0.27752860566989457,0.22396148043850417,0.5014900861083987,14.603503550085732,-0.6708702984089685,1.925868322059248,85.26314835650032,12.810983321440425,9697747200
1521639000,270.9,273.27,270.19,270.43,NaN,NaN,255.43621848739494,279.2064193548388,258.0665500000004,268.7332,274.3984,273.415,272.1562213191381,273.08673334005937,274.03307692307686,279.4298815880503,268.6362722581034,258.0665500000004,268.7332,274.3984,273.415,271.2966666666667,78709578,98603284.9,44.72500213269046,0.6448615743783,1.5,2.75,NaN,NaN,3.6375689073427897,0.7982449882863892,961.7912875816281,-0.42986775910790814,-0.03584461277648643,0.3940231463314217,14.617338917741424,-1.3389273987595824,2.207849900895183,84.1640134544522,13.628136644652626,9619037622
1521725400,267.91,268.87,263.36,263.67,NaN,NaN,255.52941176470586,279.0058225806452,258.16885000000036,268.8137,274.181,273.0785,271.8234283262307,272.18990159338705,273.37769230769226,281.0852396731434,265.6701449422411,258.16885000000036,268.8137,274.181,273.0785,265.3,148785916,100517016.2,35.10655194478471,2.4280022611352723,1.5,2.75,NaN,NaN,3.8827425568183043,1.480206253874058,957.0316320281606,-0.9378162521479463,-0.7782471688535111,0.15956908329443514,19.668986222227712,-5.450568365188076,1.679809380232775,86.28414074294173,12.036049876825484,9470251706
1521811800,264.17,265.02,257.83,258.05,NaN,NaN,255.6226050420168,278.80522580645163,258.2408000000004,268.8171,273.85959999999994,272.24550000000005,271.2832938820648,270.84324429877876,272.23692307692306,283.48029072085006,260.99355543299606,258.2408000000004,268.8171,273.85959999999994,272.24550000000005,260.29999999999995,183534751,105055432.35,29.438380830631473,3.662716603737517,1.5,2.75,NaN,NaN,4.118975231331282,1.7470277061783945,952.463716348276,-1.567136680910954,-1.7993517678442572,-0.23221508693330334,16.817686386025457,-7.349561970415041,1.2571374430724005,88.21475105683763,10.528111500089981,9286716955
1522071000,262.13,265.43,259.41,265.11,NaN,NaN,255.71579831932772,278.6046290322581,258.3474500000004,268.9007,273.63939999999997,271.60600000000005,271.0412039259054,270.2972210322284,271.6469230769231,283.50267243744594,259.79117371640024,258.3474500000004,268.9007,273.63939999999997,271.60600000000005,263.31666666666666,141956102,107828667.15,42.087975082913765,2.177164977825977,1.5,2.75,NaN,NaN,4.351905571950476,1.3164968625878075,957.2833191771999,-1.4267608721386338,-2.0156661771065956,-0.5889053049679618,26.058620826094483,-4.195576756287949,12.303463849819133,60.79849661842602,26.898039531754858,9428673057
1522157400,266.17,266.77,258.84,260.6,NaN,NaN,255.80899159663863,278.40403225806455,258.43340000000035,268.93519999999995,273.29299999999995,270.91450000000003,270.6317449484189,269.37367617201613,270.60846153846154,283.7211537953901,257.495769281533,258.43340000000035,268.93519999999995,273.29299999999995,270.91450000000003,262.07,129941445,109370781.15,37.46719061826003,2.2278967457672834,1.5,2.75,NaN,NaN,4.607483745382585,1.1880818956736507,953.8731559137848,-1.5464315987678252,-2.5219448034277434,-0.9755132046599182,26.991745407657195,-5.339629495096254,4.432905136244774,77.35541199579288,18.21168286796235,9298731612
1522243800,260.75,262.64,258.58,259.83,NaN,NaN,255.90218487394955,278.20343548387103,258.51575000000037,268.9586,272.9502,270.3235000000001,270.2081471073044,268.4647546318241,269.14384615384614,282.48954217791646,255.79815012977582,258.51575000000037,268.9586,272.9502,270.3235000000001,260.34999999999997,146452306,110598008.1,36.72583225253136,2.4540987523060402,1.5,2.75,NaN,NaN,4.5683777635695435,1.3241857472476488,955.1287739196196,-1.5806184255090674,-2.9512862365462524,-1.370667811037185,27.046095542351292,-5.516363636363642,3.6473231029793447,79.59581311948132,16.756863777539337,9152279306
1522330200,261.12,265.26,259.8389,263.15,NaN,NaN,255.9953781512605,278.00283870967746,258.6087500000004,269.01419999999996,272.6209999999999,270.09600000000006,269.93135702466503,267.9585875240314,267.96153846153845,280.4723530968972,255.45072382617968,258.6087500000004,269.01419999999996,272.6209999999999,270.09600000000006,262.7496333333333,124244790,107967493.75,42.05012142702884,1.3170910341938322,1.5,2.75,NaN,NaN,4.629922209028862,1.1507610826615118,959.273298419889,-1.2948166758178743,-2.989188655809528,-1.6943719799916537,29.002860232092765,-4.029905178701682,15.653094569908694,55.3887235515696,28.9581818785217,9276524096
1522675800,262.55,263.13,254.67,257.47,NaN,NaN,254.67,277.8022419354839,258.6749000000004,269.0044,272.1876,269.5155000000001,269.44267635703113,266.9596744265046,266.4807692307692,279.0511678207131,253.9103706408254,258.6749000000004,269.0044,272.1876,269.5155000000001,258.42333333333335,186286343,110327650.05,36.40592410664303,3.302223218036376,1.5,2.75,NaN,NaN,4.9049277655268,1.688482831960763,954.1083714515539,-1.3948423108518146,-3.437924868556422,-2.0430825577046074,30.62711317000862,-4.813486635365441,18.134530302149102,51.3556197672909,30.509849930559994,9090237753
1522762200,258.87,261.31,256.84,260.77,NaN,NaN,254.7214705882353,277.6016451612904,258.75990000000036,269.0236,271.79479999999995,268.9445000000001,269.1025714018534,266.37018162398033,265.3630769230769,277.1580233888387,253.56813045731508,258.75990000000036,269.0236,271.79479999999995,268.9445000000001,259.64,119956861,111460123.75,41.33289377383909,1.8126075760977634,1.5,2.75,NaN,NaN,4.873861496560601,1.0762311844284131,956.0173428445144,-1.1551918179832343,-3.4870723301836506,-2.3318805122004163,32.019702936819975,-3.7571507658239556,15.944512923908704,54.56640641042443,29.489080665666865,9210194614
1522848600,256.75,264.355,256.6,263.56,NaN,NaN,254.77294117647057,277.4010483870968,258.86450000000036,269.07250000000005,271.4121999999999,268.4785000000001,268.8852156606043,266.10254527883933,264.4830769230769,274.8969150084643,254.0692388376895,258.86450000000036,269.07250000000005,271.4121999999999,268.4785000000001,261.50500000000005,123715339,113685232.55,45.19860815796349,1.0420734046538838,1.5,2.75,NaN,NaN,5.079657103949129,1.0882269950548649,958.9870171561589,-0.7451158763279273,-3.2632753576103255,-2.518159481282398,32.96238868594243,-2.5403986244129735,37.70569846953883,29.149667596847582,33.144633933613605,9333909953
1522935000,265.55,266.64,264.32,265.64,NaN,NaN,254.82441176470587,277.2004516129033,258.96940000000035,269.1378,271.0591999999999,268.12150000000014,268.75795230136487,266.0584933475213,263.82461538461536,272.6605476731929,254.98868309603782,258.96940000000035,269.1378,271.0591999999999,268.12150000000014,265.53333333333336,82652618,113464688.35,47.95208993646633,0.5142574307132048,1.5,2.75,NaN,NaN,4.936824453667048,0.7284435290126984,962.0002156360744,-0.29332969504957696,-2.8848216000943694,-2.5914919050447924,33.52583131688045,0.7471460537793342,64.14596678687424,10.23607964713214,25.617953565993616,9416562571
1523021400,263.42,265.11,258,259.72,NaN,NaN,254.87588235294118,276.9998548387097,259.05295000000035,269.15330000000006,270.5899999999999,267.40250000000015,268.4035227993506,265.454827314424,262.99615384615385,271.1718684974387,254.820439194869,259.05295000000035,269.15330000000006,270.5899999999999,267.40250000000015,260.9433333333333,179521209,119095691.3,41.55277217263729,1.549042715239231,1.5,2.75,NaN,NaN,5.129908421262257,1.5073694693772688,959.6327122118386,-0.34895647463276713,-3.0276874983357516,-2.6787310237029844,32.845357937615994,0.6471614028289152,30.57202773921085,36.17873224058779,33.24924002020137,9237041362
1523280600,261.37,264.84,259.9356,261,NaN,NaN,254.92735294117645,276.7992580645162,259.1432000000004,269.18240000000003,270.1439999999999,266.5090000000001,268.1131885719251,265.0305580463836,262.2307692307692,269.0321919848183,255.4293464767201,259.1432000000004,269.18240000000003,270.1439999999999,266.5090000000001,261.92519999999996,105442932,118686571.15,43.31423347205211,0.556569766100417,1.5,2.75,NaN,NaN,5.129200676886378,0.8884150159392316,959.323435355425,-0.2594212982772284,-3.00300764654952,-2.7435863482722915,30.361352870448894,-1.5502998755233728,63.06695430759881,10.81656737779203,26.116478314609154,9342484294
1523367000,264.27,266.04,262.98,265.15,NaN,NaN,254.97882352941176,276.59866129032264,259.2547500000004,269.2506000000001,269.7153999999999,265.84050000000013,267.9969850985163,265.0419334705375,261.8246153846154,267.07211803098016,256.57711273825066,259.2547500000004,269.2506000000001,269.7153999999999,265.84050000000013,264.7233333333333,105573736,120369018.3,48.71125411117074,0.6143732289600201,1.5,2.75,NaN,NaN,5.122829199965923,0.8770839663814056,963.5410454955538,0.10015296668284757,-2.618395139918732,-2.7185481066015798,27.412480137843904,1.7459708365310644,62.174091481425364,11.310043022351422,26.515865496223224,9448058030
1523453400,263.47,265.64,263.39,263.76,NaN,NaN,255.03029411764706,276.39806451612907,259.3579000000004,269.31090000000006,269.2969999999999,265.19250000000017,267.8308288201431,264.91984456858154,261.8315384615385,267.088989415408,256.57408750766905,259.3579000000004,269.31090000000006,269.2969999999999,265.19250000000017,264.2633333333333,91140243,120327583.6,47.09393246651722,0.23274744287120744,1.5,2.75,NaN,NaN,4.9176271142540715,0.7574343327875156,964.3691241667647,0.2563548972964713,-2.3981044849809905,-2.654459382277462,25.470946849331053,1.5125274217757791,36.20546207757271,30.54299446676906,33.25154345565825,9356917787
1523539800,265.26,267,265.06,265.93,NaN,NaN,255.08176470588234,276.19746774193555,259.47110000000043,269.40580000000006,268.9803999999999,264.72400000000016,267.7562865134708,265.01604984776424,262.4376923076923,267.62802150338456,257.2473631120001,259.47110000000043,269.40580000000006,268.9803999999999,264.72400000000016,265.99666666666667,68890480,118477353.65,49.891057879094674,0.8779792926987088,1.5,2.75,NaN,NaN,4.797796606093066,0.581465384545243,965.8987066723881,0.5035052239290363,-2.0250778523661666,-2.528583076295203,25.60711304490124,1.0564316929507998,34.57374007517693,32.10969454695844,33.31656537786464,9425808267
1523626200,267.41,267.54,264.01,265.15,NaN,NaN,255.13323529411764,275.996870967742,259.5902000000004,269.4711000000001,268.6453999999999,264.23150000000015,267.65407919921705,265.02880700512003,262.4407692307692,267.6374750603542,257.24406340118423,259.5902000000004,269.4711000000001,268.6453999999999,264.23150000000015,265.56666666666666,85079176,118559660.55,48.89048132504556,0.5369072897365043,1.5,2.75,NaN,NaN,4.707239705657849,0.7176064405491418,964.2249123894527,0.6052945161883119,-1.771964931059813,-2.3772594472481248,24.85149070748786,2.982871790888239,49.03647945368043,19.80342622101276,31.160094325306815,9340729091
1523885400,267,268.2,266.07,267.33,NaN,NaN,255.18470588235292,275.79627419354847,259.7094000000004,269.5658000000001,268.3603999999999,263.88800000000015,267.6413702110125,265.24796824272767,262.95846153846156,268.6370520794683,257.27987099745485,259.7094000000004,269.5658000000001,268.3603999999999,263.88800000000015,267.2,63405287,116712741.25,51.8000004599556,1.1078072357387678,1.5,2.75,NaN,NaN,4.588865440968003,0.5432593418758382,967.9074691764956,0.798159061573986,-1.3795606202806425,-2.1777196818546285,20.464960632051913,2.51562679756107,44.00056928233042,23.70440724364257,32.29502347402702,9404134378
1523971800,269.33,270.87,268.75,270.19,NaN,NaN,255.23617647058822,275.5956774193549,259.8536000000004,269.6847000000001,268.2551999999999,263.87300000000016,267.74131647724727,265.71863793389645,263.7553846153846,270.2964389429284,257.2143302878409,259.8536000000004,269.6847000000001,268.2551999999999,263.87300000000016,269.93666666666667,64682036,114486420.95,55.38809913639985,1.82024157688141,1.5,2.75,NaN,NaN,4.513946480898861,0.5649756142542772,971.5387602017101,1.079574378479449,-0.8282517087553174,-1.9078260872347663,20.16263165334094,2.5155562300804353,37.66096807221884,29.185918022271075,33.15311390551008,9468816414
1524058200,270.69,271.3,269.87,270.39,NaN,NaN,255.28764705882352,271.3,259.9965500000004,269.78870000000006,268.38439999999986,263.84500000000014,267.845186419316,266.16352955923963,264.3123076923077,271.7268885616073,256.89772682300804,259.9965500000004,269.78870000000006,268.38439999999986,263.84500000000014,270.52000000000004,57303857,114363750.25,55.6368065840046,1.7233498011979418,1.5,2.75,NaN,NaN,4.293664589406085,0.5010666131071545,973.1803010901895,1.229523793392047,-0.37092134549470757,-1.6004451388867547,19.68414790856697,1.7881343171209156,69.54502947372751,7.546465469655584,22.90850505661692,9526120271
1524144600,269.65,269.88,267.72,268.89,NaN,NaN,255.3391176470588,270.9356,260.1299500000004,269.88000000000005,268.37959999999987,263.76800000000014,267.88615950091145,266.4231934107406,265.1907692307692,271.81887006810956,258.56266839342885,260.1299500000004,269.88000000000005,268.37959999999987,263.76800000000014,268.83,77655909,114311066.8,53.23952958605302,0.8637385233625323,1.5,2.75,NaN,NaN,4.177688547305648,0.6793385030328489,969.6852969752504,1.1779199698216867,-0.1280451766096462,-1.3059651464313329,19.86706096442437,3.5307253965809173,38.1830287860297,28.70882795444163,33.10814325952867,9448464362
1524231000,268.81,269.06,265.61,266.61,NaN,NaN,255.3905882352941,270.57120000000003,260.24915000000044,269.94250000000005,268.3583999999999,263.91500000000013,267.8361140302875,266.4409845144796,265.64,271.7825527141465,259.49744728585347,260.24915000000044,269.94250000000005,268.3583999999999,263.91500000000013,267.09333333333336,99953133,111869427.65,49.73185758349129,0.25834947050172885,1.5,2.75,NaN,NaN,4.125710793926673,0.8934803288054545,966.6419957671885,0.9502291431504541,-0.11817871749326514,-1.0684078606437193,14.701654991356838,2.149425287356327,35.102017077135336,31.59580403744319,33.30217888542149,9348511229
1524490200,267.26,267.89,265.35,266.57,NaN,NaN,255.4420588235294,270.2068,260.3792500000004,270.00590000000005,268.5371999999999,264.3410000000001,267.78646249968796,266.4532717035768,265.8715384615385,271.90904098214014,259.8340359409368,260.3792500000004,270.00590000000005,268.5371999999999,264.3410000000001,266.6033333333333,65557954,105970587.8,49.6700290410505,0.12100979124067404,1.5,2.75,NaN,NaN,4.0124457372176225,0.6186429212200708,965.3652275868592,0.7648921262057135,-0.11229270288657744,-0.8771848290922909,14.699371169132837,0.5355459174052484,14.69022552132771,56.501043529058165,28.808730949614123,9282953275
1524576600,267.73,267.9762,261.28,262.98,NaN,NaN,255.49352941176468,269.8424,260.4836000000004,270.00700000000006,268.5667999999999,264.23450000000014,267.59797377421,266.1224839222838,265.66692307692307,271.8991044933262,259.43474166051993,260.4836000000004,270.00700000000006,268.5667999999999,264.23450000000014,264.07873333333333,112885452,104517055.3,44.34175727065118,1.2610105484834466,1.5,2.75,NaN,NaN,4.204142470273509,1.0800672835259262,962.846547376908,0.3875212789210688,-0.39278323044095487,-0.7803045093620237,14.357964855584422,-0.2957233848953491,2.2710093692725217,83.92405592505105,13.804934705676416,9170067823
1524663000,262.91,264.13,260.85,263.63,NaN,NaN,255.545,269.478,260.5899000000004,270.0162000000001,268.5325999999999,264.38600000000014,267.4423669595351,265.8851045011139,265.9676923076923,271.3410576983119,260.5943269170727,260.5899000000004,270.0162000000001,268.5325999999999,264.38600000000014,262.87,103840948,103212030.45,45.482098113162074,1.0659891528448844,1.5,2.75,NaN,NaN,4.138132293825399,1.0060934519673526,960.973150626453,0.17927340568796657,-0.5562127522520655,-0.735486157940032,14.168549070476477,-0.8648892565712825,6.142942211272124,72.72202787133918,21.135029917388696,9273908771
1524749400,264.79,267.2452,264.29,266.31,NaN,NaN,255.5964705882353,269.1136,260.71050000000037,270.0292000000001,268.53879999999987,264.71000000000015,267.39796041210235,265.9255707391031,266.37615384615384,270.92021870524496,261.8320889870627,260.71050000000037,270.0292000000001,268.53879999999987,264.71000000000015,265.9484,67731942,99276012.25,50.02817253857912,0.2746202076649406,1.5,2.75,NaN,NaN,4.100779987123586,0.6822588907926245,964.2613872359445,0.21708649095711618,-0.46412804424363685,-0.681214535200753,14.612275779470298,0.4374882142183764,19.11894306442209,49.97247766962329,30.90857926595464,9341640713
1524835800,267,267.34,265.5,266.56,NaN,NaN,255.64794117647057,268.74920000000003,260.82325000000037,270.05020000000013,268.47819999999984,264.8805000000002,267.3650992194709,265.9859925734742,266.4846153846154,270.9734090576397,261.9958217115911,260.82325000000037,270.05020000000013,268.47819999999984,264.8805000000002,266.46666666666664,57053647,95916455.1,50.44330779284758,0.28588090666114063,1.5,2.75,NaN,NaN,3.939295702329042,0.5948264762341077,966.287657018271,0.25157188650769147,-0.3667496770661387,-0.6183215635738302,14.482345175436148,-0.2880335166273826,42.14610079251966,25.23989447981977,32.614004727660564,9398694360
1525095000,267.26,267.89,264.43,264.51,NaN,NaN,255.69941176470587,268.3848,260.9237000000004,270.0539000000001,268.3077999999998,265.2325000000002,267.2531345441975,265.84542185219095,266.54230769230765,270.90711205900743,262.17750332560786,260.9237000000004,270.0539000000001,268.3077999999998,265.2325000000002,265.60999999999996,82182324,90711254.15,46.99567641238386,0.14915610440953922,1.5,2.75,NaN,NaN,3.905060295019823,0.90597715542664,963.6742301491967,0.13480975919378646,-0.44980936458159704,-0.5846191237753835,14.280881916038812,-2.102224360635111,40.02981247386229,27.087894458064866,32.882293068072855,9316512036
1525181400,263.87,265.1,262.11,264.98,NaN,NaN,255.75088235294118,268.0204,261.0208000000004,270.07180000000017,268.1451999999998,265.4430000000002,267.1639920130525,265.76300072341087,266.4692307692307,270.903846087111,262.0346154513504,261.0208000000004,270.07180000000017,268.1451999999998,265.4430000000002,264.06333333333333,74203365,88423579.35,47.87528535951448,0.5746031743117808,1.5,2.75,NaN,NaN,3.8396988453755507,0.8391807428003649,964.7620414073353,0.08988273246400291,-0.47226570819537983,-0.5621484406593827,12.41076836622444,-2.000813639557664,75.12368007081074,5.179204178144509,19.697115751044738,9390715401
1525267800,264.76,265.68,262.76,263.2,NaN,NaN,255.80235294117645,267.656,261.1091500000004,270.07140000000015,267.98119999999983,265.4250000000002,267.008541345874,265.51890541641933,266.3192307692307,271.04457625296953,261.5938852854919,261.1091500000004,270.07140000000015,267.98119999999983,265.4250000000002,263.88000000000005,86368943,86556259.55,44.84031912239458,0.5186442112325097,1.5,2.75,NaN,NaN,3.7740060707058696,0.9978358982819516,964.0944695580839,-0.051458900435627175,-0.6264720662039167,-0.5750131657682895,12.559251026124727,-2.116106958235709,40.35080889616322,26.80696250406575,32.84222859977104,9304346458
1525354200,262.26,263.36,259.05,262.62,NaN,NaN,259.05,267.2916,261.1939500000004,270.05690000000016,267.8325999999999,265.27400000000017,266.8364416852515,265.2428191862842,265.95692307692303,271.0264421535739,260.88740400027217,261.1939500000004,270.05690000000016,267.8325999999999,265.27400000000017,261.6766666666667,136311479,89239202.6,43.864546108723246,1.2159754298507008,1.5,2.75,NaN,NaN,3.812291351369736,1.5274842785294005,962.0539705103909,-0.16912349684433292,-0.7864175368237056,-0.6172940399793727,12.426132006807837,-1.496568020704403,12.177543590492075,60.67815221681067,27.144304192697245,9168034979
1525440600,261.52,266.7892,261.15,266.02,NaN,NaN,259.2404347826087,266.9272,261.2891000000004,270.0620000000001,267.7449999999999,265.58900000000017,266.80442436426125,265.31683640663806,265.6361538461538,270.08319288498643,261.1891148073211,261.2891000000004,270.0620000000001,267.7449999999999,265.58900000000017,264.6530666666667,91222075,84824245.9,50.64483671186847,0.5484069677876724,1.5,2.75,NaN,NaN,3.942784826271899,1.075424532598173,966.0232675701908,-0.011399844251887226,-0.6315438452942317,-0.6201440010423445,14.438723230990405,-0.20632479273737156,16.923164564248047,53.13309553309402,29.94373990265793,9259257054
1525699800,266.89,268.02,266.11,266.92,NaN,NaN,259.4308695652174,266.5628,261.3882000000004,270.06810000000013,267.5891999999999,265.88500000000016,266.8089567421334,265.4695186536249,265.36923076923074,268.98098475639654,261.75747678206494,261.3882000000004,270.06810000000013,267.5891999999999,265.88500000000016,267.01666666666665,55304907,82317344.65,52.28765711579738,0.6589173431612724,1.5,2.75,NaN,NaN,3.804014481538192,0.6718499878142024,968.7121499580195,0.1511455161695464,-0.4312121058304115,-0.5823576219999579,14.585902168306301,1.4982127918472878,33.77637914434037,32.89587549013487,33.32774536552476,9314561961
1525786200,266.5,267.325,265.15,266.92,NaN,NaN,259.6213043478261,266.1984,261.4884000000004,270.0695000000001,267.36959999999993,265.9735000000002,266.81331137969676,265.6076597342321,265.2176923076923,268.3607447568221,262.0746398585625,261.4884000000004,270.0695000000001,267.36959999999993,265.9735000000002,266.465,67499247,80413620.2,52.287657115797394,0.3485629072678579,1.5,2.75,NaN,NaN,3.687656304285465,0.8394006740664064,969.7071871482295,0.25041174461852944,-0.26934294122679603,-0.5197546858453255,11.731864810092052,1.2479611576831242,21.33900611795817,46.997810771270714,31.66318311077113,9314561961
1525872600,267.68,269.865,267.09,269.5,NaN,NaN,259.8117391304348,265.834,261.6018000000004,270.0970000000001,267.2709999999999,266.2605000000002,266.9186717177479,265.97835880716235,265.43999999999994,269.27759540094706,261.6024045990528,261.6018000000004,270.0970000000001,267.2709999999999,266.2605000000002,268.8183333333333,59666143,78839915.2,57.04158222314309,1.2011938163882347,1.5,2.75,NaN,NaN,3.6346094254079313,0.7568012072138809,972.4271243262591,0.4688909729732112,0.06635903037118851,-0.4025319426020227,12.63161390992858,1.197852127220156,48.63932639550232,20.09910362176231,31.261569982735367,9374228104
1525959000,270.34,272.39,270.22,272.02,NaN,NaN,260.0021739130435,265.4696,261.7248000000004,270.1606000000001,267.2783999999999,266.56500000000017,267.118723807248,266.5537532064802,265.8592307692307,271.05087767873584,260.66758385972554,261.7248000000004,270.1606000000001,267.2783999999999,266.56500000000017,271.54333333333335,72063931,78998587.75,61.116785460001644,1.7990787238182302,1.5,2.75,NaN,NaN,3.5814230378787926,0.9122179655673655,975.7788752469324,0.7457398007556988,0.5296428083426008,-0.216096992413098,12.4542833964623,2.0483193277310847,99.99999999999999,0,0,9446292035
1526045400,272.16,273.15,271.58,272.85,NaN,NaN,260.1926086956522,265.1052,261.8519000000004,270.2240000000001,267.3813999999999,266.95000000000016,267.3434797363755,267.153395758244,266.6184615384615,272.71222049535186,260.5247025815711,261.8519000000004,270.2240000000001,267.3813999999999,266.95000000000016,272.5266666666667,59871511,77738204.5,62.38254903505849,1.735999750902572,1.5,2.75,NaN,NaN,3.4377499637445927,0.7701684311476477,977.2381546591348,0.9351091459236601,0.9527894399914771,0.017680294067817043,12.43979118187263,3.15299988658275,99.99999999999999,0,0,9506163546
1526304600,273.34,274.08,272.36,272.98,NaN,NaN,260.3830434782609,264.7408,261.98080000000044,270.2718000000001,267.4593999999999,267.2325000000002,267.56451974671376,267.70831044793505,267.33769230769224,274.02864212572103,260.64674248966344,261.98080000000044,270.2718000000001,267.4593999999999,267.2325000000002,273.14000000000004,54790606,77307470.45,62.587973238611006,1.6882478005728447,1.5,2.75,NaN,NaN,3.3150535377628336,0.7087362408971435,976.1489160819782,1.0129173245873506,1.2838269498020054,0.27090962521465467,10.801320835129598,3.0190957808136463,100,0,0,9560954152
1526391000,271.59,271.61,270.03,271.1,NaN,NaN,260.5734782608696,264.3764,262.1017500000004,270.3111000000001,267.4375999999999,267.2780000000002,267.70316603115634,268.03132850051264,267.70615384615377,274.65281896064454,260.759488731663,262.1017500000004,270.3111000000001,267.4375999999999,267.2780000000002,270.91333333333336,87036036,78425170.45,57.682243985540005,0.7432579653978848,1.5,2.75,NaN,NaN,3.288978285065492,1.1097972181710445,973.224703297627,0.8861401443392325,1.3785848056386953,0.4924446612994628,12.25488737266513,3.0015197568389187,67.85705952977413,8.345951391508892,23.79698907871699,9473918116
1526477400,271.14,272.76,271.11,272.24,NaN,NaN,260.7639130434783,264.012,262.2291000000004,270.3632000000001,267.42479999999995,267.37050000000016,267.88108108875804,268.4321543576067,268.1430769230769,275.4515099219744,260.8346439241794,262.2291000000004,270.3632000000001,267.42479999999995,267.37050000000016,272.0366666666667,53942631,78257109.15,59.74281585789089,1.04783455916678,1.5,2.75,NaN,NaN,3.1726226932750974,0.6893000723628186,975.9893874135558,0.8284883459728656,1.5280550937655448,0.6995667477926792,10.836640134986121,3.6630873505445147,67.27523847390684,8.630070481553892,24.094691044539267,9527860747
1526563800,271.94,273.23,271.13,272.01,NaN,NaN,260.954347826087,263.6476,262.3525500000004,270.4075000000001,267.4093999999999,267.52650000000017,268.0429994774342,268.7729015616442,268.7199999999999,275.9740662337103,261.46593376628954,262.3525500000004,270.4075000000001,267.4093999999999,267.52650000000017,272.12333333333333,56536400,77201133.7,59.11737258030553,0.871759199461486,1.5,2.75,NaN,NaN,3.096006786612592,0.7323260331862199,977.3751326481039,0.7278667083676347,1.6094001332522225,0.8815334248845879,10.606351948392517,2.251710397714461,39.12612121439338,27.859333177013827,33.01454560859278,9471324347
1526650200,271.62,272.03,270.93,271.33,NaN,NaN,261.14478260869566,263.2832,262.47200000000043,270.44570000000016,267.3539999999999,267.76250000000016,268.17190145871126,269.0164347462495,269.20846153846145,276.2411887527736,262.1757343241493,262.47200000000043,270.44570000000016,267.3539999999999,267.76250000000016,271.43,64367959,75421875,57.21040621923596,0.5599993528114198,1.5,2.75,NaN,NaN,2.953434873283119,0.853438859747255,978.211792674638,0.5752102563256409,1.600546245291639,1.025335988965998,9.229054975661088,1.6521804285928248,15.413502619953094,55.37285566654254,29.213641713504366,9406956388
1526909400,273.01,273.98,271.3512,273.37,NaN,NaN,261.33521739130435,262.9188,262.6040500000004,270.50750000000016,267.2439999999999,268.1025000000002,268.37574846033044,269.43106000851145,269.99076923076916,276.41196711344014,263.5695713480982,262.6040500000004,270.50750000000016,267.2439999999999,268.1025000000002,272.90040000000005,58025875,75045271.05,61.24888705540468,1.0092058364736156,1.5,2.75,NaN,NaN,2.931760953762898,0.77321161197938,981.4864246059723,0.5702149192022212,1.7381046379687746,1.1678897187665533,9.743661167583355,2.416454368350063,15.889732578162036,54.64424665556321,29.46602076627476,9464982263
1526995800,273.96,274.25,272.24,272.61,NaN,NaN,261.52565217391304,262.5544,262.7300500000004,270.56040000000013,267.1257999999999,268.5840000000002,268.5417975403175,269.733816198177,270.75923076923067,275.68509632557465,265.8333652128867,262.7300500000004,270.56040000000013,267.1257999999999,268.5840000000002,273.03333333333336,52966358,72049316.35,59.0142605744365,0.8532518303631947,1.5,2.75,NaN,NaN,2.865920885636976,0.7351403272544723,979.4339630533002,0.4780434782320351,1.7654440665565971,1.287400588324562,10.11620416592574,1.1539888682745876,20.13205524114856,48.59161962652524,31.27632513232621,9412015905
1527082200,271.17,273.39,270.99,273.36,NaN,NaN,261.7160869565218,262.19,262.8575000000004,270.61530000000016,267.05859999999996,269.07050000000015,268.7307466563835,270.0791670364459,271.3238461538461,275.58522576763613,267.06246654005605,262.8575000000004,270.61530000000016,267.05859999999996,269.07050000000015,272.58,64694184,70091978.15,60.54411763078952,0.5585368012918949,1.5,2.75,NaN,NaN,2.83264082237719,0.9229898443093091,980.1878498642612,0.43133863807382533,1.8265738859168437,1.3952352478430183,8.954106797979842,0.49261083743843537,22.644991724846683,45.32015433324732,32.03485394190599,9476710089
1527168600,272.91,273.22,270.78,272.8,NaN,NaN,261.9065217391305,261.8256,262.9852000000004,270.67470000000014,267.00859999999994,269.39500000000015,268.8903252188782,270.3382939853558,271.77615384615376,275.24662300936865,268.3056846829389,262.9852000000004,270.67470000000014,267.00859999999994,269.39500000000015,272.26666666666665,76043827,70507572.4,58.77987550297466,0.5294485486767596,1.5,2.75,NaN,NaN,2.8145950493502503,1.078520000214899,980.2811003450853,0.3309954797591106,1.8089795975419065,1.477984117782796,7.561468945387167,-0.018325087044167625,19.776135109921487,49.07229869923676,31.15156619084176,9400666262
1527255000,272.15,272.86,271.58,272.15,NaN,NaN,262.0969565217392,261.4612,263.10970000000043,270.7085000000002,266.9515999999999,269.67450000000014,269.0181556024516,270.51083741532193,272.1784615384615,274.22386683814375,270.1330562387792,263.10970000000043,270.7085000000002,266.9515999999999,269.67450000000014,272.19666666666666,56374755,70473627.8,56.714080867943,0.2607999407992091,1.5,2.75,NaN,NaN,2.704981117253806,0.7999411518871745,978.9927432728501,0.19579502154338124,1.7227278947120226,1.5269328731686413,7.478201999270603,-0.30405157887026185,20.846144287136685,47.64064458061707,31.51321113224625,9344291507
1527600600,270.31,271.17,267.76,269.02,NaN,NaN,262.28739130434786,261.0968,263.2360000000004,270.6940000000002,266.8479999999999,269.9000000000001,269.0182279317672,270.368852899577,272.1415384615384,274.386599312544,269.8964776105328,263.2360000000004,270.6940000000002,266.8479999999999,269.9000000000001,269.31666666666666,115908607,72159941.95,47.971197115207495,0.9542742335739023,1.5,2.75,NaN,NaN,2.825339608878533,1.606273562142188,976.9067539748547,-0.11287994825144776,1.3858329378543317,1.4987128861057795,9.855377342826499,-0.7672445592032611,3.853775609912863,78.7391577641064,17.407066625980743,9228382900
1527687000,270.5,273.11,270.42,272.61,NaN,NaN,262.47782608695655,260.7324,263.3784500000004,270.7040000000002,266.89039999999994,270.28150000000005,269.1590817383646,270.58229548056966,272.18692307692305,274.4441423957008,269.9297037581453,263.3784500000004,270.7040000000002,266.89039999999994,270.28150000000005,272.0466666666667,69678449,71933696.15,56.29351790658251,0.4737351603050943,1.5,2.75,NaN,NaN,2.9156724939586405,0.9686482515051466,981.4444746682104,-0.08499215207646182,1.392472696010202,1.477464848086664,12.268144165173448,0.1359094916250384,16.633050139854564,53.545194899986825,29.821754960158614,9298061349
1527773400,272.15,272.49,270.255,270.94,NaN,NaN,262.66826086956524,260.368,263.5004500000004,270.67920000000015,266.89019999999994,270.66850000000005,269.2289216701934,270.61636257765826,272.03999999999996,274.35339909751974,269.7266009024802,263.5004500000004,270.67920000000015,266.89019999999994,270.66850000000005,271.2283333333333,93519941,72291246.05,52.11724585503238,0.08743862837850576,1.5,2.75,NaN,NaN,2.875624458675882,1.2936551257577888,978.8391703444377,-0.1831024562279897,1.2485867778016768,1.4316892340296665,12.575846068761319,-0.393367890886362,3.50675337145012,79.77910113876058,16.714145489789303,9204541408
1527859800,272.41,273.94,272.33,273.6,NaN,NaN,262.85869565217394,260.0036,263.6359000000004,270.67600000000016,266.95359999999994,271.2175000000001,269.4003365066564,270.9005185226432,272.08769230769224,274.50008535950633,269.67529925587814,263.6359000000004,270.67600000000016,266.95359999999994,271.2175000000001,273.29,71258411,69038592.65,57.522754736360824,0.6708579144851036,1.5,2.75,NaN,NaN,2.8845084259133187,1.032153296653274,982.3908718146254,-0.07829501254601978,1.3338204683471417,1.4121154808931615,13.868178425029805,0.8366196144915928,16.230033531200746,54.146713000743034,29.623253468056223,9275799819
1528119000,274.53,275.185,274.26,274.9,NaN,NaN,263.0491304347826,259.6392,263.77570000000037,270.67960000000016,267.17819999999995,271.66150000000005,269.6160095848267,271.28142152048673,272.38,275.13885148897685,269.62114851102314,263.77570000000037,270.67960000000016,267.17819999999995,271.66150000000005,274.78166666666664,45392351,66747106.45,59.90503938962799,1.0182916645725328,1.5,2.75,NaN,NaN,2.7916863954909372,0.6800647011418125,985.0381845016365,0.06158959230304095,1.4891024712719627,1.4275128789689218,13.901231252959628,0.5596810183999608,31.21615609382572,35.54669209710684,33.237151809067434,9321192170
1528205400,275.05,275.53,274.18,275.1,NaN,NaN,263.2395652173913,259.27479999999997,263.9357500000004,270.68940000000015,267.51919999999996,272.0705000000001,269.8310680324806,271.64509566139276,272.59999999999997,275.7125651058589,269.487434894141,263.9357500000004,270.68940000000015,267.51919999999996,272.0705000000001,274.93666666666667,51135038,66538613,60.27417130918452,0.9462439352714538,1.5,2.75,NaN,NaN,2.6887087958130107,0.7685017119307852,987.3580591063982,0.1457870947410278,1.6097467473952065,1.4639596526541787,13.332015372145964,0.9133927588863244,66.0218665539323,9.280286771072442,24.697846674995258,9372327208
1528291800,275.79,277.52,275.09,277.4,NaN,NaN,263.43000000000006,258.9104,264.1092000000004,270.7022000000002,267.76499999999993,272.59450000000004,270.12788889395193,272.19318178887914,273.01461538461535,277.01243490860986,269.01679586062085,264.1092000000004,270.7022000000002,267.76499999999993,272.59450000000004,276.67,62732215,66300261.4,64.34005543437229,1.3321428520339544,1.5,2.75,NaN,NaN,2.670229596112082,0.9461835243985931,990.0212220707677,0.32435204375701976,1.8693997073504534,1.5450476635934336,13.805575430197624,1.477904594673677,65.30862744350159,9.646855596863974,25.04451695963443,9435059423
1528378200,277.95,278.28,276.34,277.37,NaN,NaN,263.62043478260875,258.546,264.2815500000004,270.6967000000002,268.1003999999999,272.98800000000006,270.4118932510519,272.6862120947002,273.47923076923075,277.96059362192057,268.99786791654094,264.2815500000004,270.6967000000002,268.1003999999999,272.98800000000006,277.33,72969402,66965424.35,64.24768826394491,1.2696776936660499,1.5,2.75,NaN,NaN,2.618070339246933,1.089657875064298,991.5478879351327,0.4032695897823966,2.049134650821429,1.6458650610390326,13.826655175621898,1.675219941348971,71.40009745130861,6.729144768758196,21.870757779933186,9362090021
1528464600,276.85,278.25,276.66,278.19,NaN,NaN,263.81086956521744,258.1816,264.4453000000004,270.7089000000002,268.46759999999995,273.29650000000004,270.7169170451283,273.2103823713954,273.84999999999997,278.98392337598335,268.7160766240166,264.4453000000004,270.7089000000002,268.46759999999995,273.29650000000004,277.70000000000005,72139719,66969213.75,65.69726829124893,1.2596609689905616,1.5,2.75,NaN,NaN,2.544636743586436,1.0772071965679901,993.660773571954,0.4689189672132781,2.23201377005563,1.763094802842352,13.65981086294941,2.2193643211464344,71.6259144719646,6.630280720239324,21.74380480779609,9434229740
1528723800,278.44,279.37,278.31,278.56,NaN,NaN,264.00130434782614,257.8172,264.6153000000004,270.69840000000016,268.77579999999995,273.582,271.0244889257115,273.71986976459584,274.30769230769226,279.9532223507581,268.66216226462643,264.6153000000004,270.69840000000016,268.77579999999995,273.582,278.74666666666667,58892515,66920263.95,66.36004319101869,1.4346226634426629,1.5,2.75,NaN,NaN,2.44716269047312,0.8800400883654912,995.2894363279846,0.49302395487417905,2.379374746435076,1.8863507915608968,13.392119213698848,3.546204743141782,72.46969509376612,6.251629130303989,21.278675775929905,9493122255
1528810200,279.03,279.33,278.19,278.92,NaN,NaN,264.1917391304348,257.45279999999997,264.7899500000004,270.69620000000015,269.2048,273.879,271.3341168109777,274.2151202632058,274.7353846153846,280.85172648529084,268.61904274547834,264.7899500000004,270.69620000000015,269.2048,273.879,278.81333333333333,72329028,67797185.05,67.02757760615796,1.15913736555324,1.5,2.75,NaN,NaN,2.3537939268678962,1.066844116708648,995.4886410962071,0.4880642226312064,2.496431069849905,2.0083668472186984,10.160102749449019,2.3146619713143326,74.51393301308947,5.411481123638675,20.07458586327186,9565451283
1528896600,279.19,279.48,277.8,278.03,NaN,NaN,264.3821739130435,279.48,264.9573000000004,270.67240000000015,269.54999999999995,274.22549999999995,271.5967004654492,274.5784421429005,275.13769230769225,281.3786496003484,268.8967350150361,264.9573000000004,270.67240000000015,269.54999999999995,274.22549999999995,278.43666666666667,79070610,67398913.75,63.66412586309725,0.9467346136272956,1.5,2.75,NaN,NaN,2.3056657892344754,1.1731733584504542,992.7006114615551,0.38426280752875996,2.4886953566296484,2.1044325491008884,8.737123478838987,2.6168155311138905,43.96025001723266,23.74260922315594,32.29714075961137,9486380673
1528983000,279.01,279.33,278.0599,278.73,NaN,NaN,264.5726086956522,279.6897435897436,265.1281000000004,270.63280000000015,269.85339999999997,274.55,271.87643770209826,274.9738286054814,275.6438461538461,281.9007539104189,269.38693839727324,265.1281000000004,270.63280000000015,269.85339999999997,274.55,278.70663333333334,77097620,68556663.2,65.14556050743089,0.8525945829617415,1.5,2.75,NaN,NaN,2.2338325185748706,1.1245824461304879,994.4547275001692,0.3245450549982962,2.5101138678487587,2.1855688128504625,7.048522482758108,1.8749999999999982,73.84039313718341,5.682198723536866,20.477408139279724,9563478293
1529069400,276.6,277.51,275.35,277.13,NaN,NaN,264.7630434782609,279.8994871794872,265.28950000000043,270.57120000000015,270.0832,274.806,272.0824597529964,275.1791782621022,276.26769230769224,281.24480394360853,271.29058067177596,265.28950000000043,270.57120000000015,270.0832,274.806,276.66333333333336,120143175,71737001.95,59.2039498207408,0.1894748628632871,1.5,2.75,NaN,NaN,2.3157016243909507,1.674772735606356,993.3295035081311,0.1480682607823498,2.3706541388283995,2.2225858780460497,7.090064815724707,0.8112040742088099,35.46973632709668,31.248149353469604,33.28211431943371,9443335118
1529328600,275.49,276.7,274.95,276.56,NaN,NaN,264.9534782608696,280.1092307692308,265.4422500000004,270.50500000000017,270.41999999999996,275.0675,272.25804956660437,275.3106850942829,276.57153846153835,281.0784346894565,272.0646422336202,265.4422500000004,270.50500000000017,270.41999999999996,275.0675,276.07,52917581,71164483.05,57.20236985667744,0.14136558388472106,1.5,2.75,NaN,NaN,2.3060086512201687,0.7435953825845996,994.9259597607016,-0.026944917381879208,2.1889047313187007,2.21584964870058,6.9491272493851195,0.5307161032351797,18.66039422991635,50.6211544193689,30.71845135071475,9390417537
1529415000,274,275.75,273.53,275.5,NaN,NaN,265.1439130434783,280.3189743589744,265.5823000000004,270.4270000000002,270.71,275.17400000000004,272.3851848777179,275.3287150853036,276.9223076923076,280.1495394552583,273.69507592935685,265.5823000000004,270.4270000000002,270.71,275.17400000000004,274.9266666666667,97531510,73139764.8,53.57493510117346,0.5070830845777985,1.5,2.75,NaN,NaN,2.357722318990159,1.3334949909491642,994.3762005590631,-0.22307549171848384,1.937005284052475,2.160080775770959,7.397690145563188,-0.6849315068493069,4.0065146689871005,78.29180810704594,17.70167722396696,9292886027
1529501400,276.27,276.72,275.59,275.97,NaN,NaN,265.334347826087,280.52871794871794,265.7229500000004,270.32090000000017,270.92639999999994,275.34200000000004,272.5257658629054,275.3897898390842,277.10461538461533,279.7813483574874,274.42788241174327,265.7229500000004,270.32090000000017,270.92639999999994,275.34200000000004,276.0933333333333,53785486,73180721.2,54.939390444662976,0.06515977692906366,1.5,2.75,NaN,NaN,2.2764564390622923,0.7349679685856936,997.3041982933019,-0.3240110922566668,1.7550669104501253,2.079078002706792,5.439367864451525,-0.5047409597288738,14.07884419608085,57.48695419341099,28.434201610508158,9346671513
1529587800,275.96,275.98,273.68,274.24,NaN,NaN,265.5247826086957,280.73846153846154,265.8638500000004,270.2165000000002,271.13599999999997,275.3860000000001,272.59299073102676,275.2802860448857,277.0538461538461,279.91462107259923,274.193071235093,265.8638500000004,270.2165000000002,271.13599999999997,275.3860000000001,274.6333333333334,71061404,73499082.2,49.20663515599182,0.5756727615269708,1.5,2.75,NaN,NaN,2.278138121986415,0.9668338960564599,994.1940701293412,-0.4996494900616071,1.4545161401297833,1.9541656301913903,6.3474888379775685,-1.419892878967608,2.16897562494311,84.3148939996291,13.516130375427787,9275610109
1529674200,275.66,275.785,274.49,274.74,NaN,NaN,265.7152173913044,280.94820512820513,266.0030500000004,270.1463000000002,271.31219999999996,275.48300000000006,272.6771871729473,275.2288302310871,277.0261538461538,279.9678701265344,274.0844375657732,266.0030500000004,270.1463000000002,271.31219999999996,275.48300000000006,275.00500000000005,56612003,72527491,50.80440553119719,0.2912480646643146,1.5,2.75,NaN,NaN,2.2257711132731006,0.7805592364969581,997.1775078948897,-0.569450706348124,1.2423522472562354,1.8118029536043594,6.1104743243572965,-1.3713383113153335,14.604559740538654,56.64745973995403,28.74798051950734,9332222112
1529933400,273.44,273.6162,269.1,271,NaN,NaN,265.9056521739131,281.1579487179487,266.1237000000004,270.0373000000002,271.4291999999999,275.42550000000006,272.61141512694934,274.82608449479307,276.5338461538461,280.8714636385305,272.19622866916177,266.1237000000004,270.0373000000002,271.4291999999999,275.42550000000006,271.23873333333336,137854162,76601461.35,40.53351824518429,1.7292460217896444,1.5,2.75,NaN,NaN,2.469644605182164,1.7996283565679,992.7786444053052,-0.8385451338061238,0.7636215363467045,1.6021666701528283,9.127718909390794,-2.8395238778144325,9.368845301019885,65.84767771128557,24.783476987694545,9194367950
1530019800,271.64,272.56,270.79,271.6,NaN,NaN,266.0960869565218,281.3676923076923,266.24880000000036,269.93750000000017,271.5146,275.5545000000001,272.5717517886376,274.5188383524318,276.09,281.1201001671981,271.0598998328019,266.24880000000036,269.93750000000017,271.5146,275.5545000000001,271.65000000000003,68683211,74240191.55,42.54045239594361,1.0920643922854296,1.5,2.75,NaN,NaN,2.419669990526294,0.9251486232190359,995.2871206021603,-0.9395664355817206,0.42770862567567747,1.367275061257398,9.290249758301098,-2.3127000683379313,29.782841353637505,37.06488267687038,33.1522759694921,9263051161
1530106200,272.26,273.865,269.18,269.35,NaN,NaN,266.2865217391305,281.5774358974359,266.3495000000004,269.87650000000014,271.4977999999999,275.3915000000001,272.44540858124003,274.0265680331526,275.40999999999997,281.416089217786,269.4039107822139,266.3495000000004,269.87650000000014,271.4977999999999,275.3915000000001,270.79833333333335,105110674,76011802.8,37.43789135295462,1.3300305563397365,1.5,2.75,NaN,NaN,2.5814792769172734,1.382820432197406,991.860376629024,-1.1096859346470604,-0.019832357051427607,1.0898535775956328,9.845600943428902,-3.365263875435007,10.948874877477147,62.87163950415383,26.17948561836902,9157940487
1530192600,269.29,271.75,268.49,270.89,NaN,NaN,268.49,281.7871794871795,266.45370000000037,269.9461000000002,271.5078,275.3890000000002,272.38441216628945,273.72784726809044,274.81999999999994,280.97742703505844,268.66257296494143,266.45370000000037,269.9461000000002,271.5078,275.3890000000002,270.37666666666667,76650517,75168331.6,42.519804383138606,1.1304462113429274,1.5,2.75,NaN,NaN,2.629945042851753,1.01971821601532,994.1615150636337,-1.0697987552885817,-0.24739486651509424,0.8224038887734875,10.653607357698933,-2.251650849781694,28.820456717708268,38.1104951058544,33.06904817643734,9234591004
1530279000,272.12,273.66,271.1495,271.28,NaN,NaN,268.7320512820513,281.9969230769231,266.55925000000036,269.9676000000001,271.55559999999997,275.27300000000014,272.34110188525847,273.4947189568437,274.23230769230764,280.1666103412109,268.2980050434044,266.55925000000036,269.9676000000001,271.55559999999997,275.27300000000014,272.02983333333333,97592499,76485036,43.76559912178573,0.4057358300389551,1.5,2.75,NaN,NaN,2.6399489683623445,1.275968530628658,996.2235452535041,-0.9713264358809008,-0.3917541560776385,0.5795722798032623,10.735679096185956,-1.9091698004049862,34.75154439760222,31.98289175659644,33.265563845801346,9332183503
1530538200,269.51,272.04,269.24,271.86,NaN,NaN,268.97410256410257,282.2066666666667,266.6681000000004,270.0095000000002,271.6606,275.12100000000015,272.3222351446601,273.3390314371443,273.75769230769225,279.3798690218936,268.1355155934909,266.6681000000004,270.0095000000002,271.6606,275.12100000000015,271.0466666666667,63554774,77393157.15,45.65210873526581,0.699751673220002,1.5,2.75,NaN,NaN,2.651381184907892,0.8211937119559671,997.7235452535041,-0.8269569618224212,-0.4541239224747642,0.372833039347657,11.011958496273312,-1.3212341197822093,67.28101214470777,8.669902115320587,24.04908573997164,9395738277
1530624600,272.87,272.98,270.42,270.9,NaN,NaN,269.2161538461539,282.4164102564103,266.77665000000036,270.1422000000002,271.74719999999996,274.9110000000001,272.26646121741857,273.10674272884484,273.1553846153846,278.1616982622761,268.1490709684931,266.77665000000036,270.1422000000002,271.74719999999996,274.9110000000001,271.43333333333334,42187071,76945758.8,43.07624597088631,0.7885805351838273,1.5,2.75,NaN,NaN,2.644853957414471,0.5482702576194493,1000.4749404338801,-0.7577825268808762,-0.5743951192534382,0.18338740762743794,10.99197601626627,-1.8371562126318257,48.338584996999145,20.39598018936609,31.26543481363477,9353551206
1530797400,272.17,273.18,270.96,273.11,NaN,NaN,269.4582051282051,282.62615384615384,266.8936000000004,270.2583000000002,271.9498,274.6965000000001,272.2995411696767,273.1070529451453,272.8461538461538,277.2981787161958,268.3941289761118,266.8936000000004,270.2583000000002,271.9498,274.6965000000001,272.4166666666667,56925919,76655444,50.061794786145484,0.11147298569766848,1.5,2.75,NaN,NaN,2.6187929604562967,0.7426206937109385,1004.3306720981258,-0.5353359899083917,-0.4857825797580517,0.04955341015033998,12.257456856601873,-0.4120478413068828,85.2844137628633,1.9324721042968294,12.783114132839872,9410477125
1530883800,273.14,275.84,272.715,275.42,NaN,NaN,269.70025641025643,282.83589743589744,267.02085000000034,270.3591000000001,272.1856,274.5990000000001,272.4219121041992,273.32733361703623,272.7584615384615,276.9518177940234,268.56510528289965,267.02085000000034,270.3591000000001,272.1856,274.5990000000001,274.6583333333333,66493696,76331658.7,56.12286910957802,0.8411398784619372,1.5,2.75,NaN,NaN,2.65495060613799,0.8711155650545296,1007.7778932011787,-0.2208805784104258,-0.22654731286269225,-0.005666734452266467,12.844933629320218,0.2475067336390794,84.83691246016969,2.0456191014370058,13.117468438393308,9476970821
1531143000,276.55,277.96,276.5,277.9,NaN,NaN,269.9423076923077,283.04564102564103,267.16005000000035,270.47810000000015,272.41740000000004,274.5845000000001,272.6367390805051,273.76282565350897,272.9430769230769,277.766898482545,268.1192553636088,267.16005000000035,270.47810000000015,272.41740000000004,274.5845000000001,277.4533333333333,50550399,75252192.7,61.52232378508031,1.3950541972511703,1.5,2.75,NaN,NaN,2.6467398485567024,0.6717465257327977,1010.3995112809021,0.14611237521506035,0.17697373456655896,0.03086135935149862,13.748099396275924,2.5461254612546043,82.91488872820096,2.54853994482199,14.53657132697703,9527521220
1531229400,278.41,279.01,278.08,278.9,NaN,NaN,270.184358974359,283.2553846153846,267.3076000000004,270.57120000000015,272.6642,274.6015000000001,272.8823571557794,274.2520803531748,273.1684615384615,278.7510545182913,267.58586855863166,267.3076000000004,270.57120000000015,272.6642,274.6015000000001,278.6633333333333,51966829,74905908.4,63.474166491682944,1.4984987373331724,1.5,2.75,NaN,NaN,2.536972716516939,0.6937614149540171,1009.6986346368516,0.43201330325986687,0.5708779884263322,0.13886468516646536,9.989274964060984,2.6877761413843717,82.1906672730911,2.756760015914347,15.052572710994541,9579488049
1531315800,277.15,278.04,276.52,276.86,NaN,NaN,270.4264102564103,283.4651282051282,267.44470000000035,270.6095000000002,272.9112,274.49850000000004,273.0383431496704,274.5004536528724,273.36999999999995,279.2727659748278,267.4672340251721,267.44470000000035,270.6095000000002,272.9112,274.49850000000004,277.14,77054739,75142193.95,57.10971706565915,0.8252058919432688,1.5,2.75,NaN,NaN,2.5257603796228714,1.025452345073563,1006.4549688832069,0.4571095778961665,0.7102516575366735,0.253142079640507,11.592218144489314,2.7881937998886173,68.55217085665456,8.011983493294416,23.435845650051014,9502433310
1531402200,278.28,279.43,277.6,279.37,NaN,NaN,270.66846153846154,283.6748717948718,267.5969000000004,270.67210000000017,273.19900000000007,274.56550000000004,273.2866434183108,274.96421997164646,273.7261538461538,280.4220241622351,267.0302835300725,267.5969000000004,270.67210000000017,273.19900000000007,274.56550000000004,278.8,60124687,74194897.8,62.139798249372035,1.2782718939236608,1.5,2.75,NaN,NaN,2.5289203525069515,0.8103614774438035,1008.8622228778804,0.6067514853943443,1.0115814363834374,0.4048299509890931,10.17771029375705,3.130421942485887,69.0853842848713,7.760291581626187,23.15432413350252,9562557997
1531488600,279.17,279.93,278.66,279.59,NaN,NaN,270.91051282051285,283.8846153846154,267.74945000000037,270.75400000000013,273.52680000000004,274.6085000000001,273.5338338724947,275.4047704505373,274.38692307692304,281.5550035392622,267.2188426145839,267.74945000000037,270.75400000000013,273.52680000000004,274.6085000000001,279.3933333333334,48234964,72751765,62.55432389318953,1.257464014447312,1.5,2.75,NaN,NaN,2.438997470185025,0.6630074748014705,1008.3330726156674,0.6790863471469522,1.2536878849227833,0.5746015377758311,10.20633565824823,3.063255676791508,66.92615610679799,8.802332381452292,24.271511511749715,9610792961
1531747800,279.64,279.803,278.84,279.34,NaN,NaN,271.1525641025641,284.094358974359,267.8959000000003,270.8469000000002,273.86120000000005,274.7190000000001,273.76152666180866,275.7795542171528,274.9823076923077,282.4067420042173,267.5578733803981,267.8959000000003,270.8469000000002,273.86120000000005,274.7190000000001,279.32766666666663,48201038,69154658.15,61.7272441619659,0.9945113373990326,1.5,2.75,NaN,NaN,2.333569079457525,0.6970034888387341,1005.2302592180567,0.6676326601873848,1.4091423630100621,0.7415097028226774,10.435106724192464,2.7514161700875306,42.14793211407361,25.238060954892003,32.614006931034375,9562591923
1531834200,278.47,280.91,278.41,280.47,NaN,NaN,271.3946153846154,284.3041025641026,268.0465000000003,270.9476000000002,274.1502,274.9145000000001,274.0246040476201,276.22626333932874,275.8376923076923,283.0280112429189,268.64737337246567,268.0465000000003,270.9476000000002,274.1502,274.9145000000001,279.93,52315500,69124554.1,64.04151682531702,1.2352202474945864,1.5,2.75,NaN,NaN,2.3454570023534163,0.7568294751575114,1007.134723480516,0.6908090615332567,1.6050210297392482,0.9142119682059915,10.439330577971809,3.5326688815061096,42.28796348522389,25.12023962866191,32.59179688611418,9614907423
1531920600,280.56,281.18,280.06,281.06,NaN,NaN,271.63666666666666,284.5138461538462,268.19565000000034,271.01110000000017,274.433,275.1925000000001,274.3005019281056,276.68661921177363,276.62,283.6989829777823,269.5410170222177,268.19565000000034,271.01110000000017,274.433,275.1925000000001,280.76666666666665,44593465,66477651.85,65.22391494785793,1.1862633908243316,1.5,2.75,NaN,NaN,2.2579243593281726,0.6708038530094381,1008.6959729801156,0.6984399540279116,1.787261910740881,1.0888219567129693,9.593154810266343,2.910915015927644,77.66478031929105,4.223809702586174,18.11140997812276,9659500888
1532007000,280.31,280.74,279.46,280,NaN,NaN,271.87871794871796,284.72358974358974,268.33405000000033,271.0321000000002,274.6946,275.3940000000001,274.52401165641515,277.0021792868428,277.29076923076923,283.85228154018614,270.7292569213523,268.33405000000033,271.0321000000002,274.6946,275.3940000000001,280.0666666666666,61412117,66858983.4,61.322511714453306,0.7831587631776975,1.5,2.75,NaN,NaN,2.2109297622333046,0.9185320188401189,1011.3967353997036,0.5890361675129214,1.8251171661041212,1.2360809985911998,9.998326948511485,1.6629148210006477,43.23277639071004,24.333496745393575,32.433726863896375,9598088771
1532093400,279.77,280.48,279.5,279.68,NaN,NaN,272.1207692307692,284.93333333333334,268.4681500000003,271.0846000000002,274.8982,275.6660000000001,274.7262072777322,277.257209830953,277.89230769230767,283.7478725870411,272.0367427975742,268.4681500000003,271.0846000000002,274.8982,275.6660000000001,279.8866666666667,82372729,67424549.65,60.152747736604816,0.5868441120256924,1.5,2.75,NaN,NaN,2.12300620778807,1.221702323969471,1010.3441606189566,0.4578949774530021,1.8084497204074523,1.3505547429544502,9.413260976594596,0.6405181720043288,14.646511226097434,56.56974734245768,28.78374143144489,9515716042
1532352600,279.45,280.43,279.06,280.2,NaN,NaN,272.3628205128205,285.14307692307693,268.60335000000026,271.17010000000016,275.0618,275.93900000000014,274.9408658158604,277.53747556133845,278.6076923076922,282.94766149469933,274.2677231206851,268.60335000000026,271.17010000000016,275.0618,275.93900000000014,279.8966666666667,47047565,66946327.75,61.43997050989225,0.6027124451981604,1.5,2.75,NaN,NaN,2.0692200500889224,0.7027654328657332,1008.6915764356974,0.37256704418868525,1.8162635481903067,1.4436965040016214,8.16446060072914,0.4661168877733996,33.63986456889316,33.02867428970527,33.33146114140157,9562763607
1532439000,281.79,282.56,280.63,281.61,NaN,NaN,272.6048717948718,285.35282051282053,268.73810000000026,271.30920000000015,275.237,276.4695000000001,275.2024004897482,277.92533503168715,279.2615384615384,282.5171310097568,276.00594591332003,268.73810000000026,271.30920000000015,275.237,276.4695000000001,281.6,68026935,63454966.4,64.76384278360709,0.9355555559214076,1.5,2.75,NaN,NaN,2.089990046511143,1.0720506031187498,1007.3459888091913,0.37637556913452985,1.9141659654197838,1.537790396285254,8.37926775123961,1.7156685689518167,37.21306524091496,29.599603484813166,33.187331274271855,9630790542
1532525400,281.33,284.37,281.28,284.01,NaN,NaN,272.8469230769231,285.5625641025641,268.8863000000003,271.45850000000013,275.4576,277.0900000000001,275.54779654897374,278.5048269334312,279.9223076923076,283.27633309328246,276.5682822913327,268.8863000000003,271.45850000000013,275.4576,277.0900000000001,283.21999999999997,78882927,63964952.2,69.57179473787886,1.244307695714003,1.5,2.75,NaN,NaN,2.1614193289032064,1.2332210732114015,1009.4941866814463,0.49817510117980435,2.1605092727600095,1.6623341715802051,7.517334146862217,1.6608798367755973,44.14093356032441,23.59088300699097,32.26818343268461,9709673469
1532611800,283.2,284.11,283.09,283.34,NaN,NaN,273.0889743589744,285.7723076923077,269.03325000000024,271.57000000000016,275.7024,277.7895000000001,275.85337315489636,278.9653196064378,280.3407692307691,283.9302964036961,276.75124205784215,269.03325000000024,271.57000000000016,275.7024,277.7895000000001,283.5133333333333,57919495,61605393.25,66.83026471779576,1.1665481679212921,1.5,2.75,NaN,NaN,2.0798893768386946,0.9401692277972757,1011.6958809443081,0.49048850812909595,2.275444806741575,1.7849562986124792,6.728914982580354,1.3412496870417399,44.8314137477112,23.034660463326105,32.13392578896268,9651753974
1532698200,283.71,283.82,280.38,281.42,NaN,NaN,273.33102564102563,285.9820512820513,269.16725000000025,271.6554000000001,275.886,278.3160000000001,276.0716722468612,279.19909869153895,280.5346153846153,284.06364763707603,277.0055831321545,269.16725000000025,271.6554000000001,275.886,278.3160000000001,281.8733333333334,76783177,61612026.25,59.5842027912339,0.5302252255024396,1.5,2.75,NaN,NaN,2.1770401356359304,1.2462368416263538,1008.5179870031908,0.32115546204277523,2.1864006261659483,1.865245164123173,8.224384503441717,0.744612300422439,46.12472290263841,22.012516777542174,31.86276031981941,9574970797
1532957400,281.51,281.69,279.36,279.95,NaN,NaN,273.57307692307694,286.1917948717949,269.2919000000002,271.7271000000001,276.0448,278.74950000000007,276.22376353129806,279.27061310186855,280.7723076923076,283.6321210680775,277.91249431653773,269.2919000000002,271.7271000000001,276.0448,278.74950000000007,280.3333333333333,63742508,59919526.7,54.694594632221104,0.13093514937524897,1.5,2.75,NaN,NaN,2.1879658402333626,1.063801927527575,1007.2428335770642,0.0873682393482742,1.9744554633085158,1.8870872239602416,8.873531923519346,-0.18540307341249995,23.72998810081604,43.9743661541301,32.29564574505388,9511228289
1533043800,280.81,282.02,280.38,281.33,NaN,NaN,273.8151282051282,286.4015384615385,269.42535000000026,271.79940000000016,276.24480000000005,279.22300000000007,276.42400809869815,279.46674518740485,280.9230769230768,283.67593708173695,278.17021676441664,269.42535000000026,271.79940000000016,276.24480000000005,279.22300000000007,281.24333333333334,68570493,60170312.65,58.16536103319486,0.32197207199490224,1.5,2.75,NaN,NaN,2.179539708788122,1.1396067259756877,1010.3657138104995,0.007119111959441593,1.8959861139095437,1.8888670019501022,9.024860406665196,0.09606489717497396,23.821850980508,43.86157676112487,32.31657225836714,9579798782
1533130200,281.56,282.13,280.1315,280.86,NaN,NaN,274.0571794871795,286.6112820512821,269.55490000000026,271.81930000000017,276.3946,279.7210000000001,276.5979685654159,279.59943612193774,281.02076923076913,283.6654790335071,278.37605942803117,269.55490000000026,271.81930000000017,276.3946,279.7210000000001,281.0405,53853326,60753625.4,56.575684952912134,0.18514357214330496,1.5,2.75,NaN,NaN,2.1666083010175403,0.8864216027509694,1007.734826388459,-0.09076742391473447,1.7754077220566842,1.8661751459714186,9.010014684542702,0.307142857142862,5.371942824576439,74.61253165944845,20.015525515975106,9525945456
1533216600,279.39,282.58,279.16,282.39,NaN,NaN,274.2992307692308,286.82102564102564,269.69040000000024,271.8580000000002,276.5902,280.1850000000001,276.8251070530466,279.8652041103246,281.2553846153845,283.8013511434445,278.70941808732454,269.69040000000024,271.8580000000002,276.5902,280.1850000000001,281.37666666666667,63426363,61078647.6,60.37249760863994,0.5130704915928956,1.5,2.75,NaN,NaN,2.2561362795162845,1.0384375799440588,1010.1591924953843,-0.0667351668189613,1.782756187447717,1.8494913542666782,9.17189782520083,0.9689645308924412,21.308404762332206,47.03951244716934,31.65208279049843,9589371819
1533303000,282.53,283.6577,282.33,283.6,NaN,NaN,274.54128205128205,287.03076923076924,269.83105000000023,271.9268000000001,276.795,280.59400000000016,277.09078912939776,280.22089895696035,281.4961538461537,284.2803459091477,278.71196178315967,269.83105000000023,271.9268000000001,276.795,280.59400000000016,283.1959,53935386,60450732.1,63.11892655343722,0.7720972166711105,1.5,2.75,NaN,NaN,2.189819402407978,0.8922205592279336,1012.3566521261464,0.012184067645089058,1.8647214388230395,1.8525373711779505,9.267409191114597,1.2134189864382705,49.00977413328948,19.82608130775298,31.164144558957553,9643307205
1533562200,283.64,284.99,283.2015,284.64,NaN,NaN,274.78333333333336,287.24051282051283,269.97565000000026,272.02020000000016,277.0318,280.93100000000015,277.38683661451944,280.6417657229641,281.7715384615383,285.00124524653035,278.5418316765462,269.97565000000026,272.02020000000016,277.0318,280.93100000000015,284.2771666666667,39400887,59893256.5,65.34225979331165,1.03563062098954,1.5,2.75,NaN,NaN,2.161153730807408,0.6578518067388772,1014.45503860305,0.11049154670395889,1.9906518045578991,1.8801602578539403,9.357644183287523,1.0759561095131467,77.83537717415189,4.168809879352153,17.99581294649593,9682708092
1533648600,285.39,286.01,285.24,285.58,NaN,NaN,275.0253846153846,287.45025641025643,270.12460000000027,272.12600000000015,277.3004,281.2650000000002,277.7081371394402,281.1120737493485,282.2007692307691,285.8327507754266,278.5687876861116,270.12460000000027,272.12600000000015,277.3004,281.2650000000002,285.60999999999996,43196646,59454747.35,67.26321079613955,1.2132712472433416,1.5,2.75,NaN,NaN,2.1046427500354503,0.7265466245396466,1015.8410590327619,0.209164162397534,2.1416154608508577,1.9324512984533238,9.17634771549119,0.5527974367099726,75.35663580648387,5.085760961170686,19.557603232345446,9725904738
1533735000,285.39,285.91,284.94,285.46,NaN,NaN,275.2674358974359,287.66,270.2663500000002,272.23860000000013,277.62919999999997,281.6950000000002,278.01213176142295,281.52616196369627,282.64538461538444,286.34861077962853,278.94215845114036,270.2663500000002,272.23860000000013,277.62919999999997,281.6950000000002,285.43666666666667,42114551,57707737.95,66.7545421801605,1.0281790514343656,1.5,2.75,NaN,NaN,2.0235968393186345,0.7297903625418399,1014.7311563082085,0.2347696060141451,2.2259133059710052,1.9911436999568601,8.011861089224737,0.7482176889955547,80.06901969843064,3.4138857419100144,16.51709455965933,9683790187
1533821400,285.53,285.97,284.915,285.07,NaN,NaN,275.50948717948717,287.8697435897436,270.41115000000025,272.38440000000014,277.87839999999994,281.9800000000002,278.2889109080338,281.86367034810615,283.01999999999987,286.6423494288025,279.39765057119723,270.41115000000025,272.38440000000014,277.87839999999994,281.9800000000002,285.3183333333333,35716976,56487352.4,65.03322584583205,0.8506808001347033,1.5,2.75,NaN,NaN,1.9544113507958756,0.6323004085424262,1015.3636118402421,0.19546982540200997,2.2354809817093724,2.0400111563073624,7.901274195484892,1.2969938170705626,53.55810458702472,16.628333298575928,29.813562114399357,9648073211
1533907800,283.45,284.055,282.36,283.16,NaN,NaN,275.7515384615385,288.0794871794872,270.5441500000003,272.50650000000013,278.1227999999999,282.1585000000002,278.47993400967954,281.98713031495316,283.1392307692306,286.6689416881909,279.6095198502703,270.5441500000003,272.50650000000013,278.1227999999999,282.1585000000002,283.19166666666666,77076044,57929406.4,57.24764628119088,0.059046064479321474,1.5,2.75,NaN,NaN,2.008381968596169,1.3305167235409476,1012.6083139132174,0.020100502831458922,2.065136784846686,2.0450362820152272,7.875098493721855,1.1466333273799023,16.2807525931906,54.07650101522875,29.64274639158063,9570997167
1534167000,283.47,284.16,281.77,282.1,NaN,NaN,275.9935897435897,288.2892307692308,270.67820000000023,272.6232000000001,278.29279999999994,282.2965000000002,278.62189738184895,281.99787980876715,282.9923076923075,286.52381121907956,279.4608041655355,270.67820000000023,272.6232000000001,278.29279999999994,282.2965000000002,282.6766666666667,65732909,58805999.95,53.42505545275389,0.16724443347736315,1.5,2.75,NaN,NaN,2.0356403994107315,1.117792556131851,1009.9309753853281,-0.1771622217271518,1.8235835048562876,2.0007457265834394,7.5093525887231385,0.27369992535457954,2.897859332487516,81.75908329682842,15.343057370684056,9505264258
1534253400,282.92,284.17,282.4833,283.9,NaN,NaN,276.23564102564103,288.4989743589744,270.81960000000026,272.82550000000015,278.47279999999995,282.4680000000002,278.82888179824704,282.17903411269407,283.03538461538443,286.5963405404719,279.474428690297,270.81960000000026,272.82550000000015,278.47279999999995,282.4680000000002,283.51776666666666,43842031,58382326.5,58.49342631554635,0.31309520986294964,1.5,2.75,NaN,NaN,2.038094656595679,0.7509469668016742,1013.6171154892822,-0.19488416146551257,1.7571405247515486,1.9520246862170612,7.8389272067579645,1.0823898027486873,2.944489884285529,81.60415995383944,15.451350161875038,9549106289
1534339800,282.38,282.54,280.16,281.78,NaN,NaN,276.47769230769234,288.708717948718,270.93995000000024,273.06280000000015,278.60639999999995,282.50400000000013,278.94461192380595,282.14103086386604,283.0630769230768,286.5786631822284,279.54749066392515,270.93995000000024,273.06280000000015,278.60639999999995,282.50400000000013,281.49333333333334,102887320,61297019.25,51.39897896384356,0.5196589974397716,1.5,2.75,NaN,NaN,2.1596593239816984,1.678504456805214,1010.4466981048117,-0.34886546393669526,1.515942856296192,1.8648083202328873,9.141261373083777,-0.21601331491908837,1.9063785154137407,85.3767678065072,12.716853678079058,9446218969
1534426200,283.4,285.04,283.36,284.06,NaN,NaN,276.7197435897436,288.91846153846154,271.07650000000024,273.25230000000016,278.73959999999994,282.70700000000016,279.1452153777743,282.3237898292121,283.3792307692306,286.4261001490614,280.3323613893998,271.07650000000024,273.25230000000016,278.73959999999994,282.70700000000016,284.15333333333336,69967919,61724809.35,57.38523485607757,0.4356120961355184,1.5,2.75,NaN,NaN,2.2382550865544375,1.1335461338286013,1014.0422408910858,-0.29858668511036934,1.4915749638449256,1.790161648955295,9.778345547473172,0.1622002820874399,12.063001927516117,60.91613987254933,27.02085819993454,9516186888
1534512600,283.83,285.5601,283.37,285.06,NaN,NaN,276.9617948717949,289.12820512820514,271.2160500000002,273.49690000000015,278.89339999999993,282.97600000000017,279.37716771590084,282.58438127404906,283.6661538461537,286.5869813206821,280.74532637162525,271.2160500000002,273.49690000000015,278.89339999999993,282.97600000000017,284.66336666666666,65618481,60887096.95,59.728174174125186,0.5819927640118973,1.5,2.75,NaN,NaN,2.234815437514833,1.077707499404765,1017.2485942331843,-0.20392341140336945,1.535257384701083,1.7391807961044525,9.682844158234552,0.1475548060708319,34.1991379418458,32.54567103617221,33.255191021982,9581805369
1534771800,285.57,285.97,285.06,285.67,NaN,NaN,277.20384615384614,289.33794871794873,271.3569500000002,273.75530000000015,279.0429999999999,283.2495000000002,279.62394545253215,282.8782497241396,284.0361538461537,286.6431094943216,281.4291981979858,271.3569500000002,273.75530000000015,279.0429999999999,283.2495000000002,285.56666666666666,39807490,60525093.2,61.13198261028157,0.7474353373467789,1.5,2.75,NaN,NaN,2.1401857634066324,0.6577022503453163,1020.4621752269884,-0.11082730759190129,1.6006466616145758,1.711473969206477,9.540489460611832,0.03151481196163311,59.31134650305067,12.962536065135204,27.72611743181412,9621612859
1534858200,286.25,287.31,285.7135,286.34,NaN,NaN,277.44589743589745,289.54769230769233,271.5007000000002,273.98720000000014,279.19859999999994,283.4860000000002,279.8873201406681,283.2079402266025,284.33999999999986,287.0281735291774,281.6518264708223,271.5007000000002,273.98720000000014,279.19859999999994,283.4860000000002,286.4545,67271983,60487345.6,62.67113276509267,0.9089347268299887,1.5,2.75,NaN,NaN,2.104458208877586,1.1121662280382825,1022.8771286426881,-0.019512069424465484,1.6870838824258954,1.7065959518503608,9.448536421687956,0.3082743641841223,62.53673293877379,11.108186350172232,26.35508071105398,9688884842
1534944600,285.88,286.76,285.575,286.17,NaN,NaN,277.6879487179487,289.7574358974359,271.6393000000002,274.27420000000006,279.3435999999999,283.59400000000016,280.13369974299485,283.49004115740223,284.53769230769217,287.3540527942733,281.72133182111105,271.6393000000002,274.27420000000006,279.3435999999999,283.59400000000016,286.16833333333335,44993333,58792865.9,62.00025884887893,0.6883047432559728,1.5,2.75,NaN,NaN,2.038782622529187,0.765285588842166,1023.8004726211512,0.012337695328608067,1.7220180710111208,1.7096803756825127,9.453659462047844,0.3858701371593022,81.81949748474199,2.86658797723794,15.313914538020056,9643891509
1535031000,285.97,286.94,285.43,285.79,NaN,NaN,277.93,289.9671794871795,271.7740000000002,274.52440000000007,279.49879999999996,283.71650000000017,280.355515439348,283.70908485669725,284.6261538461537,287.5209612765436,281.7313464157639,271.7740000000002,274.52440000000007,279.49879999999996,283.71650000000017,286.05333333333334,49204851,58357133.7,60.44272757694838,0.5234555124278408,1.5,2.75,NaN,NaN,2.001012435205673,0.8431677137014698,1022.2092947135123,-0.008183793419439311,1.6994506339082136,1.707634427327653,9.451290428957947,0.9288035033196762,54.02176997212326,16.303026739332807,29.675203288543944,9594686658
1535117400,286.44,287.67,286.38,287.51,NaN,NaN,278.1720512820513,290.1769230769231,271.91820000000024,274.7639000000001,279.67439999999993,284.0210000000002,280.63608346133435,284.07107677510703,284.7746153846153,288.0258836851359,281.52334708409467,271.91820000000024,274.7639000000001,279.67439999999993,284.0210000000002,287.18666666666667,57487399,57392344.8,64.75822250919498,0.8614807882564557,1.5,2.75,NaN,NaN,1.9923686898338389,1.0016562173985266,1024.8906886453549,0.07358094762585798,1.7996106118599755,1.7260296642341175,8.815971068940662,1.917759659695132,52.49439085845399,17.33836275035355,30.16724639119247,9652174057
1535376600,288.86,289.9,288.68,289.78,NaN,NaN,278.41410256410256,290.3866666666667,272.07155000000023,275.00530000000003,279.9274,284.51250000000016,280.99466842363495,284.61478374890635,285.10692307692295,289.3132727431541,280.90057341069183,272.07155000000023,275.00530000000003,279.9274,284.51250000000016,289.4533333333333,57072377,57058838.25,69.48909701068445,1.378312163044622,1.5,2.75,NaN,NaN,2.020770926274278,1.0002372770006407,1027.3050764130267,0.2501024822928468,2.038657767100176,1.7885552848073292,8.792686950490168,2.0711518140190193,56.83615258931305,14.486238062713728,28.677609347973217,9709246434
1535463000,290.3,290.4175,289.4,289.92,NaN,NaN,278.65615384615387,290.5964102564103,272.2303000000002,275.30730000000005,280.1946,284.9420000000002,281.3446814266297,285.1200424394867,285.4799999999999,290.40586267334857,280.55413732665124,272.2303000000002,275.30730000000005,280.1946,284.9420000000002,289.91249999999997,46943472,55977487.2,69.75872845146237,1.2553980287082034,1.5,2.75,NaN,NaN,1.9491087172546897,0.8386134202894338,1026.3715730271579,0.3402605308431257,2.2138809483612363,1.8736204175181106,8.537797741793664,2.8887784796650027,53.021646325375826,16.98547128223816,29.992882392386026,9756189906
1535549400,290.16,291.74,289.8854,291.48,NaN,NaN,278.8982051282051,291.74,272.39725000000027,275.61210000000005,280.51419999999996,285.4730000000002,281.7421449000952,285.72575268334515,286.1199999999999,291.7809648538718,280.459035146128,272.39725000000027,275.61210000000005,280.51419999999996,285.4730000000002,291.03513333333336,61485514,56359096.6,72.65822998806969,1.528978064101332,1.5,2.75,NaN,NaN,1.9423580945936407,1.0909598930654256,1028.2744432362576,0.46140694559380857,2.4503790995103714,1.9889721539165628,6.095879040115357,2.612124199112869,79.43142708479309,3.6203489031178293,16.94822401208909,9817675420
1535635800,290.94,291.36,289.63,290.3,NaN,NaN,279.1402564102564,291.9670370370371,272.5571000000003,275.8636,280.8008,285.86850000000015,282.07774706087577,286.1613952849313,286.75076923076915,292.3058332353002,281.1957052262381,272.5571000000003,275.8636,280.8008,285.86850000000015,290.43,61229501,56249253.5,67.39454227049487,1.014203454089795,1.5,2.75,NaN,NaN,1.9357610878369536,1.0885389083430237,1025.7481586479466,0.4197135340658864,2.513614071498921,2.0939005374330346,6.635998465626894,1.838209499754441,74.4865379529687,5.424272056396482,20.08918999063481,9756445919
1535722200,289.84,290.81,289.29,290.31,NaN,NaN,279.3823076923077,292.1940740740741,272.72000000000025,276.12910000000005,281.12219999999996,286.2040000000002,282.40058050946885,286.55650049589025,287.24384615384605,292.83701527593325,281.65067703175885,272.72000000000025,276.12910000000005,281.12219999999996,286.2040000000002,290.1366666666667,66140838,56859526.1,67.41608552117873,0.7741509042059992,1.5,2.75,NaN,NaN,1.90606386727717,1.1632323119203767,1027.0176115975935,0.35312731958512833,2.535309686914445,2.182182367329317,6.67885308423723,1.6242517590226437,75.40710678339289,5.063567626370445,19.529325590236677,9822586757
1536067800,289.84,290.21,288.68,289.81,NaN,NaN,279.624358974359,292.42111111111114,272.8868500000002,276.3679,281.42359999999996,286.4625000000002,282.69114597968576,286.8663575915198,287.8615384615384,292.6152566574604,283.10782026561634,272.8868500000002,276.3679,281.42359999999996,286.4625000000002,289.56666666666666,57594367,57769200.1,65.09998960613224,0.5309356236426488,1.5,2.75,NaN,NaN,1.8863450196145146,0.9969735932002285,1024.089911378748,0.24107748072021984,2.4835292182295916,2.2424517375093718,6.9730790644549865,1.2118460571348844,46.47725558264221,21.738743638648888,31.784000778708897,9764992390
1536154200,289.41,289.64,287.89,289.03,NaN,NaN,279.8664102564103,292.64814814814815,273.03890000000024,276.60670000000005,281.7842,286.63500000000016,282.9397284902863,287.07241877327976,288.24384615384605,292.48490943460024,284.00278287309186,273.03890000000024,276.60670000000005,281.7842,286.63500000000016,288.8533333333333,72452437,59231989.65,61.54765550624457,0.2537330364824095,1.5,2.75,NaN,NaN,1.8887489467849077,1.2231977589832659,1022.5488078780057,0.08798735036249195,2.352435925462487,2.264448575099995,7.323716828115576,0.9994059475137005,21.008829989595327,47.42751855617288,31.563651454231817,9692539953
1536240600,289.15,289.49,287,288.16,NaN,NaN,280.10846153846154,292.8751851851852,273.19040000000024,276.815,282.11539999999997,286.77000000000015,283.144445020079,287.17599793772933,288.4823076923076,292.3088317534463,284.65578363116884,273.19040000000024,276.815,282.11539999999997,286.77000000000015,288.2166666666667,65909863,60421755.25,57.76164535100754,0.042895563712072954,1.5,2.75,NaN,NaN,1.9316954505859862,1.0908299953765412,1020.373044804018,-0.08874493273064354,2.1535174091866907,2.242262341917334,7.633062870077429,0.8292802407362064,4.971384824006496,75.63846594403012,19.390149231963402,9626630090
1536327000,286.98,288.7,286.71,287.6,NaN,NaN,280.35051282051285,293.1022222222222,273.3369000000002,276.9891,282.4804,286.8965000000002,283.3191726663504,287.216379086517,288.6307692307691,292.1464611883834,285.1150772731548,273.3369000000002,276.9891,282.4804,286.8965000000002,287.67,73524824,62312147.65,55.39938030012208,0.19643460366730922,1.5,2.75,NaN,NaN,1.9358600612584165,1.1799436670515722,1017.477771294373,-0.2510453173813252,1.928455695190678,2.179501012572003,7.700543077679099,0.03130325901708874,4.607928375535605,76.605253100678,18.786818523786405,9553105266
1536586200,288.74,289.04,287.88,288.1,NaN,NaN,280.5925641025641,293.3292592592593,273.4774500000002,277.1662,282.8246,287.14350000000024,283.50665609119943,287.30053345922965,288.7661538461537,292.04621518199923,285.4860925103082,273.4774500000002,277.1662,282.8246,287.14350000000024,288.34000000000003,50210903,60968890.6,57.08688791292285,0.06140880916821319,1.5,2.75,NaN,NaN,1.9004414854542435,0.8235495595519332,1019.7558803834858,-0.327573106622264,1.770034629294173,2.097607735916437,6.968463548863917,-0.5797501552902029,2.63943774121274,82.62806036770131,14.732501891085962,9603316169
1536672600,287.37,289.55,286.975,289.05,NaN,NaN,280.8346153846154,293.5562962962963,273.6239000000002,277.3678,283.17999999999995,287.4910000000002,283.7240421268387,287.46714932025543,288.98769230769216,291.90546968988707,286.06991492549724,273.6239000000002,277.3678,283.17999999999995,287.4910000000002,288.52500000000003,50530492,60208769.75,60.1704225491362,0.31800965139633525,1.5,2.75,NaN,NaN,1.9486242364932254,0.8392546834923496,1020.6703238735669,-0.3168640274942476,1.7015277015486276,2.0183917290428752,5.464586929549773,-0.3000827814569552,12.559224486221968,60.045346570959886,27.39542894281814,9653846661
1536759000,289.06,289.8,288.23,289.12,NaN,NaN,281.07666666666665,293.78333333333336,273.7677000000002,277.5929,283.5252,287.75200000000024,283.93564831794305,287.6245636707073,289.243846153846,291.50440481131096,286.983287496381,273.7677000000002,277.5929,283.5252,287.75200000000024,289.05,59810758,61007206.1,60.39623837533573,0.23705639701517922,1.5,2.75,NaN,NaN,1.9215796481722802,0.9803884134926808,1022.3476906557686,-0.3074753039013445,1.6340475991661947,1.9415229030675392,5.454492635117179,-0.8096610402085953,36.89274762833526,29.947670834581853,33.15958153708289,9713657419
1536845400,290.32,291.0384,289.995,290.83,NaN,NaN,281.31871794871796,294.01037037037037,273.92070000000024,277.83549999999997,283.92379999999997,288.2045000000002,284.2060150505727,287.9298433211161,289.4992307692306,291.66680242060175,287.3316591178595,273.92070000000024,277.83549999999997,283.92379999999997,288.2045000000002,290.6211333333333,51034222,58414551.2,65.53655755147494,0.6541138898536768,1.5,2.75,NaN,NaN,1.9213525304456902,0.8736559804297529,1024.2806582282756,-0.19404455890875405,1.6989672044315967,1.8930117633403507,5.659512503973978,0.18256975542541257,67.20590941422304,8.688142565693184,24.105948020083776,9764691641
1536931800,291.06,291.27,290,290.88,NaN,NaN,281.5607692307692,294.23740740740743,274.0607500000002,278.1145,284.27919999999995,288.54550000000023,284.46773995055025,288.21081062386696,289.583846153846,291.87122340180656,287.2964689058855,274.0607500000002,278.1145,284.27919999999995,288.54550000000023,290.71666666666664,55079875,57670149,65.67683876246377,0.5928009563424067,1.5,2.75,NaN,NaN,1.8748273496995682,0.955084666072217,1025.1888528760512,-0.1268435727559991,1.7344572973953518,1.861300870151351,5.1059932442786975,0.1963418414797951,100,0,0,9819771516
1537191000,290.82,290.86,289.03,289.34,NaN,NaN,281.8028205128205,294.46444444444444,274.19390000000016,278.3716,284.5575999999999,288.75950000000023,284.6588089720973,288.318352469213,289.53923076923064,291.8212603859414,287.2572011525199,274.19390000000016,278.3716,284.5575999999999,288.75950000000023,289.74333333333334,68244043,57801427.1,57.86438290471895,0.22293817323426982,1.5,2.75,NaN,NaN,1.873053967578172,1.1806636345143111,1022.8269654111846,-0.19332227387330714,1.619648027809717,1.812970301683024,6.007699052750034,-0.16217521824644673,71.97695247028143,6.486788144112852,21.536259385605725,9751527473
1537277400,289.58,291.58,289.55,290.91,NaN,NaN,282.0448717948718,294.6914814814815,274.32340000000016,278.6176,284.8178,289.0215000000002,284.90395371828953,288.5651760435737,289.49538461538447,291.6446115301902,287.3461577005787,274.32340000000016,278.6176,284.8178,289.0215000000002,290.68,61930407,58907572.95,62.73158990058644,0.6203866348893959,1.5,2.75,NaN,NaN,1.8992643984654463,1.0513148632445906,1024.6517941702741,-0.14119033476198473,1.6364823832305433,1.777672717992528,6.751411626382258,0.6504515102238704,73.26741437496344,5.9400200982333295,20.792565526803244,9813457880
1537363800,290.97,291.69,290.825,291.22,NaN,NaN,282.2869230769231,294.9185185185185,274.45720000000017,278.8642,285.06419999999997,289.2655000000002,285.1516418077684,288.8180164203762,289.56615384615367,291.87160609229153,287.2607016000158,274.45720000000017,278.8642,285.06419999999997,289.2655000000002,291.245,49080562,57998001.9,63.6250588859096,0.560313537511127,1.5,2.75,NaN,NaN,1.8253883700036293,0.8462457393726179,1022.879390677439,-0.09753684169491916,1.6557516658738791,1.7532885075687983,6.464408503737989,1.0619100499722383,72.13875453515674,6.41703219116597,21.444213273677306,9862538442
1537450200,292.64,293.94,291.2363,293.58,NaN,NaN,282.5289743589744,293.94,274.6044000000002,279.1549,285.39859999999993,289.6360000000002,285.48216565844416,289.27153866605465,289.81769230769214,292.9560030129741,286.67938160241016,274.6044000000002,279.1549,285.39859999999993,289.6360000000002,292.91876666666667,100360646,60766367.55,69.60015594208964,1.165733236372443,1.5,2.75,NaN,NaN,1.8892892007176536,1.6515821176479062,1025.9495577618052,0.06956265442396359,1.8402418255987527,1.7706791711747891,7.1871181290656105,2.079276773296231,76.92005536592305,4.512011242576116,18.567933391500855,9962899088
1537536600,293.09,293.22,291.81,291.99,NaN,NaN,282.77102564102563,294.08666666666664,274.7484000000002,279.425,285.6509999999999,289.9460000000002,285.7373748483091,289.530439745478,289.9853846153845,293.3303014512862,286.6404677794828,274.7484000000002,279.425,285.6509999999999,289.9460000000002,292.34,105597145,63585982.25,62.188388670195685,0.6487065407629071,1.5,2.75,NaN,NaN,1.8807685435235342,1.6606984945962677,1026.6393853264658,0.05303776256349857,1.8369763743791623,1.7839386118156637,8.08305034788132,1.3502256161055142,41.856420914001205,25.5498564307335,32.59372265526531,9857301943
1537795800,291.34,291.5,290.37,291.02,NaN,NaN,283.01307692307694,294.23333333333335,274.88730000000015,279.70320000000004,285.8795999999999,290.1215000000002,285.94453661896364,289.67230262686104,290.1384615384614,293.4766125343137,286.8003105426091,274.88730000000015,279.70320000000004,285.8795999999999,290.1215000000002,290.9633333333333,53409645,63382094.55,58.12197796322932,0.1843001725001173,1.5,2.75,NaN,NaN,1.8621422189861392,0.8426614074400292,1025.8188914741654,-0.038267008371775324,1.7361048513509445,1.7743718597227198,8.540520489367045,0.6815429856426122,43.4307360370179,24.171086230388063,32.39817773259404,9803892298
1537882200,291.53,291.65,290.4833,290.75,NaN,NaN,283.2551282051282,294.38,275.0207000000002,279.9845,286.10779999999994,290.1700000000002,286.132986163318,289.77494047192187,290.3376923076922,293.4833477130226,287.19203690236174,275.0207000000002,279.9845,286.10779999999994,290.1700000000002,290.9611,44370037,62746977.55,57.00462914522082,0.13809181898644307,1.5,2.75,NaN,NaN,1.812467774772843,0.707126282929623,1024.1949554712414,-0.1268964288926553,1.6157513236069008,1.742647752499556,8.470887857077694,0.5637797454344201,24.049143814195446,43.579285755121404,32.37157043068315,9759522261
1537968600,290.91,292.24,289.41,289.88,NaN,NaN,283.4971794871795,294.52666666666664,275.14255000000014,280.22310000000004,286.29599999999994,290.16800000000023,286.27992788240357,289.78494614126265,290.5130769230768,293.2572386655076,287.76891518064605,275.14255000000014,280.22310000000004,286.29599999999994,290.16800000000023,290.51000000000005,79739674,64386787.65,53.43968715465395,0.1693059007952807,1.5,2.75,NaN,NaN,1.885148648003353,1.2384477764826027,1021.6567518001176,-0.2472042665877141,1.4336424192649133,1.6808466858526274,8.71871686928246,-0.32665130832444683,8.695698330581957,67.14270858681331,24.16159308260474,9679782587
1538055000,290.41,291.91,290.1,290.69,NaN,NaN,283.7392307692308,294.67333333333335,275.2644500000002,280.46080000000006,286.4885999999999,290.12850000000014,286.4528718870152,289.87114174685667,290.7123076923076,293.0765431855202,288.348072199095,275.2644500000002,280.46080000000006,286.4885999999999,290.12850000000014,290.9000000000001,59249455,64274984.7,56.18692658764918,0.1455506907320104,1.5,2.75,NaN,NaN,1.8954951731459728,0.9218120436207586,1022.7737204870641,-0.273283683061867,1.3392420820252937,1.6125257650871607,8.149109309605286,-0.06531903190318954,3.5273331140619604,79.70614273100202,16.76652415493601,9739032042
1538141400,289.99,291.28,289.95,290.72,NaN,NaN,283.98128205128205,294.82,275.3841500000002,280.69880000000006,286.7029999999999,290.14950000000016,286.6202102443871,289.9519853900132,290.8407692307691,293.00256992656,288.67896853497825,275.3841500000002,280.69880000000006,286.7029999999999,290.14950000000016,290.65000000000003,70091385,64718078.9,56.28979555468756,0.04225642675016059,1.5,2.75,NaN,NaN,1.855102660778402,1.0830263535526548,1024.5536478993258,-0.28809033350133095,1.252412848210497,1.540503181711828,8.14852721616881,0.4769475357710833,23.70146603905238,44.00516596968088,32.29336799126675,9809123427
1538400600,292.11,292.93,290.98,291.73,NaN,NaN,284.22333333333336,294.96666666666664,275.50905000000023,280.9211000000001,286.9439999999999,290.22050000000013,286.82059415637195,290.1213201147738,291.0415384615384,293.0022423563827,289.0808345666941,275.50905000000023,280.9211000000001,286.9439999999999,290.22050000000013,291.88,62078937,64514983.85,59.718798645710386,0.40483065569867177,1.5,2.75,NaN,NaN,1.8804524707228005,0.9622406035834418,1021.8590478241351,-0.23185731681111355,1.250681535697936,1.4825388525090495,7.61869658631058,0.2818741191433753,47.88192298445926,20.67037713567909,31.447699879861656,9871202364
1538487000,291.56,292.355,291.14,291.56,NaN,NaN,284.4653846153846,295.11333333333334,275.6385500000002,281.1165000000001,287.1711999999999,290.3080000000001,287.00645320906324,290.25833724670014,291.0976923076922,293.07270784950623,289.1226767658782,275.6385500000002,281.1165000000001,287.1711999999999,290.3080000000001,291.685,47258227,63998176.85,58.88150808633844,0.3062036000888042,1.5,2.75,NaN,NaN,1.83292015138546,0.7384308323464374,1019.6444716059644,-0.20882223426652713,1.2215110596758905,1.4303332939424176,7.054648046791659,0.11675022319894751,47.041391812407454,21.30974555152344,31.648862636069104,9823944137
1538573400,292.74,293.21,291.32,291.72,NaN,NaN,284.7074358974359,295.26,275.7646000000002,281.3052000000001,287.37339999999983,290.44250000000017,287.19129818125685,290.3975432232049,291.1623076923076,293.1594464740396,289.1651689105756,275.7646000000002,281.3052000000001,287.37339999999983,290.44250000000017,292.0833333333333,64694594,63610284.7,59.457650424307126,0.38840558825378,1.5,2.75,NaN,NaN,1.8369972834293549,1.0170461318498076,1019.1896127798171,-0.18626673361210888,1.1974998769272815,1.3837666105393904,7.038344310010752,-0.6335581442877434,81.77029276138981,2.882673979197022,15.347033259413163,9888638731
1538659800,291.18,291.24,287.66,289.44,NaN,NaN,284.94948717948716,295.40666666666664,275.8708000000002,281.4698000000001,287.48199999999986,290.50650000000013,287.2794825663056,290.3063486305187,291.1699999999999,293.13958410289735,289.20041589710246,275.8708000000002,281.4698000000001,287.48199999999986,290.50650000000013,289.4466666666667,111545910,65892087.05,48.93526700392979,0.616341485638996,1.5,2.75,NaN,NaN,1.9957831917558297,1.692857443039513,1014.0624421382372,-0.320484782362241,0.9831606325865891,1.3036454149488301,6.401386930747085,-0.8733175793691603,40.28941575506115,26.83961454370906,32.87096970122979,9777092821
1538746200,289.69,290.27,286.22,287.82,NaN,NaN,285.19153846153847,295.55333333333334,275.9740500000002,281.6370000000001,287.5715999999999,290.5175000000001,287.30067932841126,290.06955352285024,290.93230769230763,293.5941769469508,288.27043843766444,275.9740500000002,281.6370000000001,287.5715999999999,290.5175000000001,288.1033333333333,105961360,67513913.85,43.09896127575712,0.8881780895304137,1.5,2.75,NaN,NaN,2.142512963773267,1.5694744084222576,1010.4806901411803,-0.5030794150044,0.6747961461933301,1.17787556119773,6.443742403110215,-1.0995807848257813,13.280125584193023,58.789338344969636,27.930536070837324,9671131461
1539005400,287.05,288.22,285.5,287.82,NaN,NaN,285.4335897435898,295.7,276.0780000000002,281.7928000000001,287.69959999999986,290.5035000000001,287.32104484494414,289.8553103301978,290.67076923076917,293.7959765374809,287.54556192405744,276.0780000000002,281.7928000000001,287.69959999999986,290.5035000000001,287.18,87742172,69390477.3,43.09896127575711,0.9663268801548228,1.5,2.75,NaN,NaN,2.183762037789464,1.2644699303718439,1011.061169703042,-0.6018924057195987,0.4255100540482317,1.0274024597678304,6.369478175763543,-1.0077386070507333,4.330044515787039,77.40910996870876,18.260845515504187,9671131461
1539091800,287.39,288.86,286.77,287.4,NaN,NaN,285.675641025641,295.84666666666664,276.1771000000002,281.94670000000013,287.8485999999998,290.42100000000005,287.32414112553454,289.62147125113137,290.19538461538457,293.2857628882859,287.10500634248325,276.1771000000002,281.94670000000013,287.8485999999998,290.42100000000005,287.6766666666667,74338982,70580901.8,41.606905259638395,0.6676123616712784,1.5,2.75,NaN,NaN,2.1770647493759334,1.0532450011852923,1009.8188016976308,-0.6684443304015211,0.191847046765929,0.8602913771674501,6.3713678123625295,-0.8555264247274798,3.672326164878091,79.30599834823153,17.021675486890373,9596792479
1539178200,286.83,286.91,277.88,278.3,NaN,NaN,285.91769230769233,295.99333333333334,276.2310500000002,282.0164000000001,287.7879999999998,289.88000000000005,286.9702532382587,288.54323589388076,289.14230769230767,296.0460821508877,282.23853323372765,276.2310500000002,282.0164000000001,287.7879999999998,289.88000000000005,281.03,214756170,78328172.4,23.015421705209533,2.576643915245765,1.5,2.75,NaN,NaN,2.701560124420508,2.741748765735277,1003.0770674702857,-1.2637006841268266,-0.7193344779910831,0.5443662061357435,18.95844236794708,-4.262272523994628,0,100,0,9382036309
1539264600,277.08,278.9,270.36,272.17,NaN,NaN,286.1597435897436,296.14,276.2559500000002,282.0044000000001,287.6141999999998,288.94700000000006,286.3898511504838,286.98388009446353,287.6923076923077,298.9528969755367,276.43171840907866,276.2559500000002,282.0044000000001,287.6141999999998,288.94700000000006,273.81,274840490,89518485.8,17.3812174109527,4.377020105141046,1.5,2.75,NaN,NaN,3.118591544104755,3.0702093265299624,997.9189130157304,-1.9667157185748652,-1.914028442082838,0.0526872764920272,20.979336269611522,-6.380709961474962,0,100,0,9107195819
1539351000,276.77,277.09,272.37,275.95,NaN,NaN,286.4017948717949,296.28666666666663,276.2991000000002,282.0378000000001,287.4853999999998,288.20050000000003,285.9804452230139,285.9330343711813,286.5538461538461,299.24891979185384,273.8587725158384,276.2991000000002,282.0378000000001,287.4853999999998,288.20050000000003,275.1366666666667,183186492,95923816.65,28.934112882546003,3.402309802533005,1.5,2.75,NaN,NaN,3.247263576668698,1.9097081246089054,1000.6709614331467,-2.0635030053029517,-2.5266914801366624,-0.46318847483371073,23.843528956831697,-5.4091111644328755,6.875980100718539,71.07433564835155,22.0496842509299,9290382311
1539610200,275.55,277.04,274.3,274.4,NaN,NaN,286.64384615384614,296.43333333333334,276.33175000000017,282.0482000000001,287.30139999999983,287.4535,285.526310116229,284.8346501453545,285.36307692307685,299.417974530155,271.3081793159987,276.33175000000017,282.0482000000001,287.30139999999983,287.4535,275.24666666666667,102263717,97624800.35,27.251343679383922,2.792281606318626,1.5,2.75,NaN,NaN,3.211030464049506,1.047517809341159,1003.2858228061452,-2.1106897422349933,-3.101550652627452,-0.990860910392459,23.19570548310695,-5.885581012484574,5.251900737960341,74.94932312764924,19.798776134390433,9188118594
1539696600,276.6,280.82,276.07,280.4,NaN,NaN,286.88589743589745,296.58,276.3994500000002,282.12420000000014,287.2165999999998,286.928,285.32527834696515,284.41230251246355,284.5715384615384,298.49569090617933,270.6473860168975,276.3994500000002,282.12420000000014,287.2165999999998,286.928,279.09666666666664,118255834,100441071.7,41.447323445757796,1.231682173413667,1.5,2.75,NaN,NaN,3.440242573760257,1.1773653147908416,1009.3498091043291,-1.637680158060241,-3.03796110796776,-1.4002809499075193,28.10668841656943,-3.8804332921980147,14.128398543811779,57.44269758653238,28.428903869655837,9306374428
1539783000,280.44,281.15,277.56,280.45,NaN,NaN,287.1279487179487,296.72666666666663,276.4578500000002,282.2072000000001,287.1139999999998,286.3895,285.13409096080966,284.0349403684194,283.7815384615384,297.38229374860146,270.1807831744753,276.4578500000002,282.2072000000001,287.1139999999998,286.3895,279.72,110625987,103518342.95,41.54968354530218,0.9022143435555774,1.5,2.75,NaN,NaN,3.45093953277738,1.0686607208679242,1006.8343397232996,-1.239400037073181,-2.9495309962489955,-1.7101309591758145,28.086074736134783,-3.105997788833613,35.78618281294339,30.984263425533907,33.229553761522695,9417000415
1539869400,279.4,280.07,274.97,276.4,NaN,NaN,287.37,296.87333333333333,276.4875000000002,282.2810000000001,286.9327999999998,285.53049999999996,284.7915775897975,283.3078031904747,282.6023076923076,295.8968205079646,269.3077948766506,276.4875000000002,282.2810000000001,286.9327999999998,285.53049999999996,277.14666666666665,134557525,105228186.9,36.05196403509342,1.8213398171031605,1.5,2.75,NaN,NaN,3.5958724232932786,1.2787213099839125,1002.6125475195354,-1.1676649761938047,-3.1697121794180703,-2.0020472032242655,28.68240505446129,-3.967757626294217,51.614222334575636,17.983047964051714,30.402729701372643,9282442890
1539955800,277.13,279.3,275.47,276.25,NaN,NaN,287.6120512820513,297.02,276.51070000000016,282.31740000000013,286.75639999999987,284.7435,284.4566137627466,282.6356314580486,281.4246153846153,294.031076769115,268.81815400011567,276.51070000000016,282.31740000000013,286.75639999999987,284.7435,277.00666666666666,139901634,106943411.35,35.862695376253725,1.467325394230258,1.5,2.75,NaN,NaN,3.612595821629472,1.308183760307923,1001.9125475195353,-1.0528122696247006,-3.3180625402551414,-2.2652502706304407,28.76477930034466,-4.019873532068652,18.184143162681394,51.32838274589281,30.48747409142579,9142541256
1540215000,277,277.36,274.41,275.01,NaN,NaN,287.85410256410256,297.16666666666663,276.5186500000002,282.35810000000015,286.59339999999986,283.94300000000004,284.0861583210703,281.9093808429963,280.13923076923066,291.64405106076595,268.6344104776954,276.5186500000002,282.35810000000015,286.59339999999986,283.94300000000004,275.5933333333333,82415812,108393719.7,34.261405140378756,1.608952755498109,1.5,2.75,NaN,NaN,3.5652675486559375,0.7603375198129675,999.3201377843094,-0.9841167081651561,-3.495396155836886,-2.51127944767173,28.645883881268237,-4.311064718162835,19.61766568119142,49.32520986717503,31.057124451633555,9060125444
1540301400,270.95,274.87,268.61,273.61,NaN,NaN,288.09615384615387,297.31333333333333,276.5171000000002,282.3582000000001,286.42359999999985,283.086,283.6753285829891,281.1189636198538,278.9215384615384,289.54840382510383,268.2946730979729,276.5171000000002,282.3582000000001,286.42359999999985,283.086,272.36333333333334,146352719,113492853.8,32.49714211774051,2.4158372955101055,1.5,2.75,NaN,NaN,3.7677484380376547,1.2895324604129392,995.5431253690782,-0.9559205110600795,-3.706180086496829,-2.7502595754367496,28.57835375755817,-1.6852317642831467,3.7182082251279422,79.15382137358098,17.127970401291073,8913772725
1540387800,273.33,273.76,264.7,265.32,NaN,NaN,288.3382051282051,297.46,276.47100000000023,282.2624000000001,286.05199999999985,281.858,282.9555117758131,279.61430041796297,277.19076923076915,288.7453260049711,265.6362124565672,276.47100000000023,282.2624000000001,286.05199999999985,281.858,267.9266666666667,177806697,118396204.95,24.46384185199375,3.428375863044327,1.5,2.75,NaN,NaN,4.145766406749251,1.5017938883690545,990.5986576329078,-1.3921115896696912,-4.4903990625238634,-3.0982874728541723,28.095416262955148,-2.516809347099248,0,99.99999999999999,0,8735966028
1540474200,267.38,271.81,266.23,270.08,NaN,NaN,288.5802564102564,297.6066666666666,276.4508000000002,282.21220000000017,285.81799999999987,280.8275,282.45058974538904,278.7062718067284,275.8261538461537,286.1631599250107,265.48914776729674,276.4508000000002,282.21220000000017,285.81799999999987,280.8275,269.3733333333333,138061545,122336809.45,34.47917286042528,2.465072132365141,1.5,2.75,NaN,NaN,4.31321166341002,1.1285364202376622,994.4907198302716,-1.260512342179796,-4.673927900578917,-3.4134155583991213,28.368821924546978,-2.127196955970286,4.535676445206952,76.8270944300539,18.63722912473914,8874027573
1540560600,265.92,271,262.29,265.33,NaN,NaN,288.8223076923077,297.75333333333333,276.3968500000002,282.09150000000017,285.4433999999999,279.558,281.7791940690993,277.43234115846855,274.1284615384614,283.5096500678875,264.7472730090353,276.3968500000002,282.09150000000017,285.4433999999999,279.558,266.20666666666665,201574596,128910970,30.178994050870926,3.356378572441389,1.5,2.75,NaN,NaN,4.627267973166446,1.5636729442032746,990.5962793484223,-1.3839647885309447,-5.143371544062802,-3.7594067555318573,28.217406001263544,-3.3053935860058288,3.8445884538589454,78.77996670657849,17.375444839562576,8672452977
1540819800,268.8,270.25,259.85,263.86,NaN,NaN,259.85,297.9,276.3265500000002,281.9564000000002,285.0193999999999,278.1645,281.07648057619343,276.1397372386144,273.0176923076922,283.5134325537826,262.5219520616018,276.3265500000002,281.9564000000002,285.0193999999999,278.1645,264.65333333333336,160749101,133844478.2,28.97463479365814,3.381968452513788,1.5,2.75,NaN,NaN,5.039605975083126,1.2010140661895456,988.3796196436156,-1.448330841153676,-5.569820306973952,-4.121489465820276,28.215736483203475,-5.898716119828803,2.9557303612457546,81.6201095123826,15.424160126371648,8511703876
1540906200,263.67,268.12,263.12,267.77,NaN,NaN,259.7483529411765,298.0466666666666,276.2805500000002,281.8522000000002,284.6613999999999,276.97499999999997,280.5546578084996,275.3426194063654,272.6792307692306,283.539919121222,261.81854241723926,276.2805500000002,281.8522000000002,284.6613999999999,276.97499999999997,266.33666666666664,157115995,139337366.6,36.2608451047621,2.2166419981545307,1.5,2.75,NaN,NaN,5.036776976862903,1.1275941180303604,991.7442525681678,-1.1256484417495347,-5.528550018007195,-4.40290157625766,26.13039515476459,-4.521305045462652,15.066111885060263,56.07097402668421,28.862914088255522,8668819871
1540992600,270.65,273.23,270.12,270.63,NaN,NaN,259.646705882353,298.1933333333333,276.2356500000002,281.77290000000016,284.3471999999999,275.92049999999995,280.1654555414996,274.89379851052104,272.26999999999987,283.0070902805211,261.53290971947865,276.2356500000002,281.77290000000016,284.3471999999999,275.92049999999995,271.32666666666665,128296325,142517453.15,41.02646446407134,0.25167178225312536,1.5,2.75,NaN,NaN,5.06700719280127,0.9002148309861233,994.3966654541354,-0.6417300820882144,-5.205064178867929,-4.563334096779714,27.479933891675962,-2.087554269175102,37.00444084358853,29.941037437172287,33.05452171923917,8797116196
1541079000,271.6,273.73,270.38,273.51,NaN,NaN,259.5450588235294,298.34,276.2075000000002,281.7188000000002,284.0939999999999,275.12399999999997,279.90445728497025,274.7620081761857,272.20153846153835,282.89469039278583,261.50838653029086,276.2075000000002,281.7188000000002,284.0939999999999,275.12399999999997,272.54,99495037,141914909.5,45.44952350770776,0.333696923948151,1.5,2.75,NaN,NaN,4.9443638218868955,0.7010893876516899,998.9089942443624,-0.07938096030585307,-4.662560297162031,-4.583179336856178,27.588978805420208,-0.9918552036199128,33.86093436654135,32.96256881233843,33.17649682112021,8896611233
1541165400,274.75,275.23,269.59,271.89,NaN,NaN,259.4434117647059,298.4866666666666,276.16490000000016,281.6574000000002,283.81599999999986,274.3275,279.5901648424224,274.48848358797756,271.54692307692295,281.13742923061125,261.95641692323466,276.16490000000016,281.6574000000002,283.81599999999986,274.3275,272.2366666666666,122634107,142748546.85,43.47434727038875,0.27214545092913717,1.5,2.75,NaN,NaN,4.994052120323549,0.8590918065797459,996.8212453006016,0.21564921160211448,-4.313617822353535,-4.52926703395565,27.72580402044981,-1.13450419984728,41.989971371165296,25.509323096510865,32.500705532323835,8773977126
1541428200,272.44,274.01,271.35,273.39,NaN,NaN,259.3417647058824,298.6333333333333,276.1184000000001,281.6040000000002,283.5335999999998,273.60600000000005,279.3470211231117,274.38386610340825,271.00384615384604,279.21689220532096,262.7908001023711,276.1184000000001,281.6040000000002,283.5335999999998,273.60600000000005,272.9166666666667,65622482,141642562.35,45.82213761001901,0.3469348992266571,1.5,2.75,NaN,NaN,4.827334111729008,0.4632963490016954,1000.1983836292964,0.526282678368263,-3.8714136859953214,-4.3976963643635845,27.934653785234666,-0.08040641789409278,74.56191168117758,5.393197256434696,20.044891062387745,8839599608
1541514600,273.32,275.3,273.25,275.12,NaN,NaN,259.24011764705887,298.78,276.07755000000014,281.5839000000002,283.24039999999985,272.9920000000001,279.18125558887203,274.45397409355985,270.9053846153845,278.8846678505261,262.92610138024287,276.07755000000014,281.5839000000002,283.24039999999985,272.9920000000001,274.5566666666667,60085894,140929907.95,48.4799803022069,0.6587155390144779,1.5,2.75,NaN,NaN,4.628953103748365,0.4263530351649535,1003.0230065463697,0.8438906264382258,-3.3428330813158027,-4.1867237077540285,28.02730073878537,3.693652947384295,68.69121557910573,7.949870227583283,23.35891419331098,8899685502
1541601000,277.56,281.1,277.08,281.01,NaN,NaN,259.1384705882353,298.9266666666666,276.06670000000014,281.62840000000017,283.06219999999985,273.12750000000005,279.2529710559751,275.0783575132208,271.2715384615383,280.5322008274557,262.01087609562086,276.06670000000014,281.62840000000017,283.06219999999985,273.12750000000005,279.73,102752099,135329704.4,56.33419476485704,2.240682395309692,1.5,2.75,NaN,NaN,4.725456453480626,0.7592723227732108,1007.7451360937971,1.4127785948533997,-2.420750464187279,-3.8335290590406785,22.009510274458545,4.046949052132704,66.97160248095122,8.783949724782168,24.244447794266623,9002437601
1541687400,280.11,281.22,279.22,280.5,NaN,NaN,259.0368235294118,281.22,276.05270000000013,281.6784000000001,282.84259999999983,273.54400000000004,279.3018741518192,275.5947044167236,271.693846153846,282.0355393300816,261.3521529776104,276.05270000000013,281.6784000000001,282.84259999999983,273.54400000000004,280.31333333333333,65584886,124866924.2,55.54459303861424,1.9425561366877748,1.5,2.75,NaN,NaN,4.530780992517724,0.5252382600131348,1006.3222195965898,1.6976889079444675,-1.7114179241100942,-3.4091068320545617,20.93784352867301,5.717408510157169,40.84109360682836,26.360742509985645,32.798163883185985,8936852715
1541773800,279.03,279.24,276.18,277.76,NaN,NaN,258.93517647058826,280.85657142857144,276.0086000000002,281.6963000000001,282.59179999999986,273.63450000000006,279.2414084988067,275.80092304370226,272.01307692307677,282.817510157391,261.20864368876255,276.0086000000002,281.6963000000001,282.59179999999986,273.63450000000006,277.7266666666667,98812561,120648227.65,51.37802503627045,0.8815362927461571,1.5,2.75,NaN,NaN,4.515725207337886,0.8190137801829532,1003.1806978509218,1.6434892920938409,-1.3547452169372605,-2.9982345090311013,18.28782825162493,5.267945122413392,45.080636051309675,22.84263178796756,32.07673216072277,8838040154
1542033000,277.19,277.46,271.99,272.57,NaN,NaN,258.83352941176474,280.4931428571429,275.94805000000014,281.6796000000001,282.23699999999985,273.54300000000006,278.97978463610843,275.49321608715917,272.5707692307691,282.66053391976413,262.48100454177404,275.94805000000014,281.6796000000001,282.23699999999985,273.54300000000006,274.00666666666666,99673574,120518720.5,44.55966294723472,0.5113067927130678,1.5,2.75,NaN,NaN,4.605316263956608,0.8270381031799952,999.4235993063419,1.219484254963454,-1.4738791903267838,-2.6933634452902377,22.159545762086253,1.792583187063529,18.613186418336014,50.69891656859703,30.68789701306696,8738366580
1542119400,273.09,275.325,271.25,272.06,NaN,NaN,258.7318823529412,280.12971428571433,275.89955000000015,281.65280000000007,281.88199999999983,273.1260000000001,278.7084205327316,275.16624312647735,272.72307692307675,282.7171717475653,262.7289820985882,275.89955000000015,281.65280000000007,281.88199999999983,273.1260000000001,272.87833333333333,98176610,119514759.3,43.94253493091218,0.7880235083582755,1.5,2.75,NaN,NaN,4.56743653081685,0.8214601324139553,999.0514951025742,0.8818066041512846,-1.591105190101132,-2.4729117942524166,21.038666888513706,0.5283967039869958,5.845884011721693,73.45327019449904,20.700845793779283,8640189970
1542205800,274.16,274.61,268.45,270.2,NaN,NaN,258.63023529411765,279.76628571428574,275.8410500000001,281.6448000000001,281.50539999999984,272.6135000000001,278.37475698242844,274.6932675906224,273.0976923076921,282.2879920561986,263.9073925591856,275.8410500000001,281.6448000000001,281.50539999999984,272.6135000000001,271.08666666666664,125335931,120250256.5,41.67558206016531,1.1654998945447703,1.5,2.75,NaN,NaN,4.681191064329934,1.042292421222403,996.1869039706776,0.5277752453095261,-1.813192737615509,-2.340967982925035,20.681711867225715,-1.210193411575446,0,100,0,8514854039
1542292200,268.78,273.54,267.0102,273.02,NaN,NaN,258.52858823529414,279.40285714285716,275.79825000000005,281.6590000000001,281.20259999999985,272.4445000000002,278.1647665125293,274.5339087724679,273.8023076923075,281.30034909337036,266.3042662912447,275.79825000000005,281.6590000000001,281.20259999999985,272.4445000000002,271.19006666666667,135101437,120277452.1,46.2067101327177,0.9384874317850292,1.5,2.75,NaN,NaN,4.8132345597349415,1.1232482451297288,998.4761191919082,0.47951636806299014,-1.7415725228462975,-2.2210888909092876,20.64351299966597,0.4156092537423206,6.90802094354435,70.97230588199488,22.119673174460758,8649955476
1542378600,271.79,274.75,271.21,273.73,NaN,NaN,258.4269411764706,279.03942857142863,275.7896500000001,281.70280000000014,280.92519999999985,272.31850000000014,277.9908541002732,274.45734603223286,274.26076923076903,280.90794543418906,267.613593027349,275.7896500000001,281.70280000000014,280.92519999999985,272.31850000000014,273.23,126668040,119615772.4,47.31645923788296,0.18965248955210048,1.5,2.75,NaN,NaN,4.72228923403959,1.058957673043459,999.8984371963458,0.48969138311803295,-1.6089746620117467,-2.0986660451297796,20.351718675431755,0.12436446102638424,26.033862123115334,41.23507438106373,32.73106349582093,8776623516
1542637800,273.05,273.38,268.07,269.1,NaN,NaN,258.3252941176471,278.67600000000004,275.8155000000001,281.68490000000014,280.54519999999985,272.02300000000014,277.6421931551645,273.9471226005916,274.1430769230767,281.09061831272993,267.1955355334235,275.8155000000001,281.68490000000014,280.54519999999985,272.02300000000014,270.18333333333334,103061706,120648067.1,41.328803096526535,1.432904379779539,1.5,2.75,NaN,NaN,4.789268574465335,0.85423420761956,995.8589264513639,0.19405580820961532,-1.8560962848677605,-2.050152093077376,22.402997209752417,-2.188136086071526,27.065702121285955,40.029481172887024,32.90481670582702,8673561810
1542724200,265.36,267,263.15,264.12,NaN,NaN,258.22364705882353,278.31257142857146,275.79045000000013,281.61330000000015,280.0465999999999,271.54850000000016,277.1119110706482,273.01120616244003,273.42076923076905,282.19399585074996,264.64754261078815,275.79045000000013,281.61330000000015,280.0465999999999,271.54850000000016,264.75666666666666,136021311,120131496.7,36.04525409088847,2.771679340056016,1.5,2.75,NaN,NaN,4.872177962003528,1.132270176735424,990.2320677840844,-0.30053668937743794,-2.425822954799173,-2.1252862654217353,23.729470621302596,-6.010462261129493,24.11737632101854,43.50231085195915,32.3803128270223,8537540499
1542810600,265.86,267.15,265.01,265.02,NaN,NaN,258.122,277.9491428571429,275.7772000000001,281.5449000000001,279.56459999999987,271.5335000000002,276.6377184796424,272.2501389088743,272.8923076923075,282.7333525206609,263.0512628639541,275.7772000000001,281.5449000000001,279.56459999999987,271.5335000000002,265.72666666666663,75563743,115019349,37.59789143150385,1.9275586411740775,1.5,2.75,NaN,NaN,4.740593821860417,0.656965490215042,994.63509704434,-0.517971328509236,-2.7727504260582805,-2.2547790975490445,18.412662389130688,-5.518716577540113,46.426230733734805,21.783026749451306,31.790742516813904,8613104242
1542983400,263.18,264.8234,263.07,263.25,NaN,NaN,258.0203529411765,277.58571428571435,275.80530000000016,281.4684000000001,279.01299999999986,271.1920000000002,276.1127099118133,271.3929828223148,272.1123076923075,283.20030856323547,261.0243068213796,275.80530000000016,281.4684000000001,279.01299999999986,271.1920000000002,263.7144666666666,42807878,110256665.65,35.759233698537045,2.5704027805026177,1.5,2.75,NaN,NaN,4.541265691727529,0.38825659879729907,993.2233931797075,-0.7195031092849056,-3.1541579841551766,-2.434654874870271,18.23324588780573,-5.223934331797232,23.970865669325,43.68106774375303,32.34806658692199,8570296364
1543242600,265.78,267.75,265.34,267.5,NaN,NaN,257.918705882353,277.22228571428576,275.83530000000013,281.41230000000013,278.5453999999999,271.30050000000017,275.7749565819382,271.0222225535229,271.5261538461537,282.721316368661,260.3309913236464,275.83530000000013,281.41230000000013,278.5453999999999,271.30050000000017,266.8633333333333,79981362,104177003.95,42.97088002934128,0.9594479455036491,1.5,2.75,NaN,NaN,4.53831814231842,0.7677448857944431,996.3221686860252,-0.5146804282599002,-3.0780054101951464,-2.563324981935246,22.050624187091323,-1.8600726418901543,15.829219560545596,54.76269689674706,29.408083542707335,8650277726
1543329000,266.34,268.4,265.66,268.4,NaN,NaN,257.81705882352946,276.8588571428572,275.85060000000016,281.34210000000013,278.1265999999999,271.5275000000002,275.4857425983328,270.77248707223504,270.5561538461537,280.39994466836185,260.7123630239455,275.85060000000016,281.34210000000013,278.1265999999999,271.5275000000002,267.4866666666666,75502441,99914670.95,44.39445413127749,0.6691756897310502,1.5,2.75,NaN,NaN,4.409866846438529,0.7556692153626113,993.4960685276332,-0.2785158993491619,-2.9114698561216983,-2.6329539567725364,20.087834855812147,-1.345291479820637,41.58673233759558,25.736149800466876,32.67711786193755,8725780167
1543415400,269.6,274.58,268.3272,274.58,NaN,NaN,257.7154117647059,276.4954285714286,275.8935000000002,281.30890000000016,277.7999999999999,271.8680000000002,275.4502232807511,271.1351073510698,270.10076923076906,278.50481756489575,261.6967208966424,275.8935000000002,281.30890000000016,277.7999999999999,271.8680000000002,272.49573333333336,127629633,98440352.85,53.059346780906296,1.2249802093569313,1.5,2.75,NaN,NaN,4.541504928835776,1.2965174271010347,998.6181085623896,0.30250501680487574,-2.2548226857664417,-2.5573277025713175,24.432778312521926,1.6210214655810495,88.18363154702985,1.265352349359493,10.551016103610683,8853409800
1543501800,273.71,275.55,272.43,273.98,NaN,NaN,257.6137647058824,276.13200000000006,275.9154500000002,281.2597000000001,277.4551999999999,272.0355000000002,275.3925674658197,271.40604950811075,269.80999999999983,277.3512016997832,262.2687983002165,275.9154500000002,281.2597000000001,277.4551999999999,272.0355000000002,273.9866666666667,82346420,96142857.6,52.208726686181926,1.4592582003573038,1.5,2.75,NaN,NaN,4.439968862490364,0.8565006497164903,997.1824987234165,0.6358439281806825,-1.7625227923454645,-2.398366720526147,24.033052517015832,0.3516225917515334,60.29110171992769,12.399167121595813,27.309731158476488,8771063380
1543588200,273.81,276.28,273.45,275.65,NaN,NaN,257.51211764705886,275.7685714285715,275.9285500000002,281.24760000000015,277.0965999999999,272.14250000000015,275.40266285931693,271.81023526924304,270.0469230769229,278.0964787631408,261.997367390705,275.9285500000002,281.24760000000015,277.0965999999999,272.14250000000015,275.12666666666667,98204190,96078315.25,54.39996117878256,1.4986752221755,1.5,2.75,NaN,NaN,4.324971086598194,1.0221264782221502,999.1365155652533,0.9398832607443115,-1.2235126445957576,-2.163395905340069,23.567133273400337,0.7014211083914657,78.5391459548777,3.9246185200939383,17.536235525028353,8869267570
1543847400,280.28,280.4,277.505,279.3,NaN,NaN,257.41047058823534,280.4,275.9595000000002,281.24690000000015,276.8427999999999,272.51300000000015,275.5554996099319,272.5235461959818,270.603846153846,280.01937682138816,261.18831548630385,275.9595000000002,281.24690000000015,276.8427999999999,272.51300000000015,279.0683333333333,103017719,95097495.85,58.84175299680652,2.3649599376153234,1.5,2.75,NaN,NaN,4.355330294698323,1.083285296623297,1003.8404484014005,1.333836731010355,-0.49609999157712537,-1.8299367225874803,24.589656805009138,3.7904124860646555,81.66232825209461,2.942347856916941,15.395323890988452,8972285289
1543933800,278.37,278.85,269.9,270.25,NaN,NaN,257.30882352941177,280.34875,275.95375000000024,281.1535000000001,276.42739999999986,272.3560000000001,275.3474408016993,272.30701798684066,270.60769230769216,280.0226007923787,261.19278382300564,275.95375000000024,281.1535000000001,276.42739999999986,272.3560000000001,273,177986013,100715672.4,46.696252542921556,0.5235509457657317,1.5,2.75,NaN,NaN,4.7156638450770165,1.7672126766240999,997.4145891851815,0.9499705347717202,-0.6424735541228301,-1.5924440888945504,30.14292004892041,2.3209147357261832,44.429949124482576,23.486694260998632,32.083356614518785,8794299276
1544106600,265.92,269.97,262.44,269.84,NaN,NaN,257.20717647058825,280.29749999999996,275.95270000000016,281.05850000000015,276.00919999999985,272.09200000000016,275.1314627310444,272.07206389285585,270.3630769230768,279.67929730099803,261.04685654515555,275.95270000000016,281.05850000000015,276.00919999999985,272.09200000000016,267.4166666666667,204185411,107920648.25,46.23068775366802,1.630832946553264,1.5,2.75,NaN,NaN,4.936687856142944,1.8919957794082283,993.9621473190946,0.6479243811311544,-0.7825386124806073,-1.4304629936117617,27.676484667489156,1.81873066183684,13.285467098108011,58.9256261954747,27.788906706417286,8590113865
1544193000,269.46,271.22,262.63,263.57,NaN,NaN,257.10552941176473,280.24625,275.91855000000015,280.8895000000001,275.4829999999999,271.22000000000014,274.6780720357093,271.2623435221077,269.58153846153834,279.3313813672585,259.8316955558182,275.91855000000015,280.8895000000001,275.4829999999999,271.22000000000014,265.8066666666667,161018923,110833989.45,39.71034886989203,2.4874322624564233,1.5,2.75,NaN,NaN,5.197638723561307,1.4527937124616424,990.5542687467806,0.037546942857141774,-1.3835293150403345,-1.4210762578974763,31.291650332304254,0.12155745489078564,10.671634721164928,63.47842765061824,25.849937628216825,8429094942
1544452200,263.37,265.1613,258.62,264.07,NaN,NaN,257.0038823529412,280.19499999999994,275.8653500000002,280.7196000000001,274.9505999999999,270.3985000000001,274.26206921077954,270.5773584247641,269.1946153846153,279.37970438126075,259.00952638796986,275.8653500000002,280.7196000000001,274.9505999999999,270.3985000000001,262.6171,151445885,115127039.4,40.431856660059076,2.6824607144770307,1.5,2.75,NaN,NaN,5.293614529021212,1.3154675547054846,986.8591576315574,-0.30212957037243116,-1.7987382208630152,-1.496608650490584,31.061770200887654,-1.282242990654208,12.434120708166096,60.25547670616846,27.310402585665443,8580540827
1544538600,267.66,267.87,262.48,264.13,NaN,NaN,256.9022352941177,280.14374999999995,275.79650000000015,280.5609000000001,274.41879999999986,269.7170000000001,273.864733163298,269.96332428907226,269.19538461538457,279.3789418460168,259.01182738475234,275.79650000000015,280.5609000000001,274.41879999999986,269.7170000000001,264.82666666666665,121504431,116261632.9,40.523839562127165,1.6094172509186349,1.5,2.75,NaN,NaN,5.300499205519697,1.0450948259475203,985.2685223867801,-0.48172074169466605,-2.0987595776089165,-1.6170388359142505,29.423094022659285,-1.5909090909090842,13.324255395522883,58.75815863187298,27.917585972604133,8702045258
1544625000,267.47,269,265.37,265.46,NaN,NaN,256.80058823529413,280.0925,275.75165000000015,280.4187000000001,273.8933999999999,269.3615000000001,273.53513578434513,269.53443626154154,269.2292307692307,279.35984077906295,259.09862075939844,275.75165000000015,280.4187000000001,273.8933999999999,269.3615000000001,266.60999999999996,97976706,116176789.5,42.63830266494353,0.6791004626078624,1.5,2.75,NaN,NaN,5.269749262268291,0.8433414834552645,989.0715062898704,-0.46941268405583414,-2.203804690984043,-1.734392006928209,29.533841607614765,-3.3214363755553955,32.2652747434305,34.463454590444805,33.271270666124686,8800021964
1544711400,266.52,267.49,264.12,265.37,NaN,NaN,256.6989411764706,280.04124999999993,275.72025000000014,280.2704000000001,273.3695999999999,269.0270000000001,273.2149343810375,269.13782328425185,269.3923076923076,279.1956325720567,259.5889828125585,275.72025000000014,280.2704000000001,273.3695999999999,269.0270000000001,265.66,96662717,116101094.85,42.52812110047548,1.093270466711339,1.5,2.75,NaN,NaN,5.134052886391984,0.8325736904108102,985.9975124378519,-0.42702231229136034,-2.2681698972924096,-1.8411475850010492,25.398509575460942,-3.1425651507409347,44.634420592693594,23.234561231895963,32.131018175410446,8703359247
1544797800,262.96,264.03,259.85,260.47,NaN,NaN,256.5972941176471,279.98999999999995,275.68410000000017,280.0590000000001,272.7445999999999,268.5405000000001,272.7151330327615,268.3123163047993,268.8515384615384,279.72941960744834,257.97365731562843,275.68410000000017,280.0590000000001,272.7445999999999,268.5405000000001,261.45,116961071,115682351.85,36.93241397926088,2.3662178101290054,1.5,2.75,NaN,NaN,5.1616205373639845,1.0110537098317127,981.2756722618308,-0.673988794894345,-2.6836335786189807,-2.0096447837246356,26.81929692859199,-5.506983493560657,51.36560835587243,18.160709891480167,30.473681752647398,8586398176
1545057000,259.4,260.65,253.525,255.36,NaN,NaN,256.4956470588236,279.93874999999997,275.61550000000017,279.7725000000001,272.0629999999999,267.6575000000001,272.03453958049636,267.0787623710089,267.84846153846144,280.89635637874,254.8005666981829,275.61550000000017,279.7725000000001,272.0629999999999,267.6575000000001,256.51166666666666,165492257,117201892.85,32.17751986546091,3.7906478613202697,1.5,2.75,NaN,NaN,5.301861927552269,1.412027169320585,976.6443679539886,-1.1012377095344643,-3.386191920642716,-2.2849542111082517,27.000856882642186,-8.571428571428571,17.22599469409131,52.693611374734026,30.080393931174658,8420905919
1545143400,257.2,257.95,253.28,255.08,NaN,NaN,256.394,279.88749999999993,275.52995000000016,279.48990000000015,271.4081999999999,266.7250000000001,271.36965567537885,265.9360230975795,266.34846153846144,280.40083138217597,252.2960916947469,275.52995000000016,279.48990000000015,271.4081999999999,266.7250000000001,255.43666666666672,134515094,117594245.55,31.934903230852612,3.330351106128573,1.5,2.75,NaN,NaN,5.256728932727106,1.1438918067024413,974.8072506469013,-1.3083378060867217,-3.920376468716654,-2.6120386626299323,24.070061105624358,-5.613320999074926,2.938349228329678,81.601518388391,15.46013238327933,8286390825
1545229800,255.17,259.4,249.35,251.26,NaN,NaN,256.2923529411765,279.83624999999995,275.4218500000002,279.18830000000014,270.6769999999999,265.8330000000001,270.58104172732476,264.5383066120957,264.6007692307692,280.0079433070701,249.19359515446826,275.4218500000002,279.18830000000014,270.6769999999999,265.8330000000001,253.33666666666667,214992763,123190798.4,28.75000244475956,3.568230896940894,1.5,2.75,NaN,NaN,5.5991054375323115,1.7452014743984319,970.8479987383109,-1.589528922579833,-4.5989498158547235,-3.0094208932748905,19.31377380636805,-6.8855618144085335,0,100,0,8071398062
1545316200,249.86,251.62,244.65,247.17,NaN,NaN,256.190705882353,279.78499999999997,275.2938000000002,278.8605000000001,269.8723999999999,264.9855000000001,269.66296165958653,262.8841821728485,262.4099999999999,278.96611808829385,245.85388191170597,275.2938000000002,278.8605000000001,269.8723999999999,264.9855000000001,247.8133333333333,252053377,128992401.7,25.78489583283732,4.987672590698409,1.5,2.75,NaN,NaN,5.697026477708575,1.9540172419318556,965.3616520485729,-1.9160262633049814,-5.404453722406117,-3.488427459101136,19.575031912144098,-6.222255947186707,0,100,0,7819344685
1545402600,246.74,249.71,239.98,240.7,NaN,NaN,256.08905882352946,279.73374999999993,275.1268000000002,278.45420000000007,269.12039999999996,263.76950000000005,268.52715924156354,260.7714029182915,259.44076923076915,276.6479331441102,242.2336053174281,275.1268000000002,278.45420000000007,269.12039999999996,263.76950000000005,243.46333333333334,255345633,137981496.2,21.931554365882548,6.262355259475111,1.5,2.75,NaN,NaN,5.985096015015107,1.8505788097114433,959.8711644067095,-2.4013241659990143,-6.490082666599903,-4.088758500600889,20.45962917796311,-8.849926155943502,0,100,0,7563999052
1545661800,239.04,240.8355,234.27,234.34,NaN,NaN,255.9874117647059,279.68249999999995,274.90415000000013,277.9890000000001,268.3637999999999,262.32400000000007,267.1864863301297,258.2541264498828,256.6784615384614,277.25698484071916,236.09993823620368,274.90415000000013,277.9890000000001,268.3637999999999,262.32400000000007,236.48183333333338,147311588,143206681.7,18.93587688678987,8.773644830165697,1.5,2.75,NaN,NaN,6.026553442514027,1.0286642093181049,956.3476172429291,-2.9482220199488323,-7.77403602553693,-4.825814005588097,21.424690530345583,-11.278537084011658,0,100,0,7416687464
1545834600,235.97,246.18,233.76,246.18,NaN,NaN,233.76,279.6312499999999,274.7424500000002,277.6269000000001,267.76839999999993,261.2580000000001,266.3627025524776,257.1042096451321,254.85846153846143,274.6281054730789,235.08881760384398,274.7424500000002,277.6269000000001,267.76839999999993,261.2580000000001,242.04000000000002,218485360,150131881.6,36.3626506700542,4.3663512372413065,1.5,2.75,NaN,NaN,6.483228196620169,1.455289560561932,962.8269020858321,-2.3368591649175547,-7.746887961735041,-5.410028796817486,41.05717701127388,-7.262864461689134,4.1782172434218,77.99538175749865,17.826400999079553,7635172824
1545921000,242.57,248.29,238.96,248.07,NaN,NaN,233.09102564102562,279.5799999999999,274.59920000000017,277.2716000000001,267.24179999999996,260.2415000000001,265.6453416680667,256.2438087265481,253.66615384615372,273.0563790417489,234.27592865055854,274.59920000000017,277.2716000000001,267.24179999999996,260.2415000000001,245.10666666666665,186267342,155670126.65,38.63060815568642,3.4025318550509014,1.5,2.75,NaN,NaN,6.6865690397187265,1.1965516185311076,962.0015782583015,-1.6612291680765674,-7.486565256913195,-5.825336088836628,41.365068097167516,-6.519199608094363,17.503292039763206,52.5483438270497,29.948364133187102,7821440166
1546007400,249.58,251.4,246.45,247.75,NaN,NaN,232.42205128205129,279.52874999999995,274.4614500000001,276.9027000000001,266.58879999999994,258.9000000000001,264.9435635634366,255.43487456211494,252.4107692307691,271.0425096615274,233.7790288000108,274.4614500000001,276.9027000000001,266.58879999999994,258.9000000000001,248.53333333333333,153100189,156943654.45,38.38119795563569,1.1939592808495296,1.5,2.75,NaN,NaN,6.562528394024533,0.9755105393494934,963.8744616790441,-1.1179861724016238,-7.222818804338658,-6.104832631937034,41.31458436812351,-4.883479863324001,21.755688779021014,46.75114834825581,31.49316287272319,7668339977
1546266600,249.56,250.19,247.47,249.92,NaN,NaN,231.75307692307692,279.4774999999999,274.3360500000001,276.5461000000001,265.9781999999999,257.6970000000001,264.35440420800774,254.9096484133421,251.31769230769217,268.6962080517731,233.93917656361123,274.3360500000001,276.5461000000001,265.9781999999999,257.6970000000001,249.1933333333333,144299370,160041301.95,41.155678379576095,0.8727689975230324,1.5,2.75,NaN,NaN,6.288062080165638,0.9016383161209344,968.7609277866118,-0.5247443802566707,-6.760763107257873,-6.236018727001202,41.44591787474436,-2.130325814536351,57.2177773750873,14.323118498899484,28.45910412601322,7812639347
1546439400,245.98,251.21,245.95,250.18,NaN,NaN,231.08410256410255,279.4262499999999,274.21595000000013,276.1933000000001,265.45379999999994,256.42350000000016,263.7985452194584,254.4592057073095,250.14230769230755,265.48326574852933,234.80134963608577,274.21595000000013,276.1933000000001,265.45379999999994,256.42350000000016,249.11333333333332,126925199,161477352.4,41.495581676719404,0.798738336362206,1.5,2.75,NaN,NaN,6.2146290744395225,0.7860247713598256,973.6548015079086,-0.05195876545606648,-6.300967183821285,-6.249008418365219,40.27331649027183,-1.9209659714599363,79.60371471745871,3.590242097915745,16.806043184625523,7939564546
1546525800,248.23,248.57,243.67,244.21,NaN,NaN,230.41512820512818,279.3749999999999,274.08455000000015,275.7847000000001,264.81299999999993,254.66900000000015,263.0303669755581,253.48309087804193,248.51461538461524,261.3297377385618,235.69949303066866,274.08455000000015,275.7847000000001,264.81299999999993,254.66900000000015,245.48333333333338,144140692,163533501.05,36.30931818930441,2.1028890270199474,1.5,2.75,NaN,NaN,6.235726997693844,0.8814138453253643,970.8292270587493,-0.07692257320737994,-6.345161634874444,-6.268239061667064,42.19623825774094,-2.8058584732945886,50.963566744357614,18.506379085721946,30.530054169920426,7795423854
1546612200,247.59,253.11,247.17,252.39,NaN,NaN,229.74615384615385,279.3237499999999,273.9917500000002,275.4770000000001,264.3605999999999,253.77600000000015,262.6130976823989,253.37898698489508,247.89307692307676,258.99822856091345,236.78792528524008,273.9917500000002,275.4770000000001,264.3605999999999,253.77600000000015,250.88999999999996,142628834,161765642.1,46.226430706811286,0.6558399875032696,1.5,2.75,NaN,NaN,6.426032212144284,0.881700416407521,972.6358701864485,0.4906378331716983,-5.654941770202441,-6.14557960337414,46.498566546325435,2.1119067848039808,47.70924731308767,20.89960220505201,31.39115048186032,7938052688
1546871400,252.69,255.95,251.69,254.38,NaN,NaN,229.07717948717948,279.2724999999999,273.91150000000016,275.1998000000001,263.9759999999999,253.00300000000016,262.2902311066186,253.4743215577622,247.81769230769214,258.73071389828146,236.90467071710282,273.91150000000016,275.1998000000001,263.9759999999999,253.00300000000016,254.00666666666666,103139100,156713326.55,48.33407822204881,1.459068483693453,1.5,2.75,NaN,NaN,6.271315625562549,0.6581386680416937,975.7810594603814,1.003678881615686,-4.8909810013545325,-5.894659882970219,45.352801671740245,5.683423348566683,74.90220338860429,5.260687031641562,19.837109579754145,8041191788
1546957800,256.82,257.31,254,256.77,NaN,NaN,228.4082051282051,279.2212499999999,273.8770000000002,274.9285000000001,263.8049999999999,252.66300000000018,262.07375145537867,253.7881956951182,247.94769230769214,259.2374239358847,236.65796067949955,273.8770000000002,274.9285000000001,263.8049999999999,252.66300000000018,256.02666666666664,102512587,153788009.75,50.82687258967292,1.7694122480447014,1.5,2.75,NaN,NaN,6.059793080879509,0.6665837419096973,980.6998021707441,1.4788932715343677,-4.046043293552259,-5.524936565086627,41.34860838152007,9.571562686694536,73.08066506046461,5.997562053440451,20.921772886094942,8143704375
1547044200,257.56,258.91,256.19,257.97,NaN,NaN,227.73923076923074,279.1699999999999,273.87660000000017,274.6904000000001,263.56279999999987,252.35800000000023,261.912820025756,254.1864627717736,248.463846153846,260.8704263891893,236.0572659185027,273.87660000000017,274.6904000000001,263.56279999999987,252.35800000000023,257.69,95006554,150966043.2,52.07711227678177,2.086739174599025,1.5,2.75,NaN,NaN,5.82123643224526,0.629323998868641,984.2282579236196,1.8261734042812403,-3.242219809735076,-5.068393214016316,35.65798306647441,4.78917864976847,71.55373664557965,6.648957836938426,21.79730551748191,8238710929
1547130600,256.26,259.16,255.5,258.88,NaN,NaN,227.0702564102564,279.1187499999999,273.84545000000014,274.4386000000001,263.43379999999985,252.09550000000021,261.7938859070989,254.63346631731898,249.36461538461523,262.91253288653934,235.81669788269113,273.84545000000014,274.4386000000001,263.43379999999985,252.09550000000021,257.8466666666667,96823923,149732017.8,53.051940130884326,1.86622764713532,1.5,2.75,NaN,NaN,5.6668624013706,0.6466480878480487,986.7311973720188,2.052392483627072,-2.502902609482476,-4.555295093109548,25.174859230822374,4.357640988430686,100,0,0,8335534852
1547217000,257.68,259.0098,257.03,258.98,NaN,NaN,226.40128205128204,279.0674999999999,273.83735000000013,274.1778000000001,263.33619999999985,251.77150000000023,261.6835374401539,255.04742190614573,250.77076923076908,264.2238248437268,237.3177136178114,273.83735000000013,274.1778000000001,263.33619999999985,251.77150000000023,258.33993333333336,73858110,148526088,53.16468626900568,1.626280644747417,1.5,2.75,NaN,NaN,5.403500801272701,0.49727365067340895,988.8242698459079,2.134503936776058,-1.8871651721394755,-4.021669108915534,25.243200016964654,4.532795156407676,100,0,0,8409392962
1547476200,256.86,258.3,256.41,257.4,NaN,NaN,225.73230769230767,279.0162499999999,273.82520000000017,273.8951000000001,263.12879999999984,251.37300000000022,261.5155555797557,255.27147696270328,252.54461538461524,262.4870949248593,242.6021358443712,273.82520000000017,273.8951000000001,263.12879999999984,251.37300000000022,257.37,70908227,147238363.5,51.077526692009,1.179967370704707,1.5,2.75,NaN,NaN,5.20110788689608,0.48158798640817546,985.6162070867546,2.009908462145394,-1.509283531233791,-3.5191919933791853,25.779842239658734,2.9929577464788695,81.06304696849169,3.097756453500353,15.83919657800794,8338484735
1547562600,257.82,260.7,257.81,260.35,NaN,NaN,225.0633333333333,278.9649999999999,273.81120000000016,273.6352000000001,262.92319999999984,251.36700000000025,261.4698475178045,255.7551458233982,253.63461538461524,263.65370981746184,243.61552095176862,273.81120000000016,273.6352000000001,262.92319999999984,251.36700000000025,259.62,85208271,145650723.5,54.65679477923806,1.688232425038626,1.5,2.75,NaN,NaN,5.065314466403504,0.5850178354932786,988.6750176135902,2.0467976195715814,-0.9606949689147086,-3.00749258848629,26.00995895040992,4.065073147333925,80.25274050286248,3.352419674568769,16.39483982256874,8423693006
1547649000,260.83,261.9666,260.6,260.98,NaN,NaN,224.39435897435897,278.9137499999999,273.8287500000001,273.38330000000013,262.6725999999998,251.64800000000028,261.45063781122394,256.2527509830746,254.62769230769214,264.80173818273107,244.45364643265322,273.8287500000001,273.38330000000013,262.6725999999998,251.64800000000028,261.1822,77636710,141257946.15,55.407128524989275,1.9469684137653254,1.5,2.75,NaN,NaN,4.8189777188032545,0.5496095059853028,991.2411247158713,2.030246379448502,-0.4696846141756623,-2.4999309936241643,25.962973862117003,6.867040661725568,79.34782182679487,3.647561245209894,17.004616927995244,8501329716
1547735400,260.01,263.92,259.96,262.96,NaN,NaN,223.7253846153846,278.8624999999999,273.83970000000016,273.1550000000001,262.49399999999986,252.0420000000003,261.5098284852936,256.89153660373415,255.79769230769216,266.03698962085593,245.55839499452838,273.83970000000016,273.1550000000001,262.49399999999986,252.0420000000003,262.28,96118435,139338113.2,57.772229769897635,1.962368286656091,1.5,2.75,NaN,NaN,4.757622167460168,0.6898215627624847,994.9060692150169,2.0625938807894295,0.0783113573626224,-1.9842825234268069,18.640751509599532,4.187963073021908,79.39434931517543,3.632111179686701,16.97353950513787,8597448151
1547821800,264.98,266.98,262.998,266.46,NaN,NaN,223.05641025641023,278.81124999999986,273.85420000000016,272.9445000000001,262.3553999999998,252.80200000000028,261.70395285841937,257.80281883194993,257.0699999999998,268.14782261304526,245.99217738695438,273.85420000000016,272.9445000000001,262.3553999999998,252.80200000000028,265.4793333333334,127900303,134983490.2,61.64477395669121,2.820051374332791,1.5,2.75,NaN,NaN,4.704934869784444,0.9475255293109913,999.3282356021575,2.216196236810658,0.7859627725865153,-1.4302334642241425,10.363119615226967,4.748801006368419,82.2583202155024,2.7388600538836188,15.00281973061399,8725348454
1548167400,264.82,265.06,261.06,262.86,NaN,NaN,222.38743589743586,278.7599999999999,273.8403000000002,272.6753000000001,262.11019999999985,253.58650000000026,261.74928804044214,258.284455133669,258.0453846153845,268.7515025367695,247.33926669399943,273.8403000000002,272.6753000000001,262.11019999999985,253.58650000000026,262.99333333333334,115531183,128157380.5,55.96021534246708,1.4364686287136448,1.5,2.75,NaN,NaN,4.754582379085554,0.9014789671048247,994.7587717386392,1.9795901247105445,1.044254191664038,-0.9353359330465064,14.852043371887852,2.371772403318157,73.13679122141043,5.988965130771318,20.874243647818233,8609817271
1548253800,264.01,264.79,260.66,263.41,NaN,NaN,221.71846153846153,278.7087499999999,273.85875000000016,272.41020000000015,261.7581999999998,254.72200000000026,261.81441399964046,258.77260226379576,259.52230769230755,266.9957978823865,252.0488175022286,273.85875000000016,272.41020000000015,261.7581999999998,254.72200000000026,262.9533333333334,86030287,119691613.2,56.61840472893819,1.1909051049126878,1.5,2.75,NaN,NaN,4.709969352008015,0.7187662084247018,995.0968334405306,1.7711436062748165,1.2785935747970143,-0.49255003147780224,14.34280818817999,2.1087723378687433,73.24898557836438,5.942304372299356,20.808710049336266,8695847558
1548340200,263.21,264.2,262.08,263.55,NaN,NaN,221.04948717948716,278.65749999999986,273.8715000000002,272.13090000000017,261.4191999999998,256.18250000000023,261.882476195733,259.22759252438664,260.3807692307691,266.8803429992119,253.88119546232625,273.8715000000002,272.13090000000017,261.4191999999998,256.18250000000023,263.27666666666664,59204139,115286240.75,56.79540975904913,1.1105751409474613,1.5,2.75,NaN,NaN,4.5249715411502995,0.5135403723362365,998.6710466406629,1.561072049834386,1.4587900308151802,-0.10228201901920575,14.316457592593883,1.8039245982694747,72.11416913451167,6.421905265171713,21.46392560031661,8755051697
1548426600,265.61,266.7,263.6595,265.78,NaN,NaN,220.3805128205128,278.6062499999999,273.8746500000002,271.88570000000016,261.1795999999998,257.16250000000025,262.03532026648855,259.8516313315879,261.2576923076922,267.34525922771525,255.17012538766912,273.8746500000002,271.88570000000016,261.1795999999998,257.16250000000025,265.37983333333335,96883358,109206140.65,59.62153501174463,1.7892883219033868,1.5,2.75,NaN,NaN,4.426759288210991,0.8871603503552618,1002.9332839248443,1.4908151675751635,1.7612369404497485,0.27042177287458513,14.758326905417983,2.6256853811104928,72.23389804160465,6.370505863697196,21.39559609469818,8851935055
1548685800,263.39,263.83,261.79,263.76,NaN,NaN,219.71153846153842,278.55499999999984,273.8746500000002,271.6202000000001,261.00339999999983,257.94700000000023,262.10295476584196,260.2238569190557,261.79538461538453,267.41961032145423,256.17115890931484,273.8746500000002,271.6202000000001,261.00339999999983,257.94700000000023,263.12666666666667,85613655,104173456.3,56.045254698073215,0.6994614661065682,1.5,2.75,NaN,NaN,4.395562196195916,0.821837520235949,1000.9944605330476,1.237251455741511,1.816986092551474,0.579734636809963,15.87593909542279,2.4708624708624765,42.39870062833286,25.177595288758706,32.42370408290843,8766321400
1548772200,263.92,264.55,262.48,263.41,NaN,NaN,219.04256410256409,278.50374999999985,273.8620500000002,271.3562000000001,260.8303999999998,258.73000000000025,262.1542114416913,260.5272991172409,262.2138461538461,267.4321779737129,256.99551433397926,273.8620500000002,271.3562000000001,260.8303999999998,258.73000000000025,263.48,66136334,99825263.55,55.424907628319836,0.6474900775320207,1.5,2.75,NaN,NaN,4.229450610753351,0.6625210056858397,1002.8432527839199,0.9858423553801545,1.812037581035156,0.8261952256550016,15.224481331072468,1.1753408872671411,52.17404244658346,17.683053040812553,30.142904512603977,8700185066
1548858600,265.1,268.52,264.25,267.58,NaN,NaN,218.37358974358972,278.4524999999999,273.8742000000002,271.1417000000001,260.7779999999998,259.6130000000002,262.36698746358576,261.1989849155989,262.8830769230768,268.4400400373382,257.3261138088155,273.8742000000002,271.1417000000001,260.7779999999998,259.6130000000002,266.7833333333333,92473671,97233978.6,60.96819303059827,1.734287624233147,1.5,2.75,NaN,NaN,4.292346995699537,0.9510427561584938,1008.0439853330536,1.0351719105351527,2.1201601138239425,1.0849882032887899,16.324552850346937,2.5289294198789047,53.26424324022678,16.932721644982973,29.803035114790244,8792658737
1548945000,267.51,270.47,267.27,269.93,NaN,NaN,217.70461538461535,278.40124999999983,273.8872000000002,270.95940000000013,260.7161999999998,260.60050000000024,262.663576190504,262.0305101617323,263.7253846153845,269.9410304590962,257.50973877167274,273.8872000000002,270.95940000000013,260.7161999999998,260.60050000000024,269.22333333333336,104012073,96088322.3,63.70731034491852,2.1788681934386855,1.5,2.75,NaN,NaN,4.214322210292431,1.082463201670449,1012.7008377582227,1.1519051775714142,2.5248696752530577,1.3729644976816435,16.67793184509398,2.6505932461210935,58.97312329641508,13.26777703280146,27.75909967078346,8896670810
1549031400,270.15,271.2,269.18,270.06,NaN,NaN,217.03564102564098,278.34999999999985,273.88655000000017,270.78400000000016,260.6427999999998,261.89300000000026,262.9536320261705,262.7952234796626,264.69923076923067,270.6048810573445,258.7935804811168,273.88655000000017,270.78400000000016,260.6427999999998,261.89300000000026,270.1466666666667,85782524,93170413.9,63.85840859025488,2.066430164988422,1.5,2.75,NaN,NaN,4.057584909557256,0.9207056232686758,1014.7455507121186,1.160465796056013,2.8235467427516596,1.6630809466956467,16.522055671245564,1.35104706147265,57.89561077482197,13.92602963794582,28.178359587232208,8982453334
1549290600,270.11,272.03,269.36,271.96,NaN,NaN,216.36666666666665,278.29874999999987,273.8944000000002,270.62260000000015,260.69999999999976,262.87150000000025,263.306822927105,263.66805933874235,265.5923076923076,272.0797780009799,259.1048373836353,273.8944000000002,270.62260000000015,260.69999999999976,262.87150000000025,271.1166666666666,60744844,89076214.4,66.08108936820051,2.128558807077794,1.5,2.75,NaN,NaN,3.9584717017317343,0.6819423614841,1017.9734532569161,1.2110894609840532,3.176942772925713,1.96585331194166,15.420089008092445,3.4619188921859414,81.16824382969679,3.070210992157026,15.76154517814617,9043198178
1549377000,272.44,273.44,271.88,273.1,NaN,NaN,215.69769230769228,278.24749999999983,273.9154500000002,270.46310000000017,260.87959999999975,263.80750000000023,263.69086908682635,264.5663394017193,266.52461538461523,273.5537005220881,259.49553024714237,273.9154500000002,270.46310000000017,260.87959999999975,263.80750000000023,272.8066666666667,79552774,87896898.1,67.3774437623976,2.3198351299457243,1.5,2.75,NaN,NaN,3.7871522944651823,0.9050691858260241,1020.666469493146,1.2341619099978725,3.5085556994390004,2.274393789441128,11.77104918675135,3.678675828556242,100,0,0,9122750952
1549463400,272.79,273.34,271.92,272.74,NaN,NaN,215.0287179487179,278.19624999999985,273.9461000000002,270.2993000000002,261.03399999999976,264.6060000000002,264.0457369657743,265.3447832682222,267.27692307692297,274.7012713140078,259.85257483983816,273.9461000000002,270.2993000000002,261.03399999999976,264.6060000000002,272.6666666666667,58347791,85688658.3,66.51293324314366,1.8810249305698812,1.5,2.75,NaN,NaN,3.6180699877176665,0.6809278165579586,1018.210108797896,1.1402168943650106,3.6996649073973913,2.5594480130323807,12.111355631111378,3.4870043634983863,82.1628682489183,2.7712248118161544,15.065906939265563,9064403161
1549549800,270.94,271.55,268.29,270.14,NaN,NaN,214.35974358974357,278.14499999999987,273.9639500000001,270.09240000000017,261.17179999999973,265.2145000000002,264.2847276729989,265.80147057601056,267.5599999999999,275.1175983161059,260.0024016838939,273.9639500000001,270.09240000000017,261.17179999999973,265.2145000000002,269.99333333333334,95481961,85712428.65,60.477542179914664,0.765986060933227,1.5,2.75,NaN,NaN,3.6774935600235468,1.1139803468863672,1014.6884190258442,0.8323019999568939,3.599825512978498,2.767523513021604,14.213675187624974,1.6404545112499112,45.61638628702988,22.439595015969534,31.944018697000576,8968921200
1549636200,268.75,270.58,267.83,270.47,NaN,NaN,213.6907692307692,278.09374999999983,274.00140000000016,269.8883000000002,261.2311999999997,265.7940000000002,264.52728737209696,266.2460924259143,268.14538461538444,275.3255822359052,260.9651869948637,274.00140000000016,269.8883000000002,261.2311999999997,265.7940000000002,269.62666666666667,75788861,84660675.55,60.9617314238681,0.5099691430477157,1.5,2.75,NaN,NaN,3.6112440200218647,0.8952073735253817,1013.6522316824905,0.5915051087584375,3.506904898969651,2.9153997902112136,13.70236447013346,2.54397937518958,44.05885701999846,23.686657934000095,32.254485046001435,9044710061
1549895400,271.2,271.49,270.03,270.62,NaN,NaN,213.02179487179484,278.04249999999985,274.03635000000014,269.70110000000017,261.27559999999977,266.3760000000002,264.76621727907354,266.6626550520177,268.6999999999999,275.43122688553456,261.9687731144652,274.03635000000014,269.70110000000017,261.27559999999977,266.3760000000002,270.7133333333333,68021423,84368841.2,61.19444786275923,0.7731738016068463,1.5,2.75,NaN,NaN,3.4575837328774486,0.8062386780772804,1016.8714919024225,0.39256411333539987,3.4061049318804635,3.0135408185450636,12.398672193709961,2.7371777836832236,45.974743677792425,22.131020372867162,31.894235949340406,9112731484
1549981800,272.42,274.52,272.34,274.1,NaN,NaN,212.35282051282047,277.9912499999998,274.0753000000002,269.53300000000013,261.2659999999998,267.21100000000024,265.1322479740118,267.37097361849226,269.5115384615383,276.10597362672826,262.91710329634833,274.0753000000002,269.53300000000013,261.2659999999998,267.21100000000024,273.6533333333333,72270221,84436940.9,66.22488795804281,1.737216599979663,1.5,2.75,NaN,NaN,3.4891848948147723,0.8559076185101347,1020.8424390252927,0.4419044857063712,3.5659214256780274,3.124016939971656,13.37811172164562,2.4366544584797216,44.84926744706123,23.02167608106271,32.12905647187605,9185001705
1550068200,275.03,275.93,274.56,274.99,NaN,NaN,211.6838461538461,277.9399999999998,274.1174500000002,269.37070000000017,261.2861999999998,267.9430000000002,265.5188264848349,268.0965951786359,270.21999999999986,277.0339133678566,263.4060866321431,274.1174500000002,269.37070000000017,261.2861999999998,267.9430000000002,275.16,65277204,83440387.55,67.38919902754583,1.828532968549286,1.5,2.75,NaN,NaN,3.3706716880422873,0.7823214382949016,1023.9599863182132,0.4779813665517145,3.7214936481612995,3.243512281609585,11.103608820423126,1.874560071129553,68.75405875222044,7.917297781778491,23.32864346600105,9250278909
1550154600,273.78,275.64,272.87,274.38,NaN,NaN,211.01487179487177,277.88874999999985,274.16680000000014,269.17870000000016,261.2607999999998,268.61300000000017,265.86632348542963,268.69501468543245,271.0369230769229,277.0572444821761,265.0166016716697,274.16680000000014,269.17870000000016,261.2607999999998,268.61300000000017,274.2966666666667,83234396,83720271.85,65.71705067890787,1.4804073191264178,1.5,2.75,NaN,NaN,3.3277665674678367,0.9941964372634798,1025.2272204532258,0.40703782621057893,3.7523095643728084,3.3452717381622294,10.707897452701454,1.5996445234392331,71.9062159559131,6.491352464584091,21.602431579502806,9167044513
1550241000,276.36,277.41,276.13,277.37,NaN,NaN,210.3458974358974,277.8374999999998,274.22875000000016,269.0325000000001,261.2221999999998,269.3335000000002,266.31744805462847,269.5212037630103,272.11076923076905,277.21705170533704,267.00448675620106,274.22875000000016,269.0325000000001,261.2221999999998,269.3335000000002,276.96999999999997,97088659,83768783.05,69.68744054947389,1.886506857363067,1.5,2.75,NaN,NaN,3.3064975269344217,1.159007633452782,1029.4497250955612,0.5015508050155937,3.9722102444317215,3.470659439416128,11.881638196381841,1.9892631269304404,73.85423453623429,5.675195423538366,20.470570040227344,9264133172
1550586600,276.4813,278.58,276.47,277.85,NaN,NaN,209.67692307692303,277.7862499999998,274.30200000000013,268.9008000000001,261.3741999999998,269.9030000000002,266.76970499366263,270.3144224522474,272.9007692307691,278.1349319309213,267.66660653061683,274.30200000000013,268.9008000000001,261.3741999999998,269.9030000000002,277.6333333333333,59120804,80329808.1,70.28244845312472,1.9987363582418685,1.5,2.75,NaN,NaN,3.221033417867674,0.7359759147737838,1032.4073005801858,0.5334887261514241,4.137520347105408,3.6040316209539838,11.558708727691426,1.7392896374954228,74.89605466939798,5.292908370975444,19.811036959626588,9323253976
1550673000,277.81,278.92,277.25,278.41,NaN,NaN,209.0079487179487,277.7349999999998,274.38095000000015,268.7774000000001,261.5455999999998,270.6805000000002,267.2261871507739,271.08542983774765,273.55307692307673,279.23795773295257,267.8681961132009,274.38095000000015,268.7774000000001,261.5455999999998,270.6805000000002,278.1933333333334,76610767,78383787.3,70.99770841382433,1.7473358869042468,1.5,2.75,NaN,NaN,3.110245316591413,0.9773802675135602,1034.9073005801858,0.5284210592045544,4.264557944959677,3.7361368857551223,11.485576323671644,2.0789029845273945,75.31579206228955,5.128574187752678,19.55563374995779,9399864743
1550759400,277.7,278.1,276.345,277.42,NaN,NaN,208.33897435897433,277.6837499999998,274.43795000000017,268.65280000000007,261.8225999999998,271.3810000000002,267.62594451741023,271.68872223415264,274.1192307692306,279.7656780472943,268.472783491167,274.43795000000017,268.65280000000007,261.8225999999998,271.3810000000002,277.28833333333336,64214727,77293009.3,67.88693114064068,1.1825128506158327,1.5,2.75,NaN,NaN,3.0355849368348835,0.8307960523410493,1032.8686122763984,0.40030290464018803,4.236515516555357,3.8362126119151694,11.78493785845649,2.6948989412897126,51.478241525423705,18.126745991838213,30.395012482738068,9335650016
1550845800,278.11,279.36,277.4029,279.14,NaN,NaN,207.66999999999996,277.6324999999998,274.4990500000002,268.5373000000001,262.1239999999998,272.16050000000024,268.0774761049628,272.3983677356619,274.67153846153826,280.75298487934356,268.59009204373297,274.4990500000002,268.5373000000001,262.1239999999998,272.16050000000024,278.6343,78114616,78238533.15,70.32006222940572,1.4309144928530269,1.5,2.75,NaN,NaN,2.9585502984895364,0.99841616215168,1036.6274727763457,0.3738087513420081,4.303473551092679,3.9296647997506713,9.523745556202881,3.2055311125078414,81.21280690255783,3.0716573154984474,15.715535781943718,9413764632
1551105000,280.73,281.31,279.43,279.52,NaN,NaN,207.0010256410256,277.5812499999998,274.56205000000017,268.42530000000005,262.43179999999984,272.84750000000025,268.52620253221914,273.0766184275036,275.1653846153844,281.68317855734404,268.6475906734248,274.56205000000017,268.42530000000005,262.43179999999984,272.84750000000025,280.08666666666664,69030699,76845900.2,70.84562817697697,1.6682070435110878,1.5,2.75,NaN,NaN,2.9022252771688564,0.898300349404977,1036.4130502693781,0.3260317652750677,4.337204506344506,4.011172741069438,9.513076484583971,3.2887443647919508,79.60046730237262,3.5907214858087517,16.808811211818618,9482795331
1551191400,279.13,280.3,278.9,279.32,NaN,NaN,206.33205128205125,277.5299999999998,274.6111500000002,268.30120000000005,262.70899999999983,273.6255000000002,268.9494887074262,273.6712261963128,275.67153846153826,282.3766035786627,268.9664733444138,274.6111500000002,268.30120000000005,262.70899999999983,273.6255000000002,279.50666666666666,56844101,75407422.5,70.14163058635135,1.3315096559159108,1.5,2.75,NaN,NaN,2.7949234716567974,0.7538263358623616,1034.331384269912,0.22966232314626556,4.29825064500227,4.068588321856004,9.672970418358265,1.9044144472820028,56.75713379818134,14.611370531941782,28.63149566987688,9425951230
1551277800,278.52,279.59,277.48,279.2,NaN,NaN,205.6630769230769,277.4787499999998,274.64705000000015,268.17760000000004,262.9855999999998,274.41500000000025,269.35146954242913,274.1977760823782,276.36846153846136,282.4865600170817,270.25036305984105,274.64705000000015,268.17760000000004,262.9855999999998,274.41500000000025,278.75666666666666,56921570,74946684.3,69.69413343648253,0.9946741848783686,1.5,2.75,NaN,NaN,2.746000366538452,0.759494172846283,1035.4997503790914,0.11246988256456891,4.209175675061715,4.096705792497146,7.627828874033098,1.5309647623549871,29.289917911536786,37.680359471887705,33.0297226165755,9369029660
1551364200,278.96,279.45,278.32,278.68,NaN,NaN,204.99410256410252,277.4274999999998,274.67620000000016,268.04720000000003,263.34979999999985,274.97000000000025,269.71729426625546,274.6246545507231,276.9999999999998,282.17442230147117,271.8255776985284,274.67620000000016,268.04720000000003,263.34979999999985,274.97000000000025,278.81666666666666,69268293,73786415.4,67.67912922048751,0.7628396792444581,1.5,2.75,NaN,NaN,2.6305717689285624,0.9387675580185454,1034.0960776858674,-0.037413995791961696,4.049938297757194,4.087352293549156,7.84451496693212,1.5671696187768829,28.35713356410693,38.704597419134515,32.93826901675854,9299761367
1551450600,280.44,280.88,278.82,280.42,NaN,NaN,204.32512820512815,277.3762499999998,274.71340000000015,267.95700000000005,263.85099999999983,275.49450000000024,270.13700821659836,275.176592212559,277.753846153846,281.70048669964535,273.8072056080466,274.71340000000015,267.95700000000005,263.85099999999983,275.49450000000024,280.04,78880548,72529839.15,70.72878660158646,1.0497443919231528,1.5,2.75,NaN,NaN,2.5998166425765215,1.0875599466981583,1036.985048756362,-0.05561787914017202,4.017829944623941,4.073447823764113,7.940821621746973,1.0996142336950685,28.59632551263148,38.44002554178857,32.96364894557996,9378641915
1551709800,281.6,281.87,276.84,279.4,NaN,NaN,203.6561538461538,277.3249999999998,274.75490000000013,267.87280000000004,264.33739999999983,275.9615000000002,270.5002627963396,275.5788215256486,278.16153846153827,281.5728485744527,274.75022834862386,274.75490000000013,267.87280000000004,264.33739999999983,275.9615000000002,279.37,106494637,73565444.8,66.7525565106508,0.6386996611516117,1.5,2.75,NaN,NaN,2.7734011681067723,1.4476176592083898,1035.1781990441964,-0.16634300277681824,3.8655190702930895,4.031862073069908,6.355453275558154,0.5578549577109787,5.794832377766999,73.57629818764846,20.628869434584526,9272147278
1551796200,279.54,279.76,278.41,279.02,NaN,NaN,202.98717948717945,277.2737499999998,274.78880000000015,267.7848000000001,264.89259999999985,276.3145000000002,270.8343701376596,275.90655280892014,278.4715384615383,281.3671249827614,275.5759519403151,274.78880000000015,267.7848000000001,264.89259999999985,276.3145000000002,279.06333333333333,59114559,73483930.55,65.28016053409914,0.559191938643708,1.5,2.75,NaN,NaN,2.671729656099143,0.8044555939992516,1033.9516804646034,-0.2880318192520277,3.671822299004873,3.9598541182569007,6.424410023178104,0.2191013253834118,5.72137626529222,73.75591407242497,20.522709662282807,9213032719
1551882600,279.15,279.16,276.97,277.33,NaN,NaN,202.31820512820508,277.2224999999998,274.8154000000002,267.68410000000006,265.49579999999986,276.5260000000002,271.0891007204965,276.0421192080706,278.69846153846134,280.5500611987237,276.846861878199,274.8154000000002,267.68410000000006,265.49579999999986,276.5260000000002,277.82,75039771,73258280.4,59.04266221298192,0.130270769156439,1.5,2.75,NaN,NaN,2.637320394949204,1.0243179418118036,1029.8726420709538,-0.49315799397778726,3.3434066257846666,3.836564619762454,7.3046881914172115,-0.03244178501911608,5.181645974477601,75.10926119468184,19.709092830840564,9137992948
1551969000,276.83,276.99,274.07,275.01,NaN,NaN,201.6492307692307,277.17124999999976,274.83380000000017,267.6512000000001,266.18199999999985,276.63950000000017,271.24286147655545,275.9438221406353,278.51692307692286,281.1512454637885,275.88260069005725,274.83380000000017,267.6512000000001,266.18199999999985,276.63950000000017,275.3566666666666,94885089,75085145.3,51.73468770930315,0.8711490860143766,1.5,2.75,NaN,NaN,2.6817975095956887,1.2636998785963593,1026.382688592625,-0.7789091567518982,2.8629281738225814,3.6418373305744796,8.500470986133225,-1.4795443146808038,4.552266923206969,76.77109325698042,18.676639819812625,9043107859
1552055400,272.94,274.65,272.42,274.46,NaN,NaN,272.42,277.1199999999998,274.83925000000016,267.67410000000007,266.9843999999998,276.8555000000002,271.3690237715925,275.80250574628906,278.25615384615367,281.6612951034724,274.8510125888349,274.83925000000016,267.67410000000007,266.9843999999998,276.8555000000002,273.8433333333333,85795799,74600837.2,50.14993729362946,1.1990541203855087,1.5,2.75,NaN,NaN,2.675240544624566,1.150064827958794,1024.8444846306709,-0.9854823954524625,2.4099843362589013,3.395466731711364,7.219482669950464,-1.8102461362335442,0,100,0,8957312060
1552311000,275.26,278.62,275.23,278.44,NaN,NaN,273.20897959183674,277.0687499999998,274.8684000000001,267.69900000000007,267.6295999999998,277.25400000000013,271.64631695702025,276.05369567521393,278.25846153846135,281.66405735127705,274.85286572564564,274.8684000000001,267.69900000000007,267.6295999999998,277.25400000000013,277.43,65098897,74066339,59.75671127119779,0.39729562630198817,1.5,2.75,NaN,NaN,2.7812947914370985,0.8789268901221107,1030.0268723870186,-0.8402594039404656,2.3451424767857816,3.185401880726247,11.704209092946211,-0.3150508377488169,3.499462876201569,79.79100705357413,16.709530070224297,9022410957
1552397400,279.06,280.07,278.85,279.49,NaN,NaN,273.99795918367346,277.01749999999976,274.89905000000016,267.7499,268.2579999999998,277.6975000000001,271.95391237047045,276.380962753765,278.4176923076921,281.8450856105099,274.9902990048743,274.89905000000016,267.7499,268.2579999999998,277.6975000000001,279.47,79667530,74648644.35,61.845746369779036,0.7431819791378798,1.5,2.75,NaN,NaN,2.699059449191591,1.0672334466848226,1032.101480783801,-0.6672208137785569,2.3513758635030513,3.018596677281608,11.937587376107926,0.1038681948424142,17.388290818824586,52.42130488757941,30.190404293596007,9102078487
1552483800,280.48,282.38,280.3,281.34,NaN,NaN,274.78693877551024,276.9662499999998,274.9417500000001,267.75930000000005,268.92979999999983,278.0595000000001,272.32199423829513,276.85325201531117,278.5869230769229,282.3418655397817,274.83198061406415,274.9417500000001,267.75930000000005,268.92979999999983,278.0595000000001,281.34,80639153,75067090.95,65.26683083195303,1.254889302395863,1.5,2.75,NaN,NaN,2.712698059963619,1.074227760520404,1035.621886786944,-0.4332440518360281,2.4770416124865733,2.9102856643226014,12.49843708063842,0.9544997846992852,41.71684596173406,25.602833089279006,32.68032094898693,9182717640
1552570200,281.37,281.84,280.6662,281.16,NaN,NaN,275.57591836734696,276.91499999999974,274.98680000000013,267.76640000000003,269.5545999999998,278.3680000000001,272.6685826995385,277.2634184900434,278.71307692307676,282.68865146010694,274.7375023860466,274.98680000000013,267.76640000000003,269.5545999999998,278.3680000000001,281.2220666666667,67518366,75179149.05,64.65934300238709,0.9852155863155931,1.5,2.75,NaN,NaN,2.6027767699662157,0.898099630724671,1034.0498612248693,-0.3019002795986587,2.532910314824278,2.8348105944229367,12.423964988936083,0.26388987946651776,47.13278012527646,21.233139953841068,31.634079920882467,9115199274
1552656600,280.54,282.21,280.33,281.31,NaN,NaN,276.3648979591837,276.86374999999975,275.0482500000001,267.81550000000004,270.1771999999998,278.71450000000016,273.0074618093605,277.64880720527736,278.8661538461537,283.0701046506778,274.66220304162954,275.0482500000001,267.81550000000004,270.1771999999998,278.71450000000016,281.2833333333333,81308979,75082878.2,64.95210214615946,0.9157919836143419,1.5,2.75,NaN,NaN,2.551149857825771,1.0829230438318491,1036.1274173170698,-0.22002221368788089,2.559782827313086,2.7798050410009667,11.950584044075246,0.6836077308518343,78.85248691405684,3.8115853291524155,17.335927756790753,9196508253
1552915800,281.55,282.66,281.3,282.33,NaN,NaN,277.1538775510204,276.8124999999998,275.09685000000013,267.87630000000007,270.9395999999998,278.96250000000015,273.3730515423268,278.094635090489,279.1069230769229,283.70026531318183,274.51358084066396,275.09685000000013,267.87630000000007,270.9395999999998,278.96250000000015,282.09666666666664,62199806,73338435.55,66.95663732575117,0.9788722666610785,1.5,2.75,NaN,NaN,2.4660677251239314,0.8481201641885856,1039.6192321867811,-0.1174176350524454,2.63303299718541,2.7504506322378552,11.79598234963463,1.1862948892552514,79.44285802267933,3.6258211218982104,16.93132085542246,9258708059
1553002200,283.51,284.36,281.41,282.4,NaN,NaN,277.9428571428572,276.76124999999973,275.15415000000013,267.95020000000005,271.5397999999998,279.1900000000001,273.7270495210591,278.5046698437758,279.39307692307676,284.2973506299269,274.48880321622664,275.15415000000013,267.95020000000005,271.5397999999998,279.1900000000001,282.7233333333333,90268121,74895801.4,67.09572434327595,1.0329437025079307,1.5,2.75,NaN,NaN,2.500634316186507,1.2052494173591952,1036.9635530685616,-0.0675599434240195,2.666000702957831,2.7335606463818505,11.712037623325768,1.8281469729203452,80.14447436004264,3.396403645430787,16.459121994526583,9348976180
1553088600,282.16,283.5,280.32,281.55,NaN,NaN,278.7318367346939,276.70999999999975,275.19390000000016,268.0296000000001,272.0831999999998,279.3470000000001,274.03383189278225,278.79470128722573,279.47999999999985,284.49285117702976,274.46714882296993,275.19390000000016,268.0296000000001,272.0831999999998,279.3470000000001,281.78999999999996,84609210,75295723.55,63.59520640334888,0.746906948331288,1.5,2.75,NaN,NaN,2.5491604364589002,1.12369210375959,1035.0896192631735,-0.11193486921081641,2.59364205986833,2.7055769290791463,11.134813352741078,2.3780953419875717,49.70859237683737,19.350935439022937,30.940472184139686,9264366970
1553175000,280.64,285.18,280.59,284.73,NaN,NaN,279.5208163265306,276.65874999999977,275.24305000000015,268.22370000000006,272.6423999999998,279.7125000000001,274.4532894656143,279.35996783129946,279.8899999999998,285.62890903596735,274.1510909640323,275.24305000000015,268.22370000000006,272.6423999999998,279.7125000000001,283.5,79550375,76062505.95,69.91833735486112,1.3577083585989007,1.5,2.75,NaN,NaN,2.6949346909975525,1.045855300274918,1038.9656037592665,0.044393540325743164,2.761068854486325,2.716675314160582,10.419058473657794,3.741893172046943,75.49422558048572,5.042130804976402,19.463643614537858,9343917345
1553261400,283.22,283.8034,279.18,279.25,NaN,NaN,280.30979591836734,276.60749999999973,275.2638000000002,268.31540000000007,273.0679999999998,279.7180000000001,274.64139576108045,279.349494704509,279.9076923076922,285.63717424881236,274.178210366572,275.2638000000002,268.31540000000007,273.0679999999998,279.7180000000001,280.7444666666667,122659286,78289739.45,52.87477846140884,0.17102834788066024,1.5,2.75,NaN,NaN,2.898867927354871,1.5667351413059274,1033.362670853827,-0.23443823189437563,2.4236275242926126,2.6580657561869883,16.674979324936736,0.2909064789541741,38.92953419124847,28.084310032345748,32.986155776405774,9221258059
1553520600,278.87,280.1853,277.64,279.04,NaN,NaN,281.0987755102041,276.55624999999975,275.27200000000016,268.45250000000004,273.47119999999984,279.6940000000001,274.81389004495963,279.3200190183653,280.0392307692306,285.6020494323963,274.47641210606486,275.27200000000016,268.45250000000004,273.47119999999984,279.6940000000001,278.95509999999996,85575197,79116964.35,52.34816245597454,0.5404251621041622,1.5,2.75,NaN,NaN,2.8736130754009515,1.081628923746744,1034.338375727239,-0.4345497328669259,2.1148785901033307,2.5494283229702566,14.606961531549336,-0.16100754946509307,18.498248158839708,50.86060712120696,30.641144719953342,9135682862
1553607000,280.99,282.18,279.56,281.12,NaN,NaN,281.88775510204084,276.50499999999977,275.2907500000002,268.62510000000003,273.9139999999999,279.78400000000005,275.06118847456906,279.491445778521,280.5092307692306,285.2671971191527,275.75126441930854,275.2907500000002,268.62510000000003,273.9139999999999,279.78400000000005,280.9533333333333,68125920,79681055.3,56.9243713575531,0.20935587508573208,1.5,2.75,NaN,NaN,2.892640712872311,0.8549826523193651,1038.1517294567882,-0.4276978404530034,2.0148060224040023,2.4425038628570057,15.075076072220812,-0.07819719911849381,15.256841528936615,55.63815831410249,29.105000156960884,9203808782
1553693400,281.11,281.76,277.93,279.65,NaN,NaN,282.67673469387756,276.45374999999973,275.29805000000016,268.74390000000005,274.35899999999987,279.8065,275.24114186772323,279.5065461805666,280.9084615384614,284.220322239298,277.59660083762475,275.29805000000016,268.74390000000005,274.35899999999987,279.8065,279.78000000000003,72224722,80446212.9,53.047097321166646,0.19390133834002626,1.5,2.75,NaN,NaN,2.959594947667145,0.8978013929602893,1036.8861189671413,-0.5170623867941315,1.7961758793643412,2.3132382661584727,14.876595892244755,-0.5370607483283709,16.24780221020264,54.12743129481654,29.62476649498082,9131584060
1553779800,280.35,281.21,279.07,280.71,NaN,NaN,283.4657142857143,276.40249999999975,275.30880000000013,268.8447,274.76619999999986,279.908,275.4556068925184,279.62116083003644,281.08307692307676,284.0803616903782,278.0857921557753,275.30880000000013,268.8447,274.76619999999986,279.908,280.33,56238545,79794725.5,55.40583427529155,0.051472557838453434,1.5,2.75,NaN,NaN,2.901052451405205,0.7047902558421609,1039.833672765547,-0.49941171650849103,1.6889736205228587,2.1883853370313497,15.08705734494275,-0.2132878319291965,12.578082186454449,59.98283329847141,27.43908451507413,9187822605
1553866200,282.39,282.84,281.14,282.48,NaN,NaN,284.25469387755106,276.3512499999997,275.32660000000016,268.93440000000004,275.19619999999986,280.0110000000001,275.73107328889023,279.8934312271758,281.3130769230768,284.2442293308797,278.38192451527385,275.32660000000016,268.93440000000004,275.19619999999986,280.0110000000001,282.15333333333336,82186806,79960038.4,59.10059360485881,0.5732824377182597,1.5,2.75,NaN,NaN,2.845977276304833,1.02784850588566,1042.25869522832,-0.3691624573401677,1.7269322653561403,2.096094722696308,15.537092624160467,0.05312931675699859,43.811203146994586,23.878319034281134,32.31047781872429,9270009411
1554125400,284.7,286.16,284.4,285.83,NaN,NaN,285.0436734693878,276.2999999999997,275.3656000000002,269.07380000000006,275.65359999999987,280.3325000000001,276.1271096305024,280.45881872934956,281.6584615384614,285.45213924387025,277.8647838330525,275.3656000000002,269.07380000000006,275.65359999999987,280.3325000000001,285.4633333333333,77617945,78516203.8,65.00958582495963,1.4776801652868297,1.5,2.75,NaN,NaN,2.9055503279973456,0.9885595742467621,1047.232396558118,-0.07349316070349321,2.0042282718169417,2.077721432520435,16.80595243148065,1.2145892351274812,76.70238404426631,4.579206364295919,18.718409591437773,9347627356
1554211800,286.04,286.23,285.09,285.97,NaN,NaN,285.8326530612245,276.24874999999975,275.4018000000002,269.1996000000001,276.04379999999986,280.6800000000001,276.513105331267,280.98369313607816,282.0284615384614,286.4429540776648,277.61396899925796,275.4018000000002,269.1996000000001,276.04379999999986,280.6800000000001,285.7633333333333,40070351,77563993.4,65.23563277633511,1.374842648948011,1.5,2.75,NaN,NaN,2.7794395902832525,0.5166102110467148,1045.5216641113025,0.10567154252425937,2.209810860675759,2.1041393181515,16.8013552963678,1.5698810158053687,74.46599974740809,5.4370512160397215,20.096949036552182,9387697707
1554298200,287.32,287.76,285.75,286.42,NaN,NaN,286.6216326530612,276.1974999999997,275.4482500000002,269.31260000000003,276.5149999999999,281.1345000000001,276.90161100455066,281.50143664692786,282.4215384615383,287.38590283267695,277.4571740903997,275.4482500000002,269.31260000000003,276.5149999999999,281.1345000000001,286.6433333333334,68243202,77224164.95,65.99604341707176,1.3833975496620412,1.5,2.75,NaN,NaN,2.7244796195487337,0.8837026861240278,1046.9740531646432,0.22196394283642729,2.381594246697034,2.159630303860607,16.580015795273393,0.5935447617040697,100,0,0,9455940909
1554384600,286.78,287.459,286.01,287.18,NaN,NaN,287.410612244898,276.1462499999997,275.50135000000023,269.37430000000006,276.99039999999985,281.7430000000001,277.3046850828036,282.0422522043633,282.7946153846152,288.3671061431914,277.22212462603903,275.50135000000023,269.37430000000006,276.99039999999985,281.7430000000001,286.88300000000004,48997505,74929785.75,67.29707032567754,1.269000834299159,1.5,2.75,NaN,NaN,2.633373932438111,0.6539122527785954,1049.9224543088112,0.31203053699062133,2.5496684750988834,2.237637938108262,15.474920010671601,2.8397493285586415,100,0,0,9504938414
1554471000,287.92,288.63,287.6,288.57,NaN,NaN,288.1995918367347,276.0949999999997,275.5667000000002,269.4550000000001,277.49079999999987,282.4485000000001,277.7464621383799,282.6639424706144,283.2692307692306,289.62271781439875,276.91574372406245,275.5667000000002,269.4550000000001,277.49079999999987,282.4485000000001,288.26666666666665,58621729,73571082.25,69.58886323629645,1.4871885900786643,1.5,2.75,NaN,NaN,2.548847222978245,0.7968039507805392,1053.3176380633777,0.4204318117238035,2.7631777027630164,2.342745891039213,8.571427982204117,3.415280963302742,100,0,0,9563560143
1554730200,288.1,288.91,287.37,288.79,NaN,NaN,288.98857142857145,276.0437499999997,275.6308000000002,269.5653000000001,277.95099999999985,282.9660000000001,278.1795420545219,283.2473765210321,283.8261538461537,290.725052480491,276.92725521181643,275.6308000000002,269.5653000000001,277.95099999999985,282.9660000000001,288.3566666666666,53566335,72994454.15,69.94783234618441,1.3062298873997096,1.5,2.75,NaN,NaN,2.476786707051229,0.7338411612740308,1053.9822181312902,0.45901741928582984,2.9165176651465003,2.4575002458606705,8.352346395013774,2.728372225384183,100,0,0,9617126478
1554816600,287.72,288.08,286.7,287.31,NaN,NaN,289.77755102040817,275.9924999999997,275.6961500000002,269.7127000000001,278.42199999999985,283.35700000000014,278.5375992288544,283.6342930428386,284.02461538461523,291.16046901965,276.88876174958045,275.6961500000002,269.7127000000001,278.42199999999985,283.35700000000014,287.3633333333333,66142316,72318193.45,64.43739443983765,0.7831870467797116,1.5,2.75,NaN,NaN,2.4491590851190006,0.9146013312090002,1050.272450451553,0.34228497587282725,2.8853564657017046,2.5430714898288773,9.21985360130825,2.7391382084748885,74.06003617715047,5.612989317543738,20.32697450530579,9550984162
1554903000,287.77,288.3899,287.31,288.29,NaN,NaN,290.56653061224495,275.9412499999997,275.7639000000002,269.8750000000001,278.9195999999999,283.70450000000017,278.92004631791895,284.07769370542536,284.71999999999986,291.61708076485144,277.8229192351483,275.7639000000002,269.8750000000001,278.9195999999999,283.70450000000017,287.99663333333336,52601499,70916310.75,66.32894362308102,0.8638434366752101,1.5,2.75,NaN,NaN,2.351354864753358,0.741740488805673,1054.4651759813748,0.29053281098859873,2.9062375035646255,2.615704692576027,7.9199490432087405,2.7002956788144497,72.41475622563411,6.296558664079693,21.28868511028621,9603585661
1554989400,288.83,288.84,287.578,288.21,NaN,NaN,291.35551020408167,275.8899999999997,275.8499500000002,270.0551000000001,279.3321999999999,284.05700000000013,279.28435822702016,284.47124668586105,285.4253846153845,291.70234917029063,279.1484200604783,275.8499500000002,270.0551000000001,279.3321999999999,284.05700000000013,288.2093333333333,55093100,70295047.45,66.02023431716225,0.7858047291270409,1.5,2.75,NaN,NaN,2.273543802985261,0.783740846596441,1056.118455550393,0.21391305311683828,2.8830960089720747,2.6691829558552365,8.120811625970939,2.02846219201358,45.63479266552668,22.452482015541175,31.912725318932157,9548492561
1555075800,290,290.47,288.261,290.16,NaN,NaN,292.1444897959184,275.8387499999997,275.9427500000002,270.2265000000001,279.73679999999985,284.4995000000001,279.7108539828233,285.01303271577905,286.12076923076904,292.33848318879785,279.90305527274023,275.9427500000002,270.2265000000001,279.73679999999985,284.4995000000001,289.63033333333334,69727782,69715987.6,69.7196781303074,1.178696056872258,1.5,2.75,NaN,NaN,2.2725763884863173,1.000169177837194,1058.9961716586984,0.25478561047336656,2.9876649689469446,2.732879358473578,8.199688843595343,1.5148864709792678,47.992171085459745,20.634284720753868,31.373544193786383,9618220343
1555335000,290.24,290.35,289.075,289.97,NaN,NaN,292.9334693877551,275.7874999999997,276.04585000000026,270.3889000000001,280.1349999999999,284.88150000000013,280.1131734344773,285.4851248380858,286.9146153846152,292.1885898916343,281.6406408775961,276.04585000000026,270.3889000000001,280.1349999999999,284.88150000000013,289.79833333333335,49596685,69085831.55,68.93219396409738,0.9726149146483204,1.5,2.75,NaN,NaN,2.2013209321658684,0.7178995155338765,1057.792842942179,0.23000695930129833,3.0203880576002007,2.7903810982989024,5.947757231317409,1.398748120432213,25.20258257271007,42.36899434436843,32.4284230829215,9568623658
1555421400,290.95,291.01,289.5,290.16,NaN,NaN,293.7224489795919,275.7362499999997,276.1422000000003,270.5995000000001,280.49899999999985,285.26950000000016,280.5071666331252,285.9303510439824,287.6415384615383,291.7763426790565,283.5067342440201,276.1422000000003,270.5995000000001,280.49899999999985,285.26950000000016,290.22333333333336,52153197,67180085.35,69.30555664135758,0.9447257612908668,1.5,2.75,NaN,NaN,2.1519408655825916,0.776319302488055,1059.2385573296326,0.18910482020286778,3.026762123552487,2.8376573033496193,5.938882966944314,1.3057747364010923,53.62148849821988,16.690419456903992,29.68809204487612,9620776855
1555507800,291.4,291.425,288.99,289.45,NaN,NaN,294.5114285714286,275.6849999999997,276.2330500000003,270.8528000000001,280.82599999999985,285.66450000000015,280.8578659808458,286.26555570646025,288.17769230769215,291.13669581821955,285.21868879716476,276.2330500000003,270.8528000000001,280.82599999999985,285.66450000000015,289.955,58268295,65863039.6,66.10838258700572,0.757214303667997,1.5,2.75,NaN,NaN,2.1721593751838353,0.8846888232592289,1057.0892623227644,0.08237404338204612,2.940624857577177,2.858250814195131,6.343434615185617,0.7904450170624632,26.503040199543612,40.845683557130585,32.65127624332582,9562508560
1555594200,290.1,290.32,288.66,290.02,NaN,NaN,295.30040816326533,275.6337499999997,276.3238500000002,271.1028000000001,281.1715999999999,285.9290000000002,281.217165354146,286.6231218296545,288.49999999999983,291.2728352610178,285.72716473898186,276.3238500000002,271.1028000000001,281.1715999999999,285.9290000000002,289.6666666666667,68708513,65320946.5,67.4082731363971,0.6834019196180751,1.5,2.75,NaN,NaN,2.135576562670702,1.051860340082488,1056.4599455472369,0.021477018013854376,2.885097086712449,2.8636200686985944,6.292545729198036,0.5024777350382883,55.56550780779184,15.402477851935735,29.03201434027242,9631217073
1555939800,289.17,290.435,289.07,290.27,NaN,NaN,296.08938775510205,275.5824999999997,276.42070000000024,271.37300000000016,281.5741999999999,286.4800000000002,281.5721784775128,286.9704435601636,288.830769230769,291.3298578220745,286.33168063946357,276.42070000000024,271.37300000000016,281.5741999999999,286.4800000000002,289.925,40160140,61195989.2,67.98820156809572,0.5982862811449835,1.5,2.75,NaN,NaN,2.0805353796227952,0.6562544461655666,1054.2721595049122,-0.027970580083819918,2.8286568435938193,2.856627423677639,5.79936940015654,0.5124831192215663,48.17573956178359,20.460395979762126,31.36386445845428,9671377213
1556026200,290.68,293.14,290.42,292.88,NaN,NaN,296.87836734693883,275.53124999999966,276.5195500000002,271.6268000000002,282.0223999999999,287.1720000000002,282.0156224587868,287.5332584591956,289.32769230769213,292.2456489567971,286.4097356585872,276.5195500000002,271.6268000000002,282.0223999999999,287.1720000000002,292.14666666666665,52246633,59529561,73.32475260253638,1.2840695469861683,1.5,2.75,NaN,NaN,2.1369257096497387,0.8776586308103297,1058.279175823232,0.08302366303947561,2.960407002476984,2.8773833394375083,7.530481204962289,1.938672514009256,74.9119864182345,5.259245480129214,19.828768101636296,9723623846
1556112600,292.79,293.16,292.07,292.23,NaN,NaN,297.66734693877555,275.4799999999997,276.6036000000002,271.86510000000015,282.45459999999986,287.7275000000002,282.41618628393246,287.98056717736745,289.71615384615365,292.7300247378133,286.70228295449397,276.6036000000002,271.86510000000015,282.45459999999986,287.7275000000002,292.4866666666667,50392914,58642910.7,70.18668111644004,1.0640612092438086,1.5,2.75,NaN,NaN,2.062145301817617,0.8593180897482293,1059.0556686927875,0.08052643056368458,2.978041377642114,2.8975149470784296,6.750558693198734,1.3666793853411487,47.919415472919106,20.653218584957934,31.42736594212294,9673230932
1556199000,292.12,292.78,290.73,292.05,NaN,NaN,298.4563265306123,275.4287499999997,276.67435000000023,272.0398000000001,282.81359999999984,288.3475000000002,282.79398290024886,288.3681322080944,289.983846153846,293.1569401398321,286.8107521678599,276.67435000000023,272.0398000000001,282.81359999999984,288.3475000000002,291.8533333333333,57770862,57920217.7,69.3021708119103,0.8925831333258096,1.5,2.75,NaN,NaN,2.0612777802592124,0.997421354650744,1056.491492411796,0.03683661490072554,2.9435607157043364,2.906724100803611,6.772781087174028,1.332361819506621,47.912551433293125,20.65839539011869,31.42905317658819,9615460070
1556285400,292.1,293.49,291.2401,293.41,NaN,NaN,299.245306122449,275.37749999999966,276.74690000000027,272.2341000000001,283.18199999999985,288.9825000000002,283.21029729631755,288.84831009303775,290.3392307692306,293.9080742495485,286.7703872889127,276.74690000000027,272.2341000000001,283.18199999999985,288.9825000000002,292.7133666666667,50916423,57654111.6,72.15720973105155,0.8515614495565134,1.5,2.75,NaN,NaN,2.0747507959549845,0.883136025982924,1059.6052101406913,0.06781362264260071,2.991491129106862,2.9236775064642613,6.9410918813344304,1.1200716845878136,43.975792136754094,23.743742884070222,32.28046497917568,9666376493
1556544600,293.51,294.45,293.41,293.87,NaN,NaN,300.0342857142858,275.3262499999997,276.83195000000023,272.4163000000001,283.5717999999999,289.55200000000025,283.6283248533247,289.3265662746532,290.84384615384596,294.41181940714046,287.27587290055146,276.83195000000023,272.4163000000001,283.5717999999999,289.55200000000025,293.91,57197747,56404658.65,73.06953931319703,1.1012072369564891,1.5,2.75,NaN,NaN,2.00084002481534,1.0140606887619201,1061.956332803969,0.0863760244258378,3.0316475369965588,2.945271512570721,6.185245540089853,1.3449667206952363,48.266161716043314,20.40262427802715,31.33121400592955,9723574240
1556631000,293.49,294.34,291.92,294.02,NaN,NaN,300.8232653061225,275.27499999999964,276.9052000000002,272.5635000000001,283.9047999999999,289.9615000000002,284.03584152574336,289.77355996278146,291.2846153846152,294.8971628802819,287.67206788894856,276.9052000000002,272.5635000000001,283.9047999999999,289.9615000000002,293.4266666666667,81112081,56579365.45,73.37589931176247,0.8326587920116353,1.5,2.75,NaN,NaN,2.030780023042813,1.4335982801305878,1063.5735478840943,0.07620377571540127,3.0405262322149724,2.964322456499571,6.088131041701357,1.3303005238488959,53.993232267536676,16.345790593464844,29.66097713899847,9804686321
1556717400,294.72,294.95,291.8,291.81,NaN,NaN,301.6122448979592,294.95,276.9663000000002,272.7791000000001,284.18399999999986,290.25350000000026,284.3407104855181,289.96750663299275,291.56153846153825,294.7111401082044,288.4119368148721,276.9663000000002,272.7791000000001,284.18399999999986,290.25350000000026,292.8533333333333,71671870,58159441.4,62.156698694839854,0.6691827921719535,1.5,2.75,NaN,NaN,2.1107243071111816,1.2323342225222955,1061.0186560023365,-0.10222891958445457,2.836536307019003,2.9387652266034574,7.970881519524709,0.8153394368630208,47.85017089620826,20.715578764888125,31.434250338903606,9733014451
1556803800,291.68,292.7,289.52,291.18,NaN,NaN,302.40122448979594,295.0940594059406,277.02550000000025,272.9925000000001,284.43939999999986,290.49150000000026,284.6089179174586,290.0829821917553,291.6399999999998,294.69544658705246,288.5845534129472,277.02550000000025,272.9925000000001,284.43939999999986,290.49150000000026,291.1333333333334,65030170,57998789.8,59.36988679196379,0.12397970265814916,1.5,2.75,NaN,NaN,2.1871011423175264,1.1212332226973467,1059.5548058929137,-0.2757053571079435,2.594133530218528,2.8698388873264715,7.932628879680677,0.3999724156954779,45.99168300283786,22.145028399191453,31.863288597970687,9667984281
1556890200,292.82,294.34,291.2998,294.03,NaN,NaN,303.1902040816327,295.2381188118812,277.0933000000002,273.2971000000001,284.77159999999986,290.83400000000023,284.9783721167739,290.4588886496834,291.9523076923075,295.08999085374734,288.81462453086766,277.0933000000002,273.2971000000001,284.77159999999986,290.83400000000023,293.22326666666663,56543653,58376097.2,66.65366646805813,0.7638091672443235,1.5,2.75,NaN,NaN,2.256593917866272,0.9686096829371457,1063.7303037804352,-0.21426752840089147,2.602004476825357,2.8162720052262484,9.51605503022238,1.2953457126123924,47.037042312275574,21.334665300106973,31.628292387617453,9724527934
1557149400,289.25,293.31,288.9,292.82,NaN,NaN,303.97918367346944,295.3821782178218,277.15210000000025,273.5846000000001,285.0451999999999,291.04650000000026,285.28588693572397,290.6837563973326,292.1569230769229,295.1436978707144,289.1701482831314,277.15210000000025,273.5846000000001,285.0451999999999,291.04650000000026,291.6766666666667,107198069,60804914.2,61.60421298740592,0.33261991303969024,1.5,2.75,NaN,NaN,2.4618372094472525,1.7629836405558155,1061.7601880650004,-0.267422017228804,2.4819944836902437,2.7494165009190477,10.02903124137266,-0.020486205954657975,18.5433306795948,50.9034652250746,30.55320409533062,9617329865
1557235800,290.15,290.81,285.81,287.93,NaN,NaN,304.76816326530616,295.52623762376237,277.19175000000024,273.8226000000001,285.21339999999987,291.00350000000026,285.389577644127,290.4214938833009,292.03999999999985,295.5198054764619,288.5601945235378,277.19175000000024,273.8226000000001,285.21339999999987,291.00350000000026,288.18333333333334,144729908,65363092.85,46.329154595816604,1.4608408429658644,1.5,2.75,NaN,NaN,2.7867059802010195,2.214245099021504,1057.0214439062036,-0.6238537985053947,1.9695992527873045,2.593453051292699,12.92435896504228,-1.471443725832396,2.0735356833245904,84.74391979812377,13.182544518551639,9472599957
1557322200,287.53,289.43,286.87,287.53,NaN,NaN,305.5571428571429,295.67029702970297,277.2310000000002,274.0433000000001,285.3775999999999,291.0145000000002,285.4735157757298,290.14611351346275,291.8484615384613,295.967354938437,287.72956813848566,277.2310000000002,274.0433000000001,285.3775999999999,291.0145000000002,287.9433333333333,91568287,66634391.4,45.33882771431391,0.9883896859350739,1.5,2.75,NaN,NaN,2.7705126959009467,1.3741895900320327,1055.8795500544697,-0.8637259687403693,1.5137955903672378,2.377521559107607,12.920999540662244,-1.5476801917480016,1.903133285998111,85.4175085937555,12.679358120246379,9381031670
1557408600,285.23,287.33,283.3,286.66,NaN,NaN,306.3461224489796,295.81435643564356,277.2633000000003,274.2562000000001,285.52679999999987,290.9330000000002,285.52004456883844,289.8141027026568,291.57076923076903,296.4874063650562,286.6541320964819,277.2633000000003,274.2562000000001,285.52679999999987,290.9330000000002,285.7633333333333,103471104,69177871.65,43.1770022728764,1.5462901720545719,1.5,2.75,NaN,NaN,2.874761789050876,1.4957254615103497,1053.6497020277598,-1.04599203317348,1.070031517640757,2.116023550814237,12.92653220828851,-2.300535087420333,1.6219475114720057,86.59255573581042,11.785496752717572,9277560566
1557495000,285.62,288.94,282.3,288.1,NaN,NaN,307.1351020408164,295.95841584158416,277.2957500000003,274.5325000000001,285.71519999999987,290.92750000000024,285.6212192916291,289.6508548262133,291.2030769230767,296.3810740685076,286.02507977764583,277.2957500000003,274.5325000000001,285.71519999999987,290.92750000000024,286.44666666666666,112429293,72044681.3,47.62818936110387,1.197446609639661,1.5,2.75,NaN,NaN,3.143707375547241,1.5605495224808497,1056.6034267603504,-1.0327941873828792,0.8250308165856381,1.8578250039685174,12.995099255636195,-1.9634532276176477,5.320585629132265,74.83568467855784,19.843729692309896,9389989859
1557754200,282.42,283.49,279.93,280.86,NaN,NaN,307.9240816326531,296.10247524752475,277.28000000000026,274.7875000000001,285.72399999999993,290.4625000000002,285.4345048096044,288.8136305570501,290.32846153846134,297.83472905775596,282.8221940191667,277.28000000000026,274.7875000000001,285.72399999999993,290.4625000000002,281.4266666666667,127290527,74922818.55,33.44340007397767,2.6850854894948655,1.5,2.75,NaN,NaN,3.5027282772938677,1.6989553978812508,1050.77395348906,-1.4493585773854671,0.04612678223668354,1.4954853596221507,18.48643436583256,-4.4758859941500475,4.102242833359819,78.08942919609174,17.80832797054844,9262699332
1557840600,281.99,285.1,281.85,283.4,NaN,NaN,308.7130612244898,296.24653465346535,277.2803000000003,275.07070000000004,285.8039999999999,290.1340000000002,285.354720307267,288.2980466944739,289.6630769230767,297.93541222583053,281.39074162032284,277.2803000000003,275.07070000000004,285.8039999999999,290.1340000000002,283.45,77003230,76293145.8,40.175042650840595,1.5567840404806514,1.5,2.75,NaN,NaN,3.5553905432014496,1.0093073131610206,1055.427677036623,-1.4860124837315762,-0.3620302450423196,1.1239822386892566,19.91678147515515,-2.882012268256751,16.67594359690708,53.581999217862226,29.742057185230692,9339702562
1557927000,281.59,285.77,281.36,285.06,NaN,NaN,309.5020408163266,296.39059405940594,277.2985000000003,275.4087000000001,285.9247999999999,289.87900000000025,285.34316264815845,287.9896612950002,289.020769230769,297.3262464283419,280.71529203319614,277.2985000000003,275.4087000000001,285.9247999999999,289.87900000000025,284.06333333333333,73956407,77383306.3,44.150680884041854,1.1921411277324845,1.5,2.75,NaN,NaN,3.616434075829915,0.9557152638746841,1058.2921764942696,-1.3353970217921685,-0.545264038550954,0.7901329832412145,20.43912536106762,-2.1017927055429646,36.19976443922168,30.65506136324266,33.14517419753564,9413658969
1558013400,285.84,289.21,285.76,287.7,NaN,NaN,310.2910204081633,296.53465346534654,277.33725000000027,275.81400000000014,286.1321999999999,289.7915000000002,285.4355876423483,287.96207450500015,288.54615384615363,296.3807734224634,280.71153426984387,277.33725000000027,275.81400000000014,286.1321999999999,289.7915000000002,287.5566666666667,76749643,78307373.7,49.85769889955597,0.1537599457580435,1.5,2.75,NaN,NaN,3.6545459275563483,0.9801074837988085,1061.766572639131,-1.0097153087401183,-0.47201115268393323,0.5377041560561849,21.48921594542709,-2.1528415467809356,65.0109956613593,9.832717747072312,25.1562865915684,9490408612
1558099800,285.14,288.6,285.1207,285.84,NaN,NaN,311.08000000000004,296.67871287128713,277.35980000000023,276.2654000000001,286.3487999999999,289.58250000000027,285.4514469504915,287.7599721711906,287.9169230769229,295.1854490500908,280.648397103755,277.35980000000023,276.2654000000001,286.3487999999999,289.58250000000027,286.52023333333335,100353024,79889599.25,46.27024092465625,0.25851480077606576,1.5,2.75,NaN,NaN,3.642028361302325,1.2561462936616246,1058.5685618937969,-0.8762563763957177,-0.5576163144384623,0.31864006195725547,20.46122500428902,-2.383716959224103,31.763981255636224,35.041045031455106,33.19497371290866,9390055588
1558359000,284.06,285.43,283.12,283.95,NaN,NaN,311.86897959183676,296.8227722772277,277.3752500000002,276.7615000000001,286.5385999999999,289.2665000000003,285.39256667792324,287.39711767869625,287.31230769230746,294.49198908164107,280.13262630297385,277.3752500000002,276.7615000000001,286.5385999999999,289.2665000000003,284.1666666666667,62877610,81025472.75,42.89290978605914,0.9898851614517324,1.5,2.75,NaN,NaN,3.576169192637871,0.7760227477352176,1055.8720481369846,-0.8701924611729409,-0.7691005145089207,0.10109194666402022,20.56968361269528,-1.3822804153787442,44.00266292505141,23.72026769326078,32.2770693816878,9327177978
1558445400,285.83,286.93,285.55,286.51,NaN,NaN,312.6579591836735,296.9668316831683,277.3958500000002,277.1648000000001,286.69999999999993,288.94800000000026,285.4363875925145,287.31263028072516,286.9530769230767,293.78146736127394,280.1246864848795,277.3958500000002,277.1648000000001,286.69999999999993,288.94800000000026,286.33,46847085,80755495.35,48.388121099042635,0.14552466691250526,1.5,2.75,NaN,NaN,3.533585678878025,0.5801101806999195,1059.8495793709262,-0.6583232064570722,-0.72181206140732,-0.06348885495024784,19.561200370594708,-0.35474559176433135,39.1630535998839,27.845058696887545,32.99188770322856,9374025063
1558531800,285.45,286.69,285.1,285.63,NaN,NaN,313.44693877551026,297.1108910891089,277.40600000000023,277.5404000000001,286.8227999999999,288.6180000000003,285.44398023594533,287.15237977779896,286.3069230769228,291.7919369798119,280.82190917403375,277.40600000000023,277.5404000000001,286.8227999999999,288.6180000000003,285.8066666666667,49482472,80709973.25,46.72371565404606,0.27333011600218327,1.5,2.75,NaN,NaN,3.394758130386736,0.6130899318567176,1057.0974042156888,-0.5465980002686728,-0.7467363552860888,-0.20013835501741606,19.613180432398856,-0.35931068164376945,17.181761118135885,52.74289275892123,30.075346122942882,9324542591
1558618200,283.16,283.21,280.57,282.14,NaN,NaN,314.235918367347,297.2549504950495,277.39350000000024,277.8843000000001,286.8387999999999,288.1225000000003,285.3144123835553,286.6750102751514,285.48538461538436,289.9211318190269,281.0496374117418,277.39350000000024,277.8843000000001,286.8387999999999,288.1225000000003,281.9733333333333,98733847,82758122.5,40.738823967866296,1.5814683259381135,1.5,2.75,NaN,NaN,3.513703978216255,1.193041166442605,1052.9384736684563,-0.668816258666231,-1.0361586783502048,-0.36734241968397385,20.709303379247686,-2.0687261367580825,1.869762230546147,85.49838730469777,12.631850464756083,9225808744
1558704600,283.74,284.2,282.09,282.78,NaN,NaN,315.0248979591837,297.3990099009901,277.37950000000023,278.2129000000001,286.87119999999993,287.5910000000003,285.21502366263155,286.30405691561316,285.08923076923054,289.500729461294,280.6777320771671,277.37950000000023,278.2129000000001,286.87119999999993,287.5910000000003,283.0233333333333,55268095,82975706.1,42.200930442743775,0.8939074621247245,1.5,2.75,NaN,NaN,3.4134394083436663,0.6660756213799789,1055.9504617282055,-0.666167546258866,-1.2000518525075563,-0.5338843062486903,20.448101153532743,0.6836146122623225,13.20939832442472,58.918891107305775,27.871710568269506,9281076839
1559050200,283.09,284.15,280.13,280.15,NaN,NaN,315.8138775510204,297.5430693069307,277.35295000000025,278.51260000000013,286.8479999999999,286.9050000000003,285.0163952837048,285.7179562569833,284.5215384615382,289.4047394681588,279.63833745491763,277.35295000000025,278.51260000000013,286.8479999999999,286.9050000000003,281.47666666666663,70029356,83617286.55,38.04673792324498,1.1856765525817075,1.5,2.75,NaN,NaN,3.456765164890546,0.8374985471230889,1052.5873761171058,-0.7925589156014244,-1.524582950750471,-0.7320240351490465,15.033409466003432,-1.146788990825688,13.121594488625995,59.044041434669445,27.83436407670456,9211047483
1559136600,278.91,279.36,276.71,278.27,NaN,NaN,316.6028571428572,297.6871287128713,277.3189500000002,278.85320000000013,286.76679999999993,286.1175000000003,284.7518307627752,285.00862708965155,283.8761538461536,289.60307563155953,278.1492320607477,277.3189500000002,278.85320000000013,286.76679999999993,286.1175000000003,278.1133333333333,104972927,84810328.85,35.36667145476383,2.089094980183025,1.5,2.75,NaN,NaN,3.4555676531126496,1.237737530597961,1049.3192189813747,-0.9435348138800626,-1.9114425524991248,-0.9679077386190622,14.1781742804946,-2.3819546762085246,2.4631574463703187,83.21961592762744,14.317226626002242,9106074556
1559223000,279.11,280.04,277.805,279.03,NaN,NaN,317.3918367346939,297.8311881188119,277.2983000000002,279.11960000000016,286.69939999999997,285.4785000000003,284.5274452426664,284.43923403349424,283.17846153846136,288.88698604756274,277.46993702936,277.2983000000002,279.11960000000016,286.69939999999997,285.4785000000003,278.9583333333333,62523780,84352924.35,37.28979328172062,1.5736678946902012,1.5,2.75,NaN,NaN,3.36838424931889,0.7412165076882721,1050.61284542968,-0.9313762733738933,-2.132128080336429,-1.2007518069625356,13.66678138031143,-3.013555787278421,11.497364061369376,61.83844648757488,26.664189451055744,9168598336
1559309400,276.2,277.12,275.24,275.27,NaN,NaN,318.18081632653065,297.9752475247525,277.2641500000002,279.32850000000013,286.57379999999995,284.6830000000003,284.1644081743265,283.5659736493519,282.74846153846136,289.7796747882068,275.7172482887159,277.2641500000002,279.32850000000013,286.57379999999995,284.6830000000003,275.87666666666667,86862782,85444554.95,32.187185228615775,2.2628162072784965,1.5,2.75,NaN,NaN,3.398499660081824,1.0165982144892662,1046.9335112507829,-1.1039386433917746,-2.580675111202254,-1.4767364678104793,12.97811511977636,-3.6978729359081983,12.439314754587198,60.19643395313947,27.364251292273334,9081735554
1559568600,275.31,276.5521,273.09,274.57,NaN,NaN,273.09,298.1193069306931,277.2175000000002,279.50650000000013,286.37059999999997,283.71000000000026,283.78815687337254,282.70921425417555,282.06923076923056,290.3180254095268,273.8204361289343,277.2175000000002,279.50650000000013,286.37059999999997,283.71000000000026,274.7373666666667,96427952,87438769.9,31.3277246417246,2.479123118104844,1.5,2.75,NaN,NaN,3.403042541504552,1.102805450148493,1050.3401610945289,-1.1854363461511324,-2.958531900499395,-1.7730955543482625,12.945215531721477,-3.3033984856488803,2.3722131019933226,83.58542576747524,14.042361130531432,8985307602
1559655000,277.12,280.68,276.62,280.53,NaN,NaN,273.1013559322034,298.2633663366337,277.2112500000002,279.7321000000001,286.39619999999996,283.09550000000024,283.66038601559325,282.5016700394922,281.72076923076906,289.8160573628132,273.62548109872495,277.2112500000002,279.7321000000001,286.39619999999996,283.09550000000024,279.27666666666664,77231889,85940460.9,44.83429392314119,0.573075172687713,1.5,2.75,NaN,NaN,3.596396645682799,0.8986673819432588,1055.891437224093,-0.7778567451937963,-2.745416485840508,-1.9675597406467116,19.327111779504314,-2.08718718369342,13.105314949482969,59.13347252724069,27.761212523276335,9062539491
1559741400,282.33,282.99,280.32,282.96,NaN,NaN,273.1127118644068,298.4074257425743,277.2057500000002,279.9729000000001,286.47459999999995,282.84700000000026,283.63291989733466,282.5453205119215,281.3561538461537,288.7368085532408,273.9754991390666,277.2057500000002,279.9729000000001,286.47459999999995,282.84700000000026,282.09,71169717,82262451.35,49.2196419870958,0.43151887303310243,1.5,2.75,NaN,NaN,3.5302254567054576,0.865154342376645,1056.334016356746,-0.30860242185404596,-2.353312767964269,-2.044710346110223,19.260628962382256,-0.934775758848866,37.41041571269912,29.474908472819838,33.114675814481046,9133709208
1559827800,283.29,285.55,282.57,284.8,NaN,NaN,273.1240677966101,298.55148514851487,277.20445000000024,280.2311000000001,286.54819999999995,282.71050000000025,283.678687744498,282.7600518917385,281.2761538461537,288.48112451693595,274.07118317537146,277.20445000000024,280.2311000000001,286.54819999999995,282.71050000000025,284.3066666666667,69430381,81155556.05,52.31100021553222,0.9812508602602785,1.5,2.75,NaN,NaN,3.490923638369355,0.8555222141195594,1058.4848912081175,0.1377602812924703,-1.872509994494635,-2.0102702757871054,19.70322014235238,0.9427943574112232,38.74241839362148,28.26022361395017,32.99735799242836,9203139589
1559914200,285.93,288.85,285.74,287.65,NaN,NaN,273.1354237288135,298.6955445544554,277.21435000000025,280.5336000000001,286.7081999999999,282.7600000000003,283.8344254800079,283.22576123538244,281.5607692307691,289.42766368806485,273.69387477347334,277.21435000000025,280.5336000000001,286.7081999999999,282.7600000000003,287.41333333333336,74272199,79695610.8,56.70723262917759,1.8796235146449674,1.5,2.75,NaN,NaN,3.5308576642001164,0.9319484254457838,1062.689055810033,0.6105177468166048,-1.2471230922663494,-1.8576408390829542,18.865186110454605,1.7221868590423668,69.28706352973927,7.691559678989633,23.02137679127109,9277411788
1560173400,289.37,290.82,288.8734,288.97,NaN,NaN,273.1467796610169,298.839603960396,277.22750000000025,280.8198000000001,286.87339999999995,282.80350000000027,284.0358205592233,283.77283159391743,281.7499999999999,290.18203415551443,273.31796584448534,277.22750000000025,280.8198000000001,286.87339999999995,282.80350000000027,289.55446666666666,60799053,77114098.8,58.61035990984411,2.1071022435890123,1.5,2.75,NaN,NaN,3.5050821167572517,0.7884297935930751,1065.0734184471303,0.9760036914289401,-0.6376362247967791,-1.6136399162257191,18.926491789690964,3.148313403533839,100,0,0,9338210841
1560259800,290.99,291.4,288.1805,288.9,NaN,NaN,273.1581355932203,298.9836633663366,277.2411500000003,281.0990000000001,287.00179999999995,283.20550000000026,284.2265726941557,284.26113334687767,282.0015384615383,291.0538304659011,272.9492464571755,277.2411500000003,281.0990000000001,287.00179999999995,283.20550000000026,289.4935,58641325,73681638.7,58.46358671936263,1.8177847065121335,1.5,2.75,NaN,NaN,3.4846833941317326,0.7958743322574882,1065.6942377982032,1.1641634852305152,-0.15843555968757528,-1.3225990449180904,17.57708544507166,3.8200309052359205,80.10647365357693,3.4091668663917893,16.484359480031276,9279569516
1560346200,288.64,289.26,287.815,288.39,NaN,NaN,273.1694915254237,299.1277227722772,277.25415000000027,281.3533000000001,287.05299999999994,283.45500000000027,284.38984435320845,284.65435874241314,282.48230769230753,292.15552894829,272.80908643632506,277.25415000000027,281.3533000000001,287.05299999999994,283.45500000000027,288.48833333333334,47096312,72186292.8,57.337001260231894,1.2669754467420036,1.5,2.75,NaN,NaN,3.3389917231223225,0.6524273539089405,1064.551027103244,1.2005818996232374,0.17812832961095637,-1.022453570012281,16.77780036424428,3.3544780131168745,57.23708559091829,14.262514768028904,28.500399641052795,9232473204
1560432600,289.4,289.98,288.62,289.58,NaN,NaN,273.18084745762707,299.2717821782178,277.2645000000003,281.58450000000016,287.12519999999995,283.68100000000027,284.5933798687689,285.1234674336119,283.00538461538446,293.3952927822448,272.61547644852413,277.2645000000003,281.58450000000016,287.12519999999995,283.68100000000027,289.3933333333334,48945156,70935730.25,59.30740637374435,1.3401831360931091,1.5,2.75,NaN,NaN,3.214063742899302,0.6899929813579384,1068.5019454898425,1.2457363031485496,0.534716808923406,-0.7110194942251435,16.771172899153736,5.198532350056309,53.90975599628823,16.41593426620525,29.6743097375065,9281418360
1560519000,289.26,289.93,288.41,289.26,NaN,NaN,273.19220338983047,299.4158415841584,277.26190000000025,281.8485000000001,287.18199999999996,283.7590000000003,284.7763845797976,285.51742291612504,283.7061538461537,294.45390649413196,272.95840119817547,277.26190000000025,281.8485000000001,287.18199999999996,283.7590000000003,289.2,52324716,69714483.9,58.524642778279365,1.133180973931521,1.5,2.75,NaN,NaN,3.093059189835065,0.7505573171144138,1066.2986421846788,1.1947952295848743,0.7824745427559492,-0.412320686828925,13.232872472533087,5.350183923953818,23.338421936404263,44.51128424726486,32.15029381633087,9229093644
1560778200,289.52,290.22,289.18,289.37,NaN,NaN,273.20355932203387,299.559900990099,277.2591500000003,282.10810000000015,287.22579999999994,283.9355000000003,284.956526360982,285.8843350193512,284.55999999999983,295.2077993392587,273.91220066074095,277.2591500000003,282.10810000000015,287.22579999999994,283.9355000000003,289.59000000000003,39205709,66657118.15,58.72630402071573,1.0944879378195393,1.5,2.75,NaN,NaN,2.9464121048468472,0.5881698772481361,1067.725654320704,1.1110122033440728,0.9764445673511659,-0.13456763599290678,12.723698064818644,3.151178127116541,16.76747102390994,53.3297481618088,29.902780814281257,9268299353
1560864600,291.39,293.57,290.99,292.4,NaN,NaN,273.21491525423727,299.7039603960396,277.2637500000003,282.39660000000015,287.3023999999999,284.3580000000003,285.24842728800235,286.50487454131775,285.5884615384614,296.4810132523676,274.6959098245552,277.2637500000003,282.39660000000015,287.3023999999999,284.3580000000003,292.32,85434823,67784978.8,63.92896507328439,1.729006495873286,1.5,2.75,NaN,NaN,3.0359540973577857,1.2603798734241103,1071.4658898349635,1.194851878901521,1.3589972126339944,0.16414533373247348,8.431650155527107,3.3361605880689846,52.96393382739897,17.015991214783394,30.020074957817638,9353734176
1560951000,292.55,293.65,291.47,293.06,NaN,NaN,273.22627118644067,299.8480198019802,277.27755000000025,282.66940000000017,287.3877999999999,284.6855000000003,285.5547634727866,287.1291722040494,286.9569230769229,296.7330836717673,277.18076248207853,277.27755000000025,282.66940000000017,287.3877999999999,284.6855000000003,292.7266666666667,78674377,69376343.4,64.96492096374315,1.6113116038311663,1.5,2.75,NaN,NaN,2.974814518975083,1.1340231142824975,1073.6102976433071,1.2253880298499813,1.6958803710449502,0.47049234119496885,7.9741392326404235,2.9002808988764013,80.1823789709913,3.3728149710443662,16.444806057964357,9432408553
1561037400,296.04,296.3093,293.1255,295.86,NaN,NaN,273.237627118644,299.99207920792077,277.3053000000003,282.9904000000002,287.55879999999996,285.19700000000023,285.95889039542243,287.96067961318755,288.5946153846152,296.4701026335581,280.71912813567235,277.3053000000003,282.9904000000002,287.55879999999996,285.19700000000023,295.0982666666667,116570017,72730720.65,69.02878925145436,2.112063271381038,1.5,2.75,NaN,NaN,2.994420624762578,1.602761748518437,1077.2270376230138,1.354690702122355,2.1638557188479126,0.8091650167255576,8.554008647565816,2.854163045367647,84.27896708155285,2.1767432437950154,13.54428967465215,9548978570
1561123800,294.13,295.52,293.76,294,NaN,NaN,273.2489830508474,300.13613861386136,277.3262500000003,283.2963000000002,287.67299999999994,285.79000000000025,286.27422802697447,288.53585298336014,289.6307692307691,296.4650469160355,282.7964915455027,277.3262500000003,283.2963000000002,287.67299999999994,285.79000000000025,294.4266666666667,83309466,71959501.6,63.73964109736523,1.553461771789066,1.5,2.75,NaN,NaN,2.9305334372795384,1.1577271124401451,1074.5528059293276,1.2386421292657817,2.357467678307785,1.1188255490420032,9.331585027703758,1.7406651209468016,75.31808457572991,5.094248270292153,19.58766715397793,9465669104
1561383000,294.23,294.58,293.47,293.64,NaN,NaN,273.2603389830508,300.28019801980196,277.3493000000003,283.55690000000016,287.7815999999999,286.33300000000025,286.5630818298382,289.02196222304013,290.4523076923075,296.3904408039957,284.5141745806193,277.3493000000003,283.55690000000016,287.7815999999999,286.33300000000025,293.89666666666665,47582730,71575233.35,62.73766339762856,1.1648407444906728,1.5,2.75,NaN,NaN,2.8004953346167114,0.6647932220817553,1071.966162998909,1.0677989869185787,2.4535742826902265,1.3857752957716478,9.380662242218895,1.6407061266874383,61.095414016191135,11.970328534898975,26.934257448909886,9418086374
1561469400,293.7,293.73,290.64,290.76,NaN,NaN,273.2716949152542,300.42425742574255,277.3623000000003,283.76520000000016,287.7935999999999,286.8635000000003,286.7276668561191,289.18748963036967,290.910769230769,295.8725707741902,285.9489676873478,277.3623000000003,283.76520000000016,287.7935999999999,286.8635000000003,291.71,82028656,72175198.35,55.25441596562055,0.4103841249894068,1.5,2.75,NaN,NaN,2.821174239286949,1.1365213795771993,1069.0293279677915,0.7083133070834067,2.271166929625906,1.5628536225424994,11.459143765807388,0.821803807344223,32.44773538936214,34.317238300915484,33.235026309722386,9336057718
1561555800,291.75,292.31,290.345,290.47,NaN,NaN,273.2830508474576,300.56831683168315,277.3766500000003,283.96930000000015,287.80359999999996,287.47350000000034,286.8744250186242,289.30963347509635,291.12769230769214,295.73415034196273,286.52123427342156,277.3766500000003,283.96930000000015,287.80359999999996,287.47350000000034,291.0416666666667,51584902,69505797.1,54.5488501047658,0.18300704560500908,1.5,2.75,NaN,NaN,2.7600189364807366,0.7421669004929663,1070.3600545863474,0.41310833270671776,2.0792390384258965,1.6661307057191788,11.408510498007946,0.3073416672422278,13.071050081046558,59.21911897850575,27.7098309404477,9284472816
1561642200,291.31,292.06,290.89,291.5,NaN,NaN,273.29440677966096,300.71237623762374,277.3936500000003,284.16470000000015,287.83039999999994,288.0970000000003,287.05582011593305,289.51823981080145,291.3223076923075,295.75830834327803,286.886307041337,277.3936500000003,284.16470000000015,287.83039999999994,288.0970000000003,291.48333333333335,40355239,68397370.05,56.66540352064763,0.36720793155479237,1.5,2.75,NaN,NaN,2.6764461553035397,0.5900115599547091,1074.0032300244409,0.2569661505329841,1.987338393885409,1.730372243352425,11.350297632777096,0.7743898223051957,2.1664968743399053,84.36820125016634,13.465301875493761,9324828055
1561728600,292.58,293.55,292.01,293,NaN,NaN,273.30576271186436,300.85643564356434,277.4134000000003,284.36370000000016,287.9013999999999,288.9835000000004,287.2889252094259,289.84983601929656,291.63769230769213,295.9203166206661,287.3550679947182,277.4134000000003,284.36370000000016,287.9013999999999,288.9835000000004,292.8533333333333,59350929,67021777.4,59.614876938751316,0.6369731398384869,1.5,2.75,NaN,NaN,2.6317000013532876,0.8855469267217614,1078.0674731629792,0.22557968777867532,2.012346853075769,1.7867671652970938,11.557188855571738,1.2544493209385892,17.629756972042447,52.16618115754399,30.204061870413554,9384178984
1561987800,296.68,296.92,294.33,295.66,NaN,NaN,273.31711864406776,301.00049504950493,277.4461000000003,284.59290000000016,288.0141999999999,290.03800000000035,287.6172026521935,290.40318496983974,292.1969230769229,296.5354331694294,287.85841298441636,277.4461000000003,284.59290000000016,288.0141999999999,290.03800000000035,295.6366666666667,79107474,66155753.5,64.26039865344003,1.3468489126036642,1.5,2.75,NaN,NaN,2.723721429828054,1.1957761768974486,1080.2109737098872,0.34754737156780413,2.221201379756849,1.8736540081890447,12.348013030346548,1.1149110807113707,45.0823550589097,22.872347624407254,32.04529731668306,9463286458
1562074200,295.61,296.49,294.68,296.43,NaN,NaN,273.32847457627116,301.14455445544553,277.4741000000003,284.85580000000016,288.1373999999999,290.8330000000004,287.9628025481859,290.9771673536645,292.72384615384595,297.3193257954414,288.1283665122505,277.4741000000003,284.85580000000016,288.1373999999999,290.8330000000004,295.86666666666673,61504544,65369386.25,65.49764339133264,1.1908004123686506,1.5,2.75,NaN,NaN,2.6584556134117645,0.9408768772094751,1081.97648249678,0.4378332005437453,2.4209455088687264,1.983112308324981,11.197213615553983,1.1499351668600302,80.30595349377259,3.3429765913783536,16.35106991484905,9524791002
1562160600,297.18,298.82,297.02,298.8,NaN,NaN,273.33983050847456,301.2886138613861,277.5137000000003,285.13910000000016,288.2557999999999,291.6250000000004,288.38779068355115,291.72219903426793,293.45769230769207,298.6183550787771,288.29702953660706,277.5137000000003,285.13910000000016,288.2557999999999,291.6250000000004,298.2133333333333,40898896,63855845.2,69.04920992764697,1.657710427789202,1.5,2.75,NaN,NaN,2.63928021245378,0.6404878969482343,1084.151128138106,0.6046388760368093,2.738910903370993,2.1342720273341835,11.822633345562503,0.9937132427499484,100,0,0,9565689898
1562333400,297.44,298.64,296.01,298.46,NaN,NaN,273.3511864406779,301.4326732673267,277.55930000000035,285.41750000000013,288.3803999999999,292.3080000000004,288.7827792841962,292.3638943643376,294.15692307692285,299.3756254480158,288.9382207058299,277.55930000000035,285.41750000000013,288.3803999999999,292.3080000000004,297.7033333333333,51677326,62968192.45,67.96829178765154,1.4008409379680467,1.5,2.75,NaN,NaN,2.6500459115642263,0.820689366953553,1083.3752790886301,0.6363375164981395,2.929693922956858,2.2933564064587184,10.87119341740235,1.5170068027210815,79.8860145189153,3.478482628015821,16.635502853068875,9514012572
1562592600,297.01,298.2579,296.22,296.82,NaN,NaN,273.3625423728813,301.5767326732673,277.5888500000003,285.64470000000017,288.47579999999994,292.7665000000004,289.09796441030613,292.78828537725786,294.4969230769228,299.7888814732825,289.20496468056314,277.5888500000003,285.64470000000017,288.47579999999994,292.7665000000004,297.0993,45841772,61546671.1,62.856927280391105,0.907595308201842,1.5,2.75,NaN,NaN,2.6207569178810637,0.7448294307504797,1080.9177661021456,0.4972786848663828,2.914954762541697,2.4176760776753143,10.687151683954033,1.0829587249693526,55.315740545538056,15.458910441960942,29.225349012501013,9468170800
1562679000,295.54,297.52,295.48,297.19,NaN,NaN,273.3738983050847,301.7207920792079,277.61870000000033,285.86670000000015,288.55139999999994,293.17750000000035,289.41529913931373,293.2074962937095,294.81461538461514,300.21807647136376,289.4111542978665,277.61870000000033,285.86670000000015,288.55139999999994,293.17750000000035,296.73,41101279,60561782.4,63.523407581505374,0.700699539023175,1.5,2.75,NaN,NaN,2.579274280889557,0.6786669310446187,1081.8601036212967,0.38562217714820335,2.8997037991105685,2.514081621962365,10.596645522547215,2.2114458660063305,47.35490815885049,21.073489371686733,31.571602469462785,9509272079
1562765400,298.37,299.66,297.78,298.61,NaN,NaN,273.3852542372881,301.8648514851485,277.6438500000003,286.10900000000015,288.6461999999999,293.66300000000035,289.7758756436544,293.72202045621333,295.0261538461536,300.7806679990762,289.271639693231,277.6438500000003,286.10900000000015,288.6461999999999,293.66300000000035,298.68333333333334,58595558,60559494.05,66.04181107406369,1.1172843119399003,1.5,2.75,NaN,NaN,2.5714689751117334,0.9675701377495244,1084.5275714496659,0.36312376988948625,2.967986334324223,2.604862564434737,8.030591544624876,2.802354804282709,46.74818176201398,21.53873957512027,31.713078662865748,9567867637
1562851800,299.32,299.58,298.2,299.31,NaN,NaN,273.3966101694915,302.0089108910891,277.6804500000003,286.32840000000016,288.7519999999999,294.2090000000004,290.149762873315,294.254208984193,295.43461538461514,301.58031614775194,289.28891462147834,277.6804500000003,286.32840000000016,288.7519999999999,294.2090000000004,299.03,50889481,60749152.5,67.24246179954291,1.0413444304425061,1.5,2.75,NaN,NaN,2.486364048318038,0.8376986164539497,1084.6159597973142,0.35091098593200254,3.0435012968497404,2.692590310917738,7.695900341527588,2.6792452830188687,49.1641706157566,19.718304591550034,31.117524792693363,9618757118
1562938200,299.85,300.73,299.51,300.65,NaN,NaN,273.40796610169485,302.1529702970297,277.7286000000003,286.55640000000017,288.9287999999999,294.7625000000004,290.56153687828305,294.86333193807934,295.9738461538459,302.60595703008124,289.34173527761055,277.7286000000003,286.55640000000017,288.9287999999999,294.7625000000004,300.2966666666667,40354410,60319615.2,69.46792267090552,1.2443217096659762,1.5,2.75,NaN,NaN,2.4101951877238936,0.6690097386430276,1087.603111772537,0.38582875343419065,3.174876252710476,2.7890474992762853,7.737961559119669,2.610921501706477,77.62575906824901,4.240899744422383,18.13334118732861,9659111528
1563197400,301.13,301.13,300.19,300.75,NaN,NaN,273.41932203389825,302.2970297029703,277.7786000000003,286.7798000000002,289.1201999999999,295.33700000000033,290.9610844516837,295.4239669915956,296.7423076923074,303.08875262736444,290.39586275725037,277.7786000000003,286.7798000000002,289.1201999999999,295.33700000000033,300.69,33910261,59398892.45,69.63372100765173,1.1657015863828069,1.5,2.75,NaN,NaN,2.3051812457436154,0.5708904594230358,1087.1438324457652,0.3684433055413314,3.2496016312029496,2.8811583256616182,7.764654754450638,1.721572076033273,100,0,0,9693021789
1563283800,300.65,300.88,299.44,299.71,NaN,NaN,273.43067796610165,302.4410891089109,277.8277500000003,287.0027000000002,289.23379999999986,295.8540000000004,291.3041791790686,295.8321606114436,297.4530769230766,302.82534981045666,292.08080403569653,277.8277500000003,287.0027000000002,289.23379999999986,295.8540000000004,300.01,40567964,59467005.2,65.64145009047294,0.8224657705438035,1.5,2.75,NaN,NaN,2.243382585333357,0.6821928204314549,1087.917324913919,0.24559469585327465,3.1881516954782114,2.9425569996249368,7.27862178009844,1.106500691562923,79.20975364344311,3.694995780968522,17.095250575588373,9652453825
1563370200,299.75,299.93,297.74,297.74,NaN,NaN,273.44203389830506,302.5851485148515,277.86300000000034,287.1887000000002,289.3321999999999,296.1210000000004,291.5565643093012,296.01385960082996,297.93307692307656,302.06353701753875,293.80261682861436,277.86300000000034,287.1887000000002,289.3321999999999,296.1210000000004,298.47,44102443,57400386.2,58.76822529661915,0.3013210454654222,1.5,2.75,NaN,NaN,2.239569543523831,0.7683300744063635,1085.4331872021687,0.003173559289533223,2.9465239487368535,2.9433503894473203,8.510556779844778,-0.3547523427041507,47.80952497159852,20.73120448783172,31.45927054056975,9608351382
1563456600,297.19,299.25,296.7,298.83,NaN,NaN,273.4533898305084,302.7292079207921,277.90355000000034,287.3818000000002,289.55019999999985,296.4095000000003,291.8417970814855,296.28206344836997,298.3815384615381,301.38420236760857,295.3788745554677,277.90355000000034,287.3818000000002,289.55019999999985,296.4095000000003,298.26,51701687,56051751.7,61.1896706106141,0.25369971580228456,1.5,2.75,NaN,NaN,2.261743147557844,0.9223919936832232,1087.1572745155668,-0.10621038595602617,2.810587407002288,2.916797792958314,7.407188141082196,0.1239697111840798,48.011471511920284,20.578901909325186,31.40962657875452,9660053069
1563543000,300.04,300.07,296.96,297.17,NaN,NaN,273.4647457627118,302.8732673267327,277.9307500000003,287.5603000000002,289.7429999999998,296.47500000000036,292.05074621554485,296.3666288342395,298.497692307692,301.1687699219568,295.82661469342713,277.9307500000003,287.5603000000002,289.7429999999998,296.47500000000036,298.06666666666666,71081238,53777312.75,55.81378086005665,0.13373905250647852,1.5,2.75,NaN,NaN,2.322332922732284,1.3217699874748763,1085.4716678469547,-0.3017316104286527,2.539633279922498,2.8413648903511506,8.064421944343906,0.11791658244054401,16.946037596753868,53.083522583934105,29.970439819312027,9588971831
1563802200,297.61,298.5,297.04,297.9,NaN,NaN,273.4761016949152,303.01732673267327,277.96245000000033,287.7473000000002,289.96779999999984,296.67000000000036,292.280128716896,296.51266418335956,298.6107692307689,301.03521475390403,296.18632370763373,277.96245000000033,287.7473000000002,289.96779999999984,296.67000000000036,297.81333333333333,43687404,51796209.65,57.578820382827104,0.06954416312218203,1.5,2.75,NaN,NaN,2.2607377139656912,0.8434478950333772,1084.6108500995513,-0.38778054319564514,2.356639211356594,2.744419754552239,7.506921797885642,0.23890440458964957,18.30472516341509,51.130361803672876,30.56491303291204,9632659235
1563888600,299.14,300.03,298.22,300.03,NaN,NaN,273.4874576271186,303.16138613861386,278.0040000000003,287.9608000000002,290.20639999999986,296.9895000000003,292.58404523780206,296.84764854684914,298.7053846153843,301.2452406426239,296.16552858814464,278.0040000000003,287.9608000000002,290.20639999999986,296.9895000000003,299.4266666666667,44657973,51649971.8,62.309668219807925,0.535097981926185,1.5,2.75,NaN,NaN,2.2513993058252844,0.8646272484508889,1087.5826943766087,-0.3104749774648772,2.3563260327211424,2.6668010101860196,8.455453571523217,0.47553665315962595,39.349327531735746,27.678761933510074,32.97191053475417,9677317208
1563975000,299.19,301.44,299.09,301.44,NaN,NaN,273.498813559322,303.30544554455446,278.0640000000003,288.1710000000002,290.6179999999998,297.5235000000003,292.93133758141767,297.2850153519111,298.93461538461503,301.8540527949738,296.01517797425623,278.0640000000003,288.1710000000002,290.6179999999998,297.5235000000003,300.6566666666667,47213232,49909200.6,65.08545923335345,0.7970206796584629,1.5,2.75,NaN,NaN,2.2584422125520516,0.9459825329280068,1091.2360994213652,-0.18007554494770295,2.4417065790013908,2.6217821239490937,8.44268435201026,0.711636764558483,65.16378080858229,9.707787284599654,25.128431906818065,9724530440
1564061400,300.94,301,299.11,300,NaN,NaN,273.51016949152535,303.44950495049505,278.1249000000003,288.3770000000002,290.9499999999999,298.0000000000003,293.2085400292052,297.54358531839574,299.1792307692304,301.87313798642435,296.48532355203645,278.1249000000003,288.3770000000002,290.9499999999999,298.0000000000003,300.0366666666667,55394092,50099660.1,60.20856700299618,0.43473399726932865,1.5,2.75,NaN,NaN,2.263553483084047,1.1056780003982503,1087.6052874324398,-0.2047035723432411,2.3659026585200422,2.5706062308632833,8.983389475111352,-0.216198237152828,35.00462372314214,31.70952339801125,33.285852878846626,9669136348
1564147800,300.76,302.23,300.62,302.01,NaN,NaN,273.52152542372875,302.23,278.1958500000003,288.60690000000017,291.2889999999999,298.5255000000003,293.55369532217753,297.9689581452152,299.5499999999996,302.37051822846365,296.7294817715356,278.1958500000003,288.60690000000017,291.2889999999999,298.5255000000003,301.62,45084077,50336102,64.23679351954021,0.9147127174532014,1.5,2.75,NaN,NaN,2.261156805720902,0.8956608717933701,1090.6804941818673,-0.10457126531950367,2.439892149213904,2.5444634145334075,9.441604539974463,0.41895261845386234,70.81256091635186,6.978292702641072,22.20914638100707,9714220425
1564407000,301.88,301.93,300.85,301.46,NaN,NaN,273.53288135593215,302.35133333333334,278.2661500000003,288.84820000000013,291.56419999999986,298.9485000000003,293.8637464860137,298.3014383218614,299.7692307692303,302.7041396163676,296.834321922093,278.2661500000003,288.84820000000013,291.56419999999986,298.9485000000003,301.41333333333336,38126462,49274878.65,62.37602098483707,0.6558284405700945,1.5,2.75,NaN,NaN,2.182502748169407,0.77375050014456,1091.397265740936,-0.09462557899299551,2.4261814407921634,2.520807019785159,9.531885212823331,0.5838977678422476,48.493105259091465,20.278761192548266,31.228133548360262,9676093963
1564493400,299.91,301.17,299.49,300.72,NaN,NaN,273.54423728813555,302.47266666666667,278.3782500000003,289.10530000000017,291.86179999999985,299.2015000000003,294.1326191728367,298.53177752930316,299.87769230769186,302.8407796149889,296.91460500039483,278.3782500000003,289.10530000000017,291.86179999999985,299.2015000000003,300.46000000000004,45849045,47611957.2,59.86341364091405,0.3435082671097483,1.5,2.75,NaN,NaN,2.1673239804430184,0.9629733305733543,1093.4849279102857,-0.15363817391609524,2.32875930239004,2.482397476306135,9.40593735894569,1.000873245113192,22.423660212077337,45.6984640354059,31.877875752516758,9630244918
1564579800,300.99,301.2,295.2,297.43,NaN,NaN,273.55559322033895,302.594,278.50455000000034,289.3350000000002,292.1313999999998,299.2515000000003,294.26192822488235,298.4268463360362,299.62999999999954,302.8228670501839,296.4371329498152,278.50455000000034,289.3350000000002,292.1313999999998,299.2515000000003,297.9433333333333,104245162,49748988.1,50.18452231368956,0.47996633961486446,1.5,2.75,NaN,NaN,2.441086553268517,2.0954227609706897,1090.6717484821966,-0.41516381610187114,1.963442706178796,2.378606522280667,10.823206192454846,-0.4684937924572424,3.1378420371489897,80.98731762941671,15.874840333434308,9525999756
1564666200,297.6,300.87,293.96,294.84,NaN,NaN,273.5669491525423,302.7153333333334,278.59900000000033,289.4990000000002,292.29799999999983,299.0535000000003,294.2845977062595,298.0852419230804,299.17538461538413,303.18056292033725,295.170206310431,278.59900000000033,289.4990000000002,292.29799999999983,299.0535000000003,296.5566666666666,142646576,54836372.1,44.134819514707566,1.0081838413149504,1.5,2.75,NaN,NaN,2.760294656606482,2.6013131528808775,1087.2708971955797,-0.7442924996799243,1.448240897680762,2.192533397360686,11.559952925323982,-0.7840629942457317,1.8251733028466324,85.71891003530207,12.455916661851287,9383353180
1564752600,293.85,294.12,290.9,292.62,NaN,NaN,273.5783050847457,302.8366666666667,278.6901000000003,289.63030000000015,292.43779999999987,298.7615000000003,294.21931936483753,297.5647426923108,298.6299999999995,303.920199938062,293.33980006193696,278.6901000000003,289.63030000000015,292.43779999999987,298.7615000000003,292.5466666666667,116749695,58089990.55,39.715437994360606,1.8449113799495285,1.5,2.75,NaN,NaN,2.844559323991733,2.009807436610093,1084.7295720819168,-1.0732310616873595,0.850994570251487,1.9242256319388464,11.876952636010078,-1.7724068479355397,0,100,0,9266603485
1565011800,288.09,288.21,281.72,283.82,NaN,NaN,281.72,302.958,278.7072000000003,289.6551000000002,292.47139999999985,298.1115000000003,293.81150291915765,296.2557195787574,297.5592307692302,307.07996267884056,288.0384988596199,278.7072000000003,289.6551000000002,292.47139999999985,298.1115000000003,284.5833333333333,178745449,64735174.4,27.822470879406666,4.232887828690943,1.5,2.75,NaN,NaN,3.419947943706607,2.761179693369298,1077.5169623510055,-1.8022810734502914,-0.32862570987401796,1.4736553635762735,20.057438411304737,-5.402793054027924,0,100,0,9087858036
1565098200,285.91,288.04,284.28,287.8,NaN,NaN,281.9161363636364,303.07933333333335,278.7439500000003,289.72150000000016,292.5717999999998,297.64200000000034,293.57575770664164,295.4504129522091,296.71076923076873,307.50768178529563,285.91385667624183,278.7439500000003,289.72150000000016,292.5717999999998,297.64200000000034,286.70666666666665,120711682,68715694.55,37.00979367917283,2.7765440747396926,1.5,2.75,NaN,NaN,3.477094519156137,1.7566828479360834,1081.043055562101,-1.924197677438374,-0.9315917332216941,0.9926059442166799,21.838138501253688,-4.524946921443732,3.6245851698721423,79.42949802236797,16.945916807759897,9208569718
1565184600,284.4,288.82,282.04,287.97,NaN,NaN,282.11227272727274,303.2006666666667,278.80180000000036,289.78810000000016,292.7281999999998,297.11000000000035,293.3559240710871,294.7379926710463,296.00307692307643,307.75097594209456,284.2551779040583,278.80180000000036,289.78810000000016,292.7281999999998,297.11000000000035,286.2766666666667,140572265,72814529.9,37.37646343374714,2.5904829578447175,1.5,2.75,NaN,NaN,3.7130163392164106,1.9305523937743638,1079.6357914941796,-1.8979434171363683,-1.3798233272037805,0.5181200899325877,21.352874895003115,-4.009999999999991,17.376760402307703,52.4672511320753,30.155988465616993,9349141983
1565271000,289.62,293.62,289.01,293.62,NaN,NaN,282.3084090909091,303.322,278.8886500000003,289.9010000000001,293.0351999999998,296.8255000000003,293.36627998986796,294.6315171785657,295.67384615384566,307.43053731174984,283.9171549959415,278.8886500000003,289.9010000000001,293.0351999999998,296.8255000000003,292.0833333333333,87713904,74655751.05,48.174190819465686,0.5573554404088642,1.5,2.75,NaN,NaN,3.851372314986665,1.1749115475545135,1084.5974868750582,-1.426148226669267,-1.264565193403996,0.16158303326527096,25.392654193977855,-2.778053706830895,38.25868400498037,28.666503903728636,33.074812091291,9436855887
1565357400,292.58,293.24,289.65,291.62,NaN,NaN,282.5045454545455,303.4433333333334,278.97170000000034,289.9932000000001,293.2869999999998,296.37400000000036,293.2977984216378,294.34470601870225,295.0269230769226,306.6786813057328,283.37516484811243,278.97170000000034,289.9932000000001,293.2869999999998,296.37400000000036,291.50333333333333,93729958,77324528.45,45.20301467592602,0.6572010998382194,1.5,2.75,NaN,NaN,3.8598457210590484,1.2121633313368108,1081.7045006377302,-1.1847835441420878,-1.3193963969123388,-0.13461285277025103,24.85344422336183,-3.2641146420752256,41.17722252943278,26.088716459797958,32.73406101076927,9343125929
1565616600,289.96,291.6052,287.02,288.07,NaN,NaN,282.70068181818186,303.5646666666667,279.0440000000003,290.0584000000001,293.54299999999984,295.74000000000035,293.0927867188285,293.74711496930206,293.9984615384611,305.564352627629,282.43257044929317,279.0440000000003,290.0584000000001,293.54299999999984,295.74000000000035,288.8984,65527632,78905397,40.43581628086246,1.5862319703576373,1.5,2.75,NaN,NaN,3.9127138838405466,0.8304581751233062,1077.9362119014468,-1.196717992868442,-1.6305103438558035,-0.4337923509873615,25.31059882772481,-4.206570896515042,60.009414534491164,12.54885851548713,27.44172695002171,9277598297
1565703000,287.74,294.15,287.36,292.55,NaN,NaN,282.8968181818182,303.68600000000004,279.18015000000037,290.1366000000001,293.9025999999998,295.38200000000035,293.07150096514897,293.6331040198447,293.42538461538413,304.47161088470284,282.3791583460654,279.18015000000037,290.1366000000001,293.9025999999998,295.38200000000035,291.3533333333333,94792972,81616647.4,47.9027902084212,0.43998577721725707,1.5,2.75,NaN,NaN,4.118234320709076,1.1614416301054777,1081.7973057849222,-0.8516064034890738,-1.4983003553487038,-0.64669395185963,27.802861217849703,-1.6407221867330113,57.707562171292984,13.934919267940485,28.35751856076654,9372391269
1565789400,288.07,288.74,283.76,283.9,NaN,NaN,283.0929545454546,303.80733333333336,279.24925000000036,290.18310000000014,293.9699999999998,294.69000000000034,292.71183426063334,292.70614173224044,292.03230769230714,302.9638545709446,281.1007608136697,279.24925000000036,290.18310000000014,293.9699999999998,294.69000000000034,285.46666666666664,135622053,86192627.9,37.99804207215037,2.3738820382685137,1.5,2.75,NaN,NaN,4.451931869229858,1.573476250861589,1075.1506692085945,-1.1367815370116108,-2.0676708731241433,-0.9308893361125327,31.720674697792933,-3.7104870438203768,19.65642032068406,49.23452992680683,31.109049752509105,9236769216
1565875800,284.88,285.64,282.39,284.65,NaN,NaN,283.28909090909093,303.9286666666667,279.3458500000004,290.23920000000015,294.0037999999998,293.98100000000034,292.39568389747126,291.93889013869375,290.73923076923023,300.8501736957821,280.6282878426784,279.3458500000004,290.23920000000015,294.0037999999998,293.98100000000034,284.22666666666663,101929845,88704035.8,39.17243359234741,2.1788430146459934,1.5,2.75,NaN,NaN,4.3660795928562965,1.1491004223282477,1076.7532239871223,-1.1995818310810331,-2.430366624963824,-1.230784793882791,31.85565149205101,-2.7236689221516053,21.200024213300363,47.17535102607043,31.624624760629224,9338699061
1565962200,286.48,289.33,284.7138,288.85,NaN,NaN,283.4852272727273,304.05,279.47080000000034,290.31650000000013,294.0847999999998,293.56500000000034,292.2566374701195,291.64471012548483,289.82615384615326,298.15343076172167,281.49887693058486,279.47080000000034,290.31650000000013,294.0847999999998,293.56500000000034,287.63126666666665,85825286,89441238.2,45.40842924039054,0.890407437398162,1.5,2.75,NaN,NaN,4.388502479080847,0.9595717560180198,1081.4285821936103,-0.8968047588957571,-2.3517907425024873,-1.4549859836067303,33.33550939745155,1.77225001761681,45.502335364796735,22.50045416037198,31.997210474831277,9424524347
1566221400,292.19,293.08,291.44,292.33,NaN,NaN,283.6813636363637,304.17133333333334,279.5936000000004,290.44330000000014,294.17839999999984,293.28650000000033,292.25951443207555,291.7099758278196,289.4338461538456,296.7047895418483,282.1629027658429,279.5936000000004,290.44330000000014,294.17839999999984,293.28650000000033,292.2833333333333,53640153,89938875.65,49.98384246435359,0.7075838950133737,1.5,2.75,NaN,NaN,4.377180873432212,0.5964067552805792,1085.2140936633298,-0.42466766889009677,-1.9858205697193512,-1.5611529008292544,28.24132880266046,1.5740097289784478,63.68539508445292,10.490443806577066,25.824161108970014,9478164500
1566307800,291.77,292.36,289.95,290.09,NaN,NaN,283.87750000000005,304.2926666666667,279.69090000000034,290.5371000000001,294.20079999999984,292.7895000000004,292.1744354347392,291.5556924156463,289.06846153846095,295.6618141170084,282.4751089599135,279.69090000000034,290.5371000000001,294.20079999999984,292.7895000000004,290.79999999999995,51652752,90288614.6,47.23934963595716,0.12152802835089611,1.5,2.75,NaN,NaN,4.236667953901342,0.5720848883199057,1082.8838952680417,-0.23519834070925905,-1.8551508267158283,-1.6199524860065693,27.891791887330804,0.7361877973399825,41.48773203034915,25.8152851854309,32.696982784219934,9426511748
1566394200,292.48,292.86,291.72,292.45,NaN,NaN,284.0736363636364,304.41400000000004,279.78560000000033,290.63680000000016,294.27179999999987,292.3400000000004,292.1852418882789,291.6408645665371,289.055384615384,295.62112607747065,282.4896431532974,279.78560000000033,290.63680000000016,294.27179999999987,292.3400000000004,292.3433333333333,49723430,90414124.5,50.33352193487429,0.5504519589669566,1.5,2.75,NaN,NaN,4.131905957194106,0.5499520155172215,1086.5038630395372,0.061265333433346836,-1.5433708192148856,-1.6046361526482324,28.202506564869335,-0.39847421837750013,82.23899761773056,2.7462487720330246,15.01475361023641,9476235178
1566480600,293.23,293.93,290.4,292.36,NaN,NaN,284.26977272727277,304.53533333333337,279.88795000000033,290.70210000000014,294.3511999999999,291.95800000000037,292.19209514756204,291.70935365543835,289.7123076923071,295.73802771361903,283.68658767099515,279.88795000000033,290.70210000000014,294.3511999999999,291.95800000000037,292.22999999999996,51739292,90231384.5,50.21258412052543,0.5278684181490382,1.5,2.75,NaN,NaN,4.088912674537386,0.5734068283081704,1085.0610766197713,0.252756962677432,-1.2886899493014425,-1.5414469119788745,25.80002441066143,0.2537548864961282,53.33381734223213,16.77868107586501,29.887501581902878,9424495886
1566567000,290.92,292.76,283.47,284.85,NaN,NaN,284.4659090909091,304.6566666666667,279.9452500000003,290.6909000000001,294.2565999999999,291.10000000000036,291.90416984765767,291.0560818787299,289.485384615384,295.98558397511016,282.9851852556579,279.9452500000003,290.6909000000001,294.2565999999999,291.10000000000036,287.0266666666667,149318151,95443088.2,41.29606107992074,1.581544827076275,1.5,2.75,NaN,NaN,4.460418912070427,1.5644731726105232,1080.0858292470516,-0.10568730957680161,-1.6735560489498766,-1.567868739373075,29.60249582854892,-1.1177838719755513,10.495139083403558,63.67668725837614,25.828173658220308,9275177735
1566826200,287.27,288,285.58,288,NaN,NaN,284.6620454545455,304.778,280.0096500000003,290.7067000000001,294.2313999999999,290.42700000000036,291.7510651477495,290.76502646170803,289.4876923076917,295.9857590206575,282.9896255947259,280.0096500000003,290.7067000000001,294.2313999999999,290.42700000000036,287.1933333333333,72620598,97167795,45.655158643099746,0.9405704259526557,1.5,2.75,NaN,NaN,4.366817561208252,0.7473731188404553,1083.4462064329432,-0.10949333075549861,-1.7047354028174482,-1.5952420720619496,29.76297962004043,-1.5552896940693937,12.969821249395318,59.36121302127543,27.668965729329244,9347798333
1566912600,289.54,289.95,286.03,286.87,NaN,NaN,284.8581818181819,304.89933333333335,280.03895000000034,290.7036000000001,294.1813999999999,289.73450000000037,291.5596508282299,290.394071560593,288.96846153846093,295.1329346703792,282.80398840654266,280.03895000000034,290.7036000000001,294.1813999999999,289.73450000000037,287.6166666666667,68262998,98288492.65,44.381982142383244,0.7446007569025929,1.5,2.75,NaN,NaN,4.334902021121949,0.6945166840952667,1080.490754880718,-0.16370949241593324,-1.799878937581866,-1.6361694451659328,28.116236735551315,1.0461430081014538,11.84403509876669,61.28914972784867,26.866815173384627,9279535335
1566999000,286.14,289.07,285.25,288.89,NaN,NaN,285.05431818181825,305.02066666666667,280.0809000000003,290.7068000000001,294.1111999999999,289.30750000000035,291.45495863888755,290.25082665006033,288.7584615384609,294.7303075159551,282.7866155609667,280.0809000000003,290.7068000000001,294.1111999999999,289.30750000000035,287.7366666666667,59852324,96068850.75,47.21572803189046,0.5433347158131935,1.5,2.75,NaN,NaN,4.298123305327524,0.6230148849782092,1083.8249889932417,-0.04528088466754565,-1.6927705510003648,-1.6474896663328191,21.969239528550897,1.489548568417358,13.224127124286104,58.936978253153356,27.838894622560524,9339387659
1567085400,291.72,293.16,290.61,292.58,NaN,NaN,285.2504545454546,305.14200000000005,280.1550000000003,290.74470000000014,294.1015999999999,289.19450000000035,291.4990779079508,290.47265268338793,289.10538461538397,295.39261521710523,282.8181540136627,280.1550000000003,290.74470000000014,294.1015999999999,289.19450000000035,292.1166666666666,57998913,91836467.6,52.02440341158458,0.9770046901327128,1.5,2.75,NaN,NaN,4.2961144978041315,0.6315455560923601,1088.0730446674877,0.2818285994202048,-1.295203917057563,-1.5770325164777679,22.85667309017113,1.2913276787259689,28.13599626025377,38.881842324859186,32.98216141488705,9397386572
1567171800,294.22,294.2399,291.42,292.45,NaN,NaN,285.44659090909096,305.2633333333334,280.2544000000003,290.79610000000014,294.0333999999999,289.1860000000003,291.5363689703841,290.6609714754462,289.09769230769166,295.3682690391153,282.827115576268,280.2544000000003,290.79610000000014,294.0333999999999,289.1860000000003,292.70329999999996,62961780,89147071.85,51.84520621961846,0.8709297749940953,1.5,2.75,NaN,NaN,4.190670605103834,0.7062686265897807,1089.7369880207882,0.47816177412875893,-0.9793302988168193,-1.4574920729455783,21.59054114310255,0.04104949885403638,44.76033656614155,23.144258733298386,32.09540470056007,9334424792
1567517400,290.57,291.58,289.27,290.74,NaN,NaN,285.6427272727273,305.3846666666667,280.3478000000003,290.8206000000001,293.9681999999999,289.5320000000003,291.50513881468277,290.6684980015942,289.6238461538455,295.1673165385044,284.08037576918656,280.3478000000003,290.8206000000001,293.9681999999999,289.5320000000003,290.53,69252354,83672417.1,49.43319028638129,0.09986363672115607,1.5,2.75,NaN,NaN,4.118479847596418,0.82766049314954,1087.012302159358,0.48031304599581515,-0.8571007654508094,-1.3374138114466245,20.757405891437227,0.22406839256783556,16.653093973592824,53.60882057427424,29.73808545213295,9265172438
1567603800,293.14,294.055,292.31,294.04,NaN,NaN,285.83886363636367,305.50600000000003,280.4670000000003,290.87890000000016,293.9761999999999,289.84400000000034,291.6045451356756,290.98959343001377,290.34615384615313,295.5453699910186,285.14693770128764,280.4670000000003,290.87890000000016,293.9761999999999,289.84400000000034,293.4683333333333,47003957,79987030.85,53.89135807540776,0.9812668587300613,1.5,2.75,NaN,NaN,4.061088429910959,0.5876447281578274,1091.2286723729158,0.6792738550016801,-0.4883214926945243,-1.1675953476962044,21.217391619534904,0.5436826808001477,39.02444999309035,28.04764936841433,32.92790063849534,9312176395
1567690200,296.79,298.83,296.64,297.82,NaN,NaN,286.0350000000001,305.62733333333335,280.59100000000035,290.95550000000014,294.1173999999999,290.3365000000003,291.84828846368833,291.640108341441,291.0361538461532,297.4879659396789,284.5843417526275,280.59100000000035,290.95550000000014,294.1173999999999,290.3365000000003,297.7633333333333,83356779,77126256.55,58.414078363783865,2.0551616934541386,1.5,2.75,NaN,NaN,4.113153542060173,1.080783415774378,1094.7522478887213,1.0202454907905218,0.10771151579194793,-0.9125339749985739,21.917144970617287,1.8675605417977765,44.1182106139466,23.69910219359294,32.18268719246047,9395533174
1567776600,298.17,298.76,297.42,298.05,NaN,NaN,286.23113636363644,305.7486666666667,280.71260000000035,291.0363000000001,294.2689999999999,290.55800000000033,292.09149283766135,292.25057421368473,291.4761538461532,298.92417490893143,284.02813278337493,280.71260000000035,291.0363000000001,294.2689999999999,290.55800000000033,298.07666666666665,49584290,75219775.85,58.67966240753191,1.9087164577824804,1.5,2.75,NaN,NaN,3.9150711461987306,0.6591922063006255,1096.3273270349675,1.2034744126223982,0.5918090407794239,-0.6116653718429743,21.88760827319005,4.63401790416008,42.70753205868831,24.861346186959747,32.431121754351956,9445117464
1568035800,299.14,299.24,297.16,298.2,NaN,NaN,286.4272727272728,305.87,280.8581000000003,291.11670000000015,294.4029999999999,290.8870000000003,292.3310421381452,292.8171861933338,292.09999999999934,300.2997485890336,283.9002514109651,280.8581000000003,291.11670000000015,294.4029999999999,290.8870000000003,298.20000000000005,51260290,73096292.45,58.864174135271696,1.585945664892396,1.5,2.75,NaN,NaN,3.783994635755963,0.7012707249832614,1098.915177435777,1.2703797197468019,0.976309277840528,-0.29407044190627385,12.998887676141365,3.5416666666666625,72.85690510342343,6.08809233854315,21.055002558033415,9496377754
1568122200,297.36,298.2,295.97,298.13,NaN,NaN,286.62340909090915,305.9913333333334,281.0281500000003,291.20350000000013,294.5055999999999,291.3900000000003,292.55845225037484,293.3231684606353,292.5369230769224,301.34728894592894,283.72655720791585,281.0281500000003,291.20350000000013,294.5055999999999,291.3900000000003,297.43333333333334,57947101,72717265.9,58.73236997920946,1.1058969083279935,1.5,2.75,NaN,NaN,3.672995018916249,0.7968822848714943,1100.879138447901,1.2439330135876296,1.2608458250782633,0.016912811490633617,12.561657304246433,3.9251228779586538,76.36623718343063,4.697946197396771,18.935816619172602,9438430653
1568208600,298.47,300.34,297.75,300.25,NaN,NaN,286.8195454545455,306.1126666666667,281.20430000000033,291.30580000000015,294.5973999999999,291.7750000000003,292.86008157388954,293.98286670247955,293.14384615384546,302.86210664544285,283.42558566224807,281.20430000000033,291.30580000000015,294.5973999999999,291.7750000000003,299.44666666666666,68821066,71418670.6,61.541024154813094,1.57164955991367,1.5,2.75,NaN,NaN,3.5956382318508004,0.9636284940873712,1104.3692605633794,1.2972869628702772,1.6385215150784802,0.341234552208203,11.757877788289315,3.9322925681055123,78.3463060017391,3.9862863202780714,17.667407677982816,9507251719
1568295000,301.25,302.46,300.41,301.29,NaN,NaN,287.01568181818186,306.23400000000004,281.39450000000033,291.4160000000001,294.6945999999999,292.64450000000033,293.1906666102076,294.6787841593863,294.4084615384609,303.7519342783149,285.064988798607,281.39450000000033,291.4160000000001,294.6945999999999,292.64450000000033,301.3866666666667,72908745,68283005.2,62.87585834844889,1.9690196458317906,1.5,2.75,NaN,NaN,3.4966640724328846,1.067743646994611,1105.1900432450475,1.325981658477954,1.9987116253056456,0.6727299668276916,11.662849203252781,2.976963565520554,77.55951910799749,4.262721411549058,18.17775948045346,9580160464
1568381400,301.78,302.17,300.68,301.09,NaN,NaN,287.2118181818182,306.35533333333336,281.5624500000003,291.49810000000014,294.7403999999999,293.46650000000034,293.50044439019945,295.28937614420664,295.41538461538397,304.5993258353376,286.23144339543035,281.5624500000003,291.49810000000014,294.7403999999999,293.46650000000034,301.31333333333333,62104838,66291754.85,62.427129168683464,1.5497023507860752,1.5,2.75,NaN,NaN,3.353330924401965,0.9368410617659189,1103.3235301945326,1.2555601046997,2.2421800977023167,0.9866199930026167,10.575937576892299,2.9543511711403614,50.30006233232128,18.88653226816791,30.8134053995108,9518055626
1568640600,299.84,301.1378,299.45,300.16,NaN,NaN,287.40795454545463,306.4766666666667,281.72125000000034,291.5774000000001,294.77439999999996,294.0320000000003,293.76160343372106,295.75324508285365,296.43769230769163,304.47647964007297,288.3989049753103,281.72125000000034,291.5774000000001,294.77439999999996,294.0320000000003,300.2492666666667,58191175,64910049.3,60.27305225665555,1.0328234234388205,1.5,2.75,NaN,NaN,3.2343644298018277,0.896489459298562,1104.9353736161113,1.0772574501832222,2.3331918057316443,1.2559343555484221,10.979977678639427,3.2400082547981066,26.68637116041768,40.46718676855604,32.84644207102629,9459864451
1568727000,299.94,301.02,299.75,300.92,NaN,NaN,287.604090909091,306.598,281.8529500000003,291.66610000000014,294.85639999999995,294.46150000000034,294.0423248676928,296.24531697972475,297.3630769230763,304.42353837941687,290.3026154667357,281.8529500000003,291.66610000000014,294.85639999999995,294.46150000000034,300.56333333333333,42904427,64373263,61.44388912632699,0.9555681652502306,1.5,2.75,NaN,NaN,3.0940526848159817,0.666494519626883,1106.2105866274546,0.9460804957252296,2.438534975204959,1.4924544794797296,9.582630744469903,2.3398177118759333,48.8173494283384,19.972519588490908,31.210130983170693,9502768878
1568813400,300.49,301.22,298.24,301.1,NaN,NaN,287.80022727272734,306.7193333333334,281.98855000000026,291.7430000000001,294.93459999999993,295.01200000000034,294.31909644150875,296.7076677435605,298.0184615384609,304.7556321208107,291.2812909561111,281.98855000000026,291.7430000000001,294.93459999999993,295.01200000000034,300.18666666666667,74192091,65500229.95,61.731559772126865,0.6680097264265605,1.5,2.75,NaN,NaN,3.0859060644719842,1.1326997028351653,1104.9708136494312,0.8121469759632671,2.5076381994338135,1.6954912234705464,8.255007425343205,1.101336377677802,49.847599508068974,19.216950963836666,30.935449528094367,9576960969
1568899800,301.53,302.63,300.7103,301.08,NaN,NaN,287.9963636363637,302.63,282.1157000000003,291.81510000000014,294.9839999999999,295.44350000000037,294.58422991439073,297.1240803394119,298.68230769230706,304.76259186505746,292.60202351955667,282.1157000000003,291.81510000000014,294.9839999999999,295.44350000000037,301.47343333333333,78099215,66919019.2,61.676496223603266,0.9576143526616282,1.5,2.75,NaN,NaN,3.0026056312954124,1.1670705269392232,1106.2899042452584,0.6688921308907831,2.5316063870840253,1.8627142561932422,4.981425875509652,1.0166079516859496,18.42256844456081,50.95386760335374,30.623563952085444,9498861754
1568986200,300.36,300.67,297.41,298.28,NaN,NaN,288.19250000000005,302.6405263157895,282.2106000000003,291.85770000000014,294.9634,295.73950000000036,294.7291620746107,297.23416792613455,299.26230769230705,303.295265407091,295.2293499775231,282.2106000000003,291.85770000000014,294.9634,295.73950000000036,298.7866666666667,97455979,69204853.55,54.36525528639201,0.0807093251129723,1.5,2.75,NaN,NaN,3.0502766576314513,1.4082246258868067,1107.3458608010824,0.3483668695114155,2.2981728430825115,1.949805973571096,7.795212315858194,0.026827632461429943,14.78926492283229,56.35502935914174,28.855705718025963,9401405775
1569245400,297.55,299,297.27,298.21,NaN,NaN,288.3886363636364,302.6510526315789,282.35040000000026,291.9217000000001,294.91459999999995,296.40750000000037,294.8656655226652,297.32710431412175,299.5830769230763,302.37634778896063,296.789806057192,282.35040000000026,291.9217000000001,294.91459999999995,296.40750000000037,298.16,47541321,64116012.05,54.19230006477197,0.15556391965886918,1.5,2.75,NaN,NaN,2.9559711820863486,0.7414890521095658,1109.1445531365437,0.10696263299317321,2.0835092648125624,1.9765466318193892,7.791964973423181,0.02683393150638449,15.021630664818453,55.99269955254548,28.985669782636073,9353864454
1569331800,299.41,299.84,294.81,295.87,NaN,NaN,288.5847727272728,302.6615789473684,282.4805500000003,291.9686000000001,294.81699999999995,296.80100000000033,294.90505118844305,297.1883324746816,299.43307692307627,302.7494083959598,296.11674545019275,282.4805500000003,291.9686000000001,294.81699999999995,296.80100000000033,296.84,97367568,65353360.55,48.623507613199685,0.781465789497964,1.5,2.75,NaN,NaN,3.1041160976516076,1.4898632171410198,1106.1545412736623,-0.21730515533420247,1.7049151876516362,1.9222203429858387,9.01292205472203,-1.4587843463780168,4.102112625111584,78.01816567611426,17.879721698774148,9256496886
1569418200,295.96,298.11,294.33,297.62,NaN,NaN,288.7809090909092,302.6721052631579,282.6508000000003,292.00450000000006,294.7752,297.33850000000035,295.01151976928844,297.22944366756906,299.39999999999935,302.77883912704345,296.02116087295525,282.6508000000003,292.00450000000006,294.7752,297.33850000000035,296.68666666666667,73434081,65611914.7,52.550515898810566,0.45832363567762924,1.5,2.75,NaN,NaN,3.1523935192479233,1.1192186866633234,1108.6503392690113,-0.3150020318909814,1.528467803122112,1.8434698350130934,8.653838541836535,-1.2180955225862178,3.948591564801447,78.45986364896784,17.591544786230706,9329930967
1569504600,297.63,297.86,295.45,297,NaN,NaN,288.97704545454553,302.68263157894734,282.8154500000003,292.0463000000001,294.7604,297.7440000000003,295.0894993861791,297.2075918897053,299.3076923076917,302.87303966459496,295.74234495078844,282.8154500000003,292.0463000000001,294.7604,297.7440000000003,296.77,58722357,65555416.35,51.061400303414125,0.3806819060616894,1.5,2.75,NaN,NaN,3.099365410730216,0.89576666993436,1106.8236938016678,-0.41609712855120984,1.323348424324081,1.7394455528752908,8.211609307394653,-1.358397821249452,4.425363998568558,77.11196687561623,18.462669125815204,9271208610
1569591000,297.83,297.9465,293.69,295.4,NaN,NaN,289.1731818181819,302.6931578947368,282.9718000000003,292.1210000000001,294.6918,297.88500000000033,295.10167588083874,297.035440281162,299.09769230769166,303.197329468748,294.9980551466353,282.9718000000003,292.1210000000001,294.6918,297.88500000000033,295.67883333333333,84781110,66894526.2,47.33374877886186,0.9343250769110454,1.5,2.75,NaN,NaN,3.1820178813923445,1.2673848641445344,1105.5127984580413,-0.5756155327367272,1.019926136954382,1.595541669691109,8.493569949216166,-1.5858208955224038,4.7898839295044,76.12537334959032,19.084742720905297,9186427500
1569850200,295.97,297.55,295.92,296.77,NaN,NaN,289.36931818181824,302.7036842105263,283.1283500000003,292.2134000000001,294.6838,298.10100000000034,295.1671003561,297.01016025438463,298.82999999999936,303.0465096758295,294.6134903241692,283.1283500000003,292.2134000000001,294.6838,298.10100000000034,296.74666666666667,52562761,66374575.25,50.65549643539929,0.23123687985849742,1.5,2.75,NaN,NaN,3.1083023184357508,0.7919110714007921,1107.5848935286526,-0.5725399101198096,0.879866782041347,1.4524066921611567,9.221682037040786,-1.3791040808188335,14.973601277222844,56.064288152214196,28.962110570562967,9238990261
1569936600,297.74,298.455,293,293.24,NaN,NaN,289.5654545454546,302.71421052631575,283.2677000000003,292.2792000000001,294.5906,298.22600000000034,295.0915277931157,296.6510973730147,298.21076923076856,303.1095380653716,293.3120003961655,283.2677000000003,292.2792000000001,294.5906,298.22600000000034,294.8983333333333,89900420,67406978.55,43.110543270431066,1.0861862799762982,1.5,2.75,NaN,NaN,3.275923581404624,1.33369603465189,1104.1297447478698,-0.7791163491311592,0.47851125574720754,1.2576276048783668,10.73690984914752,-2.6104284290933286,15.724312524529958,54.9049152579251,29.370772217544936,9149089841
1570023000,291.5,291.51,286.64,288.06,NaN,NaN,289.761590909091,302.72473684210524,283.40565000000026,292.27880000000016,294.3512,297.92700000000036,294.8157816051504,295.8328976232038,297.20846153846094,304.21793576940723,290.19898730751464,283.40565000000026,292.27880000000016,294.3512,297.92700000000036,288.7366666666666,124523974,71282979.4,34.89658275487314,2.5963258384797965,1.5,2.75,NaN,NaN,3.5133576113042957,1.7468963144938354,1099.2768358637384,-1.2097929419918056,-0.2546135726113903,0.9551793693804154,13.562496723899066,-4.324432044639293,1.838480151144974,85.6202466418211,12.541273207033914,9024565867
1570109400,287.81,290.45,284.82,290.42,NaN,NaN,284.82,302.73526315789474,283.58095000000026,292.37440000000015,294.13079999999997,297.55700000000036,294.6433980127916,295.317383563851,296.45923076923015,304.1003239714928,288.8181375669675,283.58095000000026,292.37440000000015,294.13079999999997,297.55700000000036,288.56333333333333,85906799,71410480.4,40.46238152419378,2.162370323377635,1.5,2.75,NaN,NaN,3.6645463533539884,1.2029998750715587,1101.9243527748067,-1.2744118430707758,-0.6378354344580544,0.6365764086127215,15.243210103280408,-2.6351079522596077,12.539206333954743,60.03489736644625,27.425896299599003,9110472666
1570195800,291.14,294.63,290.82,294.35,NaN,NaN,284.8938095238095,302.7457894736842,283.77730000000025,292.4839000000001,294.01779999999997,297.3720000000004,294.63189220836836,295.22525179586523,295.9538461538456,303.20718507079346,288.7005072368977,283.77730000000025,292.4839000000001,294.01779999999997,297.3720000000004,293.2666666666667,66700681,72266299.95,48.3770347786837,0.5116876746464594,1.5,2.75,NaN,NaN,3.703507328114416,0.9229845868150054,1105.7491228305594,-1.003107070513587,-0.6173074295292622,0.38579964098432473,17.53412343678751,-1.2943898594949723,31.68711483247948,35.01626364860812,33.2966215189124,9177173347
1570455000,293.47,295.26,292.77,293.08,NaN,NaN,284.96761904761905,302.75631578947366,283.98640000000023,292.5641000000001,293.8392,297.1160000000004,294.5710336903931,295.0209421010209,295.3369230769225,302.0808976394259,288.5929485144191,283.98640000000023,292.5641000000001,293.8392,297.1160000000004,293.7033333333334,60656561,72736113.5,46.237917697003375,0.28239889101941423,1.5,2.75,NaN,NaN,3.6168282332491013,0.8339263411427668,1103.3737751880522,-0.8650396596620858,-0.6954999335932825,0.16953972606880327,17.59772678155629,-0.9429817149423803,16.25473655388393,54.10229292119859,29.642970524917487,9116516786
1570541400,291.04,291.85,288.49,288.53,NaN,NaN,285.0414285714286,302.76684210526315,284.1932000000003,292.5724000000001,293.5806,296.63600000000037,294.3341304084169,294.40275713901895,294.3715384615379,301.1436434457644,287.59943347731144,284.1932000000003,292.5724000000001,293.5806,296.63600000000037,289.62333333333333,101575470,74917531.95,39.499217147781515,1.4037953312834583,1.5,2.75,NaN,NaN,3.686340502302735,1.3558304358957196,1099.6480285355258,-1.025070904671507,-1.1117989047705805,-0.08672800009907347,19.087739827597378,-3.054230226463286,15.458988027440494,55.3114678869241,29.2295440856354,9014941316
1570627800,290.75,292.3,288.6559,291.27,NaN,NaN,285.1152380952381,302.77736842105264,284.44605000000024,292.6267000000001,293.39160000000004,296.18700000000035,294.21396843161625,294.10439931625524,293.83230769230715,300.38653195010664,287.27808343450766,284.44605000000024,292.6267000000001,293.39160000000004,296.18700000000035,290.74196666666666,65707329,74761845.1,44.72367138953694,0.8886432004397646,1.5,2.75,NaN,NaN,3.6923161807096854,0.8788885415028368,1102.2340486437229,-0.8959883965683717,-1.206713495809538,-0.31072509924116637,19.756289725124116,-1.9292929292929355,43.19450573289077,24.372447644070878,32.43304662303835,9080648645
1570714200,291.18,294.21,291,293.24,NaN,NaN,285.1890476190476,302.7878947368421,284.74055000000027,292.7196000000001,293.30780000000004,295.7845000000003,294.1757735911607,294.02207557185,293.4499999999995,299.4985115778883,287.4014884221107,284.74055000000027,292.7196000000001,293.30780000000004,295.7845000000003,292.81666666666666,57255974,73979206.55,48.187936884261774,0.1707640563974332,1.5,2.75,NaN,NaN,3.657865024944706,0.773946851691396,1104.6266224563394,-0.6395591697959742,-1.1101740614861342,-0.47061489169015996,20.40491443267815,-0.7312119160460285,38.41331584523103,28.50800157935426,33.07868257541469,9137904619
1570800600,296.27,298.74,296.1448,296.28,NaN,NaN,285.2628571428571,302.79842105263157,284.99105000000026,292.8173000000001,293.33660000000003,295.5440000000003,294.25829227386026,294.2371159935786,293.4815384615379,299.5842281392107,287.3788487838651,284.99105000000026,292.8173000000001,293.33660000000003,295.5440000000003,297.05493333333334,101228577,75935393.5,53.07520742420545,1.3509072487896836,1.5,2.75,NaN,NaN,3.7894460945915127,1.3330881995100217,1109.22244900024,-0.24701134567180905,-0.7793790737799213,-0.5323677281081123,21.216433617449475,-0.16511102874280054,44.38457499996982,23.400702290926723,32.214722709103455,9239133196
1571059800,295.93,296.67,295.57,295.95,NaN,NaN,285.33666666666664,302.80894736842106,285.23045000000025,292.9205000000001,293.4032,295.3335000000003,294.32463375331673,294.40024780371397,293.3530769230764,299.16529421278295,287.54085963336985,285.23045000000025,292.9205000000001,293.4032,295.3335000000003,296.06333333333333,40546668,75053168.15,52.49632622333816,0.713498381941442,1.5,2.75,NaN,NaN,3.597342802120692,0.5402392597067203,1107.6938750041447,-0.004227565621568674,-0.5376521851350731,-0.5334246195135044,21.043273608776293,0.9241576865366182,49.94198950008321,19.14401599627938,30.913994503637397,9198586528
1571146200,297.1,299.7,296.97,298.88,NaN,NaN,285.4104761904762,302.8194736842105,285.48610000000025,293.0879000000001,293.7044,295.2315000000003,294.5032755669122,294.82689087002694,293.49769230769175,299.743085213239,287.2522994021445,285.48610000000025,293.0879000000001,293.7044,295.2315000000003,298.5166666666667,47832356,75299564.6,56.98254850015431,1.4889513597221131,1.5,2.75,NaN,NaN,3.6082468876834994,0.6352275242770793,1110.9496391233647,0.34001510560612525,-0.10840573750584781,-0.44842084311197306,20.32274110113154,3.7561619107130433,85.49802591236575,1.8677863641323325,12.634187723501935,9246418884
1571232600,298.37,299.16,297.92,298.4,NaN,NaN,285.4842857142857,302.83,285.7285000000002,293.2441000000001,293.9164,295.0965000000003,294.6560882897784,295.16718697764344,293.728461538461,300.4421116801539,287.01481139676804,285.7285000000002,293.2441000000001,293.9164,295.0965000000003,298.49333333333334,50563596,74118139.85,56.04869786696923,1.0810569396262926,1.5,2.75,NaN,NaN,3.439086395706107,0.6822027118102317,1112.0814481777272,0.5114112777568475,0.1908432540840863,-0.32056802367276116,16.305473200995092,2.7477446456855454,61.34534193924804,11.779243352230331,26.87541470852164,9195855288
1571319000,299.68,300.24,298.515,299.28,NaN,NaN,285.55809523809523,302.8405263157895,285.9740000000002,293.43540000000013,294.1426000000001,295.0065000000003,294.83741816076747,295.5588834559631,293.9215384615379,301.10210131137103,286.7409756117048,285.9740000000002,293.43540000000013,294.1426000000001,295.0065000000003,299.34499999999997,46784885,72552423.35,57.426236262615355,1.1709170316888566,1.5,2.75,NaN,NaN,3.3248659388699586,0.644842485471576,1114.9727539593434,0.6511121553585311,0.4933221705254027,-0.15778998483312837,16.036388190662286,1.6748768472906232,59.88465876628799,12.625029277362232,27.49031195634978,9242640173
1571405400,298.69,299.395,296.99,297.97,NaN,NaN,285.63190476190476,302.8510526315789,286.2428000000002,293.63240000000013,294.2296,294.9910000000003,294.960264507404,295.7885136030142,294.28538461538403,301.7640953861652,286.80667384460287,286.2428000000002,293.63240000000013,294.2296,294.9910000000003,298.11833333333334,64338028,70896525.8,54.67882034786633,0.7733007245401906,1.5,2.75,NaN,NaN,3.259161228950674,0.9074919719126773,1114.3981334939533,0.6223789854589074,0.6201837469905058,-0.002195238468401528,15.025120265849543,1.6684864200900926,19.144090776792368,49.94188628608906,30.914022937118578,9178302145
1571664600,299.42,300.21,298.935,299.99,NaN,NaN,285.7057142857143,302.8615789473684,286.4808000000002,293.84200000000016,294.397,295.08000000000027,295.1575090365254,296.18865516463194,295.20307692307637,302.3200182912417,288.08613555491104,286.4808000000002,293.84200000000016,294.397,295.08000000000027,299.71166666666664,39460901,70492504.8,58.01445593595822,1.0754089711095078,1.5,2.75,NaN,NaN,3.1863639983113368,0.5597886060646834,1117.7573135887221,0.7006751508513379,0.8736487000957709,0.17297354924443298,14.873584385618,3.971857345856596,38.88493453751619,28.075180224650843,33.03988523783297,9217763046
1571751000,300.58,300.9,298.91,299.01,NaN,NaN,285.77952380952377,302.8721052631579,286.70395000000025,294.07940000000013,294.61580000000004,295.2370000000003,295.3085871135244,296.4573546727622,295.86384615384554,302.67004486005897,289.0576474476321,286.70395000000025,294.07940000000013,294.61580000000004,295.2370000000003,299.6066666666666,49126038,68080428.3,55.86620050412268,0.9263413466262171,1.5,2.75,NaN,NaN,3.100909427003381,0.7215882629810072,1119.9139181876753,0.648900843880073,0.9840996040945242,0.3351987602144513,10.446737487389735,2.6573282521371957,15.524069967611819,55.20275978668593,29.27317024570224,9168637008
1571837400,298.73,299.94,298.495,299.88,NaN,NaN,285.8533333333333,302.8826315789473,286.91950000000026,294.33250000000015,294.7624,295.3500000000003,295.4878582071117,296.7833208944039,296.2892307692302,303.35027214606976,289.2281893923906,286.91950000000026,294.33250000000015,294.7624,295.3500000000003,299.43833333333333,34991829,66158315.7,57.37520273391091,0.6687580893156287,1.5,2.75,NaN,NaN,2.9826301822174246,0.5289105175934822,1122.5732549606457,0.6348986812197739,1.1288221117391686,0.49392343051939475,9.751632192118139,2.2643568408129813,35.86371026417508,30.866111044094342,33.27017869173058,9203628837
1571923800,300.91,301.07,299.4601,300.37,NaN,NaN,285.9271428571428,302.8931578947368,287.13150000000024,294.53090000000014,295.09180000000003,295.5185000000003,295.6793147480093,297.12490938065116,296.84999999999945,303.96023098185776,289.73976901814115,287.13150000000024,294.53090000000014,295.09180000000003,295.5185000000003,300.3000333333333,35857459,65015070.8,58.2412225903547,0.8148551968177986,1.5,2.75,NaN,NaN,2.8845780263447502,0.5515253395678837,1120.9643082003645,0.619607608577718,1.2684329412415423,0.6488253326638243,9.454796896610532,1.380450924800875,32.731942384200785,33.939054377851726,33.32900323794747,9239486296
1572010200,299.74,302.2,299.6806,301.6,NaN,NaN,286.00095238095236,302.9036842105263,287.3451000000003,294.71730000000014,295.43080000000003,295.82850000000036,295.9114984833815,297.5511084872558,297.85538461538414,303.52594890903936,292.1848203217289,287.3451000000003,294.71730000000014,295.43080000000003,295.82850000000036,301.1602,45205412,63036285.9,60.415355012314315,1.0756649618584866,1.5,2.75,NaN,NaN,2.858493881605837,0.7171331774164696,1122.7916794582882,0.6501231155760208,1.4614792271338501,0.8113561115578294,8.134430386368473,1.909106267950679,70.88362273777491,6.939043639841215,22.177333622383866,9284691708
1572269400,302.94,303.85,302.91,303.3,NaN,NaN,286.0747619047619,302.91421052631574,287.56670000000025,294.90230000000014,295.7198,296.15500000000037,296.20124364089594,298.09862196466,298.7807692307687,303.7312592549298,293.83027920660766,287.56670000000025,294.90230000000014,295.7198,296.15500000000037,303.3533333333333,42146965,62515496.1,63.26229755951317,1.4487527293566038,1.5,2.75,NaN,NaN,2.8150300329197058,0.6741842843665764,1124.430494361111,0.7362621658780755,1.7316838189054238,0.9954216530273483,8.17565224618019,1.4788543897216329,72.37764846675289,6.309926095644702,21.312425437602414,9326838673
1572355800,303,304.23,302.86,303.21,NaN,NaN,286.1485714285714,302.92473684210523,287.7957500000003,295.05790000000013,295.9374,296.6535000000004,296.476096831449,298.58541987278767,299.5476923076918,303.8772199340573,295.21816468132636,287.7957500000003,295.05790000000013,295.9374,296.6535000000004,303.43333333333334,44284921,60234721.15,63.003953770915615,1.2384622855606142,1.5,2.75,NaN,NaN,2.71181360199687,0.7352058771836781,1125.7167857178981,0.736837715520859,1.916468797428422,1.179631081907563,6.772251922467602,1.6119302949061671,74.51446527227053,5.428305442629069,20.05722928510039,9282553752
1572442200,303.43,304.55,301.99,304.14,NaN,NaN,286.22238095238095,302.9352631578947,288.0147000000003,295.2096000000001,296.2184,297.4575000000004,296.77664205374515,299.11442750395076,300.15230769230726,304.67846519897216,295.62615018564236,288.0147000000003,295.2096000000001,296.2184,297.4575000000004,303.56,49643928,56490718.85,64.61212635494407,1.0816032206115167,1.5,2.75,NaN,NaN,2.7009697732828077,0.8787979514266705,1126.9541108373908,0.7471681642209398,2.1135912871837377,1.3664231229627979,6.5302798830209365,1.6238973536487618,76.56704627740203,4.638521075014316,18.79443264758366,9332197680
1572528600,304.13,304.13,301.73,303.33,NaN,NaN,286.2961904761905,302.9457894736842,288.2264500000003,295.3539000000001,296.436,298.1030000000004,297.03363648301007,299.5159105988126,300.7199999999996,304.8273517576992,296.61264824229994,288.2264500000003,295.3539000000001,296.436,298.1030000000004,303.06333333333333,69053791,55648068.45,62.08094975613717,0.7638910622099627,1.5,2.75,NaN,NaN,2.6801862180483194,1.24090184840908,1124.5712625204192,0.6503255730496011,2.1793300892747993,1.5290045162251982,6.9807560398643735,1.798838809276087,41.303585848507254,26.009293659790867,32.68712049170189,9263143889
1572615000,304.92,306.19,304.74,306.14,NaN,NaN,286.37,302.95631578947365,288.44235000000026,295.5314000000001,296.7116,298.6925000000004,297.390748777794,300.1467762560685,301.2784615384611,306.1385017165318,296.4184213603904,288.44235000000026,295.5314000000001,296.7116,298.6925000000004,305.69,71141515,55870110.15,66.92213662310763,1.399928415905223,1.5,2.75,NaN,NaN,2.6930300596162975,1.2733376542304884,1128.470268443858,0.7209233649193281,2.430158722374358,1.70923535745503,7.254744190360425,2.0500683356111793,47.58123832268462,20.939707215984267,31.479054461331103,9334285404
1572877800,307.85,308,306.96,307.37,NaN,NaN,286.4438095238095,302.96684210526314,288.6469000000003,295.7093000000001,297.162,299.4070000000004,297.78209196297854,300.8347023269191,301.9684615384611,307.4987131457721,296.4382099311501,288.6469000000003,295.7093000000001,297.162,299.4070000000004,307.4433333333333,60606916,55867627.9,68.79987141894635,1.6561129255068374,1.5,2.75,NaN,NaN,2.6335279125008486,1.084830666311501,1131.0373679744566,0.7902936531044464,2.697102423835588,1.9068087707311416,6.854662155063683,2.7958931139426824,52.615433935797284,17.390045664245484,29.994520399957228,9394892320
1572964200,307.59,307.9195,306.71,307.03,NaN,NaN,286.517619047619,302.97736842105263,288.8677500000003,295.88700000000006,297.5426,300.3320000000004,298.1447550232539,301.4247306767363,302.56461538461497,308.46554420529975,296.6636865639302,288.8677500000003,295.88700000000006,297.5426,300.3320000000004,307.2198333333333,43033885,52940548.65,67.65655827774212,1.3719626153182622,1.5,2.75,NaN,NaN,2.5318116330365057,0.8128719119347473,1129.7413696525111,0.753263089335932,2.8483876324010566,2.0951245430651246,6.285918574981233,2.384287048152587,52.8290495504115,17.24296977263432,29.927980676954192,9351858435
1573050600,307.03,307.4,306.06,307.1,NaN,NaN,286.59142857142854,302.98789473684207,289.08620000000025,296.06430000000006,297.94719999999995,301.12350000000043,298.49594110077334,301.9652325170471,303.2669230769227,308.98370745878975,297.55013869505564,289.08620000000025,296.06430000000006,297.94719999999995,301.12350000000043,306.85333333333335,46487108,51979537.6,67.77529098747513,1.1057703973833761,1.5,2.75,NaN,NaN,2.4466822306767533,0.8943347737668216,1128.1005443442264,0.675932139448026,2.940039717375157,2.264107577927131,6.431355371431838,2.2405699637114287,52.32010025533179,17.59442736777428,30.08547237689395,9398345543
1573137000,308.57,309.65,307.66,308.18,NaN,NaN,286.66523809523807,302.99842105263156,289.3093500000002,296.22210000000007,298.33299999999997,301.87050000000045,298.8757081164293,302.5571151344712,303.8969230769227,309.8313254361392,297.9625207177062,289.3093500000002,296.22210000000007,298.33299999999997,301.87050000000045,308.49666666666667,54272274,51830352.6,69.62784208434515,1.375537255856516,1.5,2.75,NaN,NaN,2.4540620713426966,1.0471137331216998,1126.8034888553684,0.6403107588481731,3.0644960264873475,2.4241852676391744,6.441858335590693,2.18169761273209,83.34508096118232,2.459078052968675,14.195840985849006,9452617817
1573223400,307.8,309.0036,307.03,308.94,NaN,NaN,286.7390476190476,303.00894736842105,289.5251500000002,296.38090000000005,298.66020000000003,302.50350000000043,299.2703862295105,303.1650089311882,304.66076923076884,310.4366152842349,298.88492317730277,289.5251500000002,296.38090000000005,298.66020000000003,302.50350000000043,308.32453333333336,49068797,49222363.6,70.89581829183193,1.1429143067256708,1.5,2.75,NaN,NaN,2.419743351961078,0.9968801457555362,1128.147531865433,0.6108184096994251,3.1877082797634557,2.5768898700640306,6.368854977162907,1.859545004945594,81.72796422390103,2.929305436460535,15.34273033963845,9501686614
1573482600,307.42,308.54,307.27,308.35,NaN,NaN,286.8128571428571,303.0194736842105,289.74810000000025,296.5058,298.9782,303.1235000000005,299.6264495146277,303.6588176044084,305.3123076923073,310.6805169846261,299.9440983999885,289.74810000000025,296.5058,298.9782,303.1235000000005,308.05333333333334,35934909,48991775.65,68.50481775715608,0.9505711761305489,1.5,2.75,NaN,NaN,2.366190255392431,0.7334886013669113,1126.4210414279357,0.4991676315358564,3.200849409483851,2.7016817779479947,6.443243044226739,1.6951947495135529,55.92046941925947,15.064012270342428,29.015518310398114,9465751705
1573569000,308.75,309.99,308.15,309,NaN,NaN,286.88666666666666,303.03,289.9760500000002,296.6558,299.3434,303.62950000000046,299.99403972974034,304.1675016420838,305.97615384615347,310.8468229738674,301.1054847184395,289.9760500000002,296.6558,299.3434,303.62950000000046,309.0466666666667,46484624,48924389.05,69.71656010854177,1.0094057772443499,1.5,2.75,NaN,NaN,2.3286052371501174,0.9501319260725649,1125.3931290904357,0.4198706591550163,3.226520101891765,2.8066494427367488,6.3241510994382235,1.5979483132767849,82.43349054949863,2.68725761521547,14.879251835285917,9512236329
1573655400,307.91,309.54,307.66,309.1,NaN,NaN,286.9604761904762,303.04052631578946,290.18365000000017,296.8104,299.64459999999997,304.1645000000005,300.351136210927,304.6372633904568,306.55307692307656,310.96919693689125,302.13695690926187,290.18365000000017,296.8104,299.64459999999997,304.1645000000005,308.7666666666667,54459018,49119160.15,69.90837535495507,0.8802686937378086,1.5,2.75,NaN,NaN,2.2965620059251086,1.1087123198705586,1123.9085141125195,0.32895261850260926,3.21784021586501,2.888887597362401,6.333879412417359,1.9022187057000755,83.11217735846833,2.494179074579332,14.393643566952338,9566695347
1573741800,308.79,309.64,308.09,309.55,NaN,NaN,287.03428571428566,303.0510526315789,290.38175000000024,296.99830000000003,299.87919999999997,304.6780000000005,300.7118759673612,305.1051430675561,307.0338461538458,311.28648724065874,302.78120506703283,290.38175000000024,296.99830000000003,299.87919999999997,304.6780000000005,309.0933333333333,52001874,49380009.6,70.80454526952707,0.7951903448867625,1.5,2.75,NaN,NaN,2.2432361483590304,1.053095664039725,1126.1366761089535,0.2571032240993967,3.2102666274866465,2.95316340338725,5.727780928272868,1.1138694714836432,82.95018620588242,2.5396681887726373,14.510145605344942,9618697221
1573828200,311.02,311.84,310.26,311.79,NaN,NaN,287.1080952380952,303.0615789473684,290.5904000000002,297.2115,300.154,305.3690000000005,301.1463122039353,305.74179610874126,307.69384615384575,312.03018660645216,303.35750570123935,290.5904000000002,297.2115,300.154,305.3690000000005,311.2966666666666,62706192,49298417.8,74.82387629902081,1.2356123172177138,1.5,2.75,NaN,NaN,2.24657642347624,1.2719716939881183,1128.600448711812,0.31461977970342403,3.34643812801653,3.031818348313106,4.85582943441852,1.4380063116114181,84.02239405884335,2.2455661695148,13.732039771641857,9681403413
1574087400,311.53,312.28,311.03,312.02,NaN,NaN,287.1819047619047,303.0721052631579,290.79070000000024,297.4167,300.4304,305.9705000000005,301.57273133319273,306.33972028886114,308.29999999999967,312.6825458003913,303.917454199608,290.79070000000024,297.4167,300.4304,305.9705000000005,311.77666666666664,49327980,49791771.75,75.20138799102325,1.2163075143413093,1.5,2.75,NaN,NaN,2.1753923932279373,0.9906853736330441,1126.605454977486,0.32121470725823276,3.4333367323858965,3.112122025127664,4.678329070877645,1.625248347067065,100,0,0,9730731393
1574173800,312.68,312.69,311.22,311.93,NaN,NaN,287.25571428571425,303.0826315789473,290.9848500000002,297.606,300.70640000000003,306.61650000000054,301.97889873189104,306.8721278803982,308.9615384615381,312.69119380676966,305.23188311630656,290.9848500000002,297.606,300.70640000000003,306.61650000000054,311.9466666666667,67927818,50731860.75,74.72918239391234,1.0833270943087372,1.5,2.75,NaN,NaN,2.1250072222830823,1.3389577475728602,1125.64992189158,0.2743934621531232,3.4551138528190677,3.1807203906659445,4.533064386167233,1.5727775968739772,72.18494373660323,6.397863366725076,21.4171928966717,9662803575
1574260200,311.28,311.85,309.06,310.77,NaN,NaN,287.3295238095238,303.0931578947368,291.17500000000024,297.75710000000004,300.9168,307.16100000000057,302.3236478012286,307.2433537965507,309.3176923076919,312.7759724836294,305.8594121317544,291.17500000000024,297.75710000000004,300.9168,307.16100000000057,310.56,79696276,52967083.1,68.73812958521768,0.4986975864159332,1.5,2.75,NaN,NaN,2.1782209921200053,1.5046378115543235,1123.9998645969292,0.1276361434155735,3.3402655699354113,3.212629426519838,5.440174262131611,0.8404179375689451,38.564892095467556,28.43360204411465,33.00150586041779,9583107299
1574346600,310.89,311.01,309.39,310.27,NaN,NaN,287.4033333333333,303.1036842105263,291.3756500000002,297.8955,301.0964,307.6560000000005,302.63526945608237,307.5316058159268,309.5407692307689,312.8381104584296,306.2434280031082,291.3756500000002,297.8955,301.0964,307.6560000000005,310.2233333333333,54664690,53907444.65,66.27186970081826,0.4090766268603535,1.5,2.75,NaN,NaN,2.1383480641114336,1.0140471386636205,1121.9262204615964,-0.03223715950737027,3.172332977135625,3.204570136642995,5.433892563323296,0.43050430504304527,17.668624047436108,52.095463741465814,30.235912211098068,9528442609
1574433000,311.09,311.24,309.85,310.96,NaN,NaN,287.47714285714284,303.11421052631573,291.5781000000002,298.0171,301.29380000000003,308.12400000000054,302.96172947741246,307.8581195477433,309.8430769230766,312.87407964739447,306.8120741987587,291.5781000000002,298.0171,301.29380000000003,308.12400000000054,310.68333333333334,44850228,53889685.45,67.97927288729268,0.4626896368117904,1.5,2.75,NaN,NaN,2.084894630960616,0.8322599700755907,1124.1835755895975,-0.11593398955120282,3.0596526497039918,3.1755866392551946,5.406579373675354,0.8464407329333409,13.848921619521972,57.92436172839659,28.22671665208143,9573292837
1574692200,311.98,313.37,311.98,313.37,NaN,NaN,287.55095238095237,303.1247368421052,291.7918500000002,298.1662,301.55800000000005,308.6275000000005,303.3698969488865,308.3830605431963,310.3253846153843,313.4508789431523,307.19989028761626,291.7918500000002,298.1662,301.55800000000005,308.6275000000005,312.9066666666667,48762676,54220471,73.10116005130119,0.9762968131171317,1.5,2.75,NaN,NaN,2.10811644303486,0.8993406936653132,1127.7348641565034,-0.037466737264919114,3.1287532176740456,3.1662199549389647,6.456304274046923,1.4142394822006488,13.00658096322447,59.23876261884707,27.754656417928462,9622055513
1574778600,313.41,314.28,313.06,314.08,NaN,NaN,287.62476190476184,303.1352631578947,291.9917500000002,298.33880000000005,301.82120000000003,309.1710000000005,303.7899009901066,308.92562620574904,310.7792307692305,314.2239633058106,307.33449823265033,291.9917500000002,298.33880000000005,301.82120000000003,309.1710000000005,313.8066666666666,37727953,53892622.6,74.40031066176928,1.0272064232188693,1.5,2.75,NaN,NaN,2.0446795542466534,0.7000578405698148,1129.2169981961488,0.030123802942639166,3.2038747086172634,3.1737509056746243,6.461298909304362,1.6111290844386803,33.09888016530176,33.57083557138816,33.33028426331008,9659783466
1574865000,314.61,315.48,314.37,315.48,NaN,NaN,287.69857142857137,303.1457894736842,292.19420000000025,298.52170000000007,302.10880000000003,309.7380000000005,304.24833624539656,309.54985228139196,311.28230769230737,315.35810608578566,307.2065092988291,292.19420000000025,298.52170000000007,302.10880000000003,309.7380000000005,315.11,44793179,53650085.15,76.78160220086207,1.276212366618403,1.5,2.75,NaN,NaN,1.9986310146576092,0.8349134745035908,1131.778619706424,0.1313193527242782,3.337900096579972,3.2065807438556937,6.587891304569033,1.9156840575028289,71.56665601422574,6.638730454899708,21.794613530874564,9704576645
1575037800,314.86,315.13,314.06,314.31,NaN,NaN,287.7723809523809,303.15631578947364,292.3938500000002,298.67870000000005,302.3734,310.28700000000055,304.6429112945967,310.00319968316415,311.74076923076893,315.734051755889,307.74748670564884,292.3938500000002,298.67870000000005,302.3734,310.28700000000055,314.5,36592740,52027032.6,70.85014845733329,0.9089491028724346,1.5,2.75,NaN,NaN,1.9573002278963525,0.7033409012836915,1130.006358695481,0.0839623341530471,3.311533661547003,3.2275713273939557,7.3757781179038915,0.8082363129029095,80.05325079091197,3.4148072094833877,16.53194199960464,9667983905
1575297000,314.59,314.66,311.17,311.64,NaN,NaN,287.84619047619043,303.16684210526313,292.56520000000023,298.802,302.64059999999995,310.5620000000005,304.9173069301027,310.1590854276247,311.9438461538458,315.61442387789845,308.2732684297932,292.56520000000023,298.802,302.64059999999995,310.5620000000005,312.49,76110027,52275458.2,59.54536993400278,0.2514412872067548,1.5,2.75,NaN,NaN,2.066778783046614,1.4559418438536038,1126.3123319855974,-0.14993988602282915,3.0401464698654195,3.1900863558882486,8.395380311267568,-0.12178706493173369,38.88458271559205,28.075495816795456,33.0399214676125,9591873878
1575383400,308.65,309.64,307.13,309.55,NaN,NaN,307.13,303.1773684210526,292.72370000000024,298.891,302.8674,310.67100000000056,305.0989811681379,310.10107729166043,311.97846153846126,315.5482134897654,308.40870958715715,292.72370000000024,298.891,302.8674,310.67100000000056,308.7733333333333,75172709,53003747.85,52.48573440264187,0.8480105638119897,1.5,2.75,NaN,NaN,2.2412945842575693,1.418252709463827,1123.7504758623702,-0.4511474953525587,2.6261519866975505,3.077299482050109,9.19315372621472,-0.7629916968550622,12.101563525776124,60.7788251693863,27.119611304837594,9516701169
1575469800,310.7,312.12,310.32,311.46,NaN,NaN,307.6611904761905,303.18789473684205,292.88895000000025,298.9981,303.1791999999999,310.89250000000055,305.34843288703445,310.2304985019785,312.1253846153843,315.43066817479763,308.82010105597095,292.88895000000025,298.9981,303.1791999999999,310.89250000000055,311.3,49190402,53311573.7,57.450518009725776,0.1471866574725707,1.5,2.75,NaN,NaN,2.2647735425248854,0.9226964913249222,1126.5503260082103,-0.5224521064084238,2.4242343490395797,2.9466864554480034,10.02582870725432,0.22202915339318396,14.524004330410335,56.7638486443298,28.712147025259885,9565891571
1575556200,312.23,312.25,310.58,312.02,NaN,NaN,308.192380952381,303.19842105263155,293.0619500000002,299.12120000000004,303.46719999999993,311.1385000000006,305.61006296989586,310.4009272160758,312.1430769230766,315.44344878661263,308.84270505954055,293.0619500000002,299.12120000000004,303.46719999999993,311.1385000000006,311.6166666666666,40781669,53026301.75,58.80949699753356,0.11606838170308065,1.5,2.75,NaN,NaN,2.2222897180588235,0.7690837877450127,1128.0335657056294,-0.5308831386927984,2.2830825320820054,2.8139656707748038,9.804252388647063,0.5640248815547749,13.53878711034181,58.354314005037764,28.106898884620428,9606673240
1575642600,314.12,315.31,314.11,314.87,NaN,NaN,308.7235714285714,303.20894736842104,293.24060000000026,299.2925,303.8246,311.4730000000005,305.9731977553901,310.8265531954971,312.36230769230735,315.96558102332335,308.75903436129136,293.24060000000026,299.2925,303.8246,311.4730000000005,314.7633333333334,48956767,52760526.4,64.9457187728971,0.9534178109852794,1.5,2.75,NaN,NaN,2.2985547381974802,0.9279052037661247,1131.7346619226369,-0.35211182102067173,2.373825894498964,2.7259377155196356,10.864435145964977,1.25739644970415,30.915456993764455,35.81185897740595,33.27268402882961,9655630007
1575901800,314.44,315.18,313.8,313.88,NaN,NaN,309.2547619047619,303.21947368421047,293.4124000000002,299.443,304.19419999999997,311.7200000000006,306.28326843164933,311.11735765306884,312.5123076923074,316.1926350510024,308.83198033361236,293.4124000000002,299.443,304.19419999999997,311.7200000000006,314.2866666666667,34904315,52052302.3,61.517431814455925,0.6492618092021901,1.5,2.75,NaN,NaN,2.2329436854690887,0.6705623662682832,1132.1906452469802,-0.309634479980867,2.338894615543552,2.648529095524419,11.161159235262561,0.1627469125953317,42.58917453729207,24.89328547991621,32.51753998279173,9620725692
1575988200,313.82,314.55,312.81,313.53,NaN,NaN,309.7859523809524,303.22999999999996,293.58345000000025,299.6066,304.52939999999995,311.97900000000055,306.56745398334937,311.3471331146813,312.72461538461505,316.29520995162284,309.15402081760726,293.58345000000025,299.6066,304.52939999999995,311.97900000000055,313.63,53109165,52911015.1,60.3054373302171,0.4093204812821639,1.5,2.75,NaN,NaN,2.1977334222212974,1.0037449650063508,1133.0668169012106,-0.31326127099302603,2.2569525067831364,2.5702137777761624,10.317442909642446,-0.17511462047886253,50.09594899151755,19.051430349446626,30.852620659035814,9567616527
1576074600,314.03,314.7,313.4393,314.42,NaN,NaN,310.31714285714287,303.24052631578945,293.7595500000002,299.7718,304.953,312.25000000000057,306.8753969643945,311.63978710375926,313.04384615384583,316.4160906787825,309.6716016289092,293.7595500000002,299.7718,304.953,312.25000000000057,314.18643333333335,53521450,53262856.4,62.3374162710134,0.4906646037221702,1.5,2.75,NaN,NaN,2.1308024634912037,1.0048550456636796,1135.7650336886047,-0.26574722747534585,2.23802974343198,2.503776970907326,10.367245392407057,-0.33599594269050403,51.27006008153386,18.212669798716135,30.517270119750005,9621137977
1576161000,314.43,317.99,314.17,317.13,NaN,NaN,310.84833333333336,303.2510526315789,293.9518000000002,299.9428,305.53439999999995,312.6515000000005,307.27753825990845,312.16266452244884,313.51846153846117,317.29633107361957,309.74059200330277,293.9518000000002,299.9428,305.53439999999995,312.6515000000005,316.43,96585802,55369195.6,67.75082434693229,1.0947765987751663,1.5,2.75,NaN,NaN,2.251459430384689,1.7443959760181165,1139.1447578210255,-0.0719160244766508,2.413881940311512,2.485797964788163,11.233543982434602,0.8972033979192495,62.21134156956125,11.304464977230442,26.484193453208302,9717723779
1576247400,316.87,318.67,316.02,317.32,NaN,NaN,311.3795238095238,303.2615789473684,294.13630000000023,300.1016,306.07239999999996,313.04000000000053,307.6713602889316,312.6538393298347,313.82230769230733,318.10516909269995,309.5394462919147,294.13630000000023,300.1016,306.07239999999996,313.04000000000053,317.33666666666664,81546487,56846426.25,68.09705098572469,1.0785926301271496,1.5,2.75,NaN,NaN,2.2799266139286423,1.4345050758577809,1140.0576287502008,0.04280638584459595,2.539305947093908,2.496499561249312,10.90697772006407,1.8226158387883478,66.73115243779223,8.913000466483549,24.355847095724226,9799270266
1576506600,319.22,320.15,319.17,319.5,NaN,NaN,311.9107142857143,303.27210526315787,294.3368000000002,300.2966,306.57539999999995,313.4255000000005,308.1352285128951,313.3058546317552,314.2392307692304,319.48765887990874,308.99080265855207,294.3368000000002,300.2966,306.57539999999995,313.4255000000005,319.6066666666666,82836128,57852923.05,71.83352477632178,1.5698356147833454,1.5,2.75,NaN,NaN,2.3192175700765953,1.431839976839338,1143.4215237357323,0.22883058577377557,2.782537793466531,2.5537072076927556,9.496144599576612,3.214343401712159,83.29903511943994,2.4449592881365,14.256005592423557,9882106394
1576593000,319.92,320.25,319.48,319.57,NaN,NaN,312.44190476190477,303.2826315789473,294.53955000000025,300.4722,307.1051999999999,313.8030000000005,308.5836509241541,313.9024399049214,314.55384615384577,320.50532451424806,308.6023677934435,294.53955000000025,300.4722,307.1051999999999,313.8030000000005,319.76666666666665,61131769,58443112.5,71.94713946762369,1.366763646762855,1.5,2.75,NaN,NaN,2.20855917221398,1.0460046767700812,1146.1783334861504,0.31461684828532066,2.9469782680494063,2.6323614197640857,7.698767911444702,2.603865664932901,100.00000000000001,0,0,9943238163
1576679400,320,320.25,319.53,319.59,NaN,NaN,312.97309523809525,303.2931578947368,294.7508500000002,300.6535,307.7263999999999,314.1860000000005,309.0152724565402,314.44411229492886,314.9599999999996,321.4827224141494,308.43727758584976,294.7508500000002,300.6535,307.7263999999999,314.1860000000005,319.78999999999996,48199955,57456719.35,71.98191366370321,1.2202993034444787,1.5,2.75,NaN,NaN,2.102233517055841,0.8388915264442435,1148.942304340505,0.32917089729058535,3.0438250413773176,2.7146541440867322,7.633337868698661,2.4261265303506163,100.00000000000001,0,0,9991438118
1576765800,319.8,320.98,319.5246,320.9,NaN,NaN,313.5042857142857,303.3036842105263,294.9803000000002,300.8553,308.3189999999999,314.69250000000045,309.48134020334254,315.05895874303087,315.67230769230724,322.59916580501346,308.74544957960103,294.9803000000002,300.8553,308.3189999999999,314.69250000000045,320.46819999999997,85388424,57741326.75,74.23480079353315,1.2538992104435809,1.5,2.75,NaN,NaN,2.0560311229804236,1.478809525276452,1151.4774736313677,0.3798895668345872,3.189516102629966,2.809626535795379,7.660931411925877,1.915076063137159,100.00000000000001,0,0,10076826542
1576852200,320.46,321.9742,319.3873,320.73,NaN,NaN,314.0354761904762,303.3142105263157,295.21165000000025,301.0883,308.8687999999999,315.2155000000004,309.92246411693696,315.59905791036124,316.5323076923072,322.96353513272396,310.10108025189044,295.21165000000025,301.0883,308.8687999999999,315.2155000000004,320.69716666666665,149338215,62475003,73.40986959922243,1.1945419088175993,1.5,2.75,NaN,NaN,2.093950328481823,2.390367472251262,1153.9336105769903,0.3553007758242832,3.253752505575733,2.8984517297514496,6.704365846105193,2.1823626863769667,53.76521358583735,16.49028029677002,29.74450611739261,9927488327
1577111400,321.59,321.65,321.06,321.22,NaN,NaN,314.56666666666666,303.3247368421052,295.4255500000002,301.3521,309.36759999999987,315.72850000000045,310.3655047398022,316.1343857284221,317.28307692307646,323.4435183888253,311.12263545732765,295.4255500000002,301.3521,309.36759999999987,315.72850000000045,321.31,53015641,62883273.65,74.2964835557236,1.0873179487595597,1.5,2.75,NaN,NaN,2.0100967335902613,0.8430801693798269,1155.5432406869563,0.3261095683238695,3.3060886901562867,2.979979121832417,5.923472847735523,2.4527158485631535,52.86471147605634,17.163361813115227,29.971926710828424,9980503968
1577197800,321.47,321.52,320.9,321.23,NaN,NaN,315.09785714285715,303.3352631578947,295.63425000000024,301.63820000000004,309.8731999999998,316.1215000000004,310.791563377457,316.61968232571525,317.99153846153797,323.6672402271569,312.315836695919,295.63425000000024,301.63820000000004,309.8731999999998,316.1215000000004,321.21666666666664,20270007,61458640.2,74.31530604657925,0.8999937014473082,1.5,2.75,NaN,NaN,1.9108041097623858,0.3298154162545236,1157.4368978628993,0.26418815836058007,3.3102143197831424,3.0460261614225623,5.714047468835315,2.16589275491381,46.66564903222319,21.6831416242385,31.65120934353832,10000773975
1577370600,321.65,322.95,321.64,322.94,NaN,NaN,315.62904761904764,303.3457894736842,295.84225000000026,302.0294,310.3543999999999,316.5645000000004,311.26797265677243,317.2216173423138,318.6123076923072,324.5459881111784,312.67862727343595,295.84225000000026,302.0294,310.3543999999999,316.5645000000004,322.51,31024188,61123451.95,77.3674117394576,1.0915914766544603,1.5,2.75,NaN,NaN,1.8971752447793562,0.5075660325169183,1159.8922687419818,0.2928860044508821,3.412133666986165,3.1192476625352827,5.94975576784471,1.8320562545328423,43.69597551695272,24.048893082247563,32.25513140079972,10031798163
1577457000,323.74,323.8,322.28,322.86,NaN,NaN,316.16023809523807,303.3563157894736,296.0507500000003,302.38000000000005,310.8435999999999,316.9335000000004,311.72256196435,317.7586061668553,319.3030769230764,324.95647282350086,313.6496810226519,296.0507500000003,302.38000000000005,310.8435999999999,316.9335000000004,322.97999999999996,42554820,61011534,76.90697553398856,1.0691002476064553,1.5,2.75,NaN,NaN,1.8702341558665478,0.6974881175746213,1158.4926200741215,0.26197669145333613,3.446718526851953,3.1847418353986168,4.788221233362688,1.7458716752804804,17.44358796932587,52.45742154287286,30.09899048780127,9989243343
1577716200,322.95,323.1,320.55,321.08,NaN,NaN,316.69142857142856,303.3668421052631,296.24960000000027,302.71110000000004,311.2795999999999,317.27200000000033,312.0895203186892,318.07492938905955,319.88384615384564,324.50210782120337,315.2655844864879,296.24960000000027,302.71110000000004,311.2795999999999,317.27200000000033,321.57666666666665,49782730,61671033.5,67.30862095661502,0.5662225778568195,1.5,2.75,NaN,NaN,1.9187888590189381,0.807230350696166,1156.4723737156698,0.08623995682231245,3.2925417814265074,3.206301824604195,6.371142027596894,0.49452269170578533,38.67285825328498,28.302956253752935,33.02418549296208,9939460613
1577802600,320.53,322.13,320.15,321.86,NaN,NaN,317.22261904761905,303.3773684210526,296.4472500000003,302.99350000000004,311.7573999999999,317.7830000000003,312.47267638462296,318.4354123043872,320.4561538461533,323.92516867824946,316.98713901405716,296.4472500000003,302.99350000000004,311.7573999999999,317.7830000000003,321.37999999999994,57106998,60720882.05,69.12693972488779,0.41047858953296357,1.5,2.75,NaN,NaN,1.9231610833747297,0.9404836700655274,1159.435302565376,-0.007882728827484087,3.19644841356984,3.204331142397324,5.358979459947497,0.7165879150108022,40.044633391729064,27.082875010736267,32.87249159753466,9996567611
1577975400,323.54,324.89,322.53,324.87,NaN,NaN,317.75380952380954,303.38789473684204,296.6596000000003,303.3260000000001,312.25499999999994,318.5490000000003,312.95884593816714,319.04823018015986,321.0515384615379,324.68561518188767,317.41746174118816,296.6596000000003,303.3260000000001,312.25499999999994,318.5490000000003,324.09666666666664,59253833,59924938.25,74.9233907338169,1.0313428666539894,1.5,2.75,NaN,NaN,2.0022210059908185,0.9888009021018891,1162.7849800100043,0.09641411365629304,3.32484878446769,3.228434670811397,7.2407624379555715,1.652116774617488,50.904012462162676,18.480316223178065,30.61567131465926,10055821444
1578061800,321.16,323.64,321.1,322.41,NaN,NaN,318.28499999999997,303.39842105263153,296.8639000000003,303.66940000000005,312.7229999999999,319.0965000000003,313.32947943078807,319.36839873443034,321.4430769230764,324.42245615231946,318.4636976938333,296.8639000000003,303.66940000000005,312.7229999999999,319.0965000000003,322.3833333333334,77783566,61354596.45,64.29824484669976,0.58181512132605,1.5,2.75,NaN,NaN,2.12849093413433,1.2677708028507455,1161.4675460708984,-0.029693308826473253,3.1913180347783054,3.2210113436047787,8.976306507564425,0.47055157369898654,22.816290454089444,45.14688335187108,32.036826194039485,9978037878
1578321000,320.49,323.73,320.36,323.64,NaN,NaN,318.81619047619046,303.408947368421,297.0584500000003,303.98030000000006,313.19819999999993,319.67750000000035,313.73381357075715,319.7752179025798,321.76153846153795,324.7270722300799,318.796004692996,297.0584500000003,303.98030000000006,313.19819999999993,319.67750000000035,322.57666666666665,55761948,62103610.4,66.83106142401883,0.5315063912886023,1.5,2.75,NaN,NaN,2.2171701531247354,0.8978857692949845,1162.8104081965555,-0.058048044904381424,3.148451287474302,3.2064993323786832,8.940754440605412,0.907305209989701,45.04352791426389,22.89697826500522,32.0594938207309,10033799826
1578407400,323.02,323.54,322.24,322.73,NaN,NaN,319.34738095238095,303.41947368421046,297.2758500000003,304.3686,313.6453999999999,320.0705000000003,314.0866051954333,320.05662572138175,322.0046153846149,324.7191757301714,319.2900550390584,297.2758500000003,304.3686,313.6453999999999,320.0705000000003,322.83666666666664,42854811,61798512.6,63.255584261161864,0.4487342784680425,1.5,2.75,NaN,NaN,2.158800856472967,0.6934602338632985,1160.0706957853004,-0.16008438614228426,3.006393849700828,3.1664782358431123,9.162775322573472,0.47008280928958057,46.93030875611086,21.419231442114533,31.650459801774588,9990945015
1578493800,322.94,325.78,322.67,324.45,NaN,NaN,319.87857142857143,303.42999999999995,297.50290000000024,304.76660000000004,314.10239999999993,320.5990000000003,314.4930128348281,320.4750423193454,322.37846153846107,324.99682093264653,319.7601021442756,297.50290000000024,304.76660000000004,314.10239999999993,320.5990000000003,324.3,68434153,63475004.5,66.86408167804878,0.9418413760071234,1.5,2.75,NaN,NaN,2.2267436524391804,1.0781275801248664,1162.7919203793276,-0.13474869589163951,2.998042365978563,3.1327910618702024,9.548558382792317,1.0023970363913615,49.24359727563367,19.6796774083548,31.07672531601154,10059379168
1578580200,326.16,326.73,325.52,326.65,NaN,NaN,320.4097619047619,303.44052631578944,297.7305500000003,305.1446000000001,314.5693999999999,321.2550000000003,314.9697574295407,321.06313352702676,322.82076923076875,326.1396333695168,319.5019050920207,297.7305500000003,305.1446000000001,314.5693999999999,321.2550000000003,326.3,48569601,63248026.3,70.81240157379696,1.1314825175925027,1.5,2.75,NaN,NaN,2.2305476772649553,0.7679227928729849,1164.7966318110625,0.00003277550880920188,3.132832031256214,3.132799255747405,10.06374103682664,1.1488202142812842,47.2044374846018,21.208978315021696,31.58658420037652,10107948769
1578666600,327.2899,327.46,325.2,325.71,NaN,NaN,320.94095238095235,303.4510526315789,297.9608500000002,305.4784,315.0193999999999,321.8195000000003,315.390943412696,321.5056922387385,323.2038461538457,326.61725445245685,319.79043785523453,297.9608500000002,305.4784,315.0193999999999,321.8195000000003,326.1233333333333,53057389,63224823.25,67.13169826752011,0.9348226734229143,1.5,2.75,NaN,NaN,2.2326514146031724,0.8391860391638185,1163.5030053627572,-0.004040264319261411,3.127748925348328,3.1317891896675896,10.078576823511767,0.8827355510128123,54.874859364330874,15.764056848248783,29.361083787420345,10054891380
1578925800,326.39,327.96,325.92,327.95,NaN,NaN,321.47214285714284,303.46157894736837,298.1970500000002,305.857,315.49559999999997,322.3605000000003,315.8834554357275,322.1194358350491,323.721538461538,327.7587945453779,319.6842823776981,298.1970500000002,305.857,315.49559999999997,322.3605000000003,327.27666666666664,47262010,60758633.65,71.00003136844556,1.14399142625365,1.5,2.75,NaN,NaN,2.2338905992743743,0.7778649248805153,1167.12287390676,0.10801827327154268,3.266812031257018,3.1587937579854755,10.60341139769636,2.1396536688675734,53.272169443155875,16.831700992497687,29.89612956434643,10102153390
1579012200,327.47,328.62,326.844,327.45,NaN,NaN,322.00333333333333,303.47210526315786,298.4219000000002,306.20700000000005,315.97799999999995,322.8670000000003,316.3370454186402,322.62710861266345,324.1999999999995,328.41319538885597,319.986804611143,298.4219000000002,306.20700000000005,315.97799999999995,322.8670000000003,327.638,63036384,59833128.5,69.04661133496768,1.0195368257861916,1.5,2.75,NaN,NaN,2.201184127897634,1.0535364868978896,1169.4172949265583,0.11188494568243845,3.2986499400885236,3.186764994406085,9.847372123439172,1.7367799664450303,46.43648741308232,21.798723183650928,31.76478940326676,10039117006
1579098600,327.35,329.02,327.26,328.19,NaN,NaN,322.5345238095238,303.4826315789473,298.6337000000002,306.56530000000004,316.419,323.30150000000026,316.8018671669288,323.1569077924098,324.6038461538456,329.2415879018089,319.96610440588233,298.6337000000002,306.56530000000004,316.419,323.30150000000026,328.1566666666667,72056598,59294152,70.34693964267123,1.005928912384736,1.5,2.75,NaN,NaN,2.1696709759049453,1.2152395399802665,1171.127373798394,0.12661525037682786,3.34503405737712,3.218418807000292,9.844954933820564,1.0219472404346333,47.3668591071629,21.08287671554415,31.55026417729295,10111173604
1579185000,329.7,330.92,329.45,330.92,NaN,NaN,323.0657142857143,303.4931578947368,298.8584500000002,307.026,316.89,323.86900000000026,317.35551943489236,323.8962499074184,325.22384615384567,330.81941329202044,319.6282790156709,298.8584500000002,307.026,316.89,323.86900000000026,330.43,54050328,58940079.95,74.58820771820854,1.4227931043037034,1.5,2.75,NaN,NaN,2.209694477626022,0.9170385931924749,1174.2818013571027,0.2740910516402195,3.5610326215505665,3.286941569910347,9.57929699164147,2.6394962935392794,48.624154092997436,20.13581692451774,31.24002898248482,10165223932
1579271400,331.7,332.18,330.8539,331.95,NaN,NaN,323.59690476190474,303.5036842105263,299.0861000000002,307.4655,317.3884,324.48700000000025,317.92785200607307,324.6632737257595,326.0599999999995,332.155127940871,319.96487205912797,299.0861000000002,307.4655,317.3884,324.48700000000025,331.6613,95846017,61322383.05,75.98389474388378,1.5258078276072162,1.5,2.75,NaN,NaN,2.1465805863670204,1.5629858500745268,1175.1269556118311,0.3879234958112816,3.7718459396744493,3.3839224438631677,7.455843076466908,2.56766777901372,78.42945556446432,3.9648425404324663,17.605701895103213,10261069949
1579617000,330.9,332.18,330.82,331.3,NaN,NaN,324.1280952380952,303.5142105263157,299.3067000000002,307.9098,317.87239999999997,325.0070000000003,318.4522499666192,325.2953428947348,326.78615384615335,332.95560981751265,320.61669787479406,299.3067000000002,307.9098,317.87239999999997,325.0070000000003,331.43333333333334,77742415,60940082.6,73.2497608965148,1.2532717938655937,1.5,2.75,NaN,NaN,2.090396258769377,1.2757188976964071,1172.478955467967,0.3666038193849226,3.842177218094321,3.475573398709398,7.922334384542392,2.655470517150557,52.74317492529528,17.39787970301877,29.85894537168595,10183327534
1579703400,332.24,332.95,331.17,331.34,NaN,NaN,324.6592857142857,303.5247368421052,299.5205500000002,308.33430000000004,318.33559999999994,325.53750000000025,318.95765192871255,325.87102452380765,327.28384615384573,333.7894155475444,320.77827676014704,299.5205500000002,308.33430000000004,318.33559999999994,325.53750000000025,331.82,48914899,55918916.8,73.31339981462807,1.1948251997714932,1.5,2.75,NaN,NaN,2.0682250974287055,0.8747468978154456,1172.3741269842947,0.30488964854057654,3.856685459385119,3.5517958108445424,7.385505035875641,2.123593774079207,75.43877932778447,5.143939489020487,19.417281183195026,10232242433
1579789800,330.63,332.1682,329.41,331.72,NaN,NaN,325.1904761904762,303.5352631578947,299.7352000000002,308.7257,318.7911999999999,326.0625000000003,319.45813616680226,326.42806980725453,327.9999999999996,334.24636755982897,321.75363244017024,299.7352000000002,308.7257,318.7911999999999,326.0625000000003,331.0994,52004140,55868341.75,73.9474927772028,0.9259163949056675,1.5,2.75,NaN,NaN,2.11750901904094,0.9308337847704241,1172.9627327036972,0.2420952504961602,3.8544148739647426,3.6123196234685824,7.217447692710902,1.552120006122777,73.7314391218447,5.830795174615087,20.437765703540215,10284246573
1579876200,332.44,332.53,327.36,328.77,NaN,NaN,325.7216666666667,303.5457894736842,299.94250000000017,309.0889,319.1995999999999,326.4395000000003,319.8233072975159,326.6511107779922,328.39461538461495,334.11541476601775,322.67381600321215,299.94250000000017,309.0889,319.1995999999999,326.4395000000003,329.55333333333334,87578442,59233763.5,61.692450633926605,0.3315074227970083,1.5,2.75,NaN,NaN,2.3355440891094412,1.4785223295831946,1168.9915527442556,-0.031149031481029432,3.5733833341172954,3.604532365598325,8.99688891478325,0.9394860458690254,43.034791821105166,24.77787255355104,32.18733562534378,10196668131
1580135400,323.03,325.12,322.66,323.5,NaN,NaN,326.2528571428571,303.5563157894736,300.1185500000002,309.41650000000004,319.48959999999994,326.4675000000003,319.9674913250643,326.35100498961197,328.4538461538457,333.95037114536797,322.9573211623234,300.1185500000002,309.41650000000004,319.48959999999994,326.4675000000003,323.76,84062463,61885677.25,46.7780253467035,1.2347369519285416,1.5,2.75,NaN,NaN,2.6051480827444777,1.3583508613861053,1164.207319379453,-0.5699612919529793,2.892080750657101,3.46204204261008,13.155160531448162,-1.3569141637444697,10.242778617412734,64.14663576742291,25.610585615164347,10112605668
1580221800,325.06,327.85,323.6038,326.89,NaN,NaN,326.7840476190476,303.5668421052631,300.3119500000002,309.745,319.8453999999999,326.6690000000004,320.2389622534932,326.40233784774415,328.64153846153806,333.72984086036445,323.5532360627117,300.3119500000002,309.745,319.8453999999999,326.6690000000004,326.11460000000005,63833953,62949633.9,54.412724143801455,0.46385390616032673,1.5,2.75,NaN,NaN,2.7297803625484454,1.0140480419855151,1167.7413157624144,-0.6930209616630925,2.5957658405312145,3.288786802194307,14.031663984728869,-0.17101847610322257,31.554415819736953,35.16405765646936,33.28152652379369,10176439621
1580308200,328.38,328.63,326.4,326.62,NaN,NaN,327.3152380952381,303.5773684210526,300.4942500000002,310.033,320.18679999999995,326.94600000000037,320.489199027866,326.4230675765304,328.6392307692304,333.73116986814046,323.5472916703203,300.4942500000002,310.033,320.18679999999995,326.94600000000037,327.21666666666664,54040889,63162541.85,53.75136227917004,0.08570445378951085,1.5,2.75,NaN,NaN,2.6940817652235576,0.8555844558684428,1168.4982283509387,-0.7810370853344564,2.3124904455262367,3.093527530860693,14.015510448487934,-0.47838142539382467,14.507757542553936,56.80878133110141,28.68346112634465,10122398732
1580394600,324.36,327.91,323.54,327.68,NaN,NaN,327.8464285714286,303.58789473684203,300.68280000000016,310.3293,320.5045999999999,327.2370000000004,320.77119122285166,326.54277542638465,328.7907692307689,333.63628078772905,323.9452576738087,300.68280000000016,310.3293,320.5045999999999,327.2370000000004,326.3766666666667,75491844,64081784.15,56.01184509623863,0.42359806414267454,1.5,2.75,NaN,NaN,2.8137902105647323,1.1780546531490417,1169.5749325978877,-0.7558170082298679,2.148756270573358,2.904573278803226,14.09089604846838,-0.9790886014746794,18.55907234747719,50.771167402018314,30.669760250504485,10197890576
1580481000,327,327.17,320.73,321.73,NaN,NaN,320.73,303.5984210526315,300.84065000000015,310.5646,320.6987999999999,327.08000000000044,320.80879156705356,326.08441586196705,328.3123076923073,334.45116829240123,322.17344709221334,300.84065000000015,310.5646,320.6987999999999,327.08000000000044,323.21000000000004,113845576,66811371.3,43.237046340161534,1.4549288236122986,1.5,2.75,NaN,NaN,3.109233766952965,1.7039850220826107,1164.72507417103,-1.1065839158587432,1.5213433839797972,2.6279272998385403,16.346519841275867,-3.078776924235569,16.188900309571686,54.21191638648626,29.599183303942066,10084045000
1580740200,323.35,326.16,323.22,324.12,NaN,NaN,321.07,303.608947368421,301.0140000000002,310.82449999999994,320.9425999999999,327.1655000000004,320.9386428781495,325.8973286370178,328.05615384615345,334.5831889297203,321.5291187625866,301.0140000000002,310.82449999999994,320.9425999999999,327.1655000000004,324.50000000000006,69242293,66384307.65,48.334362798156356,0.5749809776592856,1.5,2.75,NaN,NaN,3.203574212170611,1.0430521225749352,1167.8141764988088,-1.1398629557050022,1.2030986052072876,2.34296156091229,17.08307571570123,-2.1672200422577745,40.289773372013244,26.84762639115812,32.86260023682864,10153287293
1580826600,328.07,330.01,327.72,329.06,NaN,NaN,321.41,303.61947368421045,301.2092000000002,311.1126,321.3083999999999,327.4365000000004,321.25712747116324,326.1985354334923,328.1230769230766,334.6720328450987,321.5741210010545,301.2092000000002,311.1126,321.3083999999999,327.4365000000004,328.93,62573190,66724869.75,56.94134330340659,0.8575879104642707,1.5,2.75,NaN,NaN,3.395461768444138,0.9377791254511966,1169.1103997840473,-0.8070691875457809,1.3341250764800634,2.1411942640258443,19.825760000389078,-0.6881149272650368,40.14788938416424,26.97170700915306,32.8804036066827,10215860483
1580913000,332.27,333.09,330.67,332.86,NaN,NaN,321.75,303.62999999999994,301.4221500000002,311.4283,321.7601999999999,327.9430000000004,321.71214208013726,326.8329606303025,328.2723076923073,335.14957975366326,321.3950356309514,301.4221500000002,311.4283,321.7601999999999,327.9430000000004,332.20666666666665,65951146,67879686.5,62.162986688621665,1.4740258737158491,1.5,2.75,NaN,NaN,3.4407859278409836,0.9715888419726275,1173.360134006779,-0.3331863374005044,1.7247113422752136,2.057897679675718,21.02593568693877,0.34366333051971126,62.815165350258205,10.963400062575321,26.22143458716647,10281811629
1580999400,333.91,334.19,332.8,333.98,NaN,NaN,322.09000000000003,303.64052631578943,301.62765000000024,311.75719999999995,322.2205999999999,328.41950000000037,322.19323454758285,327.5136310464642,328.4284615384612,335.71280025466353,321.14412282225885,301.62765000000024,311.75719999999995,322.2205999999999,328.41950000000037,333.6566666666667,50359688,66975963.25,63.565411882021586,1.5952636588754527,1.5,2.75,NaN,NaN,3.294301218709484,0.7519068865351481,1172.6670307266952,0.034014753953204746,2.100416122117224,2.066401368164019,21.09054038226406,1.584694467256756,59.959262922435656,12.588833909398916,27.451903168165433,10332171317
1581085800,332.82,333.9941,331.6,332.2,NaN,NaN,322.43,303.65105263157886,301.8275000000002,312.07759999999996,322.59719999999993,328.6970000000004,322.5856567221874,327.9599518991819,328.4976923076919,335.9059336804168,321.08945093496703,301.8275000000002,312.07759999999996,322.59719999999993,328.6970000000004,332.5980333333334,64139443,67754455.35,59.77350024565693,1.0736389797899168,1.5,2.75,NaN,NaN,3.2300011316588053,0.9466453928184371,1169.7186105025444,0.12995174610977367,2.228841050801236,2.0988893046914625,20.587861864822536,2.6893353941267355,74.772618079723,5.312586258069222,19.914795662207773,10268031874
1581345000,331.23,334.75,331.19,334.68,NaN,NaN,322.77000000000004,303.66157894736835,302.0406500000002,312.4152,323.00919999999985,329.1455000000004,323.0599446938663,328.5999564802122,328.754615384615,336.747895698568,320.761335070662,302.0406500000002,312.4152,323.00919999999985,329.1455000000004,333.54,42070006,67205086.2,63.078231862933876,1.2056554300024087,1.5,2.75,NaN,NaN,3.2535724793974623,0.6259943760030472,1172.0626960048469,0.3224035420385851,2.5018937322396937,2.1794901902011086,17.622127836536997,2.3830646394811774,72.90638553287792,6.065611370710327,21.028003096411766,10310101880
1581431400,336.16,337.02,334.684,335.26,NaN,NaN,323.11,303.67210526315785,302.2499000000002,312.7568,323.4047999999999,329.5110000000004,323.53837823528335,329.23424633923963,329.0269230769227,337.6241189869083,320.4297271669371,302.2499000000002,312.7568,323.4047999999999,329.5110000000004,335.6546666666666,54864533,67585212.35,63.82669959512892,1.5038471484068985,1.5,2.75,NaN,NaN,3.1883173022976417,0.811783097105265,1175.637297769768,0.44327192187386055,2.733580092543434,2.2903081706695736,17.05200372629739,2.6452758557344884,72.16450444724163,6.379786944211715,21.455708608546647,10364966413
1581517800,336.83,337.65,336.43,337.42,NaN,NaN,323.45000000000005,303.6826315789473,302.46765000000016,313.12019999999995,323.86699999999985,330.00950000000046,324.0827555593899,330.01384192597874,329.6923076923073,339.37711626861596,320.0074991159986,302.46765000000016,313.12019999999995,323.86699999999985,330.00950000000046,337.1666666666667,43992662,66633026.25,66.5465322000503,1.661478037481145,1.5,2.75,NaN,NaN,3.1312946378478093,0.6602230826939216,1177.9329458264178,0.6127586855637577,3.056256527624271,2.443497842060513,17.037601172439658,2.9724121093750027,69.47542335075565,7.578988740014057,22.945587909230284,10408959075
1581604200,335.8621,338.12,335.56,337.06,NaN,NaN,323.79,303.69315789473677,302.6828500000002,313.508,324.37539999999984,330.4530000000005,324.5916671060805,330.6849045996951,330.73538461538425,340.4486510876841,321.0221181430844,302.6828500000002,313.508,324.37539999999984,330.4530000000005,336.91333333333336,54501922,65755292.45,65.66041514001608,1.4960508698828412,1.5,2.75,NaN,NaN,3.0904878780015372,0.8288598524817298,1177.6218603179987,0.6416166203295428,3.2455186174724417,2.603901997142899,17.21674080440847,4.764864948870166,39.54711647074062,27.48537142354218,32.9675121057172,10354457153
1581690600,337.51,337.73,336.2,337.6,NaN,NaN,324.13,303.70368421052626,302.9118000000002,313.9019,324.9363999999998,330.7870000000005,325.1017978078028,331.3434851140098,331.5592307692304,341.63802942028076,321.48043211818003,302.9118000000002,313.9019,324.9363999999998,330.7870000000005,337.1766666666667,64582210,66281886.55,66.38350788511737,1.2031222139233972,1.5,2.75,NaN,NaN,2.979024458144287,0.974356847119645,1178.6602537258962,0.6367918723054911,3.3998918375247626,2.7630999652192716,10.919705146041505,4.158953474021973,74.96050659470502,5.233599365129687,19.805894040165285,10419039363
1582036200,336.51,337.6677,335.21,336.73,NaN,NaN,324.47,303.7142105263157,303.1395500000002,314.3105,325.44179999999983,331.0260000000005,325.5578057369086,331.85648653172314,332.3369230769227,342.3310825547626,322.3427635990828,303.1395500000002,314.3105,325.44179999999983,331.0260000000005,336.5359,57342526,64356712,64.04367217075131,0.8904283450152267,1.5,2.75,NaN,NaN,2.9417869968482693,0.8910108086317399,1176.6578513226277,0.5196741090450447,3.4126926015255776,2.893018492480533,11.537932516104952,2.3308819060353785,48.04159776847384,20.596334774946477,31.362067456579684,10361696837
1582122600,337.79,339.08,337.48,338.34,NaN,NaN,324.81,339.08,303.3611000000002,314.7177,325.96819999999985,331.3780000000005,326.0590682570298,332.47396400489237,333.1569230769227,343.23705245525304,323.0767936985923,303.3611000000002,314.7177,325.96819999999985,331.3780000000005,338.29999999999995,48814692,62910325.85,66.40365329208636,1.2679536349121048,1.5,2.75,NaN,NaN,2.89951649707339,0.7759408545489198,1178.1147801161637,0.4953961298437459,3.5122636547852153,3.0168675249414694,9.102482560929758,1.6463377996755275,46.82936616116677,21.520048138321393,31.65058570051184,10410511529
1582209000,337.7423,338.64,333.6817,336.95,NaN,NaN,325.15000000000003,339.43048076923077,303.58175000000017,315.1172,326.40979999999985,331.6585000000005,326.4861636194992,332.9002531472836,334.3276923076919,342.09791219902576,326.55747241635805,303.58175000000017,315.1172,326.40979999999985,331.6585000000005,336.4239,74163362,64172749,62.58444611322069,0.5723771819125063,1.5,2.75,NaN,NaN,3.046572461568149,1.155683107793933,1180.587309602713,0.3379989210311507,3.4393661762304077,3.101367255199257,7.9818173125665295,0.8892748068746542,19.974261849372745,48.87437966558926,31.151358485038,10336348167
1582295400,335.47,335.81,332.58,333.48,NaN,NaN,325.49,339.7809615384615,303.8095000000002,315.498,326.8017999999999,331.74650000000054,326.7604317128522,332.9554671332566,335.0476923076919,340.1919327246452,329.90345189073855,303.8095000000002,315.498,326.8017999999999,331.74650000000054,333.9566666666666,113788208,67261952.4,54.20325121958781,0.3805271573839964,1.5,2.75,NaN,NaN,3.141103000027567,1.6917172924644392,1177.0743465953774,-0.028094928833212407,3.0662485941577415,3.094343522990954,10.20122581260925,0.3853100541842353,13.772212697557316,58.03970917418375,28.188078128258933,10222559959
1582554600,323.14,325.85,321.24,322.42,NaN,NaN,325.83000000000004,340.1314423076923,303.98395000000016,315.75449999999995,326.9795999999999,331.42900000000054,326.59021870450505,331.9520893110417,334.5369230769226,342.50262024421147,326.57122590963377,303.98395000000016,315.75449999999995,326.9795999999999,331.42900000000054,323.17,161088409,70937450.75,37.13380814635929,2.9815517785280754,1.5,2.75,NaN,NaN,3.791024214311313,2.2708513950933034,1169.9298747282014,-0.9901165799818727,1.856697798013613,2.8468143779954858,21.825291097199504,-3.663200669296041,1.272246166193085,88.14724629234153,10.58050754146538,10061471550
1582641000,323.94,324.61,311.69,312.65,NaN,NaN,326.17,340.48192307692307,304.11390000000017,315.94859999999994,326.94419999999985,330.8865000000005,326.0435434611911,330.11379509094246,332.98230769230724,347.1356071800814,318.82900820453307,304.11390000000017,315.94859999999994,326.94419999999985,330.8865000000005,316.31666666666666,218913168,77679986,28.573618649630546,5.157710590104225,1.5,2.75,NaN,NaN,4.443093913289077,2.818141187615559,1162.9492467717303,-2.190642005026439,0.10851187171243737,2.299153876738876,25.78980023228352,-6.744019566903304,0.7058307568398943,91.27476329992905,8.019405943231057,9842558382
1582727400,314.18,318.11,310.7,311.5,NaN,NaN,326.51000000000005,340.83240384615385,304.2309000000002,316.18299999999994,326.83159999999987,330.11700000000053,325.47320842349734,328.3410527013289,331.25307692307643,349.4202296733896,313.08592417276327,304.2309000000002,316.18299999999994,326.83159999999987,330.11700000000053,313.43666666666667,194773819,84226979.3,27.76236201331929,4.798049836431616,1.5,2.75,NaN,NaN,4.655015776625573,2.3124872887374224,1159.7079470175597,-2.922622270048878,-1.3541239608222213,1.5684983092266567,25.317617029012432,-7.681820876059516,0,100,0,9647784563
1582813800,305.46,311.5637,297.51,297.51,NaN,NaN,326.85,341.1828846153846,304.3141500000002,316.25389999999993,326.43539999999985,328.6615000000005,324.37661201473276,325.40476196786904,328.58461538461495,354.1115382645045,303.0576925047254,304.3141500000002,316.25389999999993,326.43539999999985,328.6615000000005,302.1945666666666,284353460,95742607.85,20.23553080744685,7.0015603661103185,1.5,2.75,NaN,NaN,5.326350364009461,2.9699782195769804,1150.5330589294917,-4.135313447044759,-3.6006434995792915,0.534669947465467,31.866652946520514,-11.733815937815228,0,100,0,9363431103
1582900200,288.7,297.892,285.54,296.26,NaN,NaN,327.19000000000005,341.53336538461537,304.3784500000002,316.27299999999997,325.9705999999998,327.09050000000053,323.2739997788609,322.6290703518815,325.6292307692303,356.0719057366401,295.1865558018205,304.3784500000002,316.27299999999997,325.9705999999998,327.09050000000053,293.23066666666665,385764020,111256216.65,19.721057386883018,9.33802088585792,1.5,2.75,NaN,NaN,5.828182480865927,3.467347997402894,1145.3852438589981,-4.763271382501654,-5.4194192806616,-0.6561478981599465,31.50073936758465,-12.24526066350712,0,100,0,8977667083
1583159400,298.21,309.16,294.46,309.09,NaN,NaN,327.53000000000003,341.88384615384615,304.4986000000002,316.43309999999997,325.76099999999985,326.4585000000005,322.71776449341536,321.33963508027375,323.6161538461534,354.69951921039,292.5327884819168,304.4986000000002,316.43309999999997,325.76099999999985,326.4585000000005,304.2366666666667,238703625,117499119.1,37.332408388006016,4.535961707838805,1.5,2.75,NaN,NaN,6.46188373223265,2.0315354432304,1153.2284657117993,-4.08240209215513,-5.759150513353859,-1.6767484211987291,44.394567211802865,-8.208356843762077,3.5726360501061243,79.6510435283877,16.776320421506192,9216370708
1583245800,309.5,313.84,297.57,300.24,NaN,NaN,327.87,342.2343269230769,304.5613000000002,316.55019999999996,325.37399999999985,325.26450000000057,321.83628353288924,319.3301460250096,320.7561538461533,353.05111324180575,288.4611944505009,304.5613000000002,316.55019999999996,325.37399999999985,325.26450000000057,303.8833333333333,300139150,129043961.95,32.10108012565517,4.572067868692084,1.5,2.75,NaN,NaN,7.162463465644602,2.325867444431793,1149.5181198159742,-3.9911398775690103,-6.665673268159992,-2.6745333905909816,45.611606024749534,-11.26086185493881,3.1903951285339516,80.83840000117722,15.97120487028882,8916231558
1583332200,306.12,313.1,303.33,312.86,NaN,NaN,328.21000000000004,342.58480769230766,304.6964000000002,316.7661,325.2131999999999,324.4545000000005,321.4842724139524,318.7139416416753,318.89461538461484,349.9831684255252,287.80606234370447,304.6964000000002,316.7661,325.2131999999999,324.4545000000005,309.7633333333334,176613448,134745974.85,44.124958870463765,1.6458039743749497,1.5,2.75,NaN,NaN,7.569430360955702,1.3107140914346949,1157.5629162708262,-2.8949542143037763,-6.293226158470702,-3.398271944166926,54.289289634479125,-7.149428698619966,11.081142355440198,62.704051136347495,26.214806508212313,9092845006
1583418600,304.98,308.47,300.01,302.46,NaN,NaN,328.55,342.93528846153845,304.7889500000002,316.85829999999993,324.8477999999999,322.9345000000005,320.73822251536603,317.165947199611,316.1915384615379,346.4027843005951,285.9802926224807,304.7889500000002,316.85829999999993,324.8477999999999,322.9345000000005,303.6466666666667,186366809,140766758,38.13213502362525,3.6569609807595875,1.5,2.75,NaN,NaN,7.946613906601725,1.3239404789019862,1150.5582594347418,-2.6888503006773217,-6.759334820013578,-4.070484519336256,56.182102720167116,-9.301907160849236,12.91693800456087,59.5101879041093,27.57287409132983,8906478197
1583505000,293.15,298.78,290.23,297.46,NaN,NaN,328.89000000000004,343.28576923076923,304.8437000000002,316.8700999999999,324.3725999999999,321.10850000000056,319.8253510441752,315.2891903234576,313.17076923076866,342.4006511606199,283.94088730091744,304.8437000000002,316.8700999999999,324.3725999999999,321.10850000000056,295.49,228667168,149682132,35.62691020109047,5.774698675385761,1.5,2.75,NaN,NaN,8.252570056130171,1.5276851347895017,1144.420387703616,-2.700692873349242,-7.446350611022808,-4.745657737673566,56.28035929178511,-7.741455244711878,17.026451706485933,53.07695708725586,29.8965912062582,8677811029
1583760600,275.3,284.19,273.45,274.23,NaN,NaN,329.23,343.63624999999996,304.7867000000002,316.65289999999993,323.4325999999999,318.21000000000055,318.0372980620507,311.3787912450331,308.2392307692302,340.3136005624633,276.16486097599704,304.7867000000002,316.65289999999993,323.4325999999999,318.21000000000055,277.29,309417350,161946027.35,26.81305713114365,10.455509894047134,1.5,2.75,NaN,NaN,9.378100766406586,1.9106201928083295,1127.5502958247907,-4.005759860123147,-9.7528575628275,-5.7470977027043535,68.4532713322129,-12.288501519270739,2.572685430227785,82.87335509553847,14.553959474233752,8368393679
1583847000,284.64,288.52,273.5,288.42,NaN,NaN,329.57000000000005,343.98673076923075,304.81810000000024,316.5482999999999,322.7421999999999,315.8970000000005,316.87583539295065,309.1922396978871,304.50615384615327,333.4932295215809,275.51907817072566,304.81810000000024,316.5482999999999,322.7421999999999,315.8970000000005,283.48,276444060,173664730.05,37.056712085458614,6.8352620161186355,1.5,2.75,NaN,NaN,9.781093568806114,1.5918261579101793,1133.1404657685403,-3.6557941707081785,-10.316840416089576,-6.661046245381398,77.38441077042717,-7.409309791332257,19.02740248767872,50.17516489215332,30.797432620167964,8644837739
1583933400,280.7,281.94,270.88,274.36,NaN,NaN,329.91,344.33721153846153,304.77600000000024,316.3078999999999,321.7721999999999,312.8520000000005,315.208547730482,305.8748835361836,299.95846153846094,327.8663405981337,272.05058247878816,304.77600000000024,316.3078999999999,321.7721999999999,312.8520000000005,275.72666666666663,256416563,183742331.55,32.24141547597195,8.993439471817808,1.5,2.75,NaN,NaN,10.33530117103425,1.3955225278624694,1122.408554799683,-4.081348551341979,-11.762731934558872,-7.681383383216892,80.8963904138155,-7.781251050384854,5.507513231451564,74.32607088318386,20.166415885364568,8388421176
1584019800,256,266.66,247.68,248.11,NaN,NaN,330.25000000000006,344.6876923076923,304.61580000000026,315.79619999999994,320.31279999999987,308.38650000000047,312.5772321332082,300.37346605654704,294.2423076923071,330.575113088104,257.90950229651025,304.61580000000026,315.79619999999994,320.31279999999987,308.38650000000047,254.15,392220670,201153731.95,25.562716924846868,15.812419737617883,1.5,2.75,NaN,NaN,11.502779658817518,1.949855298222818,1106.1912800594562,-5.7393107267506736,-14.855521791655235,-9.116211064904562,94.07491431357454,-16.25261594545331,4.360065588359827,77.33700733138625,18.30292708025392,7996200506
1584106200,263.09,271.4754,248.5237,269.32,NaN,NaN,330.59000000000003,345.03817307692304,304.57105000000024,315.5096999999999,319.2619999999999,304.99950000000047,310.8808700887687,297.41599309878063,290.9092307692302,327.8211529304097,253.99730860805067,304.57105000000024,315.5096999999999,319.2619999999999,304.99950000000047,263.10636666666664,329566100,214906940.85,36.930885813860066,10.628683725374874,1.5,2.75,NaN,NaN,12.350109683187693,1.5335293438941529,1115.561855938648,-5.04094174045432,-15.417388240472462,-10.376446500018142,110.32315687289841,-12.866802549419258,19.880592122941856,49.00751931457705,31.11188856248109,8325766606
1584365400,241.18,256.9,237.36,239.85,NaN,NaN,330.93000000000006,345.38865384615383,304.37515000000025,314.9082999999999,317.5615999999998,300.1120000000004,308.09534577156205,291.9335175655634,285.3976923076917,329.1320513782603,241.6633332371231,304.37515000000025,314.9082999999999,317.5615999999998,300.1120000000004,244.70333333333335,297240030,226539831.85,30.061282500389737,15.39230294909523,1.5,2.75,NaN,NaN,13.75081613438857,1.3120872721262242,1098.9275540296408,-6.125069564358572,-18.032783455466358,-11.907713891107786,120.00412830562284,-20.113908872901685,20.996695138063178,47.56895364051805,31.43435122141878,8028526576
1584451800,245.04,256.17,237.07,252.8,NaN,NaN,331.27000000000004,345.7391346153846,304.26280000000025,314.44619999999986,316.1693999999998,295.9155000000004,305.92690083934394,288.20651589265265,281.958461538461,328.29631637154887,235.62060670537312,304.26280000000025,314.44619999999986,316.1693999999998,295.9155000000004,248.67999999999998,262070471,236776229.1,35.719689910383636,11.40204745368613,1.5,2.75,NaN,NaN,14.132900696217959,1.1068276236856414,1102.5838391734214,-5.548494512572782,-18.843332031823763,-13.294837519250981,127.94690270464937,-19.197084958128237,18.853568066412837,50.46589275467443,30.680539178912724,8290597047
1584538200,236.25,248.37,228.02,240,NaN,NaN,331.61,346.08961538461534,304.0899500000003,313.8473999999999,314.49659999999983,290.99850000000043,303.3415321789775,283.6154191409714,277.63076923076864,328.13862724028945,227.12291122124782,304.0899500000003,313.8473999999999,314.49659999999983,290.99850000000043,238.79666666666665,327597130,250715351,32.88744041267324,15.616329084415678,1.5,2.75,NaN,NaN,14.893407789345249,1.3066496674150598,1089.0112828293024,-5.591906790391006,-20.28472100723974,-14.692814216848733,123.4957628798093,-20.650664550684382,18.021515646977615,51.63664546986817,30.341838883154207,7962999917
1584624600,239.25,247.38,232.22,240.51,NaN,NaN,331.95000000000005,346.4400961538461,303.8898500000003,313.24879999999985,312.85219999999987,286.17650000000043,300.87755052489996,279.5101411275456,272.355384615384,322.94384338758374,221.7669258431843,303.8898500000003,313.24879999999985,312.85219999999987,286.17650000000043,240.0366666666667,289322040,261473284.9,33.115001207390264,11.471633560982216,1.5,2.75,NaN,NaN,14.912450090106303,1.1065070762798987,1096.2866546055595,-5.159481179800956,-21.142165691599928,-15.982684511798972,124.43445905523592,-19.145431318496602,45.32097160411222,22.744736457404375,31.9342919384834,8252321957
1584711000,242.53,244.47,228.5,228.8,NaN,NaN,332.29,346.7905769230769,303.6190500000003,312.5207999999999,310.93919999999986,280.94250000000045,298.05097991608034,274.68060387730316,266.85999999999945,319.6128460770649,214.107153922934,303.6190500000003,312.5207999999999,310.93919999999986,280.94250000000045,233.92333333333332,347158790,273141814,30.553328881898665,12.773189724283416,1.5,2.75,NaN,NaN,14.987989369384424,1.2709836876165728,1093.517779984587,-5.21957041491234,-22.507147530439397,-17.287577115527057,125.2809660398239,-16.566385880465305,16.685339706110472,53.576080380204836,29.738579913684696,7905163167
1584970200,228.19,229.6833,218.26,222.95,NaN,NaN,218.26,347.1410576923077,303.3098000000003,311.7172999999999,308.86519999999985,275.96900000000045,295.10584344878305,269.7538796985124,259.9438461538456,310.2798271910921,209.60786511659907,303.3098000000003,311.7172999999999,308.86519999999985,275.96900000000045,223.63109999999998,326025170,281388652.05,29.332562771432023,15.423860608041206,1.5,2.75,NaN,NaN,14.73336870014268,1.1586294174438438,1086.2590159594643,-5.199340469956315,-23.78675270297245,-18.587412233016135,120.31781284214141,-22.69953539976424,16.730859906453695,53.47577919614036,29.79336089740594,7579137997
1585056600,234.42,244.1,233.8,243.15,NaN,NaN,215.33228571428572,347.4915384615384,303.0873000000003,311.1166999999999,307.2139999999999,272.4940000000005,293.06835939196804,267.22017687008264,255.3815384615379,299.89041456587023,210.87266235720557,303.0873000000003,311.1166999999999,307.2139999999999,272.4940000000005,240.35,235494475,282217717.4,38.47396913728946,5.854227392710674,1.5,2.75,NaN,NaN,15.191699507275347,0.8344425614718689,1098.1473856262155,-3.45552801501848,-22.906822251789237,-19.451294236770757,129.5886764369425,-11.375564951159063,15.215226121817741,55.76988639419057,29.01488748399168,7814632472
1585143000,244.87,256.35,239.75,246.79,NaN,NaN,212.40457142857142,347.8420192307692,302.8764000000003,310.5431999999999,305.5907999999999,269.2585000000005,291.2535217687536,265.2744457395986,251.4838461538456,288.8761600810178,214.09153222667342,302.8764000000003,310.5431999999999,305.5907999999999,269.2585000000005,247.62999999999997,299430255,287450539.2,39.98064454005071,2.3668083004206144,1.5,2.75,NaN,NaN,15.292292399612823,1.041675746489607,1106.5669395864256,-1.7717656300602656,-21.666001274346087,-19.89423564428582,128.90634440337683,-0.5320220869775589,41.14449469698925,26.17072598604686,32.684779316963905,8114062727
1585229400,249.52,262.8,249.05,261.2,NaN,NaN,209.47685714285714,348.1925,302.73790000000025,310.1218999999999,304.2657999999999,267.44300000000044,290.07495228762605,264.88640328820827,250.4815384615379,286.03456611246764,214.92851081060815,302.73790000000025,310.1218999999999,304.2657999999999,267.44300000000044,257.68333333333334,257632816,286114507,45.65442193197436,1.3536435415500412,1.5,2.75,NaN,NaN,15.343557228211909,0.900453523665614,1115.4822499355212,0.4774473794714318,-19.297426419946532,-19.774873799417964,120.0563471358774,-3.015000742611022,40.74312055023359,26.517276492422624,32.73960295734379,8371695543
1585315800,253.27,260.81,251.05,253.42,NaN,NaN,206.54914285714284,348.5429807692307,302.56305000000026,309.5946999999999,302.7703999999999,265.30100000000044,288.6375031783074,263.79436487980746,247.7892307692302,275.98161758829906,219.59684395016134,302.56305000000026,309.5946999999999,302.7703999999999,265.30100000000044,255.09333333333333,224341217,278043366.85,43.275795063902386,0.7580272914089704,1.5,2.75,NaN,NaN,14.9725888547682,0.8068569286208813,1108.4671147827162,1.5459642640094131,-17.842418469406198,-19.38838273341561,110.6916878588085,5.65770273087346,46.37622523986917,21.888701592136695,31.73507316799414,8147354326
1585575000,255.7,262.43,253.53,261.65,NaN,NaN,203.62142857142857,348.8934615384615,302.42340000000024,309.13749999999993,301.3849999999999,262.9290000000004,287.57916972033456,263.59013965315916,246.81153846153788,271.9684208000519,221.65465612302387,302.42340000000024,309.13749999999993,301.3849999999999,262.9290000000004,259.2033333333333,170961866,274656278.9,46.45395530123195,1.9431350394364455,1.5,2.75,NaN,NaN,14.546689650856186,0.6224575192116608,1112.7097554698355,2.8366275030051966,-15.842598354659117,-18.679225857664314,87.07787808950141,3.500791139240493,77.23950189799982,4.378890101153661,18.381608000846526,8318316192
1585661400,260.56,263.33,256.22,257.75,NaN,NaN,200.69371428571426,349.2439423076923,302.2658500000002,308.64469999999994,299.90099999999984,260.8045000000004,286.4093983587528,263.0339358766678,247.55307692307633,273.3787581006141,221.72739574553856,302.2658500000002,308.64469999999994,299.90099999999984,260.8045000000004,259.09999999999997,194881060,269393374.4,45.16262886701421,1.2904797780795274,1.5,2.75,NaN,NaN,14.015497532937884,0.7234070267468315,1109.902380195277,3.418295563598651,-14.406356403166,-17.82465196676465,83.17506345292439,7.395833333333333,51.803176160982844,17.82485513359704,30.371968705420123,8123435132
1585747800,247.98,257.6591,243.9,246.15,NaN,NaN,197.766,349.5944230769231,302.04975000000024,308.0352,298.19799999999987,257.4690000000004,284.8305984231154,261.4259419836518,245.77076923076862,268.3335874692714,223.20795099226584,302.04975000000024,308.0352,298.19799999999987,257.4690000000004,249.2363666666667,189554623,270040433.15,41.47007975836596,3.322527719914603,1.5,2.75,NaN,NaN,14.003676280585179,0.7019490407005371,1101.2386277714938,3.0259001825558833,-14.042276738569797,-17.06817692112568,81.83522156714815,2.345016839216671,22.985183509733023,44.90416889801118,32.11064759225581,7933880509
1585834200,245.19,252.68,244.59,251.83,NaN,NaN,194.8382857142857,349.9449038461538,301.84690000000023,307.4717,296.6077999999998,254.9375000000004,283.5364573084834,260.5120427471135,246.6923076923071,269.191068210432,224.19354717418227,301.84690000000023,307.4717,296.6077999999998,254.9375000000004,249.7,177660430,269605114.2,43.88925928151192,1.8524880007828932,1.5,2.75,NaN,NaN,13.58127083197195,0.658965355784041,1104.6679134113904,3.139423313493669,-13.143897779258594,-16.283321092752264,82.65275267980033,10.06555944055944,17.20633934063506,52.696966502515664,30.096694156849274,8111540939
1585920600,250.76,253.32,245.22,248.19,NaN,NaN,191.91057142857142,350.2953846153846,301.6225500000003,306.8642,294.93719999999985,252.4740000000004,282.1503217277586,259.33851486643607,246.3376923076917,268.58411384028386,224.09127077509953,301.6225500000003,306.8642,294.93719999999985,252.4740000000004,248.91,135561171,264949814.35,42.67203324460713,2.407393732728545,1.5,2.75,NaN,NaN,13.189751486831097,0.5116484845727163,1099.2713583048856,2.9621592888065855,-12.58062198174403,-15.542781270550616,76.38841529050815,11.320923973985202,21.308627230522667,47.04542105404123,31.64595171543609,7975979768
1586179800,257.84,267,248.1698,264.86,NaN,NaN,188.98285714285714,350.6458653846154,301.46755000000024,306.4293,293.6589999999999,252.00550000000038,281.4722698952975,259.8643705934422,248.2499999999994,272.1974116153858,224.302588384613,301.46755000000024,306.4293,293.6589999999999,252.00550000000038,260.0099333333333,188061238,258882008.75,49.56999654784236,3.0295755471752406,1.5,2.75,NaN,NaN,13.592640666343161,0.7264361046487746,1108.990490903093,3.9013133734805674,-10.666139553699907,-14.567452927180474,79.31772384372509,8.92864486942217,22.692784799698952,45.27802167899129,32.02919352130976,8164041006
1586266200,274.21,275.03,264.89,265.13,NaN,NaN,186.05514285714284,350.99634615384616,301.32320000000027,305.99060000000003,292.49159999999983,250.8410000000004,280.8313965660701,260.3658591083524,250.14384615384557,275.2111740019355,225.07651830575563,301.32320000000027,305.99060000000003,292.49159999999983,250.8410000000004,268.34999999999997,201427189,255131165.2,49.67561642359456,4.533575679292505,1.5,2.75,NaN,NaN,13.348166333032934,0.7895044450649497,1116.2335246916057,4.435483122549538,-9.023099023993552,-13.45858214654309,65.99767161321778,7.431419425422426,53.6691508737709,16.550625574081646,29.780223552147465,8365468195
1586352600,267.96,276,265.2542,274.03,NaN,NaN,183.12742857142854,351.3468269230769,301.22515000000027,305.6399,291.43439999999987,250.8245000000004,280.5646751321066,261.6672058599379,253.62307692307633,278.4289600771415,228.81719376901114,301.22515000000027,305.6399,291.43439999999987,250.8245000000004,271.76140000000004,153774487,249999061.4,53.15819707478455,5.197554880257583,1.5,2.75,NaN,NaN,13.17115445210201,0.6151002573324061,1123.440003258377,5.228451550495979,-6.923017708423117,-12.151469258919096,67.42592176713124,4.911944869831541,82.39007134455439,2.7018064769723753,14.908122178473224,8519242682
1586439000,277.58,281.2,275.47,278.2,NaN,NaN,180.19971428571426,351.6973076923077,301.16235000000023,305.32640000000004,290.4659999999999,252.3290000000004,280.4719427739847,263.24175768280094,257.8730769230763,278.83607345669503,236.91008038945762,301.16235000000023,305.32640000000004,290.4659999999999,252.3290000000004,278.29,190282705,239902163.15,54.73864785279896,5.9914706139049745,1.5,2.75,NaN,NaN,12.742500562666153,0.7931679418873134,1130.3666708124215,5.828287012739954,-4.866110492994153,-10.694397505734107,60.902039074611274,9.778233762134008,83.08380531625671,2.5039690508435317,14.412225632899757,8709525387
1586784600,277.14,277.51,271.41,275.66,NaN,NaN,177.272,352.04778846153846,301.08830000000023,304.9651,289.42559999999986,252.6460000000004,280.28323913578924,264.4244474272961,260.37384615384553,281.4707588531907,239.27693345450032,301.08830000000023,304.9651,289.42559999999986,252.6460000000004,274.86000000000007,115139268,229180821.55,53.55337973856837,4.07487627031759,1.5,2.75,NaN,NaN,12.31732195104714,0.502394865422368,1125.124613328316,5.8341257383171445,-3.401740332837676,-9.23586607115482,57.383473371272274,5.35448117714506,84.35820789141584,2.1559205008705375,13.485871607713603,8594386119
1586871000,280.98,284.9,275.5106,283.79,NaN,NaN,174.3442857142857,352.3982692307692,301.04975000000024,304.68280000000004,288.6667999999999,254.8430000000004,280.42075916967985,266.26878576755365,263.2199999999994,286.1244624473035,240.31553755269533,301.04975000000024,304.68280000000004,288.6667999999999,254.8430000000004,281.4002,134143350,221025987.55,56.77931532035105,6.021020838096032,1.5,2.75,NaN,NaN,12.108184668829484,0.606912116927673,1130.626841041154,6.134990061592501,-1.5671284941641943,-7.702118555756695,56.9726159300522,10.10281280310379,83.41666006321405,2.408661122263121,14.174678814522801,8728529469
1586957400,277.57,279.26,275.46,277.76,NaN,NaN,171.41657142857142,352.74875,300.9735500000003,304.3411,287.7395999999999,256.0910000000004,280.3164156728297,267.3631871230247,264.49384615384554,288.61682025095774,240.3708720567333,300.9735500000003,304.3411,287.7395999999999,256.0910000000004,277.49333333333334,121775006,214011214.3,53.79493341971186,3.61049366208415,1.5,2.75,NaN,NaN,11.838314335341666,0.5690122660081556,1123.7555758218305,5.687357905939255,-0.592921173332627,-6.280279079271882,58.04051966205878,12.841763152549253,57.68064832526962,13.951563230925714,28.36778844380465,8606754463
1587043800,279.15,280.03,275.76,279.1,NaN,NaN,168.4888571428571,353.09923076923076,300.89075000000025,304.0244,286.7403999999999,258.0460000000004,280.2687130974246,268.4809788255938,266.46923076923014,290.8458582403136,242.09260329814668,300.89075000000025,304.0244,286.7403999999999,258.0460000000004,278.2966666666667,131798325,204221274.05,54.36891402839008,3.14009705577766,1.5,2.75,NaN,NaN,11.297720454245832,0.6453702025565244,1125.6857287163127,5.251421818590759,0.28399819396656767,-4.967423624624192,47.23497503559894,10.828733669538979,56.338649146300256,14.792719224506069,28.86863162919369,8738552788
1587130200,285.38,287.3,282.4,286.64,NaN,NaN,165.56114285714284,353.44971153846154,300.8418000000002,303.7881,285.81599999999986,260.3525000000004,280.5185674857609,270.2104094136325,268.39153846153783,294.80139308631476,241.9816838367609,300.8418000000002,303.7881,285.81599999999986,260.3525000000004,285.44666666666666,146684784,197089411.25,57.56338937529598,4.653947530081878,1.5,2.75,NaN,NaN,11.076454707513987,0.7442550214630062,1132.4746085126333,5.229369553405697,1.56928831713293,-3.6600812362727675,47.589475035619536,15.492163262017,53.36399327687248,16.744084596737334,29.891922126390188,8885237572
1587389400,282.61,286.7912,281.35,281.59,NaN,NaN,162.63342857142857,353.80019230769227,300.7557500000002,303.4944,284.76819999999987,262.9920000000004,280.5605844471036,271.29417994566745,270.225384615384,296.73546701131517,243.7153022194528,300.7557500000002,303.4944,284.76819999999987,262.9920000000004,283.2437333333333,100224647,184742704.1,54.79647285432792,3.4739760713242305,1.5,2.75,NaN,NaN,10.673936514120129,0.5425093645146012,1126.9936582002758,4.652504487402013,2.155549372979749,-2.4969551144222644,48.29821301100324,6.316544589594488,55.92089284788723,15.07039215033145,29.008715001781326,8785012925
1587475800,276.73,278.04,272.02,273.04,NaN,NaN,159.70571428571427,354.15067307692306,300.6286500000002,303.0911,283.58499999999987,265.4965000000004,280.26565956682504,271.46044852227055,272.2938461538455,294.8717557640597,249.7159365436313,300.6286500000002,303.0911,283.58499999999987,265.4965000000004,274.3666666666666,126385698,174760730.5,50.38101230917797,0.3536102497864191,1.5,2.75,NaN,NaN,10.595083905968691,0.7231927769951728,1122.0028975059836,3.524167904146021,1.9082547657602618,-1.6159131383857592,41.05313037713692,2.9834420850149077,27.53120999191569,39.511388568434704,32.957401439649594,8658627227
1587562200,278.35,281,276.91,279.1,NaN,NaN,156.77799999999996,354.50115384615384,300.5400500000002,302.74129999999997,282.4733999999999,267.29400000000044,280.21994742694955,272.1880248534829,274.39153846153783,293.8224984459884,254.9605784770873,300.5400500000002,302.74129999999997,282.4733999999999,267.29400000000044,279.0033333333334,93524584,167662235.95,53.25602794058161,1.9540413995788073,1.5,2.75,NaN,NaN,10.406863626970926,0.5578154404900743,1126.8124791376536,3.0336727026936576,2.1761777399813127,-0.8574949627123448,42.40747337344251,1.8501623909791083,51.91705589330969,17.749291623370972,30.333652483319348,8752151811
1587648600,280.49,283.94,278.75,279.08,NaN,NaN,153.8502857142857,354.85163461538457,300.44950000000017,302.3773,281.3497999999999,268.90850000000046,280.1752436062849,272.84440343886547,276.7676923076916,289.0357098990306,264.4996747163526,300.44950000000017,302.3773,281.3497999999999,268.90850000000046,280.59,104709693,157926207.85,53.24506281249502,2.0351702776806513,1.5,2.75,NaN,NaN,10.034230510758718,0.6630292364105544,1130.4631328773655,2.5737509415301307,2.3596937142003185,-0.21405722732981214,38.530061191431216,0.3163191948238661,24.628233392755245,42.89357071180015,32.47819589544459,8647442118
1587735000,280.73,283.7,278.5,282.97,NaN,NaN,150.92257142857142,355.20211538461535,300.3713000000002,302.0639,280.26079999999985,269.99700000000047,280.28484189623447,273.8087459684973,278.16076923076855,288.6940234186804,267.6275150428567,300.3713000000002,302.0639,280.26079999999985,269.99700000000047,281.72333333333336,85165953,149302864.7,55.178096926565125,2.225200592611599,1.5,2.75,NaN,NaN,9.68892833141881,0.5704241051980298,1133.6403320518893,2.4007628456535213,2.7868963297370897,0.3861334840835683,38.37802503471465,2.6518174562867305,16.667824978303194,53.49405847369115,29.838116548005658,8732608071
1587994200,285.12,288.27,284.62,287.05,NaN,NaN,147.99485714285711,355.55259615384614,300.31000000000023,301.818,279.26059999999984,271.6785000000005,280.5501422140292,275.06981778102136,279.84692307692245,288.3111950829382,271.3826510709067,300.31000000000023,301.818,279.26059999999984,271.6785000000005,286.6466666666667,77896608,141980634.25,57.17784727795453,3.375266573099583,1.5,2.75,NaN,NaN,9.375433450603177,0.5486424850225656,1139.5915224090083,2.423341066160825,3.4153098167845997,0.9919687506237745,38.31034693136119,1.1487367419570778,37.58703261401429,29.25411237868965,33.15885500729607,8810504679
1588080600,291.02,291.4,285.4,285.73,NaN,NaN,145.0671428571428,355.9030769230769,300.23540000000025,301.5798,278.22319999999985,272.8825000000005,280.75327389191045,276.0850732304479,280.7469230769224,289.03197313337654,272.4618730204683,300.23540000000025,301.5798,278.22319999999985,272.8825000000005,287.51,105283871,138696734.5,56.302636468076145,3.0524103761695622,1.5,2.75,NaN,NaN,9.134331061274379,0.7590940866744055,1144.2988284494872,2.217174208303989,3.7634365110037606,1.5462623026997717,35.00295008132805,2.8693836405530053,40.081923026728845,27.013714990505644,32.904361982765515,8705220808
1588167000,291.53,294.88,290.41,293.21,NaN,NaN,142.13942857142854,356.25355769230765,300.1977000000002,301.3973,277.35279999999983,274.65550000000053,281.24177295497276,277.7160186370719,281.9015384615378,292.3469624759222,271.4561144471534,300.1977000000002,301.3973,277.35279999999983,274.65550000000053,292.8333333333333,118745579,134889960.45,60.03573185503191,4.468995707833007,1.5,2.75,NaN,NaN,9.13545027118335,0.8803144326224022,1153.626207502576,2.4349840273070424,4.589992336833575,2.1550083095265324,34.57355857084283,5.055535650304535,44.05111859663816,23.663540570591284,32.28534083277055,8823966387
1588253400,291.71,293.3239,288.59,290.48,NaN,NaN,139.21171428571427,356.60403846153844,300.15155000000027,301.1819,276.39559999999983,276.8720000000006,281.6040563685032,278.9316359097317,283.04153846153787,293.7450356503567,272.338041272719,300.15155000000027,301.1819,276.39559999999983,276.8720000000006,290.7979666666667,122901701,131557314.35,58.08532155066296,2.9514824492361895,1.5,2.75,NaN,NaN,8.821053823241682,0.934206521372333,1148.5068767680161,2.2499880942236734,4.967493427306124,2.7175053330824506,35.601581405080076,1.3396595032096121,40.42177243821125,26.71677598131971,32.861451580469044,8701064686
1588339800,285.31,290.6572,281.52,282.79,NaN,NaN,136.284,356.9545192307692,300.0768000000003,300.8611,275.31239999999985,278.4200000000006,281.6505639618953,279.29909915642395,282.9646153846148,293.659861245451,272.26936952377855,300.0768000000003,300.8611,275.31239999999985,278.4200000000006,284.9890666666667,125180028,128933294.25,52.874449511514385,0.9490365883777732,1.5,2.75,NaN,NaN,8.843635693010134,0.9708898599711377,1142.411948700504,1.5005553213521061,4.593199484772583,3.092644163420477,36.36587266156897,0.42615149685714887,16.843214572424415,53.218288908282226,29.93849651929335,8575884658
1588599000,280.74,283.9,279.13,283.57,NaN,NaN,133.3562857142857,357.30499999999995,300.0005000000003,300.558,274.31419999999986,280.1890000000006,281.72583596338956,279.7058516177169,283.4115384615379,293.67639664903936,273.1466802740364,300.0005000000003,300.558,274.31419999999986,280.1890000000006,282.2,80873213,126198896.35,53.33176752626219,0.16290288359732283,1.5,2.75,NaN,NaN,8.55266171493798,0.640839304772573,1141.1414032608263,0.9737465200199806,4.309827313445453,3.3360807934254724,34.85407779789832,3.8565777907998724,16.26726434061551,54.13110819523336,29.601627464151118,8656757871
1588685400,286.64,289.25,283.7134,286.19,NaN,NaN,130.4285714285714,357.65548076923073,299.94560000000024,300.2846,273.58959999999985,281.25550000000055,281.90090121972725,280.32338955888673,283.95692307692246,293.9984901768585,273.9153559769864,299.94560000000024,300.2846,273.58959999999985,281.25550000000055,286.38446666666664,79569938,120774331.35,54.91443881856312,1.6161126225788847,1.5,2.75,NaN,NaN,8.34747159244241,0.6588315340733203,1144.0541983102592,0.7292954351185541,4.247700087323665,3.5184046522051107,28.63040166987782,2.5403081332855515,36.20272770888492,30.596836840106473,33.2004354510086,8736327809
1588771800,288.04,288.46,283.78,284.25,NaN,NaN,127.50085714285711,358.0059615384615,299.87735000000026,299.98290000000003,273.02159999999986,282.21150000000057,281.99302274052224,280.69735245804037,283.77307692307636,293.6982597646128,273.8478940815399,299.87735000000026,299.98290000000003,273.02159999999986,282.21150000000057,285.49666666666667,73632628,114384603.3,53.46849164393396,0.8998678267730456,1.5,2.75,NaN,NaN,8.085509335839381,0.6437284903360766,1140.6871404474232,0.381964467678241,3.995860236802912,3.613895769124671,27.004714251761676,1.8525154077683876,13.357763796394408,58.70729391010857,27.934942293497013,8662695181
1588858200,287.75,289.78,287.13,287.68,NaN,NaN,124.57314285714283,358.3564423076923,299.81560000000025,299.6884,272.54519999999985,282.8940000000006,282.2160414565802,281.3623665096556,284.24153846153786,294.2845286572447,274.198548265831,299.81560000000025,299.6884,272.54519999999985,282.8940000000006,288.19666666666666,75250412,110458399.55,55.68998416704625,1.5169404009379266,1.5,2.75,NaN,NaN,7.902972954707995,0.6812556791205111,1144.9568909355394,0.3301883266430621,4.026631177428499,3.6964428507854366,27.574374379285764,1.6644874014913167,38.06876912122171,28.864013778323685,33.067217100454585,8737945593
1588944600,291.09,292.95,289.86,292.44,NaN,NaN,121.64542857142854,358.70692307692303,299.7706000000003,299.4396,272.44379999999984,283.60600000000056,282.6169810073025,282.4173792230217,285.73384615384555,294.3377792024813,277.1299131052098,299.7706000000003,299.4396,272.44379999999984,283.60600000000056,291.75,76622128,104775370.7,58.64096024059238,2.334696661289411,1.5,2.75,NaN,NaN,7.714903457943137,0.7312990399183574,1151.0472597743367,0.5504993427100611,4.384567029173013,3.834067686462952,27.97813165293828,1.87772165128026,76.85705991710597,4.529847439543393,18.613092643350623,8814567721
1589203800,290.34,294,289.88,292.5,NaN,NaN,118.71771428571425,359.0574038461538,299.73310000000026,299.1696,272.36859999999984,284.4480000000006,283.00455037956516,283.37762882082916,286.7646153846148,295.15051055864194,278.37872021058763,299.73310000000026,299.1696,272.36859999999984,284.4480000000006,292.12666666666667,79514231,102994118.85,58.678317134958114,2.4174180466302966,1.5,2.75,NaN,NaN,7.458124639518628,0.7720269068547889,1148.0727302170862,0.6286025308359564,4.619820850007898,3.9912183191719413,27.104076845544945,2.369369684667337,78.50686129269774,3.940245920927555,17.552892786374706,8894081952
1589290200,293.79,294.24,286.52,286.67,NaN,NaN,115.78999999999996,359.4078846153846,299.65640000000025,298.8406,271.92019999999985,284.5920000000006,283.14829350193514,283.6911879807502,287.348461538461,294.47532878054403,280.22159429637793,299.65640000000025,298.8406,271.92019999999985,284.5920000000006,289.1433333333334,95870786,101080490.65,53.61123315819163,1.2022656803584528,1.5,2.75,NaN,NaN,7.476830022410156,0.9484598401086214,1143.5443206169625,0.23615955704385172,4.286417765476756,4.050258208432904,29.78829403081178,-2.2304832713754523,46.017312325552275,22.132623922401677,31.850063752046044,8798211166
1589376600,286.06,287.19,278.965,281.6,NaN,NaN,112.86228571428568,359.75836538461533,299.5571000000002,298.4607,271.54739999999987,284.7840000000006,283.0875761097024,283.4920272206788,287.24307692307633,294.6604012783718,279.82575256778085,299.5571000000002,298.4607,271.54739999999987,284.7840000000006,282.585,144721099,102227795.3,49.599928991860686,1.6809844525431255,1.5,2.75,NaN,NaN,7.530270735095146,1.4156727001232707,1136.4700394135148,-0.38267695677621694,3.571912012462633,3.95458896923885,26.469465539362478,-3.057009088405396,34.11798737852315,32.59877472048009,33.283237900996745,8653490067
1589463000,278.95,285.11,276.37,284.97,NaN,NaN,276.37,360.1088461538461,299.47835000000026,298.10139999999996,270.9895999999998,285.0775000000006,283.16139665441995,283.6327865329951,287.08307692307636,294.5992354534243,279.56691839272844,299.47835000000026,298.10139999999996,270.9895999999998,285.0775000000006,282.1500000000001,121977890,101736773.55,52.1621023324705,1.162590566026065,1.5,2.75,NaN,NaN,7.616679968302636,1.1989557535953528,1138.7697049410342,-0.5714788420677062,3.240240416654217,3.811719258721923,27.686471725071932,0.7708900597616629,40.228338400744974,26.92566257275819,32.84599902649684,8775467957
1589549400,282.37,286.33,281.34,286.28,NaN,NaN,277.94054054054055,360.4593269230769,299.4226000000002,297.7569,270.6659999999999,285.0595000000006,283.28369482483487,283.8849021012813,287.125384615384,294.6167524288094,279.63401680195864,299.4226000000002,297.7569,270.6659999999999,285.0595000000006,284.65,111146276,99959848.15,53.15895283773903,0.32476726162337144,1.5,2.75,NaN,NaN,7.429059970566734,1.1119092121189862,1140.946284827002,-0.6110079181303498,3.047959361058986,3.6589672791893357,22.789600497823,0.9556723207673519,44.10380697684369,23.658459573352648,32.23773344980367,8886614233
1589808600,293.05,296.75,292.7,295,NaN,NaN,279.5110810810811,360.8098076923077,299.42340000000024,297.49469999999997,270.6167999999999,285.7300000000006,283.7431577728806,284.9434828535402,287.2630769230763,295.2463763551637,279.2797774909889,299.42340000000024,297.49469999999997,270.6167999999999,285.7300000000006,294.81666666666666,120320229,100964627.25,59.2466267663418,2.9610517204455546,1.5,2.75,NaN,NaN,7.646269972669112,1.1917067618352446,1148.790156051689,-0.08062201024883553,3.558189766378291,3.6388117766271266,28.172706250820447,3.078374506446767,49.17644089528365,19.77261331359593,31.05094579112042,9006934462
1589895000,294.35,296.205,291.95,291.97,NaN,NaN,281.08162162162165,361.1602884615384,299.42015000000026,297.2021,270.9715999999999,286.6765000000006,284.0657790366892,285.6126749627269,287.3776923076917,295.5821607106499,279.1732239047335,299.42015000000026,297.2021,270.9715999999999,286.6765000000006,293.375,95189316,99404808.15,56.49888755860852,2.294348304486258,1.5,2.75,NaN,NaN,7.404036403192746,0.9575926735491617,1146.0363707780461,0.029498066780509813,3.675684360102764,3.646186293322254,29.05404652587792,2.7159190853122346,49.01946018454491,19.88848748640034,31.092052329054752,8911745146
1589981400,295.82,297.87,295.57,296.93,NaN,NaN,282.65216216216214,361.5107692307692,299.48570000000024,296.94199999999995,271.1417999999999,287.56800000000055,284.57025829015237,286.6905154424672,288.465384615384,297.6403995695024,279.2903696612656,299.48570000000024,296.94199999999995,271.1417999999999,287.56800000000055,296.79,85861691,99021663.5,59.78668805232536,2.6363078363933186,1.5,2.75,NaN,NaN,7.29660523153612,0.8671000664415217,1152.0496893293953,0.3802668883732774,4.121519903788851,3.7412530154155736,29.595590862499094,3.2153781979977754,80.09740294720721,3.4204354666337253,16.482161586159044,8997606837
1590067800,296.79,297.67,293.6886,294.88,NaN,NaN,284.2227027027027,361.86125,299.5211000000002,296.6622,271.55219999999986,288.3580000000006,284.974561886617,287.4704663527084,289.335384615384,298.63270801974204,280.03806121102593,299.5211000000002,296.6622,271.55219999999986,288.3580000000006,295.4128666666667,78293925,97700875.1,57.84089362543596,1.8978975190163374,1.5,2.75,NaN,NaN,7.059804857854969,0.8013636000687163,1154.00981821882,0.4152532711510899,4.260319604354436,3.845066333203346,29.801351205385753,0.8343591847900417,55.92175117786308,15.121422716648526,28.956826105488407,8919312912
1590154200,294.57,295.63,293.22,295.44,NaN,NaN,285.79324324324324,362.21173076923077,299.5584500000002,296.40579999999994,272.49879999999985,288.98150000000055,285.38497122439674,288.2294695572124,290.04692307692244,299.682144952511,280.41170120133387,299.5584500000002,296.40579999999994,272.49879999999985,288.98150000000055,294.7633333333333,63958200,96640487.45,58.24071349974737,1.4713944862733406,1.5,2.75,NaN,NaN,6.727675939436755,0.6618157843325323,1156.3745814761373,0.4160969513667303,4.365187522411759,3.9490905710450286,28.45411840437548,1.0051282051282044,50.85064693183913,18.558795843866267,30.590557224294606,8983271112
1590499800,301.93,302.19,298.69,299.08,NaN,NaN,287.3637837837838,362.5622115384615,299.58575000000025,296.17799999999994,273.0939999999999,289.58300000000054,285.92203117638115,289.26285340890644,291.1876923076917,301.30692655614797,281.0684580592354,299.58575000000025,296.17799999999994,273.0939999999999,289.58300000000054,299.9866666666667,88951442,97193229.15,60.84033426610995,2.8423528610534445,1.5,2.75,NaN,NaN,6.729270515191272,0.9152020441950713,1162.3006800298062,0.5911064553978953,4.687973640292398,4.096867184894503,29.15631402419263,4.329019430006617,46.407941892115126,21.844117765637645,31.747940342247233,9072222554
1590586200,302.12,303.57,296.87,303.53,NaN,NaN,288.93432432432434,362.9126923076923,299.6453000000002,295.96459999999996,274.36759999999987,290.4730000000005,286.61253975769955,290.62162927472485,292.40692307692245,304.21956658908977,280.59427956475514,299.6453000000002,295.96459999999996,274.36759999999987,290.4730000000005,301.3233333333333,104817449,97169908.05,63.80672351859082,2.749298937006096,1.5,2.75,NaN,NaN,6.727179764106181,1.078702770265717,1168.1219163635099,0.9164504927650823,5.242430300850856,4.325979808085774,26.088656554492815,7.787642045454527,79.32895943968913,3.6661582668889636,17.00488229342193,9177040003
1590672600,304.65,306.84,302.24,302.97,NaN,NaN,290.5048648648649,363.26317307692307,299.7198000000002,295.7702,275.37099999999987,290.9610000000005,287.2540087868094,291.7976645818939,293.21692307692246,306.30301054442526,280.13083560941965,299.7198000000002,295.7702,275.37099999999987,290.9610000000005,304.01666666666665,90767807,95771019.45,63.158339109885915,3.2728510245427436,1.5,2.75,NaN,NaN,6.575238352384308,0.9477585967160758,1165.6156741565394,0.9971509593406633,5.572418507261602,4.575267547920939,22.126053806394125,6.316454363617222,49.58089512195747,19.452363128759732,30.9667417492828,9086272196
1590759000,302.46,304.96,299.47,304.32,NaN,NaN,292.07540540540543,363.6136538461538,299.7786500000002,295.577,276.6573999999999,291.65300000000053,287.9232633441894,292.9902679550469,294.1261538461532,308.4688357935372,279.7834718987692,299.7786500000002,295.577,276.6573999999999,291.65300000000053,302.9166666666667,119265702,95589219.5,64.10528901460074,2.2678988403340945,1.5,2.75,NaN,NaN,6.497721327213997,1.2476898820164548,1166.1880256280117,1.0399021526210088,5.8751452386972005,4.835243086076192,21.974482369780258,6.301522984490716,77.83606351971066,4.179396076898777,17.984540403390543,9205537898
1591018200,303.62,306.205,303.06,305.55,NaN,NaN,293.645945945946,363.9641346153846,299.8869000000002,295.4052,277.95819999999986,292.7910000000005,288.6145079189271,294.18643291170906,295.57846153846094,310.42180938010233,280.73511369681955,299.8869000000002,295.4052,277.95819999999986,292.7910000000005,304.93833333333333,56779836,92169209.9,64.98828199710206,2.665009741502474,1.5,2.75,NaN,NaN,6.258241232412996,0.6160390879080324,1170.9255824291956,1.0465981213902733,6.143490737814034,5.0968926164237605,21.99496597263257,3.5762711864406818,76.93865687535943,4.487415259588521,18.57392786505205,9262317734
1591104600,306.55,308.13,305.1,308.08,NaN,NaN,295.2164864864865,364.31461538461537,300.00405000000023,295.2415,279.54379999999986,294.0165000000005,289.3778605495574,295.50962977726056,297.615384615384,311.460789552397,283.76997967837104,300.00405000000023,295.2415,279.54379999999986,294.0165000000005,307.1033333333333,74267162,91838907.35,66.797526742204,2.6153573181812475,1.5,2.75,NaN,NaN,6.027652572954923,0.8086677438023766,1175.109620292254,1.1109219143335833,6.48554500934074,5.3746230950071565,16.315038956618707,5.517690173647963,76.2130435895195,4.755879007981287,19.031077402499207,9336584896
1591191000,310.24,313.22,309.94,312.18,NaN,NaN,296.787027027027,364.66509615384615,300.1207000000002,295.0968,281.3283999999999,295.3160000000006,290.2720620966336,297.0972840841881,299.70846153846094,313.50120399160767,285.9157190853142,300.1207000000002,295.0968,281.3283999999999,295.3160000000006,311.78000000000003,92567574,92488789.15,69.54417058590599,3.6249141587262805,1.5,2.75,NaN,NaN,5.96424881774386,1.000851831348686,1180.3129487333263,1.3056554679511994,7.006692429946156,5.701036961994957,14.009582110422546,5.135890613949416,75.61301684748663,4.983209800848369,19.40377335166499,9429152470
1591277400,311.11,313,309.08,311.36,NaN,NaN,298.35756756756757,365.0155769230769,300.2158500000002,294.95329999999996,282.69259999999986,296.67150000000055,291.09904005362836,298.4556379809321,301.6376923076917,314.3514502193714,288.923934396012,300.2158500000002,294.95329999999996,282.69259999999986,296.67150000000055,311.14666666666665,75794363,92596875.9,68.32675904919661,2.8048954972875264,1.5,2.75,NaN,NaN,5.818231045047871,0.8185412549107394,1182.204367457124,1.2549603195386014,7.269737361418208,6.014777041879607,13.28638319399244,5.588714053174179,78.81742901047912,3.825351811323797,17.357219178197095,9353358107
1591363800,317.23,321.275,317.16,319.34,NaN,NaN,299.9281081081081,365.36605769230766,300.3621000000002,294.86719999999997,284.1435999999999,298.2545000000006,292.20652867897627,300.444624839891,303.50999999999937,318.6916650551354,288.32833494486334,300.3621000000002,294.86719999999997,284.1435999999999,298.2545000000006,319.25833333333327,150524674,96360589,73.23683180003351,4.628175105185963,1.5,2.75,NaN,NaN,6.11085739897302,1.5620979029092485,1188.2480679617381,1.611827872061978,8.029561881957079,6.417734009895101,15.594048257077283,8.089629027890597,80.81660455729767,3.1738727992503666,16.009522643451973,9503882781
1591623000,320.22,323.41,319.63,323.2,NaN,NaN,301.49864864864867,323.41,300.5158500000002,294.82469999999995,285.3835999999999,299.7925000000006,293.42195892685953,302.61180342656803,305.912307692307,322.8153800645553,289.00923532005874,300.5158500000002,294.82469999999995,285.3835999999999,299.7925000000006,322.08,73641217,96211543.45,75.23657926736236,4.539173528196295,1.5,2.75,NaN,NaN,5.965081870474951,0.7654093714676812,1194.6320757590042,1.938837786243015,8.84128124269887,6.902443456455854,15.230182145684866,8.06473184432259,83.3894519073039,2.4752786257062884,14.135269466989818,9577523998
1591709400,320.3,323.2849,319.36,320.79,NaN,NaN,303.0691891891892,323.2038157894737,300.6580000000002,294.7507,286.7309999999999,301.20700000000056,294.4952154395317,304.34306024308535,307.74769230769164,325.51058908088885,289.9847955344944,300.6580000000002,294.7507,286.7309999999999,301.20700000000056,321.1449666666667,77479228,96109793.3,71.63749161348193,3.788849776499799,1.5,2.75,NaN,NaN,5.819354594012453,0.8061533100810446,1189.6243893593858,1.825435355451818,9.184237650770626,7.358802295318808,17.68648915561199,5.6864230883273645,61.90154758506838,11.662839345225276,26.435613069706356,9500044770
1591795800,321.42,322.39,318.2209,319,NaN,NaN,304.63972972972977,322.9976315789474,300.82875000000024,294.6315,287.8779999999999,302.82350000000054,295.4561873830795,305.7389592675534,309.6030769230763,326.62547553308264,292.58067831306994,300.82875000000024,294.6315,287.8779999999999,302.82350000000054,319.8703,95000766,96066292.3,68.99741298513769,3.0151801423126288,1.5,2.75,NaN,NaN,5.7014792658687075,0.9889084269363438,1185.1810958576173,1.4773421569919734,9.205479991558775,7.728137834566802,18.266392240190356,5.290952899627016,33.87699162487548,33.15141475982176,32.97159361530275,9405044004
1591882200,311.46,312.15,300.01,300.61,NaN,NaN,306.21027027027026,322.7914473684211,300.8918000000002,294.3181,288.7351999999999,303.7740000000005,295.6582976817823,305.25048695635786,310.0007692307686,325.88451314428744,294.1170253172497,300.8918000000002,294.3181,288.7351999999999,303.7740000000005,304.25666666666666,209243560,99292415.35,49.01268089265277,2.3498987362822144,1.5,2.75,NaN,NaN,6.650659318306658,2.107346862924309,1172.8545211328835,-0.0623434282514328,7.650208549252511,7.712551977503944,41.31889465060391,-1.2191114616193413,21.46917710037105,47.20848244561158,31.32234045401737,9195800444
1591968600,308.24,309.08,298.6,304.21,NaN,NaN,307.7808108108108,322.58526315789476,300.9785000000002,294.04720000000003,289.89639999999986,304.7360000000005,295.99365855700654,305.1513929605143,310.39538461538393,325.4051119544491,295.38565727631874,300.9785000000002,294.04720000000003,289.89639999999986,304.7360000000005,303.96333333333337,194678879,102927464.8,51.94689902807394,1.9871389427712933,1.5,2.75,NaN,NaN,6.924183652713323,1.8914181883162442,1178.9229712609247,-0.8646906533275756,6.631688660844475,7.49637931417205,41.88066752288329,-0.43855342824416027,25.57119087604503,42.13423723856405,32.29457188539093,9390479323
1592227800,298.02,308.28,296.74,307.05,NaN,NaN,296.74,322.37907894736844,301.0693000000002,293.8043,291.00079999999986,305.77450000000056,296.42724057437886,305.33221267856055,310.6661538461532,325.2928281902069,296.0394795020995,301.0693000000002,293.8043,291.00079999999986,305.77450000000056,304.0233333333333,135782724,104159287.2,54.18676337593787,1.4086192542453588,1.5,2.75,NaN,NaN,7.253884820376654,1.3036065016389629,1182.5136337545123,-1.209358731107856,5.9846809002872305,7.1940396313950865,42.1746129485962,-0.33432874578030797,28.466568203600875,38.451229156390156,33.082202640008965,9526262047
1592314200,315.48,315.64,307.67,312.96,NaN,NaN,297.71000000000004,322.1728947368421,301.1712000000002,293.6167,292.2961999999998,306.6725000000005,297.07558408126596,306.0586686139357,311.43461538461474,325.39783876250493,297.47139200672456,301.1712000000002,293.6167,292.2961999999998,306.6725000000005,312.09,137627502,105024650.85,58.519823526107686,1.1210131971705197,1.5,2.75,NaN,NaN,7.349321618921176,1.3104304645255578,1187.8730252239868,-1.0504177148108402,5.881017487881536,6.931435202692376,43.34056128292638,0.24985585239284153,48.624600844694406,20.1083057236949,31.267093431610682,9663889549
1592400600,314.07,314.39,310.86,311.66,NaN,NaN,298.68,321.9667105263158,301.2672500000002,293.44559999999996,293.2321999999998,307.6570000000005,297.647521960432,306.5921287459418,311.9992307692301,325.3460424577527,298.65241908070755,301.2672500000002,293.44559999999996,293.2321999999998,307.6570000000005,312.30333333333334,83398944,104435132.25,57.237421029167976,1.0090285855022818,1.5,2.75,NaN,NaN,7.076512931855376,0.798571727762618,1184.1901757454323,-1.0418874672631144,5.629075868613484,6.670963335876598,42.776714675151176,0.09635149023638596,50.26570940364306,18.907640879880823,30.82664971647611,9580490605
1592487000,310.005,312.3,309.51,311.78,NaN,NaN,299.65000000000003,321.7605263157895,301.37245000000024,293.3284,294.16519999999986,308.3995000000005,298.2017367855131,307.0862117225188,312.47846153846086,325.3017140867564,299.6552089901653,301.37245000000024,293.3284,294.16519999999986,308.3995000000005,311.19666666666666,80828658,104183480.6,57.33037389020917,0.4709915771063355,1.5,2.75,NaN,NaN,6.770333436722851,0.7758298871807898,1182.8413079074123,-1.0350831903875175,5.377109347892201,6.412192538279719,42.74823478338235,-2.3673827268741787,85.04100945446582,1.9808550861353365,12.978135459398848,9661319263
1592573400,314.17,314.38,306.53,308.64,NaN,NaN,300.62,321.5543421052632,301.4454500000002,293.1459,294.8573999999998,309.0875000000005,298.6110804409832,307.2341915584694,312.52153846153783,325.28904010536377,299.7540368177119,301.4454500000002,293.1459,294.8573999999998,309.0875000000005,309.84999999999997,135549624,107046265.55,54.02136803308715,0.21879985049438921,1.5,2.75,NaN,NaN,6.847452476956934,1.2662713949295732,1179.4970276371125,-1.2354038300078116,4.867937750769954,6.103341580777766,39.8588370817793,-4.504950495049505,50.29638593440375,18.885565559472848,30.818048506123407,9525769639
1592832600,307.99,311.05,306.75,310.62,NaN,NaN,301.59000000000003,321.34815789473686,301.50945000000024,292.98589999999996,295.50579999999985,309.8465000000005,299.0820184629054,307.5566495052818,312.4015384615378,325.2088869438789,299.59418997919676,301.50945000000024,292.98589999999996,295.50579999999985,309.8465000000005,309.4733333333333,74649389,107580825,55.75553894236255,0.2568307239321608,1.5,2.75,NaN,NaN,6.665491585745725,0.6938912115611681,1181.327328158885,-1.225483041696748,4.571487778656831,5.796970820353579,39.18961862605003,-3.170298326007673,44.280227965936355,23.48670004221833,32.23307199184532,9600419028
1592919000,313.49,314.5,311.6101,312.05,NaN,NaN,302.56,321.14197368421054,301.57945000000024,292.82959999999997,296.2335999999998,310.4950000000005,299.59056675847773,307.9845876476359,312.4546153846147,325.24997179084124,299.6592589783882,301.57945000000024,292.82959999999997,296.2335999999998,310.4950000000005,312.72003333333333,68471246,106556815.2,57.01647597683654,0.9770125055727277,1.5,2.75,NaN,NaN,6.466527901049601,0.6425796967700663,1183.4244331782784,-1.1166136548861232,4.401203751745925,5.517817406632048,39.4050570769796,-2.1786833855799337,34.88812906007018,31.813129949183008,33.2987409907468,9668890274
1593005400,309.84,310.51,302.1,304.09,NaN,NaN,303.53000000000003,320.9357894736842,301.60890000000023,292.65319999999997,296.6395999999998,310.52300000000054,299.7670151208904,307.61367453833725,311.28153846153776,324.1329085678606,298.4301683552149,301.60890000000023,292.65319999999997,296.6395999999998,310.52300000000054,305.56666666666666,132813492,107956617.35,48.6969600813874,1.5580360109412807,1.5,2.75,NaN,NaN,6.7153473366889145,1.2302487356510343,1177.463539112409,-1.548135191504298,3.5826484172516757,5.130783608755974,41.584330556104554,1.1576461195568881,28.596063007485206,38.318166318194834,33.08577067431996,9536076782
1593091800,303.47,307.64,301.28,307.35,NaN,NaN,304.5,320.7296052631579,301.65500000000026,292.48549999999994,297.23139999999984,310.74200000000053,300.0643870769339,307.5885626775432,310.062307692307,321.02862017497876,299.09599520963525,301.65500000000026,292.48549999999994,297.23139999999984,310.74200000000053,305.42333333333335,89467968,107891625.4,51.79897024704334,1.1435628231396318,1.5,2.75,NaN,NaN,6.689965384068279,0.829239226569294,1180.4847407896343,-1.576179516519515,3.1605592131065805,4.736738729626095,23.443057727709096,1.0321817165773786,29.62073239275733,37.200615825696985,33.178651781545675,9625544750
1593178200,306.16,306.39,299.42,300.05,NaN,NaN,305.47,320.5234210526316,301.6540000000003,292.19539999999995,297.65039999999976,310.5285000000006,300.06382287783845,306.870604327301,308.4669230769224,318.7389115283231,298.1949346255217,301.6540000000003,292.19539999999995,297.65039999999976,310.5285000000006,301.9533333333333,127961017,108326391.15,45.207258183674895,2.3548785542905923,1.5,2.75,NaN,NaN,6.77853928520626,1.1812543152371044,1174.6570256154907,-2.0201841100642453,2.2115085920457886,4.231692702110034,26.828765643469012,-2.2797589969060414,30.996165586988564,35.73766230792017,33.266172105091265,9497583733
1593437400,301.41,304.61,298.93,304.46,NaN,NaN,306.44,320.3172368421053,301.6698500000003,291.9113999999999,298.00679999999977,310.47400000000056,300.2362219806683,306.64102296279617,307.34846153846087,315.793158904826,298.90376417209575,301.6698500000003,291.9113999999999,298.00679999999977,310.47400000000056,302.6666666666667,79773260,109476062.35,49.396701703557405,1.4922638908528627,1.5,2.75,NaN,NaN,6.700072193405814,0.7286822186293221,1179.5795015403448,-1.949719835424374,1.794542907829566,3.74426274325394,27.753734232579294,-2.716002044989775,30.353063891486254,36.41502360771701,33.23191250079673,9577356993
1593523800,303.99,310.2,303.82,308.36,NaN,NaN,307.41,320.11105263157896,301.7062000000003,291.6551999999999,298.5421999999998,310.48800000000057,300.55480151083816,306.8047350615775,307.9446153846147,315.4436024562578,300.44562831297156,301.7062000000003,291.6551999999999,298.5421999999998,310.48800000000057,307.46,113394772,111432442.85,52.83146191957942,0.05061188921563793,1.5,2.75,NaN,NaN,6.677209893876827,1.0176100343832677,1183.2030957205213,-1.5885934974922629,1.7585208713886118,3.3471143688808747,26.293600995261308,-1.0588461785278864,36.01975478888391,30.72649366555391,33.253751545562196,9690751765
1593610200,309.57,311.89,309.07,310.52,NaN,NaN,308.38,319.90486842105264,301.75800000000027,291.43839999999994,299.2917999999998,310.40500000000054,300.9455936084523,307.1585698176177,308.4299999999993,315.7129748782389,301.1470251217597,301.75800000000027,291.43839999999994,299.2917999999998,310.40500000000054,310.49333333333334,72396542,110423891.25,54.66676639980739,1.0431367343089664,1.5,2.75,NaN,NaN,6.452409187171338,0.6556238978763574,1184.6120224847166,-1.171638657838384,1.8825660465828946,3.0542047044212786,26.651959573025426,-0.40413111809609054,67.33427520140685,8.605032433078057,24.060692365515095,9763148307
1593696600,314.24,315.7,311.51,312.23,NaN,NaN,309.35,319.6986842105263,301.8145500000003,291.2138999999999,299.9543999999998,310.44850000000054,301.3881193492973,307.6415631683208,308.82846153846083,316.3293777744196,301.3275453025021,301.8145500000003,291.2138999999999,299.9543999999998,310.44850000000054,313.1466666666667,69344217,110101383.95,56.12231417708055,1.5552008077737318,1.5,2.75,NaN,NaN,6.361522816659101,0.6298214837289517,1187.649423750867,-0.7675966037815991,2.0947089496942795,2.8623055534758786,26.864388547471666,1.1631674442716537,65.7808979855543,9.384203806578702,24.83489820786699,9832492524
1594042200,316.37,317.68,315.56,317.05,NaN,NaN,310.32,319.49250000000006,301.89430000000027,291.0317999999999,300.71379999999976,310.3340000000006,302.0023107473641,308.53760477133784,309.1430769230762,317.59373874374177,300.6924151024106,301.89430000000027,291.0317999999999,300.71379999999976,310.3340000000006,316.7633333333333,61713828,105660841.65,60.01902975448524,2.2337346934419147,1.5,2.75,NaN,NaN,6.296414044040594,0.5840747341803897,1191.867366943481,-0.19260614329458647,2.6215478743576455,2.814154017652232,27.269996270224482,2.0700534415040908,100,0,0,9894206352
1594128600,315.38,317.52,313.37,313.78,NaN,NaN,311.29,319.28631578947375,301.9578000000003,290.7953999999999,301.32999999999976,309.86300000000057,302.46418091413415,309.0368805074009,309.3061538461531,318.022449948953,300.5898577433532,301.9578000000003,290.7953999999999,301.32999999999976,309.86300000000057,314.89,82909963,106124278.95,56.36201349794503,1.5156768640204823,1.5,2.75,NaN,NaN,6.14309875518055,0.7812534871408895,1187.2131468470652,-0.05645639546759451,2.7435835233177386,2.800039918785333,28.11758844068595,0.5543983336003722,75.77643115552661,4.92918455757856,19.294384286894847,9811296389
1594215000,314.61,316.3,312.7,316.18,NaN,NaN,312.26,319.08013157894743,302.0473000000003,290.5865999999999,301.9125999999998,309.63250000000056,303.0020561724034,309.71717760193417,309.64461538461467,319.03455309355235,300.254677675677,302.0473000000003,290.5865999999999,301.9125999999998,309.63250000000056,315.05999999999995,54638596,104982247.35,58.367054379641786,1.2530049834113866,1.5,2.75,NaN,NaN,5.9614488440962266,0.5204555758636081,1189.6671187340228,0.159474130055012,2.999382581354098,2.839908451299086,28.311111035424513,3.975796639152893,71.08188114314477,6.8648827112868664,22.05323614556836,9865934985
1594301400,316.84,317.1,310.68,314.38,NaN,NaN,313.23,318.8739473684211,302.1281500000003,290.35439999999994,302.4855999999998,309.40150000000057,303.44825004799543,310.1612559255595,310.0861538461532,319.78049331574863,300.39181437655776,302.1281500000003,290.35439999999994,302.4855999999998,309.40150000000057,314.05333333333334,83354158,104399916.95,56.278494429344676,0.8744717500919029,1.5,2.75,NaN,NaN,5.994202498089355,0.7984121102310896,1185.3699390281392,0.1456926046356406,3.0220242070936365,2.876331602457996,23.14295074986347,2.287294615259467,38.3463431045687,28.595090057004487,33.0585668384268,9782580827
1594387800,314.31,317.88,312.76,317.59,NaN,NaN,314.2,318.6677631578948,302.23675000000026,290.16299999999995,302.9731999999998,310.2505000000006,304.0028284774858,310.8687553612205,310.622307692307,321.1136437628262,300.1309716217878,302.23675000000026,290.16299999999995,302.9731999999998,310.2505000000006,316.07666666666665,57550365,96815257.2,59.089920717661656,1.4375149853318379,1.5,2.75,NaN,NaN,5.931759462511544,0.594434871779693,1190.098820380064,0.30804889909312516,3.2613927263244022,2.953343827231277,23.086303585083694,5.845692384602554,36.302040162640324,30.486121497211485,33.21183834014819,9840131192
1594647000,320.13,322.71,314.13,314.84,NaN,NaN,315.17,318.4615789473685,302.32285000000024,289.92799999999994,303.4603999999998,310.7820000000006,304.42781559601576,311.2469691363424,310.8369230769224,321.5481433180289,300.1257028358159,302.32285000000024,289.92799999999994,303.4603999999998,310.7820000000006,317.22666666666663,102997484,92231187.45,55.780684442081935,1.6563128934718139,1.5,2.75,NaN,NaN,6.120919500903575,1.1167316267703544,1187.1582322036052,0.19123859935006227,3.192392076418855,3.001153477068793,17.446527137692442,3.409314852525782,11.841580714438285,61.29983429602381,26.858584989537896,9737133708
1594733400,313.3,319.76,312,318.92,NaN,NaN,316.14,318.25539473684216,302.4324500000002,289.74769999999995,304.1829999999998,311.3755000000006,304.9961365530348,311.97773398050026,311.9776923076916,322.7304498183482,301.224934797035,302.4324500000002,289.74769999999995,304.1829999999998,311.3755000000006,316.8933333333334,93656951,90124898.8,59.41246191816192,1.1331442179165094,1.5,2.75,NaN,NaN,6.237996679410462,1.0391906370717612,1191.104563336666,0.34101424807335334,3.4274212871604846,3.086407039087131,17.12032086230587,3.4245686859514857,38.6506294275471,28.350105695546677,32.99926487690621,9830790659
1594819800,322.41,323.04,319.265,321.85,NaN,NaN,317.11,318.04921052631585,302.5647000000002,289.6313999999999,304.94859999999983,311.8200000000006,305.6570723744844,312.9179497918812,313.09307692307624,324.6708364635299,301.5153173826226,302.5647000000002,289.6313999999999,304.94859999999983,311.8200000000006,321.38500000000005,87196524,87603349.9,61.83654258585203,2.110433457052365,1.5,2.75,NaN,NaN,6.086711202309715,0.9953560463102792,1196.4830920786708,0.5758617638268815,3.8062342438707333,3.230372480043852,16.618293015199285,3.6487182790158577,43.98611951484681,23.775585096689223,32.23829538846395,9917987183
1594906200,319.79,321.28,319.09,320.79,NaN,NaN,318.08000000000004,317.84302631578953,302.6848000000002,289.6150999999999,305.64059999999984,312.2765000000006,306.2505205166615,313.6676688593211,314.6884615384609,324.1619414324653,305.2149816444565,302.6848000000002,289.6150999999999,305.64059999999984,312.2765000000006,320.3866666666666,54622520,86164528.7,60.43038925825892,1.4705064125697382,1.5,2.75,NaN,NaN,5.84908897357331,0.6339327890967736,1194.835583136575,0.5957745987990188,3.975090728542625,3.3793161297436063,17.04781732820935,2.7415687153700805,49.58648414372084,19.452388567033214,30.961127289245955,9863364663
1594992600,321.88,322.57,319.735,321.72,NaN,NaN,319.05,317.6368421052632,302.82720000000023,289.70579999999995,306.3899999999998,312.77350000000064,306.85716677091006,314.43455753938576,316.0161538461532,324.12279514426893,307.90951254803747,302.82720000000023,289.70579999999995,306.3899999999998,312.77350000000064,321.3416666666667,62774911,85261841.35,61.2626870428065,1.6659931569181916,1.5,2.75,NaN,NaN,5.633796904032358,0.7362603247367001,1196.6414793853282,0.6055659362941532,4.136273550111298,3.5307076138171447,16.988257333640686,1.4729537927771694,50.44602501095323,18.82961541944166,30.724359569605113,9926139574
1595251800,321.43,325.13,320.62,324.32,NaN,NaN,320.02000000000004,317.4306578947369,303.00850000000025,289.83399999999995,307.1227999999998,313.55750000000063,307.54198376028614,315.37602824992047,317.24384615384554,325.1728679713501,309.31482433634096,303.00850000000025,289.83399999999995,307.1227999999998,313.55750000000063,323.3566666666666,56308749,81299797.6,63.569723766348254,1.9965676384148,1.5,2.75,NaN,NaN,5.553525696601475,0.6926062630197741,1195.0205379982349,0.7136953284790577,4.422826774415967,3.709131445936909,15.509688556814568,3.3590413665625665,83.58337046287018,2.3911324525082787,14.025497084621543,9982448323
1595338200,326.45,326.93,323.94,325.01,NaN,NaN,320.99,317.2244736842106,303.18145000000027,290.1089999999999,307.7741999999998,314.2770000000006,308.2270040049808,316.2935493689757,318.358461538461,326.26712804536777,310.4497950315542,303.18145000000027,290.1089999999999,307.7741999999998,314.2770000000006,325.29333333333335,57498967,80442276.5,64.17942627103184,2.1232108991540346,1.5,2.75,NaN,NaN,5.370416718272799,0.7147854275357312,1199.913510149248,0.7542743928940658,4.651974437054491,3.8977000441604255,13.288947964978627,2.7927130115756795,81.53747563572966,2.984942387648894,15.477581976621424,10039947290
1595424600,324.62,327.2,324.5,326.86,NaN,NaN,321.96000000000004,317.01828947368426,303.3440000000003,290.41499999999996,308.4613999999998,315.0175000000006,308.95770973027567,317.2998780005018,319.48384615384555,327.73996756941847,311.2277247382726,303.3440000000003,290.41499999999996,308.4613999999998,315.0175000000006,326.18666666666667,57792915,79908359.95,65.83062690515587,1.9326523970453837,1.5,2.75,NaN,NaN,5.1796726669675985,0.7232399092680916,1202.1592791179687,0.8226963450329245,4.926070475451581,4.103374130418657,13.115464354326116,3.96971817545646,79.447090112002,3.652577775948949,16.90033211204905,10097740205
1595511000,326.47,327.23,321.48,322.96,NaN,NaN,322.93,316.81210526315795,303.49340000000024,290.55369999999994,309.1871999999998,315.9610000000006,309.5068191526178,317.83893723854925,319.9384615384609,328.259052664498,311.6178704124238,303.49340000000024,290.55369999999994,309.1871999999998,315.9610000000006,323.89000000000004,75737989,77054584.8,59.594030629753455,1.1081604864775685,1.5,2.75,NaN,NaN,5.22041033361277,0.9829134657799103,1201.3474349770827,0.5361562296614135,4.773569417495423,4.23741318783401,15.050797975959185,1.6908592839824947,72.12181537064698,6.46142088487919,21.41676374447383,10022002216
1595597400,320.95,321.99,319.246,320.88,NaN,NaN,323.90000000000003,316.60592105263163,303.6551500000003,290.76009999999997,309.9727999999998,316.6375000000006,309.95282624467205,318.12856226344934,320.48461538461476,328.01071199426303,312.9585187749665,303.6551500000003,290.76009999999997,309.9727999999998,316.6375000000006,320.70533333333333,73766597,76269516.25,56.51867715520861,0.09753641664444343,1.5,2.75,NaN,NaN,5.112809595497572,0.9671832289876363,1198.6598311584899,0.15707981311276065,4.43376295422496,4.2766831411121995,15.055968028303216,1.9184347605132832,41.00353169293036,26.372221443902834,32.6242468631668,9948235619
1595856600,321.63,323.41,320.775,323.22,NaN,NaN,324.87,316.3997368421053,303.81490000000025,290.86369999999994,310.73779999999977,317.7960000000006,310.4731075684104,318.6134610955018,321.02615384615325,328.2421000273676,313.8102076649389,303.81490000000025,290.86369999999994,310.73779999999977,317.7960000000006,322.4683333333333,48292970,72286113.9,59.077230649921326,0.6471501244772293,1.5,2.75,NaN,NaN,4.935823195819177,0.6680808718920495,1201.5616047290966,0.02159130526792019,4.303672272697099,4.282080967429179,14.036978235636077,1.3483005142355484,37.55156412122239,29.30457394089833,33.143861937879294,9996528589
1595943000,322.43,323.64,320.85,321.17,NaN,NaN,325.84000000000003,316.193552631579,303.95455000000027,291.0507999999999,311.43559999999974,318.6315000000006,310.89259354611977,318.8569409911683,321.5484615384609,327.6635115535204,315.43341152340145,303.95455000000027,291.0507999999999,311.43559999999974,318.6315000000006,321.8866666666667,57494979,71172199.85,55.97002538350247,0.458782132767334,1.5,2.75,NaN,NaN,4.782550110403519,0.8078291681467537,1200.5003726186546,-0.2343272441296893,3.989171912267068,4.223499156396757,13.21682204947625,-0.21127854590648026,15.542896974012173,55.1933112015405,29.26379182444732,9939033610
1596029400,322.12,325.73,322.075,325.12,NaN,NaN,NaN,NaN,304.0987500000003,291.32739999999995,312.0379999999998,319.4695000000006,311.45053105411506,319.45342280153324,322.1276923076917,328.05688555337883,316.19849906200454,304.0987500000003,291.32739999999995,312.0379999999998,319.4695000000006,324.30833333333334,48454159,67925169.2,60.30254374784513,1.0381673574653436,1.5,2.75,NaN,NaN,4.7666536739461245,0.7133461656507732,1205.6935634267447,-0.168873275115347,4.012407562502574,4.181280837617921,14.02746077991295,1.349792699273663,13.572280521459684,58.31838580628513,28.1093336722552,9987487769
1596115800,321.9,324.41,319.64,323.96,NaN,NaN,NaN,NaN,304.2388000000003,291.82469999999995,312.67779999999976,320.14150000000063,311.9410984637576,319.88262062995864,322.8292307692301,327.057476170327,318.6009853681332,304.2388000000003,291.82469999999995,312.67779999999976,320.14150000000063,322.67,61861714,67398427.8,58.48257455233704,0.6112276701860686,1.5,2.75,NaN,NaN,4.817606982949974,0.9178509947378921,1202.5249675231937,-0.2311438085486781,3.892351076932073,4.123494885480751,14.059196663475166,0.6962576153176526,14.972037784789011,56.077464652155236,28.950497563055745,9925626055
1596202200,325.9,326.63,321.33,326.52,NaN,NaN,NaN,NaN,304.3770000000003,292.2057,313.2695999999998,320.8560000000007,312.51282009262985,320.514751998534,323.41384615384555,327.4138579882022,319.4138343194889,304.3770000000003,292.2057,313.2695999999998,320.8560000000007,324.82666666666665,85210755,68191754.7,61.26126697653898,0.715999347407023,1.5,2.75,NaN,NaN,4.852063627024977,1.2495756323454748,1200.5741150831773,-0.13227672852468508,3.958148974824894,4.090425703349579,14.585600970140787,0.6783423778983685,49.06906406378427,19.793350401582334,31.137585534633406,10010836810
1596461400,328.32,329.62,327.73,328.79,NaN,NaN,NaN,NaN,304.5289500000003,292.74999999999994,313.9477999999998,321.44300000000067,313.151140873311,321.3028708558165,323.9476923076917,328.74361463883315,319.1517699765502,304.5289500000003,292.74999999999994,313.9477999999998,321.44300000000067,328.71333333333337,53077948,67759960.7,63.58839592954307,1.729902325771993,1.5,2.75,NaN,NaN,4.726916225094622,0.7833231815909244,1204.0777363981656,0.044199873069102225,4.1456755446859574,4.101475671616855,14.414490399307226,1.1630411371957876,51.008103594518865,18.435105988447482,30.55679041703365,10063914758
1596547800,327.86,330.06,327.86,330.06,NaN,NaN,NaN,NaN,304.6828500000003,293.56949999999995,314.64019999999977,322.2570000000007,313.81423338808315,322.1368831552625,324.6607692307686,330.0824321124599,319.2391063490773,304.6828500000003,293.56949999999995,314.64019999999977,322.2570000000007,329.32666666666665,41917893,65710357.2,64.8602470806255,1.5102410888569897,1.5,2.75,NaN,NaN,4.546422209016434,0.6379191163489825,1207.3108979056276,0.19615101989812622,4.346664446489513,4.150513426591386,14.481570007667445,0.9790124212200907,75.80256030941652,4.931401060219893,19.26603863036361,10105832651
1596634200,331.47,332.39,331.18,332.11,NaN,NaN,NaN,NaN,304.85355000000027,294.19739999999996,315.3007999999998,323.05350000000067,314.53171443168776,323.08670380714227,325.45999999999935,331.88281510294064,319.03718489705807,304.85355000000027,294.19739999999996,315.3007999999998,323.05350000000067,331.8933333333333,42866354,65121745.1,66.87178985288463,1.9396131127217533,1.5,2.75,NaN,NaN,4.388106336943831,0.6582494669664496,1210.743818853823,0.37409526653963354,4.618132509765928,4.244037243226295,14.53822127614013,2.833168194203627,75.34701114912937,5.106635089297609,19.546353761573016,10148699005
1596720600,331.4799,334.46,331.13,334.33,NaN,NaN,NaN,NaN,305.0252500000003,295.1422,315.9167999999998,324.05100000000067,315.3081177873078,324.15749392074775,326.22999999999934,334.1476608822599,318.31233911773876,305.0252500000003,295.1422,315.9167999999998,324.05100000000067,333.3066666666666,43679447,63138009.55,68.94501151270583,2.1049613873124247,1.5,2.75,NaN,NaN,4.312527312876413,0.691809059413087,1211.0644490743541,0.5689997171905645,4.9552868897145,4.386287172523936,11.855014219916354,4.191598105210667,100,0,0,10192378452
1596807000,333.28,334.88,332.3,334.57,NaN,NaN,NaN,NaN,305.2030500000003,295.9599,316.5487999999998,324.90000000000066,316.0634857172173,325.1491611663908,326.9653846153839,335.99145494319527,317.9393142875726,305.2030500000003,295.9599,316.5487999999998,324.90000000000066,333.9166666666667,57308270,63125904.8,69.16964229996775,1.8158308262780019,1.5,2.75,NaN,NaN,4.188775361956668,0.9078407696740056,1214.163586238597,0.6366614419621097,5.1821139749765734,4.545452533014464,10.270245037193753,3.511540127467349,100,0,0,10249686722
1597066200,335.06,335.77,332.955,335.57,NaN,NaN,NaN,NaN,305.3815000000003,296.91560000000004,317.1737999999998,325.9365000000006,316.82844706164013,326.1416220076869,327.63538461538394,337.75725618264346,317.5135130481244,305.3815000000003,296.91560000000004,317.1737999999998,325.9365000000006,334.76499999999993,44282089,60190135.05,70.13885220807428,1.8773715888005142,1.5,2.75,NaN,NaN,4.090648550388335,0.7357034331824448,1218.5410015382781,0.6680732961273224,5.3805441531736165,4.712470857046294,10.091974090418734,4.483606812591455,100,0,0,10293968811
1597152600,336.85,337.54,332.01,332.8,NaN,NaN,NaN,NaN,305.5436500000003,297.8385,317.7187999999998,326.6305000000006,317.4547824709876,326.77575324505005,328.39230769230704,338.4740631983333,318.3105521862808,305.5436500000003,297.8385,317.7187999999998,326.6305000000006,334.1166666666666,69600882,58987331.6,64.12527394307742,1.6368795249457506,1.5,2.75,NaN,NaN,4.1934593682177415,1.1799293189251503,1219.609320005696,0.4330025056004194,5.253723989046819,4.820721483446399,10.829883471441006,2.362204724409451,68.7652251538988,7.997202492560876,23.237572353540326,10224367929
1597239000,335.44,338.28,332.8377,337.44,NaN,NaN,NaN,NaN,305.72285000000034,298.92490000000004,318.3059999999998,327.4100000000006,318.2385164917332,327.7913957931405,329.6661538461531,339.8137857441202,319.51852194818605,305.72285000000034,298.92490000000004,318.3059999999998,327.4100000000006,336.18590000000006,53826128,57318811.8,68.93066911945844,2.0865173420724776,1.5,2.75,NaN,NaN,4.2853551276307575,0.9390656629068505,1222.5267008706348,0.5151303438739365,5.46463441328882,4.949504069414884,11.332000690160115,4.161007531794055,70.36862246536069,7.249817875628267,22.381559659011046,10278194057
1597325400,336.61,338.2514,335.83,336.83,NaN,NaN,NaN,NaN,305.8905000000003,300.06370000000004,318.7989999999998,328.21200000000056,318.96759427637113,328.6522152414128,330.7130769230762,340.79254694768076,320.6336068984716,305.8905000000003,300.06370000000004,318.7989999999998,328.21200000000056,336.97046666666665,41816146,56678493.1,67.64777571058349,1.6191845565845118,1.5,2.75,NaN,NaN,4.152215475657132,0.7377780126620903,1220.196771380592,0.4555500392322882,5.518941618455244,5.063391579222956,10.956295393048823,3.157540120053903,47.82613703215626,20.86863183566214,31.305231132181607,10236377911
1597411800,336.41,337.42,335.62,336.84,NaN,NaN,NaN,NaN,306.0586500000003,301.0006,319.3085999999998,328.9680000000006,319.66847293219973,329.43200426604017,331.9184615384608,340.8242344152626,323.012688661659,306.0586500000003,301.0006,319.3085999999998,328.9680000000006,336.6266666666666,47260390,55902767.05,67.6584023121724,1.291298230543034,1.5,2.75,NaN,NaN,3.9842000845387666,0.8454034119228809,1221.252727936416,0.34880177485462927,5.499393797791242,5.150592022936613,10.838984796451603,2.448371300830303,45.57070916965957,22.616882919938746,31.812407910401678,10283638301
1597671000,337.94,338.34,336.8517,337.91,NaN,NaN,NaN,NaN,306.2275000000003,301.9118,319.6799999999998,329.6475000000006,320.3838269348586,330.2394324311792,332.902307692307,341.40321498816223,324.4014003964517,306.2275000000003,301.9118,319.6799999999998,329.6475000000006,337.70056666666665,35480974,54861378.3,68.83786948191016,1.4374495017759852,1.5,2.75,NaN,NaN,3.8067572213574263,0.6467386547596089,1222.1697388910447,0.28493720136799006,5.506763524646601,5.221826323278611,10.566633788192936,2.378355450524154,42.84323820613651,24.767726895850295,32.38903489801319,10319119275
1597757400,338.34,339.1,336.61,338.64,NaN,NaN,NaN,NaN,306.4040500000003,302.6862,319.98879999999974,330.3290000000006,321.0997552903543,331.0394864853526,334.03153846153776,341.29031075088403,326.7727661721915,306.4040500000003,302.6862,319.98879999999974,330.3290000000006,338.1166666666667,38733908,53923125.35,69.65105885704904,1.4269901906671998,1.5,2.75,NaN,NaN,3.7127031341176107,0.718317192273055,1219.575021538512,0.2289517457932977,5.508016005520233,5.279064259726935,10.545775608273395,1.966216012766846,78.57924748651034,3.9355528581122496,17.48519965537742,10357853183
1597843800,339.05,339.61,336.62,337.23,NaN,NaN,NaN,NaN,306.55950000000036,303.5243,320.31759999999974,330.84750000000065,321.7323139064189,331.62905920103333,334.85538461538385,340.8354881153575,328.8752811154102,306.55950000000036,303.5243,320.31759999999974,330.84750000000065,337.82,68054244,54436191.8,66.06500379522832,1.1069571633461592,1.5,2.75,NaN,NaN,3.661081481680639,1.2501654092562735,1217.2516493659086,0.043747990864064334,5.333749248307015,5.290001257442951,10.911915098962035,0.867406454700456,38.98851484039186,28.100582430749593,32.91090272885854,10289798939
1597930200,335.36,338.8,335.22,338.28,NaN,NaN,NaN,NaN,306.7140500000003,304.2906,320.70319999999975,331.6135000000006,322.38124277283384,332.2624821342682,335.5853846153838,340.67645441618566,330.49431481458197,306.7140500000003,304.2906,320.70319999999975,331.6135000000006,337.43333333333334,42207826,52759683.65,67.4106169948391,0.9343802241061281,1.5,2.75,NaN,NaN,3.655289947274878,0.8000014988717621,1214.6759657010416,-0.05584686138704331,5.220192680709147,5.27603954209619,10.483521834309368,1.1088860328182382,64.92050297060251,9.88787300601845,25.191624023379052,10332006765
1598016600,337.92,339.72,337.55,339.48,NaN,NaN,NaN,NaN,306.87630000000036,305.1079,321.4805999999997,332.5435000000006,323.0517822719384,332.94986478814747,336.30999999999915,340.6794393233662,331.9405606766321,306.87630000000036,305.1079,321.4805999999997,332.5435000000006,338.9166666666667,55106628,51826685.2,68.9270777060336,1.0825905301909216,1.5,2.75,NaN,NaN,3.5491978081838162,1.0632867563754589,1211.7886748258213,-0.08686284936546063,5.1674609803893645,5.254323829754825,10.563201235038644,1.1651816312542913,66.337234345696,9.156980697835023,24.505784956468997,10387113393
1598275800,342.12,343,339.4504,342.92,NaN,NaN,NaN,NaN,307.05540000000036,306.07559999999995,322.25479999999976,333.52850000000063,323.83092806519574,333.89940147499055,337.1415384615376,342.0753205724351,332.2077563506401,307.05540000000036,306.07559999999995,322.25479999999976,333.52850000000063,341.79013333333336,48588662,51841469.8,72.83013074599346,1.5584924931920083,1.5,2.75,NaN,NaN,3.5492265361706865,0.9372547149502308,1215.8722609551537,0.06988052048594628,5.341674480362258,5.2717939598763115,11.663830523082641,3.040865384615386,69.0980312624834,7.84912869549512,23.05284004202149,10435702055
1598362200,343.53,344.21,342.27,344.12,NaN,NaN,NaN,NaN,307.23510000000033,306.9984999999999,322.99619999999976,334.6760000000006,324.626577944992,334.87279181070573,337.89461538461455,343.77898119133954,332.01024957788957,307.23510000000033,306.9984999999999,322.99619999999976,334.6760000000006,343.5333333333333,38463381,50889889.9,74.0544447316196,1.76317336410797,1.5,2.75,NaN,NaN,3.4342817835870663,0.7558157637122339,1215.6008125981384,0.19298023307503165,5.513019251220101,5.320039018145069,9.577019622064133,1.979611190137508,69.14879149891281,7.82515205577837,23.026056445308825,10474165436
1598448600,344.76,347.86,344.17,347.57,NaN,NaN,NaN,NaN,307.42825000000033,307.99229999999994,323.6883999999998,335.7985000000006,325.52631998636485,336.08204973349564,338.89461538461455,346.37985672144356,331.40937404778555,307.42825000000033,307.99229999999994,323.6883999999998,335.7985000000006,346.5333333333333,50790237,51006693.8,77.23109843716531,2.3417389321586124,1.5,2.75,NaN,NaN,3.4561187990451336,0.9957563060086048,1213.051302841342,0.43168956533416925,5.85965097481278,5.427961409478611,8.183558225463415,3.1885520885906864,99.99999999999999,0,0,10524955673
1598535000,348.51,349.9,346.53,348.33,NaN,NaN,NaN,NaN,307.62815000000035,308.82699999999994,324.4217999999998,337.0170000000006,326.4205819476839,337.24852118744843,339.87615384615304,348.60352383847385,331.14878385383224,307.62815000000035,308.82699999999994,324.4217999999998,337.0170000000006,348.25333333333333,58034142,50815315.2,77.87377636183228,2.438024467198589,1.5,2.75,NaN,NaN,3.449967456256196,1.1420600614517096,1215.063060732173,0.5576938063157186,6.125078667373259,5.5673848610575405,7.636221224124788,3.411115069469187,99.99999999999999,0,0,10582989815
1598621400,349.44,350.72,348.15,350.58,NaN,NaN,NaN,NaN,307.83605000000034,309.6814999999999,325.1977999999998,338.2200000000006,327.36801010659826,338.5181858362629,341.2438461538453,350.65293354021736,331.83475876747326,307.83605000000034,309.6814999999999,325.1977999999998,338.2200000000006,349.81666666666666,48588940,48984224.45,79.70056716379085,2.3345693147809206,1.5,2.75,NaN,NaN,3.3871126379521854,0.9919303723915547,1218.5011161009973,0.7002685511144424,6.442720549950593,5.742451998836151,7.499133701419391,3.749519102719647,99.99999999999999,0,0,10631578755
1598880600,350.35,351.3,349.06,349.31,NaN,NaN,NaN,NaN,308.03710000000035,310.43429999999995,326.0111999999998,339.24600000000066,328.2284802984964,339.54597766138073,342.1569230769223,352.1950178536295,332.11882830021506,308.03710000000035,310.43429999999995,326.0111999999998,339.24600000000066,349.89000000000004,66099183,49635286.2,75.89181808809805,2.1516975125265967,1.5,2.75,NaN,NaN,3.3051760209556016,1.331697428592645,1214.9579045879645,0.6195211326498749,6.516853414648494,5.89733228199862,8.690990249329188,3.1508386487125017,71.09644479936993,6.931278440599336,21.97227676003073,10565479572
1598967000,350.21,352.71,349.24,352.6,NaN,NaN,NaN,NaN,308.2523500000003,311.1782999999999,326.85079999999977,340.3730000000006,329.1842261691436,340.7892178841064,343.36999999999927,354.31085357380516,332.42914642619337,308.2523500000003,311.1782999999999,326.85079999999977,340.3730000000006,351.5166666666667,54999325,50289357.8,78.7278389581277,2.042534847036708,1.5,2.75,NaN,NaN,3.3169491623159137,1.0936573343953102,1217.7394225378011,0.692629154856828,6.7631187255696545,6.070489570712827,9.302141212763031,4.557720250274294,74.15940356270835,5.698872483967477,20.141723953324174,10620478897